PokerStars Zoom Hand #84298198668:  Hold'em No Limit ($0.10/$0.25) - 2012/08/05 13:00:02 JST [2012/08/05 0:00:02 ET]
Table 'Whirlpool' 9-max Seat #1 is the button
Seat 1: KrystalAA ($18.87 in chips) 
Seat 2: Sharks_Nica ($25.10 in chips) 
Seat 3: 2997qwer ($12.50 in chips) 
Seat 4: wtu1986 ($25.47 in chips) 
Seat 5: chiyuki ($27.11 in chips) 
Seat 6: Medic8681 ($14.14 in chips) 
Seat 7: seula i ($83.97 in chips) 
Seat 8: nice.franki ($10.30 in chips) 
Seat 9: AndiM64 ($25 in chips) 
Sharks_Nica: posts small blind $0.10
2997qwer: posts big blind $0.25
*** HOLE CARDS ***
Dealt to chiyuki [As 9h]
wtu1986: folds 
chiyuki: folds 
Medic8681: folds 
seula i: folds 
nice.franki: folds 
AndiM64: folds 
KrystalAA: raises $0.46 to $0.71
Sharks_Nica: raises $1.54 to $2.25
2997qwer: folds 
KrystalAA: folds 
Uncalled bet ($1.54) returned to Sharks_Nica
Sharks_Nica collected $1.67 from pot
Sharks_Nica: doesn't show hand 
*** SUMMARY ***
Total pot $1.67 | Rake $0 
Seat 1: KrystalAA (button) folded before Flop
Seat 2: Sharks_Nica (small blind) collected ($1.67)
Seat 3: 2997qwer (big blind) folded before Flop
Seat 4: wtu1986 folded before Flop (didn't bet)
Seat 5: chiyuki folded before Flop (didn't bet)
Seat 6: Medic8681 folded before Flop (didn't bet)
Seat 7: seula i folded before Flop (didn't bet)
Seat 8: nice.franki folded before Flop (didn't bet)
Seat 9: AndiM64 folded before Flop (didn't bet)



PokerStars Zoom Hand #84298207211:  Hold'em No Limit ($0.10/$0.25) - 2012/08/05 13:00:39 JST [2012/08/05 0:00:39 ET]
Table 'Whirlpool' 9-max Seat #1 is the button
Seat 1: Lasutchik ($27.20 in chips) 
Seat 2: 2997qwer ($12.25 in chips) 
Seat 3: masterkoolb ($13.60 in chips) 
Seat 4: BlOnDhOlIc ($28.27 in chips) 
Seat 5: AndiM64 ($25 in chips) 
Seat 6: chiyuki ($27.11 in chips) 
Seat 7: Sharks_Nica ($25 in chips) 
Seat 8: mikifeio ($35.44 in chips) 
Seat 9: Medic8681 ($12.85 in chips) 
2997qwer: posts small blind $0.10
masterkoolb: posts big blind $0.25
*** HOLE CARDS ***
Dealt to chiyuki [Ac 5c]
BlOnDhOlIc: folds 
AndiM64: folds 
chiyuki: folds 
Sharks_Nica: folds 
mikifeio: folds 
Medic8681: folds 
Lasutchik: folds 
2997qwer: folds 
Uncalled bet ($0.15) returned to masterkoolb
masterkoolb collected $0.20 from pot
masterkoolb: doesn't show hand 
*** SUMMARY ***
Total pot $0.20 | Rake $0 
Seat 1: Lasutchik (button) folded before Flop (didn't bet)
Seat 2: 2997qwer (small blind) folded before Flop
Seat 3: masterkoolb (big blind) collected ($0.20)
Seat 4: BlOnDhOlIc folded before Flop (didn't bet)
Seat 5: AndiM64 folded before Flop (didn't bet)
Seat 6: chiyuki folded before Flop (didn't bet)
Seat 7: Sharks_Nica folded before Flop (didn't bet)
Seat 8: mikifeio folded before Flop (didn't bet)
Seat 9: Medic8681 folded before Flop (didn't bet)



PokerStars Zoom Hand #84298199350:  Hold'em No Limit ($0.10/$0.25) - 2012/08/05 13:00:05 JST [2012/08/05 0:00:05 ET]
Table 'Whirlpool' 9-max Seat #1 is the button
Seat 1: masterkoolb ($13.60 in chips) 
Seat 2: Anafim ($12.50 in chips) 
Seat 3: mistownboi ($8.85 in chips) 
Seat 4: Lasutchik ($27.45 in chips) 
Seat 5: luyifei ($14.47 in chips) 
Seat 6: TraderYao ($25.35 in chips) 
Seat 7: fwani ($28.28 in chips) 
Seat 8: cR!Ma*aRm ($21.01 in chips) 
Seat 9: chiyuki ($27.11 in chips) 
Anafim: posts small blind $0.10
mistownboi: posts big blind $0.25
*** HOLE CARDS ***
Dealt to chiyuki [6d Qd]
Lasutchik: folds 
luyifei: raises $0.50 to $0.75
TraderYao: folds 
fwani: folds 
cR!Ma*aRm: calls $0.75
chiyuki: folds 
masterkoolb: folds 
Anafim: folds 
mistownboi: folds 
*** FLOP *** [3d 8h 7d]
luyifei: bets $0.50
cR!Ma*aRm: calls $0.50
*** TURN *** [3d 8h 7d] [8d]
luyifei: bets $0.25
cR!Ma*aRm: calls $0.25
*** RIVER *** [3d 8h 7d 8d] [3s]
luyifei: checks 
cR!Ma*aRm: bets $1.25
luyifei: folds 
Uncalled bet ($1.25) returned to cR!Ma*aRm
cR!Ma*aRm collected $3.20 from pot
cR!Ma*aRm: doesn't show hand 
*** SUMMARY ***
Total pot $3.35 | Rake $0.15 
Board [3d 8h 7d 8d 3s]
Seat 1: masterkoolb (button) folded before Flop (didn't bet)
Seat 2: Anafim (small blind) folded before Flop
Seat 3: mistownboi (big blind) folded before Flop
Seat 4: Lasutchik folded before Flop (didn't bet)
Seat 5: luyifei folded on the River
Seat 6: TraderYao folded before Flop (didn't bet)
Seat 7: fwani folded before Flop (didn't bet)
Seat 8: cR!Ma*aRm collected ($3.20)
Seat 9: chiyuki folded before Flop (didn't bet)



PokerStars Zoom Hand #84298208979:  Hold'em No Limit ($0.10/$0.25) - 2012/08/05 13:00:46 JST [2012/08/05 0:00:46 ET]
Table 'Whirlpool' 9-max Seat #1 is the button
Seat 1: seula i ($57.53 in chips) 
Seat 2: BlOnDhOlIc ($28.27 in chips) 
Seat 3: chiyuki ($27.11 in chips) 
Seat 4: Connor82002 ($8.74 in chips) 
Seat 5: nice.franki ($4.57 in chips) 
Seat 6: RomarioJa ($12 in chips) 
Seat 7: JAMES3FINGER ($323.04 in chips) 
Seat 8: KeLevro0 ($12.25 in chips) 
Seat 9: 2997qwer ($13.80 in chips) 
BlOnDhOlIc: posts small blind $0.10
chiyuki: posts big blind $0.25
*** HOLE CARDS ***
Dealt to chiyuki [7s 5d]
Connor82002: raises $0.25 to $0.50
nice.franki: folds 
RomarioJa: folds 
JAMES3FINGER: raises $8.25 to $8.75
KeLevro0: folds 
2997qwer: folds 
seula i: folds 
BlOnDhOlIc: folds 
chiyuki: folds 
Connor82002: folds 
Uncalled bet ($8.25) returned to JAMES3FINGER
JAMES3FINGER collected $1.35 from pot
JAMES3FINGER: doesn't show hand 
*** SUMMARY ***
Total pot $1.35 | Rake $0 
Seat 1: seula i (button) folded before Flop (didn't bet)
Seat 2: BlOnDhOlIc (small blind) folded before Flop
Seat 3: chiyuki (big blind) folded before Flop
Seat 4: Connor82002 folded before Flop
Seat 5: nice.franki folded before Flop (didn't bet)
Seat 6: RomarioJa folded before Flop (didn't bet)
Seat 7: JAMES3FINGER collected ($1.35)
Seat 8: KeLevro0 folded before Flop (didn't bet)
Seat 9: 2997qwer folded before Flop (didn't bet)



PokerStars Zoom Hand #84298205784:  Hold'em No Limit ($0.10/$0.25) - 2012/08/05 13:00:33 JST [2012/08/05 0:00:33 ET]
Table 'Whirlpool' 9-max Seat #1 is the button
Seat 1: TraderYao ($25.25 in chips) 
Seat 2: AUGH-AUGH ($33.34 in chips) 
Seat 3: puffy5533 ($23.58 in chips) 
Seat 4: AndiM64 ($25 in chips) 
Seat 5: jtedecaliss ($175.79 in chips) 
Seat 6: wtu1986 ($24.65 in chips) 
Seat 7: chiyuki ($27.11 in chips) 
Seat 8: a_tasmanian ($60.51 in chips) 
Seat 9: RomarioJa ($8.30 in chips) 
AUGH-AUGH: posts small blind $0.10
puffy5533: posts big blind $0.25
*** HOLE CARDS ***
Dealt to chiyuki [6h Ts]
AndiM64: folds 
jtedecaliss has timed out
jtedecaliss: folds 
wtu1986: raises $0.50 to $0.75
chiyuki: folds 
a_tasmanian: folds 
RomarioJa: folds 
TraderYao: folds 
AUGH-AUGH: folds 
puffy5533: folds 
Uncalled bet ($0.50) returned to wtu1986
wtu1986 collected $0.60 from pot
wtu1986: doesn't show hand 
*** SUMMARY ***
Total pot $0.60 | Rake $0 
Seat 1: TraderYao (button) folded before Flop (didn't bet)
Seat 2: AUGH-AUGH (small blind) folded before Flop
Seat 3: puffy5533 (big blind) folded before Flop
Seat 4: AndiM64 folded before Flop (didn't bet)
Seat 5: jtedecaliss folded before Flop (didn't bet)
Seat 6: wtu1986 collected ($0.60)
Seat 7: chiyuki folded before Flop (didn't bet)
Seat 8: a_tasmanian folded before Flop (didn't bet)
Seat 9: RomarioJa folded before Flop (didn't bet)



PokerStars Zoom Hand #84298214168:  Hold'em No Limit ($0.10/$0.25) - 2012/08/05 13:01:07 JST [2012/08/05 0:01:07 ET]
Table 'Whirlpool' 9-max Seat #1 is the button
Seat 1: BlOnDhOlIc ($28.17 in chips) 
Seat 2: 2997qwer ($10.15 in chips) 
Seat 3: DooMSDaY1337 ($57.21 in chips) 
Seat 4: RomarioJa ($13.57 in chips) 
Seat 5: wtu1986 ($24.90 in chips) 
Seat 6: JAMES3FINGER ($323.89 in chips) 
Seat 7: taksist889 ($18 in chips) 
Seat 8: chiyuki ($26.86 in chips) 
Seat 9: Oswulf ($14.23 in chips) 
2997qwer: posts small blind $0.10
DooMSDaY1337: posts big blind $0.25
*** HOLE CARDS ***
Dealt to chiyuki [8d 4s]
RomarioJa: folds 
wtu1986: folds 
JAMES3FINGER: folds 
taksist889: folds 
chiyuki: folds 
Oswulf: folds 
BlOnDhOlIc: raises $0.25 to $0.50
2997qwer: folds 
DooMSDaY1337: folds 
Uncalled bet ($0.25) returned to BlOnDhOlIc
BlOnDhOlIc collected $0.60 from pot
BlOnDhOlIc: doesn't show hand 
*** SUMMARY ***
Total pot $0.60 | Rake $0 
Seat 1: BlOnDhOlIc (button) collected ($0.60)
Seat 2: 2997qwer (small blind) folded before Flop
Seat 3: DooMSDaY1337 (big blind) folded before Flop
Seat 4: RomarioJa folded before Flop (didn't bet)
Seat 5: wtu1986 folded before Flop (didn't bet)
Seat 6: JAMES3FINGER folded before Flop (didn't bet)
Seat 7: taksist889 folded before Flop (didn't bet)
Seat 8: chiyuki folded before Flop (didn't bet)
Seat 9: Oswulf folded before Flop (didn't bet)



PokerStars Zoom Hand #84298212943:  Hold'em No Limit ($0.10/$0.25) - 2012/08/05 13:01:02 JST [2012/08/05 0:01:02 ET]
Table 'Whirlpool' 9-max Seat #1 is the button
Seat 1: masterkoolb ($14.37 in chips) 
Seat 2: DooMSDaY1337 ($26.05 in chips) 
Seat 3: Catrban ($23.87 in chips) 
Seat 4: BlOnDhOlIc ($33.10 in chips) 
Seat 5: chiyuki ($26.86 in chips) 
Seat 6: KeLevro0 ($11.90 in chips) 
Seat 7: KrystalAA ($18.16 in chips) 
Seat 8: Jippyflip ($19.21 in chips) 
Seat 9: 5zzzz33 ($18.65 in chips) 
DooMSDaY1337: posts small blind $0.10
Catrban: posts big blind $0.25
*** HOLE CARDS ***
Dealt to chiyuki [4c Ts]
BlOnDhOlIc: folds 
chiyuki: folds 
KeLevro0: folds 
KrystalAA: raises $0.46 to $0.71
Jippyflip: folds 
5zzzz33: folds 
masterkoolb: folds 
DooMSDaY1337: folds 
Catrban: folds 
Uncalled bet ($0.46) returned to KrystalAA
KrystalAA collected $0.60 from pot
KrystalAA: doesn't show hand 
*** SUMMARY ***
Total pot $0.60 | Rake $0 
Seat 1: masterkoolb (button) folded before Flop (didn't bet)
Seat 2: DooMSDaY1337 (small blind) folded before Flop
Seat 3: Catrban (big blind) folded before Flop
Seat 4: BlOnDhOlIc folded before Flop (didn't bet)
Seat 5: chiyuki folded before Flop (didn't bet)
Seat 6: KeLevro0 folded before Flop (didn't bet)
Seat 7: KrystalAA collected ($0.60)
Seat 8: Jippyflip folded before Flop (didn't bet)
Seat 9: 5zzzz33 folded before Flop (didn't bet)



PokerStars Zoom Hand #84298215484:  Hold'em No Limit ($0.10/$0.25) - 2012/08/05 13:01:13 JST [2012/08/05 0:01:13 ET]
Table 'Whirlpool' 9-max Seat #1 is the button
Seat 1: RomarioJa ($13.57 in chips) 
Seat 2: masterkoolb ($14.37 in chips) 
Seat 3: Jippyflip ($19.21 in chips) 
Seat 4: chiyuki ($26.86 in chips) 
Seat 5: agurio ($30.56 in chips) 
Seat 6: Medic8681 ($12.85 in chips) 
Seat 7: fwani ($25 in chips) 
Seat 8: KeLevro0 ($11.90 in chips) 
Seat 9: mikifeio ($35.19 in chips) 
masterkoolb: posts small blind $0.10
Jippyflip: posts big blind $0.25
*** HOLE CARDS ***
Dealt to chiyuki [4d 3h]
chiyuki: folds 
agurio: folds 
Medic8681: folds 
fwani: folds 
KeLevro0: folds 
mikifeio: raises $0.25 to $0.50
RomarioJa: folds 
masterkoolb: folds 
Jippyflip: folds 
Uncalled bet ($0.25) returned to mikifeio
mikifeio collected $0.60 from pot
mikifeio: doesn't show hand 
*** SUMMARY ***
Total pot $0.60 | Rake $0 
Seat 1: RomarioJa (button) folded before Flop (didn't bet)
Seat 2: masterkoolb (small blind) folded before Flop
Seat 3: Jippyflip (big blind) folded before Flop
Seat 4: chiyuki folded before Flop (didn't bet)
Seat 5: agurio folded before Flop (didn't bet)
Seat 6: Medic8681 folded before Flop (didn't bet)
Seat 7: fwani folded before Flop (didn't bet)
Seat 8: KeLevro0 folded before Flop (didn't bet)
Seat 9: mikifeio collected ($0.60)



PokerStars Zoom Hand #84298216272:  Hold'em No Limit ($0.10/$0.25) - 2012/08/05 13:01:16 JST [2012/08/05 0:01:16 ET]
Table 'Whirlpool' 9-max Seat #1 is the button
Seat 1: chiyuki ($26.86 in chips) 
Seat 2: Ring Circus ($24.57 in chips) 
Seat 3: Assassin365 ($30.23 in chips) 
Seat 4: lolos21 ($18.56 in chips) 
Seat 5: leo2095 ($15.27 in chips) 
Seat 6: Oswulf ($14.23 in chips) 
Seat 7: Shugana ($25 in chips) 
Seat 8: nice.franki ($4.47 in chips) 
Seat 9: Th3Fog ($21.64 in chips) 
Ring Circus: posts small blind $0.10
Assassin365: posts big blind $0.25
*** HOLE CARDS ***
Dealt to chiyuki [9c Ts]
lolos21: folds 
leo2095: folds 
Oswulf: folds 
Shugana: folds 
nice.franki: folds 
Th3Fog: folds 
chiyuki: raises $0.50 to $0.75
Ring Circus: folds 
Assassin365: folds 
Uncalled bet ($0.50) returned to chiyuki
chiyuki collected $0.60 from pot
chiyuki: doesn't show hand 
*** SUMMARY ***
Total pot $0.60 | Rake $0 
Seat 1: chiyuki (button) collected ($0.60)
Seat 2: Ring Circus (small blind) folded before Flop
Seat 3: Assassin365 (big blind) folded before Flop
Seat 4: lolos21 folded before Flop (didn't bet)
Seat 5: leo2095 folded before Flop (didn't bet)
Seat 6: Oswulf folded before Flop (didn't bet)
Seat 7: Shugana folded before Flop (didn't bet)
Seat 8: nice.franki folded before Flop (didn't bet)
Seat 9: Th3Fog folded before Flop (didn't bet)



PokerStars Zoom Hand #84298225737:  Hold'em No Limit ($0.10/$0.25) - 2012/08/05 13:01:52 JST [2012/08/05 0:01:52 ET]
Table 'Whirlpool' 9-max Seat #1 is the button
Seat 1: AndiM64 ($28.15 in chips) 
Seat 2: slapshot2011 ($24.29 in chips) 
Seat 3: deadmoneykid ($25 in chips) 
Seat 4: agurio ($25.35 in chips) 
Seat 5: Anafim ($12.50 in chips) 
Seat 6: chiyuki ($27.11 in chips) 
Seat 7: Medic8681 ($12.60 in chips) 
Seat 8: jamielniak ($25.17 in chips) 
Seat 9: 2997qwer ($9.80 in chips) 
slapshot2011: posts small blind $0.10
deadmoneykid: posts big blind $0.25
*** HOLE CARDS ***
Dealt to chiyuki [4h Jd]
agurio: folds 
Anafim: folds 
chiyuki: folds 
Medic8681: folds 
jamielniak: folds 
2997qwer: raises $0.50 to $0.75
AndiM64: folds 
slapshot2011: folds 
deadmoneykid: folds 
Uncalled bet ($0.50) returned to 2997qwer
2997qwer collected $0.60 from pot
2997qwer: doesn't show hand 
*** SUMMARY ***
Total pot $0.60 | Rake $0 
Seat 1: AndiM64 (button) folded before Flop (didn't bet)
Seat 2: slapshot2011 (small blind) folded before Flop
Seat 3: deadmoneykid (big blind) folded before Flop
Seat 4: agurio folded before Flop (didn't bet)
Seat 5: Anafim folded before Flop (didn't bet)
Seat 6: chiyuki folded before Flop (didn't bet)
Seat 7: Medic8681 folded before Flop (didn't bet)
Seat 8: jamielniak folded before Flop (didn't bet)
Seat 9: 2997qwer collected ($0.60)



PokerStars Zoom Hand #84298226862:  Hold'em No Limit ($0.10/$0.25) - 2012/08/05 13:01:56 JST [2012/08/05 0:01:56 ET]
Table 'Whirlpool' 9-max Seat #1 is the button
Seat 1: TErr18 ($19.99 in chips) 
Seat 2: AUGH-AUGH ($30.92 in chips) 
Seat 3: agurio ($25.35 in chips) 
Seat 4: chiyuki ($27.11 in chips) 
Seat 5: wtu1986 ($25.82 in chips) 
Seat 6: kamikkaze ($40.04 in chips) 
Seat 7: Anafim ($12.50 in chips) 
Seat 8: RomarioJa ($11.31 in chips) 
Seat 9: AndiM64 ($25 in chips) 
AUGH-AUGH: posts small blind $0.10
agurio: posts big blind $0.25
*** HOLE CARDS ***
Dealt to chiyuki [9h Kd]
chiyuki: folds 
wtu1986: folds 
kamikkaze: folds 
Anafim: folds 
RomarioJa: raises $0.37 to $0.62
AndiM64: folds 
TErr18: folds 
AUGH-AUGH: folds 
agurio: folds 
Uncalled bet ($0.37) returned to RomarioJa
RomarioJa collected $0.60 from pot
RomarioJa: doesn't show hand 
*** SUMMARY ***
Total pot $0.60 | Rake $0 
Seat 1: TErr18 (button) folded before Flop (didn't bet)
Seat 2: AUGH-AUGH (small blind) folded before Flop
Seat 3: agurio (big blind) folded before Flop
Seat 4: chiyuki folded before Flop (didn't bet)
Seat 5: wtu1986 folded before Flop (didn't bet)
Seat 6: kamikkaze folded before Flop (didn't bet)
Seat 7: Anafim folded before Flop (didn't bet)
Seat 8: RomarioJa collected ($0.60)
Seat 9: AndiM64 folded before Flop (didn't bet)



PokerStars Zoom Hand #84298231948:  Hold'em No Limit ($0.10/$0.25) - 2012/08/05 13:02:11 JST [2012/08/05 0:02:11 ET]
Table 'Whirlpool' 9-max Seat #1 is the button
Seat 1: nice.franki ($12.35 in chips) 
Seat 2: KeLevro0 ($12.25 in chips) 
Seat 3: Anafim ($12.50 in chips) 
Seat 4: AndiM64 ($25 in chips) 
Seat 5: TErr18 ($19.99 in chips) 
Seat 6: 2997qwer ($10.15 in chips) 
Seat 7: chiyuki ($26.86 in chips) 
Seat 8: Th3Fog ($52.70 in chips) 
Seat 9: agurio ($25.10 in chips) 
KeLevro0: posts small blind $0.10
Anafim: posts big blind $0.25
*** HOLE CARDS ***
Dealt to chiyuki [4s 9d]
AndiM64: folds 
TErr18: folds 
2997qwer: folds 
chiyuki: folds 
Th3Fog: folds 
agurio: folds 
nice.franki: folds 
KeLevro0: folds 
Uncalled bet ($0.15) returned to Anafim
Anafim collected $0.20 from pot
Anafim: doesn't show hand 
*** SUMMARY ***
Total pot $0.20 | Rake $0 
Seat 1: nice.franki (button) folded before Flop (didn't bet)
Seat 2: KeLevro0 (small blind) folded before Flop
Seat 3: Anafim (big blind) collected ($0.20)
Seat 4: AndiM64 folded before Flop (didn't bet)
Seat 5: TErr18 folded before Flop (didn't bet)
Seat 6: 2997qwer folded before Flop (didn't bet)
Seat 7: chiyuki folded before Flop (didn't bet)
Seat 8: Th3Fog folded before Flop (didn't bet)
Seat 9: agurio folded before Flop (didn't bet)



PokerStars Zoom Hand #84298220875:  Hold'em No Limit ($0.10/$0.25) - 2012/08/05 13:01:34 JST [2012/08/05 0:01:34 ET]
Table 'Whirlpool' 9-max Seat #1 is the button
Seat 1: Th3Fog ($61.21 in chips) 
Seat 2: chiyuki ($27.21 in chips) 
Seat 3: wtu1986 ($24.90 in chips) 
Seat 4: KeLevro0 ($12.67 in chips) 
Seat 5: Oswulf ($14.23 in chips) 
Seat 6: MATT361 ($11.60 in chips) 
Seat 7: RomarioJa ($12.66 in chips) 
Seat 8: 2997qwer ($9.80 in chips) 
Seat 9: fwani ($25 in chips) 
chiyuki: posts small blind $0.10
wtu1986: posts big blind $0.25
*** HOLE CARDS ***
Dealt to chiyuki [7c 6c]
KeLevro0: raises $0.42 to $0.67
Oswulf: folds 
MATT361: calls $0.67
RomarioJa: folds 
2997qwer: folds 
fwani: folds 
Th3Fog: calls $0.67
chiyuki: folds 
wtu1986: calls $0.42
*** FLOP *** [4h 9c Qc]
wtu1986: checks 
KeLevro0: checks 
MATT361: bets $1
Th3Fog: folds 
wtu1986: folds 
KeLevro0: folds 
Uncalled bet ($1) returned to MATT361
MATT361 collected $2.65 from pot
MATT361: doesn't show hand 
*** SUMMARY ***
Total pot $2.78 | Rake $0.13 
Board [4h 9c Qc]
Seat 1: Th3Fog (button) folded on the Flop
Seat 2: chiyuki (small blind) folded before Flop
Seat 3: wtu1986 (big blind) folded on the Flop
Seat 4: KeLevro0 folded on the Flop
Seat 5: Oswulf folded before Flop (didn't bet)
Seat 6: MATT361 collected ($2.65)
Seat 7: RomarioJa folded before Flop (didn't bet)
Seat 8: 2997qwer folded before Flop (didn't bet)
Seat 9: fwani folded before Flop (didn't bet)



PokerStars Zoom Hand #84298224070:  Hold'em No Limit ($0.10/$0.25) - 2012/08/05 13:01:46 JST [2012/08/05 0:01:46 ET]
Table 'Whirlpool' 9-max Seat #1 is the button
Seat 1: Assassin365 ($29.88 in chips) 
Seat 2: fwani ($25 in chips) 
Seat 3: BlOnDhOlIc ($34.49 in chips) 
Seat 4: 1474 BigJohn ($30.90 in chips) 
Seat 5: Seadogvcd ($6.34 in chips) 
Seat 6: monst3r4119 ($21.58 in chips) 
Seat 7: adshoshan7 ($22.16 in chips) 
Seat 8: AndiM64 ($30.08 in chips) 
Seat 9: chiyuki ($27.11 in chips) 
fwani: posts small blind $0.10
BlOnDhOlIc: posts big blind $0.25
*** HOLE CARDS ***
Dealt to chiyuki [2d Js]
1474 BigJohn: calls $0.25
Seadogvcd: folds 
monst3r4119: folds 
adshoshan7: folds 
AndiM64: folds 
chiyuki: folds 
Assassin365: folds 
fwani: folds 
BlOnDhOlIc: checks 
*** FLOP *** [5h Qd Ts]
BlOnDhOlIc: bets $0.42
1474 BigJohn: raises $0.42 to $0.84
BlOnDhOlIc: calls $0.42
*** TURN *** [5h Qd Ts] [9d]
BlOnDhOlIc: checks 
1474 BigJohn: bets $0.25
BlOnDhOlIc: calls $0.25
*** RIVER *** [5h Qd Ts 9d] [Kd]
BlOnDhOlIc: checks 
1474 BigJohn: checks 
*** SHOW DOWN ***
BlOnDhOlIc: shows [5s 4c] (a pair of Fives)
1474 BigJohn: shows [Qc 7c] (a pair of Queens)
1474 BigJohn collected $2.65 from pot
*** SUMMARY ***
Total pot $2.78 | Rake $0.13 
Board [5h Qd Ts 9d Kd]
Seat 1: Assassin365 (button) folded before Flop (didn't bet)
Seat 2: fwani (small blind) folded before Flop
Seat 3: BlOnDhOlIc (big blind) showed [5s 4c] and lost with a pair of Fives
Seat 4: 1474 BigJohn showed [Qc 7c] and won ($2.65) with a pair of Queens
Seat 5: Seadogvcd folded before Flop (didn't bet)
Seat 6: monst3r4119 folded before Flop (didn't bet)
Seat 7: adshoshan7 folded before Flop (didn't bet)
Seat 8: AndiM64 folded before Flop (didn't bet)
Seat 9: chiyuki folded before Flop (didn't bet)



PokerStars Zoom Hand #84298228017:  Hold'em No Limit ($0.10/$0.25) - 2012/08/05 13:02:00 JST [2012/08/05 0:02:00 ET]
Table 'Whirlpool' 9-max Seat #1 is the button
Seat 1: slapshot2011 ($24.19 in chips) 
Seat 2: fwani ($27.78 in chips) 
Seat 3: chiyuki ($27.11 in chips) 
Seat 4: puffy5533 ($21.83 in chips) 
Seat 5: kamikkaze ($40.04 in chips) 
Seat 6: Th3Fog ($52.70 in chips) 
Seat 7: softdesign ($44.79 in chips) 
Seat 8: TErr18 ($19.99 in chips) 
Seat 9: DooMSDaY1337 ($37.69 in chips) 
fwani: posts small blind $0.10
chiyuki: posts big blind $0.25
*** HOLE CARDS ***
Dealt to chiyuki [Qc 5s]
puffy5533: raises $0.50 to $0.75
kamikkaze: folds 
Th3Fog: folds 
softdesign: folds 
TErr18: folds 
DooMSDaY1337: folds 
slapshot2011: raises $0.75 to $1.50
fwani: folds 
chiyuki: folds 
puffy5533: calls $0.75
*** FLOP *** [6c 9h 2s]
puffy5533: checks 
slapshot2011: bets $2
puffy5533: calls $2
*** TURN *** [6c 9h 2s] [8h]
puffy5533: checks 
slapshot2011: bets $2
puffy5533: calls $2
*** RIVER *** [6c 9h 2s 8h] [Qd]
puffy5533: checks 
slapshot2011: bets $2.50
puffy5533: calls $2.50
*** SHOW DOWN ***
slapshot2011: shows [Ac Ad] (a pair of Aces)
puffy5533: mucks hand 
slapshot2011 collected $15.61 from pot
*** SUMMARY ***
Total pot $16.35 | Rake $0.74 
Board [6c 9h 2s 8h Qd]
Seat 1: slapshot2011 (button) showed [Ac Ad] and won ($15.61) with a pair of Aces
Seat 2: fwani (small blind) folded before Flop
Seat 3: chiyuki (big blind) folded before Flop
Seat 4: puffy5533 mucked [Jd Js]
Seat 5: kamikkaze folded before Flop (didn't bet)
Seat 6: Th3Fog folded before Flop (didn't bet)
Seat 7: softdesign folded before Flop (didn't bet)
Seat 8: TErr18 folded before Flop (didn't bet)
Seat 9: DooMSDaY1337 folded before Flop (didn't bet)



PokerStars Zoom Hand #84298233877:  Hold'em No Limit ($0.10/$0.25) - 2012/08/05 13:02:18 JST [2012/08/05 0:02:18 ET]
Table 'Whirlpool' 9-max Seat #1 is the button
Seat 1: s9999999 ($22.75 in chips) 
Seat 2: deadmoneykid ($24.75 in chips) 
Seat 3: Seadogvcd ($6.33 in chips) 
Seat 4: chiyuki ($26.86 in chips) 
Seat 5: KrystalAA ($18.26 in chips) 
Seat 6: nice.franki ($4.47 in chips) 
Seat 7: RomarioJa ($11.66 in chips) 
Seat 8: JAMES3FINGER ($336.82 in chips) 
Seat 9: Medic8681 ($12.85 in chips) 
deadmoneykid: posts small blind $0.10
Seadogvcd: posts big blind $0.25
*** HOLE CARDS ***
Dealt to chiyuki [Ac Kd]
chiyuki: raises $0.50 to $0.75
KrystalAA: folds 
nice.franki: folds 
RomarioJa: folds 
JAMES3FINGER: calls $0.75
Medic8681: folds 
s9999999: calls $0.75
deadmoneykid: calls $0.65
Seadogvcd: folds 
*** FLOP *** [3h 5h Ts]
deadmoneykid: checks 
chiyuki: bets $1.75
JAMES3FINGER: calls $1.75
s9999999: folds 
deadmoneykid: folds 
*** TURN *** [3h 5h Ts] [4s]
chiyuki: checks 
JAMES3FINGER: checks 
*** RIVER *** [3h 5h Ts 4s] [2d]
chiyuki: bets $3.25
JAMES3FINGER: calls $3.25
*** SHOW DOWN ***
chiyuki: shows [Ac Kd] (a straight, Ace to Five)
JAMES3FINGER: mucks hand 
chiyuki collected $12.65 from pot
*** SUMMARY ***
Total pot $13.25 | Rake $0.60 
Board [3h 5h Ts 4s 2d]
Seat 1: s9999999 (button) folded on the Flop
Seat 2: deadmoneykid (small blind) folded on the Flop
Seat 3: Seadogvcd (big blind) folded before Flop
Seat 4: chiyuki showed [Ac Kd] and won ($12.65) with a straight, Ace to Five
Seat 5: KrystalAA folded before Flop (didn't bet)
Seat 6: nice.franki folded before Flop (didn't bet)
Seat 7: RomarioJa folded before Flop (didn't bet)
Seat 8: JAMES3FINGER mucked [Td 9d]
Seat 9: Medic8681 folded before Flop (didn't bet)



PokerStars Zoom Hand #84298253915:  Hold'em No Limit ($0.10/$0.25) - 2012/08/05 13:03:29 JST [2012/08/05 0:03:29 ET]
Table 'Whirlpool' 9-max Seat #1 is the button
Seat 1: Th3Fog ($52.70 in chips) 
Seat 2: pyty_82 ($50.84 in chips) 
Seat 3: KrystalAA ($28.90 in chips) 
Seat 4: chiyuki ($33.76 in chips) 
Seat 5: Lasutchik ($26.61 in chips) 
Seat 6: Seadogvcd ($5.74 in chips) 
Seat 7: BlOnDhOlIc ($29.25 in chips) 
Seat 8: Oswulf ($14.23 in chips) 
Seat 9: KeLevro0 ($11.65 in chips) 
pyty_82: posts small blind $0.10
KrystalAA: posts big blind $0.25
*** HOLE CARDS ***
Dealt to chiyuki [5h 9s]
chiyuki: folds 
Lasutchik: folds 
Seadogvcd: raises $0.50 to $0.75
BlOnDhOlIc: folds 
Oswulf: folds 
KeLevro0: folds 
Th3Fog: folds 
pyty_82: folds 
KrystalAA: folds 
Uncalled bet ($0.50) returned to Seadogvcd
Seadogvcd collected $0.60 from pot
Seadogvcd: doesn't show hand 
*** SUMMARY ***
Total pot $0.60 | Rake $0 
Seat 1: Th3Fog (button) folded before Flop (didn't bet)
Seat 2: pyty_82 (small blind) folded before Flop
Seat 3: KrystalAA (big blind) folded before Flop
Seat 4: chiyuki folded before Flop (didn't bet)
Seat 5: Lasutchik folded before Flop (didn't bet)
Seat 6: Seadogvcd collected ($0.60)
Seat 7: BlOnDhOlIc folded before Flop (didn't bet)
Seat 8: Oswulf folded before Flop (didn't bet)
Seat 9: KeLevro0 folded before Flop (didn't bet)



PokerStars Zoom Hand #84298258331:  Hold'em No Limit ($0.10/$0.25) - 2012/08/05 13:03:45 JST [2012/08/05 0:03:45 ET]
Table 'Whirlpool' 9-max Seat #1 is the button
Seat 1: chiyuki ($33.76 in chips) 
Seat 2: BlOnDhOlIc ($25.15 in chips) 
Seat 3: jtedecaliss ($175.79 in chips) 
Seat 4: mid22 ($14.41 in chips) 
Seat 5: Catrban ($23.80 in chips) 
Seat 6: AndiM64 ($26.39 in chips) 
Seat 7: Ring Circus ($21.48 in chips) 
Seat 8: Jippyflip ($21.23 in chips) 
Seat 9: Th3Fog ($52.70 in chips) 
BlOnDhOlIc: posts small blind $0.10
jtedecaliss: posts big blind $0.25
*** HOLE CARDS ***
Dealt to chiyuki [2c 3h]
mid22: folds 
Catrban: folds 
AndiM64: folds 
Ring Circus: folds 
Jippyflip: folds 
Th3Fog: folds 
chiyuki: folds 
BlOnDhOlIc: raises $0.25 to $0.50
jtedecaliss: folds 
Uncalled bet ($0.25) returned to BlOnDhOlIc
BlOnDhOlIc collected $0.50 from pot
BlOnDhOlIc: doesn't show hand 
*** SUMMARY ***
Total pot $0.50 | Rake $0 
Seat 1: chiyuki (button) folded before Flop (didn't bet)
Seat 2: BlOnDhOlIc (small blind) collected ($0.50)
Seat 3: jtedecaliss (big blind) folded before Flop
Seat 4: mid22 folded before Flop (didn't bet)
Seat 5: Catrban folded before Flop (didn't bet)
Seat 6: AndiM64 folded before Flop (didn't bet)
Seat 7: Ring Circus folded before Flop (didn't bet)
Seat 8: Jippyflip folded before Flop (didn't bet)
Seat 9: Th3Fog folded before Flop (didn't bet)



PokerStars Zoom Hand #84298264500:  Hold'em No Limit ($0.10/$0.25) - 2012/08/05 13:04:06 JST [2012/08/05 0:04:06 ET]
Table 'Whirlpool' 9-max Seat #1 is the button
Seat 1: 2997qwer ($13.10 in chips) 
Seat 2: chiyuki ($33.76 in chips) 
Seat 3: Medic8681 ($16.17 in chips) 
Seat 4: a_tasmanian ($59.01 in chips) 
Seat 5: Lasutchik ($26.61 in chips) 
Seat 6: pyty_82 ($50.74 in chips) 
Seat 7: KrystalAA ($17.45 in chips) 
Seat 8: jtedecaliss ($175.54 in chips) 
Seat 9: fwani ($25 in chips) 
chiyuki: posts small blind $0.10
Medic8681: posts big blind $0.25
*** HOLE CARDS ***
Dealt to chiyuki [Qd Tc]
a_tasmanian: folds 
Lasutchik: folds 
pyty_82: folds 
KrystalAA: folds 
jtedecaliss: folds 
fwani: folds 
2997qwer: raises $0.50 to $0.75
chiyuki: folds 
Medic8681: raises $1.50 to $2.25
2997qwer: folds 
Uncalled bet ($1.50) returned to Medic8681
Medic8681 collected $1.60 from pot
Medic8681: doesn't show hand 
*** SUMMARY ***
Total pot $1.60 | Rake $0 
Seat 1: 2997qwer (button) folded before Flop
Seat 2: chiyuki (small blind) folded before Flop
Seat 3: Medic8681 (big blind) collected ($1.60)
Seat 4: a_tasmanian folded before Flop (didn't bet)
Seat 5: Lasutchik folded before Flop (didn't bet)
Seat 6: pyty_82 folded before Flop (didn't bet)
Seat 7: KrystalAA folded before Flop (didn't bet)
Seat 8: jtedecaliss folded before Flop (didn't bet)
Seat 9: fwani folded before Flop (didn't bet)



PokerStars Zoom Hand #84298270203:  Hold'em No Limit ($0.10/$0.25) - 2012/08/05 13:04:25 JST [2012/08/05 0:04:25 ET]
Table 'Whirlpool' 9-max Seat #1 is the button
Seat 1: mollybally1 ($14.65 in chips) 
Seat 2: BlOnDhOlIc ($29 in chips) 
Seat 3: Anafim ($12.50 in chips) 
Seat 4: wtu1986 ($26.38 in chips) 
Seat 5: fwani ($42.02 in chips) 
Seat 6: Loholov ($15 in chips) 
Seat 7: Lasutchik ($10.50 in chips) 
Seat 8: chiyuki ($33.66 in chips) 
Seat 9: KeLevro0 ($16.56 in chips) 
BlOnDhOlIc: posts small blind $0.10
Anafim: posts big blind $0.25
*** HOLE CARDS ***
Dealt to chiyuki [3c Kh]
wtu1986: folds 
fwani: raises $0.35 to $0.60
Loholov: folds 
Lasutchik: folds 
chiyuki: folds 
KeLevro0: folds 
mollybally1: folds 
BlOnDhOlIc: folds 
Anafim: folds 
Uncalled bet ($0.35) returned to fwani
fwani collected $0.60 from pot
fwani: doesn't show hand 
*** SUMMARY ***
Total pot $0.60 | Rake $0 
Seat 1: mollybally1 (button) folded before Flop (didn't bet)
Seat 2: BlOnDhOlIc (small blind) folded before Flop
Seat 3: Anafim (big blind) folded before Flop
Seat 4: wtu1986 folded before Flop (didn't bet)
Seat 5: fwani collected ($0.60)
Seat 6: Loholov folded before Flop (didn't bet)
Seat 7: Lasutchik folded before Flop (didn't bet)
Seat 8: chiyuki folded before Flop (didn't bet)
Seat 9: KeLevro0 folded before Flop (didn't bet)



PokerStars Zoom Hand #84298273067:  Hold'em No Limit ($0.10/$0.25) - 2012/08/05 13:04:35 JST [2012/08/05 0:04:35 ET]
Table 'Whirlpool' 9-max Seat #1 is the button
Seat 1: Ring Circus ($21.48 in chips) 
Seat 2: jethaz ($31.50 in chips) 
Seat 3: chiyuki ($33.66 in chips) 
Seat 4: softdesign ($42.67 in chips) 
Seat 5: Th3Fog ($60.54 in chips) 
Seat 6: a_tasmanian ($59.11 in chips) 
Seat 7: deadmoneykid ($24.30 in chips) 
Seat 8: Jippyflip ($20.88 in chips) 
Seat 9: BlOnDhOlIc ($28.90 in chips) 
jethaz: posts small blind $0.10
chiyuki: posts big blind $0.25
*** HOLE CARDS ***
Dealt to chiyuki [Td Jd]
softdesign: folds 
Th3Fog: folds 
a_tasmanian: raises $0.50 to $0.75
deadmoneykid: folds 
Jippyflip: folds 
BlOnDhOlIc: folds 
Ring Circus: folds 
jethaz: folds 
chiyuki: folds 
Uncalled bet ($0.50) returned to a_tasmanian
a_tasmanian collected $0.60 from pot
a_tasmanian: doesn't show hand 
*** SUMMARY ***
Total pot $0.60 | Rake $0 
Seat 1: Ring Circus (button) folded before Flop (didn't bet)
Seat 2: jethaz (small blind) folded before Flop
Seat 3: chiyuki (big blind) folded before Flop
Seat 4: softdesign folded before Flop (didn't bet)
Seat 5: Th3Fog folded before Flop (didn't bet)
Seat 6: a_tasmanian collected ($0.60)
Seat 7: deadmoneykid folded before Flop (didn't bet)
Seat 8: Jippyflip folded before Flop (didn't bet)
Seat 9: BlOnDhOlIc folded before Flop (didn't bet)



PokerStars Zoom Hand #84298256255:  Hold'em No Limit ($0.10/$0.25) - 2012/08/05 13:03:38 JST [2012/08/05 0:03:38 ET]
Table 'Whirlpool' 9-max Seat #1 is the button
Seat 1: DooMSDaY1337 ($32.64 in chips) 
Seat 2: silvno31 ($47.58 in chips) 
Seat 3: Jene4kaBest ($11.24 in chips) 
Seat 4: AUGH-AUGH ($30.57 in chips) 
Seat 5: slickthis ($23.91 in chips) 
Seat 6: chiyuki ($33.76 in chips) 
Seat 7: Sharks_Nica ($29.13 in chips) 
Seat 8: TraderYao ($24.90 in chips) 
Seat 9: BlOnDhOlIc ($25.15 in chips) 
silvno31: posts small blind $0.10
Jene4kaBest: posts big blind $0.25
*** HOLE CARDS ***
Dealt to chiyuki [Qs Jc]
AUGH-AUGH: folds 
slickthis: calls $0.25
chiyuki: folds 
Sharks_Nica: folds 
TraderYao: raises $1 to $1.25
BlOnDhOlIc: folds 
DooMSDaY1337: folds 
silvno31: folds 
Jene4kaBest: folds 
slickthis: calls $1
*** FLOP *** [2s Jd 4d]
slickthis: bets $1.25
TraderYao: calls $1.25
*** TURN *** [2s Jd 4d] [3h]
slickthis: bets $1.25
TraderYao: calls $1.25
*** RIVER *** [2s Jd 4d 3h] [Qc]
slickthis: bets $2.50
TraderYao: folds 
Uncalled bet ($2.50) returned to slickthis
slickthis collected $7.50 from pot
slickthis: doesn't show hand 
*** SUMMARY ***
Total pot $7.85 | Rake $0.35 
Board [2s Jd 4d 3h Qc]
Seat 1: DooMSDaY1337 (button) folded before Flop (didn't bet)
Seat 2: silvno31 (small blind) folded before Flop
Seat 3: Jene4kaBest (big blind) folded before Flop
Seat 4: AUGH-AUGH folded before Flop (didn't bet)
Seat 5: slickthis collected ($7.50)
Seat 6: chiyuki folded before Flop (didn't bet)
Seat 7: Sharks_Nica folded before Flop (didn't bet)
Seat 8: TraderYao folded on the River
Seat 9: BlOnDhOlIc folded before Flop (didn't bet)



PokerStars Zoom Hand #84298276391:  Hold'em No Limit ($0.10/$0.25) - 2012/08/05 13:04:46 JST [2012/08/05 0:04:46 ET]
Table 'Whirlpool' 9-max Seat #1 is the button
Seat 1: jamielniak ($25 in chips) 
Seat 2: Lab50att ($16.13 in chips) 
Seat 3: s9999999 ($14 in chips) 
Seat 4: deadmoneykid ($24.30 in chips) 
Seat 5: Th3Fog ($60.54 in chips) 
Seat 6: vfo.pt ($10.55 in chips) 
Seat 7: KrystalAA ($35.51 in chips) 
Seat 8: jethaz ($31.40 in chips) 
Seat 9: chiyuki ($33.41 in chips) 
Lab50att: posts small blind $0.10
s9999999: posts big blind $0.25
*** HOLE CARDS ***
Dealt to chiyuki [Qs Ad]
deadmoneykid: folds 
Th3Fog: folds 
vfo.pt: folds 
KrystalAA: folds 
jethaz: folds 
chiyuki: raises $0.50 to $0.75
jamielniak: folds 
Lab50att: folds 
s9999999: folds 
Uncalled bet ($0.50) returned to chiyuki
chiyuki collected $0.60 from pot
chiyuki: doesn't show hand 
*** SUMMARY ***
Total pot $0.60 | Rake $0 
Seat 1: jamielniak (button) folded before Flop (didn't bet)
Seat 2: Lab50att (small blind) folded before Flop
Seat 3: s9999999 (big blind) folded before Flop
Seat 4: deadmoneykid folded before Flop (didn't bet)
Seat 5: Th3Fog folded before Flop (didn't bet)
Seat 6: vfo.pt folded before Flop (didn't bet)
Seat 7: KrystalAA folded before Flop (didn't bet)
Seat 8: jethaz folded before Flop (didn't bet)
Seat 9: chiyuki collected ($0.60)



PokerStars Zoom Hand #84298283831:  Hold'em No Limit ($0.10/$0.25) - 2012/08/05 13:05:12 JST [2012/08/05 0:05:12 ET]
Table 'Whirlpool' 9-max Seat #1 is the button
Seat 1: s9999999 ($13.65 in chips) 
Seat 2: DooMSDaY1337 ($25.10 in chips) 
Seat 3: hassantas ($25 in chips) 
Seat 4: RomarioJa ($10.46 in chips) 
Seat 5: Th3Fog ($22.30 in chips) 
Seat 6: Oswulf ($13.88 in chips) 
Seat 7: Catrban ($23.55 in chips) 
Seat 8: chiyuki ($33.76 in chips) 
Seat 9: jethaz ($72.95 in chips) 
DooMSDaY1337: posts small blind $0.10
hassantas: posts big blind $0.25
*** HOLE CARDS ***
Dealt to chiyuki [Ah 2d]
RomarioJa: folds 
Th3Fog: folds 
Oswulf: folds 
Catrban: folds 
chiyuki: folds 
jethaz: folds 
s9999999: folds 
DooMSDaY1337: raises $0.50 to $0.75
hassantas: folds 
Uncalled bet ($0.50) returned to DooMSDaY1337
DooMSDaY1337 collected $0.50 from pot
DooMSDaY1337: doesn't show hand 
*** SUMMARY ***
Total pot $0.50 | Rake $0 
Seat 1: s9999999 (button) folded before Flop (didn't bet)
Seat 2: DooMSDaY1337 (small blind) collected ($0.50)
Seat 3: hassantas (big blind) folded before Flop
Seat 4: RomarioJa folded before Flop (didn't bet)
Seat 5: Th3Fog folded before Flop (didn't bet)
Seat 6: Oswulf folded before Flop (didn't bet)
Seat 7: Catrban folded before Flop (didn't bet)
Seat 8: chiyuki folded before Flop (didn't bet)
Seat 9: jethaz folded before Flop (didn't bet)



PokerStars Zoom Hand #84298285895:  Hold'em No Limit ($0.10/$0.25) - 2012/08/05 13:05:19 JST [2012/08/05 0:05:19 ET]
Table 'Whirlpool' 9-max Seat #1 is the button
Seat 1: RomarioJa ($10.46 in chips) 
Seat 2: Loholov ($16.12 in chips) 
Seat 3: DooMSDaY1337 ($63.45 in chips) 
Seat 4: Oswulf ($13.88 in chips) 
Seat 5: chiyuki ($33.76 in chips) 
Seat 6: fwani ($42.26 in chips) 
Seat 7: mollybally1 ($14.97 in chips) 
Seat 8: jethaz ($80.72 in chips) 
Seat 9: nice.franki ($7.01 in chips) 
Loholov: posts small blind $0.10
DooMSDaY1337: posts big blind $0.25
*** HOLE CARDS ***
Dealt to chiyuki [Tc 3d]
Oswulf: folds 
chiyuki: folds 
fwani: folds 
mollybally1: folds 
jethaz: folds 
nice.franki: folds 
RomarioJa: folds 
Loholov: folds 
Uncalled bet ($0.15) returned to DooMSDaY1337
DooMSDaY1337 collected $0.20 from pot
DooMSDaY1337: doesn't show hand 
*** SUMMARY ***
Total pot $0.20 | Rake $0 
Seat 1: RomarioJa (button) folded before Flop (didn't bet)
Seat 2: Loholov (small blind) folded before Flop
Seat 3: DooMSDaY1337 (big blind) collected ($0.20)
Seat 4: Oswulf folded before Flop (didn't bet)
Seat 5: chiyuki folded before Flop (didn't bet)
Seat 6: fwani folded before Flop (didn't bet)
Seat 7: mollybally1 folded before Flop (didn't bet)
Seat 8: jethaz folded before Flop (didn't bet)
Seat 9: nice.franki folded before Flop (didn't bet)



PokerStars Zoom Hand #84298282584:  Hold'em No Limit ($0.10/$0.25) - 2012/08/05 13:05:08 JST [2012/08/05 0:05:08 ET]
Table 'Whirlpool' 9-max Seat #1 is the button
Seat 1: TraderYao ($25 in chips) 
Seat 2: jethaz ($34.43 in chips) 
Seat 3: Sharks_Nica ($29.80 in chips) 
Seat 4: DooMSDaY1337 ($63.45 in chips) 
Seat 5: ll_LaMeR_ll ($20.75 in chips) 
Seat 6: KeLevro0 ($11.30 in chips) 
Seat 7: chiyuki ($33.76 in chips) 
Seat 8: Ring Circus ($21.48 in chips) 
Seat 9: seula i ($83.97 in chips) 
jethaz: posts small blind $0.10
Sharks_Nica: posts big blind $0.25
*** HOLE CARDS ***
Dealt to chiyuki [Qs 5c]
DooMSDaY1337: folds 
ll_LaMeR_ll: raises $1 to $1.25
KeLevro0: folds 
chiyuki: folds 
Ring Circus: folds 
seula i: folds 
TraderYao: folds 
jethaz: folds 
Sharks_Nica: raises $2.50 to $3.75
ll_LaMeR_ll: calls $2.50
*** FLOP *** [8s Ad 2h]
Sharks_Nica: bets $3.99
ll_LaMeR_ll: calls $3.99
*** TURN *** [8s Ad 2h] [4d]
Sharks_Nica: checks 
ll_LaMeR_ll: bets $12.94
Sharks_Nica: folds 
Uncalled bet ($12.94) returned to ll_LaMeR_ll
ll_LaMeR_ll collected $14.88 from pot
ll_LaMeR_ll: doesn't show hand 
*** SUMMARY ***
Total pot $15.58 | Rake $0.70 
Board [8s Ad 2h 4d]
Seat 1: TraderYao (button) folded before Flop (didn't bet)
Seat 2: jethaz (small blind) folded before Flop
Seat 3: Sharks_Nica (big blind) folded on the Turn
Seat 4: DooMSDaY1337 folded before Flop (didn't bet)
Seat 5: ll_LaMeR_ll collected ($14.88)
Seat 6: KeLevro0 folded before Flop (didn't bet)
Seat 7: chiyuki folded before Flop (didn't bet)
Seat 8: Ring Circus folded before Flop (didn't bet)
Seat 9: seula i folded before Flop (didn't bet)



PokerStars Zoom Hand #84298287688:  Hold'em No Limit ($0.10/$0.25) - 2012/08/05 13:05:25 JST [2012/08/05 0:05:25 ET]
Table 'Whirlpool' 9-max Seat #1 is the button
Seat 1: chiyuki ($33.76 in chips) 
Seat 2: Alvinpe85 ($26.13 in chips) 
Seat 3: PetitAlejo ($25 in chips) 
Seat 4: fwani ($42.26 in chips) 
Seat 5: monst3r4119 ($24.96 in chips) 
Seat 6: TraderYao ($25.35 in chips) 
Seat 7: nice.franki ($7.01 in chips) 
Seat 8: gunbowler ($88.94 in chips) 
Seat 9: 2997qwer ($11.90 in chips) 
Alvinpe85: posts small blind $0.10
PetitAlejo: posts big blind $0.25
*** HOLE CARDS ***
Dealt to chiyuki [6h 2c]
fwani: folds 
monst3r4119: calls $0.25
TraderYao: raises $1 to $1.25
nice.franki: folds 
gunbowler: calls $1.25
2997qwer: folds 
chiyuki: folds 
Alvinpe85: folds 
PetitAlejo: folds 
monst3r4119: calls $1
*** FLOP *** [4d 8c 8d]
monst3r4119: checks 
TraderYao: checks 
gunbowler: checks 
*** TURN *** [4d 8c 8d] [2s]
monst3r4119: bets $1.75
TraderYao: folds 
gunbowler: folds 
Uncalled bet ($1.75) returned to monst3r4119
monst3r4119 collected $3.92 from pot
monst3r4119: doesn't show hand 
*** SUMMARY ***
Total pot $4.10 | Rake $0.18 
Board [4d 8c 8d 2s]
Seat 1: chiyuki (button) folded before Flop (didn't bet)
Seat 2: Alvinpe85 (small blind) folded before Flop
Seat 3: PetitAlejo (big blind) folded before Flop
Seat 4: fwani folded before Flop (didn't bet)
Seat 5: monst3r4119 collected ($3.92)
Seat 6: TraderYao folded on the Turn
Seat 7: nice.franki folded before Flop (didn't bet)
Seat 8: gunbowler folded on the Turn
Seat 9: 2997qwer folded before Flop (didn't bet)



PokerStars Zoom Hand #84298302758:  Hold'em No Limit ($0.10/$0.25) - 2012/08/05 13:06:17 JST [2012/08/05 0:06:17 ET]
Table 'Whirlpool' 9-max Seat #1 is the button
Seat 1: TankAbbott1 ($28.01 in chips) 
Seat 2: RomarioJa ($12.41 in chips) 
Seat 3: Medic8681 ($14.09 in chips) 
Seat 4: mollybally1 ($14.47 in chips) 
Seat 5: chiyuki ($33.66 in chips) 
Seat 6: KrystalAA ($20.74 in chips) 
Seat 7: TErr18 ($18.29 in chips) 
Seat 8: wtu1986 ($25 in chips) 
Seat 9: 5zzzz33 ($19.05 in chips) 
RomarioJa: posts small blind $0.10
Medic8681: posts big blind $0.25
*** HOLE CARDS ***
Dealt to chiyuki [Tc Qh]
mollybally1: folds 
chiyuki: folds 
KrystalAA: folds 
TErr18: folds 
wtu1986: folds 
5zzzz33: folds 
TankAbbott1: folds 
RomarioJa: folds 
Uncalled bet ($0.15) returned to Medic8681
Medic8681 collected $0.20 from pot
Medic8681: doesn't show hand 
*** SUMMARY ***
Total pot $0.20 | Rake $0 
Seat 1: TankAbbott1 (button) folded before Flop (didn't bet)
Seat 2: RomarioJa (small blind) folded before Flop
Seat 3: Medic8681 (big blind) collected ($0.20)
Seat 4: mollybally1 folded before Flop (didn't bet)
Seat 5: chiyuki folded before Flop (didn't bet)
Seat 6: KrystalAA folded before Flop (didn't bet)
Seat 7: TErr18 folded before Flop (didn't bet)
Seat 8: wtu1986 folded before Flop (didn't bet)
Seat 9: 5zzzz33 folded before Flop (didn't bet)



PokerStars Zoom Hand #84298300671:  Hold'em No Limit ($0.10/$0.25) - 2012/08/05 13:06:10 JST [2012/08/05 0:06:10 ET]
Table 'Whirlpool' 9-max Seat #1 is the button
Seat 1: DooMSDaY1337 ($63.80 in chips) 
Seat 2: Medic8681 ($15.43 in chips) 
Seat 3: deadmoneykid ($25.10 in chips) 
Seat 4: chiyuki ($33.66 in chips) 
Seat 5: masterkoolb ($13.47 in chips) 
Seat 6: pyty_82 ($49.89 in chips) 
Seat 7: Sharks_Nica ($31.52 in chips) 
Seat 8: TraderYao ($25 in chips) 
Seat 9: Loholov ($15.35 in chips) 
Medic8681: posts small blind $0.10
deadmoneykid: posts big blind $0.25
*** HOLE CARDS ***
Dealt to chiyuki [8d 3d]
chiyuki: folds 
masterkoolb: folds 
pyty_82: folds 
Sharks_Nica: folds 
TraderYao: folds 
Loholov: folds 
DooMSDaY1337: raises $0.50 to $0.75
Medic8681: raises $1.50 to $2.25
deadmoneykid: folds 
DooMSDaY1337: calls $1.50
*** FLOP *** [7d Ad 3c]
Medic8681: checks 
DooMSDaY1337: bets $2.27
Medic8681: folds 
Uncalled bet ($2.27) returned to DooMSDaY1337
DooMSDaY1337 collected $4.54 from pot
DooMSDaY1337: doesn't show hand 
*** SUMMARY ***
Total pot $4.75 | Rake $0.21 
Board [7d Ad 3c]
Seat 1: DooMSDaY1337 (button) collected ($4.54)
Seat 2: Medic8681 (small blind) folded on the Flop
Seat 3: deadmoneykid (big blind) folded before Flop
Seat 4: chiyuki folded before Flop (didn't bet)
Seat 5: masterkoolb folded before Flop (didn't bet)
Seat 6: pyty_82 folded before Flop (didn't bet)
Seat 7: Sharks_Nica folded before Flop (didn't bet)
Seat 8: TraderYao folded before Flop (didn't bet)
Seat 9: Loholov folded before Flop (didn't bet)



PokerStars Zoom Hand #84298310382:  Hold'em No Limit ($0.10/$0.25) - 2012/08/05 13:06:43 JST [2012/08/05 0:06:43 ET]
Table 'Whirlpool' 9-max Seat #1 is the button
Seat 1: seula i ($50.52 in chips) 
Seat 2: BlOnDhOlIc ($45.31 in chips) 
Seat 3: Medic8681 ($12.85 in chips) 
Seat 4: silvno31 ($44.48 in chips) 
Seat 5: Jene4kaBest ($9.98 in chips) 
Seat 6: chiyuki ($33.41 in chips) 
Seat 7: s9999999 ($15.30 in chips) 
Seat 8: KrystalAA ($20.74 in chips) 
Seat 9: fwani ($42.01 in chips) 
BlOnDhOlIc: posts small blind $0.10
Medic8681: posts big blind $0.25
*** HOLE CARDS ***
Dealt to chiyuki [Tc 2d]
silvno31: folds 
Jene4kaBest: folds 
chiyuki: folds 
s9999999: folds 
KrystalAA: folds 
fwani: raises $0.35 to $0.60
seula i: folds 
BlOnDhOlIc: folds 
Medic8681: folds 
Uncalled bet ($0.35) returned to fwani
fwani collected $0.60 from pot
fwani: doesn't show hand 
*** SUMMARY ***
Total pot $0.60 | Rake $0 
Seat 1: seula i (button) folded before Flop (didn't bet)
Seat 2: BlOnDhOlIc (small blind) folded before Flop
Seat 3: Medic8681 (big blind) folded before Flop
Seat 4: silvno31 folded before Flop (didn't bet)
Seat 5: Jene4kaBest folded before Flop (didn't bet)
Seat 6: chiyuki folded before Flop (didn't bet)
Seat 7: s9999999 folded before Flop (didn't bet)
Seat 8: KrystalAA folded before Flop (didn't bet)
Seat 9: fwani collected ($0.60)



PokerStars Zoom Hand #84298307140:  Hold'em No Limit ($0.10/$0.25) - 2012/08/05 13:06:32 JST [2012/08/05 0:06:32 ET]
Table 'Whirlpool' 9-max Seat #1 is the button
Seat 1: JAMES3FINGER ($331.92 in chips) 
Seat 2: wtu1986 ($25 in chips) 
Seat 3: TraderYao ($25 in chips) 
Seat 4: jethaz ($52.69 in chips) 
Seat 5: Lasutchik ($26.92 in chips) 
Seat 6: jamielniak ($25 in chips) 
Seat 7: RomarioJa ($12.31 in chips) 
Seat 8: 2997qwer ($11.55 in chips) 
Seat 9: chiyuki ($33.41 in chips) 
wtu1986: posts small blind $0.10
TraderYao: posts big blind $0.25
*** HOLE CARDS ***
Dealt to chiyuki [2s 7d]
jethaz: folds 
Lasutchik: folds 
jamielniak: folds 
RomarioJa: folds 
2997qwer: folds 
chiyuki: folds 
JAMES3FINGER: raises $1 to $1.25
wtu1986: folds 
TraderYao: folds 
Uncalled bet ($1) returned to JAMES3FINGER
JAMES3FINGER collected $0.60 from pot
JAMES3FINGER: doesn't show hand 
*** SUMMARY ***
Total pot $0.60 | Rake $0 
Seat 1: JAMES3FINGER (button) collected ($0.60)
Seat 2: wtu1986 (small blind) folded before Flop
Seat 3: TraderYao (big blind) folded before Flop
Seat 4: jethaz folded before Flop (didn't bet)
Seat 5: Lasutchik folded before Flop (didn't bet)
Seat 6: jamielniak folded before Flop (didn't bet)
Seat 7: RomarioJa folded before Flop (didn't bet)
Seat 8: 2997qwer folded before Flop (didn't bet)
Seat 9: chiyuki folded before Flop (didn't bet)



PokerStars Zoom Hand #84298303906:  Hold'em No Limit ($0.10/$0.25) - 2012/08/05 13:06:21 JST [2012/08/05 0:06:21 ET]
Table 'Whirlpool' 9-max Seat #1 is the button
Seat 1: Loholov ($15 in chips) 
Seat 2: vfo.pt ($8.43 in chips) 
Seat 3: chiyuki ($33.66 in chips) 
Seat 4: TErr18 ($18.29 in chips) 
Seat 5: SlimeyGash ($25 in chips) 
Seat 6: Seadogvcd ($5.81 in chips) 
Seat 7: Catrban ($22.93 in chips) 
Seat 8: jethaz ($52.69 in chips) 
Seat 9: DooMSDaY1337 ($39.78 in chips) 
vfo.pt: posts small blind $0.10
chiyuki: posts big blind $0.25
*** HOLE CARDS ***
Dealt to chiyuki [5d 4c]
TErr18: raises $0.75 to $1
SlimeyGash: folds 
Seadogvcd: folds 
Catrban: folds 
jethaz: folds 
DooMSDaY1337: folds 
Loholov: folds 
vfo.pt: calls $0.90
chiyuki: folds 
*** FLOP *** [4h Jd 5s]
vfo.pt: checks 
TErr18: bets $1.50
vfo.pt: calls $1.50
*** TURN *** [4h Jd 5s] [Kh]
vfo.pt: checks 
TErr18: bets $2.75
vfo.pt: folds 
Uncalled bet ($2.75) returned to TErr18
TErr18 collected $5.01 from pot
TErr18: doesn't show hand 
*** SUMMARY ***
Total pot $5.25 | Rake $0.24 
Board [4h Jd 5s Kh]
Seat 1: Loholov (button) folded before Flop (didn't bet)
Seat 2: vfo.pt (small blind) folded on the Turn
Seat 3: chiyuki (big blind) folded before Flop
Seat 4: TErr18 collected ($5.01)
Seat 5: SlimeyGash folded before Flop (didn't bet)
Seat 6: Seadogvcd folded before Flop (didn't bet)
Seat 7: Catrban folded before Flop (didn't bet)
Seat 8: jethaz folded before Flop (didn't bet)
Seat 9: DooMSDaY1337 folded before Flop (didn't bet)



PokerStars Zoom Hand #84298290059:  Hold'em No Limit ($0.10/$0.25) - 2012/08/05 13:05:33 JST [2012/08/05 0:05:33 ET]
Table 'Whirlpool' 9-max Seat #1 is the button
Seat 1: taksist889 ($24.92 in chips) 
Seat 2: chiyuki ($33.76 in chips) 
Seat 3: DooMSDaY1337 ($40.03 in chips) 
Seat 4: jethaz ($80.72 in chips) 
Seat 5: Assassin365 ($33.20 in chips) 
Seat 6: seula i ($50.87 in chips) 
Seat 7: Seadogvcd ($6.06 in chips) 
Seat 8: Alvinpe85 ($26.03 in chips) 
Seat 9: puffy5533 ($23.43 in chips) 
chiyuki: posts small blind $0.10
DooMSDaY1337: posts big blind $0.25
*** HOLE CARDS ***
Dealt to chiyuki [Ah 5h]
jethaz: folds 
Assassin365: folds 
seula i: folds 
Seadogvcd has timed out
Seadogvcd: folds 
Alvinpe85: raises $0.50 to $0.75
puffy5533: folds 
taksist889: raises $1 to $1.75
chiyuki: folds 
DooMSDaY1337: folds 
Alvinpe85: calls $1
*** FLOP *** [2d 4s Qd]
Alvinpe85: checks 
taksist889: bets $2.25
Alvinpe85: calls $2.25
*** TURN *** [2d 4s Qd] [6c]
Alvinpe85: checks 
taksist889: bets $3.75
Alvinpe85: calls $3.75
*** RIVER *** [2d 4s Qd 6c] [6d]
Alvinpe85: checks 
taksist889: checks 
*** SHOW DOWN ***
Alvinpe85: shows [Jd Qc] (two pair, Queens and Sixes)
taksist889: shows [Ac As] (two pair, Aces and Sixes)
taksist889 collected $15.14 from pot
*** SUMMARY ***
Total pot $15.85 | Rake $0.71 
Board [2d 4s Qd 6c 6d]
Seat 1: taksist889 (button) showed [Ac As] and won ($15.14) with two pair, Aces and Sixes
Seat 2: chiyuki (small blind) folded before Flop
Seat 3: DooMSDaY1337 (big blind) folded before Flop
Seat 4: jethaz folded before Flop (didn't bet)
Seat 5: Assassin365 folded before Flop (didn't bet)
Seat 6: seula i folded before Flop (didn't bet)
Seat 7: Seadogvcd folded before Flop (didn't bet)
Seat 8: Alvinpe85 showed [Jd Qc] and lost with two pair, Queens and Sixes
Seat 9: puffy5533 folded before Flop (didn't bet)



PokerStars Zoom Hand #84298311847:  Hold'em No Limit ($0.10/$0.25) - 2012/08/05 13:06:48 JST [2012/08/05 0:06:48 ET]
Table 'Whirlpool' 9-max Seat #1 is the button
Seat 1: chiyuki ($33.41 in chips) 
Seat 2: simonzez ($27.13 in chips) 
Seat 3: mollybally1 ($12.62 in chips) 
Seat 4: deadmoneykid ($23.95 in chips) 
Seat 5: mikifeio ($33.95 in chips) 
Seat 6: PetitAlejo ($25.35 in chips) 
Seat 7: TErr18 ($22.33 in chips) 
Seat 8: BlOnDhOlIc ($26.62 in chips) 
Seat 9: silvno31 ($44.48 in chips) 
simonzez: posts small blind $0.10
mollybally1: posts big blind $0.25
*** HOLE CARDS ***
Dealt to chiyuki [8c 2h]
deadmoneykid has timed out
deadmoneykid: folds 
mikifeio: folds 
PetitAlejo: folds 
TErr18: folds 
BlOnDhOlIc: folds 
silvno31: folds 
chiyuki: folds 
simonzez: calls $0.15
mollybally1: checks 
*** FLOP *** [Th Qh 7c]
simonzez: bets $0.75
mollybally1: folds 
Uncalled bet ($0.75) returned to simonzez
simonzez collected $0.48 from pot
simonzez: doesn't show hand 
*** SUMMARY ***
Total pot $0.50 | Rake $0.02 
Board [Th Qh 7c]
Seat 1: chiyuki (button) folded before Flop (didn't bet)
Seat 2: simonzez (small blind) collected ($0.48)
Seat 3: mollybally1 (big blind) folded on the Flop
Seat 4: deadmoneykid folded before Flop (didn't bet)
Seat 5: mikifeio folded before Flop (didn't bet)
Seat 6: PetitAlejo folded before Flop (didn't bet)
Seat 7: TErr18 folded before Flop (didn't bet)
Seat 8: BlOnDhOlIc folded before Flop (didn't bet)
Seat 9: silvno31 folded before Flop (didn't bet)



PokerStars Zoom Hand #84298319564:  Hold'em No Limit ($0.10/$0.25) - 2012/08/05 13:07:15 JST [2012/08/05 0:07:15 ET]
Table 'Whirlpool' 9-max Seat #1 is the button
Seat 1: TraderYao ($25 in chips) 
Seat 2: nice.franki ($13.25 in chips) 
Seat 3: fwani ($42.36 in chips) 
Seat 4: seula i ($50.52 in chips) 
Seat 5: TErr18 ($22.33 in chips) 
Seat 6: RomarioJa ($5.55 in chips) 
Seat 7: PetitAlejo ($25.35 in chips) 
Seat 8: AndiM64 ($25.64 in chips) 
Seat 9: chiyuki ($33.41 in chips) 
nice.franki: posts small blind $0.10
fwani: posts big blind $0.25
*** HOLE CARDS ***
Dealt to chiyuki [Qd 9s]
seula i: folds 
TErr18: folds 
RomarioJa: folds 
PetitAlejo: folds 
AndiM64: folds 
chiyuki: folds 
TraderYao: folds 
nice.franki: folds 
Uncalled bet ($0.15) returned to fwani
fwani collected $0.20 from pot
fwani: doesn't show hand 
*** SUMMARY ***
Total pot $0.20 | Rake $0 
Seat 1: TraderYao (button) folded before Flop (didn't bet)
Seat 2: nice.franki (small blind) folded before Flop
Seat 3: fwani (big blind) collected ($0.20)
Seat 4: seula i folded before Flop (didn't bet)
Seat 5: TErr18 folded before Flop (didn't bet)
Seat 6: RomarioJa folded before Flop (didn't bet)
Seat 7: PetitAlejo folded before Flop (didn't bet)
Seat 8: AndiM64 folded before Flop (didn't bet)
Seat 9: chiyuki folded before Flop (didn't bet)



PokerStars Zoom Hand #84298316606:  Hold'em No Limit ($0.10/$0.25) - 2012/08/05 13:07:04 JST [2012/08/05 0:07:04 ET]
Table 'Whirlpool' 9-max Seat #1 is the button
Seat 1: luyifei ($17.68 in chips) 
Seat 2: doanut13 ($23.30 in chips) 
Seat 3: Th3Fog ($61.81 in chips) 
Seat 4: hassantas ($25.35 in chips) 
Seat 5: wtu1986 ($24.90 in chips) 
Seat 6: puffy5533 ($20.68 in chips) 
Seat 7: chiyuki ($33.41 in chips) 
Seat 8: DooMSDaY1337 ($66.09 in chips) 
Seat 9: Zugrug ($25 in chips) 
doanut13: posts small blind $0.10
Th3Fog: posts big blind $0.25
*** HOLE CARDS ***
Dealt to chiyuki [2h Td]
hassantas: folds 
wtu1986: folds 
puffy5533: raises $0.50 to $0.75
chiyuki: folds 
DooMSDaY1337: folds 
Zugrug: calls $0.75
luyifei: raises $2.50 to $3.25
doanut13: folds 
Th3Fog: folds 
puffy5533: folds 
Zugrug: folds 
Uncalled bet ($2.50) returned to luyifei
luyifei collected $2.60 from pot
luyifei: doesn't show hand 
*** SUMMARY ***
Total pot $2.60 | Rake $0 
Seat 1: luyifei (button) collected ($2.60)
Seat 2: doanut13 (small blind) folded before Flop
Seat 3: Th3Fog (big blind) folded before Flop
Seat 4: hassantas folded before Flop (didn't bet)
Seat 5: wtu1986 folded before Flop (didn't bet)
Seat 6: puffy5533 folded before Flop
Seat 7: chiyuki folded before Flop (didn't bet)
Seat 8: DooMSDaY1337 folded before Flop (didn't bet)
Seat 9: Zugrug folded before Flop



PokerStars Zoom Hand #84298313051:  Hold'em No Limit ($0.10/$0.25) - 2012/08/05 13:06:52 JST [2012/08/05 0:06:52 ET]
Table 'Whirlpool' 9-max Seat #1 is the button
Seat 1: cR!Ma*aRm ($24.75 in chips) 
Seat 2: KrystalAA ($20.74 in chips) 
Seat 3: TraderYao ($25.72 in chips) 
Seat 4: s9999999 ($15.30 in chips) 
Seat 5: bigrasbig ($13.13 in chips) 
Seat 6: Jippyflip ($22.57 in chips) 
Seat 7: Jene4kaBest ($9.98 in chips) 
Seat 8: chiyuki ($33.41 in chips) 
Seat 9: TErr18 ($22.33 in chips) 
KrystalAA: posts small blind $0.10
TraderYao: posts big blind $0.25
*** HOLE CARDS ***
Dealt to chiyuki [Js 6h]
s9999999: folds 
bigrasbig: calls $0.25
Jippyflip: folds 
Jene4kaBest: calls $0.25
chiyuki: folds 
TErr18: folds 
cR!Ma*aRm: calls $0.25
KrystalAA: calls $0.15
TraderYao: checks 
*** FLOP *** [7s Qd 6s]
KrystalAA: checks 
TraderYao: checks 
bigrasbig: bets $0.50
Jene4kaBest: folds 
cR!Ma*aRm: calls $0.50
KrystalAA: folds 
TraderYao: calls $0.50
*** TURN *** [7s Qd 6s] [8c]
TraderYao: checks 
bigrasbig: bets $2.25
cR!Ma*aRm: calls $2.25
TraderYao: folds 
*** RIVER *** [7s Qd 6s 8c] [3d]
bigrasbig: bets $3.50
cR!Ma*aRm: calls $3.50
*** SHOW DOWN ***
bigrasbig: shows [Ts 9s] (a straight, Six to Ten)
cR!Ma*aRm: mucks hand 
bigrasbig collected $13.61 from pot
*** SUMMARY ***
Total pot $14.25 | Rake $0.64 
Board [7s Qd 6s 8c 3d]
Seat 1: cR!Ma*aRm (button) mucked [Qs Kd]
Seat 2: KrystalAA (small blind) folded on the Flop
Seat 3: TraderYao (big blind) folded on the Turn
Seat 4: s9999999 folded before Flop (didn't bet)
Seat 5: bigrasbig showed [Ts 9s] and won ($13.61) with a straight, Six to Ten
Seat 6: Jippyflip folded before Flop (didn't bet)
Seat 7: Jene4kaBest folded on the Flop
Seat 8: chiyuki folded before Flop (didn't bet)
Seat 9: TErr18 folded before Flop (didn't bet)



PokerStars Zoom Hand #84298326141:  Hold'em No Limit ($0.10/$0.25) - 2012/08/05 13:07:37 JST [2012/08/05 0:07:37 ET]
Table 'Whirlpool' 9-max Seat #1 is the button
Seat 1: fwani ($42.46 in chips) 
Seat 2: NastyMcNast ($30.82 in chips) 
Seat 3: slapshot2011 ($36.72 in chips) 
Seat 4: nice.franki ($6.66 in chips) 
Seat 5: chiyuki ($33.41 in chips) 
Seat 6: THE_BIG_BOTT ($13.63 in chips) 
Seat 7: agurio ($44.32 in chips) 
Seat 8: Zugrug ($25 in chips) 
Seat 9: Alvinpe85 ($25 in chips) 
NastyMcNast: posts small blind $0.10
slapshot2011: posts big blind $0.25
*** HOLE CARDS ***
Dealt to chiyuki [Ks 6c]
nice.franki: folds 
chiyuki: folds 
THE_BIG_BOTT: raises $0.50 to $0.75
agurio: folds 
Zugrug: folds 
Alvinpe85: folds 
fwani: folds 
NastyMcNast: folds 
slapshot2011: folds 
Uncalled bet ($0.50) returned to THE_BIG_BOTT
THE_BIG_BOTT collected $0.60 from pot
THE_BIG_BOTT: doesn't show hand 
*** SUMMARY ***
Total pot $0.60 | Rake $0 
Seat 1: fwani (button) folded before Flop (didn't bet)
Seat 2: NastyMcNast (small blind) folded before Flop
Seat 3: slapshot2011 (big blind) folded before Flop
Seat 4: nice.franki folded before Flop (didn't bet)
Seat 5: chiyuki folded before Flop (didn't bet)
Seat 6: THE_BIG_BOTT collected ($0.60)
Seat 7: agurio folded before Flop (didn't bet)
Seat 8: Zugrug folded before Flop (didn't bet)
Seat 9: Alvinpe85 folded before Flop (didn't bet)



PokerStars Zoom Hand #84298328181:  Hold'em No Limit ($0.10/$0.25) - 2012/08/05 13:07:44 JST [2012/08/05 0:07:44 ET]
Table 'Whirlpool' 9-max Seat #1 is the button
Seat 1: MibNe ($26.63 in chips) 
Seat 2: fwani ($42.46 in chips) 
Seat 3: chiyuki ($33.41 in chips) 
Seat 4: seula i ($62.45 in chips) 
Seat 5: BlOnDhOlIc ($33.38 in chips) 
Seat 6: deadmoneykid ($21.55 in chips) 
Seat 7: Lab50att ($15.43 in chips) 
Seat 8: jtedecaliss ($180.81 in chips) 
Seat 9: SlimeyGash ($23.50 in chips) 
fwani: posts small blind $0.10
chiyuki: posts big blind $0.25
*** HOLE CARDS ***
Dealt to chiyuki [Th Jh]
seula i: folds 
BlOnDhOlIc: folds 
deadmoneykid: folds 
Lab50att: folds 
jtedecaliss: raises $0.50 to $0.75
SlimeyGash: folds 
MibNe: folds 
fwani: folds 
chiyuki: folds 
Uncalled bet ($0.50) returned to jtedecaliss
jtedecaliss collected $0.60 from pot
jtedecaliss: doesn't show hand 
*** SUMMARY ***
Total pot $0.60 | Rake $0 
Seat 1: MibNe (button) folded before Flop (didn't bet)
Seat 2: fwani (small blind) folded before Flop
Seat 3: chiyuki (big blind) folded before Flop
Seat 4: seula i folded before Flop (didn't bet)
Seat 5: BlOnDhOlIc folded before Flop (didn't bet)
Seat 6: deadmoneykid folded before Flop (didn't bet)
Seat 7: Lab50att folded before Flop (didn't bet)
Seat 8: jtedecaliss collected ($0.60)
Seat 9: SlimeyGash folded before Flop (didn't bet)



PokerStars Zoom Hand #84298322892:  Hold'em No Limit ($0.10/$0.25) - 2012/08/05 13:07:26 JST [2012/08/05 0:07:26 ET]
Table 'Whirlpool' 9-max Seat #1 is the button
Seat 1: doanut13 ($23.20 in chips) 
Seat 2: JAMES3FINGER ($332.27 in chips) 
Seat 3: PetitAlejo ($25 in chips) 
Seat 4: vit 111 ($38.11 in chips) 
Seat 5: Lab50att ($15.68 in chips) 
Seat 6: MATT361 ($12.48 in chips) 
Seat 7: chiyuki ($33.41 in chips) 
Seat 8: Zugrug ($25 in chips) 
Seat 9: KrystalAA ($28.25 in chips) 
JAMES3FINGER: posts small blind $0.10
PetitAlejo: posts big blind $0.25
*** HOLE CARDS ***
Dealt to chiyuki [Kd 7c]
vit 111: calls $0.25
Lab50att: folds 
MATT361: folds 
chiyuki: folds 
Zugrug: folds 
KrystalAA: folds 
doanut13: calls $0.25
JAMES3FINGER: raises $0.50 to $0.75
PetitAlejo: folds 
vit 111: raises $4 to $4.75
doanut13: folds 
JAMES3FINGER: folds 
Uncalled bet ($4) returned to vit 111
vit 111 collected $2 from pot
vit 111: doesn't show hand 
*** SUMMARY ***
Total pot $2 | Rake $0 
Seat 1: doanut13 (button) folded before Flop
Seat 2: JAMES3FINGER (small blind) folded before Flop
Seat 3: PetitAlejo (big blind) folded before Flop
Seat 4: vit 111 collected ($2)
Seat 5: Lab50att folded before Flop (didn't bet)
Seat 6: MATT361 folded before Flop (didn't bet)
Seat 7: chiyuki folded before Flop (didn't bet)
Seat 8: Zugrug folded before Flop (didn't bet)
Seat 9: KrystalAA folded before Flop (didn't bet)



PokerStars Zoom Hand #84298341375:  Hold'em No Limit ($0.10/$0.25) - 2012/08/05 13:08:30 JST [2012/08/05 0:08:30 ET]
Table 'Whirlpool' 9-max Seat #1 is the button
Seat 1: TraderYao ($25 in chips) 
Seat 2: fwani ($25.45 in chips) 
Seat 3: Alvinpe85 ($25 in chips) 
Seat 4: masterkoolb ($12.50 in chips) 
Seat 5: chiyuki ($33.06 in chips) 
Seat 6: Th3Fog ($23.85 in chips) 
Seat 7: RomarioJa ($11.19 in chips) 
Seat 8: DooMSDaY1337 ($32.89 in chips) 
Seat 9: D@vidMed ($22.92 in chips) 
fwani: posts small blind $0.10
Alvinpe85: posts big blind $0.25
*** HOLE CARDS ***
Dealt to chiyuki [9s 5h]
masterkoolb: folds 
chiyuki: folds 
Th3Fog: folds 
RomarioJa: folds 
DooMSDaY1337: folds 
D@vidMed: raises $0.57 to $0.82
TraderYao: folds 
fwani: folds 
Alvinpe85: folds 
Uncalled bet ($0.57) returned to D@vidMed
D@vidMed collected $0.60 from pot
D@vidMed: doesn't show hand 
*** SUMMARY ***
Total pot $0.60 | Rake $0 
Seat 1: TraderYao (button) folded before Flop (didn't bet)
Seat 2: fwani (small blind) folded before Flop
Seat 3: Alvinpe85 (big blind) folded before Flop
Seat 4: masterkoolb folded before Flop (didn't bet)
Seat 5: chiyuki folded before Flop (didn't bet)
Seat 6: Th3Fog folded before Flop (didn't bet)
Seat 7: RomarioJa folded before Flop (didn't bet)
Seat 8: DooMSDaY1337 folded before Flop (didn't bet)
Seat 9: D@vidMed collected ($0.60)



PokerStars Zoom Hand #84298335243:  Hold'em No Limit ($0.10/$0.25) - 2012/08/05 13:08:08 JST [2012/08/05 0:08:08 ET]
Table 'Whirlpool' 9-max Seat #1 is the button
Seat 1: Medic8681 ($13.34 in chips) 
Seat 2: chiyuki ($33.16 in chips) 
Seat 3: THE_BIG_BOTT ($13.88 in chips) 
Seat 4: PetitAlejo ($39.25 in chips) 
Seat 5: DooMSDaY1337 ($34.87 in chips) 
Seat 6: leo2095 ($16.95 in chips) 
Seat 7: Jene4kaBest ($9.38 in chips) 
Seat 8: doanut13 ($22.95 in chips) 
Seat 9: deadmoneykid ($23.70 in chips) 
chiyuki: posts small blind $0.10
THE_BIG_BOTT: posts big blind $0.25
*** HOLE CARDS ***
Dealt to chiyuki [Ac 3c]
PetitAlejo: folds 
DooMSDaY1337: folds 
leo2095: folds 
Jene4kaBest: folds 
doanut13: raises $0.75 to $1
deadmoneykid: folds 
Medic8681: folds 
chiyuki: folds 
THE_BIG_BOTT: calls $0.75
*** FLOP *** [Qh 6s 6h]
THE_BIG_BOTT: checks 
doanut13: checks 
*** TURN *** [Qh 6s 6h] [Ks]
THE_BIG_BOTT: bets $0.50
doanut13: calls $0.50
*** RIVER *** [Qh 6s 6h Ks] [2h]
THE_BIG_BOTT: bets $1
doanut13: raises $1.75 to $2.75
THE_BIG_BOTT: calls $1.75
*** SHOW DOWN ***
doanut13: shows [As 7c] (a pair of Sixes)
THE_BIG_BOTT: shows [Kc 8c] (two pair, Kings and Sixes)
THE_BIG_BOTT collected $8.21 from pot
*** SUMMARY ***
Total pot $8.60 | Rake $0.39 
Board [Qh 6s 6h Ks 2h]
Seat 1: Medic8681 (button) folded before Flop (didn't bet)
Seat 2: chiyuki (small blind) folded before Flop
Seat 3: THE_BIG_BOTT (big blind) showed [Kc 8c] and won ($8.21) with two pair, Kings and Sixes
Seat 4: PetitAlejo folded before Flop (didn't bet)
Seat 5: DooMSDaY1337 folded before Flop (didn't bet)
Seat 6: leo2095 folded before Flop (didn't bet)
Seat 7: Jene4kaBest folded before Flop (didn't bet)
Seat 8: doanut13 showed [As 7c] and lost with a pair of Sixes
Seat 9: deadmoneykid folded before Flop (didn't bet)



PokerStars Zoom Hand #84298340246:  Hold'em No Limit ($0.10/$0.25) - 2012/08/05 13:08:26 JST [2012/08/05 0:08:26 ET]
Table 'Whirlpool' 9-max Seat #1 is the button
Seat 1: BlOnDhOlIc ($25 in chips) 
Seat 2: slapshot2011 ($37.49 in chips) 
Seat 3: TErr18 ($21.98 in chips) 
Seat 4: NastyMcNast ($54.92 in chips) 
Seat 5: Zugrug ($25 in chips) 
Seat 6: chiyuki ($33.06 in chips) 
Seat 7: wtu1986 ($25 in chips) 
Seat 8: RomarioJa ($11.19 in chips) 
Seat 9: ShevchukAI ($13.12 in chips) 
slapshot2011: posts small blind $0.10
TErr18: posts big blind $0.25
*** HOLE CARDS ***
Dealt to chiyuki [Jc 8d]
NastyMcNast: folds 
Zugrug: folds 
chiyuki: folds 
wtu1986: folds 
RomarioJa: folds 
ShevchukAI: folds 
BlOnDhOlIc: folds 
slapshot2011: calls $0.15
TErr18: checks 
*** FLOP *** [Ts As Kd]
slapshot2011: bets $0.75
TErr18: folds 
Uncalled bet ($0.75) returned to slapshot2011
slapshot2011 collected $0.48 from pot
slapshot2011: doesn't show hand 
*** SUMMARY ***
Total pot $0.50 | Rake $0.02 
Board [Ts As Kd]
Seat 1: BlOnDhOlIc (button) folded before Flop (didn't bet)
Seat 2: slapshot2011 (small blind) collected ($0.48)
Seat 3: TErr18 (big blind) folded on the Flop
Seat 4: NastyMcNast folded before Flop (didn't bet)
Seat 5: Zugrug folded before Flop (didn't bet)
Seat 6: chiyuki folded before Flop (didn't bet)
Seat 7: wtu1986 folded before Flop (didn't bet)
Seat 8: RomarioJa folded before Flop (didn't bet)
Seat 9: ShevchukAI folded before Flop (didn't bet)



PokerStars Zoom Hand #84298342245:  Hold'em No Limit ($0.10/$0.25) - 2012/08/05 13:08:33 JST [2012/08/05 0:08:33 ET]
Table 'Whirlpool' 9-max Seat #1 is the button
Seat 1: s9999999 ($13.03 in chips) 
Seat 2: jamielniak ($26.21 in chips) 
Seat 3: DT_Jesus ($30.12 in chips) 
Seat 4: wtu1986 ($26.70 in chips) 
Seat 5: BlOnDhOlIc ($25 in chips) 
Seat 6: RomarioJa ($11.19 in chips) 
Seat 7: PetitAlejo ($25 in chips) 
Seat 8: chiyuki ($33.06 in chips) 
Seat 9: Oswulf ($15.87 in chips) 
jamielniak: posts small blind $0.10
DT_Jesus: posts big blind $0.25
*** HOLE CARDS ***
Dealt to chiyuki [Ts Ad]
wtu1986: folds 
BlOnDhOlIc: folds 
RomarioJa: folds 
PetitAlejo: folds 
chiyuki: raises $0.50 to $0.75
Oswulf: folds 
s9999999: calls $0.75
jamielniak: calls $0.65
DT_Jesus: folds 
*** FLOP *** [5h Qs 9h]
jamielniak: checks 
chiyuki: checks 
s9999999: bets $0.90
jamielniak: folds 
chiyuki: folds 
Uncalled bet ($0.90) returned to s9999999
s9999999 collected $2.39 from pot
s9999999: doesn't show hand 
*** SUMMARY ***
Total pot $2.50 | Rake $0.11 
Board [5h Qs 9h]
Seat 1: s9999999 (button) collected ($2.39)
Seat 2: jamielniak (small blind) folded on the Flop
Seat 3: DT_Jesus (big blind) folded before Flop
Seat 4: wtu1986 folded before Flop (didn't bet)
Seat 5: BlOnDhOlIc folded before Flop (didn't bet)
Seat 6: RomarioJa folded before Flop (didn't bet)
Seat 7: PetitAlejo folded before Flop (didn't bet)
Seat 8: chiyuki folded on the Flop
Seat 9: Oswulf folded before Flop (didn't bet)



PokerStars Zoom Hand #84298351639:  Hold'em No Limit ($0.10/$0.25) - 2012/08/05 13:09:05 JST [2012/08/05 0:09:05 ET]
Table 'Whirlpool' 9-max Seat #1 is the button
Seat 1: chiyuki ($32.31 in chips) 
Seat 2: BlOnDhOlIc ($25.10 in chips) 
Seat 3: masterkoolb ($12.50 in chips) 
Seat 4: KeLevro0 ($10.95 in chips) 
Seat 5: seula i ($84.49 in chips) 
Seat 6: envious_0007 ($16.80 in chips) 
Seat 7: fwani ($25.35 in chips) 
Seat 8: slapshot2011 ($37.72 in chips) 
Seat 9: a_tasmanian ($56.82 in chips) 
BlOnDhOlIc: posts small blind $0.10
masterkoolb: posts big blind $0.25
*** HOLE CARDS ***
Dealt to chiyuki [7h Ks]
KeLevro0: folds 
seula i: folds 
envious_0007: folds 
fwani: folds 
slapshot2011: calls $0.25
a_tasmanian: folds 
chiyuki: folds 
BlOnDhOlIc: folds 
masterkoolb: checks 
*** FLOP *** [Kd Ah 4h]
masterkoolb: checks 
slapshot2011: bets $0.50
masterkoolb: folds 
Uncalled bet ($0.50) returned to slapshot2011
slapshot2011 collected $0.57 from pot
slapshot2011: doesn't show hand 
*** SUMMARY ***
Total pot $0.60 | Rake $0.03 
Board [Kd Ah 4h]
Seat 1: chiyuki (button) folded before Flop (didn't bet)
Seat 2: BlOnDhOlIc (small blind) folded before Flop
Seat 3: masterkoolb (big blind) folded on the Flop
Seat 4: KeLevro0 folded before Flop (didn't bet)
Seat 5: seula i folded before Flop (didn't bet)
Seat 6: envious_0007 folded before Flop (didn't bet)
Seat 7: fwani folded before Flop (didn't bet)
Seat 8: slapshot2011 collected ($0.57)
Seat 9: a_tasmanian folded before Flop (didn't bet)



PokerStars Zoom Hand #84298356094:  Hold'em No Limit ($0.10/$0.25) - 2012/08/05 13:09:20 JST [2012/08/05 0:09:20 ET]
Table 'Whirlpool' 9-max Seat #1 is the button
Seat 1: BlOnDhOlIc ($25 in chips) 
Seat 2: masterkoolb ($13.88 in chips) 
Seat 3: taksist889 ($30.56 in chips) 
Seat 4: chiyuki ($32.31 in chips) 
Seat 5: KeLevro0 ($11.78 in chips) 
Seat 6: Medic8681 ($15.52 in chips) 
Seat 7: TraderYao ($25 in chips) 
Seat 8: Rsonal ($67.45 in chips) 
Seat 9: Loholov ($15 in chips) 
masterkoolb: posts small blind $0.10
taksist889: posts big blind $0.25
*** HOLE CARDS ***
Dealt to chiyuki [7c Jh]
chiyuki: folds 
KeLevro0: raises $0.42 to $0.67
Medic8681: folds 
TraderYao: folds 
Rsonal: folds 
Loholov: folds 
BlOnDhOlIc: folds 
masterkoolb: folds 
taksist889: folds 
Uncalled bet ($0.42) returned to KeLevro0
KeLevro0 collected $0.60 from pot
KeLevro0: doesn't show hand 
*** SUMMARY ***
Total pot $0.60 | Rake $0 
Seat 1: BlOnDhOlIc (button) folded before Flop (didn't bet)
Seat 2: masterkoolb (small blind) folded before Flop
Seat 3: taksist889 (big blind) folded before Flop
Seat 4: chiyuki folded before Flop (didn't bet)
Seat 5: KeLevro0 collected ($0.60)
Seat 6: Medic8681 folded before Flop (didn't bet)
Seat 7: TraderYao folded before Flop (didn't bet)
Seat 8: Rsonal folded before Flop (didn't bet)
Seat 9: Loholov folded before Flop (didn't bet)



PokerStars Zoom Hand #84298357260:  Hold'em No Limit ($0.10/$0.25) - 2012/08/05 13:09:24 JST [2012/08/05 0:09:24 ET]
Table 'Whirlpool' 9-max Seat #1 is the button
Seat 1: KINGKILERACE ($42.34 in chips) 
Seat 2: ll_LaMeR_ll ($39.60 in chips) 
Seat 3: pyty_82 ($57.49 in chips) 
Seat 4: fwani ($31.93 in chips) 
Seat 5: PetitAlejo ($40.62 in chips) 
Seat 6: chiyuki ($32.31 in chips) 
Seat 7: hassantas ($25 in chips) 
Seat 8: NastyMcNast ($30.97 in chips) 
Seat 9: KeLevro0 ($12.15 in chips) 
ll_LaMeR_ll: posts small blind $0.10
pyty_82: posts big blind $0.25
*** HOLE CARDS ***
Dealt to chiyuki [Qd Kc]
fwani: folds 
PetitAlejo: folds 
chiyuki: raises $0.50 to $0.75
hassantas: folds 
NastyMcNast: folds 
KeLevro0: folds 
KINGKILERACE: folds 
ll_LaMeR_ll: folds 
pyty_82: folds 
Uncalled bet ($0.50) returned to chiyuki
chiyuki collected $0.60 from pot
chiyuki: doesn't show hand 
*** SUMMARY ***
Total pot $0.60 | Rake $0 
Seat 1: KINGKILERACE (button) folded before Flop (didn't bet)
Seat 2: ll_LaMeR_ll (small blind) folded before Flop
Seat 3: pyty_82 (big blind) folded before Flop
Seat 4: fwani folded before Flop (didn't bet)
Seat 5: PetitAlejo folded before Flop (didn't bet)
Seat 6: chiyuki collected ($0.60)
Seat 7: hassantas folded before Flop (didn't bet)
Seat 8: NastyMcNast folded before Flop (didn't bet)
Seat 9: KeLevro0 folded before Flop (didn't bet)



PokerStars Zoom Hand #84298361016:  Hold'em No Limit ($0.10/$0.25) - 2012/08/05 13:09:38 JST [2012/08/05 0:09:38 ET]
Table 'Whirlpool' 9-max Seat #1 is the button
Seat 1: PetitAlejo ($25 in chips) 
Seat 2: chiyuki ($32.66 in chips) 
Seat 3: 2997qwer ($15.32 in chips) 
Seat 4: seula i ($84.24 in chips) 
Seat 5: luyifei ($21.43 in chips) 
Seat 6: jamielniak ($26.18 in chips) 
Seat 7: DanyArdaggo ($24.30 in chips) 
Seat 8: KeLevro0 ($12.13 in chips) 
Seat 9: petersmiths ($31.68 in chips) 
chiyuki: posts small blind $0.10
2997qwer: posts big blind $0.25
*** HOLE CARDS ***
Dealt to chiyuki [Th 9h]
seula i: folds 
luyifei: raises $0.50 to $0.75
jamielniak: calls $0.75
DanyArdaggo: folds 
KeLevro0: folds 
petersmiths: folds 
PetitAlejo: calls $0.75
chiyuki: folds 
2997qwer: folds 
*** FLOP *** [Js Qc 2h]
luyifei: bets $0.75
jamielniak: folds 
PetitAlejo: folds 
Uncalled bet ($0.75) returned to luyifei
luyifei collected $2.48 from pot
luyifei: doesn't show hand 
*** SUMMARY ***
Total pot $2.60 | Rake $0.12 
Board [Js Qc 2h]
Seat 1: PetitAlejo (button) folded on the Flop
Seat 2: chiyuki (small blind) folded before Flop
Seat 3: 2997qwer (big blind) folded before Flop
Seat 4: seula i folded before Flop (didn't bet)
Seat 5: luyifei collected ($2.48)
Seat 6: jamielniak folded on the Flop
Seat 7: DanyArdaggo folded before Flop (didn't bet)
Seat 8: KeLevro0 folded before Flop (didn't bet)
Seat 9: petersmiths folded before Flop (didn't bet)



PokerStars Zoom Hand #84298363398:  Hold'em No Limit ($0.10/$0.25) - 2012/08/05 13:09:46 JST [2012/08/05 0:09:46 ET]
Table 'Whirlpool' 9-max Seat #1 is the button
Seat 1: KeLevro0 ($12.03 in chips) 
Seat 2: BlOnDhOlIc ($36.98 in chips) 
Seat 3: chiyuki ($32.56 in chips) 
Seat 4: RomarioJa ($11.74 in chips) 
Seat 5: nice.franki ($7.47 in chips) 
Seat 6: SlimeyGash ($22.65 in chips) 
Seat 7: Zugrug ($25 in chips) 
Seat 8: THE_BIG_BOTT ($13.09 in chips) 
Seat 9: KrystalAA ($14.59 in chips) 
BlOnDhOlIc: posts small blind $0.10
chiyuki: posts big blind $0.25
*** HOLE CARDS ***
Dealt to chiyuki [8c 8h]
RomarioJa: folds 
nice.franki: folds 
SlimeyGash: raises $0.50 to $0.75
Zugrug: folds 
THE_BIG_BOTT: raises $12.34 to $13.09 and is all-in
KrystalAA: folds 
KeLevro0: folds 
BlOnDhOlIc: folds 
chiyuki: folds 
SlimeyGash: folds 
Uncalled bet ($12.34) returned to THE_BIG_BOTT
THE_BIG_BOTT collected $1.85 from pot
THE_BIG_BOTT: doesn't show hand 
*** SUMMARY ***
Total pot $1.85 | Rake $0 
Seat 1: KeLevro0 (button) folded before Flop (didn't bet)
Seat 2: BlOnDhOlIc (small blind) folded before Flop
Seat 3: chiyuki (big blind) folded before Flop
Seat 4: RomarioJa folded before Flop (didn't bet)
Seat 5: nice.franki folded before Flop (didn't bet)
Seat 6: SlimeyGash folded before Flop
Seat 7: Zugrug folded before Flop (didn't bet)
Seat 8: THE_BIG_BOTT collected ($1.85)
Seat 9: KrystalAA folded before Flop (didn't bet)



PokerStars Zoom Hand #84298373570:  Hold'em No Limit ($0.10/$0.25) - 2012/08/05 13:10:21 JST [2012/08/05 0:10:21 ET]
Table 'Whirlpool' 9-max Seat #1 is the button
Seat 1: Loholov ($15 in chips) 
Seat 2: Th3Fog ($23.95 in chips) 
Seat 3: wtu1986 ($25.21 in chips) 
Seat 4: mikifeio ($30.95 in chips) 
Seat 5: THE_BIG_BOTT ($14.19 in chips) 
Seat 6: Roglus ($22.29 in chips) 
Seat 7: 2997qwer ($11.45 in chips) 
Seat 8: nice.franki ($13.30 in chips) 
Seat 9: chiyuki ($32.31 in chips) 
Th3Fog: posts small blind $0.10
wtu1986: posts big blind $0.25
*** HOLE CARDS ***
Dealt to chiyuki [Js 8c]
mikifeio: folds 
THE_BIG_BOTT: folds 
Roglus: folds 
2997qwer: folds 
nice.franki: folds 
chiyuki: folds 
Loholov: folds 
Th3Fog: folds 
Uncalled bet ($0.15) returned to wtu1986
wtu1986 collected $0.20 from pot
wtu1986: doesn't show hand 
*** SUMMARY ***
Total pot $0.20 | Rake $0 
Seat 1: Loholov (button) folded before Flop (didn't bet)
Seat 2: Th3Fog (small blind) folded before Flop
Seat 3: wtu1986 (big blind) collected ($0.20)
Seat 4: mikifeio folded before Flop (didn't bet)
Seat 5: THE_BIG_BOTT folded before Flop (didn't bet)
Seat 6: Roglus folded before Flop (didn't bet)
Seat 7: 2997qwer folded before Flop (didn't bet)
Seat 8: nice.franki folded before Flop (didn't bet)
Seat 9: chiyuki folded before Flop (didn't bet)



PokerStars Zoom Hand #84298375105:  Hold'em No Limit ($0.10/$0.25) - 2012/08/05 13:10:26 JST [2012/08/05 0:10:26 ET]
Table 'Whirlpool' 9-max Seat #1 is the button
Seat 1: seula i ($63.47 in chips) 
Seat 2: KrystalAA ($18.44 in chips) 
Seat 3: SlimeyGash ($21.90 in chips) 
Seat 4: KeLevro0 ($12.03 in chips) 
Seat 5: gunbowler ($92.81 in chips) 
Seat 6: mikifeio ($30.95 in chips) 
Seat 7: chiyuki ($32.31 in chips) 
Seat 8: BlOnDhOlIc ($37.23 in chips) 
Seat 9: cR!Ma*aRm ($18.13 in chips) 
KrystalAA: posts small blind $0.10
SlimeyGash: posts big blind $0.25
*** HOLE CARDS ***
Dealt to chiyuki [As 7c]
KeLevro0: folds 
gunbowler: folds 
mikifeio: folds 
chiyuki: folds 
BlOnDhOlIc: folds 
cR!Ma*aRm: folds 
seula i: raises $0.25 to $0.50
KrystalAA: folds 
SlimeyGash: folds 
Uncalled bet ($0.25) returned to seula i
seula i collected $0.60 from pot
seula i: doesn't show hand 
*** SUMMARY ***
Total pot $0.60 | Rake $0 
Seat 1: seula i (button) collected ($0.60)
Seat 2: KrystalAA (small blind) folded before Flop
Seat 3: SlimeyGash (big blind) folded before Flop
Seat 4: KeLevro0 folded before Flop (didn't bet)
Seat 5: gunbowler folded before Flop (didn't bet)
Seat 6: mikifeio folded before Flop (didn't bet)
Seat 7: chiyuki folded before Flop (didn't bet)
Seat 8: BlOnDhOlIc folded before Flop (didn't bet)
Seat 9: cR!Ma*aRm folded before Flop (didn't bet)



PokerStars Zoom Hand #84298377737:  Hold'em No Limit ($0.10/$0.25) - 2012/08/05 13:10:35 JST [2012/08/05 0:10:35 ET]
Table 'Whirlpool' 9-max Seat #1 is the button
Seat 1: BlOnDhOlIc ($25.35 in chips) 
Seat 2: Loholov ($15 in chips) 
Seat 3: deadmoneykid ($25.09 in chips) 
Seat 4: RomarioJa ($10.82 in chips) 
Seat 5: PetitAlejo ($25 in chips) 
Seat 6: pyty_82 ($57.24 in chips) 
Seat 7: seula i ($79.99 in chips) 
Seat 8: chiyuki ($32.31 in chips) 
Seat 9: 2997qwer ($14.97 in chips) 
Loholov: posts small blind $0.10
deadmoneykid: posts big blind $0.25
*** HOLE CARDS ***
Dealt to chiyuki [Ts Th]
RomarioJa: folds 
PetitAlejo: folds 
pyty_82: folds 
seula i: folds 
chiyuki: raises $0.50 to $0.75
2997qwer: folds 
BlOnDhOlIc: folds 
Loholov: folds 
deadmoneykid: folds 
Uncalled bet ($0.50) returned to chiyuki
chiyuki collected $0.60 from pot
chiyuki: doesn't show hand 
*** SUMMARY ***
Total pot $0.60 | Rake $0 
Seat 1: BlOnDhOlIc (button) folded before Flop (didn't bet)
Seat 2: Loholov (small blind) folded before Flop
Seat 3: deadmoneykid (big blind) folded before Flop
Seat 4: RomarioJa folded before Flop (didn't bet)
Seat 5: PetitAlejo folded before Flop (didn't bet)
Seat 6: pyty_82 folded before Flop (didn't bet)
Seat 7: seula i folded before Flop (didn't bet)
Seat 8: chiyuki collected ($0.60)
Seat 9: 2997qwer folded before Flop (didn't bet)



PokerStars Zoom Hand #84298385031:  Hold'em No Limit ($0.10/$0.25) - 2012/08/05 13:11:01 JST [2012/08/05 0:11:01 ET]
Table 'Whirlpool' 9-max Seat #1 is the button
Seat 1: jtedecaliss ($181.38 in chips) 
Seat 2: Zugrug ($25.10 in chips) 
Seat 3: seula i ($26.28 in chips) 
Seat 4: nice.franki ($7.37 in chips) 
Seat 5: chiyuki ($32.66 in chips) 
Seat 6: Oswulf ($15.42 in chips) 
Seat 7: NastyMcNast ($28.72 in chips) 
Seat 8: PetitAlejo ($40.97 in chips) 
Seat 9: BlOnDhOlIc ($37.33 in chips) 
Zugrug: posts small blind $0.10
seula i: posts big blind $0.25
*** HOLE CARDS ***
Dealt to chiyuki [9h Qh]
nice.franki: folds 
chiyuki: folds 
Oswulf: folds 
NastyMcNast: folds 
PetitAlejo: folds 
BlOnDhOlIc: folds 
jtedecaliss: folds 
Zugrug: folds 
Uncalled bet ($0.15) returned to seula i
seula i collected $0.20 from pot
seula i: doesn't show hand 
*** SUMMARY ***
Total pot $0.20 | Rake $0 
Seat 1: jtedecaliss (button) folded before Flop (didn't bet)
Seat 2: Zugrug (small blind) folded before Flop
Seat 3: seula i (big blind) collected ($0.20)
Seat 4: nice.franki folded before Flop (didn't bet)
Seat 5: chiyuki folded before Flop (didn't bet)
Seat 6: Oswulf folded before Flop (didn't bet)
Seat 7: NastyMcNast folded before Flop (didn't bet)
Seat 8: PetitAlejo folded before Flop (didn't bet)
Seat 9: BlOnDhOlIc folded before Flop (didn't bet)



PokerStars Zoom Hand #84298386209:  Hold'em No Limit ($0.10/$0.25) - 2012/08/05 13:11:05 JST [2012/08/05 0:11:05 ET]
Table 'Whirlpool' 9-max Seat #1 is the button
Seat 1: chiyuki ($32.66 in chips) 
Seat 2: wtu1986 ($25.31 in chips) 
Seat 3: Oswulf ($15.42 in chips) 
Seat 4: 2997qwer ($11.45 in chips) 
Seat 5: KeLevro0 ($11.78 in chips) 
Seat 6: jtedecaliss ($181.38 in chips) 
Seat 7: PetitAlejo ($40.97 in chips) 
Seat 8: Medic8681 ($14.02 in chips) 
Seat 9: TraderYao ($25 in chips) 
wtu1986: posts small blind $0.10
Oswulf: posts big blind $0.25
*** HOLE CARDS ***
Dealt to chiyuki [7s 9h]
2997qwer: folds 
KeLevro0: folds 
jtedecaliss: folds 
PetitAlejo: folds 
Medic8681: folds 
TraderYao: folds 
chiyuki: folds 
wtu1986: folds 
Uncalled bet ($0.15) returned to Oswulf
Oswulf collected $0.20 from pot
Oswulf: doesn't show hand 
*** SUMMARY ***
Total pot $0.20 | Rake $0 
Seat 1: chiyuki (button) folded before Flop (didn't bet)
Seat 2: wtu1986 (small blind) folded before Flop
Seat 3: Oswulf (big blind) collected ($0.20)
Seat 4: 2997qwer folded before Flop (didn't bet)
Seat 5: KeLevro0 folded before Flop (didn't bet)
Seat 6: jtedecaliss folded before Flop (didn't bet)
Seat 7: PetitAlejo folded before Flop (didn't bet)
Seat 8: Medic8681 folded before Flop (didn't bet)
Seat 9: TraderYao folded before Flop (didn't bet)



PokerStars Zoom Hand #84298387974:  Hold'em No Limit ($0.10/$0.25) - 2012/08/05 13:11:11 JST [2012/08/05 0:11:11 ET]
Table 'Whirlpool' 9-max Seat #1 is the button
Seat 1: JAMES3FINGER ($317.30 in chips) 
Seat 2: KeLevro0 ($11.78 in chips) 
Seat 3: silvno31 ($14.74 in chips) 
Seat 4: chiyuki ($32.66 in chips) 
Seat 5: DooMSDaY1337 ($52.49 in chips) 
Seat 6: Medic8681 ($14.02 in chips) 
Seat 7: THE_BIG_BOTT ($16.01 in chips) 
Seat 8: Zugrug ($26.49 in chips) 
Seat 9: NastyMcNast ($28.72 in chips) 
KeLevro0: posts small blind $0.10
silvno31: posts big blind $0.25
*** HOLE CARDS ***
Dealt to chiyuki [8c Th]
chiyuki: folds 
DooMSDaY1337: folds 
Medic8681: folds 
THE_BIG_BOTT: folds 
Zugrug: folds 
NastyMcNast: folds 
JAMES3FINGER: folds 
KeLevro0: folds 
Uncalled bet ($0.15) returned to silvno31
silvno31 collected $0.20 from pot
silvno31: doesn't show hand 
*** SUMMARY ***
Total pot $0.20 | Rake $0 
Seat 1: JAMES3FINGER (button) folded before Flop (didn't bet)
Seat 2: KeLevro0 (small blind) folded before Flop
Seat 3: silvno31 (big blind) collected ($0.20)
Seat 4: chiyuki folded before Flop (didn't bet)
Seat 5: DooMSDaY1337 folded before Flop (didn't bet)
Seat 6: Medic8681 folded before Flop (didn't bet)
Seat 7: THE_BIG_BOTT folded before Flop (didn't bet)
Seat 8: Zugrug folded before Flop (didn't bet)
Seat 9: NastyMcNast folded before Flop (didn't bet)



PokerStars Zoom Hand #84298389083:  Hold'em No Limit ($0.10/$0.25) - 2012/08/05 13:11:15 JST [2012/08/05 0:11:15 ET]
Table 'Whirlpool' 9-max Seat #1 is the button
Seat 1: mikifeio ($30.95 in chips) 
Seat 2: chiyuki ($32.66 in chips) 
Seat 3: 2997qwer ($11.45 in chips) 
Seat 4: RomarioJa ($12.25 in chips) 
Seat 5: pyty_82 ($57.59 in chips) 
Seat 6: THE_BIG_BOTT ($16.01 in chips) 
Seat 7: leo2095 ($19.40 in chips) 
Seat 8: KeLevro0 ($11.68 in chips) 
Seat 9: JAMES3FINGER ($317.30 in chips) 
chiyuki: posts small blind $0.10
2997qwer: posts big blind $0.25
*** HOLE CARDS ***
Dealt to chiyuki [6c As]
RomarioJa: folds 
pyty_82: folds 
THE_BIG_BOTT: folds 
leo2095: folds 
KeLevro0: folds 
JAMES3FINGER: folds 
mikifeio: folds 
chiyuki: raises $0.50 to $0.75
2997qwer: folds 
Uncalled bet ($0.50) returned to chiyuki
chiyuki collected $0.50 from pot
chiyuki: doesn't show hand 
*** SUMMARY ***
Total pot $0.50 | Rake $0 
Seat 1: mikifeio (button) folded before Flop (didn't bet)
Seat 2: chiyuki (small blind) collected ($0.50)
Seat 3: 2997qwer (big blind) folded before Flop
Seat 4: RomarioJa folded before Flop (didn't bet)
Seat 5: pyty_82 folded before Flop (didn't bet)
Seat 6: THE_BIG_BOTT folded before Flop (didn't bet)
Seat 7: leo2095 folded before Flop (didn't bet)
Seat 8: KeLevro0 folded before Flop (didn't bet)
Seat 9: JAMES3FINGER folded before Flop (didn't bet)



PokerStars Zoom Hand #84298395389:  Hold'em No Limit ($0.10/$0.25) - 2012/08/05 13:11:37 JST [2012/08/05 0:11:37 ET]
Table 'Whirlpool' 9-max Seat #1 is the button
Seat 1: Zugrug ($25 in chips) 
Seat 2: TankAbbott1 ($26.37 in chips) 
Seat 3: TraderYao ($24.90 in chips) 
Seat 4: a_tasmanian ($54.82 in chips) 
Seat 5: BlOnDhOlIc ($25 in chips) 
Seat 6: chiyuki ($32.91 in chips) 
Seat 7: Medic8681 ($12.50 in chips) 
Seat 8: kamikkaze ($45.15 in chips) 
Seat 9: polk11 ($24.15 in chips) 
TankAbbott1: posts small blind $0.10
TraderYao: posts big blind $0.25
*** HOLE CARDS ***
Dealt to chiyuki [9s Qc]
a_tasmanian: folds 
BlOnDhOlIc: folds 
chiyuki: folds 
Medic8681: folds 
kamikkaze: folds 
polk11: folds 
Zugrug: folds 
TankAbbott1: folds 
Uncalled bet ($0.15) returned to TraderYao
TraderYao collected $0.20 from pot
TraderYao: doesn't show hand 
*** SUMMARY ***
Total pot $0.20 | Rake $0 
Seat 1: Zugrug (button) folded before Flop (didn't bet)
Seat 2: TankAbbott1 (small blind) folded before Flop
Seat 3: TraderYao (big blind) collected ($0.20)
Seat 4: a_tasmanian folded before Flop (didn't bet)
Seat 5: BlOnDhOlIc folded before Flop (didn't bet)
Seat 6: chiyuki folded before Flop (didn't bet)
Seat 7: Medic8681 folded before Flop (didn't bet)
Seat 8: kamikkaze folded before Flop (didn't bet)
Seat 9: polk11 folded before Flop (didn't bet)



PokerStars Zoom Hand #84298397134:  Hold'em No Limit ($0.10/$0.25) - 2012/08/05 13:11:43 JST [2012/08/05 0:11:43 ET]
Table 'Whirlpool' 9-max Seat #1 is the button
Seat 1: RomarioJa ($12.25 in chips) 
Seat 2: DooMSDaY1337 ($37.22 in chips) 
Seat 3: chiyuki ($32.91 in chips) 
Seat 4: nice.franki ($7.47 in chips) 
Seat 5: TraderYao ($25 in chips) 
Seat 6: MATT361 ($13.58 in chips) 
Seat 7: Medic8681 ($12.75 in chips) 
Seat 8: wtu1986 ($24.59 in chips) 
Seat 9: Loholov ($15 in chips) 
DooMSDaY1337: posts small blind $0.10
chiyuki: posts big blind $0.25
*** HOLE CARDS ***
Dealt to chiyuki [9h 2d]
nice.franki: folds 
TraderYao: folds 
MATT361: folds 
Medic8681: folds 
wtu1986: raises $0.50 to $0.75
Loholov: folds 
RomarioJa: folds 
DooMSDaY1337: folds 
chiyuki: folds 
Uncalled bet ($0.50) returned to wtu1986
wtu1986 collected $0.60 from pot
wtu1986: doesn't show hand 
*** SUMMARY ***
Total pot $0.60 | Rake $0 
Seat 1: RomarioJa (button) folded before Flop (didn't bet)
Seat 2: DooMSDaY1337 (small blind) folded before Flop
Seat 3: chiyuki (big blind) folded before Flop
Seat 4: nice.franki folded before Flop (didn't bet)
Seat 5: TraderYao folded before Flop (didn't bet)
Seat 6: MATT361 folded before Flop (didn't bet)
Seat 7: Medic8681 folded before Flop (didn't bet)
Seat 8: wtu1986 collected ($0.60)
Seat 9: Loholov folded before Flop (didn't bet)



PokerStars Zoom Hand #84298405566:  Hold'em No Limit ($0.10/$0.25) - 2012/08/05 13:12:13 JST [2012/08/05 0:12:13 ET]
Table 'Whirlpool' 9-max Seat #1 is the button
Seat 1: DooMSDaY1337 ($36.87 in chips) 
Seat 2: ll_LaMeR_ll ($35.25 in chips) 
Seat 3: bigrasbig ($19.52 in chips) 
Seat 4: JAMES3FINGER ($315.30 in chips) 
Seat 5: Th3Fog ($55.18 in chips) 
Seat 6: PetitAlejo ($25.35 in chips) 
Seat 7: chiyuki ($32.66 in chips) 
Seat 8: D@vidMed ($30.45 in chips) 
Seat 9: nice.franki ($7.37 in chips) 
ll_LaMeR_ll: posts small blind $0.10
bigrasbig: posts big blind $0.25
*** HOLE CARDS ***
Dealt to chiyuki [2c 6c]
JAMES3FINGER: calls $0.25
Th3Fog: folds 
PetitAlejo: folds 
chiyuki: folds 
D@vidMed: folds 
nice.franki: folds 
DooMSDaY1337: folds 
ll_LaMeR_ll: folds 
bigrasbig: checks 
*** FLOP *** [8h 4s 7s]
bigrasbig: bets $0.50
JAMES3FINGER: raises $1 to $1.50
bigrasbig: raises $17.77 to $19.27 and is all-in
JAMES3FINGER: calls $17.77
*** TURN *** [8h 4s 7s] [5s]
*** RIVER *** [8h 4s 7s 5s] [2h]
*** SHOW DOWN ***
bigrasbig: shows [7d 4d] (two pair, Sevens and Fours)
JAMES3FINGER: shows [Kc Ks] (a pair of Kings)
bigrasbig collected $37.38 from pot
*** SUMMARY ***
Total pot $39.14 | Rake $1.76 
Board [8h 4s 7s 5s 2h]
Seat 1: DooMSDaY1337 (button) folded before Flop (didn't bet)
Seat 2: ll_LaMeR_ll (small blind) folded before Flop
Seat 3: bigrasbig (big blind) showed [7d 4d] and won ($37.38) with two pair, Sevens and Fours
Seat 4: JAMES3FINGER showed [Kc Ks] and lost with a pair of Kings
Seat 5: Th3Fog folded before Flop (didn't bet)
Seat 6: PetitAlejo folded before Flop (didn't bet)
Seat 7: chiyuki folded before Flop (didn't bet)
Seat 8: D@vidMed folded before Flop (didn't bet)
Seat 9: nice.franki folded before Flop (didn't bet)



PokerStars Zoom Hand #84298407087:  Hold'em No Limit ($0.10/$0.25) - 2012/08/05 13:12:18 JST [2012/08/05 0:12:18 ET]
Table 'Whirlpool' 9-max Seat #1 is the button
Seat 1: deadmoneykid ($20.75 in chips) 
Seat 2: Medic8681 ($13.77 in chips) 
Seat 3: puffy5533 ($19.58 in chips) 
Seat 4: BlOnDhOlIc ($25.25 in chips) 
Seat 5: PetitAlejo ($25.35 in chips) 
Seat 6: nice.franki ($7.37 in chips) 
Seat 7: slickthis ($27.35 in chips) 
Seat 8: chiyuki ($32.66 in chips) 
Seat 9: DooMSDaY1337 ($28.62 in chips) 
Medic8681: posts small blind $0.10
puffy5533: posts big blind $0.25
*** HOLE CARDS ***
Dealt to chiyuki [Td 2c]
BlOnDhOlIc: folds 
PetitAlejo: folds 
nice.franki: folds 
slickthis: folds 
chiyuki: folds 
DooMSDaY1337: folds 
deadmoneykid: folds 
Medic8681: raises $0.50 to $0.75
puffy5533: folds 
Uncalled bet ($0.50) returned to Medic8681
Medic8681 collected $0.50 from pot
Medic8681: doesn't show hand 
*** SUMMARY ***
Total pot $0.50 | Rake $0 
Seat 1: deadmoneykid (button) folded before Flop (didn't bet)
Seat 2: Medic8681 (small blind) collected ($0.50)
Seat 3: puffy5533 (big blind) folded before Flop
Seat 4: BlOnDhOlIc folded before Flop (didn't bet)
Seat 5: PetitAlejo folded before Flop (didn't bet)
Seat 6: nice.franki folded before Flop (didn't bet)
Seat 7: slickthis folded before Flop (didn't bet)
Seat 8: chiyuki folded before Flop (didn't bet)
Seat 9: DooMSDaY1337 folded before Flop (didn't bet)



PokerStars Zoom Hand #84298402966:  Hold'em No Limit ($0.10/$0.25) - 2012/08/05 13:12:04 JST [2012/08/05 0:12:04 ET]
Table 'Whirlpool' 9-max Seat #1 is the button
Seat 1: BlOnDhOlIc ($49.35 in chips) 
Seat 2: deadmoneykid ($24.89 in chips) 
Seat 3: 4ydo yogurt ($16.85 in chips) 
Seat 4: PetitAlejo ($40.72 in chips) 
Seat 5: seula i ($52.45 in chips) 
Seat 6: Loholov ($15 in chips) 
Seat 7: RomarioJa ($10.54 in chips) 
Seat 8: Medic8681 ($12.75 in chips) 
Seat 9: chiyuki ($32.66 in chips) 
deadmoneykid: posts small blind $0.10
4ydo yogurt: posts big blind $0.25
*** HOLE CARDS ***
Dealt to chiyuki [3h 7s]
PetitAlejo: folds 
seula i: folds 
Loholov: folds 
RomarioJa: folds 
Medic8681: folds 
chiyuki: folds 
BlOnDhOlIc: raises $0.25 to $0.50
deadmoneykid: folds 
4ydo yogurt: calls $0.25
*** FLOP *** [7d Qc 5h]
4ydo yogurt: bets $0.40
BlOnDhOlIc: calls $0.40
*** TURN *** [7d Qc 5h] [9h]
4ydo yogurt: checks 
BlOnDhOlIc: bets $0.90
4ydo yogurt: calls $0.90
*** RIVER *** [7d Qc 5h 9h] [Jd]
4ydo yogurt: bets $1.30
BlOnDhOlIc: calls $1.30
*** SHOW DOWN ***
4ydo yogurt: shows [9s 7h] (two pair, Nines and Sevens)
BlOnDhOlIc: mucks hand 
4ydo yogurt collected $6.02 from pot
*** SUMMARY ***
Total pot $6.30 | Rake $0.28 
Board [7d Qc 5h 9h Jd]
Seat 1: BlOnDhOlIc (button) mucked [4s Qs]
Seat 2: deadmoneykid (small blind) folded before Flop
Seat 3: 4ydo yogurt (big blind) showed [9s 7h] and won ($6.02) with two pair, Nines and Sevens
Seat 4: PetitAlejo folded before Flop (didn't bet)
Seat 5: seula i folded before Flop (didn't bet)
Seat 6: Loholov folded before Flop (didn't bet)
Seat 7: RomarioJa folded before Flop (didn't bet)
Seat 8: Medic8681 folded before Flop (didn't bet)
Seat 9: chiyuki folded before Flop (didn't bet)



PokerStars Zoom Hand #84298410158:  Hold'em No Limit ($0.10/$0.25) - 2012/08/05 13:12:29 JST [2012/08/05 0:12:29 ET]
Table 'Whirlpool' 9-max Seat #1 is the button
Seat 1: luyifei ($24.08 in chips) 
Seat 2: DooMSDaY1337 ($28.62 in chips) 
Seat 3: polk11 ($24.15 in chips) 
Seat 4: KrystalAA ($17.63 in chips) 
Seat 5: chiyuki ($32.66 in chips) 
Seat 6: Roglus ($34.94 in chips) 
Seat 7: hassantas ($27.20 in chips) 
Seat 8: seula i ($63.17 in chips) 
Seat 9: TErr18 ($15.54 in chips) 
DooMSDaY1337: posts small blind $0.10
polk11: posts big blind $0.25
*** HOLE CARDS ***
Dealt to chiyuki [Ad 4h]
KrystalAA: folds 
chiyuki: folds 
Roglus: folds 
hassantas: folds 
seula i: raises $0.50 to $0.75
TErr18: folds 
luyifei: calls $0.75
DooMSDaY1337: folds 
polk11: folds 
*** FLOP *** [7h Ks 7s]
seula i: bets $1.25
luyifei: folds 
Uncalled bet ($1.25) returned to seula i
seula i collected $1.77 from pot
seula i: doesn't show hand 
*** SUMMARY ***
Total pot $1.85 | Rake $0.08 
Board [7h Ks 7s]
Seat 1: luyifei (button) folded on the Flop
Seat 2: DooMSDaY1337 (small blind) folded before Flop
Seat 3: polk11 (big blind) folded before Flop
Seat 4: KrystalAA folded before Flop (didn't bet)
Seat 5: chiyuki folded before Flop (didn't bet)
Seat 6: Roglus folded before Flop (didn't bet)
Seat 7: hassantas folded before Flop (didn't bet)
Seat 8: seula i collected ($1.77)
Seat 9: TErr18 folded before Flop (didn't bet)



PokerStars Zoom Hand #84298412797:  Hold'em No Limit ($0.10/$0.25) - 2012/08/05 13:12:38 JST [2012/08/05 0:12:38 ET]
Table 'Whirlpool' 9-max Seat #1 is the button
Seat 1: 2997qwer ($8.87 in chips) 
Seat 2: bigrasbig ($37.38 in chips) 
Seat 3: BlOnDhOlIc ($38.02 in chips) 
Seat 4: chiyuki ($32.66 in chips) 
Seat 5: Zugrug ($25 in chips) 
Seat 6: silvno31 ($16.47 in chips) 
Seat 7: PetitAlejo ($25.35 in chips) 
Seat 8: DooMSDaY1337 ($36.87 in chips) 
Seat 9: TraderYao ($25 in chips) 
bigrasbig: posts small blind $0.10
BlOnDhOlIc: posts big blind $0.25
*** HOLE CARDS ***
Dealt to chiyuki [Ac 2s]
chiyuki: folds 
Zugrug: folds 
silvno31: raises $0.50 to $0.75
PetitAlejo: folds 
DooMSDaY1337: folds 
TraderYao: folds 
2997qwer: folds 
bigrasbig: folds 
BlOnDhOlIc: calls $0.50
*** FLOP *** [Kd Jh 8s]
BlOnDhOlIc: checks 
silvno31: bets $1
BlOnDhOlIc: raises $1.50 to $2.50
silvno31: folds 
Uncalled bet ($1.50) returned to BlOnDhOlIc
BlOnDhOlIc collected $3.44 from pot
BlOnDhOlIc: doesn't show hand 
*** SUMMARY ***
Total pot $3.60 | Rake $0.16 
Board [Kd Jh 8s]
Seat 1: 2997qwer (button) folded before Flop (didn't bet)
Seat 2: bigrasbig (small blind) folded before Flop
Seat 3: BlOnDhOlIc (big blind) collected ($3.44)
Seat 4: chiyuki folded before Flop (didn't bet)
Seat 5: Zugrug folded before Flop (didn't bet)
Seat 6: silvno31 folded on the Flop
Seat 7: PetitAlejo folded before Flop (didn't bet)
Seat 8: DooMSDaY1337 folded before Flop (didn't bet)
Seat 9: TraderYao folded before Flop (didn't bet)



PokerStars Zoom Hand #84298407964:  Hold'em No Limit ($0.10/$0.25) - 2012/08/05 13:12:21 JST [2012/08/05 0:12:21 ET]
Table 'Whirlpool' 9-max Seat #1 is the button
Seat 1: chiyuki ($32.66 in chips) 
Seat 2: fwani ($45.04 in chips) 
Seat 3: Th3Fog ($66.28 in chips) 
Seat 4: wtu1986 ($24.94 in chips) 
Seat 5: taksist889 ($34.50 in chips) 
Seat 6: RomarioJa ($9.97 in chips) 
Seat 7: softdesign ($51.78 in chips) 
Seat 8: 2997qwer ($8.87 in chips) 
Seat 9: nice.franki ($12.85 in chips) 
fwani: posts small blind $0.10
Th3Fog: posts big blind $0.25
*** HOLE CARDS ***
Dealt to chiyuki [6h Qd]
wtu1986: folds 
taksist889: folds 
RomarioJa: raises $0.37 to $0.62
softdesign: calls $0.62
2997qwer: folds 
nice.franki: calls $0.62
chiyuki: folds 
fwani: folds 
Th3Fog: calls $0.37
*** FLOP *** [8h 8d 3c]
Th3Fog: checks 
RomarioJa: checks 
softdesign: bets $1
nice.franki: folds 
Th3Fog: folds 
RomarioJa: folds 
Uncalled bet ($1) returned to softdesign
softdesign collected $2.46 from pot
softdesign: doesn't show hand 
*** SUMMARY ***
Total pot $2.58 | Rake $0.12 
Board [8h 8d 3c]
Seat 1: chiyuki (button) folded before Flop (didn't bet)
Seat 2: fwani (small blind) folded before Flop
Seat 3: Th3Fog (big blind) folded on the Flop
Seat 4: wtu1986 folded before Flop (didn't bet)
Seat 5: taksist889 folded before Flop (didn't bet)
Seat 6: RomarioJa folded on the Flop
Seat 7: softdesign collected ($2.46)
Seat 8: 2997qwer folded before Flop (didn't bet)
Seat 9: nice.franki folded on the Flop



PokerStars Zoom Hand #84298404688:  Hold'em No Limit ($0.10/$0.25) - 2012/08/05 13:12:10 JST [2012/08/05 0:12:10 ET]
Table 'Whirlpool' 9-max Seat #1 is the button
Seat 1: 2997qwer ($11.10 in chips) 
Seat 2: PetitAlejo ($40.72 in chips) 
Seat 3: MibNe ($30.45 in chips) 
Seat 4: chiyuki ($32.66 in chips) 
Seat 5: nice.franki ($14.47 in chips) 
Seat 6: DooMSDaY1337 ($36.87 in chips) 
Seat 7: envious_0007 ($10.05 in chips) 
Seat 8: puffy5533 ($19.58 in chips) 
Seat 9: Alvinpe85 ($25 in chips) 
PetitAlejo: posts small blind $0.10
MibNe: posts big blind $0.25
*** HOLE CARDS ***
Dealt to chiyuki [5h 6c]
chiyuki: folds 
nice.franki: folds 
DooMSDaY1337: folds 
envious_0007: calls $0.25
puffy5533: folds 
Alvinpe85: folds 
2997qwer: raises $0.75 to $1
PetitAlejo: folds 
MibNe: folds 
envious_0007: calls $0.75
*** FLOP *** [3h Qh 3s]
envious_0007: checks 
2997qwer: checks 
*** TURN *** [3h Qh 3s] [2d]
envious_0007: checks 
2997qwer: checks 
*** RIVER *** [3h Qh 3s 2d] [Js]
envious_0007: checks 
2997qwer: checks 
*** SHOW DOWN ***
envious_0007: shows [As Kh] (a pair of Threes)
2997qwer: mucks hand 
envious_0007 collected $2.24 from pot
*** SUMMARY ***
Total pot $2.35 | Rake $0.11 
Board [3h Qh 3s 2d Js]
Seat 1: 2997qwer (button) mucked [Ah Td]
Seat 2: PetitAlejo (small blind) folded before Flop
Seat 3: MibNe (big blind) folded before Flop
Seat 4: chiyuki folded before Flop (didn't bet)
Seat 5: nice.franki folded before Flop (didn't bet)
Seat 6: DooMSDaY1337 folded before Flop (didn't bet)
Seat 7: envious_0007 showed [As Kh] and won ($2.24) with a pair of Threes
Seat 8: puffy5533 folded before Flop (didn't bet)
Seat 9: Alvinpe85 folded before Flop (didn't bet)



PokerStars Zoom Hand #84298414233:  Hold'em No Limit ($0.10/$0.25) - 2012/08/05 13:12:43 JST [2012/08/05 0:12:43 ET]
Table 'Whirlpool' 9-max Seat #1 is the button
Seat 1: KrystalAA ($14.24 in chips) 
Seat 2: pyty_82 ($58 in chips) 
Seat 3: chiyuki ($32.66 in chips) 
Seat 4: MibNe ($30.10 in chips) 
Seat 5: RomarioJa ($10.59 in chips) 
Seat 6: fwani ($30.88 in chips) 
Seat 7: Zugrug ($25 in chips) 
Seat 8: vit 111 ($38.88 in chips) 
Seat 9: BlOnDhOlIc ($25 in chips) 
pyty_82: posts small blind $0.10
chiyuki: posts big blind $0.25
*** HOLE CARDS ***
Dealt to chiyuki [Ts 8s]
MibNe: folds 
RomarioJa: raises $0.37 to $0.62
fwani: folds 
Zugrug: folds 
vit 111: folds 
BlOnDhOlIc: folds 
KrystalAA: calls $0.62
pyty_82: folds 
chiyuki: calls $0.37
*** FLOP *** [5d Tc Td]
chiyuki: checks 
RomarioJa: bets $1.23
KrystalAA: calls $1.23
chiyuki: raises $2.77 to $4
RomarioJa: folds 
KrystalAA: calls $2.77
*** TURN *** [5d Tc Td] [3d]
chiyuki: bets $12.25
KrystalAA: calls $9.62 and is all-in
Uncalled bet ($2.63) returned to chiyuki
*** RIVER *** [5d Tc Td 3d] [Th]
*** SHOW DOWN ***
chiyuki: shows [Ts 8s] (four of a kind, Tens)
KrystalAA: mucks hand 
chiyuki collected $29.06 from pot
*** SUMMARY ***
Total pot $30.43 | Rake $1.37 
Board [5d Tc Td 3d Th]
Seat 1: KrystalAA (button) mucked [5h 5s]
Seat 2: pyty_82 (small blind) folded before Flop
Seat 3: chiyuki (big blind) showed [Ts 8s] and won ($29.06) with four of a kind, Tens
Seat 4: MibNe folded before Flop (didn't bet)
Seat 5: RomarioJa folded on the Flop
Seat 6: fwani folded before Flop (didn't bet)
Seat 7: Zugrug folded before Flop (didn't bet)
Seat 8: vit 111 folded before Flop (didn't bet)
Seat 9: BlOnDhOlIc folded before Flop (didn't bet)



PokerStars Zoom Hand #84298438489:  Hold'em No Limit ($0.10/$0.25) - 2012/08/05 13:14:09 JST [2012/08/05 0:14:09 ET]
Table 'Whirlpool' 9-max Seat #1 is the button
Seat 1: TErr18 ($19.20 in chips) 
Seat 2: chiyuki ($47.48 in chips) 
Seat 3: nice.franki ($14.47 in chips) 
Seat 4: bigrasbig ($35.28 in chips) 
Seat 5: KrystalAA ($12.50 in chips) 
Seat 6: PetitAlejo ($27.70 in chips) 
Seat 7: deadmoneykid ($24.75 in chips) 
Seat 8: wtu1986 ($25.50 in chips) 
Seat 9: seula i ($80.54 in chips) 
chiyuki: posts small blind $0.10
nice.franki: posts big blind $0.25
*** HOLE CARDS ***
Dealt to chiyuki [9d Jh]
bigrasbig: folds 
KrystalAA: folds 
PetitAlejo: folds 
deadmoneykid: folds 
wtu1986: folds 
seula i: folds 
TErr18: folds 
chiyuki: folds 
Uncalled bet ($0.15) returned to nice.franki
nice.franki collected $0.20 from pot
nice.franki: doesn't show hand 
*** SUMMARY ***
Total pot $0.20 | Rake $0 
Seat 1: TErr18 (button) folded before Flop (didn't bet)
Seat 2: chiyuki (small blind) folded before Flop
Seat 3: nice.franki (big blind) collected ($0.20)
Seat 4: bigrasbig folded before Flop (didn't bet)
Seat 5: KrystalAA folded before Flop (didn't bet)
Seat 6: PetitAlejo folded before Flop (didn't bet)
Seat 7: deadmoneykid folded before Flop (didn't bet)
Seat 8: wtu1986 folded before Flop (didn't bet)
Seat 9: seula i folded before Flop (didn't bet)



PokerStars Zoom Hand #84298441081:  Hold'em No Limit ($0.10/$0.25) - 2012/08/05 13:14:18 JST [2012/08/05 0:14:18 ET]
Table 'Whirlpool' 9-max Seat #1 is the button
Seat 1: slapshot2011 ($33.59 in chips) 
Seat 2: bigrasbig ($35.28 in chips) 
Seat 3: mikifeio ($48.64 in chips) 
Seat 4: silvno31 ($14.72 in chips) 
Seat 5: Suhoff76 ($25 in chips) 
Seat 6: Alvinpe85 ($28.60 in chips) 
Seat 7: slickthis ($23.45 in chips) 
Seat 8: Jene4kaBest ($7.66 in chips) 
Seat 9: chiyuki ($47.38 in chips) 
bigrasbig: posts small blind $0.10
mikifeio: posts big blind $0.25
*** HOLE CARDS ***
Dealt to chiyuki [Qh 8d]
silvno31: folds 
Suhoff76: folds 
Alvinpe85: folds 
slickthis: folds 
Jene4kaBest: folds 
chiyuki: folds 
slapshot2011: folds 
bigrasbig: folds 
Uncalled bet ($0.15) returned to mikifeio
mikifeio collected $0.20 from pot
mikifeio: doesn't show hand 
*** SUMMARY ***
Total pot $0.20 | Rake $0 
Seat 1: slapshot2011 (button) folded before Flop (didn't bet)
Seat 2: bigrasbig (small blind) folded before Flop
Seat 3: mikifeio (big blind) collected ($0.20)
Seat 4: silvno31 folded before Flop (didn't bet)
Seat 5: Suhoff76 folded before Flop (didn't bet)
Seat 6: Alvinpe85 folded before Flop (didn't bet)
Seat 7: slickthis folded before Flop (didn't bet)
Seat 8: Jene4kaBest folded before Flop (didn't bet)
Seat 9: chiyuki folded before Flop (didn't bet)



PokerStars Zoom Hand #84298442817:  Hold'em No Limit ($0.10/$0.25) - 2012/08/05 13:14:24 JST [2012/08/05 0:14:24 ET]
Table 'Whirlpool' 9-max Seat #1 is the button
Seat 1: DonSimonUsa ($24.75 in chips) 
Seat 2: Alvinpe85 ($28.60 in chips) 
Seat 3: 4ydo yogurt ($20.90 in chips) 
Seat 4: 5zzzz33 ($19.05 in chips) 
Seat 5: D@vidMed ($28.12 in chips) 
Seat 6: TraderYao ($25 in chips) 
Seat 7: chiyuki ($47.38 in chips) 
Seat 8: Tasman007 ($7.98 in chips) 
Seat 9: Suhoff76 ($25.25 in chips) 
Alvinpe85: posts small blind $0.10
4ydo yogurt: posts big blind $0.25
*** HOLE CARDS ***
Dealt to chiyuki [Jh Qs]
5zzzz33: folds 
D@vidMed: raises $0.57 to $0.82
TraderYao: folds 
chiyuki: folds 
Tasman007: folds 
Suhoff76: folds 
DonSimonUsa: calls $0.82
Alvinpe85: folds 
4ydo yogurt: calls $0.57
*** FLOP *** [6d As Ac]
4ydo yogurt: checks 
D@vidMed: bets $0.82
DonSimonUsa: folds 
4ydo yogurt: calls $0.82
*** TURN *** [6d As Ac] [3d]
4ydo yogurt: bets $0.25
D@vidMed: calls $0.25
*** RIVER *** [6d As Ac 3d] [9s]
4ydo yogurt: checks 
D@vidMed: bets $3.63
4ydo yogurt: folds 
Uncalled bet ($3.63) returned to D@vidMed
D@vidMed collected $4.49 from pot
D@vidMed: doesn't show hand 
*** SUMMARY ***
Total pot $4.70 | Rake $0.21 
Board [6d As Ac 3d 9s]
Seat 1: DonSimonUsa (button) folded on the Flop
Seat 2: Alvinpe85 (small blind) folded before Flop
Seat 3: 4ydo yogurt (big blind) folded on the River
Seat 4: 5zzzz33 folded before Flop (didn't bet)
Seat 5: D@vidMed collected ($4.49)
Seat 6: TraderYao folded before Flop (didn't bet)
Seat 7: chiyuki folded before Flop (didn't bet)
Seat 8: Tasman007 folded before Flop (didn't bet)
Seat 9: Suhoff76 folded before Flop (didn't bet)



PokerStars Zoom Hand #84298446839:  Hold'em No Limit ($0.10/$0.25) - 2012/08/05 13:14:39 JST [2012/08/05 0:14:39 ET]
Table 'Whirlpool' 9-max Seat #1 is the button
Seat 1: doanut13 ($36.02 in chips) 
Seat 2: fwani ($27.05 in chips) 
Seat 3: Zugrug ($25 in chips) 
Seat 4: deadmoneykid ($23.29 in chips) 
Seat 5: wtu1986 ($24.94 in chips) 
Seat 6: RomarioJa ($9 in chips) 
Seat 7: TraderYao ($25 in chips) 
Seat 8: chiyuki ($47.38 in chips) 
Seat 9: Jene4kaBest ($7.66 in chips) 
fwani: posts small blind $0.10
Zugrug: posts big blind $0.25
*** HOLE CARDS ***
Dealt to chiyuki [Kd Qs]
deadmoneykid: folds 
wtu1986: folds 
RomarioJa: folds 
TraderYao: folds 
chiyuki: raises $0.50 to $0.75
Jene4kaBest: folds 
doanut13: calls $0.75
fwani: calls $0.65
Zugrug: folds 
*** FLOP *** [2c Ad 5h]
fwani: checks 
chiyuki: checks 
doanut13: bets $0.75
fwani: calls $0.75
chiyuki: folds 
*** TURN *** [2c Ad 5h] [Qh]
fwani: bets $2.80
doanut13: folds 
Uncalled bet ($2.80) returned to fwani
fwani collected $3.82 from pot
fwani: doesn't show hand 
*** SUMMARY ***
Total pot $4 | Rake $0.18 
Board [2c Ad 5h Qh]
Seat 1: doanut13 (button) folded on the Turn
Seat 2: fwani (small blind) collected ($3.82)
Seat 3: Zugrug (big blind) folded before Flop
Seat 4: deadmoneykid folded before Flop (didn't bet)
Seat 5: wtu1986 folded before Flop (didn't bet)
Seat 6: RomarioJa folded before Flop (didn't bet)
Seat 7: TraderYao folded before Flop (didn't bet)
Seat 8: chiyuki folded on the Flop
Seat 9: Jene4kaBest folded before Flop (didn't bet)



PokerStars Zoom Hand #84298459488:  Hold'em No Limit ($0.10/$0.25) - 2012/08/05 13:15:23 JST [2012/08/05 0:15:23 ET]
Table 'Whirlpool' 9-max Seat #1 is the button
Seat 1: Catrban ($24.41 in chips) 
Seat 2: silvno31 ($18.73 in chips) 
Seat 3: Medic8681 ($15.39 in chips) 
Seat 4: BlOnDhOlIc ($26.12 in chips) 
Seat 5: vit 111 ($41.02 in chips) 
Seat 6: chiyuki ($46.63 in chips) 
Seat 7: ryanjp2323 ($30.22 in chips) 
Seat 8: Suhoff76 ($25 in chips) 
Seat 9: Th3Fog ($52.43 in chips) 
silvno31: posts small blind $0.10
Medic8681: posts big blind $0.25
*** HOLE CARDS ***
Dealt to chiyuki [Ts 8h]
BlOnDhOlIc: folds 
vit 111: folds 
chiyuki: folds 
ryanjp2323: folds 
Suhoff76: folds 
Th3Fog: folds 
Catrban: folds 
silvno31: folds 
Uncalled bet ($0.15) returned to Medic8681
Medic8681 collected $0.20 from pot
Medic8681: doesn't show hand 
*** SUMMARY ***
Total pot $0.20 | Rake $0 
Seat 1: Catrban (button) folded before Flop (didn't bet)
Seat 2: silvno31 (small blind) folded before Flop
Seat 3: Medic8681 (big blind) collected ($0.20)
Seat 4: BlOnDhOlIc folded before Flop (didn't bet)
Seat 5: vit 111 folded before Flop (didn't bet)
Seat 6: chiyuki folded before Flop (didn't bet)
Seat 7: ryanjp2323 folded before Flop (didn't bet)
Seat 8: Suhoff76 folded before Flop (didn't bet)
Seat 9: Th3Fog folded before Flop (didn't bet)



PokerStars Zoom Hand #84298466062:  Hold'em No Limit ($0.10/$0.25) - 2012/08/05 13:15:47 JST [2012/08/05 0:15:47 ET]
Table 'Whirlpool' 9-max Seat #1 is the button
Seat 1: TErr18 ($13.69 in chips) 
Seat 2: DooMSDaY1337 ($26.32 in chips) 
Seat 3: taksist889 ($36.20 in chips) 
Seat 4: chiyuki ($46.63 in chips) 
Seat 5: 4ydo yogurt ($19.47 in chips) 
Seat 6: Th3Fog ($24.33 in chips) 
Seat 7: kkbruins0408 ($11.88 in chips) 
Seat 8: wtu1986 ($24.59 in chips) 
Seat 9: PetitAlejo ($27.35 in chips) 
DooMSDaY1337: posts small blind $0.10
taksist889: posts big blind $0.25
*** HOLE CARDS ***
Dealt to chiyuki [6h Qs]
chiyuki: folds 
4ydo yogurt: raises $0.50 to $0.75
Th3Fog: folds 
kkbruins0408: folds 
wtu1986: folds 
PetitAlejo: folds 
TErr18: folds 
DooMSDaY1337: folds 
taksist889: folds 
Uncalled bet ($0.50) returned to 4ydo yogurt
4ydo yogurt collected $0.60 from pot
4ydo yogurt: doesn't show hand 
*** SUMMARY ***
Total pot $0.60 | Rake $0 
Seat 1: TErr18 (button) folded before Flop (didn't bet)
Seat 2: DooMSDaY1337 (small blind) folded before Flop
Seat 3: taksist889 (big blind) folded before Flop
Seat 4: chiyuki folded before Flop (didn't bet)
Seat 5: 4ydo yogurt collected ($0.60)
Seat 6: Th3Fog folded before Flop (didn't bet)
Seat 7: kkbruins0408 folded before Flop (didn't bet)
Seat 8: wtu1986 folded before Flop (didn't bet)
Seat 9: PetitAlejo folded before Flop (didn't bet)



PokerStars Zoom Hand #84298467198:  Hold'em No Limit ($0.10/$0.25) - 2012/08/05 13:15:51 JST [2012/08/05 0:15:51 ET]
Table 'Whirlpool' 9-max Seat #1 is the button
Seat 1: kamikkaze ($49.48 in chips) 
Seat 2: chiyuki ($46.63 in chips) 
Seat 3: RomarioJa ($10.77 in chips) 
Seat 4: Zugrug ($26.85 in chips) 
Seat 5: nice.franki ($12.37 in chips) 
Seat 6: seula i ($77.89 in chips) 
Seat 7: Medic8681 ($12.85 in chips) 
Seat 8: BlOnDhOlIc ($50.68 in chips) 
Seat 9: NastyMcNast ($54.02 in chips) 
chiyuki: posts small blind $0.10
RomarioJa: posts big blind $0.25
*** HOLE CARDS ***
Dealt to chiyuki [8d 8h]
Zugrug: folds 
nice.franki: folds 
seula i: raises $0.75 to $1
Medic8681: folds 
BlOnDhOlIc: folds 
NastyMcNast: folds 
kamikkaze: folds 
chiyuki: folds 
RomarioJa: folds 
Uncalled bet ($0.75) returned to seula i
seula i collected $0.60 from pot
seula i: doesn't show hand 
*** SUMMARY ***
Total pot $0.60 | Rake $0 
Seat 1: kamikkaze (button) folded before Flop (didn't bet)
Seat 2: chiyuki (small blind) folded before Flop
Seat 3: RomarioJa (big blind) folded before Flop
Seat 4: Zugrug folded before Flop (didn't bet)
Seat 5: nice.franki folded before Flop (didn't bet)
Seat 6: seula i collected ($0.60)
Seat 7: Medic8681 folded before Flop (didn't bet)
Seat 8: BlOnDhOlIc folded before Flop (didn't bet)
Seat 9: NastyMcNast folded before Flop (didn't bet)



PokerStars Zoom Hand #84298464682:  Hold'em No Limit ($0.10/$0.25) - 2012/08/05 13:15:42 JST [2012/08/05 0:15:42 ET]
Table 'Whirlpool' 9-max Seat #1 is the button
Seat 1: TraderYao ($25 in chips) 
Seat 2: Medic8681 ($13.31 in chips) 
Seat 3: MATT361 ($7.98 in chips) 
Seat 4: RomarioJa ($6.24 in chips) 
Seat 5: chiyuki ($46.63 in chips) 
Seat 6: silvno31 ($18.63 in chips) 
Seat 7: Suhoff76 ($25 in chips) 
Seat 8: seula i ($25.93 in chips) 
Seat 9: kkbruins0408 ($11.88 in chips) 
Medic8681: posts small blind $0.10
MATT361: posts big blind $0.25
*** HOLE CARDS ***
Dealt to chiyuki [Js 8s]
RomarioJa: folds 
chiyuki: folds 
silvno31: folds 
Suhoff76: folds 
seula i: folds 
kkbruins0408: folds 
TraderYao: raises $0.37 to $0.62
Medic8681: raises $1.13 to $1.75
MATT361: folds 
TraderYao: folds 
Uncalled bet ($1.13) returned to Medic8681
Medic8681 collected $1.49 from pot
Medic8681: doesn't show hand 
*** SUMMARY ***
Total pot $1.49 | Rake $0 
Seat 1: TraderYao (button) folded before Flop
Seat 2: Medic8681 (small blind) collected ($1.49)
Seat 3: MATT361 (big blind) folded before Flop
Seat 4: RomarioJa folded before Flop (didn't bet)
Seat 5: chiyuki folded before Flop (didn't bet)
Seat 6: silvno31 folded before Flop (didn't bet)
Seat 7: Suhoff76 folded before Flop (didn't bet)
Seat 8: seula i folded before Flop (didn't bet)
Seat 9: kkbruins0408 folded before Flop (didn't bet)



PokerStars Zoom Hand #84298462083:  Hold'em No Limit ($0.10/$0.25) - 2012/08/05 13:15:32 JST [2012/08/05 0:15:32 ET]
Table 'Whirlpool' 9-max Seat #1 is the button
Seat 1: chiyuki ($46.63 in chips) 
Seat 2: PetitAlejo ($25 in chips) 
Seat 3: vit 111 ($41.02 in chips) 
Seat 4: TraderYao ($24.90 in chips) 
Seat 5: leo2095 ($16.55 in chips) 
Seat 6: Alvinpe85 ($27.61 in chips) 
Seat 7: KeLevro0 ($7.17 in chips) 
Seat 8: DooMSDaY1337 ($34.02 in chips) 
Seat 9: nice.franki ($11.20 in chips) 
PetitAlejo: posts small blind $0.10
vit 111: posts big blind $0.25
*** HOLE CARDS ***
Dealt to chiyuki [3h 9c]
TraderYao: folds 
leo2095: folds 
Alvinpe85: raises $0.50 to $0.75
KeLevro0: folds 
DooMSDaY1337: folds 
nice.franki: folds 
chiyuki: folds 
PetitAlejo: folds 
vit 111: calls $0.50
*** FLOP *** [8c 9h Kd]
vit 111: checks 
Alvinpe85: bets $1
vit 111: calls $1
*** TURN *** [8c 9h Kd] [Jh]
vit 111: checks 
Alvinpe85: checks 
*** RIVER *** [8c 9h Kd Jh] [9d]
vit 111: bets $1
Alvinpe85: folds 
Uncalled bet ($1) returned to vit 111
vit 111 collected $3.44 from pot
vit 111: doesn't show hand 
*** SUMMARY ***
Total pot $3.60 | Rake $0.16 
Board [8c 9h Kd Jh 9d]
Seat 1: chiyuki (button) folded before Flop (didn't bet)
Seat 2: PetitAlejo (small blind) folded before Flop
Seat 3: vit 111 (big blind) collected ($3.44)
Seat 4: TraderYao folded before Flop (didn't bet)
Seat 5: leo2095 folded before Flop (didn't bet)
Seat 6: Alvinpe85 folded on the River
Seat 7: KeLevro0 folded before Flop (didn't bet)
Seat 8: DooMSDaY1337 folded before Flop (didn't bet)
Seat 9: nice.franki folded before Flop (didn't bet)



PokerStars Zoom Hand #84298471725:  Hold'em No Limit ($0.10/$0.25) - 2012/08/05 13:16:07 JST [2012/08/05 0:16:07 ET]
Table 'Whirlpool' 9-max Seat #1 is the button
Seat 1: Zugrug ($25.95 in chips) 
Seat 2: TraderYao ($25 in chips) 
Seat 3: Medic8681 ($12.50 in chips) 
Seat 4: DonSimonUsa ($23.83 in chips) 
Seat 5: petersmiths ($36.03 in chips) 
Seat 6: BlOnDhOlIc ($39.77 in chips) 
Seat 7: chiyuki ($46.53 in chips) 
Seat 8: NastyMcNast ($32.71 in chips) 
Seat 9: KeLevro0 ($12.67 in chips) 
TraderYao: posts small blind $0.10
Medic8681: posts big blind $0.25
*** HOLE CARDS ***
Dealt to chiyuki [Qc 5d]
DonSimonUsa: folds 
petersmiths: raises $0.25 to $0.50
BlOnDhOlIc: folds 
chiyuki: folds 
NastyMcNast: folds 
KeLevro0: folds 
Zugrug: folds 
TraderYao: folds 
Medic8681: calls $0.25
*** FLOP *** [4h 7d Ah]
Medic8681: checks 
petersmiths: bets $0.42
Medic8681: folds 
Uncalled bet ($0.42) returned to petersmiths
petersmiths collected $1.05 from pot
petersmiths: doesn't show hand 
*** SUMMARY ***
Total pot $1.10 | Rake $0.05 
Board [4h 7d Ah]
Seat 1: Zugrug (button) folded before Flop (didn't bet)
Seat 2: TraderYao (small blind) folded before Flop
Seat 3: Medic8681 (big blind) folded on the Flop
Seat 4: DonSimonUsa folded before Flop (didn't bet)
Seat 5: petersmiths collected ($1.05)
Seat 6: BlOnDhOlIc folded before Flop (didn't bet)
Seat 7: chiyuki folded before Flop (didn't bet)
Seat 8: NastyMcNast folded before Flop (didn't bet)
Seat 9: KeLevro0 folded before Flop (didn't bet)



PokerStars Zoom Hand #84298474004:  Hold'em No Limit ($0.10/$0.25) - 2012/08/05 13:16:15 JST [2012/08/05 0:16:15 ET]
Table 'Whirlpool' 9-max Seat #1 is the button
Seat 1: Th3Fog ($67.47 in chips) 
Seat 2: DooMSDaY1337 ($54.14 in chips) 
Seat 3: chiyuki ($46.53 in chips) 
Seat 4: Loholov ($20.67 in chips) 
Seat 5: ryanjp2323 ($29.87 in chips) 
Seat 6: wtu1986 ($24.59 in chips) 
Seat 7: Zugrug ($28.19 in chips) 
Seat 8: BlOnDhOlIc ($26.58 in chips) 
Seat 9: Suhoff76 ($25.35 in chips) 
DooMSDaY1337: posts small blind $0.10
chiyuki: posts big blind $0.25
*** HOLE CARDS ***
Dealt to chiyuki [Ks 8d]
Loholov: folds 
ryanjp2323: raises $0.75 to $1
wtu1986: folds 
Zugrug: folds 
BlOnDhOlIc: folds 
Suhoff76: folds 
Th3Fog: folds 
DooMSDaY1337: folds 
chiyuki: folds 
Uncalled bet ($0.75) returned to ryanjp2323
ryanjp2323 collected $0.60 from pot
ryanjp2323: doesn't show hand 
*** SUMMARY ***
Total pot $0.60 | Rake $0 
Seat 1: Th3Fog (button) folded before Flop (didn't bet)
Seat 2: DooMSDaY1337 (small blind) folded before Flop
Seat 3: chiyuki (big blind) folded before Flop
Seat 4: Loholov folded before Flop (didn't bet)
Seat 5: ryanjp2323 collected ($0.60)
Seat 6: wtu1986 folded before Flop (didn't bet)
Seat 7: Zugrug folded before Flop (didn't bet)
Seat 8: BlOnDhOlIc folded before Flop (didn't bet)
Seat 9: Suhoff76 folded before Flop (didn't bet)



PokerStars Zoom Hand #84298477425:  Hold'em No Limit ($0.10/$0.25) - 2012/08/05 13:16:27 JST [2012/08/05 0:16:27 ET]
Table 'Whirlpool' 9-max Seat #1 is the button
Seat 1: slapshot2011 ($39.01 in chips) 
Seat 2: Suhoff76 ($25.10 in chips) 
Seat 3: BlOnDhOlIc ($51.03 in chips) 
Seat 4: mikifeio ($46.89 in chips) 
Seat 5: softdesign ($52.17 in chips) 
Seat 6: bigrasbig ($68.73 in chips) 
Seat 7: Th3Fog ($67.47 in chips) 
Seat 8: chiyuki ($46.28 in chips) 
Seat 9: TErr18 ($25.80 in chips) 
Suhoff76: posts small blind $0.10
BlOnDhOlIc: posts big blind $0.25
*** HOLE CARDS ***
Dealt to chiyuki [6s 4s]
mikifeio: folds 
softdesign: folds 
bigrasbig: folds 
Th3Fog: folds 
chiyuki: folds 
TErr18: folds 
slapshot2011: folds 
Suhoff76: raises $0.35 to $0.60
BlOnDhOlIc: raises $1.65 to $2.25
Suhoff76: folds 
Uncalled bet ($1.65) returned to BlOnDhOlIc
BlOnDhOlIc collected $1.20 from pot
BlOnDhOlIc: doesn't show hand 
*** SUMMARY ***
Total pot $1.20 | Rake $0 
Seat 1: slapshot2011 (button) folded before Flop (didn't bet)
Seat 2: Suhoff76 (small blind) folded before Flop
Seat 3: BlOnDhOlIc (big blind) collected ($1.20)
Seat 4: mikifeio folded before Flop (didn't bet)
Seat 5: softdesign folded before Flop (didn't bet)
Seat 6: bigrasbig folded before Flop (didn't bet)
Seat 7: Th3Fog folded before Flop (didn't bet)
Seat 8: chiyuki folded before Flop (didn't bet)
Seat 9: TErr18 folded before Flop (didn't bet)



PokerStars Zoom Hand #84298473094:  Hold'em No Limit ($0.10/$0.25) - 2012/08/05 13:16:12 JST [2012/08/05 0:16:12 ET]
Table 'Whirlpool' 9-max Seat #1 is the button
Seat 1: TErr18 ($13.59 in chips) 
Seat 2: KeLevro0 ($12.67 in chips) 
Seat 3: goldstone ($25 in chips) 
Seat 4: Jippyflip ($25.61 in chips) 
Seat 5: fwani ($46.95 in chips) 
Seat 6: jtedecaliss ($152.45 in chips) 
Seat 7: PetitAlejo ($25 in chips) 
Seat 8: deadmoneykid ($22.44 in chips) 
Seat 9: chiyuki ($46.53 in chips) 
KeLevro0: posts small blind $0.10
goldstone: posts big blind $0.25
*** HOLE CARDS ***
Dealt to chiyuki [5c Th]
Jippyflip: calls $0.25
fwani: folds 
jtedecaliss: folds 
PetitAlejo: folds 
deadmoneykid: folds 
chiyuki: folds 
TErr18: folds 
KeLevro0: folds 
goldstone: checks 
*** FLOP *** [4d 6d Qh]
goldstone: checks 
Jippyflip: bets $0.25
goldstone: folds 
Uncalled bet ($0.25) returned to Jippyflip
Jippyflip collected $0.57 from pot
Jippyflip: doesn't show hand 
*** SUMMARY ***
Total pot $0.60 | Rake $0.03 
Board [4d 6d Qh]
Seat 1: TErr18 (button) folded before Flop (didn't bet)
Seat 2: KeLevro0 (small blind) folded before Flop
Seat 3: goldstone (big blind) folded on the Flop
Seat 4: Jippyflip collected ($0.57)
Seat 5: fwani folded before Flop (didn't bet)
Seat 6: jtedecaliss folded before Flop (didn't bet)
Seat 7: PetitAlejo folded before Flop (didn't bet)
Seat 8: deadmoneykid folded before Flop (didn't bet)
Seat 9: chiyuki folded before Flop (didn't bet)



PokerStars Zoom Hand #84298481559:  Hold'em No Limit ($0.10/$0.25) - 2012/08/05 13:16:41 JST [2012/08/05 0:16:41 ET]
Table 'Whirlpool' 9-max Seat #1 is the button
Seat 1: ShockLaMuc ($24.65 in chips) 
Seat 2: wtu1986 ($25.99 in chips) 
Seat 3: puffy5533 ($18.63 in chips) 
Seat 4: Roglus ($12.99 in chips) 
Seat 5: chiyuki ($46.28 in chips) 
Seat 6: deadmoneykid ($20.40 in chips) 
Seat 7: luyifei ($22.20 in chips) 
Seat 8: Suhoff76 ($25 in chips) 
Seat 9: slapshot2011 ($38.91 in chips) 
wtu1986: posts small blind $0.10
puffy5533: posts big blind $0.25
*** HOLE CARDS ***
Dealt to chiyuki [Jd 6c]
Roglus: folds 
chiyuki: folds 
deadmoneykid: folds 
luyifei: raises $0.50 to $0.75
Suhoff76: folds 
slapshot2011: folds 
ShockLaMuc: folds 
wtu1986: folds 
puffy5533: folds 
Uncalled bet ($0.50) returned to luyifei
luyifei collected $0.60 from pot
luyifei: doesn't show hand 
*** SUMMARY ***
Total pot $0.60 | Rake $0 
Seat 1: ShockLaMuc (button) folded before Flop (didn't bet)
Seat 2: wtu1986 (small blind) folded before Flop
Seat 3: puffy5533 (big blind) folded before Flop
Seat 4: Roglus folded before Flop (didn't bet)
Seat 5: chiyuki folded before Flop (didn't bet)
Seat 6: deadmoneykid folded before Flop (didn't bet)
Seat 7: luyifei collected ($0.60)
Seat 8: Suhoff76 folded before Flop (didn't bet)
Seat 9: slapshot2011 folded before Flop (didn't bet)



PokerStars Zoom Hand #84298479762:  Hold'em No Limit ($0.10/$0.25) - 2012/08/05 13:16:35 JST [2012/08/05 0:16:35 ET]
Table 'Whirlpool' 9-max Seat #1 is the button
Seat 1: DooMSDaY1337 ($54.04 in chips) 
Seat 2: ryanjp2323 ($30.22 in chips) 
Seat 3: doanut13 ($41.36 in chips) 
Seat 4: seula i ($78.14 in chips) 
Seat 5: nice.franki ($7.97 in chips) 
Seat 6: chiyuki ($46.28 in chips) 
Seat 7: MATT361 ($7.63 in chips) 
Seat 8: TraderYao ($25.35 in chips) 
Seat 9: Suhoff76 ($25 in chips) 
ryanjp2323: posts small blind $0.10
doanut13: posts big blind $0.25
*** HOLE CARDS ***
Dealt to chiyuki [Td 4c]
seula i: folds 
nice.franki: folds 
chiyuki: folds 
MATT361: folds 
TraderYao: folds 
Suhoff76: folds 
DooMSDaY1337: raises $0.50 to $0.75
ryanjp2323: folds 
doanut13: calls $0.50
*** FLOP *** [8c 7d Kc]
doanut13: checks 
DooMSDaY1337: bets $0.76
doanut13: folds 
Uncalled bet ($0.76) returned to DooMSDaY1337
DooMSDaY1337 collected $1.53 from pot
DooMSDaY1337: doesn't show hand 
*** SUMMARY ***
Total pot $1.60 | Rake $0.07 
Board [8c 7d Kc]
Seat 1: DooMSDaY1337 (button) collected ($1.53)
Seat 2: ryanjp2323 (small blind) folded before Flop
Seat 3: doanut13 (big blind) folded on the Flop
Seat 4: seula i folded before Flop (didn't bet)
Seat 5: nice.franki folded before Flop (didn't bet)
Seat 6: chiyuki folded before Flop (didn't bet)
Seat 7: MATT361 folded before Flop (didn't bet)
Seat 8: TraderYao folded before Flop (didn't bet)
Seat 9: Suhoff76 folded before Flop (didn't bet)



PokerStars Zoom Hand #84298484031:  Hold'em No Limit ($0.10/$0.25) - 2012/08/05 13:16:51 JST [2012/08/05 0:16:51 ET]
Table 'Whirlpool' 9-max Seat #1 is the button
Seat 1: masterkoolb ($12.50 in chips) 
Seat 2: RomarioJa ($9.54 in chips) 
Seat 3: fwani ($29.37 in chips) 
Seat 4: chiyuki ($46.28 in chips) 
Seat 5: polk11 ($20.15 in chips) 
Seat 6: Lasutchik ($12.59 in chips) 
Seat 7: BlOnDhOlIc ($25 in chips) 
Seat 8: Suhoff76 ($25 in chips) 
Seat 9: Medic8681 ($12.50 in chips) 
RomarioJa: posts small blind $0.10
fwani: posts big blind $0.25
*** HOLE CARDS ***
Dealt to chiyuki [7h 4d]
chiyuki: folds 
polk11: folds 
Lasutchik: folds 
BlOnDhOlIc: folds 
Suhoff76: folds 
Medic8681: folds 
masterkoolb: raises $0.60 to $0.85
RomarioJa: folds 
fwani: folds 
Uncalled bet ($0.60) returned to masterkoolb
masterkoolb collected $0.60 from pot
masterkoolb: doesn't show hand 
*** SUMMARY ***
Total pot $0.60 | Rake $0 
Seat 1: masterkoolb (button) collected ($0.60)
Seat 2: RomarioJa (small blind) folded before Flop
Seat 3: fwani (big blind) folded before Flop
Seat 4: chiyuki folded before Flop (didn't bet)
Seat 5: polk11 folded before Flop (didn't bet)
Seat 6: Lasutchik folded before Flop (didn't bet)
Seat 7: BlOnDhOlIc folded before Flop (didn't bet)
Seat 8: Suhoff76 folded before Flop (didn't bet)
Seat 9: Medic8681 folded before Flop (didn't bet)



PokerStars Zoom Hand #84298485414:  Hold'em No Limit ($0.10/$0.25) - 2012/08/05 13:16:56 JST [2012/08/05 0:16:56 ET]
Table 'Whirlpool' 9-max Seat #1 is the button
Seat 1: seula i ($58.66 in chips) 
Seat 2: chiyuki ($46.28 in chips) 
Seat 3: mikifeio ($46.79 in chips) 
Seat 4: wtu1986 ($25 in chips) 
Seat 5: Loholov ($16.43 in chips) 
Seat 6: TraderYao ($24.90 in chips) 
Seat 7: KeLevro0 ($12.32 in chips) 
Seat 8: BlOnDhOlIc ($25 in chips) 
Seat 9: ShockLaMuc ($24.65 in chips) 
chiyuki: posts small blind $0.10
mikifeio: posts big blind $0.25
*** HOLE CARDS ***
Dealt to chiyuki [9h 3s]
wtu1986: folds 
Loholov: folds 
TraderYao: folds 
KeLevro0: folds 
BlOnDhOlIc: folds 
ShockLaMuc: folds 
seula i: raises $0.75 to $1
chiyuki: folds 
mikifeio: calls $0.75
*** FLOP *** [Ah Kc Ts]
mikifeio: checks 
seula i: bets $1.75
mikifeio: folds 
Uncalled bet ($1.75) returned to seula i
seula i collected $2.01 from pot
seula i: doesn't show hand 
*** SUMMARY ***
Total pot $2.10 | Rake $0.09 
Board [Ah Kc Ts]
Seat 1: seula i (button) collected ($2.01)
Seat 2: chiyuki (small blind) folded before Flop
Seat 3: mikifeio (big blind) folded on the Flop
Seat 4: wtu1986 folded before Flop (didn't bet)
Seat 5: Loholov folded before Flop (didn't bet)
Seat 6: TraderYao folded before Flop (didn't bet)
Seat 7: KeLevro0 folded before Flop (didn't bet)
Seat 8: BlOnDhOlIc folded before Flop (didn't bet)
Seat 9: ShockLaMuc folded before Flop (didn't bet)



PokerStars Zoom Hand #84298487107:  Hold'em No Limit ($0.10/$0.25) - 2012/08/05 13:17:02 JST [2012/08/05 0:17:02 ET]
Table 'Whirlpool' 9-max Seat #1 is the button
Seat 1: wtu1986 ($25.89 in chips) 
Seat 2: masterkoolb ($12.95 in chips) 
Seat 3: a_tasmanian ($68.02 in chips) 
Seat 4: BlOnDhOlIc ($25 in chips) 
Seat 5: Zugrug ($26.50 in chips) 
Seat 6: PetitAlejo ($29.85 in chips) 
Seat 7: chiyuki ($46.18 in chips) 
Seat 8: TErr18 ($26.67 in chips) 
Seat 9: Roglus ($42.71 in chips) 
masterkoolb: posts small blind $0.10
a_tasmanian: posts big blind $0.25
*** HOLE CARDS ***
Dealt to chiyuki [7d Ac]
BlOnDhOlIc: raises $0.25 to $0.50
Zugrug: folds 
PetitAlejo: folds 
chiyuki: folds 
TErr18: folds 
Roglus: folds 
wtu1986: folds 
masterkoolb: raises $1.50 to $2
a_tasmanian: folds 
BlOnDhOlIc: calls $1.50
*** FLOP *** [4d 6s 7h]
masterkoolb: bets $3.04
BlOnDhOlIc: folds 
Uncalled bet ($3.04) returned to masterkoolb
masterkoolb collected $4.06 from pot
masterkoolb: doesn't show hand 
*** SUMMARY ***
Total pot $4.25 | Rake $0.19 
Board [4d 6s 7h]
Seat 1: wtu1986 (button) folded before Flop (didn't bet)
Seat 2: masterkoolb (small blind) collected ($4.06)
Seat 3: a_tasmanian (big blind) folded before Flop
Seat 4: BlOnDhOlIc folded on the Flop
Seat 5: Zugrug folded before Flop (didn't bet)
Seat 6: PetitAlejo folded before Flop (didn't bet)
Seat 7: chiyuki folded before Flop (didn't bet)
Seat 8: TErr18 folded before Flop (didn't bet)
Seat 9: Roglus folded before Flop (didn't bet)



PokerStars Zoom Hand #84298482704:  Hold'em No Limit ($0.10/$0.25) - 2012/08/05 13:16:45 JST [2012/08/05 0:16:45 ET]
Table 'Whirlpool' 9-max Seat #1 is the button
Seat 1: chiyuki ($46.28 in chips) 
Seat 2: goldstone ($24.25 in chips) 
Seat 3: bigrasbig ($68.63 in chips) 
Seat 4: petersmiths ($36.33 in chips) 
Seat 5: seula i ($78.14 in chips) 
Seat 6: TraderYao ($24.90 in chips) 
Seat 7: Rodina-Kr ($25 in chips) 
Seat 8: deadmoneykid ($25.10 in chips) 
Seat 9: Suhoff76 ($25 in chips) 
goldstone: posts small blind $0.10
bigrasbig: posts big blind $0.25
*** HOLE CARDS ***
Dealt to chiyuki [4c Jh]
petersmiths: folds 
seula i: folds 
TraderYao: folds 
Rodina-Kr: folds 
bigrasbig said, "lol"
deadmoneykid: folds 
Suhoff76: folds 
chiyuki: folds 
goldstone: raises $0.30 to $0.55
bigrasbig: calls $0.30
*** FLOP *** [As 3c 2d]
goldstone: bets $0.49
bigrasbig: calls $0.49
*** TURN *** [As 3c 2d] [6s]
goldstone: checks 
bigrasbig: checks 
*** RIVER *** [As 3c 2d 6s] [8s]
goldstone: bets $0.93
bigrasbig: calls $0.93
*** SHOW DOWN ***
goldstone: shows [Jc 6c] (a pair of Sixes)
bigrasbig: shows [Ac Jd] (a pair of Aces)
bigrasbig collected $3.76 from pot
*** SUMMARY ***
Total pot $3.94 | Rake $0.18 
Board [As 3c 2d 6s 8s]
Seat 1: chiyuki (button) folded before Flop (didn't bet)
Seat 2: goldstone (small blind) showed [Jc 6c] and lost with a pair of Sixes
Seat 3: bigrasbig (big blind) showed [Ac Jd] and won ($3.76) with a pair of Aces
Seat 4: petersmiths folded before Flop (didn't bet)
Seat 5: seula i folded before Flop (didn't bet)
Seat 6: TraderYao folded before Flop (didn't bet)
Seat 7: Rodina-Kr folded before Flop (didn't bet)
Seat 8: deadmoneykid folded before Flop (didn't bet)
Seat 9: Suhoff76 folded before Flop (didn't bet)



PokerStars Zoom Hand #84298489121:  Hold'em No Limit ($0.10/$0.25) - 2012/08/05 13:17:09 JST [2012/08/05 0:17:09 ET]
Table 'Whirlpool' 9-max Seat #1 is the button
Seat 1: Roglus ($42.71 in chips) 
Seat 2: PetitAlejo ($27.80 in chips) 
Seat 3: chiyuki ($46.18 in chips) 
Seat 4: Suhoff76 ($25 in chips) 
Seat 5: KeLevro0 ($12.50 in chips) 
Seat 6: kamikkaze ($48.85 in chips) 
Seat 7: deadmoneykid ($23.80 in chips) 
Seat 8: Medic8681 ($14.53 in chips) 
Seat 9: Rodina-Kr ($25 in chips) 
PetitAlejo: posts small blind $0.10
chiyuki: posts big blind $0.25
*** HOLE CARDS ***
Dealt to chiyuki [8c Kh]
Suhoff76: folds 
KeLevro0: folds 
kamikkaze: folds 
deadmoneykid: folds 
Medic8681: folds 
Rodina-Kr: folds 
Roglus: raises $0.50 to $0.75
PetitAlejo: folds 
chiyuki: folds 
Uncalled bet ($0.50) returned to Roglus
Roglus collected $0.60 from pot
Roglus: doesn't show hand 
*** SUMMARY ***
Total pot $0.60 | Rake $0 
Seat 1: Roglus (button) collected ($0.60)
Seat 2: PetitAlejo (small blind) folded before Flop
Seat 3: chiyuki (big blind) folded before Flop
Seat 4: Suhoff76 folded before Flop (didn't bet)
Seat 5: KeLevro0 folded before Flop (didn't bet)
Seat 6: kamikkaze folded before Flop (didn't bet)
Seat 7: deadmoneykid folded before Flop (didn't bet)
Seat 8: Medic8681 folded before Flop (didn't bet)
Seat 9: Rodina-Kr folded before Flop (didn't bet)



PokerStars Zoom Hand #84298488241:  Hold'em No Limit ($0.10/$0.25) - 2012/08/05 13:17:06 JST [2012/08/05 0:17:06 ET]
Table 'Whirlpool' 9-max Seat #1 is the button
Seat 1: Zugrug ($26.50 in chips) 
Seat 2: fwani ($25 in chips) 
Seat 3: Jippyflip ($25.83 in chips) 
Seat 4: polk11 ($20.15 in chips) 
Seat 5: kamikkaze ($48.85 in chips) 
Seat 6: 5zzzz33 ($21.49 in chips) 
Seat 7: NastyMcNast ($42.42 in chips) 
Seat 8: chiyuki ($46.18 in chips) 
Seat 9: DooMSDaY1337 ($31.42 in chips) 
fwani: posts small blind $0.10
Jippyflip: posts big blind $0.25
*** HOLE CARDS ***
Dealt to chiyuki [4d 7c]
polk11: calls $0.25
kamikkaze: folds 
5zzzz33: folds 
NastyMcNast: folds 
chiyuki: folds 
DooMSDaY1337: folds 
Zugrug: folds 
fwani: calls $0.15
Jippyflip: checks 
*** FLOP *** [5s 6s Jd]
fwani: checks 
Jippyflip: checks 
polk11: bets $0.75
fwani: folds 
Jippyflip: folds 
Uncalled bet ($0.75) returned to polk11
polk11 collected $0.72 from pot
polk11: doesn't show hand 
*** SUMMARY ***
Total pot $0.75 | Rake $0.03 
Board [5s 6s Jd]
Seat 1: Zugrug (button) folded before Flop (didn't bet)
Seat 2: fwani (small blind) folded on the Flop
Seat 3: Jippyflip (big blind) folded on the Flop
Seat 4: polk11 collected ($0.72)
Seat 5: kamikkaze folded before Flop (didn't bet)
Seat 6: 5zzzz33 folded before Flop (didn't bet)
Seat 7: NastyMcNast folded before Flop (didn't bet)
Seat 8: chiyuki folded before Flop (didn't bet)
Seat 9: DooMSDaY1337 folded before Flop (didn't bet)



PokerStars Zoom Hand #84298498885:  Hold'em No Limit ($0.10/$0.25) - 2012/08/05 13:17:44 JST [2012/08/05 0:17:44 ET]
Table 'Whirlpool' 9-max Seat #1 is the button
Seat 1: BlOnDhOlIc ($36.92 in chips) 
Seat 2: Th3Fog ($56.18 in chips) 
Seat 3: Medic8681 ($14.14 in chips) 
Seat 4: silvno31 ($21.48 in chips) 
Seat 5: chiyuki ($45.93 in chips) 
Seat 6: MATT361 ($6.88 in chips) 
Seat 7: MibNe ($28.04 in chips) 
Seat 8: TraderYao ($25 in chips) 
Seat 9: Catrban ($33.21 in chips) 
Th3Fog: posts small blind $0.10
Medic8681: posts big blind $0.25
*** HOLE CARDS ***
Dealt to chiyuki [Js 7d]
silvno31: folds 
chiyuki: folds 
MATT361: folds 
MibNe: folds 
TraderYao: folds 
Catrban: folds 
BlOnDhOlIc: folds 
Th3Fog: raises $0.25 to $0.50
Medic8681: raises $1 to $1.50
Th3Fog: folds 
Uncalled bet ($1) returned to Medic8681
Medic8681 collected $1 from pot
Medic8681: doesn't show hand 
*** SUMMARY ***
Total pot $1 | Rake $0 
Seat 1: BlOnDhOlIc (button) folded before Flop (didn't bet)
Seat 2: Th3Fog (small blind) folded before Flop
Seat 3: Medic8681 (big blind) collected ($1)
Seat 4: silvno31 folded before Flop (didn't bet)
Seat 5: chiyuki folded before Flop (didn't bet)
Seat 6: MATT361 folded before Flop (didn't bet)
Seat 7: MibNe folded before Flop (didn't bet)
Seat 8: TraderYao folded before Flop (didn't bet)
Seat 9: Catrban folded before Flop (didn't bet)



PokerStars Zoom Hand #84298498079:  Hold'em No Limit ($0.10/$0.25) - 2012/08/05 13:17:41 JST [2012/08/05 0:17:41 ET]
Table 'Whirlpool' 9-max Seat #1 is the button
Seat 1: leo2095 ($15.45 in chips) 
Seat 2: nice.franki ($7.97 in chips) 
Seat 3: KeLevro0 ($12.40 in chips) 
Seat 4: DooMSDaY1337 ($55.74 in chips) 
Seat 5: TErr18 ($26.67 in chips) 
Seat 6: chiyuki ($45.93 in chips) 
Seat 7: envious_0007 ($15.49 in chips) 
Seat 8: NastyMcNast ($42.17 in chips) 
Seat 9: DT_Jesus ($27.30 in chips) 
nice.franki: posts small blind $0.10
KeLevro0: posts big blind $0.25
*** HOLE CARDS ***
Dealt to chiyuki [Qd Jh]
DooMSDaY1337: folds 
TErr18: folds 
chiyuki: folds 
envious_0007: folds 
NastyMcNast: folds 
DT_Jesus: folds 
leo2095: raises $0.25 to $0.50
nice.franki: folds 
KeLevro0: folds 
Uncalled bet ($0.25) returned to leo2095
leo2095 collected $0.60 from pot
leo2095: doesn't show hand 
leo2095 is disconnected 
*** SUMMARY ***
Total pot $0.60 | Rake $0 
Seat 1: leo2095 (button) collected ($0.60)
Seat 2: nice.franki (small blind) folded before Flop
Seat 3: KeLevro0 (big blind) folded before Flop
Seat 4: DooMSDaY1337 folded before Flop (didn't bet)
Seat 5: TErr18 folded before Flop (didn't bet)
Seat 6: chiyuki folded before Flop (didn't bet)
Seat 7: envious_0007 folded before Flop (didn't bet)
Seat 8: NastyMcNast folded before Flop (didn't bet)
Seat 9: DT_Jesus folded before Flop (didn't bet)



PokerStars Zoom Hand #84298501137:  Hold'em No Limit ($0.10/$0.25) - 2012/08/05 13:17:52 JST [2012/08/05 0:17:52 ET]
Table 'Whirlpool' 9-max Seat #1 is the button
Seat 1: vit 111 ($38.20 in chips) 
Seat 2: chiyuki ($45.93 in chips) 
Seat 3: BlackZafiro ($25 in chips) 
Seat 4: TraderYao ($25 in chips) 
Seat 5: Lasutchik ($10.34 in chips) 
Seat 6: Catrban ($33.21 in chips) 
Seat 7: PetitAlejo ($25.35 in chips) 
Seat 8: DooMSDaY1337 ($72.06 in chips) 
Seat 9: KeLevro0 ($12.15 in chips) 
chiyuki: posts small blind $0.10
BlackZafiro: posts big blind $0.25
*** HOLE CARDS ***
Dealt to chiyuki [4s 8h]
TraderYao: folds 
Lasutchik: raises $0.27 to $0.52
Catrban: folds 
PetitAlejo: folds 
DooMSDaY1337: folds 
KeLevro0: folds 
vit 111: folds 
chiyuki: folds 
BlackZafiro: folds 
Uncalled bet ($0.27) returned to Lasutchik
Lasutchik collected $0.60 from pot
Lasutchik: doesn't show hand 
*** SUMMARY ***
Total pot $0.60 | Rake $0 
Seat 1: vit 111 (button) folded before Flop (didn't bet)
Seat 2: chiyuki (small blind) folded before Flop
Seat 3: BlackZafiro (big blind) folded before Flop
Seat 4: TraderYao folded before Flop (didn't bet)
Seat 5: Lasutchik collected ($0.60)
Seat 6: Catrban folded before Flop (didn't bet)
Seat 7: PetitAlejo folded before Flop (didn't bet)
Seat 8: DooMSDaY1337 folded before Flop (didn't bet)
Seat 9: KeLevro0 folded before Flop (didn't bet)



PokerStars Zoom Hand #84298502846:  Hold'em No Limit ($0.10/$0.25) - 2012/08/05 13:17:58 JST [2012/08/05 0:17:58 ET]
Table 'Whirlpool' 9-max Seat #1 is the button
Seat 1: chiyuki ($45.83 in chips) 
Seat 2: TErr18 ($26.77 in chips) 
Seat 3: Zugrug ($28.69 in chips) 
Seat 4: KeLevro0 ($12.15 in chips) 
Seat 5: PetitAlejo ($25.35 in chips) 
Seat 6: nice.franki ($7.87 in chips) 
Seat 7: deadmoneykid ($25 in chips) 
Seat 8: Jippyflip ($25.58 in chips) 
Seat 9: BlOnDhOlIc ($25.25 in chips) 
TErr18: posts small blind $0.10
Zugrug: posts big blind $0.25
*** HOLE CARDS ***
Dealt to chiyuki [Tc Kc]
KeLevro0: folds 
PetitAlejo: folds 
nice.franki: folds 
deadmoneykid: folds 
Jippyflip: calls $0.25
BlOnDhOlIc: folds 
chiyuki: folds 
TErr18: folds 
Zugrug: checks 
*** FLOP *** [Qc 3s 5s]
Zugrug: checks 
Jippyflip: checks 
*** TURN *** [Qc 3s 5s] [7s]
Zugrug: checks 
Jippyflip: checks 
*** RIVER *** [Qc 3s 5s 7s] [6s]
Zugrug: checks 
Jippyflip: checks 
*** SHOW DOWN ***
Zugrug: shows [Th 3c] (a pair of Threes)
Jippyflip: shows [Js Kd] (a flush, Jack high)
Jippyflip collected $0.57 from pot
*** SUMMARY ***
Total pot $0.60 | Rake $0.03 
Board [Qc 3s 5s 7s 6s]
Seat 1: chiyuki (button) folded before Flop (didn't bet)
Seat 2: TErr18 (small blind) folded before Flop
Seat 3: Zugrug (big blind) showed [Th 3c] and lost with a pair of Threes
Seat 4: KeLevro0 folded before Flop (didn't bet)
Seat 5: PetitAlejo folded before Flop (didn't bet)
Seat 6: nice.franki folded before Flop (didn't bet)
Seat 7: deadmoneykid folded before Flop (didn't bet)
Seat 8: Jippyflip showed [Js Kd] and won ($0.57) with a flush, Jack high
Seat 9: BlOnDhOlIc folded before Flop (didn't bet)



PokerStars Zoom Hand #84298500311:  Hold'em No Limit ($0.10/$0.25) - 2012/08/05 13:17:49 JST [2012/08/05 0:17:49 ET]
Table 'Whirlpool' 9-max Seat #1 is the button
Seat 1: DT_Jesus ($27.30 in chips) 
Seat 2: MibNe ($28.04 in chips) 
Seat 3: ll_LaMeR_ll ($18.87 in chips) 
Seat 4: cR!Ma*aRm ($23.04 in chips) 
Seat 5: chiyuki ($45.93 in chips) 
Seat 6: TErr18 ($12.50 in chips) 
Seat 7: NastyMcNast ($42.17 in chips) 
Seat 8: Loholov ($29.14 in chips) 
Seat 9: BlOnDhOlIc ($51.28 in chips) 
MibNe: posts small blind $0.10
ll_LaMeR_ll: posts big blind $0.25
*** HOLE CARDS ***
Dealt to chiyuki [2s 9h]
cR!Ma*aRm: folds 
chiyuki: folds 
TErr18: folds 
NastyMcNast: folds 
Loholov: raises $0.50 to $0.75
BlOnDhOlIc: folds 
DT_Jesus: calls $0.75
MibNe: folds 
ll_LaMeR_ll: folds 
*** FLOP *** [5h Kd 9c]
Loholov: checks 
DT_Jesus: bets $0.50
Loholov: calls $0.50
*** TURN *** [5h Kd 9c] [7d]
Loholov: checks 
DT_Jesus: bets $0.80
Loholov: calls $0.80
*** RIVER *** [5h Kd 9c 7d] [5s]
Loholov: bets $2.75
DT_Jesus: raises $8.35 to $11.10
Loholov: calls $8.35
*** SHOW DOWN ***
DT_Jesus: shows [8d Qd] (a pair of Fives)
Loholov: shows [4d 5d] (three of a kind, Fives)
Loholov collected $25.45 from pot
*** SUMMARY ***
Total pot $26.65 | Rake $1.20 
Board [5h Kd 9c 7d 5s]
Seat 1: DT_Jesus (button) showed [8d Qd] and lost with a pair of Fives
Seat 2: MibNe (small blind) folded before Flop
Seat 3: ll_LaMeR_ll (big blind) folded before Flop
Seat 4: cR!Ma*aRm folded before Flop (didn't bet)
Seat 5: chiyuki folded before Flop (didn't bet)
Seat 6: TErr18 folded before Flop (didn't bet)
Seat 7: NastyMcNast folded before Flop (didn't bet)
Seat 8: Loholov showed [4d 5d] and won ($25.45) with three of a kind, Fives
Seat 9: BlOnDhOlIc folded before Flop (didn't bet)



PokerStars Zoom Hand #84298508166:  Hold'em No Limit ($0.10/$0.25) - 2012/08/05 13:18:18 JST [2012/08/05 0:18:18 ET]
Table 'Whirlpool' 9-max Seat #1 is the button
Seat 1: BlOnDhOlIc ($25.25 in chips) 
Seat 2: masterkoolb ($12.50 in chips) 
Seat 3: D@vidMed ($30.72 in chips) 
Seat 4: Medic8681 ($14.20 in chips) 
Seat 5: wtu1986 ($25.25 in chips) 
Seat 6: NastyMcNast ($25.87 in chips) 
Seat 7: Th3Fog ($68.57 in chips) 
Seat 8: RomarioJa ($8.82 in chips) 
Seat 9: chiyuki ($45.83 in chips) 
masterkoolb: posts small blind $0.10
D@vidMed: posts big blind $0.25
*** HOLE CARDS ***
Dealt to chiyuki [7h 3h]
Medic8681: folds 
wtu1986: folds 
NastyMcNast: folds 
Th3Fog: folds 
RomarioJa: folds 
chiyuki: folds 
BlOnDhOlIc: raises $0.25 to $0.50
masterkoolb: folds 
D@vidMed: calls $0.25
*** FLOP *** [8d 7d 8c]
D@vidMed: checks 
BlOnDhOlIc: bets $0.78
D@vidMed: folds 
Uncalled bet ($0.78) returned to BlOnDhOlIc
BlOnDhOlIc collected $1.05 from pot
BlOnDhOlIc: doesn't show hand 
*** SUMMARY ***
Total pot $1.10 | Rake $0.05 
Board [8d 7d 8c]
Seat 1: BlOnDhOlIc (button) collected ($1.05)
Seat 2: masterkoolb (small blind) folded before Flop
Seat 3: D@vidMed (big blind) folded on the Flop
Seat 4: Medic8681 folded before Flop (didn't bet)
Seat 5: wtu1986 folded before Flop (didn't bet)
Seat 6: NastyMcNast folded before Flop (didn't bet)
Seat 7: Th3Fog folded before Flop (didn't bet)
Seat 8: RomarioJa folded before Flop (didn't bet)
Seat 9: chiyuki folded before Flop (didn't bet)



PokerStars Zoom Hand #84298494176:  Hold'em No Limit ($0.10/$0.25) - 2012/08/05 13:17:27 JST [2012/08/05 0:17:27 ET]
Table 'Whirlpool' 9-max Seat #1 is the button
Seat 1: masterkoolb ($15.01 in chips) 
Seat 2: kamikkaze ($48.95 in chips) 
Seat 3: seula i ($78.49 in chips) 
Seat 4: Zugrug ($26.60 in chips) 
Seat 5: KeLevro0 ($12.50 in chips) 
Seat 6: wtu1986 ($25.45 in chips) 
Seat 7: Alvinpe85 ($33.43 in chips) 
Seat 8: RomarioJa ($5.62 in chips) 
Seat 9: chiyuki ($45.93 in chips) 
kamikkaze: posts small blind $0.10
seula i: posts big blind $0.25
*** HOLE CARDS ***
Dealt to chiyuki [6s Ad]
Zugrug: folds 
KeLevro0: folds 
wtu1986: folds 
Alvinpe85: folds 
RomarioJa: raises $0.37 to $0.62
chiyuki: folds 
masterkoolb: calls $0.62
kamikkaze: calls $0.52
seula i: calls $0.37
*** FLOP *** [Jd Jh 7d]
kamikkaze: checks 
seula i: checks 
RomarioJa: checks 
masterkoolb: checks 
*** TURN *** [Jd Jh 7d] [Kc]
kamikkaze: checks 
seula i: checks 
RomarioJa: checks 
masterkoolb: checks 
*** RIVER *** [Jd Jh 7d Kc] [3h]
kamikkaze: checks 
seula i: checks 
RomarioJa: bets $0.70
masterkoolb: folds 
kamikkaze: folds 
seula i: folds 
Uncalled bet ($0.70) returned to RomarioJa
RomarioJa collected $2.37 from pot
RomarioJa: doesn't show hand 
*** SUMMARY ***
Total pot $2.48 | Rake $0.11 
Board [Jd Jh 7d Kc 3h]
Seat 1: masterkoolb (button) folded on the River
Seat 2: kamikkaze (small blind) folded on the River
Seat 3: seula i (big blind) folded on the River
Seat 4: Zugrug folded before Flop (didn't bet)
Seat 5: KeLevro0 folded before Flop (didn't bet)
Seat 6: wtu1986 folded before Flop (didn't bet)
Seat 7: Alvinpe85 folded before Flop (didn't bet)
Seat 8: RomarioJa collected ($2.37)
Seat 9: chiyuki folded before Flop (didn't bet)



PokerStars Zoom Hand #84298510146:  Hold'em No Limit ($0.10/$0.25) - 2012/08/05 13:18:25 JST [2012/08/05 0:18:25 ET]
Table 'Whirlpool' 9-max Seat #1 is the button
Seat 1: Rodina-Kr ($25 in chips) 
Seat 2: DooMSDaY1337 ($54.99 in chips) 
Seat 3: silvno31 ($23.55 in chips) 
Seat 4: chiyuki ($45.83 in chips) 
Seat 5: 5zzzz33 ($21.39 in chips) 
Seat 6: seula i ($25.58 in chips) 
Seat 7: 4ydo yogurt ($20.10 in chips) 
Seat 8: Suhoff76 ($25 in chips) 
Seat 9: nice.franki ($10.65 in chips) 
DooMSDaY1337: posts small blind $0.10
silvno31: posts big blind $0.25
*** HOLE CARDS ***
Dealt to chiyuki [Jd Jc]
chiyuki: raises $0.50 to $0.75
5zzzz33: folds 
seula i: folds 
4ydo yogurt: folds 
Suhoff76: folds 
nice.franki: folds 
Rodina-Kr: calls $0.75
DooMSDaY1337: folds 
silvno31: calls $0.50
*** FLOP *** [2s 3h 4c]
silvno31: checks 
chiyuki: bets $1.25
Rodina-Kr: calls $1.25
silvno31: raises $21.55 to $22.80 and is all-in
chiyuki: folds 
Rodina-Kr: folds 
Uncalled bet ($21.55) returned to silvno31
silvno31 collected $5.83 from pot
silvno31: doesn't show hand 
*** SUMMARY ***
Total pot $6.10 | Rake $0.27 
Board [2s 3h 4c]
Seat 1: Rodina-Kr (button) folded on the Flop
Seat 2: DooMSDaY1337 (small blind) folded before Flop
Seat 3: silvno31 (big blind) collected ($5.83)
Seat 4: chiyuki folded on the Flop
Seat 5: 5zzzz33 folded before Flop (didn't bet)
Seat 6: seula i folded before Flop (didn't bet)
Seat 7: 4ydo yogurt folded before Flop (didn't bet)
Seat 8: Suhoff76 folded before Flop (didn't bet)
Seat 9: nice.franki folded before Flop (didn't bet)



PokerStars Zoom Hand #84298526945:  Hold'em No Limit ($0.10/$0.25) - 2012/08/05 13:19:26 JST [2012/08/05 0:19:26 ET]
Table 'Whirlpool' 9-max Seat #1 is the button
Seat 1: BlackZafiro ($25 in chips) 
Seat 2: TErr18 ($12.02 in chips) 
Seat 3: slickthis ($30.86 in chips) 
Seat 4: seula i ($56.32 in chips) 
Seat 5: wtu1986 ($25.10 in chips) 
Seat 6: BlOnDhOlIc ($36.07 in chips) 
Seat 7: Medic8681 ($15.31 in chips) 
Seat 8: chiyuki ($43.83 in chips) 
Seat 9: gAm813r ($27.17 in chips) 
TErr18: posts small blind $0.10
slickthis: posts big blind $0.25
*** HOLE CARDS ***
Dealt to chiyuki [6d 8c]
seula i: folds 
wtu1986: folds 
BlOnDhOlIc: folds 
Medic8681: folds 
chiyuki: folds 
gAm813r: folds 
BlackZafiro: raises $0.37 to $0.62
TErr18: folds 
slickthis: folds 
Uncalled bet ($0.37) returned to BlackZafiro
BlackZafiro collected $0.60 from pot
BlackZafiro: doesn't show hand 
*** SUMMARY ***
Total pot $0.60 | Rake $0 
Seat 1: BlackZafiro (button) collected ($0.60)
Seat 2: TErr18 (small blind) folded before Flop
Seat 3: slickthis (big blind) folded before Flop
Seat 4: seula i folded before Flop (didn't bet)
Seat 5: wtu1986 folded before Flop (didn't bet)
Seat 6: BlOnDhOlIc folded before Flop (didn't bet)
Seat 7: Medic8681 folded before Flop (didn't bet)
Seat 8: chiyuki folded before Flop (didn't bet)
Seat 9: gAm813r folded before Flop (didn't bet)



PokerStars Zoom Hand #84298528329:  Hold'em No Limit ($0.10/$0.25) - 2012/08/05 13:19:31 JST [2012/08/05 0:19:31 ET]
Table 'Whirlpool' 9-max Seat #1 is the button
Seat 1: deadmoneykid ($24.65 in chips) 
Seat 2: D@vidMed ($31.99 in chips) 
Seat 3: chiyuki ($43.83 in chips) 
Seat 4: ShockLaMuc ($24.43 in chips) 
Seat 5: BlOnDhOlIc ($36.07 in chips) 
Seat 6: KeLevro0 ($11.40 in chips) 
Seat 7: goldstone ($27.22 in chips) 
Seat 8: Loholov ($15 in chips) 
Seat 9: Suhoff76 ($25 in chips) 
D@vidMed: posts small blind $0.10
chiyuki: posts big blind $0.25
*** HOLE CARDS ***
Dealt to chiyuki [Jh 5h]
ShockLaMuc: folds 
BlOnDhOlIc: folds 
KeLevro0: folds 
goldstone: folds 
Loholov: folds 
Suhoff76: folds 
deadmoneykid: raises $0.25 to $0.50
D@vidMed: folds 
chiyuki: calls $0.25
*** FLOP *** [9s 7c 9h]
chiyuki: checks 
deadmoneykid: bets $0.50
chiyuki: raises $1.50 to $2
deadmoneykid: calls $1.50
*** TURN *** [9s 7c 9h] [8c]
chiyuki: bets $2.50
deadmoneykid: calls $2.50
*** RIVER *** [9s 7c 9h 8c] [Js]
chiyuki: checks 
deadmoneykid: bets $4
chiyuki: calls $4
*** SHOW DOWN ***
deadmoneykid: shows [9c Ah] (three of a kind, Nines)
chiyuki: mucks hand 
deadmoneykid collected $17.29 from pot
*** SUMMARY ***
Total pot $18.10 | Rake $0.81 
Board [9s 7c 9h 8c Js]
Seat 1: deadmoneykid (button) showed [9c Ah] and won ($17.29) with three of a kind, Nines
Seat 2: D@vidMed (small blind) folded before Flop
Seat 3: chiyuki (big blind) mucked [Jh 5h]
Seat 4: ShockLaMuc folded before Flop (didn't bet)
Seat 5: BlOnDhOlIc folded before Flop (didn't bet)
Seat 6: KeLevro0 folded before Flop (didn't bet)
Seat 7: goldstone folded before Flop (didn't bet)
Seat 8: Loholov folded before Flop (didn't bet)
Seat 9: Suhoff76 folded before Flop (didn't bet)



PokerStars Zoom Hand #84298557540:  Hold'em No Limit ($0.10/$0.25) - 2012/08/05 13:21:16 JST [2012/08/05 0:21:16 ET]
Table 'Whirlpool' 9-max Seat #1 is the button
Seat 1: chiyuki ($34.83 in chips) 
Seat 2: ShockLaMuc ($23.93 in chips) 
Seat 3: Lasutchik ($26.17 in chips) 
Seat 4: Th3Fog ($56.38 in chips) 
Seat 5: RomarioJa ($7.96 in chips) 
Seat 6: Suhoff76 ($26.14 in chips) 
Seat 7: wtu1986 ($25 in chips) 
Seat 8: Zugrug ($29.19 in chips) 
Seat 9: Catrban ($34.32 in chips) 
ShockLaMuc: posts small blind $0.10
Lasutchik: posts big blind $0.25
*** HOLE CARDS ***
Dealt to chiyuki [2c 3c]
Th3Fog: folds 
RomarioJa: folds 
Suhoff76: folds 
wtu1986: folds 
Zugrug: folds 
Catrban: folds 
chiyuki: folds 
ShockLaMuc: folds 
Uncalled bet ($0.15) returned to Lasutchik
Lasutchik collected $0.20 from pot
Lasutchik: doesn't show hand 
*** SUMMARY ***
Total pot $0.20 | Rake $0 
Seat 1: chiyuki (button) folded before Flop (didn't bet)
Seat 2: ShockLaMuc (small blind) folded before Flop
Seat 3: Lasutchik (big blind) collected ($0.20)
Seat 4: Th3Fog folded before Flop (didn't bet)
Seat 5: RomarioJa folded before Flop (didn't bet)
Seat 6: Suhoff76 folded before Flop (didn't bet)
Seat 7: wtu1986 folded before Flop (didn't bet)
Seat 8: Zugrug folded before Flop (didn't bet)
Seat 9: Catrban folded before Flop (didn't bet)



PokerStars Zoom Hand #84298553360:  Hold'em No Limit ($0.10/$0.25) - 2012/08/05 13:21:01 JST [2012/08/05 0:21:01 ET]
Table 'Whirlpool' 9-max Seat #1 is the button
Seat 1: hirozo ($25 in chips) 
Seat 2: RomarioJa ($10.42 in chips) 
Seat 3: ShockLaMuc ($24.18 in chips) 
Seat 4: deadmoneykid ($26.84 in chips) 
Seat 5: nice.franki ($13.77 in chips) 
Seat 6: PetitAlejo ($27.55 in chips) 
Seat 7: chiyuki ($34.83 in chips) 
Seat 8: masterkoolb ($13.24 in chips) 
Seat 9: seula i ($76.77 in chips) 
RomarioJa: posts small blind $0.10
ShockLaMuc: posts big blind $0.25
*** HOLE CARDS ***
Dealt to chiyuki [8s Ad]
deadmoneykid: raises $0.50 to $0.75
nice.franki: folds 
PetitAlejo: folds 
chiyuki: folds 
masterkoolb: folds 
seula i: folds 
hirozo: folds 
RomarioJa: folds 
ShockLaMuc: folds 
Uncalled bet ($0.50) returned to deadmoneykid
deadmoneykid collected $0.60 from pot
deadmoneykid: doesn't show hand 
*** SUMMARY ***
Total pot $0.60 | Rake $0 
Seat 1: hirozo (button) folded before Flop (didn't bet)
Seat 2: RomarioJa (small blind) folded before Flop
Seat 3: ShockLaMuc (big blind) folded before Flop
Seat 4: deadmoneykid collected ($0.60)
Seat 5: nice.franki folded before Flop (didn't bet)
Seat 6: PetitAlejo folded before Flop (didn't bet)
Seat 7: chiyuki folded before Flop (didn't bet)
Seat 8: masterkoolb folded before Flop (didn't bet)
Seat 9: seula i folded before Flop (didn't bet)



PokerStars Zoom Hand #84298558601:  Hold'em No Limit ($0.10/$0.25) - 2012/08/05 13:21:20 JST [2012/08/05 0:21:20 ET]
Table 'Whirlpool' 9-max Seat #1 is the button
Seat 1: Loholov ($15 in chips) 
Seat 2: fwani ($36.03 in chips) 
Seat 3: polk11 ($21 in chips) 
Seat 4: Rodina-Kr ($25.68 in chips) 
Seat 5: DooMSDaY1337 ($88.10 in chips) 
Seat 6: chiyuki ($34.83 in chips) 
Seat 7: Suhoff76 ($26.14 in chips) 
Seat 8: BlackZafiro ($25.35 in chips) 
Seat 9: ShockLaMuc ($23.83 in chips) 
fwani: posts small blind $0.10
polk11: posts big blind $0.25
*** HOLE CARDS ***
Dealt to chiyuki [As Qh]
Rodina-Kr: folds 
DooMSDaY1337: folds 
chiyuki: raises $0.50 to $0.75
Suhoff76: folds 
BlackZafiro: folds 
ShockLaMuc: folds 
Loholov: folds 
fwani: folds 
polk11: folds 
Uncalled bet ($0.50) returned to chiyuki
chiyuki collected $0.60 from pot
chiyuki: doesn't show hand 
*** SUMMARY ***
Total pot $0.60 | Rake $0 
Seat 1: Loholov (button) folded before Flop (didn't bet)
Seat 2: fwani (small blind) folded before Flop
Seat 3: polk11 (big blind) folded before Flop
Seat 4: Rodina-Kr folded before Flop (didn't bet)
Seat 5: DooMSDaY1337 folded before Flop (didn't bet)
Seat 6: chiyuki collected ($0.60)
Seat 7: Suhoff76 folded before Flop (didn't bet)
Seat 8: BlackZafiro folded before Flop (didn't bet)
Seat 9: ShockLaMuc folded before Flop (didn't bet)



PokerStars Zoom Hand #84298568199:  Hold'em No Limit ($0.10/$0.25) - 2012/08/05 13:21:55 JST [2012/08/05 0:21:55 ET]
Table 'Whirlpool' 9-max Seat #1 is the button
Seat 1: RomarioJa ($8.82 in chips) 
Seat 2: wtu1986 ($25 in chips) 
Seat 3: Alvinpe85 ($28.04 in chips) 
Seat 4: BlackZafiro ($25 in chips) 
Seat 5: hirozo ($25 in chips) 
Seat 6: slickthis ($34.39 in chips) 
Seat 7: chiyuki ($35.18 in chips) 
Seat 8: Suhoff76 ($31.33 in chips) 
Seat 9: Th3Fog ($28.62 in chips) 
wtu1986: posts small blind $0.10
Alvinpe85: posts big blind $0.25
*** HOLE CARDS ***
Dealt to chiyuki [9d Td]
BlackZafiro: folds 
hirozo: folds 
slickthis: folds 
chiyuki: folds 
Suhoff76: folds 
Th3Fog: folds 
RomarioJa: folds 
wtu1986: raises $0.37 to $0.62
Alvinpe85: raises $1.13 to $1.75
wtu1986: folds 
Uncalled bet ($1.13) returned to Alvinpe85
Alvinpe85 collected $1.24 from pot
Alvinpe85: doesn't show hand 
*** SUMMARY ***
Total pot $1.24 | Rake $0 
Seat 1: RomarioJa (button) folded before Flop (didn't bet)
Seat 2: wtu1986 (small blind) folded before Flop
Seat 3: Alvinpe85 (big blind) collected ($1.24)
Seat 4: BlackZafiro folded before Flop (didn't bet)
Seat 5: hirozo folded before Flop (didn't bet)
Seat 6: slickthis folded before Flop (didn't bet)
Seat 7: chiyuki folded before Flop (didn't bet)
Seat 8: Suhoff76 folded before Flop (didn't bet)
Seat 9: Th3Fog folded before Flop (didn't bet)



PokerStars Zoom Hand #84298574639:  Hold'em No Limit ($0.10/$0.25) - 2012/08/05 13:22:18 JST [2012/08/05 0:22:18 ET]
Table 'Whirlpool' 9-max Seat #1 is the button
Seat 1: diez007 ($24.75 in chips) 
Seat 2: Medic8681 ($13.11 in chips) 
Seat 3: chiyuki ($35.08 in chips) 
Seat 4: DooMSDaY1337 ($25 in chips) 
Seat 5: Zugrug ($39.91 in chips) 
Seat 6: Suhoff76 ($25 in chips) 
Seat 7: RomarioJa ($7.61 in chips) 
Seat 8: ll_LaMeR_ll ($25.15 in chips) 
Seat 9: D@vidMed ($33.33 in chips) 
Medic8681: posts small blind $0.10
chiyuki: posts big blind $0.25
*** HOLE CARDS ***
Dealt to chiyuki [7s Kc]
DooMSDaY1337: folds 
Zugrug: folds 
Suhoff76: raises $0.50 to $0.75
RomarioJa: folds 
ll_LaMeR_ll: folds 
D@vidMed: folds 
diez007: folds 
Medic8681: folds 
chiyuki: folds 
Uncalled bet ($0.50) returned to Suhoff76
Suhoff76 collected $0.60 from pot
Suhoff76: doesn't show hand 
*** SUMMARY ***
Total pot $0.60 | Rake $0 
Seat 1: diez007 (button) folded before Flop (didn't bet)
Seat 2: Medic8681 (small blind) folded before Flop
Seat 3: chiyuki (big blind) folded before Flop
Seat 4: DooMSDaY1337 folded before Flop (didn't bet)
Seat 5: Zugrug folded before Flop (didn't bet)
Seat 6: Suhoff76 collected ($0.60)
Seat 7: RomarioJa folded before Flop (didn't bet)
Seat 8: ll_LaMeR_ll folded before Flop (didn't bet)
Seat 9: D@vidMed folded before Flop (didn't bet)



PokerStars Zoom Hand #84298566236:  Hold'em No Limit ($0.10/$0.25) - 2012/08/05 13:21:48 JST [2012/08/05 0:21:48 ET]
Table 'Whirlpool' 9-max Seat #1 is the button
Seat 1: RomarioJa ($7.86 in chips) 
Seat 2: fwani ($27.77 in chips) 
Seat 3: MATT361 ($8.53 in chips) 
Seat 4: deadmoneykid ($32.94 in chips) 
Seat 5: chiyuki ($35.18 in chips) 
Seat 6: Paranoix1990 ($25.49 in chips) 
Seat 7: Loholov ($15 in chips) 
Seat 8: luyifei ($17.45 in chips) 
Seat 9: masterkoolb ($12.60 in chips) 
fwani: posts small blind $0.10
MATT361: posts big blind $0.25
*** HOLE CARDS ***
Dealt to chiyuki [6h 9d]
deadmoneykid: folds 
chiyuki: folds 
Paranoix1990: folds 
Loholov: folds 
luyifei: calls $0.25
masterkoolb: raises $0.85 to $1.10
RomarioJa: folds 
fwani: folds 
MATT361: calls $0.85
luyifei: raises $1.15 to $2.25
masterkoolb: raises $10.35 to $12.60 and is all-in
MATT361: folds 
luyifei: calls $10.35
*** FLOP *** [4d Jh 2c]
*** TURN *** [4d Jh 2c] [Tc]
*** RIVER *** [4d Jh 2c Tc] [7c]
*** SHOW DOWN ***
luyifei: shows [Ah As] (a pair of Aces)
masterkoolb: mucks hand 
luyifei collected $25.21 from pot
*** SUMMARY ***
Total pot $26.40 | Rake $1.19 
Board [4d Jh 2c Tc 7c]
Seat 1: RomarioJa (button) folded before Flop (didn't bet)
Seat 2: fwani (small blind) folded before Flop
Seat 3: MATT361 (big blind) folded before Flop
Seat 4: deadmoneykid folded before Flop (didn't bet)
Seat 5: chiyuki folded before Flop (didn't bet)
Seat 6: Paranoix1990 folded before Flop (didn't bet)
Seat 7: Loholov folded before Flop (didn't bet)
Seat 8: luyifei showed [Ah As] and won ($25.21) with a pair of Aces
Seat 9: masterkoolb mucked [Ks Kc]



PokerStars Zoom Hand #84298582195:  Hold'em No Limit ($0.10/$0.25) - 2012/08/05 13:22:45 JST [2012/08/05 0:22:45 ET]
Table 'Whirlpool' 9-max Seat #1 is the button
Seat 1: leo2095 ($16.05 in chips) 
Seat 2: Medic8681 ($12.50 in chips) 
Seat 3: hirozo ($25.25 in chips) 
Seat 4: 4ydo yogurt ($12.15 in chips) 
Seat 5: seula i ($74.17 in chips) 
Seat 6: masterkoolb ($12.60 in chips) 
Seat 7: nice.franki ($13.42 in chips) 
Seat 8: gunbowler ($100.42 in chips) 
Seat 9: chiyuki ($34.83 in chips) 
Medic8681: posts small blind $0.10
hirozo: posts big blind $0.25
*** HOLE CARDS ***
Dealt to chiyuki [2h Jd]
4ydo yogurt: folds 
seula i: folds 
masterkoolb: folds 
nice.franki: folds 
gunbowler: folds 
chiyuki: folds 
leo2095: folds 
Medic8681: raises $0.50 to $0.75
hirozo: folds 
Uncalled bet ($0.50) returned to Medic8681
Medic8681 collected $0.50 from pot
Medic8681: doesn't show hand 
*** SUMMARY ***
Total pot $0.50 | Rake $0 
Seat 1: leo2095 (button) folded before Flop (didn't bet)
Seat 2: Medic8681 (small blind) collected ($0.50)
Seat 3: hirozo (big blind) folded before Flop
Seat 4: 4ydo yogurt folded before Flop (didn't bet)
Seat 5: seula i folded before Flop (didn't bet)
Seat 6: masterkoolb folded before Flop (didn't bet)
Seat 7: nice.franki folded before Flop (didn't bet)
Seat 8: gunbowler folded before Flop (didn't bet)
Seat 9: chiyuki folded before Flop (didn't bet)



PokerStars Zoom Hand #84298570716:  Hold'em No Limit ($0.10/$0.25) - 2012/08/05 13:22:04 JST [2012/08/05 0:22:04 ET]
Table 'Whirlpool' 9-max Seat #1 is the button
Seat 1: deadmoneykid ($23.39 in chips) 
Seat 2: chiyuki ($35.18 in chips) 
Seat 3: diez007 ($25 in chips) 
Seat 4: seula i ($74.27 in chips) 
Seat 5: Lasutchik ($10.92 in chips) 
Seat 6: NastyMcNast ($49.81 in chips) 
Seat 7: RomarioJa ($8.82 in chips) 
Seat 8: Loholov ($15 in chips) 
Seat 9: Zugrug ($36.86 in chips) 
chiyuki: posts small blind $0.10
diez007: posts big blind $0.25
*** HOLE CARDS ***
Dealt to chiyuki [7c Kh]
seula i: folds 
Lasutchik: raises $0.27 to $0.52
NastyMcNast: folds 
RomarioJa: folds 
Loholov: folds 
Zugrug: folds 
deadmoneykid: calls $0.52
chiyuki: folds 
diez007: folds 
*** FLOP *** [As 7s Qd]
Lasutchik: checks 
deadmoneykid: bets $1
Lasutchik: raises $1.69 to $2.69
deadmoneykid: raises $20.18 to $22.87 and is all-in
Lasutchik: folds 
Uncalled bet ($20.18) returned to deadmoneykid
deadmoneykid collected $6.47 from pot
deadmoneykid: doesn't show hand 
*** SUMMARY ***
Total pot $6.77 | Rake $0.30 
Board [As 7s Qd]
Seat 1: deadmoneykid (button) collected ($6.47)
Seat 2: chiyuki (small blind) folded before Flop
Seat 3: diez007 (big blind) folded before Flop
Seat 4: seula i folded before Flop (didn't bet)
Seat 5: Lasutchik folded on the Flop
Seat 6: NastyMcNast folded before Flop (didn't bet)
Seat 7: RomarioJa folded before Flop (didn't bet)
Seat 8: Loholov folded before Flop (didn't bet)
Seat 9: Zugrug folded before Flop (didn't bet)



PokerStars Zoom Hand #84298584899:  Hold'em No Limit ($0.10/$0.25) - 2012/08/05 13:22:56 JST [2012/08/05 0:22:56 ET]
Table 'Whirlpool' 9-max Seat #1 is the button
Seat 1: PetitAlejo ($25 in chips) 
Seat 2: Jene4kaBest ($13.28 in chips) 
Seat 3: kkbruins0408 ($11.84 in chips) 
Seat 4: Medic8681 ($14.43 in chips) 
Seat 5: silvno31 ($28.94 in chips) 
Seat 6: chiyuki ($34.83 in chips) 
Seat 7: Suhoff76 ($25 in chips) 
Seat 8: nice.franki ($10.85 in chips) 
Seat 9: Lasutchik ($27.18 in chips) 
Jene4kaBest: posts small blind $0.10
kkbruins0408: posts big blind $0.25
*** HOLE CARDS ***
Dealt to chiyuki [Ts 7c]
Medic8681: folds 
silvno31: folds 
chiyuki: folds 
Suhoff76: folds 
nice.franki: folds 
Lasutchik: raises $0.50 to $0.75
PetitAlejo: folds 
Jene4kaBest: folds 
kkbruins0408: folds 
Uncalled bet ($0.50) returned to Lasutchik
Lasutchik collected $0.60 from pot
Lasutchik: doesn't show hand 
*** SUMMARY ***
Total pot $0.60 | Rake $0 
Seat 1: PetitAlejo (button) folded before Flop (didn't bet)
Seat 2: Jene4kaBest (small blind) folded before Flop
Seat 3: kkbruins0408 (big blind) folded before Flop
Seat 4: Medic8681 folded before Flop (didn't bet)
Seat 5: silvno31 folded before Flop (didn't bet)
Seat 6: chiyuki folded before Flop (didn't bet)
Seat 7: Suhoff76 folded before Flop (didn't bet)
Seat 8: nice.franki folded before Flop (didn't bet)
Seat 9: Lasutchik collected ($0.60)



PokerStars Zoom Hand #84298583302:  Hold'em No Limit ($0.10/$0.25) - 2012/08/05 13:22:49 JST [2012/08/05 0:22:49 ET]
Table 'Whirlpool' 9-max Seat #1 is the button
Seat 1: KeLevro0 ($25.78 in chips) 
Seat 2: masterkoolb ($12.60 in chips) 
Seat 3: vit 111 ($36.31 in chips) 
Seat 4: 4ydo yogurt ($12.15 in chips) 
Seat 5: Loholov ($15 in chips) 
Seat 6: RomarioJa ($8.92 in chips) 
Seat 7: Zugrug ($39.66 in chips) 
Seat 8: chiyuki ($34.83 in chips) 
Seat 9: agurio ($25 in chips) 
masterkoolb: posts small blind $0.10
vit 111: posts big blind $0.25
*** HOLE CARDS ***
Dealt to chiyuki [7d Qd]
4ydo yogurt: raises $0.50 to $0.75
Loholov: raises $1.75 to $2.50
RomarioJa: folds 
Zugrug: folds 
chiyuki: folds 
agurio: folds 
KeLevro0: raises $23.28 to $25.78 and is all-in
masterkoolb: folds 
vit 111: folds 
4ydo yogurt: folds 
Loholov: calls $12.50 and is all-in
Uncalled bet ($10.78) returned to KeLevro0
*** FLOP *** [Jc 6d 9s]
*** TURN *** [Jc 6d 9s] [4d]
*** RIVER *** [Jc 6d 9s 4d] [8c]
*** SHOW DOWN ***
Loholov: shows [Kh Kc] (a pair of Kings)
KeLevro0: shows [As Ad] (a pair of Aces)
KeLevro0 collected $29.70 from pot
*** SUMMARY ***
Total pot $31.10 | Rake $1.40 
Board [Jc 6d 9s 4d 8c]
Seat 1: KeLevro0 (button) showed [As Ad] and won ($29.70) with a pair of Aces
Seat 2: masterkoolb (small blind) folded before Flop
Seat 3: vit 111 (big blind) folded before Flop
Seat 4: 4ydo yogurt folded before Flop
Seat 5: Loholov showed [Kh Kc] and lost with a pair of Kings
Seat 6: RomarioJa folded before Flop (didn't bet)
Seat 7: Zugrug folded before Flop (didn't bet)
Seat 8: chiyuki folded before Flop (didn't bet)
Seat 9: agurio folded before Flop (didn't bet)



PokerStars Zoom Hand #84298587138:  Hold'em No Limit ($0.10/$0.25) - 2012/08/05 13:23:04 JST [2012/08/05 0:23:04 ET]
Table 'Whirlpool' 9-max Seat #1 is the button
Seat 1: Th3Fog ($69.36 in chips) 
Seat 2: 4ydo yogurt ($11.40 in chips) 
Seat 3: seula i ($54.62 in chips) 
Seat 4: chiyuki ($34.83 in chips) 
Seat 5: Suhoff76 ($25 in chips) 
Seat 6: DT_Jesus ($13.39 in chips) 
Seat 7: BlackZafiro ($26.03 in chips) 
Seat 8: polk11 ($20.15 in chips) 
Seat 9: PetitAlejo ($25 in chips) 
4ydo yogurt: posts small blind $0.10
seula i: posts big blind $0.25
*** HOLE CARDS ***
Dealt to chiyuki [7c As]
chiyuki: folds 
Suhoff76: folds 
DT_Jesus: calls $0.25
BlackZafiro: calls $0.25
polk11: folds 
PetitAlejo: folds 
Th3Fog: folds 
4ydo yogurt: folds 
seula i: checks 
*** FLOP *** [Qs 2s 5d]
seula i: checks 
DT_Jesus: checks 
BlackZafiro: bets $0.50
seula i: folds 
DT_Jesus: folds 
Uncalled bet ($0.50) returned to BlackZafiro
BlackZafiro collected $0.81 from pot
BlackZafiro: doesn't show hand 
*** SUMMARY ***
Total pot $0.85 | Rake $0.04 
Board [Qs 2s 5d]
Seat 1: Th3Fog (button) folded before Flop (didn't bet)
Seat 2: 4ydo yogurt (small blind) folded before Flop
Seat 3: seula i (big blind) folded on the Flop
Seat 4: chiyuki folded before Flop (didn't bet)
Seat 5: Suhoff76 folded before Flop (didn't bet)
Seat 6: DT_Jesus folded on the Flop
Seat 7: BlackZafiro collected ($0.81)
Seat 8: polk11 folded before Flop (didn't bet)
Seat 9: PetitAlejo folded before Flop (didn't bet)



PokerStars Zoom Hand #84298592754:  Hold'em No Limit ($0.10/$0.25) - 2012/08/05 13:23:24 JST [2012/08/05 0:23:24 ET]
Table 'Whirlpool' 9-max Seat #1 is the button
Seat 1: masterkoolb ($12.50 in chips) 
Seat 2: chiyuki ($34.83 in chips) 
Seat 3: nice.franki ($9.90 in chips) 
Seat 4: Alvinpe85 ($28.56 in chips) 
Seat 5: DooMSDaY1337 ($25 in chips) 
Seat 6: munky3 ($5.86 in chips) 
Seat 7: TErr18 ($28.55 in chips) 
Seat 8: Roglus ($12.88 in chips) 
Seat 9: Zugrug ($36.41 in chips) 
chiyuki: posts small blind $0.10
nice.franki: posts big blind $0.25
*** HOLE CARDS ***
Dealt to chiyuki [2h Td]
Alvinpe85: folds 
DooMSDaY1337: folds 
munky3: folds 
TErr18: folds 
Roglus: raises $0.50 to $0.75
Zugrug: folds 
masterkoolb: folds 
chiyuki: folds 
nice.franki: folds 
Uncalled bet ($0.50) returned to Roglus
Roglus collected $0.60 from pot
Roglus: doesn't show hand 
*** SUMMARY ***
Total pot $0.60 | Rake $0 
Seat 1: masterkoolb (button) folded before Flop (didn't bet)
Seat 2: chiyuki (small blind) folded before Flop
Seat 3: nice.franki (big blind) folded before Flop
Seat 4: Alvinpe85 folded before Flop (didn't bet)
Seat 5: DooMSDaY1337 folded before Flop (didn't bet)
Seat 6: munky3 folded before Flop (didn't bet)
Seat 7: TErr18 folded before Flop (didn't bet)
Seat 8: Roglus collected ($0.60)
Seat 9: Zugrug folded before Flop (didn't bet)



PokerStars Zoom Hand #84298594184:  Hold'em No Limit ($0.10/$0.25) - 2012/08/05 13:23:29 JST [2012/08/05 0:23:29 ET]
Table 'Whirlpool' 9-max Seat #1 is the button
Seat 1: RomarioJa ($7.26 in chips) 
Seat 2: Zugrug ($40.01 in chips) 
Seat 3: BlOnDhOlIc ($33.34 in chips) 
Seat 4: agurio ($25 in chips) 
Seat 5: wtu1986 ($25.60 in chips) 
Seat 6: DooMSDaY1337 ($89.61 in chips) 
Seat 7: Paranoix1990 ($22.74 in chips) 
Seat 8: chiyuki ($34.73 in chips) 
Seat 9: deadmoneykid ($26.55 in chips) 
Zugrug: posts small blind $0.10
BlOnDhOlIc: posts big blind $0.25
*** HOLE CARDS ***
Dealt to chiyuki [As 4c]
agurio: folds 
wtu1986: folds 
DooMSDaY1337: raises $0.50 to $0.75
Paranoix1990: folds 
chiyuki: folds 
deadmoneykid: folds 
RomarioJa: folds 
Zugrug: folds 
BlOnDhOlIc: folds 
Uncalled bet ($0.50) returned to DooMSDaY1337
DooMSDaY1337 collected $0.60 from pot
DooMSDaY1337: doesn't show hand 
*** SUMMARY ***
Total pot $0.60 | Rake $0 
Seat 1: RomarioJa (button) folded before Flop (didn't bet)
Seat 2: Zugrug (small blind) folded before Flop
Seat 3: BlOnDhOlIc (big blind) folded before Flop
Seat 4: agurio folded before Flop (didn't bet)
Seat 5: wtu1986 folded before Flop (didn't bet)
Seat 6: DooMSDaY1337 collected ($0.60)
Seat 7: Paranoix1990 folded before Flop (didn't bet)
Seat 8: chiyuki folded before Flop (didn't bet)
Seat 9: deadmoneykid folded before Flop (didn't bet)



PokerStars Zoom Hand #84298597214:  Hold'em No Limit ($0.10/$0.25) - 2012/08/05 13:23:40 JST [2012/08/05 0:23:40 ET]
Table 'Whirlpool' 9-max Seat #1 is the button
Seat 1: Suhoff76 ($25 in chips) 
Seat 2: Catrban ($37.77 in chips) 
Seat 3: Lasutchik ($7.71 in chips) 
Seat 4: TErr18 ($11.59 in chips) 
Seat 5: nice.franki ($9.65 in chips) 
Seat 6: D@vidMed ($34.63 in chips) 
Seat 7: SlimeyGash ($22.66 in chips) 
Seat 8: ShockLaMuc ($23.99 in chips) 
Seat 9: chiyuki ($34.73 in chips) 
Catrban: posts small blind $0.10
Lasutchik: posts big blind $0.25
*** HOLE CARDS ***
Dealt to chiyuki [9h 4d]
TErr18: folds 
nice.franki: folds 
D@vidMed: raises $0.57 to $0.82
SlimeyGash: folds 
ShockLaMuc: folds 
chiyuki: folds 
Suhoff76: folds 
Catrban: folds 
Lasutchik: folds 
Uncalled bet ($0.57) returned to D@vidMed
D@vidMed collected $0.60 from pot
D@vidMed: doesn't show hand 
*** SUMMARY ***
Total pot $0.60 | Rake $0 
Seat 1: Suhoff76 (button) folded before Flop (didn't bet)
Seat 2: Catrban (small blind) folded before Flop
Seat 3: Lasutchik (big blind) folded before Flop
Seat 4: TErr18 folded before Flop (didn't bet)
Seat 5: nice.franki folded before Flop (didn't bet)
Seat 6: D@vidMed collected ($0.60)
Seat 7: SlimeyGash folded before Flop (didn't bet)
Seat 8: ShockLaMuc folded before Flop (didn't bet)
Seat 9: chiyuki folded before Flop (didn't bet)



PokerStars Zoom Hand #84298588572:  Hold'em No Limit ($0.10/$0.25) - 2012/08/05 13:23:09 JST [2012/08/05 0:23:09 ET]
Table 'Whirlpool' 9-max Seat #1 is the button
Seat 1: Suhoff76 ($25 in chips) 
Seat 2: softdesign ($56.13 in chips) 
Seat 3: fwani ($25.97 in chips) 
Seat 4: chiyuki ($34.83 in chips) 
Seat 5: TErr18 ($11.84 in chips) 
Seat 6: ShockLaMuc ($28.27 in chips) 
Seat 7: wtu1986 ($25.60 in chips) 
Seat 8: leo2095 ($15.80 in chips) 
Seat 9: diez007 ($24.65 in chips) 
softdesign: posts small blind $0.10
fwani: posts big blind $0.25
*** HOLE CARDS ***
Dealt to chiyuki [2h Kc]
chiyuki: folds 
TErr18: folds 
ShockLaMuc: folds 
wtu1986: folds 
leo2095: folds 
diez007: raises $0.62 to $0.87
Suhoff76: folds 
softdesign: calls $0.77
fwani: calls $0.62
*** FLOP *** [Ah 7h Ks]
softdesign: checks 
fwani: checks 
diez007: bets $2.25
softdesign: folds 
fwani: folds 
Uncalled bet ($2.25) returned to diez007
diez007 collected $2.49 from pot
diez007: doesn't show hand 
*** SUMMARY ***
Total pot $2.61 | Rake $0.12 
Board [Ah 7h Ks]
Seat 1: Suhoff76 (button) folded before Flop (didn't bet)
Seat 2: softdesign (small blind) folded on the Flop
Seat 3: fwani (big blind) folded on the Flop
Seat 4: chiyuki folded before Flop (didn't bet)
Seat 5: TErr18 folded before Flop (didn't bet)
Seat 6: ShockLaMuc folded before Flop (didn't bet)
Seat 7: wtu1986 folded before Flop (didn't bet)
Seat 8: leo2095 folded before Flop (didn't bet)
Seat 9: diez007 collected ($2.49)



PokerStars Zoom Hand #84298598337:  Hold'em No Limit ($0.10/$0.25) - 2012/08/05 13:23:44 JST [2012/08/05 0:23:44 ET]
Table 'Whirlpool' 9-max Seat #1 is the button
Seat 1: agurio ($25 in chips) 
Seat 2: NastyMcNast ($26.82 in chips) 
Seat 3: chiyuki ($34.73 in chips) 
Seat 4: Medic8681 ($13.74 in chips) 
Seat 5: 5zzzz33 ($14.74 in chips) 
Seat 6: puffy5533 ($15.08 in chips) 
Seat 7: KeLevro0 ($8.90 in chips) 
Seat 8: Suhoff76 ($25 in chips) 
Seat 9: Loholov ($15 in chips) 
NastyMcNast: posts small blind $0.10
chiyuki: posts big blind $0.25
*** HOLE CARDS ***
Dealt to chiyuki [Kd 6h]
Medic8681: folds 
5zzzz33: folds 
puffy5533: folds 
KeLevro0: folds 
Suhoff76: folds 
Loholov: folds 
agurio: folds 
NastyMcNast: raises $0.50 to $0.75
chiyuki: folds 
Uncalled bet ($0.50) returned to NastyMcNast
NastyMcNast collected $0.50 from pot
NastyMcNast: doesn't show hand 
*** SUMMARY ***
Total pot $0.50 | Rake $0 
Seat 1: agurio (button) folded before Flop (didn't bet)
Seat 2: NastyMcNast (small blind) collected ($0.50)
Seat 3: chiyuki (big blind) folded before Flop
Seat 4: Medic8681 folded before Flop (didn't bet)
Seat 5: 5zzzz33 folded before Flop (didn't bet)
Seat 6: puffy5533 folded before Flop (didn't bet)
Seat 7: KeLevro0 folded before Flop (didn't bet)
Seat 8: Suhoff76 folded before Flop (didn't bet)
Seat 9: Loholov folded before Flop (didn't bet)



PokerStars Zoom Hand #84298589962:  Hold'em No Limit ($0.10/$0.25) - 2012/08/05 13:23:14 JST [2012/08/05 0:23:14 ET]
Table 'Whirlpool' 9-max Seat #1 is the button
Seat 1: agurio ($25 in chips) 
Seat 2: deadmoneykid ($26.65 in chips) 
Seat 3: gunbowler ($100.77 in chips) 
Seat 4: chiyuki ($34.83 in chips) 
Seat 5: Rodina-Kr ($25.32 in chips) 
Seat 6: seula i ($73.92 in chips) 
Seat 7: ShockLaMuc ($28.27 in chips) 
Seat 8: TraderYao ($25 in chips) 
Seat 9: Medic8681 ($12.75 in chips) 
deadmoneykid: posts small blind $0.10
gunbowler: posts big blind $0.25
*** HOLE CARDS ***
Dealt to chiyuki [6s 7d]
chiyuki: folds 
Rodina-Kr: folds 
seula i: folds 
ShockLaMuc: folds 
TraderYao: folds 
Medic8681: raises $0.50 to $0.75
agurio: folds 
deadmoneykid: folds 
gunbowler: calls $0.50
*** FLOP *** [8d 9h 9s]
gunbowler: checks 
Medic8681: bets $0.75
gunbowler: calls $0.75
*** TURN *** [8d 9h 9s] [8s]
gunbowler: checks 
Medic8681: bets $1.50
gunbowler: calls $1.50
*** RIVER *** [8d 9h 9s 8s] [Ks]
gunbowler: checks 
Medic8681: bets $2.50
gunbowler: folds 
Uncalled bet ($2.50) returned to Medic8681
Medic8681 collected $5.83 from pot
Medic8681: doesn't show hand 
*** SUMMARY ***
Total pot $6.10 | Rake $0.27 
Board [8d 9h 9s 8s Ks]
Seat 1: agurio (button) folded before Flop (didn't bet)
Seat 2: deadmoneykid (small blind) folded before Flop
Seat 3: gunbowler (big blind) folded on the River
Seat 4: chiyuki folded before Flop (didn't bet)
Seat 5: Rodina-Kr folded before Flop (didn't bet)
Seat 6: seula i folded before Flop (didn't bet)
Seat 7: ShockLaMuc folded before Flop (didn't bet)
Seat 8: TraderYao folded before Flop (didn't bet)
Seat 9: Medic8681 collected ($5.83)



PokerStars Zoom Hand #84298591642:  Hold'em No Limit ($0.10/$0.25) - 2012/08/05 13:23:20 JST [2012/08/05 0:23:20 ET]
Table 'Whirlpool' 9-max Seat #1 is the button
Seat 1: chiyuki ($34.83 in chips) 
Seat 2: TraderYao ($25 in chips) 
Seat 3: Loholov ($20.94 in chips) 
Seat 4: Rodina-Kr ($25.32 in chips) 
Seat 5: goldstone ($31.49 in chips) 
Seat 6: PetitAlejo ($28.55 in chips) 
Seat 7: masterkoolb ($12.50 in chips) 
Seat 8: Th3Fog ($28.27 in chips) 
Seat 9: fwani ($26.13 in chips) 
TraderYao: posts small blind $0.10
Loholov: posts big blind $0.25
*** HOLE CARDS ***
Dealt to chiyuki [8c 5d]
Rodina-Kr: folds 
goldstone: raises $0.57 to $0.82
PetitAlejo: folds 
masterkoolb: folds 
Th3Fog: folds 
fwani: folds 
chiyuki: folds 
TraderYao: folds 
Loholov: calls $0.57
*** FLOP *** [Kc 4d 3c]
Loholov: checks 
goldstone: bets $1.14
Loholov: calls $1.14
*** TURN *** [Kc 4d 3c] [3d]
Loholov: checks 
goldstone: bets $3.37
Loholov: raises $4.13 to $7.50
goldstone: raises $16.57 to $24.07
Loholov: calls $11.48 and is all-in
Uncalled bet ($5.09) returned to goldstone
*** RIVER *** [Kc 4d 3c 3d] [8h]
*** SHOW DOWN ***
Loholov: shows [Ks Ad] (two pair, Kings and Threes)
goldstone: shows [Kd Ah] (two pair, Kings and Threes)
Loholov collected $20.05 from pot
goldstone collected $20.04 from pot
*** SUMMARY ***
Total pot $41.98 | Rake $1.89 
Board [Kc 4d 3c 3d 8h]
Seat 1: chiyuki (button) folded before Flop (didn't bet)
Seat 2: TraderYao (small blind) folded before Flop
Seat 3: Loholov (big blind) showed [Ks Ad] and won ($20.05) with two pair, Kings and Threes
Seat 4: Rodina-Kr folded before Flop (didn't bet)
Seat 5: goldstone showed [Kd Ah] and won ($20.04) with two pair, Kings and Threes
Seat 6: PetitAlejo folded before Flop (didn't bet)
Seat 7: masterkoolb folded before Flop (didn't bet)
Seat 8: Th3Fog folded before Flop (didn't bet)
Seat 9: fwani folded before Flop (didn't bet)



PokerStars Zoom Hand #84298608518:  Hold'em No Limit ($0.10/$0.25) - 2012/08/05 13:24:22 JST [2012/08/05 0:24:22 ET]
Table 'Whirlpool' 9-max Seat #1 is the button
Seat 1: fwani ($25.78 in chips) 
Seat 2: deadmoneykid ($38.39 in chips) 
Seat 3: Suhoff76 ($25.97 in chips) 
Seat 4: BlackZafiro ($26.59 in chips) 
Seat 5: chiyuki ($34.48 in chips) 
Seat 6: TraderYao ($31.59 in chips) 
Seat 7: Loholov ($20.05 in chips) 
Seat 8: MATT361 ($4.36 in chips) 
Seat 9: Zugrug ($34.01 in chips) 
deadmoneykid: posts small blind $0.10
Suhoff76: posts big blind $0.25
*** HOLE CARDS ***
Dealt to chiyuki [3d 6c]
BlackZafiro: folds 
chiyuki: folds 
TraderYao: folds 
Loholov: folds 
MATT361: folds 
Zugrug: folds 
fwani: folds 
deadmoneykid: folds 
Uncalled bet ($0.15) returned to Suhoff76
Suhoff76 collected $0.20 from pot
Suhoff76: doesn't show hand 
*** SUMMARY ***
Total pot $0.20 | Rake $0 
Seat 1: fwani (button) folded before Flop (didn't bet)
Seat 2: deadmoneykid (small blind) folded before Flop
Seat 3: Suhoff76 (big blind) collected ($0.20)
Seat 4: BlackZafiro folded before Flop (didn't bet)
Seat 5: chiyuki folded before Flop (didn't bet)
Seat 6: TraderYao folded before Flop (didn't bet)
Seat 7: Loholov folded before Flop (didn't bet)
Seat 8: MATT361 folded before Flop (didn't bet)
Seat 9: Zugrug folded before Flop (didn't bet)



PokerStars Zoom Hand #84298610139:  Hold'em No Limit ($0.10/$0.25) - 2012/08/05 13:24:28 JST [2012/08/05 0:24:28 ET]
Table 'Whirlpool' 9-max Seat #1 is the button
Seat 1: agurio ($25 in chips) 
Seat 2: chiyuki ($34.48 in chips) 
Seat 3: KeLevro0 ($10.69 in chips) 
Seat 4: TraderYao ($31.59 in chips) 
Seat 5: kamikkaze ($49.91 in chips) 
Seat 6: TErr18 ($28.55 in chips) 
Seat 7: deadmoneykid ($23.99 in chips) 
Seat 8: Jippyflip ($18.70 in chips) 
Seat 9: seula i ($25 in chips) 
chiyuki: posts small blind $0.10
KeLevro0: posts big blind $0.25
*** HOLE CARDS ***
Dealt to chiyuki [9c Ks]
TraderYao: folds 
kamikkaze: folds 
TErr18: folds 
deadmoneykid: folds 
Jippyflip: folds 
seula i: raises $0.75 to $1
agurio: folds 
chiyuki: folds 
KeLevro0: folds 
Uncalled bet ($0.75) returned to seula i
seula i collected $0.60 from pot
seula i: doesn't show hand 
*** SUMMARY ***
Total pot $0.60 | Rake $0 
Seat 1: agurio (button) folded before Flop (didn't bet)
Seat 2: chiyuki (small blind) folded before Flop
Seat 3: KeLevro0 (big blind) folded before Flop
Seat 4: TraderYao folded before Flop (didn't bet)
Seat 5: kamikkaze folded before Flop (didn't bet)
Seat 6: TErr18 folded before Flop (didn't bet)
Seat 7: deadmoneykid folded before Flop (didn't bet)
Seat 8: Jippyflip folded before Flop (didn't bet)
Seat 9: seula i collected ($0.60)



PokerStars Zoom Hand #84298604149:  Hold'em No Limit ($0.10/$0.25) - 2012/08/05 13:24:06 JST [2012/08/05 0:24:06 ET]
Table 'Whirlpool' 9-max Seat #1 is the button
Seat 1: DooMSDaY1337 ($89.71 in chips) 
Seat 2: eagie20 ($135.26 in chips) 
Seat 3: Zugrug ($39.81 in chips) 
Seat 4: RomarioJa ($8.57 in chips) 
Seat 5: KeLevro0 ($8.90 in chips) 
Seat 6: TraderYao ($25.10 in chips) 
Seat 7: chiyuki ($34.48 in chips) 
Seat 8: deadmoneykid ($23.99 in chips) 
Seat 9: PetitAlejo ($26.80 in chips) 
eagie20: posts small blind $0.10
Zugrug: posts big blind $0.25
*** HOLE CARDS ***
Dealt to chiyuki [7h 3h]
RomarioJa: folds 
KeLevro0: folds 
TraderYao: folds 
chiyuki: folds 
deadmoneykid: folds 
PetitAlejo: folds 
DooMSDaY1337: raises $0.50 to $0.75
eagie20: calls $0.65
Zugrug: calls $0.50
*** FLOP *** [9s 8d 4h]
eagie20: checks 
Zugrug: checks 
DooMSDaY1337: bets $1.07
eagie20: calls $1.07
Zugrug: folds 
*** TURN *** [9s 8d 4h] [Ks]
eagie20: checks 
DooMSDaY1337: bets $2.50
eagie20: calls $2.50
*** RIVER *** [9s 8d 4h Ks] [Jc]
eagie20: checks 
DooMSDaY1337: bets $7
eagie20: folds 
Uncalled bet ($7) returned to DooMSDaY1337
DooMSDaY1337 collected $8.97 from pot
DooMSDaY1337: doesn't show hand 
*** SUMMARY ***
Total pot $9.39 | Rake $0.42 
Board [9s 8d 4h Ks Jc]
Seat 1: DooMSDaY1337 (button) collected ($8.97)
Seat 2: eagie20 (small blind) folded on the River
Seat 3: Zugrug (big blind) folded on the Flop
Seat 4: RomarioJa folded before Flop (didn't bet)
Seat 5: KeLevro0 folded before Flop (didn't bet)
Seat 6: TraderYao folded before Flop (didn't bet)
Seat 7: chiyuki folded before Flop (didn't bet)
Seat 8: deadmoneykid folded before Flop (didn't bet)
Seat 9: PetitAlejo folded before Flop (didn't bet)



PokerStars Zoom Hand #84298606665:  Hold'em No Limit ($0.10/$0.25) - 2012/08/05 13:24:15 JST [2012/08/05 0:24:15 ET]
Table 'Whirlpool' 9-max Seat #1 is the button
Seat 1: nice.franki ($13.07 in chips) 
Seat 2: MibNe ($23.67 in chips) 
Seat 3: DooMSDaY1337 ($95.36 in chips) 
Seat 4: Roglus ($13.13 in chips) 
Seat 5: TraderYao ($31.59 in chips) 
Seat 6: chiyuki ($34.48 in chips) 
Seat 7: a_tasmanian ($76.58 in chips) 
Seat 8: silvno31 ($28.54 in chips) 
Seat 9: Lasutchik ($7.36 in chips) 
MibNe: posts small blind $0.10
DooMSDaY1337: posts big blind $0.25
*** HOLE CARDS ***
Dealt to chiyuki [Qs 8s]
Roglus: raises $0.50 to $0.75
TraderYao: folds 
chiyuki: folds 
a_tasmanian: raises $1 to $1.75
silvno31: folds 
Lasutchik: folds 
nice.franki: folds 
MibNe: folds 
DooMSDaY1337: folds 
Roglus: calls $1
*** FLOP *** [7c 7d 9d]
Roglus: checks 
a_tasmanian: bets $3.50
Roglus: calls $3.50
*** TURN *** [7c 7d 9d] [Kc]
Roglus: checks 
a_tasmanian: checks 
*** RIVER *** [7c 7d 9d Kc] [8d]
Roglus: bets $7.88 and is all-in
a_tasmanian: calls $7.88
*** SHOW DOWN ***
Roglus: shows [Ac Kh] (two pair, Kings and Sevens)
a_tasmanian: shows [Ks Kd] (a full house, Kings full of Sevens)
a_tasmanian collected $25.41 from pot
*** SUMMARY ***
Total pot $26.61 | Rake $1.20 
Board [7c 7d 9d Kc 8d]
Seat 1: nice.franki (button) folded before Flop (didn't bet)
Seat 2: MibNe (small blind) folded before Flop
Seat 3: DooMSDaY1337 (big blind) folded before Flop
Seat 4: Roglus showed [Ac Kh] and lost with two pair, Kings and Sevens
Seat 5: TraderYao folded before Flop (didn't bet)
Seat 6: chiyuki folded before Flop (didn't bet)
Seat 7: a_tasmanian showed [Ks Kd] and won ($25.41) with a full house, Kings full of Sevens
Seat 8: silvno31 folded before Flop (didn't bet)
Seat 9: Lasutchik folded before Flop (didn't bet)



PokerStars Zoom Hand #84298603329:  Hold'em No Limit ($0.10/$0.25) - 2012/08/05 13:24:03 JST [2012/08/05 0:24:03 ET]
Table 'Whirlpool' 9-max Seat #1 is the button
Seat 1: chiyuki ($34.48 in chips) 
Seat 2: BlOnDhOlIc ($33.09 in chips) 
Seat 3: a_tasmanian ($76.83 in chips) 
Seat 4: masterkoolb ($12.50 in chips) 
Seat 5: Paranoix1990 ($22.64 in chips) 
Seat 6: silvno31 ($28.54 in chips) 
Seat 7: Roglus ($13.13 in chips) 
Seat 8: Zugrug ($35.41 in chips) 
Seat 9: BlackZafiro ($26.59 in chips) 
BlOnDhOlIc: posts small blind $0.10
a_tasmanian: posts big blind $0.25
*** HOLE CARDS ***
Dealt to chiyuki [Qh 6s]
masterkoolb: raises $0.60 to $0.85
Paranoix1990: calls $0.85
silvno31: folds 
Roglus: folds 
Zugrug: folds 
BlackZafiro: folds 
chiyuki: folds 
BlOnDhOlIc: calls $0.75
a_tasmanian: folds 
*** FLOP *** [Qc Kc 7s]
BlOnDhOlIc: checks 
masterkoolb: checks 
Paranoix1990: checks 
*** TURN *** [Qc Kc 7s] [8d]
BlOnDhOlIc: checks 
masterkoolb: checks 
Paranoix1990: bets $0.25
BlOnDhOlIc: folds 
masterkoolb: calls $0.25
*** RIVER *** [Qc Kc 7s 8d] [Ah]
masterkoolb: checks 
Paranoix1990: checks 
*** SHOW DOWN ***
masterkoolb: shows [9h 9s] (a pair of Nines)
Paranoix1990: shows [Kd Td] (a pair of Kings)
Paranoix1990 collected $3.15 from pot
*** SUMMARY ***
Total pot $3.30 | Rake $0.15 
Board [Qc Kc 7s 8d Ah]
Seat 1: chiyuki (button) folded before Flop (didn't bet)
Seat 2: BlOnDhOlIc (small blind) folded on the Turn
Seat 3: a_tasmanian (big blind) folded before Flop
Seat 4: masterkoolb showed [9h 9s] and lost with a pair of Nines
Seat 5: Paranoix1990 showed [Kd Td] and won ($3.15) with a pair of Kings
Seat 6: silvno31 folded before Flop (didn't bet)
Seat 7: Roglus folded before Flop (didn't bet)
Seat 8: Zugrug folded before Flop (didn't bet)
Seat 9: BlackZafiro folded before Flop (didn't bet)



PokerStars Zoom Hand #84298617949:  Hold'em No Limit ($0.10/$0.25) - 2012/08/05 13:24:56 JST [2012/08/05 0:24:56 ET]
Table 'Whirlpool' 9-max Seat #1 is the button
Seat 1: Loholov ($19.95 in chips) 
Seat 2: KeLevro0 ($10.44 in chips) 
Seat 3: ShockLaMuc ($25.33 in chips) 
Seat 4: Lasutchik ($27.18 in chips) 
Seat 5: 4ydo yogurt ($7.63 in chips) 
Seat 6: ryanjp2323 ($9.88 in chips) 
Seat 7: jtedecaliss ($146.04 in chips) 
Seat 8: petersmiths ($32.13 in chips) 
Seat 9: chiyuki ($34.38 in chips) 
KeLevro0: posts small blind $0.10
ShockLaMuc: posts big blind $0.25
*** HOLE CARDS ***
Dealt to chiyuki [8c 6s]
Lasutchik: raises $0.37 to $0.62
4ydo yogurt: calls $0.62
ryanjp2323: folds 
jtedecaliss: folds 
petersmiths: calls $0.62
chiyuki: folds 
Loholov: folds 
KeLevro0: folds 
ShockLaMuc: folds 
*** FLOP *** [5h Js 3c]
Lasutchik: checks 
4ydo yogurt: bets $0.70
petersmiths: folds 
Lasutchik: calls $0.70
*** TURN *** [5h Js 3c] [3d]
Lasutchik: checks 
4ydo yogurt: bets $1.30
Lasutchik: folds 
Uncalled bet ($1.30) returned to 4ydo yogurt
4ydo yogurt collected $3.45 from pot
4ydo yogurt: doesn't show hand 
*** SUMMARY ***
Total pot $3.61 | Rake $0.16 
Board [5h Js 3c 3d]
Seat 1: Loholov (button) folded before Flop (didn't bet)
Seat 2: KeLevro0 (small blind) folded before Flop
Seat 3: ShockLaMuc (big blind) folded before Flop
Seat 4: Lasutchik folded on the Turn
Seat 5: 4ydo yogurt collected ($3.45)
Seat 6: ryanjp2323 folded before Flop (didn't bet)
Seat 7: jtedecaliss folded before Flop (didn't bet)
Seat 8: petersmiths folded on the Flop
Seat 9: chiyuki folded before Flop (didn't bet)



PokerStars Zoom Hand #84298616555:  Hold'em No Limit ($0.10/$0.25) - 2012/08/05 13:24:51 JST [2012/08/05 0:24:51 ET]
Table 'Whirlpool' 9-max Seat #1 is the button
Seat 1: BlOnDhOlIc ($25.35 in chips) 
Seat 2: deadmoneykid ($23.99 in chips) 
Seat 3: hirozo ($25.55 in chips) 
Seat 4: Alvinpe85 ($29.75 in chips) 
Seat 5: wtu1986 ($25.35 in chips) 
Seat 6: seula i ($54.37 in chips) 
Seat 7: KeLevro0 ($10.44 in chips) 
Seat 8: chiyuki ($34.38 in chips) 
Seat 9: MibNe ($23.57 in chips) 
deadmoneykid: posts small blind $0.10
hirozo: posts big blind $0.25
*** HOLE CARDS ***
Dealt to chiyuki [3c 4c]
Alvinpe85: folds 
wtu1986: folds 
seula i: raises $1 to $1.25
KeLevro0: folds 
chiyuki: folds 
MibNe: calls $1.25
BlOnDhOlIc: calls $1.25
deadmoneykid: folds 
hirozo: calls $1
*** FLOP *** [6s Th 7s]
hirozo: checks 
seula i: checks 
MibNe: bets $2.43
BlOnDhOlIc: raises $4.07 to $6.50
hirozo: raises $17.80 to $24.30 and is all-in
seula i: folds 
MibNe: folds 
BlOnDhOlIc: calls $17.60 and is all-in
Uncalled bet ($0.20) returned to hirozo
*** TURN *** [6s Th 7s] [7d]
*** RIVER *** [6s Th 7s 7d] [Ks]
*** SHOW DOWN ***
hirozo: shows [5s 4s] (a flush, King high)
BlOnDhOlIc: shows [6h 6d] (a full house, Sixes full of Sevens)
BlOnDhOlIc collected $53.73 from pot
hirozo is disconnected 
*** SUMMARY ***
Total pot $55.73 | Rake $2 
Board [6s Th 7s 7d Ks]
Seat 1: BlOnDhOlIc (button) showed [6h 6d] and won ($53.73) with a full house, Sixes full of Sevens
Seat 2: deadmoneykid (small blind) folded before Flop
Seat 3: hirozo (big blind) showed [5s 4s] and lost with a flush, King high
Seat 4: Alvinpe85 folded before Flop (didn't bet)
Seat 5: wtu1986 folded before Flop (didn't bet)
Seat 6: seula i folded on the Flop
Seat 7: KeLevro0 folded before Flop (didn't bet)
Seat 8: chiyuki folded before Flop (didn't bet)
Seat 9: MibNe folded on the Flop



PokerStars Zoom Hand #84298630520:  Hold'em No Limit ($0.10/$0.25) - 2012/08/05 13:25:42 JST [2012/08/05 0:25:42 ET]
Table 'Whirlpool' 9-max Seat #1 is the button
Seat 1: chiyuki ($33.88 in chips) 
Seat 2: a_tasmanian ($88.26 in chips) 
Seat 3: KeLevro0 ($10.34 in chips) 
Seat 4: fwani ($34.90 in chips) 
Seat 5: goldstone ($26.73 in chips) 
Seat 6: NastyMcNast ($28.37 in chips) 
Seat 7: Roglus ($46.43 in chips) 
Seat 8: luyifei ($27.64 in chips) 
Seat 9: BlackZafiro ($25.49 in chips) 
a_tasmanian: posts small blind $0.10
KeLevro0: posts big blind $0.25
*** HOLE CARDS ***
Dealt to chiyuki [2d Kc]
fwani: folds 
goldstone: folds 
NastyMcNast: folds 
Roglus: raises $0.50 to $0.75
luyifei: folds 
BlackZafiro: folds 
chiyuki: folds 
a_tasmanian: folds 
KeLevro0: folds 
Uncalled bet ($0.50) returned to Roglus
Roglus collected $0.60 from pot
Roglus: doesn't show hand 
*** SUMMARY ***
Total pot $0.60 | Rake $0 
Seat 1: chiyuki (button) folded before Flop (didn't bet)
Seat 2: a_tasmanian (small blind) folded before Flop
Seat 3: KeLevro0 (big blind) folded before Flop
Seat 4: fwani folded before Flop (didn't bet)
Seat 5: goldstone folded before Flop (didn't bet)
Seat 6: NastyMcNast folded before Flop (didn't bet)
Seat 7: Roglus collected ($0.60)
Seat 8: luyifei folded before Flop (didn't bet)
Seat 9: BlackZafiro folded before Flop (didn't bet)



PokerStars Zoom Hand #84298621576:  Hold'em No Limit ($0.10/$0.25) - 2012/08/05 13:25:09 JST [2012/08/05 0:25:09 ET]
Table 'Whirlpool' 9-max Seat #1 is the button
Seat 1: DooMSDaY1337 ($95.01 in chips) 
Seat 2: deadmoneykid ($25.73 in chips) 
Seat 3: chiyuki ($34.38 in chips) 
Seat 4: gedavaca ($38.04 in chips) 
Seat 5: KeLevro0 ($10.34 in chips) 
Seat 6: Loholov ($19.95 in chips) 
Seat 7: de harlekijn ($17.94 in chips) 
Seat 8: hirozo ($26.04 in chips) 
Seat 9: silvno31 ($27.44 in chips) 
deadmoneykid: posts small blind $0.10
chiyuki: posts big blind $0.25
*** HOLE CARDS ***
Dealt to chiyuki [4h 7d]
gedavaca: folds 
KeLevro0: folds 
Loholov: folds 
de harlekijn: raises $0.25 to $0.50
hirozo: calls $0.50
silvno31: folds 
DooMSDaY1337: folds 
deadmoneykid: folds 
chiyuki: calls $0.25
*** FLOP *** [Th 3h Jc]
chiyuki: checks 
de harlekijn: bets $0.75
hirozo: calls $0.75
chiyuki: folds 
*** TURN *** [Th 3h Jc] [9d]
de harlekijn: checks 
hirozo: bets $1.97
de harlekijn: folds 
Uncalled bet ($1.97) returned to hirozo
hirozo collected $2.96 from pot
hirozo: doesn't show hand 
hirozo is disconnected 
*** SUMMARY ***
Total pot $3.10 | Rake $0.14 
Board [Th 3h Jc 9d]
Seat 1: DooMSDaY1337 (button) folded before Flop (didn't bet)
Seat 2: deadmoneykid (small blind) folded before Flop
Seat 3: chiyuki (big blind) folded on the Flop
Seat 4: gedavaca folded before Flop (didn't bet)
Seat 5: KeLevro0 folded before Flop (didn't bet)
Seat 6: Loholov folded before Flop (didn't bet)
Seat 7: de harlekijn folded on the Turn
Seat 8: hirozo collected ($2.96)
Seat 9: silvno31 folded before Flop (didn't bet)



PokerStars Zoom Hand #84298631558:  Hold'em No Limit ($0.10/$0.25) - 2012/08/05 13:25:46 JST [2012/08/05 0:25:46 ET]
Table 'Whirlpool' 9-max Seat #1 is the button
Seat 1: Landybob ($24.75 in chips) 
Seat 2: wtu1986 ($25.10 in chips) 
Seat 3: polk11 ($20.60 in chips) 
Seat 4: ll_LaMeR_ll ($47.69 in chips) 
Seat 5: Medic8681 ($14.83 in chips) 
Seat 6: Catrban ($38.09 in chips) 
Seat 7: chiyuki ($33.88 in chips) 
Seat 8: Jippyflip ($18.35 in chips) 
Seat 9: nice.franki ($11.82 in chips) 
wtu1986: posts small blind $0.10
polk11: posts big blind $0.25
*** HOLE CARDS ***
Dealt to chiyuki [Js Jd]
ll_LaMeR_ll: folds 
Medic8681: folds 
Catrban has timed out
Catrban: folds 
chiyuki: raises $0.50 to $0.75
Jippyflip: folds 
nice.franki: folds 
Landybob: folds 
wtu1986: folds 
polk11: folds 
Uncalled bet ($0.50) returned to chiyuki
chiyuki collected $0.60 from pot
chiyuki: doesn't show hand 
*** SUMMARY ***
Total pot $0.60 | Rake $0 
Seat 1: Landybob (button) folded before Flop (didn't bet)
Seat 2: wtu1986 (small blind) folded before Flop
Seat 3: polk11 (big blind) folded before Flop
Seat 4: ll_LaMeR_ll folded before Flop (didn't bet)
Seat 5: Medic8681 folded before Flop (didn't bet)
Seat 6: Catrban folded before Flop (didn't bet)
Seat 7: chiyuki collected ($0.60)
Seat 8: Jippyflip folded before Flop (didn't bet)
Seat 9: nice.franki folded before Flop (didn't bet)



PokerStars Zoom Hand #84298642219:  Hold'em No Limit ($0.10/$0.25) - 2012/08/05 13:26:25 JST [2012/08/05 0:26:25 ET]
Table 'Whirlpool' 9-max Seat #1 is the button
Seat 1: Roglus ($16.75 in chips) 
Seat 2: Loholov ($15 in chips) 
Seat 3: hirozo ($25 in chips) 
Seat 4: Suhoff76 ($25 in chips) 
Seat 5: kkbruins0408 ($29.59 in chips) 
Seat 6: agurio ($30.01 in chips) 
Seat 7: chiyuki ($34.23 in chips) 
Seat 8: DooMSDaY1337 ($94.66 in chips) 
Seat 9: ll_LaMeR_ll ($46.87 in chips) 
Loholov: posts small blind $0.10
hirozo: posts big blind $0.25
*** HOLE CARDS ***
Dealt to chiyuki [8c 4c]
Suhoff76: folds 
kkbruins0408: folds 
agurio: folds 
chiyuki: folds 
DooMSDaY1337: raises $0.50 to $0.75
ll_LaMeR_ll: folds 
Roglus: folds 
Loholov: folds 
hirozo: folds 
Uncalled bet ($0.50) returned to DooMSDaY1337
DooMSDaY1337 collected $0.60 from pot
DooMSDaY1337: doesn't show hand 
*** SUMMARY ***
Total pot $0.60 | Rake $0 
Seat 1: Roglus (button) folded before Flop (didn't bet)
Seat 2: Loholov (small blind) folded before Flop
Seat 3: hirozo (big blind) folded before Flop
Seat 4: Suhoff76 folded before Flop (didn't bet)
Seat 5: kkbruins0408 folded before Flop (didn't bet)
Seat 6: agurio folded before Flop (didn't bet)
Seat 7: chiyuki folded before Flop (didn't bet)
Seat 8: DooMSDaY1337 collected ($0.60)
Seat 9: ll_LaMeR_ll folded before Flop (didn't bet)



PokerStars Zoom Hand #84298641104:  Hold'em No Limit ($0.10/$0.25) - 2012/08/05 13:26:21 JST [2012/08/05 0:26:21 ET]
Table 'Whirlpool' 9-max Seat #1 is the button
Seat 1: RomarioJa ($9.59 in chips) 
Seat 2: Medic8681 ($14.58 in chips) 
Seat 3: TraderYao ($27.10 in chips) 
Seat 4: gunbowler ($97.45 in chips) 
Seat 5: NastyMcNast ($46.86 in chips) 
Seat 6: chiyuki ($34.23 in chips) 
Seat 7: Lasutchik ($8.69 in chips) 
Seat 8: taksist889 ($21.44 in chips) 
Seat 9: Zugrug ($35.16 in chips) 
Medic8681: posts small blind $0.10
TraderYao: posts big blind $0.25
*** HOLE CARDS ***
Dealt to chiyuki [6c Th]
gunbowler: folds 
NastyMcNast: folds 
chiyuki: folds 
Lasutchik: folds 
taksist889: folds 
Zugrug: folds 
RomarioJa: folds 
Medic8681: raises $0.50 to $0.75
TraderYao: folds 
Uncalled bet ($0.50) returned to Medic8681
Medic8681 collected $0.50 from pot
Medic8681: doesn't show hand 
*** SUMMARY ***
Total pot $0.50 | Rake $0 
Seat 1: RomarioJa (button) folded before Flop (didn't bet)
Seat 2: Medic8681 (small blind) collected ($0.50)
Seat 3: TraderYao (big blind) folded before Flop
Seat 4: gunbowler folded before Flop (didn't bet)
Seat 5: NastyMcNast folded before Flop (didn't bet)
Seat 6: chiyuki folded before Flop (didn't bet)
Seat 7: Lasutchik folded before Flop (didn't bet)
Seat 8: taksist889 folded before Flop (didn't bet)
Seat 9: Zugrug folded before Flop (didn't bet)



PokerStars Zoom Hand #84298640007:  Hold'em No Limit ($0.10/$0.25) - 2012/08/05 13:26:17 JST [2012/08/05 0:26:17 ET]
Table 'Whirlpool' 9-max Seat #1 is the button
Seat 1: DooMSDaY1337 ($25.92 in chips) 
Seat 2: BlOnDhOlIc ($28.13 in chips) 
Seat 3: Suhoff76 ($26.32 in chips) 
Seat 4: seula i ($62.68 in chips) 
Seat 5: chiyuki ($34.23 in chips) 
Seat 6: KeLevro0 ($9.30 in chips) 
Seat 7: Landybob ($25 in chips) 
Seat 8: Lasutchik ($8.69 in chips) 
Seat 9: Th3Fog ($27.22 in chips) 
BlOnDhOlIc: posts small blind $0.10
Suhoff76: posts big blind $0.25
*** HOLE CARDS ***
Dealt to chiyuki [9s 4c]
seula i: folds 
chiyuki: folds 
KeLevro0: raises $0.42 to $0.67
Landybob: calls $0.67
Lasutchik: folds 
Th3Fog: folds 
DooMSDaY1337: raises $2.33 to $3
BlOnDhOlIc: folds 
Suhoff76: folds 
KeLevro0: folds 
Landybob: raises $22 to $25 and is all-in
DooMSDaY1337: calls $22
*** FLOP *** [6s 3h 8s]
*** TURN *** [6s 3h 8s] [7c]
*** RIVER *** [6s 3h 8s 7c] [7s]
*** SHOW DOWN ***
Landybob: shows [Kc Ks] (two pair, Kings and Sevens)
DooMSDaY1337: shows [Ad Ac] (two pair, Aces and Sevens)
DooMSDaY1337 collected $49.02 from pot
*** SUMMARY ***
Total pot $51.02 | Rake $2 
Board [6s 3h 8s 7c 7s]
Seat 1: DooMSDaY1337 (button) showed [Ad Ac] and won ($49.02) with two pair, Aces and Sevens
Seat 2: BlOnDhOlIc (small blind) folded before Flop
Seat 3: Suhoff76 (big blind) folded before Flop
Seat 4: seula i folded before Flop (didn't bet)
Seat 5: chiyuki folded before Flop (didn't bet)
Seat 6: KeLevro0 folded before Flop
Seat 7: Landybob showed [Kc Ks] and lost with two pair, Kings and Sevens
Seat 8: Lasutchik folded before Flop (didn't bet)
Seat 9: Th3Fog folded before Flop (didn't bet)



PokerStars Zoom Hand #84298643545:  Hold'em No Limit ($0.10/$0.25) - 2012/08/05 13:26:31 JST [2012/08/05 0:26:31 ET]
Table 'Whirlpool' 9-max Seat #1 is the button
Seat 1: Th3Fog ($43.32 in chips) 
Seat 2: PetitAlejo ($25.35 in chips) 
Seat 3: seula i ($25 in chips) 
Seat 4: Loholov ($15 in chips) 
Seat 5: agurio ($30.01 in chips) 
Seat 6: nice.franki ($3.82 in chips) 
Seat 7: kkbruins0408 ($29.59 in chips) 
Seat 8: simonzez ($63.87 in chips) 
Seat 9: chiyuki ($34.23 in chips) 
PetitAlejo: posts small blind $0.10
seula i: posts big blind $0.25
*** HOLE CARDS ***
Dealt to chiyuki [3c Ac]
Loholov: folds 
agurio: folds 
nice.franki: folds 
kkbruins0408: folds 
simonzez: calls $0.25
chiyuki: folds 
Th3Fog: folds 
PetitAlejo: folds 
seula i: checks 
*** FLOP *** [6h Qc Qh]
seula i: checks 
simonzez: bets $0.50
seula i: folds 
Uncalled bet ($0.50) returned to simonzez
simonzez collected $0.57 from pot
simonzez: doesn't show hand 
*** SUMMARY ***
Total pot $0.60 | Rake $0.03 
Board [6h Qc Qh]
Seat 1: Th3Fog (button) folded before Flop (didn't bet)
Seat 2: PetitAlejo (small blind) folded before Flop
Seat 3: seula i (big blind) folded on the Flop
Seat 4: Loholov folded before Flop (didn't bet)
Seat 5: agurio folded before Flop (didn't bet)
Seat 6: nice.franki folded before Flop (didn't bet)
Seat 7: kkbruins0408 folded before Flop (didn't bet)
Seat 8: simonzez collected ($0.57)
Seat 9: chiyuki folded before Flop (didn't bet)



PokerStars Zoom Hand #84298646393:  Hold'em No Limit ($0.10/$0.25) - 2012/08/05 13:26:41 JST [2012/08/05 0:26:41 ET]
Table 'Whirlpool' 9-max Seat #1 is the button
Seat 1: BlOnDhOlIc ($28.13 in chips) 
Seat 2: Roglus ($16.75 in chips) 
Seat 3: jtedecaliss ($144.94 in chips) 
Seat 4: chiyuki ($34.23 in chips) 
Seat 5: taksist889 ($21.34 in chips) 
Seat 6: DooMSDaY1337 ($95.01 in chips) 
Seat 7: KeLevro0 ($8.63 in chips) 
Seat 8: a_tasmanian ($87.31 in chips) 
Seat 9: PetitAlejo ($25.17 in chips) 
Roglus: posts small blind $0.10
jtedecaliss: posts big blind $0.25
*** HOLE CARDS ***
Dealt to chiyuki [9s 6c]
chiyuki: folds 
taksist889: raises $0.50 to $0.75
DooMSDaY1337: folds 
KeLevro0: calls $0.75
a_tasmanian: folds 
PetitAlejo: folds 
BlOnDhOlIc: folds 
Roglus: folds 
jtedecaliss: folds 
*** FLOP *** [Kh 7h 8s]
taksist889: checks 
KeLevro0: bets $0.99
taksist889: folds 
Uncalled bet ($0.99) returned to KeLevro0
KeLevro0 collected $1.77 from pot
KeLevro0: doesn't show hand 
*** SUMMARY ***
Total pot $1.85 | Rake $0.08 
Board [Kh 7h 8s]
Seat 1: BlOnDhOlIc (button) folded before Flop (didn't bet)
Seat 2: Roglus (small blind) folded before Flop
Seat 3: jtedecaliss (big blind) folded before Flop
Seat 4: chiyuki folded before Flop (didn't bet)
Seat 5: taksist889 folded on the Flop
Seat 6: DooMSDaY1337 folded before Flop (didn't bet)
Seat 7: KeLevro0 collected ($1.77)
Seat 8: a_tasmanian folded before Flop (didn't bet)
Seat 9: PetitAlejo folded before Flop (didn't bet)



PokerStars Zoom Hand #84298647223:  Hold'em No Limit ($0.10/$0.25) - 2012/08/05 13:26:44 JST [2012/08/05 0:26:44 ET]
Table 'Whirlpool' 9-max Seat #1 is the button
Seat 1: Suhoff76 ($26.49 in chips) 
Seat 2: chiyuki ($34.23 in chips) 
Seat 3: wtu1986 ($24.85 in chips) 
Seat 4: diez007 ($24.75 in chips) 
Seat 5: seula i ($62.58 in chips) 
Seat 6: gedavaca ($37.47 in chips) 
Seat 7: TraderYao ($31.69 in chips) 
Seat 8: RomarioJa ($9.49 in chips) 
Seat 9: ShockLaMuc ($36.50 in chips) 
chiyuki: posts small blind $0.10
wtu1986: posts big blind $0.25
*** HOLE CARDS ***
Dealt to chiyuki [6d Ad]
diez007: folds 
seula i: folds 
gedavaca: folds 
TraderYao: folds 
RomarioJa: folds 
ShockLaMuc: folds 
Suhoff76: folds 
chiyuki: raises $0.50 to $0.75
wtu1986: raises $1.35 to $2.10
chiyuki: folds 
Uncalled bet ($1.35) returned to wtu1986
wtu1986 collected $1.50 from pot
wtu1986: doesn't show hand 
*** SUMMARY ***
Total pot $1.50 | Rake $0 
Seat 1: Suhoff76 (button) folded before Flop (didn't bet)
Seat 2: chiyuki (small blind) folded before Flop
Seat 3: wtu1986 (big blind) collected ($1.50)
Seat 4: diez007 folded before Flop (didn't bet)
Seat 5: seula i folded before Flop (didn't bet)
Seat 6: gedavaca folded before Flop (didn't bet)
Seat 7: TraderYao folded before Flop (didn't bet)
Seat 8: RomarioJa folded before Flop (didn't bet)
Seat 9: ShockLaMuc folded before Flop (didn't bet)



PokerStars Zoom Hand #84298661782:  Hold'em No Limit ($0.10/$0.25) - 2012/08/05 13:27:38 JST [2012/08/05 0:27:38 ET]
Table 'Whirlpool' 9-max Seat #1 is the button
Seat 1: ll_LaMeR_ll ($27.57 in chips) 
Seat 2: Dejacob ($25.35 in chips) 
Seat 3: agurio ($27.17 in chips) 
Seat 4: chiyuki ($33.48 in chips) 
Seat 5: Suhoff76 ($26.24 in chips) 
Seat 6: Loholov ($15 in chips) 
Seat 7: TraderYao ($31.94 in chips) 
Seat 8: Lasutchik ($8.34 in chips) 
Seat 9: seula i ($25 in chips) 
Dejacob: posts small blind $0.10
agurio: posts big blind $0.25
*** HOLE CARDS ***
Dealt to chiyuki [Tc 5s]
chiyuki: folds 
Suhoff76: folds 
Loholov: folds 
TraderYao: folds 
Lasutchik: folds 
seula i: folds 
ll_LaMeR_ll: folds 
Dejacob: folds 
Uncalled bet ($0.15) returned to agurio
agurio collected $0.20 from pot
agurio: doesn't show hand 
*** SUMMARY ***
Total pot $0.20 | Rake $0 
Seat 1: ll_LaMeR_ll (button) folded before Flop (didn't bet)
Seat 2: Dejacob (small blind) folded before Flop
Seat 3: agurio (big blind) collected ($0.20)
Seat 4: chiyuki folded before Flop (didn't bet)
Seat 5: Suhoff76 folded before Flop (didn't bet)
Seat 6: Loholov folded before Flop (didn't bet)
Seat 7: TraderYao folded before Flop (didn't bet)
Seat 8: Lasutchik folded before Flop (didn't bet)
Seat 9: seula i folded before Flop (didn't bet)



PokerStars Zoom Hand #84298663182:  Hold'em No Limit ($0.10/$0.25) - 2012/08/05 13:27:44 JST [2012/08/05 0:27:44 ET]
Table 'Whirlpool' 9-max Seat #1 is the button
Seat 1: Loholov ($15 in chips) 
Seat 2: DooMSDaY1337 ($61.99 in chips) 
Seat 3: chiyuki ($33.48 in chips) 
Seat 4: Suhoff76 ($30.72 in chips) 
Seat 5: Medic8681 ($15.18 in chips) 
Seat 6: seula i ($53.12 in chips) 
Seat 7: PetitAlejo ($25 in chips) 
Seat 8: Zugrug ($33.96 in chips) 
Seat 9: Th3Fog ($67.51 in chips) 
DooMSDaY1337: posts small blind $0.10
chiyuki: posts big blind $0.25
*** HOLE CARDS ***
Dealt to chiyuki [5c 2c]
Suhoff76: folds 
Medic8681: raises $0.50 to $0.75
seula i: folds 
PetitAlejo: folds 
Zugrug: folds 
Th3Fog: folds 
Loholov: folds 
DooMSDaY1337: folds 
chiyuki: folds 
Uncalled bet ($0.50) returned to Medic8681
Medic8681 collected $0.60 from pot
Medic8681: doesn't show hand 
*** SUMMARY ***
Total pot $0.60 | Rake $0 
Seat 1: Loholov (button) folded before Flop (didn't bet)
Seat 2: DooMSDaY1337 (small blind) folded before Flop
Seat 3: chiyuki (big blind) folded before Flop
Seat 4: Suhoff76 folded before Flop (didn't bet)
Seat 5: Medic8681 collected ($0.60)
Seat 6: seula i folded before Flop (didn't bet)
Seat 7: PetitAlejo folded before Flop (didn't bet)
Seat 8: Zugrug folded before Flop (didn't bet)
Seat 9: Th3Fog folded before Flop (didn't bet)



PokerStars Zoom Hand #84298667288:  Hold'em No Limit ($0.10/$0.25) - 2012/08/05 13:27:59 JST [2012/08/05 0:27:59 ET]
Table 'Whirlpool' 9-max Seat #1 is the button
Seat 1: agurio ($27.27 in chips) 
Seat 2: BlackZafiro ($25 in chips) 
Seat 3: gedavaca ($40.07 in chips) 
Seat 4: silvno31 ($30.42 in chips) 
Seat 5: DooMSDaY1337 ($49.59 in chips) 
Seat 6: seula i ($61.33 in chips) 
Seat 7: slickthis ($33.03 in chips) 
Seat 8: chiyuki ($33.23 in chips) 
Seat 9: Suhoff76 ($30.47 in chips) 
BlackZafiro: posts small blind $0.10
gedavaca: posts big blind $0.25
*** HOLE CARDS ***
Dealt to chiyuki [8c 9d]
silvno31: folds 
DooMSDaY1337: folds 
seula i: raises $0.50 to $0.75
slickthis: folds 
chiyuki: folds 
Suhoff76: folds 
agurio: folds 
BlackZafiro: folds 
gedavaca: folds 
Uncalled bet ($0.50) returned to seula i
seula i collected $0.60 from pot
seula i: doesn't show hand 
*** SUMMARY ***
Total pot $0.60 | Rake $0 
Seat 1: agurio (button) folded before Flop (didn't bet)
Seat 2: BlackZafiro (small blind) folded before Flop
Seat 3: gedavaca (big blind) folded before Flop
Seat 4: silvno31 folded before Flop (didn't bet)
Seat 5: DooMSDaY1337 folded before Flop (didn't bet)
Seat 6: seula i collected ($0.60)
Seat 7: slickthis folded before Flop (didn't bet)
Seat 8: chiyuki folded before Flop (didn't bet)
Seat 9: Suhoff76 folded before Flop (didn't bet)



PokerStars Zoom Hand #84298668369:  Hold'em No Limit ($0.10/$0.25) - 2012/08/05 13:28:03 JST [2012/08/05 0:28:03 ET]
Table 'Whirlpool' 9-max Seat #1 is the button
Seat 1: fwani ($28.12 in chips) 
Seat 2: Suhoff76 ($30.47 in chips) 
Seat 3: nice.franki ($8.80 in chips) 
Seat 4: Roglus ($46.79 in chips) 
Seat 5: chiyuki ($33.23 in chips) 
Seat 6: slickthis ($33.03 in chips) 
Seat 7: Th3Fog ($67.51 in chips) 
Seat 8: DooMSDaY1337 ($49.59 in chips) 
Seat 9: agurio ($27.27 in chips) 
Suhoff76: posts small blind $0.10
nice.franki: posts big blind $0.25
*** HOLE CARDS ***
Dealt to chiyuki [Kh 9d]
Roglus: folds 
chiyuki: folds 
slickthis: folds 
Th3Fog: folds 
DooMSDaY1337: folds 
agurio: raises $0.50 to $0.75
fwani: folds 
Suhoff76: folds 
nice.franki: folds 
Uncalled bet ($0.50) returned to agurio
agurio collected $0.60 from pot
agurio: doesn't show hand 
*** SUMMARY ***
Total pot $0.60 | Rake $0 
Seat 1: fwani (button) folded before Flop (didn't bet)
Seat 2: Suhoff76 (small blind) folded before Flop
Seat 3: nice.franki (big blind) folded before Flop
Seat 4: Roglus folded before Flop (didn't bet)
Seat 5: chiyuki folded before Flop (didn't bet)
Seat 6: slickthis folded before Flop (didn't bet)
Seat 7: Th3Fog folded before Flop (didn't bet)
Seat 8: DooMSDaY1337 folded before Flop (didn't bet)
Seat 9: agurio collected ($0.60)



PokerStars Zoom Hand #84298669450:  Hold'em No Limit ($0.10/$0.25) - 2012/08/05 13:28:07 JST [2012/08/05 0:28:07 ET]
Table 'Whirlpool' 9-max Seat #1 is the button
Seat 1: chiyuki ($33.23 in chips) 
Seat 2: ShockLaMuc ($36.25 in chips) 
Seat 3: carlosrbr ($12.50 in chips) 
Seat 4: Zugrug ($33.96 in chips) 
Seat 5: nice.franki ($11.82 in chips) 
Seat 6: BlackZafiro ($27.05 in chips) 
Seat 7: silvno31 ($30.42 in chips) 
Seat 8: petersmiths ($29.96 in chips) 
Seat 9: Roglus ($46.79 in chips) 
ShockLaMuc: posts small blind $0.10
carlosrbr: posts big blind $0.25
*** HOLE CARDS ***
Dealt to chiyuki [Qd Kh]
Zugrug: raises $0.50 to $0.75
nice.franki: folds 
BlackZafiro: folds 
silvno31: calls $0.75
petersmiths: folds 
Roglus: folds 
chiyuki: folds 
ShockLaMuc: folds 
carlosrbr: calls $0.50
*** FLOP *** [2d 9d Qc]
carlosrbr: checks 
Zugrug: bets $2
silvno31: folds 
carlosrbr: folds 
Uncalled bet ($2) returned to Zugrug
Zugrug collected $2.24 from pot
Zugrug: doesn't show hand 
*** SUMMARY ***
Total pot $2.35 | Rake $0.11 
Board [2d 9d Qc]
Seat 1: chiyuki (button) folded before Flop (didn't bet)
Seat 2: ShockLaMuc (small blind) folded before Flop
Seat 3: carlosrbr (big blind) folded on the Flop
Seat 4: Zugrug collected ($2.24)
Seat 5: nice.franki folded before Flop (didn't bet)
Seat 6: BlackZafiro folded before Flop (didn't bet)
Seat 7: silvno31 folded on the Flop
Seat 8: petersmiths folded before Flop (didn't bet)
Seat 9: Roglus folded before Flop (didn't bet)



PokerStars Zoom Hand #84298672145:  Hold'em No Limit ($0.10/$0.25) - 2012/08/05 13:28:17 JST [2012/08/05 0:28:17 ET]
Table 'Whirlpool' 9-max Seat #1 is the button
Seat 1: ShockLaMuc ($22.14 in chips) 
Seat 2: luyifei ($25.92 in chips) 
Seat 3: hirozo ($25 in chips) 
Seat 4: Roglus ($17.76 in chips) 
Seat 5: deadmoneykid ($28.19 in chips) 
Seat 6: KeLevro0 ($11.75 in chips) 
Seat 7: chiyuki ($33.23 in chips) 
Seat 8: PetitAlejo ($25.17 in chips) 
Seat 9: Dejacob ($25.80 in chips) 
luyifei: posts small blind $0.10
hirozo: posts big blind $0.25
*** HOLE CARDS ***
Dealt to chiyuki [Qd Ad]
Roglus: folds 
deadmoneykid: folds 
KeLevro0: folds 
chiyuki: raises $0.50 to $0.75
PetitAlejo: folds 
Dejacob: folds 
ShockLaMuc: folds 
luyifei: raises $0.50 to $1.25
hirozo: folds 
chiyuki: calls $0.50
*** FLOP *** [2h 4d Ts]
luyifei: bets $0.75
chiyuki: calls $0.75
*** TURN *** [2h 4d Ts] [Qc]
luyifei: bets $1.25
chiyuki: raises $3.50 to $4.75
luyifei: folds 
Uncalled bet ($3.50) returned to chiyuki
chiyuki collected $6.45 from pot
chiyuki: doesn't show hand 
*** SUMMARY ***
Total pot $6.75 | Rake $0.30 
Board [2h 4d Ts Qc]
Seat 1: ShockLaMuc (button) folded before Flop (didn't bet)
Seat 2: luyifei (small blind) folded on the Turn
Seat 3: hirozo (big blind) folded before Flop
Seat 4: Roglus folded before Flop (didn't bet)
Seat 5: deadmoneykid folded before Flop (didn't bet)
Seat 6: KeLevro0 folded before Flop (didn't bet)
Seat 7: chiyuki collected ($6.45)
Seat 8: PetitAlejo folded before Flop (didn't bet)
Seat 9: Dejacob folded before Flop (didn't bet)



PokerStars Zoom Hand #84298689219:  Hold'em No Limit ($0.10/$0.25) - 2012/08/05 13:29:21 JST [2012/08/05 0:29:21 ET]
Table 'Whirlpool' 9-max Seat #1 is the button
Seat 1: wtu1986 ($25.35 in chips) 
Seat 2: Alvinpe85 ($57.41 in chips) 
Seat 3: BlOnDhOlIc ($26.72 in chips) 
Seat 4: agurio ($30.01 in chips) 
Seat 5: a_tasmanian ($87.82 in chips) 
Seat 6: fwani ($30.91 in chips) 
Seat 7: seula i ($61.93 in chips) 
Seat 8: luyifei ($22.67 in chips) 
Seat 9: chiyuki ($36.33 in chips) 
Alvinpe85: posts small blind $0.10
BlOnDhOlIc: posts big blind $0.25
*** HOLE CARDS ***
Dealt to chiyuki [3s 4c]
agurio: folds 
a_tasmanian: folds 
fwani: raises $0.35 to $0.60
seula i: folds 
luyifei: folds 
chiyuki: folds 
wtu1986: folds 
Alvinpe85: folds 
BlOnDhOlIc: folds 
Uncalled bet ($0.35) returned to fwani
fwani collected $0.60 from pot
fwani: doesn't show hand 
*** SUMMARY ***
Total pot $0.60 | Rake $0 
Seat 1: wtu1986 (button) folded before Flop (didn't bet)
Seat 2: Alvinpe85 (small blind) folded before Flop
Seat 3: BlOnDhOlIc (big blind) folded before Flop
Seat 4: agurio folded before Flop (didn't bet)
Seat 5: a_tasmanian folded before Flop (didn't bet)
Seat 6: fwani collected ($0.60)
Seat 7: seula i folded before Flop (didn't bet)
Seat 8: luyifei folded before Flop (didn't bet)
Seat 9: chiyuki folded before Flop (didn't bet)



PokerStars Zoom Hand #84298687887:  Hold'em No Limit ($0.10/$0.25) - 2012/08/05 13:29:16 JST [2012/08/05 0:29:16 ET]
Table 'Whirlpool' 9-max Seat #1 is the button
Seat 1: a_tasmanian ($87.82 in chips) 
Seat 2: chiyuki ($36.43 in chips) 
Seat 3: Dejacob ($25 in chips) 
Seat 4: TErr18 ($27 in chips) 
Seat 5: RomarioJa ($6.58 in chips) 
Seat 6: hirozo ($27.75 in chips) 
Seat 7: wtu1986 ($25.35 in chips) 
Seat 8: BlOnDhOlIc ($26.72 in chips) 
Seat 9: munky3 ($18.34 in chips) 
chiyuki: posts small blind $0.10
Dejacob: posts big blind $0.25
*** HOLE CARDS ***
Dealt to chiyuki [6d 4h]
TErr18: calls $0.25
RomarioJa: folds 
hirozo: folds 
wtu1986: folds 
BlOnDhOlIc: folds 
munky3: calls $0.25
a_tasmanian: folds 
chiyuki: folds 
Dejacob: checks 
*** FLOP *** [Kc Qd Td]
Dejacob: checks 
TErr18: checks 
munky3: checks 
*** TURN *** [Kc Qd Td] [7d]
Dejacob: checks 
TErr18: checks 
munky3: bets $0.50
Dejacob: folds 
TErr18: folds 
Uncalled bet ($0.50) returned to munky3
munky3 collected $0.81 from pot
munky3: doesn't show hand 
*** SUMMARY ***
Total pot $0.85 | Rake $0.04 
Board [Kc Qd Td 7d]
Seat 1: a_tasmanian (button) folded before Flop (didn't bet)
Seat 2: chiyuki (small blind) folded before Flop
Seat 3: Dejacob (big blind) folded on the Turn
Seat 4: TErr18 folded on the Turn
Seat 5: RomarioJa folded before Flop (didn't bet)
Seat 6: hirozo folded before Flop (didn't bet)
Seat 7: wtu1986 folded before Flop (didn't bet)
Seat 8: BlOnDhOlIc folded before Flop (didn't bet)
Seat 9: munky3 collected ($0.81)



PokerStars Zoom Hand #84298687095:  Hold'em No Limit ($0.10/$0.25) - 2012/08/05 13:29:13 JST [2012/08/05 0:29:13 ET]
Table 'Whirlpool' 9-max Seat #1 is the button
Seat 1: agurio ($30.01 in chips) 
Seat 2: deadmoneykid ($25.10 in chips) 
Seat 3: DooMSDaY1337 ($96.38 in chips) 
Seat 4: Jene4kaBest ($15.64 in chips) 
Seat 5: Alvinpe85 ($57.41 in chips) 
Seat 6: chiyuki ($36.43 in chips) 
Seat 7: PetitAlejo ($35.08 in chips) 
Seat 8: Nerkit ($12.50 in chips) 
Seat 9: KINGKILERACE ($18.97 in chips) 
deadmoneykid: posts small blind $0.10
DooMSDaY1337: posts big blind $0.25
*** HOLE CARDS ***
Dealt to chiyuki [6h Qh]
Jene4kaBest: folds 
Alvinpe85: folds 
chiyuki: folds 
PetitAlejo: folds 
Nerkit: folds 
KINGKILERACE: calls $0.25
agurio: folds 
deadmoneykid: folds 
DooMSDaY1337: checks 
*** FLOP *** [9s 4s 8c]
DooMSDaY1337: bets $0.25
KINGKILERACE: calls $0.25
*** TURN *** [9s 4s 8c] [Ah]
DooMSDaY1337: bets $0.52
KINGKILERACE: calls $0.52
*** RIVER *** [9s 4s 8c Ah] [Js]
DooMSDaY1337: checks 
KINGKILERACE: bets $1.50
DooMSDaY1337: folds 
Uncalled bet ($1.50) returned to KINGKILERACE
KINGKILERACE collected $2.04 from pot
KINGKILERACE: doesn't show hand 
*** SUMMARY ***
Total pot $2.14 | Rake $0.10 
Board [9s 4s 8c Ah Js]
Seat 1: agurio (button) folded before Flop (didn't bet)
Seat 2: deadmoneykid (small blind) folded before Flop
Seat 3: DooMSDaY1337 (big blind) folded on the River
Seat 4: Jene4kaBest folded before Flop (didn't bet)
Seat 5: Alvinpe85 folded before Flop (didn't bet)
Seat 6: chiyuki folded before Flop (didn't bet)
Seat 7: PetitAlejo folded before Flop (didn't bet)
Seat 8: Nerkit folded before Flop (didn't bet)
Seat 9: KINGKILERACE collected ($2.04)



PokerStars Zoom Hand #84298690817:  Hold'em No Limit ($0.10/$0.25) - 2012/08/05 13:29:27 JST [2012/08/05 0:29:27 ET]
Table 'Whirlpool' 9-max Seat #1 is the button
Seat 1: Rsonal ($24.18 in chips) 
Seat 2: eagie20 ($129.80 in chips) 
Seat 3: slapshot2011 ($44.96 in chips) 
Seat 4: chiyuki ($36.33 in chips) 
Seat 5: ladymadon107 ($24.58 in chips) 
Seat 6: NastyMcNast ($37.87 in chips) 
Seat 7: agurio ($30.01 in chips) 
Seat 8: TraderYao ($29.14 in chips) 
Seat 9: a_tasmanian ($87.82 in chips) 
eagie20: posts small blind $0.10
slapshot2011: posts big blind $0.25
*** HOLE CARDS ***
Dealt to chiyuki [Th 2s]
chiyuki: folds 
ladymadon107: folds 
NastyMcNast: folds 
agurio: folds 
TraderYao: folds 
a_tasmanian: folds 
Rsonal: calls $0.25
eagie20: raises $0.75 to $1
slapshot2011: folds 
Rsonal: calls $0.75
*** FLOP *** [2d 9c Jc]
eagie20: checks 
Rsonal: bets $2.25
eagie20: calls $2.25
*** TURN *** [2d 9c Jc] [4s]
eagie20: checks 
Rsonal: bets $20.93 and is all-in
eagie20: folds 
Uncalled bet ($20.93) returned to Rsonal
Rsonal collected $6.45 from pot
Rsonal: doesn't show hand 
*** SUMMARY ***
Total pot $6.75 | Rake $0.30 
Board [2d 9c Jc 4s]
Seat 1: Rsonal (button) collected ($6.45)
Seat 2: eagie20 (small blind) folded on the Turn
Seat 3: slapshot2011 (big blind) folded before Flop
Seat 4: chiyuki folded before Flop (didn't bet)
Seat 5: ladymadon107 folded before Flop (didn't bet)
Seat 6: NastyMcNast folded before Flop (didn't bet)
Seat 7: agurio folded before Flop (didn't bet)
Seat 8: TraderYao folded before Flop (didn't bet)
Seat 9: a_tasmanian folded before Flop (didn't bet)



PokerStars Zoom Hand #84298692439:  Hold'em No Limit ($0.10/$0.25) - 2012/08/05 13:29:33 JST [2012/08/05 0:29:33 ET]
Table 'Whirlpool' 9-max Seat #1 is the button
Seat 1: fwani ($28.22 in chips) 
Seat 2: ladymadon107 ($24.58 in chips) 
Seat 3: chiyuki ($36.33 in chips) 
Seat 4: cR!Ma*aRm ($24.67 in chips) 
Seat 5: Th3Fog ($67.16 in chips) 
Seat 6: luyifei ($22.67 in chips) 
Seat 7: Loholov ($15 in chips) 
Seat 8: BlackZafiro ($26.55 in chips) 
Seat 9: agurio ($30.01 in chips) 
ladymadon107: posts small blind $0.10
chiyuki: posts big blind $0.25
*** HOLE CARDS ***
Dealt to chiyuki [7s 7c]
cR!Ma*aRm: raises $0.25 to $0.50
Th3Fog: folds 
luyifei: folds 
Loholov: folds 
BlackZafiro: folds 
agurio: folds 
fwani: calls $0.50
ladymadon107: calls $0.40
chiyuki: calls $0.25
*** FLOP *** [Ac 3d 8h]
ladymadon107: checks 
chiyuki: checks 
cR!Ma*aRm: bets $0.75
fwani: folds 
ladymadon107: folds 
chiyuki: folds 
Uncalled bet ($0.75) returned to cR!Ma*aRm
cR!Ma*aRm collected $1.91 from pot
cR!Ma*aRm: doesn't show hand 
*** SUMMARY ***
Total pot $2 | Rake $0.09 
Board [Ac 3d 8h]
Seat 1: fwani (button) folded on the Flop
Seat 2: ladymadon107 (small blind) folded on the Flop
Seat 3: chiyuki (big blind) folded on the Flop
Seat 4: cR!Ma*aRm collected ($1.91)
Seat 5: Th3Fog folded before Flop (didn't bet)
Seat 6: luyifei folded before Flop (didn't bet)
Seat 7: Loholov folded before Flop (didn't bet)
Seat 8: BlackZafiro folded before Flop (didn't bet)
Seat 9: agurio folded before Flop (didn't bet)



PokerStars Zoom Hand #84298702932:  Hold'em No Limit ($0.10/$0.25) - 2012/08/05 13:30:12 JST [2012/08/05 0:30:12 ET]
Table 'Whirlpool' 9-max Seat #1 is the button
Seat 1: silvno31 ($29.03 in chips) 
Seat 2: luyifei ($21.67 in chips) 
Seat 3: ZSIDD ($17.77 in chips) 
Seat 4: simonzez ($54.05 in chips) 
Seat 5: Roglus ($46.39 in chips) 
Seat 6: chiyuki ($35.83 in chips) 
Seat 7: KeLevro0 ($15.91 in chips) 
Seat 8: NastyMcNast ($37.52 in chips) 
Seat 9: deadmoneykid ($24.57 in chips) 
luyifei: posts small blind $0.10
ZSIDD: posts big blind $0.25
*** HOLE CARDS ***
Dealt to chiyuki [Kc 4s]
simonzez: folds 
Roglus: folds 
chiyuki: folds 
KeLevro0: raises $0.42 to $0.67
NastyMcNast: folds 
deadmoneykid: folds 
silvno31: folds 
luyifei: calls $0.57
ZSIDD: folds 
*** FLOP *** [6h Qh 7d]
luyifei: bets $0.50
KeLevro0: calls $0.50
*** TURN *** [6h Qh 7d] [Qc]
luyifei: bets $0.75
KeLevro0: folds 
Uncalled bet ($0.75) returned to luyifei
luyifei collected $2.47 from pot
luyifei: doesn't show hand 
*** SUMMARY ***
Total pot $2.59 | Rake $0.12 
Board [6h Qh 7d Qc]
Seat 1: silvno31 (button) folded before Flop (didn't bet)
Seat 2: luyifei (small blind) collected ($2.47)
Seat 3: ZSIDD (big blind) folded before Flop
Seat 4: simonzez folded before Flop (didn't bet)
Seat 5: Roglus folded before Flop (didn't bet)
Seat 6: chiyuki folded before Flop (didn't bet)
Seat 7: KeLevro0 folded on the Turn
Seat 8: NastyMcNast folded before Flop (didn't bet)
Seat 9: deadmoneykid folded before Flop (didn't bet)



PokerStars Zoom Hand #84298705622:  Hold'em No Limit ($0.10/$0.25) - 2012/08/05 13:30:22 JST [2012/08/05 0:30:22 ET]
Table 'Whirlpool' 9-max Seat #1 is the button
Seat 1: chiyuki ($35.83 in chips) 
Seat 2: Nerkit ($11.75 in chips) 
Seat 3: Suhoff76 ($26.10 in chips) 
Seat 4: Catrban ($38.09 in chips) 
Seat 5: deadmoneykid ($23.55 in chips) 
Seat 6: BlackZafiro ($26.55 in chips) 
Seat 7: Alvinpe85 ($27.54 in chips) 
Seat 8: seula i ($51.03 in chips) 
Seat 9: hirozo ($36.34 in chips) 
Nerkit: posts small blind $0.10
Suhoff76: posts big blind $0.25
*** HOLE CARDS ***
Dealt to chiyuki [Th 6s]
Catrban: folds 
deadmoneykid: folds 
BlackZafiro: folds 
Alvinpe85: folds 
seula i: folds 
hirozo: folds 
chiyuki: folds 
Nerkit: folds 
Uncalled bet ($0.15) returned to Suhoff76
Suhoff76 collected $0.20 from pot
Suhoff76: doesn't show hand 
*** SUMMARY ***
Total pot $0.20 | Rake $0 
Seat 1: chiyuki (button) folded before Flop (didn't bet)
Seat 2: Nerkit (small blind) folded before Flop
Seat 3: Suhoff76 (big blind) collected ($0.20)
Seat 4: Catrban folded before Flop (didn't bet)
Seat 5: deadmoneykid folded before Flop (didn't bet)
Seat 6: BlackZafiro folded before Flop (didn't bet)
Seat 7: Alvinpe85 folded before Flop (didn't bet)
Seat 8: seula i folded before Flop (didn't bet)
Seat 9: hirozo folded before Flop (didn't bet)



PokerStars Zoom Hand #84298712799:  Hold'em No Limit ($0.10/$0.25) - 2012/08/05 13:30:48 JST [2012/08/05 0:30:48 ET]
Table 'Whirlpool' 9-max Seat #1 is the button
Seat 1: eagie20 ($126.90 in chips) 
Seat 2: chiyuki ($35.83 in chips) 
Seat 3: Catrban ($37.99 in chips) 
Seat 4: goldstone ($36.38 in chips) 
Seat 5: KeLevro0 ($14.74 in chips) 
Seat 6: Th3Fog ($23.90 in chips) 
Seat 7: gunbowler ($93.11 in chips) 
Seat 8: DooMSDaY1337 ($92.86 in chips) 
Seat 9: wtu1986 ($26.53 in chips) 
chiyuki: posts small blind $0.10
Catrban: posts big blind $0.25
*** HOLE CARDS ***
Dealt to chiyuki [Js 4d]
goldstone: folds 
KeLevro0: folds 
Th3Fog: folds 
gunbowler: folds 
DooMSDaY1337: folds 
wtu1986: folds 
eagie20: raises $0.50 to $0.75
chiyuki: folds 
Catrban: folds 
Uncalled bet ($0.50) returned to eagie20
eagie20 collected $0.60 from pot
eagie20: doesn't show hand 
*** SUMMARY ***
Total pot $0.60 | Rake $0 
Seat 1: eagie20 (button) collected ($0.60)
Seat 2: chiyuki (small blind) folded before Flop
Seat 3: Catrban (big blind) folded before Flop
Seat 4: goldstone folded before Flop (didn't bet)
Seat 5: KeLevro0 folded before Flop (didn't bet)
Seat 6: Th3Fog folded before Flop (didn't bet)
Seat 7: gunbowler folded before Flop (didn't bet)
Seat 8: DooMSDaY1337 folded before Flop (didn't bet)
Seat 9: wtu1986 folded before Flop (didn't bet)



PokerStars Zoom Hand #84298711405:  Hold'em No Limit ($0.10/$0.25) - 2012/08/05 13:30:43 JST [2012/08/05 0:30:43 ET]
Table 'Whirlpool' 9-max Seat #1 is the button
Seat 1: ShockLaMuc ($20.04 in chips) 
Seat 2: Ellen1947 ($27.55 in chips) 
Seat 3: deadmoneykid ($23.55 in chips) 
Seat 4: carlosrbr ($12 in chips) 
Seat 5: chiyuki ($35.83 in chips) 
Seat 6: KeLevro0 ($14.74 in chips) 
Seat 7: DooMSDaY1337 ($92.86 in chips) 
Seat 8: seula i ($25.25 in chips) 
Seat 9: BlOnDhOlIc ($33.18 in chips) 
Ellen1947: posts small blind $0.10
deadmoneykid: posts big blind $0.25
*** HOLE CARDS ***
Dealt to chiyuki [Ac Qh]
carlosrbr: calls $0.25
chiyuki: folds 
KeLevro0: folds 
DooMSDaY1337: folds 
seula i: folds 
BlOnDhOlIc: folds 
ShockLaMuc: folds 
Ellen1947: raises $0.75 to $1
deadmoneykid: folds 
carlosrbr: folds 
Uncalled bet ($0.75) returned to Ellen1947
Ellen1947 collected $0.75 from pot
Ellen1947: doesn't show hand 
*** SUMMARY ***
Total pot $0.75 | Rake $0 
Seat 1: ShockLaMuc (button) folded before Flop (didn't bet)
Seat 2: Ellen1947 (small blind) collected ($0.75)
Seat 3: deadmoneykid (big blind) folded before Flop
Seat 4: carlosrbr folded before Flop
Seat 5: chiyuki folded before Flop (didn't bet)
Seat 6: KeLevro0 folded before Flop (didn't bet)
Seat 7: DooMSDaY1337 folded before Flop (didn't bet)
Seat 8: seula i folded before Flop (didn't bet)
Seat 9: BlOnDhOlIc folded before Flop (didn't bet)



PokerStars Zoom Hand #84298710084:  Hold'em No Limit ($0.10/$0.25) - 2012/08/05 13:30:38 JST [2012/08/05 0:30:38 ET]
Table 'Whirlpool' 9-max Seat #1 is the button
Seat 1: PetitAlejo ($28.64 in chips) 
Seat 2: KeLevro0 ($11.45 in chips) 
Seat 3: RomarioJa ($8.95 in chips) 
Seat 4: fwani ($31.51 in chips) 
Seat 5: ladymadon107 ($23.33 in chips) 
Seat 6: BlackZafiro ($25.35 in chips) 
Seat 7: hirozo ($36.34 in chips) 
Seat 8: chiyuki ($35.83 in chips) 
Seat 9: Catrban ($37.99 in chips) 
KeLevro0: posts small blind $0.10
RomarioJa: posts big blind $0.25
*** HOLE CARDS ***
Dealt to chiyuki [7s 9s]
fwani: folds 
ladymadon107: calls $0.25
BlackZafiro: folds 
hirozo: folds 
chiyuki: folds 
Catrban: folds 
PetitAlejo: folds 
KeLevro0: folds 
RomarioJa: checks 
*** FLOP *** [Ts Qs 2h]
RomarioJa: checks 
ladymadon107: checks 
*** TURN *** [Ts Qs 2h] [Ad]
RomarioJa: bets $0.42
ladymadon107: folds 
Uncalled bet ($0.42) returned to RomarioJa
RomarioJa collected $0.57 from pot
RomarioJa: doesn't show hand 
*** SUMMARY ***
Total pot $0.60 | Rake $0.03 
Board [Ts Qs 2h Ad]
Seat 1: PetitAlejo (button) folded before Flop (didn't bet)
Seat 2: KeLevro0 (small blind) folded before Flop
Seat 3: RomarioJa (big blind) collected ($0.57)
Seat 4: fwani folded before Flop (didn't bet)
Seat 5: ladymadon107 folded on the Turn
Seat 6: BlackZafiro folded before Flop (didn't bet)
Seat 7: hirozo folded before Flop (didn't bet)
Seat 8: chiyuki folded before Flop (didn't bet)
Seat 9: Catrban folded before Flop (didn't bet)



PokerStars Zoom Hand #84298714205:  Hold'em No Limit ($0.10/$0.25) - 2012/08/05 13:30:53 JST [2012/08/05 0:30:53 ET]
Table 'Whirlpool' 9-max Seat #1 is the button
Seat 1: Dejacob ($25.97 in chips) 
Seat 2: goldstone ($36.38 in chips) 
Seat 3: Th3Fog ($23.90 in chips) 
Seat 4: seula i ($25.25 in chips) 
Seat 5: TraderYao ($31.09 in chips) 
Seat 6: chiyuki ($35.73 in chips) 
Seat 7: Medic8681 ($16.08 in chips) 
Seat 8: D@vidMed ($19.22 in chips) 
Seat 9: diez007 ($12.33 in chips) 
goldstone: posts small blind $0.10
Th3Fog: posts big blind $0.25
*** HOLE CARDS ***
Dealt to chiyuki [Qs Ah]
seula i: folds 
TraderYao: folds 
chiyuki: raises $0.50 to $0.75
Medic8681: calls $0.75
D@vidMed: calls $0.75
diez007: folds 
Dejacob: folds 
goldstone: folds 
Th3Fog: folds 
*** FLOP *** [6h 6d 9h]
chiyuki: checks 
Medic8681: bets $1.25
D@vidMed: folds 
chiyuki: folds 
Uncalled bet ($1.25) returned to Medic8681
Medic8681 collected $2.48 from pot
Medic8681: doesn't show hand 
*** SUMMARY ***
Total pot $2.60 | Rake $0.12 
Board [6h 6d 9h]
Seat 1: Dejacob (button) folded before Flop (didn't bet)
Seat 2: goldstone (small blind) folded before Flop
Seat 3: Th3Fog (big blind) folded before Flop
Seat 4: seula i folded before Flop (didn't bet)
Seat 5: TraderYao folded before Flop (didn't bet)
Seat 6: chiyuki folded on the Flop
Seat 7: Medic8681 collected ($2.48)
Seat 8: D@vidMed folded on the Flop
Seat 9: diez007 folded before Flop (didn't bet)



PokerStars Zoom Hand #84298730890:  Hold'em No Limit ($0.10/$0.25) - 2012/08/05 13:31:56 JST [2012/08/05 0:31:56 ET]
Table 'Whirlpool' 9-max Seat #1 is the button
Seat 1: deadmoneykid ($24.65 in chips) 
Seat 2: TraderYao ($31.19 in chips) 
Seat 3: SlimeyGash ($4.56 in chips) 
Seat 4: chiyuki ($34.98 in chips) 
Seat 5: kamikkaze ($46.05 in chips) 
Seat 6: ZSIDD ($17.50 in chips) 
Seat 7: eagie20 ($124.90 in chips) 
Seat 8: silvno31 ($28.78 in chips) 
Seat 9: Suhoff76 ($25 in chips) 
TraderYao: posts small blind $0.10
SlimeyGash: posts big blind $0.25
*** HOLE CARDS ***
Dealt to chiyuki [4d 7d]
chiyuki: folds 
kamikkaze: folds 
ZSIDD: folds 
eagie20: folds 
silvno31: folds 
Suhoff76: raises $0.32 to $0.57
deadmoneykid: raises $0.93 to $1.50
TraderYao: folds 
SlimeyGash: folds 
Suhoff76: folds 
Uncalled bet ($0.93) returned to deadmoneykid
deadmoneykid collected $1.49 from pot
deadmoneykid: doesn't show hand 
*** SUMMARY ***
Total pot $1.49 | Rake $0 
Seat 1: deadmoneykid (button) collected ($1.49)
Seat 2: TraderYao (small blind) folded before Flop
Seat 3: SlimeyGash (big blind) folded before Flop
Seat 4: chiyuki folded before Flop (didn't bet)
Seat 5: kamikkaze folded before Flop (didn't bet)
Seat 6: ZSIDD folded before Flop (didn't bet)
Seat 7: eagie20 folded before Flop (didn't bet)
Seat 8: silvno31 folded before Flop (didn't bet)
Seat 9: Suhoff76 folded before Flop



PokerStars Zoom Hand #84298739011:  Hold'em No Limit ($0.10/$0.25) - 2012/08/05 13:32:26 JST [2012/08/05 0:32:26 ET]
Table 'Whirlpool' 9-max Seat #1 is the button
Seat 1: ShockLaMuc ($19.54 in chips) 
Seat 2: BlackZafiro ($25 in chips) 
Seat 3: Dejacob ($26.37 in chips) 
Seat 4: TraderYao ($28.59 in chips) 
Seat 5: fwani ($32.84 in chips) 
Seat 6: DooMSDaY1337 ($52.74 in chips) 
Seat 7: Suhoff76 ($27.92 in chips) 
Seat 8: RomarioJa ($5.26 in chips) 
Seat 9: chiyuki ($34.73 in chips) 
BlackZafiro: posts small blind $0.10
Dejacob: posts big blind $0.25
*** HOLE CARDS ***
Dealt to chiyuki [8d Ad]
TraderYao: folds 
fwani: folds 
DooMSDaY1337: folds 
Suhoff76: folds 
RomarioJa: raises $0.37 to $0.62
chiyuki: folds 
ShockLaMuc: folds 
BlackZafiro: folds 
Dejacob: folds 
Uncalled bet ($0.37) returned to RomarioJa
RomarioJa collected $0.60 from pot
RomarioJa: doesn't show hand 
*** SUMMARY ***
Total pot $0.60 | Rake $0 
Seat 1: ShockLaMuc (button) folded before Flop (didn't bet)
Seat 2: BlackZafiro (small blind) folded before Flop
Seat 3: Dejacob (big blind) folded before Flop
Seat 4: TraderYao folded before Flop (didn't bet)
Seat 5: fwani folded before Flop (didn't bet)
Seat 6: DooMSDaY1337 folded before Flop (didn't bet)
Seat 7: Suhoff76 folded before Flop (didn't bet)
Seat 8: RomarioJa collected ($0.60)
Seat 9: chiyuki folded before Flop (didn't bet)



PokerStars Zoom Hand #84298731977:  Hold'em No Limit ($0.10/$0.25) - 2012/08/05 13:32:00 JST [2012/08/05 0:32:00 ET]
Table 'Whirlpool' 9-max Seat #1 is the button
Seat 1: silvno31 ($28.78 in chips) 
Seat 2: de harlekijn ($9.55 in chips) 
Seat 3: chiyuki ($34.98 in chips) 
Seat 4: Jippyflip ($19.85 in chips) 
Seat 5: KeLevro0 ($11.20 in chips) 
Seat 6: Anafim ($12.50 in chips) 
Seat 7: ZSIDD ($17.50 in chips) 
Seat 8: PetitAlejo ($34.38 in chips) 
Seat 9: eagie20 ($124.90 in chips) 
de harlekijn: posts small blind $0.10
chiyuki: posts big blind $0.25
*** HOLE CARDS ***
Dealt to chiyuki [Qh 8s]
Jippyflip: folds 
KeLevro0: folds 
Anafim: folds 
ZSIDD: folds 
PetitAlejo: folds 
eagie20: raises $0.50 to $0.75
silvno31: folds 
de harlekijn: calls $0.65
chiyuki: folds 
*** FLOP *** [Tc 3h 4h]
de harlekijn: checks 
eagie20: bets $1.25
de harlekijn: calls $1.25
*** TURN *** [Tc 3h 4h] [Td]
de harlekijn: checks 
eagie20: checks 
*** RIVER *** [Tc 3h 4h Td] [Jd]
de harlekijn: bets $2.75
eagie20: calls $2.75
*** SHOW DOWN ***
de harlekijn: shows [Js Ad] (two pair, Jacks and Tens)
eagie20: mucks hand 
de harlekijn collected $9.31 from pot
*** SUMMARY ***
Total pot $9.75 | Rake $0.44 
Board [Tc 3h 4h Td Jd]
Seat 1: silvno31 (button) folded before Flop (didn't bet)
Seat 2: de harlekijn (small blind) showed [Js Ad] and won ($9.31) with two pair, Jacks and Tens
Seat 3: chiyuki (big blind) folded before Flop
Seat 4: Jippyflip folded before Flop (didn't bet)
Seat 5: KeLevro0 folded before Flop (didn't bet)
Seat 6: Anafim folded before Flop (didn't bet)
Seat 7: ZSIDD folded before Flop (didn't bet)
Seat 8: PetitAlejo folded before Flop (didn't bet)
Seat 9: eagie20 mucked [6c 6s]



PokerStars Zoom Hand #84298743005:  Hold'em No Limit ($0.10/$0.25) - 2012/08/05 13:32:42 JST [2012/08/05 0:32:42 ET]
Table 'Whirlpool' 9-max Seat #1 is the button
Seat 1: Loholov ($15 in chips) 
Seat 2: PetitAlejo ($27.89 in chips) 
Seat 3: Suhoff76 ($25 in chips) 
Seat 4: Dejacob ($26.12 in chips) 
Seat 5: BlOnDhOlIc ($65.68 in chips) 
Seat 6: Catrban ($37.14 in chips) 
Seat 7: chiyuki ($34.73 in chips) 
Seat 8: petersmiths ($23.11 in chips) 
Seat 9: polk11 ($29.31 in chips) 
PetitAlejo: posts small blind $0.10
Suhoff76: posts big blind $0.25
*** HOLE CARDS ***
Dealt to chiyuki [Qs 3s]
Dejacob: raises $0.50 to $0.75
BlOnDhOlIc: folds 
Catrban: folds 
chiyuki: folds 
petersmiths: folds 
polk11: folds 
Loholov: folds 
PetitAlejo: folds 
Suhoff76: folds 
Uncalled bet ($0.50) returned to Dejacob
Dejacob collected $0.60 from pot
Dejacob: doesn't show hand 
*** SUMMARY ***
Total pot $0.60 | Rake $0 
Seat 1: Loholov (button) folded before Flop (didn't bet)
Seat 2: PetitAlejo (small blind) folded before Flop
Seat 3: Suhoff76 (big blind) folded before Flop
Seat 4: Dejacob collected ($0.60)
Seat 5: BlOnDhOlIc folded before Flop (didn't bet)
Seat 6: Catrban folded before Flop (didn't bet)
Seat 7: chiyuki folded before Flop (didn't bet)
Seat 8: petersmiths folded before Flop (didn't bet)
Seat 9: polk11 folded before Flop (didn't bet)



PokerStars Zoom Hand #84298746831:  Hold'em No Limit ($0.10/$0.25) - 2012/08/05 13:32:56 JST [2012/08/05 0:32:56 ET]
Table 'Whirlpool' 9-max Seat #1 is the button
Seat 1: Loholov ($22 in chips) 
Seat 2: diez007 ($14.16 in chips) 
Seat 3: fwani ($31.80 in chips) 
Seat 4: RomarioJa ($11.91 in chips) 
Seat 5: chiyuki ($34.73 in chips) 
Seat 6: petersmiths ($23.11 in chips) 
Seat 7: eduvazsilva ($14.55 in chips) 
Seat 8: ShockLaMuc ($19.54 in chips) 
Seat 9: wtu1986 ($24.50 in chips) 
diez007: posts small blind $0.10
fwani: posts big blind $0.25
*** HOLE CARDS ***
Dealt to chiyuki [6d 7c]
RomarioJa: folds 
chiyuki: folds 
petersmiths: folds 
eduvazsilva: raises $0.50 to $0.75
ShockLaMuc: folds 
wtu1986: folds 
Loholov: folds 
diez007: folds 
fwani: folds 
Uncalled bet ($0.50) returned to eduvazsilva
eduvazsilva collected $0.60 from pot
eduvazsilva: doesn't show hand 
*** SUMMARY ***
Total pot $0.60 | Rake $0 
Seat 1: Loholov (button) folded before Flop (didn't bet)
Seat 2: diez007 (small blind) folded before Flop
Seat 3: fwani (big blind) folded before Flop
Seat 4: RomarioJa folded before Flop (didn't bet)
Seat 5: chiyuki folded before Flop (didn't bet)
Seat 6: petersmiths folded before Flop (didn't bet)
Seat 7: eduvazsilva collected ($0.60)
Seat 8: ShockLaMuc folded before Flop (didn't bet)
Seat 9: wtu1986 folded before Flop (didn't bet)



PokerStars Zoom Hand #84298745995:  Hold'em No Limit ($0.10/$0.25) - 2012/08/05 13:32:53 JST [2012/08/05 0:32:53 ET]
Table 'Whirlpool' 9-max Seat #1 is the button
Seat 1: chiyuki ($34.73 in chips) 
Seat 2: slapshot2011 ($44.74 in chips) 
Seat 3: seula i ($60.54 in chips) 
Seat 4: TraderYao ($26.85 in chips) 
Seat 5: KeLevro0 ($11.10 in chips) 
Seat 6: Landybob ($32.34 in chips) 
Seat 7: eagie20 ($120.15 in chips) 
Seat 8: de harlekijn ($14.11 in chips) 
Seat 9: Roglus ($15.62 in chips) 
slapshot2011: posts small blind $0.10
seula i: posts big blind $0.25
*** HOLE CARDS ***
Dealt to chiyuki [2s 4h]
TraderYao: folds 
KeLevro0: folds 
Landybob: folds 
eagie20: folds 
de harlekijn: raises $0.50 to $0.75
Roglus: folds 
chiyuki: folds 
slapshot2011: calls $0.65
seula i: raises $3.25 to $4
de harlekijn: folds 
slapshot2011: folds 
Uncalled bet ($3.25) returned to seula i
seula i collected $2.25 from pot
seula i: doesn't show hand 
*** SUMMARY ***
Total pot $2.25 | Rake $0 
Seat 1: chiyuki (button) folded before Flop (didn't bet)
Seat 2: slapshot2011 (small blind) folded before Flop
Seat 3: seula i (big blind) collected ($2.25)
Seat 4: TraderYao folded before Flop (didn't bet)
Seat 5: KeLevro0 folded before Flop (didn't bet)
Seat 6: Landybob folded before Flop (didn't bet)
Seat 7: eagie20 folded before Flop (didn't bet)
Seat 8: de harlekijn folded before Flop
Seat 9: Roglus folded before Flop (didn't bet)



PokerStars Zoom Hand #84298744631:  Hold'em No Limit ($0.10/$0.25) - 2012/08/05 13:32:48 JST [2012/08/05 0:32:48 ET]
Table 'Whirlpool' 9-max Seat #1 is the button
Seat 1: petersmiths ($23.11 in chips) 
Seat 2: ygoegoe ($25 in chips) 
Seat 3: Lasutchik ($31.57 in chips) 
Seat 4: ShockLaMuc ($19.54 in chips) 
Seat 5: DooMSDaY1337 ($52.74 in chips) 
Seat 6: seula i ($60.54 in chips) 
Seat 7: masterkoolb ($12.50 in chips) 
Seat 8: chiyuki ($34.73 in chips) 
Seat 9: cR!Ma*aRm ($31.10 in chips) 
ygoegoe: posts small blind $0.10
Lasutchik: posts big blind $0.25
*** HOLE CARDS ***
Dealt to chiyuki [8h 6h]
ShockLaMuc: folds 
DooMSDaY1337: folds 
seula i: folds 
masterkoolb: raises $0.60 to $0.85
chiyuki: folds 
cR!Ma*aRm: calls $0.85
petersmiths: folds 
ygoegoe: folds 
Lasutchik: folds 
*** FLOP *** [Ts Th Tc]
masterkoolb: bets $1.47
cR!Ma*aRm: folds 
Uncalled bet ($1.47) returned to masterkoolb
masterkoolb collected $1.96 from pot
masterkoolb: doesn't show hand 
*** SUMMARY ***
Total pot $2.05 | Rake $0.09 
Board [Ts Th Tc]
Seat 1: petersmiths (button) folded before Flop (didn't bet)
Seat 2: ygoegoe (small blind) folded before Flop
Seat 3: Lasutchik (big blind) folded before Flop
Seat 4: ShockLaMuc folded before Flop (didn't bet)
Seat 5: DooMSDaY1337 folded before Flop (didn't bet)
Seat 6: seula i folded before Flop (didn't bet)
Seat 7: masterkoolb collected ($1.96)
Seat 8: chiyuki folded before Flop (didn't bet)
Seat 9: cR!Ma*aRm folded on the Flop



PokerStars Zoom Hand #84298749245:  Hold'em No Limit ($0.10/$0.25) - 2012/08/05 13:33:05 JST [2012/08/05 0:33:05 ET]
Table 'Whirlpool' 9-max Seat #1 is the button
Seat 1: Anafim ($13.20 in chips) 
Seat 2: wtu1986 ($24.50 in chips) 
Seat 3: PetitAlejo ($27.79 in chips) 
Seat 4: Th3Fog ($16.67 in chips) 
Seat 5: eagie20 ($120.15 in chips) 
Seat 6: D@vidMed ($12.47 in chips) 
Seat 7: chiyuki ($34.73 in chips) 
Seat 8: gunbowler ($91.36 in chips) 
Seat 9: ygoegoe ($25 in chips) 
wtu1986: posts small blind $0.10
PetitAlejo: posts big blind $0.25
*** HOLE CARDS ***
Dealt to chiyuki [Td 8s]
Th3Fog: folds 
eagie20: folds 
D@vidMed: folds 
chiyuki: folds 
gunbowler: raises $0.50 to $0.75
ygoegoe: folds 
Anafim: calls $0.75
wtu1986: folds 
PetitAlejo: raises $2.25 to $3
gunbowler: folds 
Anafim: folds 
Uncalled bet ($2.25) returned to PetitAlejo
PetitAlejo collected $2.35 from pot
PetitAlejo: doesn't show hand 
*** SUMMARY ***
Total pot $2.35 | Rake $0 
Seat 1: Anafim (button) folded before Flop
Seat 2: wtu1986 (small blind) folded before Flop
Seat 3: PetitAlejo (big blind) collected ($2.35)
Seat 4: Th3Fog folded before Flop (didn't bet)
Seat 5: eagie20 folded before Flop (didn't bet)
Seat 6: D@vidMed folded before Flop (didn't bet)
Seat 7: chiyuki folded before Flop (didn't bet)
Seat 8: gunbowler folded before Flop
Seat 9: ygoegoe folded before Flop (didn't bet)



PokerStars Zoom Hand #84298747946:  Hold'em No Limit ($0.10/$0.25) - 2012/08/05 13:33:00 JST [2012/08/05 0:33:00 ET]
Table 'Whirlpool' 9-max Seat #1 is the button
Seat 1: RomarioJa ($11.91 in chips) 
Seat 2: Loholov ($15 in chips) 
Seat 3: TamiKarpen13 ($18.86 in chips) 
Seat 4: chiyuki ($34.73 in chips) 
Seat 5: ZSIDD ($18.63 in chips) 
Seat 6: wtu1986 ($25.50 in chips) 
Seat 7: deadmoneykid ($23.62 in chips) 
Seat 8: BlOnDhOlIc ($34.41 in chips) 
Seat 9: ShockLaMuc ($16.43 in chips) 
Loholov: posts small blind $0.10
TamiKarpen13: posts big blind $0.25
*** HOLE CARDS ***
Dealt to chiyuki [7d 2c]
chiyuki: folds 
ZSIDD: calls $0.25
wtu1986: folds 
deadmoneykid: folds 
BlOnDhOlIc: folds 
ShockLaMuc: folds 
RomarioJa: folds 
Loholov: folds 
TamiKarpen13: checks 
*** FLOP *** [9h 7h 8d]
TamiKarpen13: checks 
ZSIDD: bets $0.25
TamiKarpen13: calls $0.25
*** TURN *** [9h 7h 8d] [7c]
TamiKarpen13: checks 
ZSIDD: bets $1
TamiKarpen13: calls $1
*** RIVER *** [9h 7h 8d 7c] [Kd]
TamiKarpen13: checks 
ZSIDD: bets $4.67
TamiKarpen13: folds 
Uncalled bet ($4.67) returned to ZSIDD
ZSIDD collected $2.96 from pot
ZSIDD: doesn't show hand 
*** SUMMARY ***
Total pot $3.10 | Rake $0.14 
Board [9h 7h 8d 7c Kd]
Seat 1: RomarioJa (button) folded before Flop (didn't bet)
Seat 2: Loholov (small blind) folded before Flop
Seat 3: TamiKarpen13 (big blind) folded on the River
Seat 4: chiyuki folded before Flop (didn't bet)
Seat 5: ZSIDD collected ($2.96)
Seat 6: wtu1986 folded before Flop (didn't bet)
Seat 7: deadmoneykid folded before Flop (didn't bet)
Seat 8: BlOnDhOlIc folded before Flop (didn't bet)
Seat 9: ShockLaMuc folded before Flop (didn't bet)



PokerStars Zoom Hand #84298752171:  Hold'em No Limit ($0.10/$0.25) - 2012/08/05 13:33:16 JST [2012/08/05 0:33:16 ET]
Table 'Whirlpool' 9-max Seat #1 is the button
Seat 1: 5zzzz33 ($13.25 in chips) 
Seat 2: chiyuki ($34.73 in chips) 
Seat 3: wtu1986 ($25 in chips) 
Seat 4: Th3Fog ($66.55 in chips) 
Seat 5: deadmoneykid ($23.62 in chips) 
Seat 6: peng2astic ($7.85 in chips) 
Seat 7: Loholov ($15.35 in chips) 
Seat 8: RomarioJa ($11.91 in chips) 
Seat 9: TraderYao ($28.49 in chips) 
chiyuki: posts small blind $0.10
wtu1986: posts big blind $0.25
*** HOLE CARDS ***
Dealt to chiyuki [As Ac]
Th3Fog: folds 
deadmoneykid: folds 
peng2astic has timed out
peng2astic: folds 
Loholov: folds 
RomarioJa: folds 
TraderYao: raises $0.50 to $0.75
5zzzz33: raises $1.25 to $2
chiyuki: calls $1.90
wtu1986: folds 
TraderYao: calls $1.25
*** FLOP *** [Jc 7h 4c]
chiyuki: checks 
TraderYao: checks 
5zzzz33: bets $11.25 and is all-in
chiyuki: calls $11.25
TraderYao: folds 
*** TURN *** [Jc 7h 4c] [Td]
*** RIVER *** [Jc 7h 4c Td] [4s]
*** SHOW DOWN ***
chiyuki: shows [As Ac] (two pair, Aces and Fours)
5zzzz33: shows [Qh Qs] (two pair, Queens and Fours)
chiyuki collected $27.46 from pot
*** SUMMARY ***
Total pot $28.75 | Rake $1.29 
Board [Jc 7h 4c Td 4s]
Seat 1: 5zzzz33 (button) showed [Qh Qs] and lost with two pair, Queens and Fours
Seat 2: chiyuki (small blind) showed [As Ac] and won ($27.46) with two pair, Aces and Fours
Seat 3: wtu1986 (big blind) folded before Flop
Seat 4: Th3Fog folded before Flop (didn't bet)
Seat 5: deadmoneykid folded before Flop (didn't bet)
Seat 6: peng2astic folded before Flop (didn't bet)
Seat 7: Loholov folded before Flop (didn't bet)
Seat 8: RomarioJa folded before Flop (didn't bet)
Seat 9: TraderYao folded on the Flop



PokerStars Zoom Hand #84298772824:  Hold'em No Limit ($0.10/$0.25) - 2012/08/05 13:34:34 JST [2012/08/05 0:34:34 ET]
Table 'Whirlpool' 9-max Seat #1 is the button
Seat 1: ShockLaMuc ($17.56 in chips) 
Seat 2: seula i ($62.04 in chips) 
Seat 3: chiyuki ($48.94 in chips) 
Seat 4: Th3Fog ($66.30 in chips) 
Seat 5: Dejacob ($40.81 in chips) 
Seat 6: NastyMcNast ($62.87 in chips) 
Seat 7: Lasutchik ($12.15 in chips) 
Seat 8: RomarioJa ($9.52 in chips) 
Seat 9: deadmoneykid ($25.76 in chips) 
seula i: posts small blind $0.10
chiyuki: posts big blind $0.25
*** HOLE CARDS ***
Dealt to chiyuki [5c 9c]
Th3Fog: folds 
Dejacob: folds 
NastyMcNast: folds 
Lasutchik: folds 
RomarioJa: folds 
deadmoneykid: folds 
ShockLaMuc: raises $0.50 to $0.75
seula i: folds 
chiyuki: folds 
Uncalled bet ($0.50) returned to ShockLaMuc
ShockLaMuc collected $0.60 from pot
ShockLaMuc: doesn't show hand 
*** SUMMARY ***
Total pot $0.60 | Rake $0 
Seat 1: ShockLaMuc (button) collected ($0.60)
Seat 2: seula i (small blind) folded before Flop
Seat 3: chiyuki (big blind) folded before Flop
Seat 4: Th3Fog folded before Flop (didn't bet)
Seat 5: Dejacob folded before Flop (didn't bet)
Seat 6: NastyMcNast folded before Flop (didn't bet)
Seat 7: Lasutchik folded before Flop (didn't bet)
Seat 8: RomarioJa folded before Flop (didn't bet)
Seat 9: deadmoneykid folded before Flop (didn't bet)



PokerStars Zoom Hand #84298781004:  Hold'em No Limit ($0.10/$0.25) - 2012/08/05 13:35:06 JST [2012/08/05 0:35:06 ET]
Table 'Whirlpool' 9-max Seat #1 is the button
Seat 1: chiyuki ($48.69 in chips) 
Seat 2: Catrban ($36.49 in chips) 
Seat 3: Nerkit ($11.65 in chips) 
Seat 4: ShockLaMuc ($16.43 in chips) 
Seat 5: ladymadon107 ($21.71 in chips) 
Seat 6: masterkoolb ($13.26 in chips) 
Seat 7: deadmoneykid ($25.57 in chips) 
Seat 8: cR!Ma*aRm ($30.41 in chips) 
Seat 9: simonzez ($58.62 in chips) 
Catrban: posts small blind $0.10
Nerkit: posts big blind $0.25
*** HOLE CARDS ***
Dealt to chiyuki [9d 4s]
ShockLaMuc: folds 
ladymadon107: folds 
masterkoolb: folds 
deadmoneykid has timed out
deadmoneykid: folds 
cR!Ma*aRm: folds 
simonzez: folds 
chiyuki: folds 
Catrban: folds 
Uncalled bet ($0.15) returned to Nerkit
Nerkit collected $0.20 from pot
Nerkit: doesn't show hand 
*** SUMMARY ***
Total pot $0.20 | Rake $0 
Seat 1: chiyuki (button) folded before Flop (didn't bet)
Seat 2: Catrban (small blind) folded before Flop
Seat 3: Nerkit (big blind) collected ($0.20)
Seat 4: ShockLaMuc folded before Flop (didn't bet)
Seat 5: ladymadon107 folded before Flop (didn't bet)
Seat 6: masterkoolb folded before Flop (didn't bet)
Seat 7: deadmoneykid folded before Flop (didn't bet)
Seat 8: cR!Ma*aRm folded before Flop (didn't bet)
Seat 9: simonzez folded before Flop (didn't bet)



PokerStars Zoom Hand #84298778127:  Hold'em No Limit ($0.10/$0.25) - 2012/08/05 13:34:54 JST [2012/08/05 0:34:54 ET]
Table 'Whirlpool' 9-max Seat #1 is the button
Seat 1: goldstone ($35.78 in chips) 
Seat 2: ShockLaMuc ($39.59 in chips) 
Seat 3: trusbi_na_go ($10.39 in chips) 
Seat 4: jeff0923 ($24.65 in chips) 
Seat 5: Alvinpe85 ($26.94 in chips) 
Seat 6: Landybob ($32.44 in chips) 
Seat 7: macr11111111 ($12.50 in chips) 
Seat 8: KeLevro0 ($12.60 in chips) 
Seat 9: chiyuki ($48.69 in chips) 
ShockLaMuc: posts small blind $0.10
trusbi_na_go: posts big blind $0.25
*** HOLE CARDS ***
Dealt to chiyuki [3d Td]
jeff0923: folds 
Alvinpe85: folds 
Landybob: folds 
macr11111111: folds 
KeLevro0: folds 
chiyuki: folds 
goldstone: raises $0.30 to $0.55
ShockLaMuc: calls $0.45
trusbi_na_go: calls $0.30
*** FLOP *** [6d Qs 2s]
ShockLaMuc: checks 
trusbi_na_go: bets $0.79
goldstone: calls $0.79
ShockLaMuc: folds 
*** TURN *** [6d Qs 2s] [7d]
trusbi_na_go: checks 
goldstone: bets $1.44
trusbi_na_go: folds 
Uncalled bet ($1.44) returned to goldstone
goldstone collected $3.08 from pot
goldstone: doesn't show hand 
*** SUMMARY ***
Total pot $3.23 | Rake $0.15 
Board [6d Qs 2s 7d]
Seat 1: goldstone (button) collected ($3.08)
Seat 2: ShockLaMuc (small blind) folded on the Flop
Seat 3: trusbi_na_go (big blind) folded on the Turn
Seat 4: jeff0923 folded before Flop (didn't bet)
Seat 5: Alvinpe85 folded before Flop (didn't bet)
Seat 6: Landybob folded before Flop (didn't bet)
Seat 7: macr11111111 folded before Flop (didn't bet)
Seat 8: KeLevro0 folded before Flop (didn't bet)
Seat 9: chiyuki folded before Flop (didn't bet)



PokerStars Zoom Hand #84298787255:  Hold'em No Limit ($0.10/$0.25) - 2012/08/05 13:35:30 JST [2012/08/05 0:35:30 ET]
Table 'Whirlpool' 9-max Seat #1 is the button
Seat 1: Dejacob ($25.78 in chips) 
Seat 2: jethaz ($53.25 in chips) 
Seat 3: BlackZafiro ($25 in chips) 
Seat 4: wtu1986 ($25.75 in chips) 
Seat 5: KeLevro0 ($10.75 in chips) 
Seat 6: PetitAlejo ($37.46 in chips) 
Seat 7: chiyuki ($48.69 in chips) 
Seat 8: Th3Fog ($65.95 in chips) 
Seat 9: DooMSDaY1337 ($98.80 in chips) 
jethaz: posts small blind $0.10
BlackZafiro: posts big blind $0.25
*** HOLE CARDS ***
Dealt to chiyuki [4c Qd]
wtu1986: folds 
KeLevro0: folds 
PetitAlejo: folds 
chiyuki: folds 
Th3Fog: folds 
DooMSDaY1337: folds 
Dejacob: folds 
jethaz: folds 
Uncalled bet ($0.15) returned to BlackZafiro
BlackZafiro collected $0.20 from pot
BlackZafiro: doesn't show hand 
*** SUMMARY ***
Total pot $0.20 | Rake $0 
Seat 1: Dejacob (button) folded before Flop (didn't bet)
Seat 2: jethaz (small blind) folded before Flop
Seat 3: BlackZafiro (big blind) collected ($0.20)
Seat 4: wtu1986 folded before Flop (didn't bet)
Seat 5: KeLevro0 folded before Flop (didn't bet)
Seat 6: PetitAlejo folded before Flop (didn't bet)
Seat 7: chiyuki folded before Flop (didn't bet)
Seat 8: Th3Fog folded before Flop (didn't bet)
Seat 9: DooMSDaY1337 folded before Flop (didn't bet)



PokerStars Zoom Hand #84298779986:  Hold'em No Limit ($0.10/$0.25) - 2012/08/05 13:35:02 JST [2012/08/05 0:35:02 ET]
Table 'Whirlpool' 9-max Seat #1 is the button
Seat 1: Anafim ($12.50 in chips) 
Seat 2: 4ydo yogurt ($9.30 in chips) 
Seat 3: KINGKILERACE ($7 in chips) 
Seat 4: RomarioJa ($9.52 in chips) 
Seat 5: cR!Ma*aRm ($30.41 in chips) 
Seat 6: TamiKarpen13 ($16.51 in chips) 
Seat 7: Nerkit ($11.65 in chips) 
Seat 8: chiyuki ($48.69 in chips) 
Seat 9: Dejacob ($25.68 in chips) 
4ydo yogurt: posts small blind $0.10
KINGKILERACE: posts big blind $0.25
*** HOLE CARDS ***
Dealt to chiyuki [Kh 8c]
RomarioJa: folds 
cR!Ma*aRm: folds 
TamiKarpen13: folds 
Nerkit: folds 
chiyuki: folds 
Dejacob: folds 
Anafim: raises $0.50 to $0.75
4ydo yogurt: calls $0.65
KINGKILERACE: calls $0.50
*** FLOP *** [9s 3h 9d]
4ydo yogurt: bets $0.50
KINGKILERACE: folds 
Anafim: raises $0.50 to $1
4ydo yogurt: calls $0.50
*** TURN *** [9s 3h 9d] [Qh]
4ydo yogurt: checks 
Anafim: bets $1
4ydo yogurt: folds 
Uncalled bet ($1) returned to Anafim
Anafim collected $4.06 from pot
Anafim: doesn't show hand 
*** SUMMARY ***
Total pot $4.25 | Rake $0.19 
Board [9s 3h 9d Qh]
Seat 1: Anafim (button) collected ($4.06)
Seat 2: 4ydo yogurt (small blind) folded on the Turn
Seat 3: KINGKILERACE (big blind) folded on the Flop
Seat 4: RomarioJa folded before Flop (didn't bet)
Seat 5: cR!Ma*aRm folded before Flop (didn't bet)
Seat 6: TamiKarpen13 folded before Flop (didn't bet)
Seat 7: Nerkit folded before Flop (didn't bet)
Seat 8: chiyuki folded before Flop (didn't bet)
Seat 9: Dejacob folded before Flop (didn't bet)



PokerStars Zoom Hand #84298790150:  Hold'em No Limit ($0.10/$0.25) - 2012/08/05 13:35:41 JST [2012/08/05 0:35:41 ET]
Table 'Whirlpool' 9-max Seat #1 is the button
Seat 1: Th3Fog ($55 in chips) 
Seat 2: chiyuki ($48.69 in chips) 
Seat 3: agurio ($30.05 in chips) 
Seat 4: a_tasmanian ($82.81 in chips) 
Seat 5: TamiKarpen13 ($16.16 in chips) 
Seat 6: Dejacob ($25.78 in chips) 
Seat 7: munky3 ($34.40 in chips) 
Seat 8: Nerkit ($11.75 in chips) 
Seat 9: jtedecaliss ($136.65 in chips) 
chiyuki: posts small blind $0.10
agurio: posts big blind $0.25
*** HOLE CARDS ***
Dealt to chiyuki [7d 4s]
a_tasmanian: folds 
TamiKarpen13: folds 
Dejacob: folds 
munky3: folds 
Nerkit: folds 
jtedecaliss: folds 
Th3Fog: folds 
chiyuki: folds 
Uncalled bet ($0.15) returned to agurio
agurio collected $0.20 from pot
agurio: doesn't show hand 
*** SUMMARY ***
Total pot $0.20 | Rake $0 
Seat 1: Th3Fog (button) folded before Flop (didn't bet)
Seat 2: chiyuki (small blind) folded before Flop
Seat 3: agurio (big blind) collected ($0.20)
Seat 4: a_tasmanian folded before Flop (didn't bet)
Seat 5: TamiKarpen13 folded before Flop (didn't bet)
Seat 6: Dejacob folded before Flop (didn't bet)
Seat 7: munky3 folded before Flop (didn't bet)
Seat 8: Nerkit folded before Flop (didn't bet)
Seat 9: jtedecaliss folded before Flop (didn't bet)



PokerStars Zoom Hand #84298791722:  Hold'em No Limit ($0.10/$0.25) - 2012/08/05 13:35:47 JST [2012/08/05 0:35:47 ET]
Table 'Whirlpool' 9-max Seat #1 is the button
Seat 1: 4ydo yogurt ($7.55 in chips) 
Seat 2: PetitAlejo ($30.34 in chips) 
Seat 3: Suhoff76 ($25 in chips) 
Seat 4: Ellen1947 ($26.60 in chips) 
Seat 5: Catrban ($36.71 in chips) 
Seat 6: chiyuki ($48.59 in chips) 
Seat 7: BlackZafiro ($26.20 in chips) 
Seat 8: BlOnDhOlIc ($64.63 in chips) 
Seat 9: munky3 ($34.40 in chips) 
PetitAlejo: posts small blind $0.10
Suhoff76: posts big blind $0.25
*** HOLE CARDS ***
Dealt to chiyuki [Tc 5s]
Ellen1947: folds 
Catrban: folds 
chiyuki: folds 
BlackZafiro: folds 
BlOnDhOlIc: folds 
munky3: folds 
4ydo yogurt: folds 
PetitAlejo: raises $0.50 to $0.75
Suhoff76: folds 
Uncalled bet ($0.50) returned to PetitAlejo
PetitAlejo collected $0.50 from pot
PetitAlejo: doesn't show hand 
*** SUMMARY ***
Total pot $0.50 | Rake $0 
Seat 1: 4ydo yogurt (button) folded before Flop (didn't bet)
Seat 2: PetitAlejo (small blind) collected ($0.50)
Seat 3: Suhoff76 (big blind) folded before Flop
Seat 4: Ellen1947 folded before Flop (didn't bet)
Seat 5: Catrban folded before Flop (didn't bet)
Seat 6: chiyuki folded before Flop (didn't bet)
Seat 7: BlackZafiro folded before Flop (didn't bet)
Seat 8: BlOnDhOlIc folded before Flop (didn't bet)
Seat 9: munky3 folded before Flop (didn't bet)



PokerStars Zoom Hand #84298783607:  Hold'em No Limit ($0.10/$0.25) - 2012/08/05 13:35:16 JST [2012/08/05 0:35:16 ET]
Table 'Whirlpool' 9-max Seat #1 is the button
Seat 1: Rsonal ($23.56 in chips) 
Seat 2: KeLevro0 ($10.85 in chips) 
Seat 3: BlOnDhOlIc ($64.98 in chips) 
Seat 4: seula i ($61.69 in chips) 
Seat 5: PetitAlejo ($30.34 in chips) 
Seat 6: chiyuki ($48.69 in chips) 
Seat 7: simonzez ($58.62 in chips) 
Seat 8: Jippyflip ($17.65 in chips) 
Seat 9: Dejacob ($25.44 in chips) 
KeLevro0: posts small blind $0.10
BlOnDhOlIc: posts big blind $0.25
*** HOLE CARDS ***
Dealt to chiyuki [3d 6h]
seula i: folds 
PetitAlejo: folds 
chiyuki: folds 
simonzez: calls $0.25
Jippyflip: calls $0.25
Dejacob: folds 
Rsonal: raises $0.25 to $0.50
KeLevro0: folds 
BlOnDhOlIc: folds 
simonzez: calls $0.25
Jippyflip: calls $0.25
*** FLOP *** [9h Ad 6c]
simonzez: checks 
Jippyflip: checks 
Rsonal: bets $1
simonzez: calls $1
Jippyflip: folds 
*** TURN *** [9h Ad 6c] [8s]
simonzez: checks 
Rsonal: checks 
*** RIVER *** [9h Ad 6c 8s] [Ah]
simonzez: checks 
Rsonal: bets $4
simonzez: folds 
Uncalled bet ($4) returned to Rsonal
Rsonal collected $3.68 from pot
Rsonal: doesn't show hand 
*** SUMMARY ***
Total pot $3.85 | Rake $0.17 
Board [9h Ad 6c 8s Ah]
Seat 1: Rsonal (button) collected ($3.68)
Seat 2: KeLevro0 (small blind) folded before Flop
Seat 3: BlOnDhOlIc (big blind) folded before Flop
Seat 4: seula i folded before Flop (didn't bet)
Seat 5: PetitAlejo folded before Flop (didn't bet)
Seat 6: chiyuki folded before Flop (didn't bet)
Seat 7: simonzez folded on the River
Seat 8: Jippyflip folded on the Flop
Seat 9: Dejacob folded before Flop (didn't bet)



PokerStars Zoom Hand #84298793348:  Hold'em No Limit ($0.10/$0.25) - 2012/08/05 13:35:53 JST [2012/08/05 0:35:53 ET]
Table 'Whirlpool' 9-max Seat #1 is the button
Seat 1: Nerkit ($11.75 in chips) 
Seat 2: Dejacob ($25.78 in chips) 
Seat 3: chiyuki ($48.59 in chips) 
Seat 4: a_tasmanian ($82.81 in chips) 
Seat 5: wtu1986 ($25 in chips) 
Seat 6: eduvazsilva ($14.10 in chips) 
Seat 7: Th3Fog ($65.95 in chips) 
Seat 8: 4ydo yogurt ($7.55 in chips) 
Seat 9: trusbi_na_go ($8.95 in chips) 
Dejacob: posts small blind $0.10
chiyuki: posts big blind $0.25
*** HOLE CARDS ***
Dealt to chiyuki [2d 8h]
a_tasmanian: raises $0.25 to $0.50
wtu1986: folds 
eduvazsilva: folds 
Th3Fog: folds 
4ydo yogurt: folds 
trusbi_na_go: folds 
Nerkit: folds 
Dejacob: folds 
chiyuki: folds 
Uncalled bet ($0.25) returned to a_tasmanian
a_tasmanian collected $0.60 from pot
a_tasmanian: doesn't show hand 
*** SUMMARY ***
Total pot $0.60 | Rake $0 
Seat 1: Nerkit (button) folded before Flop (didn't bet)
Seat 2: Dejacob (small blind) folded before Flop
Seat 3: chiyuki (big blind) folded before Flop
Seat 4: a_tasmanian collected ($0.60)
Seat 5: wtu1986 folded before Flop (didn't bet)
Seat 6: eduvazsilva folded before Flop (didn't bet)
Seat 7: Th3Fog folded before Flop (didn't bet)
Seat 8: 4ydo yogurt folded before Flop (didn't bet)
Seat 9: trusbi_na_go folded before Flop (didn't bet)



PokerStars Zoom Hand #84298789369:  Hold'em No Limit ($0.10/$0.25) - 2012/08/05 13:35:38 JST [2012/08/05 0:35:38 ET]
Table 'Whirlpool' 9-max Seat #1 is the button
Seat 1: Loholov ($15 in chips) 
Seat 2: ygoegoe ($26.87 in chips) 
Seat 3: NastyMcNast ($31.55 in chips) 
Seat 4: chiyuki ($48.69 in chips) 
Seat 5: TraderYao ($26.59 in chips) 
Seat 6: Th3Fog ($65.95 in chips) 
Seat 7: fwani ($33.15 in chips) 
Seat 8: Ellen1947 ($25.75 in chips) 
Seat 9: jethaz ($53.15 in chips) 
ygoegoe: posts small blind $0.10
NastyMcNast: posts big blind $0.25
*** HOLE CARDS ***
Dealt to chiyuki [9s Qd]
chiyuki: folds 
TraderYao: folds 
Th3Fog: folds 
fwani: folds 
Ellen1947: folds 
jethaz: folds 
Loholov: raises $0.50 to $0.75
ygoegoe: folds 
NastyMcNast: folds 
Uncalled bet ($0.50) returned to Loholov
Loholov collected $0.60 from pot
Loholov: doesn't show hand 
*** SUMMARY ***
Total pot $0.60 | Rake $0 
Seat 1: Loholov (button) collected ($0.60)
Seat 2: ygoegoe (small blind) folded before Flop
Seat 3: NastyMcNast (big blind) folded before Flop
Seat 4: chiyuki folded before Flop (didn't bet)
Seat 5: TraderYao folded before Flop (didn't bet)
Seat 6: Th3Fog folded before Flop (didn't bet)
Seat 7: fwani folded before Flop (didn't bet)
Seat 8: Ellen1947 folded before Flop (didn't bet)
Seat 9: jethaz folded before Flop (didn't bet)



PokerStars Zoom Hand #84298785667:  Hold'em No Limit ($0.10/$0.25) - 2012/08/05 13:35:24 JST [2012/08/05 0:35:24 ET]
Table 'Whirlpool' 9-max Seat #1 is the button
Seat 1: KeLevro0 ($12.50 in chips) 
Seat 2: Ellen1947 ($26.70 in chips) 
Seat 3: leo2095 ($14.82 in chips) 
Seat 4: PetitAlejo ($37.46 in chips) 
Seat 5: chiyuki ($48.69 in chips) 
Seat 6: DooMSDaY1337 ($98.80 in chips) 
Seat 7: jethaz ($29.24 in chips) 
Seat 8: NastyMcNast ($46.81 in chips) 
Seat 9: Alvinpe85 ($51.83 in chips) 
Ellen1947: posts small blind $0.10
leo2095: posts big blind $0.25
*** HOLE CARDS ***
Dealt to chiyuki [Td 7c]
PetitAlejo: folds 
chiyuki: folds 
DooMSDaY1337: folds 
jethaz: raises $0.50 to $0.75
NastyMcNast: raises $1.50 to $2.25
Alvinpe85: folds 
KeLevro0: folds 
Ellen1947: folds 
leo2095: folds 
jethaz: calls $1.50
*** FLOP *** [Ks 9d 8c]
jethaz: checks 
NastyMcNast: bets $3.24
jethaz: calls $3.24
*** TURN *** [Ks 9d 8c] [Th]
jethaz: checks 
NastyMcNast: checks 
*** RIVER *** [Ks 9d 8c Th] [9s]
jethaz: checks 
NastyMcNast: bets $4.32
jethaz: raises $19.43 to $23.75 and is all-in
NastyMcNast: folds 
Uncalled bet ($19.43) returned to jethaz
jethaz collected $19.07 from pot
jethaz: doesn't show hand 
*** SUMMARY ***
Total pot $19.97 | Rake $0.90 
Board [Ks 9d 8c Th 9s]
Seat 1: KeLevro0 (button) folded before Flop (didn't bet)
Seat 2: Ellen1947 (small blind) folded before Flop
Seat 3: leo2095 (big blind) folded before Flop
Seat 4: PetitAlejo folded before Flop (didn't bet)
Seat 5: chiyuki folded before Flop (didn't bet)
Seat 6: DooMSDaY1337 folded before Flop (didn't bet)
Seat 7: jethaz collected ($19.07)
Seat 8: NastyMcNast folded on the River
Seat 9: Alvinpe85 folded before Flop (didn't bet)



PokerStars Zoom Hand #84298805798:  Hold'em No Limit ($0.10/$0.25) - 2012/08/05 13:36:41 JST [2012/08/05 0:36:41 ET]
Table 'Whirlpool' 9-max Seat #1 is the button
Seat 1: TamiKarpen13 ($17.40 in chips) 
Seat 2: chiyuki ($48.34 in chips) 
Seat 3: macr11111111 ($11.90 in chips) 
Seat 4: TErr18 ($32.85 in chips) 
Seat 5: jethaz ($67 in chips) 
Seat 6: ygoegoe ($26.50 in chips) 
Seat 7: Suhoff76 ($25 in chips) 
Seat 8: taksist889 ($24.73 in chips) 
Seat 9: BlOnDhOlIc ($65.33 in chips) 
chiyuki: posts small blind $0.10
macr11111111: posts big blind $0.25
*** HOLE CARDS ***
Dealt to chiyuki [Js 6h]
TErr18: folds 
jethaz: folds 
ygoegoe: folds 
Suhoff76: folds 
taksist889: folds 
BlOnDhOlIc: raises $0.37 to $0.62
TamiKarpen13: calls $0.62
chiyuki: folds 
macr11111111: folds 
*** FLOP *** [5s Ks 8d]
BlOnDhOlIc: bets $1.14
TamiKarpen13: folds 
Uncalled bet ($1.14) returned to BlOnDhOlIc
BlOnDhOlIc collected $1.52 from pot
BlOnDhOlIc: doesn't show hand 
*** SUMMARY ***
Total pot $1.59 | Rake $0.07 
Board [5s Ks 8d]
Seat 1: TamiKarpen13 (button) folded on the Flop
Seat 2: chiyuki (small blind) folded before Flop
Seat 3: macr11111111 (big blind) folded before Flop
Seat 4: TErr18 folded before Flop (didn't bet)
Seat 5: jethaz folded before Flop (didn't bet)
Seat 6: ygoegoe folded before Flop (didn't bet)
Seat 7: Suhoff76 folded before Flop (didn't bet)
Seat 8: taksist889 folded before Flop (didn't bet)
Seat 9: BlOnDhOlIc collected ($1.52)



PokerStars Zoom Hand #84298808456:  Hold'em No Limit ($0.10/$0.25) - 2012/08/05 13:36:51 JST [2012/08/05 0:36:51 ET]
Table 'Whirlpool' 9-max Seat #1 is the button
Seat 1: eduvazsilva ($13.75 in chips) 
Seat 2: hirozo ($27.29 in chips) 
Seat 3: agurio ($25.68 in chips) 
Seat 4: NastyMcNast ($37 in chips) 
Seat 5: taksist889 ($24.73 in chips) 
Seat 6: Loholov ($24.36 in chips) 
Seat 7: chiyuki ($48.24 in chips) 
Seat 8: KeLevro0 ($15.92 in chips) 
Seat 9: timburonps ($25 in chips) 
hirozo: posts small blind $0.10
agurio: posts big blind $0.25
*** HOLE CARDS ***
Dealt to chiyuki [4c Jc]
NastyMcNast: folds 
taksist889: folds 
Loholov: folds 
chiyuki: folds 
KeLevro0: folds 
timburonps: folds 
eduvazsilva: folds 
hirozo: raises $0.25 to $0.50
agurio: folds 
Uncalled bet ($0.25) returned to hirozo
hirozo collected $0.50 from pot
hirozo: doesn't show hand 
*** SUMMARY ***
Total pot $0.50 | Rake $0 
Seat 1: eduvazsilva (button) folded before Flop (didn't bet)
Seat 2: hirozo (small blind) collected ($0.50)
Seat 3: agurio (big blind) folded before Flop
Seat 4: NastyMcNast folded before Flop (didn't bet)
Seat 5: taksist889 folded before Flop (didn't bet)
Seat 6: Loholov folded before Flop (didn't bet)
Seat 7: chiyuki folded before Flop (didn't bet)
Seat 8: KeLevro0 folded before Flop (didn't bet)
Seat 9: timburonps folded before Flop (didn't bet)



PokerStars Zoom Hand #84298803118:  Hold'em No Limit ($0.10/$0.25) - 2012/08/05 13:36:31 JST [2012/08/05 0:36:31 ET]
Table 'Whirlpool' 9-max Seat #1 is the button
Seat 1: chiyuki ($48.34 in chips) 
Seat 2: timburonps ($25.10 in chips) 
Seat 3: fwani ($33.15 in chips) 
Seat 4: seula i ($34.18 in chips) 
Seat 5: Suhoff76 ($25 in chips) 
Seat 6: wtu1986 ($24.90 in chips) 
Seat 7: Loholov ($15.35 in chips) 
Seat 8: TErr18 ($32.85 in chips) 
Seat 9: jtedecaliss ($136.30 in chips) 
timburonps: posts small blind $0.10
fwani: posts big blind $0.25
*** HOLE CARDS ***
Dealt to chiyuki [8c 6d]
seula i: raises $0.50 to $0.75
Suhoff76: folds 
wtu1986: folds 
Loholov: folds 
TErr18: folds 
jtedecaliss: folds 
chiyuki: folds 
timburonps: folds 
fwani: calls $0.50
*** FLOP *** [Qh 3d 7c]
fwani: checks 
seula i: checks 
*** TURN *** [Qh 3d 7c] [5h]
fwani: bets $1.10
seula i: folds 
Uncalled bet ($1.10) returned to fwani
fwani collected $1.53 from pot
fwani: doesn't show hand 
*** SUMMARY ***
Total pot $1.60 | Rake $0.07 
Board [Qh 3d 7c 5h]
Seat 1: chiyuki (button) folded before Flop (didn't bet)
Seat 2: timburonps (small blind) folded before Flop
Seat 3: fwani (big blind) collected ($1.53)
Seat 4: seula i folded on the Turn
Seat 5: Suhoff76 folded before Flop (didn't bet)
Seat 6: wtu1986 folded before Flop (didn't bet)
Seat 7: Loholov folded before Flop (didn't bet)
Seat 8: TErr18 folded before Flop (didn't bet)
Seat 9: jtedecaliss folded before Flop (didn't bet)



PokerStars Zoom Hand #84298811202:  Hold'em No Limit ($0.10/$0.25) - 2012/08/05 13:37:01 JST [2012/08/05 0:37:01 ET]
Table 'Whirlpool' 9-max Seat #1 is the button
Seat 1: jethaz ($64.77 in chips) 
Seat 2: DooMSDaY1337 ($99.48 in chips) 
Seat 3: a_tasmanian ($100.10 in chips) 
Seat 4: Nerkit ($11.65 in chips) 
Seat 5: Lasutchik ($12.11 in chips) 
Seat 6: Dejacob ($26.70 in chips) 
Seat 7: BlOnDhOlIc ($66.23 in chips) 
Seat 8: chiyuki ($48.24 in chips) 
Seat 9: silvno31 ($27.30 in chips) 
DooMSDaY1337: posts small blind $0.10
a_tasmanian: posts big blind $0.25
*** HOLE CARDS ***
Dealt to chiyuki [2d Kd]
Nerkit: folds 
Lasutchik: folds 
Dejacob: folds 
BlOnDhOlIc: folds 
chiyuki: folds 
silvno31: folds 
jethaz: folds 
DooMSDaY1337: folds 
Uncalled bet ($0.15) returned to a_tasmanian
a_tasmanian collected $0.20 from pot
a_tasmanian: doesn't show hand 
*** SUMMARY ***
Total pot $0.20 | Rake $0 
Seat 1: jethaz (button) folded before Flop (didn't bet)
Seat 2: DooMSDaY1337 (small blind) folded before Flop
Seat 3: a_tasmanian (big blind) collected ($0.20)
Seat 4: Nerkit folded before Flop (didn't bet)
Seat 5: Lasutchik folded before Flop (didn't bet)
Seat 6: Dejacob folded before Flop (didn't bet)
Seat 7: BlOnDhOlIc folded before Flop (didn't bet)
Seat 8: chiyuki folded before Flop (didn't bet)
Seat 9: silvno31 folded before Flop (didn't bet)



PokerStars Zoom Hand #84298814433:  Hold'em No Limit ($0.10/$0.25) - 2012/08/05 13:37:13 JST [2012/08/05 0:37:13 ET]
Table 'Whirlpool' 9-max Seat #1 is the button
Seat 1: ladymadon107 ($25.03 in chips) 
Seat 2: wtu1986 ($24.92 in chips) 
Seat 3: TamiKarpen13 ($16.78 in chips) 
Seat 4: PetitAlejo ($25 in chips) 
Seat 5: ShockLaMuc ($14.67 in chips) 
Seat 6: ygoegoe ($27.47 in chips) 
Seat 7: 5zzzz33 ($21.75 in chips) 
Seat 8: TraderYao ($28.47 in chips) 
Seat 9: chiyuki ($48.24 in chips) 
wtu1986: posts small blind $0.10
TamiKarpen13: posts big blind $0.25
*** HOLE CARDS ***
Dealt to chiyuki [4d 7c]
PetitAlejo: folds 
ShockLaMuc: folds 
ygoegoe: folds 
5zzzz33: folds 
TraderYao: folds 
chiyuki: folds 
ladymadon107: folds 
wtu1986: folds 
Uncalled bet ($0.15) returned to TamiKarpen13
TamiKarpen13 collected $0.20 from pot
TamiKarpen13: doesn't show hand 
*** SUMMARY ***
Total pot $0.20 | Rake $0 
Seat 1: ladymadon107 (button) folded before Flop (didn't bet)
Seat 2: wtu1986 (small blind) folded before Flop
Seat 3: TamiKarpen13 (big blind) collected ($0.20)
Seat 4: PetitAlejo folded before Flop (didn't bet)
Seat 5: ShockLaMuc folded before Flop (didn't bet)
Seat 6: ygoegoe folded before Flop (didn't bet)
Seat 7: 5zzzz33 folded before Flop (didn't bet)
Seat 8: TraderYao folded before Flop (didn't bet)
Seat 9: chiyuki folded before Flop (didn't bet)



PokerStars Zoom Hand #84298804414:  Hold'em No Limit ($0.10/$0.25) - 2012/08/05 13:36:36 JST [2012/08/05 0:36:36 ET]
Table 'Whirlpool' 9-max Seat #1 is the button
Seat 1: taksist889 ($24.73 in chips) 
Seat 2: deadmoneykid ($22.42 in chips) 
Seat 3: Anafim ($13.74 in chips) 
Seat 4: ygoegoe ($26.50 in chips) 
Seat 5: DooMSDaY1337 ($94.58 in chips) 
Seat 6: TErr18 ($32.85 in chips) 
Seat 7: ShockLaMuc ($17.56 in chips) 
Seat 8: hirozo ($26.90 in chips) 
Seat 9: chiyuki ($48.34 in chips) 
deadmoneykid: posts small blind $0.10
Anafim: posts big blind $0.25
*** HOLE CARDS ***
Dealt to chiyuki [Th 5h]
ygoegoe: folds 
DooMSDaY1337: folds 
TErr18: folds 
ShockLaMuc: folds 
hirozo: folds 
chiyuki: folds 
taksist889: folds 
deadmoneykid: raises $0.50 to $0.75
Anafim: calls $0.50
*** FLOP *** [8h 3h Tc]
deadmoneykid: bets $0.75
Anafim: calls $0.75
*** TURN *** [8h 3h Tc] [Qd]
deadmoneykid: checks 
Anafim: bets $1.50
deadmoneykid: folds 
Uncalled bet ($1.50) returned to Anafim
Anafim collected $2.86 from pot
Anafim: doesn't show hand 
*** SUMMARY ***
Total pot $3 | Rake $0.14 
Board [8h 3h Tc Qd]
Seat 1: taksist889 (button) folded before Flop (didn't bet)
Seat 2: deadmoneykid (small blind) folded on the Turn
Seat 3: Anafim (big blind) collected ($2.86)
Seat 4: ygoegoe folded before Flop (didn't bet)
Seat 5: DooMSDaY1337 folded before Flop (didn't bet)
Seat 6: TErr18 folded before Flop (didn't bet)
Seat 7: ShockLaMuc folded before Flop (didn't bet)
Seat 8: hirozo folded before Flop (didn't bet)
Seat 9: chiyuki folded before Flop (didn't bet)



PokerStars Zoom Hand #84298809550:  Hold'em No Limit ($0.10/$0.25) - 2012/08/05 13:36:55 JST [2012/08/05 0:36:55 ET]
Table 'Whirlpool' 9-max Seat #1 is the button
Seat 1: wildy29 ($16.69 in chips) 
Seat 2: Suhoff76 ($25 in chips) 
Seat 3: DooMSDaY1337 ($82.16 in chips) 
Seat 4: Dejacob ($25 in chips) 
Seat 5: chiyuki ($48.24 in chips) 
Seat 6: KeLevro0 ($15.92 in chips) 
Seat 7: eduvazsilva ($13.75 in chips) 
Seat 8: TraderYao ($26.79 in chips) 
Seat 9: NastyMcNast ($37 in chips) 
Suhoff76: posts small blind $0.10
DooMSDaY1337: posts big blind $0.25
*** HOLE CARDS ***
Dealt to chiyuki [6h Qs]
Dejacob: folds 
chiyuki: folds 
KeLevro0: folds 
eduvazsilva: folds 
TraderYao: raises $0.50 to $0.75
NastyMcNast: folds 
wildy29: calls $0.75
Suhoff76: folds 
DooMSDaY1337: folds 
*** FLOP *** [7h 4h Jh]
TraderYao: checks 
wildy29: bets $0.25
TraderYao: calls $0.25
*** TURN *** [7h 4h Jh] [Kd]
TraderYao: checks 
wildy29: bets $0.25
TraderYao: raises $1.75 to $2
wildy29: folds 
Uncalled bet ($1.75) returned to TraderYao
TraderYao collected $2.72 from pot
TraderYao: doesn't show hand 
*** SUMMARY ***
Total pot $2.85 | Rake $0.13 
Board [7h 4h Jh Kd]
Seat 1: wildy29 (button) folded on the Turn
Seat 2: Suhoff76 (small blind) folded before Flop
Seat 3: DooMSDaY1337 (big blind) folded before Flop
Seat 4: Dejacob folded before Flop (didn't bet)
Seat 5: chiyuki folded before Flop (didn't bet)
Seat 6: KeLevro0 folded before Flop (didn't bet)
Seat 7: eduvazsilva folded before Flop (didn't bet)
Seat 8: TraderYao collected ($2.72)
Seat 9: NastyMcNast folded before Flop (didn't bet)



PokerStars Zoom Hand #84298796672:  Hold'em No Limit ($0.10/$0.25) - 2012/08/05 13:36:06 JST [2012/08/05 0:36:06 ET]
Table 'Whirlpool' 9-max Seat #1 is the button
Seat 1: seula i ($47.02 in chips) 
Seat 2: ShockLaMuc ($17.66 in chips) 
Seat 3: NastyMcNast ($36.40 in chips) 
Seat 4: Th3Fog ($65.95 in chips) 
Seat 5: Alvinpe85 ($26.59 in chips) 
Seat 6: Lasutchik ($31.68 in chips) 
Seat 7: fwani ($32.59 in chips) 
Seat 8: chiyuki ($48.34 in chips) 
Seat 9: Ellen1947 ($26.60 in chips) 
ShockLaMuc: posts small blind $0.10
NastyMcNast: posts big blind $0.25
*** HOLE CARDS ***
Dealt to chiyuki [4h 4c]
Th3Fog: folds 
Alvinpe85: folds 
Lasutchik: folds 
fwani: raises $0.35 to $0.60
chiyuki: folds 
Ellen1947: calls $0.60
seula i: folds 
ShockLaMuc: folds 
NastyMcNast: folds 
*** FLOP *** [4s Ac 7d]
fwani: bets $1.20
Ellen1947: calls $1.20
*** TURN *** [4s Ac 7d] [8d]
fwani: bets $2.80
Ellen1947: calls $2.80
*** RIVER *** [4s Ac 7d 8d] [Tc]
fwani: bets $4.60
Ellen1947: raises $7.10 to $11.70
fwani: folds 
Uncalled bet ($7.10) returned to Ellen1947
Ellen1947 collected $17.91 from pot
Ellen1947: doesn't show hand 
*** SUMMARY ***
Total pot $18.75 | Rake $0.84 
Board [4s Ac 7d 8d Tc]
Seat 1: seula i (button) folded before Flop (didn't bet)
Seat 2: ShockLaMuc (small blind) folded before Flop
Seat 3: NastyMcNast (big blind) folded before Flop
Seat 4: Th3Fog folded before Flop (didn't bet)
Seat 5: Alvinpe85 folded before Flop (didn't bet)
Seat 6: Lasutchik folded before Flop (didn't bet)
Seat 7: fwani folded on the River
Seat 8: chiyuki folded before Flop (didn't bet)
Seat 9: Ellen1947 collected ($17.91)



PokerStars Zoom Hand #84298817103:  Hold'em No Limit ($0.10/$0.25) - 2012/08/05 13:37:24 JST [2012/08/05 0:37:24 ET]
Table 'Whirlpool' 9-max Seat #1 is the button
Seat 1: puffy5533 ($24.15 in chips) 
Seat 2: seula i ($60.94 in chips) 
Seat 3: taiali ($16.62 in chips) 
Seat 4: chiyuki ($48.24 in chips) 
Seat 5: hirozo ($25 in chips) 
Seat 6: BlackZafiro ($25 in chips) 
Seat 7: fwani ($30.19 in chips) 
Seat 8: Suhoff76 ($25 in chips) 
Seat 9: ladymadon107 ($25.03 in chips) 
seula i: posts small blind $0.10
taiali: posts big blind $0.25
*** HOLE CARDS ***
Dealt to chiyuki [7c 2c]
chiyuki: folds 
hirozo: folds 
BlackZafiro: raises $0.50 to $0.75
fwani: folds 
Suhoff76: calls $0.75
ladymadon107: folds 
puffy5533: folds 
seula i: folds 
taiali: folds 
*** FLOP *** [Qd 4h 6c]
BlackZafiro: bets $1.06
Suhoff76: raises $1.74 to $2.80
BlackZafiro: calls $1.74
*** TURN *** [Qd 4h 6c] [8h]
BlackZafiro: checks 
Suhoff76: checks 
*** RIVER *** [Qd 4h 6c 8h] [Qs]
BlackZafiro: checks 
Suhoff76: checks 
*** SHOW DOWN ***
BlackZafiro: shows [Ac Ad] (two pair, Aces and Queens)
Suhoff76: mucks hand 
BlackZafiro collected $7.11 from pot
*** SUMMARY ***
Total pot $7.45 | Rake $0.34 
Board [Qd 4h 6c 8h Qs]
Seat 1: puffy5533 (button) folded before Flop (didn't bet)
Seat 2: seula i (small blind) folded before Flop
Seat 3: taiali (big blind) folded before Flop
Seat 4: chiyuki folded before Flop (didn't bet)
Seat 5: hirozo folded before Flop (didn't bet)
Seat 6: BlackZafiro showed [Ac Ad] and won ($7.11) with two pair, Aces and Queens
Seat 7: fwani folded before Flop (didn't bet)
Seat 8: Suhoff76 mucked [Td Ts]
Seat 9: ladymadon107 folded before Flop (didn't bet)



PokerStars Zoom Hand #84298818457:  Hold'em No Limit ($0.10/$0.25) - 2012/08/05 13:37:29 JST [2012/08/05 0:37:29 ET]
Table 'Whirlpool' 9-max Seat #1 is the button
Seat 1: timburonps ($25.85 in chips) 
Seat 2: D@vidMed ($12.10 in chips) 
Seat 3: chiyuki ($48.24 in chips) 
Seat 4: Dejacob ($26.27 in chips) 
Seat 5: PetitAlejo ($37.39 in chips) 
Seat 6: DooMSDaY1337 ($49.49 in chips) 
Seat 7: ladymadon107 ($25.03 in chips) 
Seat 8: deadmoneykid ($25.41 in chips) 
Seat 9: Nerkit ($11.50 in chips) 
D@vidMed: posts small blind $0.10
chiyuki: posts big blind $0.25
*** HOLE CARDS ***
Dealt to chiyuki [3h 2h]
Dejacob: folds 
PetitAlejo: folds 
DooMSDaY1337: folds 
ladymadon107: folds 
deadmoneykid has timed out
deadmoneykid: folds 
Nerkit: raises $0.50 to $0.75
timburonps: folds 
D@vidMed: calls $0.65
chiyuki: folds 
*** FLOP *** [3d 3s 4s]
D@vidMed: checks 
Nerkit: checks 
*** TURN *** [3d 3s 4s] [8d]
D@vidMed: checks 
Nerkit: checks 
*** RIVER *** [3d 3s 4s 8d] [Kh]
D@vidMed: bets $0.82
Nerkit: calls $0.82
*** SHOW DOWN ***
D@vidMed: shows [Ks Td] (two pair, Kings and Threes)
Nerkit: shows [Jd Kc] (two pair, Kings and Threes - Jack kicker)
Nerkit collected $3.24 from pot
*** SUMMARY ***
Total pot $3.39 | Rake $0.15 
Board [3d 3s 4s 8d Kh]
Seat 1: timburonps (button) folded before Flop (didn't bet)
Seat 2: D@vidMed (small blind) showed [Ks Td] and lost with two pair, Kings and Threes
Seat 3: chiyuki (big blind) folded before Flop
Seat 4: Dejacob folded before Flop (didn't bet)
Seat 5: PetitAlejo folded before Flop (didn't bet)
Seat 6: DooMSDaY1337 folded before Flop (didn't bet)
Seat 7: ladymadon107 folded before Flop (didn't bet)
Seat 8: deadmoneykid folded before Flop (didn't bet)
Seat 9: Nerkit showed [Jd Kc] and won ($3.24) with two pair, Kings and Threes



PokerStars Zoom Hand #84298815802:  Hold'em No Limit ($0.10/$0.25) - 2012/08/05 13:37:18 JST [2012/08/05 0:37:18 ET]
Table 'Whirlpool' 9-max Seat #1 is the button
Seat 1: Ellen1947 ($27.42 in chips) 
Seat 2: Roglus ($11.23 in chips) 
Seat 3: jeff0923 ($26.12 in chips) 
Seat 4: Rsonal ($26.85 in chips) 
Seat 5: chiyuki ($48.24 in chips) 
Seat 6: Th3Fog ($25.36 in chips) 
Seat 7: timburonps ($25 in chips) 
Seat 8: Suhoff76 ($25 in chips) 
Seat 9: Paranoix1990 ($20.87 in chips) 
Roglus: posts small blind $0.10
jeff0923: posts big blind $0.25
*** HOLE CARDS ***
Dealt to chiyuki [Tc 5s]
Rsonal: raises $0.25 to $0.50
chiyuki: folds 
Th3Fog: calls $0.50
timburonps: folds 
Suhoff76: folds 
Paranoix1990: folds 
Ellen1947: folds 
Roglus: folds 
jeff0923: calls $0.25
*** FLOP *** [4d Th 6d]
jeff0923: checks 
Rsonal: bets $1.50
Th3Fog: calls $1.50
jeff0923: calls $1.50
*** TURN *** [4d Th 6d] [8h]
jeff0923: checks 
Rsonal: checks 
Th3Fog: checks 
*** RIVER *** [4d Th 6d 8h] [Qh]
jeff0923: checks 
Rsonal: bets $4.75
Th3Fog: folds 
jeff0923: calls $4.75
*** SHOW DOWN ***
Rsonal: shows [6s Ks] (a pair of Sixes)
jeff0923: shows [9d Qd] (a pair of Queens)
jeff0923 collected $14.90 from pot
*** SUMMARY ***
Total pot $15.60 | Rake $0.70 
Board [4d Th 6d 8h Qh]
Seat 1: Ellen1947 (button) folded before Flop (didn't bet)
Seat 2: Roglus (small blind) folded before Flop
Seat 3: jeff0923 (big blind) showed [9d Qd] and won ($14.90) with a pair of Queens
Seat 4: Rsonal showed [6s Ks] and lost with a pair of Sixes
Seat 5: chiyuki folded before Flop (didn't bet)
Seat 6: Th3Fog folded on the River
Seat 7: timburonps folded before Flop (didn't bet)
Seat 8: Suhoff76 folded before Flop (didn't bet)
Seat 9: Paranoix1990 folded before Flop (didn't bet)



PokerStars Zoom Hand #84298827310:  Hold'em No Limit ($0.10/$0.25) - 2012/08/05 13:38:03 JST [2012/08/05 0:38:03 ET]
Table 'Whirlpool' 9-max Seat #1 is the button
Seat 1: chiyuki ($47.99 in chips) 
Seat 2: PetitAlejo ($37.14 in chips) 
Seat 3: Alvinpe85 ($25.66 in chips) 
Seat 4: KeLevro0 ($7.45 in chips) 
Seat 5: Loholov ($24.71 in chips) 
Seat 6: fwani ($29.94 in chips) 
Seat 7: slapshot2011 ($41.06 in chips) 
Seat 8: ygoegoe ($26.15 in chips) 
Seat 9: jethaz ($47.40 in chips) 
PetitAlejo: posts small blind $0.10
Alvinpe85: posts big blind $0.25
*** HOLE CARDS ***
Dealt to chiyuki [Ks 9d]
KeLevro0: folds 
Loholov: folds 
fwani: folds 
slapshot2011: calls $0.25
ygoegoe: folds 
jethaz: raises $1 to $1.25
chiyuki: folds 
PetitAlejo: folds 
Alvinpe85: calls $1
slapshot2011: calls $1
*** FLOP *** [4c Qc 8d]
Alvinpe85: checks 
slapshot2011: checks 
jethaz: bets $2
Alvinpe85: folds 
slapshot2011: folds 
Uncalled bet ($2) returned to jethaz
jethaz collected $3.68 from pot
jethaz: doesn't show hand 
*** SUMMARY ***
Total pot $3.85 | Rake $0.17 
Board [4c Qc 8d]
Seat 1: chiyuki (button) folded before Flop (didn't bet)
Seat 2: PetitAlejo (small blind) folded before Flop
Seat 3: Alvinpe85 (big blind) folded on the Flop
Seat 4: KeLevro0 folded before Flop (didn't bet)
Seat 5: Loholov folded before Flop (didn't bet)
Seat 6: fwani folded before Flop (didn't bet)
Seat 7: slapshot2011 folded on the Flop
Seat 8: ygoegoe folded before Flop (didn't bet)
Seat 9: jethaz collected ($3.68)



PokerStars Zoom Hand #84298830462:  Hold'em No Limit ($0.10/$0.25) - 2012/08/05 13:38:15 JST [2012/08/05 0:38:15 ET]
Table 'Whirlpool' 9-max Seat #1 is the button
Seat 1: ll_LaMeR_ll ($36.29 in chips) 
Seat 2: hirozo ($25 in chips) 
Seat 3: kkbruins0408 ($11.28 in chips) 
Seat 4: DooMSDaY1337 ($99.83 in chips) 
Seat 5: Anafim ($15 in chips) 
Seat 6: TraderYao ($28.16 in chips) 
Seat 7: chiyuki ($47.99 in chips) 
Seat 8: Suhoff76 ($25 in chips) 
Seat 9: deadmoneykid ($30.06 in chips) 
hirozo: posts small blind $0.10
kkbruins0408: posts big blind $0.25
*** HOLE CARDS ***
Dealt to chiyuki [Td Th]
DooMSDaY1337: raises $0.50 to $0.75
Anafim: folds 
TraderYao: folds 
chiyuki: raises $1.50 to $2.25
Suhoff76: folds 
deadmoneykid: folds 
ll_LaMeR_ll: folds 
hirozo: folds 
kkbruins0408: folds 
DooMSDaY1337: folds 
Uncalled bet ($1.50) returned to chiyuki
chiyuki collected $1.85 from pot
chiyuki: doesn't show hand 
*** SUMMARY ***
Total pot $1.85 | Rake $0 
Seat 1: ll_LaMeR_ll (button) folded before Flop (didn't bet)
Seat 2: hirozo (small blind) folded before Flop
Seat 3: kkbruins0408 (big blind) folded before Flop
Seat 4: DooMSDaY1337 folded before Flop
Seat 5: Anafim folded before Flop (didn't bet)
Seat 6: TraderYao folded before Flop (didn't bet)
Seat 7: chiyuki collected ($1.85)
Seat 8: Suhoff76 folded before Flop (didn't bet)
Seat 9: deadmoneykid folded before Flop (didn't bet)



PokerStars Zoom Hand #84298829084:  Hold'em No Limit ($0.10/$0.25) - 2012/08/05 13:38:10 JST [2012/08/05 0:38:10 ET]
Table 'Whirlpool' 9-max Seat #1 is the button
Seat 1: ygoegoe ($26.15 in chips) 
Seat 2: 4ydo yogurt ($8.58 in chips) 
Seat 3: wtu1986 ($26.32 in chips) 
Seat 4: hirozo ($25 in chips) 
Seat 5: BlOnDhOlIc ($35.83 in chips) 
Seat 6: chiyuki ($47.99 in chips) 
Seat 7: Suhoff76 ($25 in chips) 
Seat 8: timburonps ($31.60 in chips) 
Seat 9: wildy29 ($15.34 in chips) 
4ydo yogurt: posts small blind $0.10
wtu1986: posts big blind $0.25
*** HOLE CARDS ***
Dealt to chiyuki [8c Tc]
hirozo: folds 
BlOnDhOlIc: folds 
chiyuki: folds 
Suhoff76: folds 
timburonps: folds 
wildy29: raises $0.50 to $0.75
ygoegoe: folds 
4ydo yogurt: calls $0.65
wtu1986: folds 
*** FLOP *** [4s Qs 8h]
4ydo yogurt: bets $0.40
wildy29: raises $0.40 to $0.80
4ydo yogurt: calls $0.40
*** TURN *** [4s Qs 8h] [6s]
4ydo yogurt: checks 
wildy29: checks 
*** RIVER *** [4s Qs 8h 6s] [2h]
4ydo yogurt: checks 
wildy29: checks 
*** SHOW DOWN ***
4ydo yogurt: shows [5s 5c] (a pair of Fives)
wildy29: shows [Qc Ah] (a pair of Queens)
wildy29 collected $3.20 from pot
*** SUMMARY ***
Total pot $3.35 | Rake $0.15 
Board [4s Qs 8h 6s 2h]
Seat 1: ygoegoe (button) folded before Flop (didn't bet)
Seat 2: 4ydo yogurt (small blind) showed [5s 5c] and lost with a pair of Fives
Seat 3: wtu1986 (big blind) folded before Flop
Seat 4: hirozo folded before Flop (didn't bet)
Seat 5: BlOnDhOlIc folded before Flop (didn't bet)
Seat 6: chiyuki folded before Flop (didn't bet)
Seat 7: Suhoff76 folded before Flop (didn't bet)
Seat 8: timburonps folded before Flop (didn't bet)
Seat 9: wildy29 showed [Qc Ah] and won ($3.20) with a pair of Queens



PokerStars Zoom Hand #84298837379:  Hold'em No Limit ($0.10/$0.25) - 2012/08/05 13:38:43 JST [2012/08/05 0:38:43 ET]
Table 'Whirlpool' 9-max Seat #1 is the button
Seat 1: kkbruins0408 ($11.03 in chips) 
Seat 2: BlOnDhOlIc ($35.71 in chips) 
Seat 3: BlackZafiro ($25 in chips) 
Seat 4: TraderYao ($27.91 in chips) 
Seat 5: chiyuki ($49.09 in chips) 
Seat 6: Rsonal ($20.10 in chips) 
Seat 7: jethaz ($49.83 in chips) 
Seat 8: Dejacob ($26.12 in chips) 
Seat 9: munky3 ($43.89 in chips) 
BlOnDhOlIc: posts small blind $0.10
BlackZafiro: posts big blind $0.25
*** HOLE CARDS ***
Dealt to chiyuki [3s 6h]
TraderYao: folds 
chiyuki: folds 
Rsonal: folds 
jethaz: folds 
Dejacob: folds 
munky3: folds 
kkbruins0408: folds 
BlOnDhOlIc: folds 
Uncalled bet ($0.15) returned to BlackZafiro
BlackZafiro collected $0.20 from pot
BlackZafiro: doesn't show hand 
*** SUMMARY ***
Total pot $0.20 | Rake $0 
Seat 1: kkbruins0408 (button) folded before Flop (didn't bet)
Seat 2: BlOnDhOlIc (small blind) folded before Flop
Seat 3: BlackZafiro (big blind) collected ($0.20)
Seat 4: TraderYao folded before Flop (didn't bet)
Seat 5: chiyuki folded before Flop (didn't bet)
Seat 6: Rsonal folded before Flop (didn't bet)
Seat 7: jethaz folded before Flop (didn't bet)
Seat 8: Dejacob folded before Flop (didn't bet)
Seat 9: munky3 folded before Flop (didn't bet)



PokerStars Zoom Hand #84298838728:  Hold'em No Limit ($0.10/$0.25) - 2012/08/05 13:38:48 JST [2012/08/05 0:38:48 ET]
Table 'Whirlpool' 9-max Seat #1 is the button
Seat 1: BlOnDhOlIc ($35.61 in chips) 
Seat 2: chiyuki ($49.09 in chips) 
Seat 3: hirozo ($26.90 in chips) 
Seat 4: Suhoff76 ($25 in chips) 
Seat 5: Anafim ($15 in chips) 
Seat 6: jethaz ($49.83 in chips) 
Seat 7: Dejacob ($26.12 in chips) 
Seat 8: NastyMcNast ($36.15 in chips) 
Seat 9: ShockLaMuc ($44.87 in chips) 
chiyuki: posts small blind $0.10
hirozo: posts big blind $0.25
*** HOLE CARDS ***
Dealt to chiyuki [9c Qh]
Suhoff76: folds 
Anafim: folds 
jethaz: folds 
Dejacob: folds 
NastyMcNast: raises $0.50 to $0.75
ShockLaMuc: folds 
BlOnDhOlIc: folds 
chiyuki: folds 
hirozo: folds 
Uncalled bet ($0.50) returned to NastyMcNast
NastyMcNast collected $0.60 from pot
NastyMcNast: doesn't show hand 
*** SUMMARY ***
Total pot $0.60 | Rake $0 
Seat 1: BlOnDhOlIc (button) folded before Flop (didn't bet)
Seat 2: chiyuki (small blind) folded before Flop
Seat 3: hirozo (big blind) folded before Flop
Seat 4: Suhoff76 folded before Flop (didn't bet)
Seat 5: Anafim folded before Flop (didn't bet)
Seat 6: jethaz folded before Flop (didn't bet)
Seat 7: Dejacob folded before Flop (didn't bet)
Seat 8: NastyMcNast collected ($0.60)
Seat 9: ShockLaMuc folded before Flop (didn't bet)



PokerStars Zoom Hand #84298842882:  Hold'em No Limit ($0.10/$0.25) - 2012/08/05 13:39:04 JST [2012/08/05 0:39:04 ET]
Table 'Whirlpool' 9-max Seat #1 is the button
Seat 1: TraderYao ($24.90 in chips) 
Seat 2: Dejacob ($26.45 in chips) 
Seat 3: KeLevro0 ($12.55 in chips) 
Seat 4: wtu1986 ($26.07 in chips) 
Seat 5: Anafim ($16.04 in chips) 
Seat 6: BlOnDhOlIc ($35.61 in chips) 
Seat 7: isti2 ($16.35 in chips) 
Seat 8: Th3Fog ($53.78 in chips) 
Seat 9: chiyuki ($48.99 in chips) 
Dejacob: posts small blind $0.10
KeLevro0: posts big blind $0.25
*** HOLE CARDS ***
Dealt to chiyuki [Kh 4d]
wtu1986: folds 
Anafim: folds 
BlOnDhOlIc: folds 
isti2: folds 
Th3Fog: raises $0.47 to $0.72
chiyuki: folds 
TraderYao: calls $0.72
Dejacob: folds 
KeLevro0: folds 
*** FLOP *** [9s 8s 8h]
Th3Fog: bets $1
TraderYao: folds 
Uncalled bet ($1) returned to Th3Fog
Th3Fog collected $1.71 from pot
Th3Fog: doesn't show hand 
*** SUMMARY ***
Total pot $1.79 | Rake $0.08 
Board [9s 8s 8h]
Seat 1: TraderYao (button) folded on the Flop
Seat 2: Dejacob (small blind) folded before Flop
Seat 3: KeLevro0 (big blind) folded before Flop
Seat 4: wtu1986 folded before Flop (didn't bet)
Seat 5: Anafim folded before Flop (didn't bet)
Seat 6: BlOnDhOlIc folded before Flop (didn't bet)
Seat 7: isti2 folded before Flop (didn't bet)
Seat 8: Th3Fog collected ($1.71)
Seat 9: chiyuki folded before Flop (didn't bet)



PokerStars Zoom Hand #84298846777:  Hold'em No Limit ($0.10/$0.25) - 2012/08/05 13:39:19 JST [2012/08/05 0:39:19 ET]
Table 'Whirlpool' 9-max Seat #1 is the button
Seat 1: Nerkit ($13.17 in chips) 
Seat 2: KAKamiro ($13.25 in chips) 
Seat 3: Dejacob ($36.35 in chips) 
Seat 4: fwani ($25 in chips) 
Seat 5: seula i ($52.24 in chips) 
Seat 6: chiyuki ($48.99 in chips) 
Seat 7: munky3 ($43.39 in chips) 
Seat 8: agurio ($33.31 in chips) 
Seat 9: BlOnDhOlIc ($35.61 in chips) 
KAKamiro: posts small blind $0.10
Dejacob: posts big blind $0.25
*** HOLE CARDS ***
Dealt to chiyuki [5s Ks]
fwani: raises $0.35 to $0.60
seula i: folds 
chiyuki: folds 
munky3: folds 
agurio: folds 
BlOnDhOlIc: folds 
Nerkit: folds 
KAKamiro: folds 
Dejacob: folds 
Uncalled bet ($0.35) returned to fwani
fwani collected $0.60 from pot
fwani: doesn't show hand 
*** SUMMARY ***
Total pot $0.60 | Rake $0 
Seat 1: Nerkit (button) folded before Flop (didn't bet)
Seat 2: KAKamiro (small blind) folded before Flop
Seat 3: Dejacob (big blind) folded before Flop
Seat 4: fwani collected ($0.60)
Seat 5: seula i folded before Flop (didn't bet)
Seat 6: chiyuki folded before Flop (didn't bet)
Seat 7: munky3 folded before Flop (didn't bet)
Seat 8: agurio folded before Flop (didn't bet)
Seat 9: BlOnDhOlIc folded before Flop (didn't bet)



PokerStars Zoom Hand #84298848375:  Hold'em No Limit ($0.10/$0.25) - 2012/08/05 13:39:25 JST [2012/08/05 0:39:25 ET]
Table 'Whirlpool' 9-max Seat #1 is the button
Seat 1: Jippyflip ($18.31 in chips) 
Seat 2: NastyMcNast ($64.64 in chips) 
Seat 3: chiyuki ($48.99 in chips) 
Seat 4: TraderYao ($25.05 in chips) 
Seat 5: jeff0923 ($34.17 in chips) 
Seat 6: munky3 ($43.39 in chips) 
Seat 7: BlOnDhOlIc ($35.61 in chips) 
Seat 8: PetitAlejo ($37.04 in chips) 
Seat 9: Suhoff76 ($37.48 in chips) 
NastyMcNast: posts small blind $0.10
chiyuki: posts big blind $0.25
*** HOLE CARDS ***
Dealt to chiyuki [5c Ks]
TraderYao: raises $0.50 to $0.75
jeff0923: folds 
munky3: calls $0.75
BlOnDhOlIc: folds 
PetitAlejo: folds 
Suhoff76: calls $0.75
Jippyflip: folds 
NastyMcNast: folds 
chiyuki: folds 
*** FLOP *** [8d 8s Kh]
TraderYao: checks 
munky3: bets $0.75
Suhoff76: folds 
TraderYao: calls $0.75
*** TURN *** [8d 8s Kh] [7s]
TraderYao: checks 
munky3: checks 
*** RIVER *** [8d 8s Kh 7s] [6d]
TraderYao: checks 
munky3: checks 
*** SHOW DOWN ***
TraderYao: shows [Ah As] (two pair, Aces and Eights)
munky3: mucks hand 
TraderYao collected $3.92 from pot
*** SUMMARY ***
Total pot $4.10 | Rake $0.18 
Board [8d 8s Kh 7s 6d]
Seat 1: Jippyflip (button) folded before Flop (didn't bet)
Seat 2: NastyMcNast (small blind) folded before Flop
Seat 3: chiyuki (big blind) folded before Flop
Seat 4: TraderYao showed [Ah As] and won ($3.92) with two pair, Aces and Eights
Seat 5: jeff0923 folded before Flop (didn't bet)
Seat 6: munky3 mucked [Ac Js]
Seat 7: BlOnDhOlIc folded before Flop (didn't bet)
Seat 8: PetitAlejo folded before Flop (didn't bet)
Seat 9: Suhoff76 folded on the Flop



PokerStars Zoom Hand #84298854065:  Hold'em No Limit ($0.10/$0.25) - 2012/08/05 13:39:48 JST [2012/08/05 0:39:48 ET]
Table 'Whirlpool' 9-max Seat #1 is the button
Seat 1: Anafim ($15.34 in chips) 
Seat 2: chiyuki ($48.74 in chips) 
Seat 3: Ellen1947 ($26.77 in chips) 
Seat 4: BlOnDhOlIc ($35.73 in chips) 
Seat 5: leo2095 ($13.72 in chips) 
Seat 6: PetitAlejo ($37.04 in chips) 
Seat 7: Alvinpe85 ($60.53 in chips) 
Seat 8: Th3Fog ($66.90 in chips) 
Seat 9: Jippyflip ($17.96 in chips) 
chiyuki: posts small blind $0.10
Ellen1947: posts big blind $0.25
*** HOLE CARDS ***
Dealt to chiyuki [3c Jd]
BlOnDhOlIc: folds 
leo2095: raises $0.25 to $0.50
PetitAlejo: folds 
Alvinpe85: folds 
Th3Fog: folds 
Jippyflip: folds 
Anafim: folds 
chiyuki: folds 
Ellen1947: folds 
Uncalled bet ($0.25) returned to leo2095
leo2095 collected $0.60 from pot
leo2095: doesn't show hand 
*** SUMMARY ***
Total pot $0.60 | Rake $0 
Seat 1: Anafim (button) folded before Flop (didn't bet)
Seat 2: chiyuki (small blind) folded before Flop
Seat 3: Ellen1947 (big blind) folded before Flop
Seat 4: BlOnDhOlIc folded before Flop (didn't bet)
Seat 5: leo2095 collected ($0.60)
Seat 6: PetitAlejo folded before Flop (didn't bet)
Seat 7: Alvinpe85 folded before Flop (didn't bet)
Seat 8: Th3Fog folded before Flop (didn't bet)
Seat 9: Jippyflip folded before Flop (didn't bet)



PokerStars Zoom Hand #84298855052:  Hold'em No Limit ($0.10/$0.25) - 2012/08/05 13:39:52 JST [2012/08/05 0:39:52 ET]
Table 'Whirlpool' 9-max Seat #1 is the button
Seat 1: chiyuki ($48.64 in chips) 
Seat 2: solawind ($24.30 in chips) 
Seat 3: hirozo ($25 in chips) 
Seat 4: jethaz ($62.45 in chips) 
Seat 5: cr0lox ($25.64 in chips) 
Seat 6: peng2astic ($16.58 in chips) 
Seat 7: TraderYao ($27.72 in chips) 
Seat 8: KAKamiro ($12.50 in chips) 
Seat 9: Anafim ($15.34 in chips) 
solawind: posts small blind $0.10
hirozo: posts big blind $0.25
*** HOLE CARDS ***
Dealt to chiyuki [Jh 8s]
jethaz: folds 
cr0lox: folds 
peng2astic: folds 
TraderYao: folds 
KAKamiro: folds 
Anafim: folds 
chiyuki: folds 
solawind: raises $0.50 to $0.75
hirozo: folds 
Uncalled bet ($0.50) returned to solawind
solawind collected $0.50 from pot
solawind: doesn't show hand 
*** SUMMARY ***
Total pot $0.50 | Rake $0 
Seat 1: chiyuki (button) folded before Flop (didn't bet)
Seat 2: solawind (small blind) collected ($0.50)
Seat 3: hirozo (big blind) folded before Flop
Seat 4: jethaz folded before Flop (didn't bet)
Seat 5: cr0lox folded before Flop (didn't bet)
Seat 6: peng2astic folded before Flop (didn't bet)
Seat 7: TraderYao folded before Flop (didn't bet)
Seat 8: KAKamiro folded before Flop (didn't bet)
Seat 9: Anafim folded before Flop (didn't bet)



PokerStars Zoom Hand #84298851978:  Hold'em No Limit ($0.10/$0.25) - 2012/08/05 13:39:39 JST [2012/08/05 0:39:39 ET]
Table 'Whirlpool' 9-max Seat #1 is the button
Seat 1: vit 111 ($28.59 in chips) 
Seat 2: agurio ($25.28 in chips) 
Seat 3: BlackZafiro ($28.56 in chips) 
Seat 4: silvno31 ($28.59 in chips) 
Seat 5: Loholov ($24.36 in chips) 
Seat 6: Alvinpe85 ($60.53 in chips) 
Seat 7: Nerkit ($13.17 in chips) 
Seat 8: chiyuki ($48.74 in chips) 
Seat 9: BlOnDhOlIc ($35.73 in chips) 
agurio: posts small blind $0.10
BlackZafiro: posts big blind $0.25
*** HOLE CARDS ***
Dealt to chiyuki [3d 7d]
silvno31: folds 
Loholov: folds 
Alvinpe85: folds 
Nerkit: folds 
chiyuki: folds 
BlOnDhOlIc: folds 
vit 111: calls $0.25
agurio: folds 
BlackZafiro: checks 
*** FLOP *** [As Td Qs]
BlackZafiro: checks 
vit 111: bets $0.50
BlackZafiro: calls $0.50
*** TURN *** [As Td Qs] [Ad]
BlackZafiro: checks 
vit 111: checks 
*** RIVER *** [As Td Qs Ad] [4s]
BlackZafiro: bets $1
vit 111: folds 
Uncalled bet ($1) returned to BlackZafiro
BlackZafiro collected $1.53 from pot
BlackZafiro: doesn't show hand 
*** SUMMARY ***
Total pot $1.60 | Rake $0.07 
Board [As Td Qs Ad 4s]
Seat 1: vit 111 (button) folded on the River
Seat 2: agurio (small blind) folded before Flop
Seat 3: BlackZafiro (big blind) collected ($1.53)
Seat 4: silvno31 folded before Flop (didn't bet)
Seat 5: Loholov folded before Flop (didn't bet)
Seat 6: Alvinpe85 folded before Flop (didn't bet)
Seat 7: Nerkit folded before Flop (didn't bet)
Seat 8: chiyuki folded before Flop (didn't bet)
Seat 9: BlOnDhOlIc folded before Flop (didn't bet)



PokerStars Zoom Hand #84298858923:  Hold'em No Limit ($0.10/$0.25) - 2012/08/05 13:40:07 JST [2012/08/05 0:40:07 ET]
Table 'Whirlpool' 9-max Seat #1 is the button
Seat 1: TErr18 ($25.67 in chips) 
Seat 2: Suhoff76 ($36.73 in chips) 
Seat 3: Nerkit ($13.17 in chips) 
Seat 4: TraderYao ($25 in chips) 
Seat 5: chiyuki ($48.64 in chips) 
Seat 6: hirozo ($27.65 in chips) 
Seat 7: NastyMcNast ($36.15 in chips) 
Seat 8: Jippyflip ($17.96 in chips) 
Seat 9: gedavaca ($44.26 in chips) 
Suhoff76: posts small blind $0.10
Nerkit: posts big blind $0.25
*** HOLE CARDS ***
Dealt to chiyuki [2c 8h]
TraderYao: folds 
chiyuki: folds 
hirozo: folds 
NastyMcNast: folds 
Jippyflip: folds 
gedavaca: folds 
TErr18: folds 
Suhoff76: folds 
Uncalled bet ($0.15) returned to Nerkit
Nerkit collected $0.20 from pot
Nerkit: doesn't show hand 
*** SUMMARY ***
Total pot $0.20 | Rake $0 
Seat 1: TErr18 (button) folded before Flop (didn't bet)
Seat 2: Suhoff76 (small blind) folded before Flop
Seat 3: Nerkit (big blind) collected ($0.20)
Seat 4: TraderYao folded before Flop (didn't bet)
Seat 5: chiyuki folded before Flop (didn't bet)
Seat 6: hirozo folded before Flop (didn't bet)
Seat 7: NastyMcNast folded before Flop (didn't bet)
Seat 8: Jippyflip folded before Flop (didn't bet)
Seat 9: gedavaca folded before Flop (didn't bet)



PokerStars Zoom Hand #84298860989:  Hold'em No Limit ($0.10/$0.25) - 2012/08/05 13:40:15 JST [2012/08/05 0:40:15 ET]
Table 'Whirlpool' 9-max Seat #1 is the button
Seat 1: wtu1986 ($27.73 in chips) 
Seat 2: deadmoneykid ($29.81 in chips) 
Seat 3: simonzez ($25 in chips) 
Seat 4: BlackZafiro ($28.71 in chips) 
Seat 5: D@vidMed ($10.53 in chips) 
Seat 6: TraderYao ($25 in chips) 
Seat 7: chiyuki ($48.64 in chips) 
Seat 8: Ellen1947 ($33.44 in chips) 
Seat 9: timburonps ($25 in chips) 
deadmoneykid: posts small blind $0.10
simonzez: posts big blind $0.25
*** HOLE CARDS ***
Dealt to chiyuki [7s 7c]
BlackZafiro: folds 
D@vidMed: folds 
TraderYao: folds 
chiyuki: raises $0.50 to $0.75
Ellen1947: folds 
timburonps: folds 
wtu1986: folds 
deadmoneykid: folds 
simonzez: calls $0.50
*** FLOP *** [6s 2h 4d]
simonzez: bets $1
chiyuki: calls $1
*** TURN *** [6s 2h 4d] [Tc]
simonzez: bets $1
chiyuki: calls $1
*** RIVER *** [6s 2h 4d Tc] [2c]
simonzez: bets $1.25
chiyuki: calls $1.25
*** SHOW DOWN ***
simonzez: shows [Qc 4h] (two pair, Fours and Deuces)
chiyuki: shows [7s 7c] (two pair, Sevens and Deuces)
chiyuki collected $7.74 from pot
*** SUMMARY ***
Total pot $8.10 | Rake $0.36 
Board [6s 2h 4d Tc 2c]
Seat 1: wtu1986 (button) folded before Flop (didn't bet)
Seat 2: deadmoneykid (small blind) folded before Flop
Seat 3: simonzez (big blind) showed [Qc 4h] and lost with two pair, Fours and Deuces
Seat 4: BlackZafiro folded before Flop (didn't bet)
Seat 5: D@vidMed folded before Flop (didn't bet)
Seat 6: TraderYao folded before Flop (didn't bet)
Seat 7: chiyuki showed [7s 7c] and won ($7.74) with two pair, Sevens and Deuces
Seat 8: Ellen1947 folded before Flop (didn't bet)
Seat 9: timburonps folded before Flop (didn't bet)



PokerStars Zoom Hand #84298878343:  Hold'em No Limit ($0.10/$0.25) - 2012/08/05 13:41:24 JST [2012/08/05 0:41:24 ET]
Table 'Whirlpool' 9-max Seat #1 is the button
Seat 1: TraderYao ($27.12 in chips) 
Seat 2: timburonps ($48.35 in chips) 
Seat 3: BlOnDhOlIc ($36.40 in chips) 
Seat 4: a_tasmanian ($105.29 in chips) 
Seat 5: hirozo ($25.78 in chips) 
Seat 6: Nerkit ($14.79 in chips) 
Seat 7: jethaz ($59.35 in chips) 
Seat 8: Lasutchik ($29.96 in chips) 
Seat 9: chiyuki ($52.38 in chips) 
timburonps: posts small blind $0.10
BlOnDhOlIc: posts big blind $0.25
*** HOLE CARDS ***
Dealt to chiyuki [Ad 9s]
a_tasmanian: folds 
hirozo: folds 
Nerkit: folds 
jethaz: folds 
Lasutchik: folds 
chiyuki: raises $0.50 to $0.75
TraderYao: folds 
timburonps: folds 
BlOnDhOlIc: folds 
Uncalled bet ($0.50) returned to chiyuki
chiyuki collected $0.60 from pot
chiyuki: doesn't show hand 
*** SUMMARY ***
Total pot $0.60 | Rake $0 
Seat 1: TraderYao (button) folded before Flop (didn't bet)
Seat 2: timburonps (small blind) folded before Flop
Seat 3: BlOnDhOlIc (big blind) folded before Flop
Seat 4: a_tasmanian folded before Flop (didn't bet)
Seat 5: hirozo folded before Flop (didn't bet)
Seat 6: Nerkit folded before Flop (didn't bet)
Seat 7: jethaz folded before Flop (didn't bet)
Seat 8: Lasutchik folded before Flop (didn't bet)
Seat 9: chiyuki collected ($0.60)



PokerStars Zoom Hand #84298885429:  Hold'em No Limit ($0.10/$0.25) - 2012/08/05 13:41:51 JST [2012/08/05 0:41:51 ET]
Table 'Whirlpool' 9-max Seat #1 is the button
Seat 1: timburonps ($25.43 in chips) 
Seat 2: PetitAlejo ($26.09 in chips) 
Seat 3: Suhoff76 ($31.95 in chips) 
Seat 4: seula i ($52.34 in chips) 
Seat 5: Dejacob ($25 in chips) 
Seat 6: fwani ($25.60 in chips) 
Seat 7: BlackZafiro ($26.61 in chips) 
Seat 8: chiyuki ($52.73 in chips) 
Seat 9: ygoegoe ($26.47 in chips) 
PetitAlejo: posts small blind $0.10
Suhoff76: posts big blind $0.25
*** HOLE CARDS ***
Dealt to chiyuki [Jc 7d]
seula i: folds 
Dejacob: raises $0.50 to $0.75
fwani: folds 
BlackZafiro: folds 
chiyuki: folds 
ygoegoe: folds 
timburonps: folds 
PetitAlejo: folds 
Suhoff76: folds 
Uncalled bet ($0.50) returned to Dejacob
Dejacob collected $0.60 from pot
Dejacob: doesn't show hand 
*** SUMMARY ***
Total pot $0.60 | Rake $0 
Seat 1: timburonps (button) folded before Flop (didn't bet)
Seat 2: PetitAlejo (small blind) folded before Flop
Seat 3: Suhoff76 (big blind) folded before Flop
Seat 4: seula i folded before Flop (didn't bet)
Seat 5: Dejacob collected ($0.60)
Seat 6: fwani folded before Flop (didn't bet)
Seat 7: BlackZafiro folded before Flop (didn't bet)
Seat 8: chiyuki folded before Flop (didn't bet)
Seat 9: ygoegoe folded before Flop (didn't bet)



PokerStars Zoom Hand #84298884424:  Hold'em No Limit ($0.10/$0.25) - 2012/08/05 13:41:47 JST [2012/08/05 0:41:47 ET]
Table 'Whirlpool' 9-max Seat #1 is the button
Seat 1: Nerkit ($14.79 in chips) 
Seat 2: Suhoff76 ($36.99 in chips) 
Seat 3: roksmokndonk ($25 in chips) 
Seat 4: chiyuki ($52.73 in chips) 
Seat 5: jethaz ($73.04 in chips) 
Seat 6: Dejacob ($43.55 in chips) 
Seat 7: silvno31 ($30.06 in chips) 
Seat 8: Landybob ($35.22 in chips) 
Seat 9: agurio ($33.06 in chips) 
Suhoff76: posts small blind $0.10
roksmokndonk: posts big blind $0.25
*** HOLE CARDS ***
Dealt to chiyuki [2s 8c]
chiyuki: folds 
jethaz: folds 
Dejacob: folds 
silvno31: folds 
Landybob: folds 
agurio: folds 
Nerkit: raises $0.50 to $0.75
Suhoff76: folds 
roksmokndonk: calls $0.50
*** FLOP *** [2h 3d 2c]
roksmokndonk: checks 
Nerkit: checks 
*** TURN *** [2h 3d 2c] [6h]
roksmokndonk: checks 
Nerkit: bets $0.75
roksmokndonk: calls $0.75
*** RIVER *** [2h 3d 2c 6h] [8h]
roksmokndonk: checks 
Nerkit: checks 
*** SHOW DOWN ***
roksmokndonk: shows [Kh Ah] (a flush, Ace high)
Nerkit: mucks hand 
roksmokndonk collected $2.96 from pot
*** SUMMARY ***
Total pot $3.10 | Rake $0.14 
Board [2h 3d 2c 6h 8h]
Seat 1: Nerkit (button) mucked [Qc Kd]
Seat 2: Suhoff76 (small blind) folded before Flop
Seat 3: roksmokndonk (big blind) showed [Kh Ah] and won ($2.96) with a flush, Ace high
Seat 4: chiyuki folded before Flop (didn't bet)
Seat 5: jethaz folded before Flop (didn't bet)
Seat 6: Dejacob folded before Flop (didn't bet)
Seat 7: silvno31 folded before Flop (didn't bet)
Seat 8: Landybob folded before Flop (didn't bet)
Seat 9: agurio folded before Flop (didn't bet)



PokerStars Zoom Hand #84298888966:  Hold'em No Limit ($0.10/$0.25) - 2012/08/05 13:42:04 JST [2012/08/05 0:42:04 ET]
Table 'Whirlpool' 9-max Seat #1 is the button
Seat 1: TraderYao ($25 in chips) 
Seat 2: vit 111 ($37.01 in chips) 
Seat 3: chiyuki ($52.73 in chips) 
Seat 4: PetitAlejo ($28.64 in chips) 
Seat 5: Alvinpe85 ($49.75 in chips) 
Seat 6: jethaz ($48.23 in chips) 
Seat 7: deadmoneykid ($35.04 in chips) 
Seat 8: kamikkaze ($16.31 in chips) 
Seat 9: Suhoff76 ($31.70 in chips) 
vit 111: posts small blind $0.10
chiyuki: posts big blind $0.25
*** HOLE CARDS ***
Dealt to chiyuki [8s 8h]
PetitAlejo: folds 
Alvinpe85: folds 
jethaz: folds 
deadmoneykid: folds 
kamikkaze: raises $0.50 to $0.75
Suhoff76: folds 
TraderYao: folds 
vit 111: calls $0.65
chiyuki: calls $0.50
*** FLOP *** [3c 5d 7d]
vit 111: checks 
chiyuki: bets $1.25
kamikkaze: folds 
vit 111: calls $1.25
*** TURN *** [3c 5d 7d] [7c]
vit 111: checks 
chiyuki: checks 
*** RIVER *** [3c 5d 7d 7c] [Js]
vit 111: checks 
chiyuki: bets $2.27
vit 111: raises $6.48 to $8.75
chiyuki: folds 
Uncalled bet ($6.48) returned to vit 111
vit 111 collected $8.87 from pot
vit 111: doesn't show hand 
*** SUMMARY ***
Total pot $9.29 | Rake $0.42 
Board [3c 5d 7d 7c Js]
Seat 1: TraderYao (button) folded before Flop (didn't bet)
Seat 2: vit 111 (small blind) collected ($8.87)
Seat 3: chiyuki (big blind) folded on the River
Seat 4: PetitAlejo folded before Flop (didn't bet)
Seat 5: Alvinpe85 folded before Flop (didn't bet)
Seat 6: jethaz folded before Flop (didn't bet)
Seat 7: deadmoneykid folded before Flop (didn't bet)
Seat 8: kamikkaze folded on the Flop
Seat 9: Suhoff76 folded before Flop (didn't bet)



PokerStars Zoom Hand #84298911151:  Hold'em No Limit ($0.10/$0.25) - 2012/08/05 13:43:31 JST [2012/08/05 0:43:31 ET]
Table 'Whirlpool' 9-max Seat #1 is the button
Seat 1: Alvinpe85 ($49.75 in chips) 
Seat 2: jethaz ($55.95 in chips) 
Seat 3: solawind ($19.58 in chips) 
Seat 4: Tom1999 ($14.21 in chips) 
Seat 5: kamikkaze ($15.21 in chips) 
Seat 6: chiyuki ($48.46 in chips) 
Seat 7: roksmokndonk ($37.84 in chips) 
Seat 8: Roglus ($22.26 in chips) 
Seat 9: Suhoff76 ($31.70 in chips) 
jethaz: posts small blind $0.10
solawind: posts big blind $0.25
*** HOLE CARDS ***
Dealt to chiyuki [Tc 3d]
Tom1999: folds 
kamikkaze: folds 
chiyuki: folds 
roksmokndonk: folds 
Roglus: folds 
Suhoff76: folds 
Alvinpe85: raises $0.37 to $0.62
jethaz: folds 
solawind: folds 
Uncalled bet ($0.37) returned to Alvinpe85
Alvinpe85 collected $0.60 from pot
Alvinpe85: doesn't show hand 
*** SUMMARY ***
Total pot $0.60 | Rake $0 
Seat 1: Alvinpe85 (button) collected ($0.60)
Seat 2: jethaz (small blind) folded before Flop
Seat 3: solawind (big blind) folded before Flop
Seat 4: Tom1999 folded before Flop (didn't bet)
Seat 5: kamikkaze folded before Flop (didn't bet)
Seat 6: chiyuki folded before Flop (didn't bet)
Seat 7: roksmokndonk folded before Flop (didn't bet)
Seat 8: Roglus folded before Flop (didn't bet)
Seat 9: Suhoff76 folded before Flop (didn't bet)



PokerStars Zoom Hand #84298908814:  Hold'em No Limit ($0.10/$0.25) - 2012/08/05 13:43:21 JST [2012/08/05 0:43:21 ET]
Table 'Whirlpool' 9-max Seat #1 is the button
Seat 1: Tom1999 ($14.21 in chips) 
Seat 2: Loholov ($15.77 in chips) 
Seat 3: Dejacob ($43.20 in chips) 
Seat 4: chiyuki ($48.46 in chips) 
Seat 5: KeLevro0 ($11.88 in chips) 
Seat 6: jtedecaliss ($159.06 in chips) 
Seat 7: ladymadon107 ($21.99 in chips) 
Seat 8: NastyMcNast ($25.35 in chips) 
Seat 9: silvno31 ($32.32 in chips) 
Loholov: posts small blind $0.10
Dejacob: posts big blind $0.25
*** HOLE CARDS ***
Dealt to chiyuki [4s 2s]
chiyuki: folds 
KeLevro0: folds 
jtedecaliss: folds 
ladymadon107: calls $0.25
NastyMcNast: folds 
silvno31: raises $1 to $1.25
Tom1999: folds 
Loholov: folds 
Dejacob: folds 
ladymadon107: folds 
Uncalled bet ($1) returned to silvno31
silvno31 collected $0.85 from pot
silvno31: doesn't show hand 
*** SUMMARY ***
Total pot $0.85 | Rake $0 
Seat 1: Tom1999 (button) folded before Flop (didn't bet)
Seat 2: Loholov (small blind) folded before Flop
Seat 3: Dejacob (big blind) folded before Flop
Seat 4: chiyuki folded before Flop (didn't bet)
Seat 5: KeLevro0 folded before Flop (didn't bet)
Seat 6: jtedecaliss folded before Flop (didn't bet)
Seat 7: ladymadon107 folded before Flop
Seat 8: NastyMcNast folded before Flop (didn't bet)
Seat 9: silvno31 collected ($0.85)



PokerStars Zoom Hand #84298912435:  Hold'em No Limit ($0.10/$0.25) - 2012/08/05 13:43:36 JST [2012/08/05 0:43:36 ET]
Table 'Whirlpool' 9-max Seat #1 is the button
Seat 1: Loholov ($19.18 in chips) 
Seat 2: Roglus ($69.14 in chips) 
Seat 3: Ellen1947 ($30.69 in chips) 
Seat 4: jethaz ($49.70 in chips) 
Seat 5: Alvinpe85 ($27.46 in chips) 
Seat 6: PetitAlejo ($36.69 in chips) 
Seat 7: Nerkit ($13.04 in chips) 
Seat 8: Suhoff76 ($28.94 in chips) 
Seat 9: chiyuki ($48.46 in chips) 
Roglus: posts small blind $0.10
Ellen1947: posts big blind $0.25
*** HOLE CARDS ***
Dealt to chiyuki [Ac Th]
jethaz: folds 
Alvinpe85: folds 
PetitAlejo: folds 
Nerkit: folds 
Suhoff76: raises $0.32 to $0.57
chiyuki: folds 
Loholov: folds 
Roglus: raises $0.68 to $1.25
Ellen1947: folds 
Suhoff76: folds 
Uncalled bet ($0.68) returned to Roglus
Roglus collected $1.39 from pot
Roglus: doesn't show hand 
*** SUMMARY ***
Total pot $1.39 | Rake $0 
Seat 1: Loholov (button) folded before Flop (didn't bet)
Seat 2: Roglus (small blind) collected ($1.39)
Seat 3: Ellen1947 (big blind) folded before Flop
Seat 4: jethaz folded before Flop (didn't bet)
Seat 5: Alvinpe85 folded before Flop (didn't bet)
Seat 6: PetitAlejo folded before Flop (didn't bet)
Seat 7: Nerkit folded before Flop (didn't bet)
Seat 8: Suhoff76 folded before Flop
Seat 9: chiyuki folded before Flop (didn't bet)



PokerStars Zoom Hand #84298916306:  Hold'em No Limit ($0.10/$0.25) - 2012/08/05 13:43:51 JST [2012/08/05 0:43:51 ET]
Table 'Whirlpool' 9-max Seat #1 is the button
Seat 1: jethaz ($49.70 in chips) 
Seat 2: chiyuki ($48.46 in chips) 
Seat 3: Suhoff76 ($38.32 in chips) 
Seat 4: wtu1986 ($26.39 in chips) 
Seat 5: Th3Fog ($22.61 in chips) 
Seat 6: ChrisCDee ($25 in chips) 
Seat 7: leo2095 ($14.46 in chips) 
Seat 8: KeLevro0 ($13.06 in chips) 
Seat 9: TraderYao ($29.53 in chips) 
chiyuki: posts small blind $0.10
Suhoff76: posts big blind $0.25
*** HOLE CARDS ***
Dealt to chiyuki [9s 4d]
wtu1986: folds 
Th3Fog: folds 
ChrisCDee: folds 
leo2095: folds 
KeLevro0: folds 
TraderYao: folds 
jethaz: folds 
chiyuki: folds 
Uncalled bet ($0.15) returned to Suhoff76
Suhoff76 collected $0.20 from pot
Suhoff76: doesn't show hand 
*** SUMMARY ***
Total pot $0.20 | Rake $0 
Seat 1: jethaz (button) folded before Flop (didn't bet)
Seat 2: chiyuki (small blind) folded before Flop
Seat 3: Suhoff76 (big blind) collected ($0.20)
Seat 4: wtu1986 folded before Flop (didn't bet)
Seat 5: Th3Fog folded before Flop (didn't bet)
Seat 6: ChrisCDee folded before Flop (didn't bet)
Seat 7: leo2095 folded before Flop (didn't bet)
Seat 8: KeLevro0 folded before Flop (didn't bet)
Seat 9: TraderYao folded before Flop (didn't bet)



PokerStars Zoom Hand #84298919161:  Hold'em No Limit ($0.10/$0.25) - 2012/08/05 13:44:02 JST [2012/08/05 0:44:02 ET]
Table 'Whirlpool' 9-max Seat #1 is the button
Seat 1: fwani ($25 in chips) 
Seat 2: PetitAlejo ($37.04 in chips) 
Seat 3: carlosrbr ($12.50 in chips) 
Seat 4: NastyMcNast ($32.40 in chips) 
Seat 5: Anafim ($15.78 in chips) 
Seat 6: chiyuki ($48.36 in chips) 
Seat 7: D@vidMed ($25.25 in chips) 
Seat 8: gazandim ($23.40 in chips) 
Seat 9: Alvinpe85 ($50.10 in chips) 
PetitAlejo: posts small blind $0.10
carlosrbr: posts big blind $0.25
*** HOLE CARDS ***
Dealt to chiyuki [Kc 7c]
NastyMcNast: folds 
Anafim: folds 
chiyuki: folds 
D@vidMed: folds 
gazandim: folds 
Alvinpe85: folds 
fwani: raises $0.35 to $0.60
PetitAlejo: folds 
carlosrbr: folds 
Uncalled bet ($0.35) returned to fwani
fwani collected $0.60 from pot
fwani: doesn't show hand 
*** SUMMARY ***
Total pot $0.60 | Rake $0 
Seat 1: fwani (button) collected ($0.60)
Seat 2: PetitAlejo (small blind) folded before Flop
Seat 3: carlosrbr (big blind) folded before Flop
Seat 4: NastyMcNast folded before Flop (didn't bet)
Seat 5: Anafim folded before Flop (didn't bet)
Seat 6: chiyuki folded before Flop (didn't bet)
Seat 7: D@vidMed folded before Flop (didn't bet)
Seat 8: gazandim folded before Flop (didn't bet)
Seat 9: Alvinpe85 folded before Flop (didn't bet)



PokerStars Zoom Hand #84298909619:  Hold'em No Limit ($0.10/$0.25) - 2012/08/05 13:43:25 JST [2012/08/05 0:43:25 ET]
Table 'Whirlpool' 9-max Seat #1 is the button
Seat 1: chiyuki ($48.46 in chips) 
Seat 2: ll_LaMeR_ll ($41.62 in chips) 
Seat 3: cR!Ma*aRm ($42.70 in chips) 
Seat 4: Dejacob ($25.35 in chips) 
Seat 5: Jippyflip ($19.41 in chips) 
Seat 6: BlackValaR ($11.43 in chips) 
Seat 7: vit 111 ($41.61 in chips) 
Seat 8: kamikkaze ($15.21 in chips) 
Seat 9: roksmokndonk ($37.84 in chips) 
ll_LaMeR_ll: posts small blind $0.10
cR!Ma*aRm: posts big blind $0.25
*** HOLE CARDS ***
Dealt to chiyuki [3c 7c]
Dejacob: raises $0.50 to $0.75
Jippyflip: calls $0.75
BlackValaR: folds 
vit 111: calls $0.75
kamikkaze: folds 
roksmokndonk: folds 
chiyuki: folds 
ll_LaMeR_ll: folds 
cR!Ma*aRm: folds 
*** FLOP *** [Th Qd 4d]
Dejacob: bets $2
Jippyflip: calls $2
vit 111: folds 
*** TURN *** [Th Qd 4d] [6h]
Dejacob: bets $6
Jippyflip: calls $6
*** RIVER *** [Th Qd 4d 6h] [Qh]
Dejacob: checks 
Jippyflip: checks 
*** SHOW DOWN ***
Dejacob: shows [Ah Qc] (three of a kind, Queens)
Jippyflip: mucks hand 
Dejacob collected $17.76 from pot
*** SUMMARY ***
Total pot $18.60 | Rake $0.84 
Board [Th Qd 4d 6h Qh]
Seat 1: chiyuki (button) folded before Flop (didn't bet)
Seat 2: ll_LaMeR_ll (small blind) folded before Flop
Seat 3: cR!Ma*aRm (big blind) folded before Flop
Seat 4: Dejacob showed [Ah Qc] and won ($17.76) with three of a kind, Queens
Seat 5: Jippyflip mucked [Ad Kd]
Seat 6: BlackValaR folded before Flop (didn't bet)
Seat 7: vit 111 folded on the Flop
Seat 8: kamikkaze folded before Flop (didn't bet)
Seat 9: roksmokndonk folded before Flop (didn't bet)



PokerStars Zoom Hand #84298920184:  Hold'em No Limit ($0.10/$0.25) - 2012/08/05 13:44:06 JST [2012/08/05 0:44:06 ET]
Table 'Whirlpool' 9-max Seat #1 is the button
Seat 1: ygoegoe ($29.80 in chips) 
Seat 2: Nerkit ($12.92 in chips) 
Seat 3: BlackZafiro ($25.35 in chips) 
Seat 4: jethaz ($56.20 in chips) 
Seat 5: goldstone ($39.88 in chips) 
Seat 6: D@vidMed ($25.25 in chips) 
Seat 7: KeLevro0 ($13.06 in chips) 
Seat 8: chiyuki ($48.36 in chips) 
Seat 9: Th3Fog ($22.61 in chips) 
Nerkit: posts small blind $0.10
BlackZafiro: posts big blind $0.25
*** HOLE CARDS ***
Dealt to chiyuki [2h 5s]
jethaz: folds 
goldstone: folds 
D@vidMed: folds 
KeLevro0: raises $0.42 to $0.67
chiyuki: folds 
Th3Fog: folds 
ygoegoe: folds 
Nerkit: folds 
BlackZafiro: folds 
Uncalled bet ($0.42) returned to KeLevro0
KeLevro0 collected $0.60 from pot
KeLevro0: doesn't show hand 
*** SUMMARY ***
Total pot $0.60 | Rake $0 
Seat 1: ygoegoe (button) folded before Flop (didn't bet)
Seat 2: Nerkit (small blind) folded before Flop
Seat 3: BlackZafiro (big blind) folded before Flop
Seat 4: jethaz folded before Flop (didn't bet)
Seat 5: goldstone folded before Flop (didn't bet)
Seat 6: D@vidMed folded before Flop (didn't bet)
Seat 7: KeLevro0 collected ($0.60)
Seat 8: chiyuki folded before Flop (didn't bet)
Seat 9: Th3Fog folded before Flop (didn't bet)



PokerStars Zoom Hand #84298925674:  Hold'em No Limit ($0.10/$0.25) - 2012/08/05 13:44:27 JST [2012/08/05 0:44:27 ET]
Table 'Whirlpool' 9-max Seat #1 is the button
Seat 1: roksmokndonk ($38.62 in chips) 
Seat 2: carlosrbr ($12.25 in chips) 
Seat 3: deadmoneykid ($35.04 in chips) 
Seat 4: taksist889 ($18.11 in chips) 
Seat 5: Wilcox76607 ($20.50 in chips) 
Seat 6: goldstone ($39.88 in chips) 
Seat 7: chiyuki ($48.11 in chips) 
Seat 8: ChrisCDee ($25 in chips) 
Seat 9: mariuka1 ($11.05 in chips) 
carlosrbr: posts small blind $0.10
deadmoneykid: posts big blind $0.25
*** HOLE CARDS ***
Dealt to chiyuki [5c 8h]
taksist889: folds 
Wilcox76607: folds 
goldstone: folds 
chiyuki: folds 
ChrisCDee: folds 
mariuka1: folds 
roksmokndonk: folds 
carlosrbr: folds 
Uncalled bet ($0.15) returned to deadmoneykid
deadmoneykid collected $0.20 from pot
deadmoneykid: doesn't show hand 
*** SUMMARY ***
Total pot $0.20 | Rake $0 
Seat 1: roksmokndonk (button) folded before Flop (didn't bet)
Seat 2: carlosrbr (small blind) folded before Flop
Seat 3: deadmoneykid (big blind) collected ($0.20)
Seat 4: taksist889 folded before Flop (didn't bet)
Seat 5: Wilcox76607 folded before Flop (didn't bet)
Seat 6: goldstone folded before Flop (didn't bet)
Seat 7: chiyuki folded before Flop (didn't bet)
Seat 8: ChrisCDee folded before Flop (didn't bet)
Seat 9: mariuka1 folded before Flop (didn't bet)



PokerStars Zoom Hand #84298921509:  Hold'em No Limit ($0.10/$0.25) - 2012/08/05 13:44:11 JST [2012/08/05 0:44:11 ET]
Table 'Whirlpool' 9-max Seat #1 is the button
Seat 1: kamikkaze ($14.96 in chips) 
Seat 2: PetitAlejo ($25 in chips) 
Seat 3: chiyuki ($48.36 in chips) 
Seat 4: NastyMcNast ($29.70 in chips) 
Seat 5: solawind ($19.33 in chips) 
Seat 6: TraderYao ($29.53 in chips) 
Seat 7: Roglus ($20.76 in chips) 
Seat 8: peng2astic ($21.53 in chips) 
Seat 9: gunbowler ($149.61 in chips) 
PetitAlejo: posts small blind $0.10
chiyuki: posts big blind $0.25
*** HOLE CARDS ***
Dealt to chiyuki [5h Ad]
NastyMcNast: folds 
solawind: raises $0.50 to $0.75
TraderYao: folds 
Roglus: folds 
peng2astic: calls $0.75
gunbowler: calls $0.75
kamikkaze: folds 
PetitAlejo: folds 
chiyuki: folds 
*** FLOP *** [Kc 9d As]
solawind: bets $1.48
peng2astic: raises $1.48 to $2.96
gunbowler: folds 
solawind: folds 
Uncalled bet ($1.48) returned to peng2astic
peng2astic collected $5.31 from pot
peng2astic: doesn't show hand 
*** SUMMARY ***
Total pot $5.56 | Rake $0.25 
Board [Kc 9d As]
Seat 1: kamikkaze (button) folded before Flop (didn't bet)
Seat 2: PetitAlejo (small blind) folded before Flop
Seat 3: chiyuki (big blind) folded before Flop
Seat 4: NastyMcNast folded before Flop (didn't bet)
Seat 5: solawind folded on the Flop
Seat 6: TraderYao folded before Flop (didn't bet)
Seat 7: Roglus folded before Flop (didn't bet)
Seat 8: peng2astic collected ($5.31)
Seat 9: gunbowler folded on the Flop



PokerStars Zoom Hand #84298915254:  Hold'em No Limit ($0.10/$0.25) - 2012/08/05 13:43:47 JST [2012/08/05 0:43:47 ET]
Table 'Whirlpool' 9-max Seat #1 is the button
Seat 1: Suhoff76 ($38.32 in chips) 
Seat 2: Dejacob ($42.95 in chips) 
Seat 3: Landybob ($35.67 in chips) 
Seat 4: jethaz ($49.70 in chips) 
Seat 5: BlOnDhOlIc ($66.37 in chips) 
Seat 6: fwani ($25 in chips) 
Seat 7: chiyuki ($48.46 in chips) 
Seat 8: Loholov ($15.67 in chips) 
Seat 9: NastyMcNast ($25.10 in chips) 
Dejacob: posts small blind $0.10
Landybob: posts big blind $0.25
*** HOLE CARDS ***
Dealt to chiyuki [8s 9h]
jethaz: folds 
BlOnDhOlIc: folds 
fwani: raises $0.35 to $0.60
chiyuki: folds 
Loholov: folds 
NastyMcNast: calls $0.60
Suhoff76: folds 
Dejacob: raises $1.65 to $2.25
Landybob: folds 
fwani: calls $1.65
NastyMcNast: calls $1.65
*** FLOP *** [6h Qh Qc]
Dejacob: checks 
fwani: bets $3.40
NastyMcNast: folds 
Dejacob: folds 
Uncalled bet ($3.40) returned to fwani
fwani collected $6.68 from pot
fwani: doesn't show hand 
*** SUMMARY ***
Total pot $7 | Rake $0.32 
Board [6h Qh Qc]
Seat 1: Suhoff76 (button) folded before Flop (didn't bet)
Seat 2: Dejacob (small blind) folded on the Flop
Seat 3: Landybob (big blind) folded before Flop
Seat 4: jethaz folded before Flop (didn't bet)
Seat 5: BlOnDhOlIc folded before Flop (didn't bet)
Seat 6: fwani collected ($6.68)
Seat 7: chiyuki folded before Flop (didn't bet)
Seat 8: Loholov folded before Flop (didn't bet)
Seat 9: NastyMcNast folded on the Flop



PokerStars Zoom Hand #84298929562:  Hold'em No Limit ($0.10/$0.25) - 2012/08/05 13:44:43 JST [2012/08/05 0:44:43 ET]
Table 'Whirlpool' 9-max Seat #1 is the button
Seat 1: jethaz ($56.75 in chips) 
Seat 2: Dejacob ($34.36 in chips) 
Seat 3: taksist889 ($18.01 in chips) 
Seat 4: solawind ($17.10 in chips) 
Seat 5: Nerkit ($12.94 in chips) 
Seat 6: Roglus ($67.71 in chips) 
Seat 7: Ellen1947 ($29.94 in chips) 
Seat 8: hirozo ($25 in chips) 
Seat 9: chiyuki ($48.11 in chips) 
Dejacob: posts small blind $0.10
taksist889: posts big blind $0.25
*** HOLE CARDS ***
Dealt to chiyuki [Jc 8h]
solawind: folds 
Nerkit: folds 
Roglus: folds 
Ellen1947: folds 
hirozo: folds 
chiyuki: folds 
jethaz: folds 
Dejacob: folds 
Uncalled bet ($0.15) returned to taksist889
taksist889 collected $0.20 from pot
taksist889: doesn't show hand 
*** SUMMARY ***
Total pot $0.20 | Rake $0 
Seat 1: jethaz (button) folded before Flop (didn't bet)
Seat 2: Dejacob (small blind) folded before Flop
Seat 3: taksist889 (big blind) collected ($0.20)
Seat 4: solawind folded before Flop (didn't bet)
Seat 5: Nerkit folded before Flop (didn't bet)
Seat 6: Roglus folded before Flop (didn't bet)
Seat 7: Ellen1947 folded before Flop (didn't bet)
Seat 8: hirozo folded before Flop (didn't bet)
Seat 9: chiyuki folded before Flop (didn't bet)



PokerStars Zoom Hand #84298930932:  Hold'em No Limit ($0.10/$0.25) - 2012/08/05 13:44:48 JST [2012/08/05 0:44:48 ET]
Table 'Whirlpool' 9-max Seat #1 is the button
Seat 1: KeLevro0 ($10.88 in chips) 
Seat 2: goldstone ($39.88 in chips) 
Seat 3: Dejacob ($34.26 in chips) 
Seat 4: PetitAlejo ($25.67 in chips) 
Seat 5: chiyuki ($48.11 in chips) 
Seat 6: Loholov ($15 in chips) 
Seat 7: cr0lox ($26.72 in chips) 
Seat 8: BlackZafiro ($25 in chips) 
Seat 9: Suhoff76 ($34.88 in chips) 
goldstone: posts small blind $0.10
Dejacob: posts big blind $0.25
*** HOLE CARDS ***
Dealt to chiyuki [Jc Qh]
PetitAlejo: folds 
chiyuki: folds 
Loholov: folds 
cr0lox: folds 
BlackZafiro: folds 
Suhoff76: folds 
KeLevro0: folds 
goldstone: folds 
Uncalled bet ($0.15) returned to Dejacob
Dejacob collected $0.20 from pot
Dejacob: doesn't show hand 
*** SUMMARY ***
Total pot $0.20 | Rake $0 
Seat 1: KeLevro0 (button) folded before Flop (didn't bet)
Seat 2: goldstone (small blind) folded before Flop
Seat 3: Dejacob (big blind) collected ($0.20)
Seat 4: PetitAlejo folded before Flop (didn't bet)
Seat 5: chiyuki folded before Flop (didn't bet)
Seat 6: Loholov folded before Flop (didn't bet)
Seat 7: cr0lox folded before Flop (didn't bet)
Seat 8: BlackZafiro folded before Flop (didn't bet)
Seat 9: Suhoff76 folded before Flop (didn't bet)



PokerStars Zoom Hand #84298927002:  Hold'em No Limit ($0.10/$0.25) - 2012/08/05 13:44:33 JST [2012/08/05 0:44:33 ET]
Table 'Whirlpool' 9-max Seat #1 is the button
Seat 1: chiyuki ($48.11 in chips) 
Seat 2: Wilcox76607 ($20.50 in chips) 
Seat 3: agurio ($32.21 in chips) 
Seat 4: Suhoff76 ($28.27 in chips) 
Seat 5: TraderYao ($25 in chips) 
Seat 6: Ellen1947 ($29.94 in chips) 
Seat 7: taiali ($17.95 in chips) 
Seat 8: lovinlife5 ($21.30 in chips) 
Seat 9: carlosrbr ($12.15 in chips) 
Wilcox76607: posts small blind $0.10
agurio: posts big blind $0.25
*** HOLE CARDS ***
Dealt to chiyuki [4d Kd]
Suhoff76: folds 
TraderYao: raises $0.50 to $0.75
Ellen1947: folds 
taiali: folds 
lovinlife5: folds 
carlosrbr: calls $0.75
chiyuki: folds 
Wilcox76607: calls $0.65
agurio: calls $0.50
*** FLOP *** [Qh Td Ks]
Wilcox76607: checks 
agurio: checks 
TraderYao: checks 
carlosrbr: checks 
*** TURN *** [Qh Td Ks] [As]
Wilcox76607: checks 
agurio: checks 
TraderYao: checks 
carlosrbr: bets $1.50
Wilcox76607: folds 
agurio: folds 
TraderYao: calls $1.50
*** RIVER *** [Qh Td Ks As] [8s]
TraderYao: checks 
carlosrbr: checks 
*** SHOW DOWN ***
TraderYao: shows [Kh Ad] (two pair, Aces and Kings)
carlosrbr: shows [8d 8h] (three of a kind, Eights)
carlosrbr collected $5.73 from pot
*** SUMMARY ***
Total pot $6 | Rake $0.27 
Board [Qh Td Ks As 8s]
Seat 1: chiyuki (button) folded before Flop (didn't bet)
Seat 2: Wilcox76607 (small blind) folded on the Turn
Seat 3: agurio (big blind) folded on the Turn
Seat 4: Suhoff76 folded before Flop (didn't bet)
Seat 5: TraderYao showed [Kh Ad] and lost with two pair, Aces and Kings
Seat 6: Ellen1947 folded before Flop (didn't bet)
Seat 7: taiali folded before Flop (didn't bet)
Seat 8: lovinlife5 folded before Flop (didn't bet)
Seat 9: carlosrbr showed [8d 8h] and won ($5.73) with three of a kind, Eights



PokerStars Zoom Hand #84298933316:  Hold'em No Limit ($0.10/$0.25) - 2012/08/05 13:44:57 JST [2012/08/05 0:44:57 ET]
Table 'Whirlpool' 9-max Seat #1 is the button
Seat 1: BlOnDhOlIc ($25 in chips) 
Seat 2: chiyuki ($48.11 in chips) 
Seat 3: BlackValaR ($6.93 in chips) 
Seat 4: jtedecaliss ($158.96 in chips) 
Seat 5: ChrisCDee ($26.69 in chips) 
Seat 6: Anafim ($15.43 in chips) 
Seat 7: TamiKarpen13 ($16.31 in chips) 
Seat 8: leo2095 ($14.36 in chips) 
Seat 9: hirozo ($25 in chips) 
chiyuki: posts small blind $0.10
BlackValaR: posts big blind $0.25
*** HOLE CARDS ***
Dealt to chiyuki [8s Ks]
jtedecaliss: folds 
ChrisCDee: folds 
Anafim: folds 
TamiKarpen13: folds 
leo2095: calls $0.25
hirozo: folds 
BlOnDhOlIc: folds 
chiyuki: folds 
BlackValaR: checks 
*** FLOP *** [Jc 3d 2h]
BlackValaR: checks 
leo2095: bets $0.50
BlackValaR: folds 
Uncalled bet ($0.50) returned to leo2095
leo2095 collected $0.57 from pot
leo2095: doesn't show hand 
*** SUMMARY ***
Total pot $0.60 | Rake $0.03 
Board [Jc 3d 2h]
Seat 1: BlOnDhOlIc (button) folded before Flop (didn't bet)
Seat 2: chiyuki (small blind) folded before Flop
Seat 3: BlackValaR (big blind) folded on the Flop
Seat 4: jtedecaliss folded before Flop (didn't bet)
Seat 5: ChrisCDee folded before Flop (didn't bet)
Seat 6: Anafim folded before Flop (didn't bet)
Seat 7: TamiKarpen13 folded before Flop (didn't bet)
Seat 8: leo2095 collected ($0.57)
Seat 9: hirozo folded before Flop (didn't bet)



PokerStars Zoom Hand #84298938489:  Hold'em No Limit ($0.10/$0.25) - 2012/08/05 13:45:17 JST [2012/08/05 0:45:17 ET]
Table 'Whirlpool' 9-max Seat #1 is the button
Seat 1: Suhoff76 ($39.38 in chips) 
Seat 2: timburonps ($25 in chips) 
Seat 3: BlOnDhOlIc ($25 in chips) 
Seat 4: BlackZafiro ($25 in chips) 
Seat 5: chiyuki ($48.01 in chips) 
Seat 6: KeLevro0 ($13.06 in chips) 
Seat 7: jethaz ($41.35 in chips) 
Seat 8: ShockLaMuc ($23.55 in chips) 
Seat 9: seula i ($25.04 in chips) 
timburonps: posts small blind $0.10
BlOnDhOlIc: posts big blind $0.25
*** HOLE CARDS ***
Dealt to chiyuki [9d Ac]
BlackZafiro: folds 
chiyuki: folds 
KeLevro0: folds 
jethaz: folds 
ShockLaMuc: raises $0.50 to $0.75
seula i: folds 
Suhoff76: folds 
timburonps: folds 
BlOnDhOlIc: folds 
Uncalled bet ($0.50) returned to ShockLaMuc
ShockLaMuc collected $0.60 from pot
ShockLaMuc: doesn't show hand 
*** SUMMARY ***
Total pot $0.60 | Rake $0 
Seat 1: Suhoff76 (button) folded before Flop (didn't bet)
Seat 2: timburonps (small blind) folded before Flop
Seat 3: BlOnDhOlIc (big blind) folded before Flop
Seat 4: BlackZafiro folded before Flop (didn't bet)
Seat 5: chiyuki folded before Flop (didn't bet)
Seat 6: KeLevro0 folded before Flop (didn't bet)
Seat 7: jethaz folded before Flop (didn't bet)
Seat 8: ShockLaMuc collected ($0.60)
Seat 9: seula i folded before Flop (didn't bet)



PokerStars Zoom Hand #84298940035:  Hold'em No Limit ($0.10/$0.25) - 2012/08/05 13:45:23 JST [2012/08/05 0:45:23 ET]
Table 'Whirlpool' 9-max Seat #1 is the button
Seat 1: TraderYao ($25 in chips) 
Seat 2: Suhoff76 ($31.30 in chips) 
Seat 3: mariuka1 ($12.25 in chips) 
Seat 4: chiyuki ($48.01 in chips) 
Seat 5: Rudolf ($25.35 in chips) 
Seat 6: BlackZafiro ($25 in chips) 
Seat 7: carlosrbr ($15.63 in chips) 
Seat 8: KeLevro0 ($13.06 in chips) 
Seat 9: PetitAlejo ($35.94 in chips) 
Suhoff76: posts small blind $0.10
mariuka1: posts big blind $0.25
*** HOLE CARDS ***
Dealt to chiyuki [7c 7d]
chiyuki: folds 
Rudolf: folds 
BlackZafiro: folds 
carlosrbr: folds 
KeLevro0: raises $0.42 to $0.67
PetitAlejo: folds 
TraderYao: folds 
Suhoff76: folds 
mariuka1: folds 
Uncalled bet ($0.42) returned to KeLevro0
KeLevro0 collected $0.60 from pot
KeLevro0: doesn't show hand 
*** SUMMARY ***
Total pot $0.60 | Rake $0 
Seat 1: TraderYao (button) folded before Flop (didn't bet)
Seat 2: Suhoff76 (small blind) folded before Flop
Seat 3: mariuka1 (big blind) folded before Flop
Seat 4: chiyuki folded before Flop (didn't bet)
Seat 5: Rudolf folded before Flop (didn't bet)
Seat 6: BlackZafiro folded before Flop (didn't bet)
Seat 7: carlosrbr folded before Flop (didn't bet)
Seat 8: KeLevro0 collected ($0.60)
Seat 9: PetitAlejo folded before Flop (didn't bet)



PokerStars Zoom Hand #84298940836:  Hold'em No Limit ($0.10/$0.25) - 2012/08/05 13:45:26 JST [2012/08/05 0:45:26 ET]
Table 'Whirlpool' 9-max Seat #1 is the button
Seat 1: BlackValaR ($6.68 in chips) 
Seat 2: Loholov ($15 in chips) 
Seat 3: Suhoff76 ($39.38 in chips) 
Seat 4: KeLevro0 ($10.88 in chips) 
Seat 5: jethaz ($41.35 in chips) 
Seat 6: ygoegoe ($26.21 in chips) 
Seat 7: PetitAlejo ($25.67 in chips) 
Seat 8: chiyuki ($48.01 in chips) 
Seat 9: hirozo ($25 in chips) 
Loholov: posts small blind $0.10
Suhoff76: posts big blind $0.25
*** HOLE CARDS ***
Dealt to chiyuki [Ad 7h]
KeLevro0: folds 
jethaz: folds 
ygoegoe: folds 
PetitAlejo: folds 
chiyuki: folds 
hirozo: raises $0.50 to $0.75
BlackValaR: folds 
Loholov: folds 
Suhoff76: folds 
Uncalled bet ($0.50) returned to hirozo
hirozo collected $0.60 from pot
hirozo: doesn't show hand 
*** SUMMARY ***
Total pot $0.60 | Rake $0 
Seat 1: BlackValaR (button) folded before Flop (didn't bet)
Seat 2: Loholov (small blind) folded before Flop
Seat 3: Suhoff76 (big blind) folded before Flop
Seat 4: KeLevro0 folded before Flop (didn't bet)
Seat 5: jethaz folded before Flop (didn't bet)
Seat 6: ygoegoe folded before Flop (didn't bet)
Seat 7: PetitAlejo folded before Flop (didn't bet)
Seat 8: chiyuki folded before Flop (didn't bet)
Seat 9: hirozo collected ($0.60)



PokerStars Zoom Hand #84298941654:  Hold'em No Limit ($0.10/$0.25) - 2012/08/05 13:45:29 JST [2012/08/05 0:45:29 ET]
Table 'Whirlpool' 9-max Seat #1 is the button
Seat 1: ladymadon107 ($22.34 in chips) 
Seat 2: softdesign ($77.08 in chips) 
Seat 3: BlackZafiro ($25 in chips) 
Seat 4: chiyuki ($48.01 in chips) 
Seat 5: carlosrbr ($15.63 in chips) 
Seat 6: gunbowler ($148.70 in chips) 
Seat 7: roksmokndonk ($38.62 in chips) 
Seat 8: Alvinpe85 ($27.66 in chips) 
Seat 9: fwani ($29.33 in chips) 
softdesign: posts small blind $0.10
BlackZafiro: posts big blind $0.25
*** HOLE CARDS ***
Dealt to chiyuki [8d 2d]
chiyuki: folds 
carlosrbr: folds 
gunbowler: raises $0.35 to $0.60
roksmokndonk: folds 
Alvinpe85: folds 
fwani: folds 
ladymadon107: folds 
softdesign: raises $1.90 to $2.50
BlackZafiro: folds 
gunbowler: folds 
Uncalled bet ($1.90) returned to softdesign
softdesign collected $1.45 from pot
softdesign: doesn't show hand 
*** SUMMARY ***
Total pot $1.45 | Rake $0 
Seat 1: ladymadon107 (button) folded before Flop (didn't bet)
Seat 2: softdesign (small blind) collected ($1.45)
Seat 3: BlackZafiro (big blind) folded before Flop
Seat 4: chiyuki folded before Flop (didn't bet)
Seat 5: carlosrbr folded before Flop (didn't bet)
Seat 6: gunbowler folded before Flop
Seat 7: roksmokndonk folded before Flop (didn't bet)
Seat 8: Alvinpe85 folded before Flop (didn't bet)
Seat 9: fwani folded before Flop (didn't bet)



PokerStars Zoom Hand #84298950941:  Hold'em No Limit ($0.10/$0.25) - 2012/08/05 13:46:06 JST [2012/08/05 0:46:06 ET]
Table 'Whirlpool' 9-max Seat #1 is the button
Seat 1: chiyuki ($47.76 in chips) 
Seat 2: Roglus ($65.01 in chips) 
Seat 3: PetitAlejo ($25.25 in chips) 
Seat 4: wildy29 ($12.69 in chips) 
Seat 5: Wilcox76607 ($19.50 in chips) 
Seat 6: Alvinpe85 ($27.41 in chips) 
Seat 7: BlOnDhOlIc ($25 in chips) 
Seat 8: NastyMcNast ($25 in chips) 
Seat 9: slapshot2011 ($45.77 in chips) 
Roglus: posts small blind $0.10
PetitAlejo: posts big blind $0.25
*** HOLE CARDS ***
Dealt to chiyuki [3s Jh]
wildy29: folds 
Wilcox76607: folds 
Alvinpe85: folds 
BlOnDhOlIc: folds 
NastyMcNast: folds 
slapshot2011: calls $0.25
chiyuki: folds 
Roglus: raises $0.75 to $1
PetitAlejo: folds 
slapshot2011: folds 
Uncalled bet ($0.75) returned to Roglus
Roglus collected $0.75 from pot
Roglus: doesn't show hand 
*** SUMMARY ***
Total pot $0.75 | Rake $0 
Seat 1: chiyuki (button) folded before Flop (didn't bet)
Seat 2: Roglus (small blind) collected ($0.75)
Seat 3: PetitAlejo (big blind) folded before Flop
Seat 4: wildy29 folded before Flop (didn't bet)
Seat 5: Wilcox76607 folded before Flop (didn't bet)
Seat 6: Alvinpe85 folded before Flop (didn't bet)
Seat 7: BlOnDhOlIc folded before Flop (didn't bet)
Seat 8: NastyMcNast folded before Flop (didn't bet)
Seat 9: slapshot2011 folded before Flop



PokerStars Zoom Hand #84298942952:  Hold'em No Limit ($0.10/$0.25) - 2012/08/05 13:45:34 JST [2012/08/05 0:45:34 ET]
Table 'Whirlpool' 9-max Seat #1 is the button
Seat 1: solawind ($11.35 in chips) 
Seat 2: ygoegoe ($30.57 in chips) 
Seat 3: chiyuki ($48.01 in chips) 
Seat 4: ChrisCDee ($25.35 in chips) 
Seat 5: NastyMcNast ($31.98 in chips) 
Seat 6: carlosrbr ($15.63 in chips) 
Seat 7: agurio ($25 in chips) 
Seat 8: DjJooni ($12 in chips) 
Seat 9: D@vidMed ($25.25 in chips) 
ygoegoe: posts small blind $0.10
chiyuki: posts big blind $0.25
*** HOLE CARDS ***
Dealt to chiyuki [2h Qd]
ChrisCDee: raises $0.50 to $0.75
NastyMcNast: folds 
carlosrbr: folds 
agurio: folds 
DjJooni: folds 
D@vidMed: folds 
solawind: calls $0.75
ygoegoe: folds 
chiyuki: folds 
*** FLOP *** [8c 5s 4d]
ChrisCDee: checks 
solawind: bets $1.06
ChrisCDee: folds 
Uncalled bet ($1.06) returned to solawind
solawind collected $1.77 from pot
solawind: doesn't show hand 
*** SUMMARY ***
Total pot $1.85 | Rake $0.08 
Board [8c 5s 4d]
Seat 1: solawind (button) collected ($1.77)
Seat 2: ygoegoe (small blind) folded before Flop
Seat 3: chiyuki (big blind) folded before Flop
Seat 4: ChrisCDee folded on the Flop
Seat 5: NastyMcNast folded before Flop (didn't bet)
Seat 6: carlosrbr folded before Flop (didn't bet)
Seat 7: agurio folded before Flop (didn't bet)
Seat 8: DjJooni folded before Flop (didn't bet)
Seat 9: D@vidMed folded before Flop (didn't bet)



PokerStars Zoom Hand #84298956305:  Hold'em No Limit ($0.10/$0.25) - 2012/08/05 13:46:27 JST [2012/08/05 0:46:27 ET]
Table 'Whirlpool' 9-max Seat #1 is the button
Seat 1: NastyMcNast ($31.63 in chips) 
Seat 2: Landybob ($35.10 in chips) 
Seat 3: Suhoff76 ($39.03 in chips) 
Seat 4: gunbowler ($147.50 in chips) 
Seat 5: Roglus ($65.51 in chips) 
Seat 6: taksist889 ($28.85 in chips) 
Seat 7: fwani ($28.54 in chips) 
Seat 8: chiyuki ($47.76 in chips) 
Seat 9: jethaz ($41 in chips) 
Landybob: posts small blind $0.10
Suhoff76: posts big blind $0.25
*** HOLE CARDS ***
Dealt to chiyuki [2d 3h]
gunbowler: folds 
Roglus: folds 
taksist889: folds 
fwani: folds 
chiyuki: folds 
jethaz: folds 
NastyMcNast: folds 
Landybob: folds 
Uncalled bet ($0.15) returned to Suhoff76
Suhoff76 collected $0.20 from pot
Suhoff76: doesn't show hand 
*** SUMMARY ***
Total pot $0.20 | Rake $0 
Seat 1: NastyMcNast (button) folded before Flop (didn't bet)
Seat 2: Landybob (small blind) folded before Flop
Seat 3: Suhoff76 (big blind) collected ($0.20)
Seat 4: gunbowler folded before Flop (didn't bet)
Seat 5: Roglus folded before Flop (didn't bet)
Seat 6: taksist889 folded before Flop (didn't bet)
Seat 7: fwani folded before Flop (didn't bet)
Seat 8: chiyuki folded before Flop (didn't bet)
Seat 9: jethaz folded before Flop (didn't bet)



PokerStars Zoom Hand #84298951953:  Hold'em No Limit ($0.10/$0.25) - 2012/08/05 13:46:10 JST [2012/08/05 0:46:10 ET]
Table 'Whirlpool' 9-max Seat #1 is the button
Seat 1: Wilcox76607 ($19.50 in chips) 
Seat 2: Suhoff76 ($39.13 in chips) 
Seat 3: taiali ($17.43 in chips) 
Seat 4: NastyMcNast ($25 in chips) 
Seat 5: Th3Fog ($22.61 in chips) 
Seat 6: silvno31 ($40.12 in chips) 
Seat 7: mariuka1 ($11.90 in chips) 
Seat 8: TraderYao ($28.43 in chips) 
Seat 9: chiyuki ($47.76 in chips) 
Suhoff76: posts small blind $0.10
taiali: posts big blind $0.25
*** HOLE CARDS ***
Dealt to chiyuki [5h Qh]
NastyMcNast: raises $0.50 to $0.75
Th3Fog: folds 
silvno31: folds 
mariuka1: folds 
TraderYao: calls $0.75
chiyuki: folds 
Wilcox76607: folds 
Suhoff76: folds 
taiali: folds 
*** FLOP *** [Kh 8h 7c]
NastyMcNast: checks 
TraderYao: bets $1.09
NastyMcNast: folds 
Uncalled bet ($1.09) returned to TraderYao
TraderYao collected $1.77 from pot
TraderYao: doesn't show hand 
*** SUMMARY ***
Total pot $1.85 | Rake $0.08 
Board [Kh 8h 7c]
Seat 1: Wilcox76607 (button) folded before Flop (didn't bet)
Seat 2: Suhoff76 (small blind) folded before Flop
Seat 3: taiali (big blind) folded before Flop
Seat 4: NastyMcNast folded on the Flop
Seat 5: Th3Fog folded before Flop (didn't bet)
Seat 6: silvno31 folded before Flop (didn't bet)
Seat 7: mariuka1 folded before Flop (didn't bet)
Seat 8: TraderYao collected ($1.77)
Seat 9: chiyuki folded before Flop (didn't bet)



PokerStars Zoom Hand #84298957328:  Hold'em No Limit ($0.10/$0.25) - 2012/08/05 13:46:31 JST [2012/08/05 0:46:31 ET]
Table 'Whirlpool' 9-max Seat #1 is the button
Seat 1: Roglus ($65.51 in chips) 
Seat 2: chiyuki ($47.76 in chips) 
Seat 3: KeLevro0 ($9.33 in chips) 
Seat 4: PetitAlejo ($26.02 in chips) 
Seat 5: jeff0923 ($27.18 in chips) 
Seat 6: Paranoix1990 ($26.18 in chips) 
Seat 7: BlOnDhOlIc ($45.84 in chips) 
Seat 8: ShockLaMuc ($23.55 in chips) 
Seat 9: Landybob ($35 in chips) 
chiyuki: posts small blind $0.10
KeLevro0: posts big blind $0.25
*** HOLE CARDS ***
Dealt to chiyuki [9c Kd]
PetitAlejo: folds 
jeff0923: folds 
Paranoix1990: calls $0.25
BlOnDhOlIc: folds 
ShockLaMuc: folds 
Landybob: folds 
Roglus: folds 
chiyuki: folds 
KeLevro0: checks 
*** FLOP *** [2s 4s 6c]
KeLevro0: checks 
Paranoix1990: checks 
*** TURN *** [2s 4s 6c] [8d]
KeLevro0: bets $0.43
Paranoix1990: folds 
Uncalled bet ($0.43) returned to KeLevro0
KeLevro0 collected $0.57 from pot
KeLevro0: doesn't show hand 
*** SUMMARY ***
Total pot $0.60 | Rake $0.03 
Board [2s 4s 6c 8d]
Seat 1: Roglus (button) folded before Flop (didn't bet)
Seat 2: chiyuki (small blind) folded before Flop
Seat 3: KeLevro0 (big blind) collected ($0.57)
Seat 4: PetitAlejo folded before Flop (didn't bet)
Seat 5: jeff0923 folded before Flop (didn't bet)
Seat 6: Paranoix1990 folded on the Turn
Seat 7: BlOnDhOlIc folded before Flop (didn't bet)
Seat 8: ShockLaMuc folded before Flop (didn't bet)
Seat 9: Landybob folded before Flop (didn't bet)



PokerStars Zoom Hand #84298962464:  Hold'em No Limit ($0.10/$0.25) - 2012/08/05 13:46:51 JST [2012/08/05 0:46:51 ET]
Table 'Whirlpool' 9-max Seat #1 is the button
Seat 1: jethaz ($60.79 in chips) 
Seat 2: BlOnDhOlIc ($33.08 in chips) 
Seat 3: Jippyflip ($10.63 in chips) 
Seat 4: Wilcox76607 ($19.50 in chips) 
Seat 5: chiyuki ($47.66 in chips) 
Seat 6: Nerkit ($11.84 in chips) 
Seat 7: wtu1986 ($25 in chips) 
Seat 8: seula i ($40.50 in chips) 
Seat 9: Rudolf ($27.73 in chips) 
BlOnDhOlIc: posts small blind $0.10
Jippyflip: posts big blind $0.25
*** HOLE CARDS ***
Dealt to chiyuki [Qd 4d]
Wilcox76607: folds 
chiyuki: folds 
Nerkit: folds 
wtu1986: folds 
seula i: folds 
Rudolf: folds 
jethaz: folds 
BlOnDhOlIc: raises $0.25 to $0.50
Jippyflip: folds 
Uncalled bet ($0.25) returned to BlOnDhOlIc
BlOnDhOlIc collected $0.50 from pot
BlOnDhOlIc: doesn't show hand 
*** SUMMARY ***
Total pot $0.50 | Rake $0 
Seat 1: jethaz (button) folded before Flop (didn't bet)
Seat 2: BlOnDhOlIc (small blind) collected ($0.50)
Seat 3: Jippyflip (big blind) folded before Flop
Seat 4: Wilcox76607 folded before Flop (didn't bet)
Seat 5: chiyuki folded before Flop (didn't bet)
Seat 6: Nerkit folded before Flop (didn't bet)
Seat 7: wtu1986 folded before Flop (didn't bet)
Seat 8: seula i folded before Flop (didn't bet)
Seat 9: Rudolf folded before Flop (didn't bet)



PokerStars Zoom Hand #84298948361:  Hold'em No Limit ($0.10/$0.25) - 2012/08/05 13:45:56 JST [2012/08/05 0:45:56 ET]
Table 'Whirlpool' 9-max Seat #1 is the button
Seat 1: agurio ($31.36 in chips) 
Seat 2: flyinprits ($24.10 in chips) 
Seat 3: deadmoneykid ($29.36 in chips) 
Seat 4: Th3Fog ($55.29 in chips) 
Seat 5: hirozo ($25.35 in chips) 
Seat 6: PetitAlejo ($25.67 in chips) 
Seat 7: chiyuki ($47.76 in chips) 
Seat 8: Anafim ($15.18 in chips) 
Seat 9: KeLevro0 ($10.53 in chips) 
flyinprits: posts small blind $0.10
deadmoneykid: posts big blind $0.25
*** HOLE CARDS ***
Dealt to chiyuki [8h 7s]
Th3Fog: folds 
hirozo: raises $0.50 to $0.75
PetitAlejo: folds 
chiyuki: folds 
Anafim: folds 
KeLevro0: folds 
agurio: folds 
flyinprits: calls $0.65
deadmoneykid: folds 
*** FLOP *** [9d 4s 5c]
flyinprits: bets $1.25
hirozo: raises $2.09 to $3.34
flyinprits: calls $2.09
*** TURN *** [9d 4s 5c] [4c]
flyinprits: checks 
hirozo: bets $5.37
flyinprits: calls $5.37
*** RIVER *** [9d 4s 5c 4c] [Th]
flyinprits: checks 
hirozo: bets $15.89 and is all-in
flyinprits: calls $14.64 and is all-in
Uncalled bet ($1.25) returned to hirozo
*** SHOW DOWN ***
hirozo: shows [Jd Jh] (two pair, Jacks and Fours)
flyinprits: shows [Qs Qd] (two pair, Queens and Fours)
flyinprits collected $46.45 from pot
*** SUMMARY ***
Total pot $48.45 | Rake $2 
Board [9d 4s 5c 4c Th]
Seat 1: agurio (button) folded before Flop (didn't bet)
Seat 2: flyinprits (small blind) showed [Qs Qd] and won ($46.45) with two pair, Queens and Fours
Seat 3: deadmoneykid (big blind) folded before Flop
Seat 4: Th3Fog folded before Flop (didn't bet)
Seat 5: hirozo showed [Jd Jh] and lost with two pair, Jacks and Fours
Seat 6: PetitAlejo folded before Flop (didn't bet)
Seat 7: chiyuki folded before Flop (didn't bet)
Seat 8: Anafim folded before Flop (didn't bet)
Seat 9: KeLevro0 folded before Flop (didn't bet)



PokerStars Zoom Hand #84298954791:  Hold'em No Limit ($0.10/$0.25) - 2012/08/05 13:46:21 JST [2012/08/05 0:46:21 ET]
Table 'Whirlpool' 9-max Seat #1 is the button
Seat 1: PetitAlejo ($26.10 in chips) 
Seat 2: puffy5533 ($23.40 in chips) 
Seat 3: peng2astic ($22.61 in chips) 
Seat 4: ygoegoe ($30.47 in chips) 
Seat 5: DjJooni ($11.75 in chips) 
Seat 6: chiyuki ($47.76 in chips) 
Seat 7: BlackZafiro ($25.35 in chips) 
Seat 8: goldstone ($40.56 in chips) 
Seat 9: Jippyflip ($10.63 in chips) 
puffy5533: posts small blind $0.10
peng2astic: posts big blind $0.25
*** HOLE CARDS ***
Dealt to chiyuki [8h 7d]
ygoegoe: folds 
DjJooni: calls $0.25
chiyuki: folds 
BlackZafiro: raises $0.75 to $1
goldstone: folds 
Jippyflip: folds 
PetitAlejo: folds 
puffy5533: folds 
peng2astic: calls $0.75
DjJooni: raises $1 to $2
BlackZafiro: calls $1
peng2astic: calls $1
*** FLOP *** [Ac Qs 5c]
peng2astic: bets $1.25
DjJooni: calls $1.25
BlackZafiro: folds 
*** TURN *** [Ac Qs 5c] [2s]
peng2astic: bets $1.75
DjJooni: calls $1.75
*** RIVER *** [Ac Qs 5c 2s] [Kc]
peng2astic: bets $8
DjJooni: calls $6.75 and is all-in
Uncalled bet ($1.25) returned to peng2astic
*** SHOW DOWN ***
peng2astic: shows [8s Ad] (a pair of Aces)
DjJooni: shows [Qd Ah] (two pair, Aces and Queens)
DjJooni collected $24.45 from pot
*** SUMMARY ***
Total pot $25.60 | Rake $1.15 
Board [Ac Qs 5c 2s Kc]
Seat 1: PetitAlejo (button) folded before Flop (didn't bet)
Seat 2: puffy5533 (small blind) folded before Flop
Seat 3: peng2astic (big blind) showed [8s Ad] and lost with a pair of Aces
Seat 4: ygoegoe folded before Flop (didn't bet)
Seat 5: DjJooni showed [Qd Ah] and won ($24.45) with two pair, Aces and Queens
Seat 6: chiyuki folded before Flop (didn't bet)
Seat 7: BlackZafiro folded on the Flop
Seat 8: goldstone folded before Flop (didn't bet)
Seat 9: Jippyflip folded before Flop (didn't bet)



PokerStars Zoom Hand #84298970980:  Hold'em No Limit ($0.10/$0.25) - 2012/08/05 13:47:25 JST [2012/08/05 0:47:25 ET]
Table 'Whirlpool' 9-max Seat #1 is the button
Seat 1: 123progress ($24.90 in chips) 
Seat 2: NastyMcNast ($26.21 in chips) 
Seat 3: Loholov ($20.05 in chips) 
Seat 4: chiyuki ($47.41 in chips) 
Seat 5: ygoegoe ($29.87 in chips) 
Seat 6: deadmoneykid ($29.01 in chips) 
Seat 7: Rudolf ($27.48 in chips) 
Seat 8: jethaz ($51.20 in chips) 
Seat 9: seula i ($40.50 in chips) 
NastyMcNast: posts small blind $0.10
Loholov: posts big blind $0.25
*** HOLE CARDS ***
Dealt to chiyuki [8s 3h]
chiyuki: folds 
ygoegoe: raises $0.50 to $0.75
deadmoneykid: folds 
Rudolf: folds 
jethaz: folds 
seula i: folds 
123progress: folds 
NastyMcNast: folds 
Loholov: folds 
Uncalled bet ($0.50) returned to ygoegoe
ygoegoe collected $0.60 from pot
ygoegoe: doesn't show hand 
*** SUMMARY ***
Total pot $0.60 | Rake $0 
Seat 1: 123progress (button) folded before Flop (didn't bet)
Seat 2: NastyMcNast (small blind) folded before Flop
Seat 3: Loholov (big blind) folded before Flop
Seat 4: chiyuki folded before Flop (didn't bet)
Seat 5: ygoegoe collected ($0.60)
Seat 6: deadmoneykid folded before Flop (didn't bet)
Seat 7: Rudolf folded before Flop (didn't bet)
Seat 8: jethaz folded before Flop (didn't bet)
Seat 9: seula i folded before Flop (didn't bet)



PokerStars Zoom Hand #84298963506:  Hold'em No Limit ($0.10/$0.25) - 2012/08/05 13:46:55 JST [2012/08/05 0:46:55 ET]
Table 'Whirlpool' 9-max Seat #1 is the button
Seat 1: jeff0923 ($27.08 in chips) 
Seat 2: BlOnDhOlIc ($63.27 in chips) 
Seat 3: chiyuki ($47.66 in chips) 
Seat 4: BlackZafiro ($41.60 in chips) 
Seat 5: Suhoff76 ($27.80 in chips) 
Seat 6: Tom1999 ($26.27 in chips) 
Seat 7: goldstone ($40.56 in chips) 
Seat 8: ChrisCDee ($25.84 in chips) 
Seat 9: Wilcox76607 ($19.50 in chips) 
BlOnDhOlIc: posts small blind $0.10
chiyuki: posts big blind $0.25
*** HOLE CARDS ***
Dealt to chiyuki [Ah 4s]
BlackZafiro: raises $0.50 to $0.75
Suhoff76: folds 
Tom1999: folds 
goldstone: folds 
ChrisCDee: calls $0.75
Wilcox76607: folds 
jeff0923: folds 
BlOnDhOlIc: folds 
chiyuki: folds 
*** FLOP *** [3s 9c Td]
BlackZafiro: bets $1.25
ChrisCDee: calls $1.25
*** TURN *** [3s 9c Td] [Qh]
BlackZafiro: bets $2.49
ChrisCDee: folds 
Uncalled bet ($2.49) returned to BlackZafiro
BlackZafiro collected $4.15 from pot
BlackZafiro: doesn't show hand 
*** SUMMARY ***
Total pot $4.35 | Rake $0.20 
Board [3s 9c Td Qh]
Seat 1: jeff0923 (button) folded before Flop (didn't bet)
Seat 2: BlOnDhOlIc (small blind) folded before Flop
Seat 3: chiyuki (big blind) folded before Flop
Seat 4: BlackZafiro collected ($4.15)
Seat 5: Suhoff76 folded before Flop (didn't bet)
Seat 6: Tom1999 folded before Flop (didn't bet)
Seat 7: goldstone folded before Flop (didn't bet)
Seat 8: ChrisCDee folded on the Turn
Seat 9: Wilcox76607 folded before Flop (didn't bet)



PokerStars Zoom Hand #84298970214:  Hold'em No Limit ($0.10/$0.25) - 2012/08/05 13:47:22 JST [2012/08/05 0:47:22 ET]
Table 'Whirlpool' 9-max Seat #1 is the button
Seat 1: TraderYao ($26.73 in chips) 
Seat 2: taksist889 ($28.60 in chips) 
Seat 3: BlOnDhOlIc ($33.33 in chips) 
Seat 4: chiyuki ($47.41 in chips) 
Seat 5: PetitAlejo ($25 in chips) 
Seat 6: jethaz ($65.27 in chips) 
Seat 7: Dejacob ($38.45 in chips) 
Seat 8: KeLevro0 ($10.18 in chips) 
Seat 9: Nerkit ($11.59 in chips) 
taksist889: posts small blind $0.10
BlOnDhOlIc: posts big blind $0.25
*** HOLE CARDS ***
Dealt to chiyuki [4h Js]
chiyuki: folds 
PetitAlejo: folds 
jethaz: raises $0.50 to $0.75
Dejacob: folds 
KeLevro0: raises $2 to $2.75
Nerkit: folds 
TraderYao: folds 
taksist889: calls $2.65
BlOnDhOlIc: folds 
jethaz: folds 
*** FLOP *** [5s 3s Jd]
taksist889: checks 
KeLevro0: bets $3.47
taksist889: raises $3.47 to $6.94
KeLevro0: raises $0.49 to $7.43 and is all-in
taksist889: calls $0.49
*** TURN *** [5s 3s Jd] [Qc]
*** RIVER *** [5s 3s Jd Qc] [5c]
*** SHOW DOWN ***
taksist889: shows [As Ah] (two pair, Aces and Fives)
KeLevro0: shows [Qs Qh] (a full house, Queens full of Fives)
KeLevro0 collected $20.40 from pot
*** SUMMARY ***
Total pot $21.36 | Rake $0.96 
Board [5s 3s Jd Qc 5c]
Seat 1: TraderYao (button) folded before Flop (didn't bet)
Seat 2: taksist889 (small blind) showed [As Ah] and lost with two pair, Aces and Fives
Seat 3: BlOnDhOlIc (big blind) folded before Flop
Seat 4: chiyuki folded before Flop (didn't bet)
Seat 5: PetitAlejo folded before Flop (didn't bet)
Seat 6: jethaz folded before Flop
Seat 7: Dejacob folded before Flop (didn't bet)
Seat 8: KeLevro0 showed [Qs Qh] and won ($20.40) with a full house, Queens full of Fives
Seat 9: Nerkit folded before Flop (didn't bet)



PokerStars Zoom Hand #84298973197:  Hold'em No Limit ($0.10/$0.25) - 2012/08/05 13:47:34 JST [2012/08/05 0:47:34 ET]
Table 'Whirlpool' 9-max Seat #1 is the button
Seat 1: chiyuki ($47.41 in chips) 
Seat 2: PetitAlejo ($25 in chips) 
Seat 3: BlOnDhOlIc ($47.20 in chips) 
Seat 4: Roglus ($16.04 in chips) 
Seat 5: kamikkaze ($13.69 in chips) 
Seat 6: TamiKarpen13 ($6.66 in chips) 
Seat 7: hirozo ($25 in chips) 
Seat 8: Alvinpe85 ($44.51 in chips) 
Seat 9: cR!Ma*aRm ($38.51 in chips) 
PetitAlejo: posts small blind $0.10
BlOnDhOlIc: posts big blind $0.25
*** HOLE CARDS ***
Dealt to chiyuki [Kh Ac]
Roglus: folds 
kamikkaze: folds 
TamiKarpen13: raises $0.50 to $0.75
hirozo: folds 
Alvinpe85: folds 
cR!Ma*aRm: folds 
chiyuki: raises $1.50 to $2.25
PetitAlejo: folds 
BlOnDhOlIc: folds 
TamiKarpen13: raises $4.41 to $6.66 and is all-in
chiyuki: calls $4.41
*** FLOP *** [6d 4h Ks]
*** TURN *** [6d 4h Ks] [2d]
*** RIVER *** [6d 4h Ks 2d] [8h]
*** SHOW DOWN ***
TamiKarpen13: shows [Jh Jc] (a pair of Jacks)
chiyuki: shows [Kh Ac] (a pair of Kings)
chiyuki collected $13.05 from pot
*** SUMMARY ***
Total pot $13.67 | Rake $0.62 
Board [6d 4h Ks 2d 8h]
Seat 1: chiyuki (button) showed [Kh Ac] and won ($13.05) with a pair of Kings
Seat 2: PetitAlejo (small blind) folded before Flop
Seat 3: BlOnDhOlIc (big blind) folded before Flop
Seat 4: Roglus folded before Flop (didn't bet)
Seat 5: kamikkaze folded before Flop (didn't bet)
Seat 6: TamiKarpen13 showed [Jh Jc] and lost with a pair of Jacks
Seat 7: hirozo folded before Flop (didn't bet)
Seat 8: Alvinpe85 folded before Flop (didn't bet)
Seat 9: cR!Ma*aRm folded before Flop (didn't bet)



PokerStars Zoom Hand #84298980417:  Hold'em No Limit ($0.10/$0.25) - 2012/08/05 13:48:02 JST [2012/08/05 0:48:02 ET]
Table 'Whirlpool' 9-max Seat #1 is the button
Seat 1: taksist889 ($18.42 in chips) 
Seat 2: petersmiths ($45 in chips) 
Seat 3: agurio ($32.28 in chips) 
Seat 4: roksmokndonk ($37.12 in chips) 
Seat 5: Suhoff76 ($29.53 in chips) 
Seat 6: chiyuki ($53.80 in chips) 
Seat 7: jethaz ($60.44 in chips) 
Seat 8: TraderYao ($46.48 in chips) 
Seat 9: Anafim ($14.58 in chips) 
petersmiths: posts small blind $0.10
agurio: posts big blind $0.25
*** HOLE CARDS ***
Dealt to chiyuki [9h 8h]
roksmokndonk: folds 
Suhoff76: folds 
chiyuki: folds 
jethaz: folds 
TraderYao: folds 
Anafim: folds 
taksist889: folds 
petersmiths: raises $0.25 to $0.50
agurio: folds 
Uncalled bet ($0.25) returned to petersmiths
petersmiths collected $0.50 from pot
petersmiths: doesn't show hand 
*** SUMMARY ***
Total pot $0.50 | Rake $0 
Seat 1: taksist889 (button) folded before Flop (didn't bet)
Seat 2: petersmiths (small blind) collected ($0.50)
Seat 3: agurio (big blind) folded before Flop
Seat 4: roksmokndonk folded before Flop (didn't bet)
Seat 5: Suhoff76 folded before Flop (didn't bet)
Seat 6: chiyuki folded before Flop (didn't bet)
Seat 7: jethaz folded before Flop (didn't bet)
Seat 8: TraderYao folded before Flop (didn't bet)
Seat 9: Anafim folded before Flop (didn't bet)



PokerStars Zoom Hand #84298981392:  Hold'em No Limit ($0.10/$0.25) - 2012/08/05 13:48:06 JST [2012/08/05 0:48:06 ET]
Table 'Whirlpool' 9-max Seat #1 is the button
Seat 1: fwani ($40.03 in chips) 
Seat 2: munky3 ($37.57 in chips) 
Seat 3: PetitAlejo ($26.10 in chips) 
Seat 4: jethaz ($60.44 in chips) 
Seat 5: BlOnDhOlIc ($46.95 in chips) 
Seat 6: wtu1986 ($24.90 in chips) 
Seat 7: Suhoff76 ($29.53 in chips) 
Seat 8: timburonps ($25 in chips) 
Seat 9: chiyuki ($53.80 in chips) 
munky3: posts small blind $0.10
PetitAlejo: posts big blind $0.25
*** HOLE CARDS ***
Dealt to chiyuki [Qd 4d]
jethaz: folds 
BlOnDhOlIc: folds 
wtu1986: folds 
Suhoff76: folds 
timburonps: folds 
chiyuki: folds 
fwani: raises $0.35 to $0.60
munky3: folds 
PetitAlejo: calls $0.35
*** FLOP *** [9c 9s 3s]
PetitAlejo: checks 
fwani: bets $0.90
PetitAlejo: folds 
Uncalled bet ($0.90) returned to fwani
fwani collected $1.24 from pot
fwani: doesn't show hand 
*** SUMMARY ***
Total pot $1.30 | Rake $0.06 
Board [9c 9s 3s]
Seat 1: fwani (button) collected ($1.24)
Seat 2: munky3 (small blind) folded before Flop
Seat 3: PetitAlejo (big blind) folded on the Flop
Seat 4: jethaz folded before Flop (didn't bet)
Seat 5: BlOnDhOlIc folded before Flop (didn't bet)
Seat 6: wtu1986 folded before Flop (didn't bet)
Seat 7: Suhoff76 folded before Flop (didn't bet)
Seat 8: timburonps folded before Flop (didn't bet)
Seat 9: chiyuki folded before Flop (didn't bet)



PokerStars Zoom Hand #84298983988:  Hold'em No Limit ($0.10/$0.25) - 2012/08/05 13:48:17 JST [2012/08/05 0:48:17 ET]
Table 'Whirlpool' 9-max Seat #1 is the button
Seat 1: agurio ($30.30 in chips) 
Seat 2: chiyuki ($53.80 in chips) 
Seat 3: jethaz ($64.77 in chips) 
Seat 4: KeLevro0 ($20.40 in chips) 
Seat 5: Th3Fog ($22.46 in chips) 
Seat 6: Loholov ($15.10 in chips) 
Seat 7: ChrisCDee ($25 in chips) 
Seat 8: NastyMcNast ($26.11 in chips) 
Seat 9: TraderYao ($27.31 in chips) 
chiyuki: posts small blind $0.10
jethaz: posts big blind $0.25
*** HOLE CARDS ***
Dealt to chiyuki [Jc Ts]
KeLevro0: folds 
Th3Fog: folds 
Loholov: folds 
ChrisCDee: folds 
NastyMcNast: folds 
TraderYao: raises $0.50 to $0.75
agurio: folds 
chiyuki: folds 
jethaz: folds 
Uncalled bet ($0.50) returned to TraderYao
TraderYao collected $0.60 from pot
TraderYao: doesn't show hand 
*** SUMMARY ***
Total pot $0.60 | Rake $0 
Seat 1: agurio (button) folded before Flop (didn't bet)
Seat 2: chiyuki (small blind) folded before Flop
Seat 3: jethaz (big blind) folded before Flop
Seat 4: KeLevro0 folded before Flop (didn't bet)
Seat 5: Th3Fog folded before Flop (didn't bet)
Seat 6: Loholov folded before Flop (didn't bet)
Seat 7: ChrisCDee folded before Flop (didn't bet)
Seat 8: NastyMcNast folded before Flop (didn't bet)
Seat 9: TraderYao collected ($0.60)



PokerStars Zoom Hand #84298972217:  Hold'em No Limit ($0.10/$0.25) - 2012/08/05 13:47:30 JST [2012/08/05 0:47:30 ET]
Table 'Whirlpool' 9-max Seat #1 is the button
Seat 1: timburonps ($28.75 in chips) 
Seat 2: agurio ($32.38 in chips) 
Seat 3: Rudolf ($27.48 in chips) 
Seat 4: TamiKarpen13 ($6.66 in chips) 
Seat 5: goldstone ($40.56 in chips) 
Seat 6: Roglus ($16.04 in chips) 
Seat 7: chiyuki ($47.41 in chips) 
Seat 8: Nerkit ($11.59 in chips) 
Seat 9: 123progress ($24.90 in chips) 
agurio: posts small blind $0.10
Rudolf: posts big blind $0.25
*** HOLE CARDS ***
Dealt to chiyuki [6d Jd]
TamiKarpen13: folds 
goldstone: raises $0.57 to $0.82
Roglus: folds 
chiyuki: folds 
Nerkit: folds 
123progress: folds 
timburonps: folds 
agurio: folds 
Rudolf: calls $0.57
*** FLOP *** [8h As Tc]
Rudolf: checks 
goldstone: bets $1.14
Rudolf: raises $1.86 to $3
goldstone: calls $1.86
*** TURN *** [8h As Tc] [Ah]
Rudolf: bets $6.25
goldstone: calls $6.25
*** RIVER *** [8h As Tc Ah] [4h]
Rudolf: bets $17.41 and is all-in
goldstone: calls $17.41
*** SHOW DOWN ***
Rudolf: shows [Ac Th] (a full house, Aces full of Tens)
goldstone: shows [Kc Kh] (two pair, Aces and Kings)
Rudolf collected $53.06 from pot
*** SUMMARY ***
Total pot $55.06 | Rake $2 
Board [8h As Tc Ah 4h]
Seat 1: timburonps (button) folded before Flop (didn't bet)
Seat 2: agurio (small blind) folded before Flop
Seat 3: Rudolf (big blind) showed [Ac Th] and won ($53.06) with a full house, Aces full of Tens
Seat 4: TamiKarpen13 folded before Flop (didn't bet)
Seat 5: goldstone showed [Kc Kh] and lost with two pair, Aces and Kings
Seat 6: Roglus folded before Flop (didn't bet)
Seat 7: chiyuki folded before Flop (didn't bet)
Seat 8: Nerkit folded before Flop (didn't bet)
Seat 9: 123progress folded before Flop (didn't bet)



PokerStars Zoom Hand #84298989904:  Hold'em No Limit ($0.10/$0.25) - 2012/08/05 13:48:40 JST [2012/08/05 0:48:40 ET]
Table 'Whirlpool' 9-max Seat #1 is the button
Seat 1: Ellen1947 ($33.80 in chips) 
Seat 2: deadmoneykid ($28.76 in chips) 
Seat 3: chiyuki ($53.70 in chips) 
Seat 4: Suhoff76 ($34.88 in chips) 
Seat 5: PetitAlejo ($25 in chips) 
Seat 6: Tuan0109 ($9.36 in chips) 
Seat 7: timburonps ($25 in chips) 
Seat 8: vit 111 ($9.31 in chips) 
Seat 9: Th3Fog ($55.07 in chips) 
deadmoneykid: posts small blind $0.10
chiyuki: posts big blind $0.25
*** HOLE CARDS ***
Dealt to chiyuki [2h 4s]
Suhoff76: folds 
PetitAlejo: folds 
Tuan0109: raises $0.50 to $0.75
timburonps: raises $1 to $1.75
vit 111: raises $7.56 to $9.31 and is all-in
Th3Fog: folds 
Ellen1947: folds 
deadmoneykid: folds 
chiyuki: folds 
Tuan0109: raises $0.05 to $9.36 and is all-in
timburonps: calls $7.61
*** FLOP *** [Td 4d 3d]
*** TURN *** [Td 4d 3d] [5s]
*** RIVER *** [Td 4d 3d 5s] [9s]
*** SHOW DOWN ***
Tuan0109: shows [Qh As] (high card Ace)
timburonps: shows [Qs Qc] (a pair of Queens)
timburonps collected $0.09 from side pot
vit 111: shows [Kc 5c] (a pair of Fives)
timburonps collected $27.01 from main pot
*** SUMMARY ***
Total pot $28.38 Main pot $27.01. Side pot $0.09. | Rake $1.28 
Board [Td 4d 3d 5s 9s]
Seat 1: Ellen1947 (button) folded before Flop (didn't bet)
Seat 2: deadmoneykid (small blind) folded before Flop
Seat 3: chiyuki (big blind) folded before Flop
Seat 4: Suhoff76 folded before Flop (didn't bet)
Seat 5: PetitAlejo folded before Flop (didn't bet)
Seat 6: Tuan0109 showed [Qh As] and lost with high card Ace
Seat 7: timburonps showed [Qs Qc] and won ($27.10) with a pair of Queens
Seat 8: vit 111 showed [Kc 5c] and lost with a pair of Fives
Seat 9: Th3Fog folded before Flop (didn't bet)



PokerStars Zoom Hand #84298997669:  Hold'em No Limit ($0.10/$0.25) - 2012/08/05 13:49:10 JST [2012/08/05 0:49:10 ET]
Table 'Whirlpool' 9-max Seat #1 is the button
Seat 1: ShockLaMuc ($27.36 in chips) 
Seat 2: agurio ($30.65 in chips) 
Seat 3: petersmiths ($44.25 in chips) 
Seat 4: PetitAlejo ($25.50 in chips) 
Seat 5: chiyuki ($53.45 in chips) 
Seat 6: BlackZafiro ($25.70 in chips) 
Seat 7: jethaz ($45.39 in chips) 
Seat 8: NastyMcNast ($25 in chips) 
Seat 9: deadmoneykid ($40.22 in chips) 
agurio: posts small blind $0.10
petersmiths: posts big blind $0.25
*** HOLE CARDS ***
Dealt to chiyuki [2h Qh]
PetitAlejo: folds 
chiyuki: folds 
BlackZafiro: folds 
jethaz: folds 
NastyMcNast: folds 
deadmoneykid: folds 
ShockLaMuc: folds 
agurio: folds 
Uncalled bet ($0.15) returned to petersmiths
petersmiths collected $0.20 from pot
petersmiths: doesn't show hand 
*** SUMMARY ***
Total pot $0.20 | Rake $0 
Seat 1: ShockLaMuc (button) folded before Flop (didn't bet)
Seat 2: agurio (small blind) folded before Flop
Seat 3: petersmiths (big blind) collected ($0.20)
Seat 4: PetitAlejo folded before Flop (didn't bet)
Seat 5: chiyuki folded before Flop (didn't bet)
Seat 6: BlackZafiro folded before Flop (didn't bet)
Seat 7: jethaz folded before Flop (didn't bet)
Seat 8: NastyMcNast folded before Flop (didn't bet)
Seat 9: deadmoneykid folded before Flop (didn't bet)



PokerStars Zoom Hand #84298999405:  Hold'em No Limit ($0.10/$0.25) - 2012/08/05 13:49:17 JST [2012/08/05 0:49:17 ET]
Table 'Whirlpool' 9-max Seat #1 is the button
Seat 1: Th3Fog ($55.42 in chips) 
Seat 2: ShockLaMuc ($27.36 in chips) 
Seat 3: solawind ($15.07 in chips) 
Seat 4: Alvinpe85 ($42.91 in chips) 
Seat 5: wtu1986 ($25.25 in chips) 
Seat 6: chiyuki ($53.45 in chips) 
Seat 7: Nerkit ($12.97 in chips) 
Seat 8: ygoegoe ($29.47 in chips) 
Seat 9: Loholov ($20.13 in chips) 
ShockLaMuc: posts small blind $0.10
solawind: posts big blind $0.25
*** HOLE CARDS ***
Dealt to chiyuki [3h 9c]
Alvinpe85: folds 
wtu1986: folds 
chiyuki: folds 
Nerkit: folds 
ygoegoe: folds 
Loholov: folds 
Th3Fog: raises $0.47 to $0.72
ShockLaMuc: folds 
solawind: folds 
Uncalled bet ($0.47) returned to Th3Fog
Th3Fog collected $0.60 from pot
Th3Fog: doesn't show hand 
*** SUMMARY ***
Total pot $0.60 | Rake $0 
Seat 1: Th3Fog (button) collected ($0.60)
Seat 2: ShockLaMuc (small blind) folded before Flop
Seat 3: solawind (big blind) folded before Flop
Seat 4: Alvinpe85 folded before Flop (didn't bet)
Seat 5: wtu1986 folded before Flop (didn't bet)
Seat 6: chiyuki folded before Flop (didn't bet)
Seat 7: Nerkit folded before Flop (didn't bet)
Seat 8: ygoegoe folded before Flop (didn't bet)
Seat 9: Loholov folded before Flop (didn't bet)



PokerStars Zoom Hand #84298995588:  Hold'em No Limit ($0.10/$0.25) - 2012/08/05 13:49:02 JST [2012/08/05 0:49:02 ET]
Table 'Whirlpool' 9-max Seat #1 is the button
Seat 1: petersmiths ($44.25 in chips) 
Seat 2: KeLevro0 ($13.16 in chips) 
Seat 3: Dejacob ($32.86 in chips) 
Seat 4: goldstone ($13.08 in chips) 
Seat 5: solawind ($15.07 in chips) 
Seat 6: Roglus ($67.29 in chips) 
Seat 7: chiyuki ($53.45 in chips) 
Seat 8: RikkStroken ($15 in chips) 
Seat 9: BlackZafiro ($25 in chips) 
KeLevro0: posts small blind $0.10
Dejacob: posts big blind $0.25
*** HOLE CARDS ***
Dealt to chiyuki [Jh Qc]
goldstone: calls $0.25
solawind: folds 
Roglus: folds 
chiyuki: folds 
RikkStroken: folds 
BlackZafiro: folds 
petersmiths: folds 
KeLevro0: folds 
Dejacob: checks 
*** FLOP *** [Js Qd 8s]
Dejacob: checks 
goldstone: bets $0.39
Dejacob: folds 
Uncalled bet ($0.39) returned to goldstone
goldstone collected $0.57 from pot
goldstone: doesn't show hand 
*** SUMMARY ***
Total pot $0.60 | Rake $0.03 
Board [Js Qd 8s]
Seat 1: petersmiths (button) folded before Flop (didn't bet)
Seat 2: KeLevro0 (small blind) folded before Flop
Seat 3: Dejacob (big blind) folded on the Flop
Seat 4: goldstone collected ($0.57)
Seat 5: solawind folded before Flop (didn't bet)
Seat 6: Roglus folded before Flop (didn't bet)
Seat 7: chiyuki folded before Flop (didn't bet)
Seat 8: RikkStroken folded before Flop (didn't bet)
Seat 9: BlackZafiro folded before Flop (didn't bet)



PokerStars Zoom Hand #84298993540:  Hold'em No Limit ($0.10/$0.25) - 2012/08/05 13:48:54 JST [2012/08/05 0:48:54 ET]
Table 'Whirlpool' 9-max Seat #1 is the button
Seat 1: TErr18 ($13.39 in chips) 
Seat 2: RomarioJa ($7.09 in chips) 
Seat 3: hirozo ($25.48 in chips) 
Seat 4: PetitAlejo ($25.50 in chips) 
Seat 5: wildy29 ($15.65 in chips) 
Seat 6: ChrisCDee ($25.38 in chips) 
Seat 7: jeff0923 ($26.73 in chips) 
Seat 8: chiyuki ($53.45 in chips) 
Seat 9: Suhoff76 ($40.61 in chips) 
RomarioJa: posts small blind $0.10
hirozo: posts big blind $0.25
*** HOLE CARDS ***
Dealt to chiyuki [4s Qd]
PetitAlejo: folds 
wildy29: calls $0.25
ChrisCDee: folds 
jeff0923: folds 
chiyuki: folds 
Suhoff76: calls $0.25
TErr18: folds 
RomarioJa: folds 
hirozo: raises $1 to $1.25
wildy29: folds 
Suhoff76: calls $1
*** FLOP *** [3c Jd Qc]
hirozo: bets $1.36
Suhoff76: folds 
Uncalled bet ($1.36) returned to hirozo
hirozo collected $2.72 from pot
hirozo: doesn't show hand 
*** SUMMARY ***
Total pot $2.85 | Rake $0.13 
Board [3c Jd Qc]
Seat 1: TErr18 (button) folded before Flop (didn't bet)
Seat 2: RomarioJa (small blind) folded before Flop
Seat 3: hirozo (big blind) collected ($2.72)
Seat 4: PetitAlejo folded before Flop (didn't bet)
Seat 5: wildy29 folded before Flop
Seat 6: ChrisCDee folded before Flop (didn't bet)
Seat 7: jeff0923 folded before Flop (didn't bet)
Seat 8: chiyuki folded before Flop (didn't bet)
Seat 9: Suhoff76 folded on the Flop



PokerStars Zoom Hand #84299006189:  Hold'em No Limit ($0.10/$0.25) - 2012/08/05 13:49:45 JST [2012/08/05 0:49:45 ET]
Table 'Whirlpool' 9-max Seat #1 is the button
Seat 1: chiyuki ($53.35 in chips) 
Seat 2: hirozo ($26.95 in chips) 
Seat 3: ll_LaMeR_ll ($67.73 in chips) 
Seat 4: wildy29 ($15.40 in chips) 
Seat 5: peng2astic ($11.21 in chips) 
Seat 6: Alvinpe85 ($30.13 in chips) 
Seat 7: ShockLaMuc ($25.19 in chips) 
Seat 8: Suhoff76 ($28.23 in chips) 
Seat 9: roksmokndonk ($38.38 in chips) 
hirozo: posts small blind $0.10
ll_LaMeR_ll: posts big blind $0.25
*** HOLE CARDS ***
Dealt to chiyuki [Jd 6d]
wildy29: folds 
peng2astic: raises $1 to $1.25
Alvinpe85: folds 
ShockLaMuc: folds 
Suhoff76: folds 
roksmokndonk: folds 
chiyuki: folds 
hirozo: folds 
ll_LaMeR_ll: folds 
Uncalled bet ($1) returned to peng2astic
peng2astic collected $0.60 from pot
peng2astic: doesn't show hand 
*** SUMMARY ***
Total pot $0.60 | Rake $0 
Seat 1: chiyuki (button) folded before Flop (didn't bet)
Seat 2: hirozo (small blind) folded before Flop
Seat 3: ll_LaMeR_ll (big blind) folded before Flop
Seat 4: wildy29 folded before Flop (didn't bet)
Seat 5: peng2astic collected ($0.60)
Seat 6: Alvinpe85 folded before Flop (didn't bet)
Seat 7: ShockLaMuc folded before Flop (didn't bet)
Seat 8: Suhoff76 folded before Flop (didn't bet)
Seat 9: roksmokndonk folded before Flop (didn't bet)



PokerStars Zoom Hand #84299000388:  Hold'em No Limit ($0.10/$0.25) - 2012/08/05 13:49:22 JST [2012/08/05 0:49:22 ET]
Table 'Whirlpool' 9-max Seat #1 is the button
Seat 1: deadmoneykid ($40.22 in chips) 
Seat 2: chiyuki ($53.45 in chips) 
Seat 3: wtu1986 ($25.25 in chips) 
Seat 4: Dejacob ($32.03 in chips) 
Seat 5: timburonps ($42.74 in chips) 
Seat 6: PetitAlejo ($25.40 in chips) 
Seat 7: Wilcox76607 ($16.10 in chips) 
Seat 8: jethaz ($45.39 in chips) 
Seat 9: KeLevro0 ($13.06 in chips) 
chiyuki: posts small blind $0.10
wtu1986: posts big blind $0.25
*** HOLE CARDS ***
Dealt to chiyuki [3c 3h]
Dejacob: folds 
timburonps: raises $0.50 to $0.75
PetitAlejo: folds 
Wilcox76607: raises $1 to $1.75
jethaz: folds 
KeLevro0: folds 
deadmoneykid has timed out
deadmoneykid: folds 
chiyuki: folds 
wtu1986: folds 
timburonps: folds 
Uncalled bet ($1) returned to Wilcox76607
Wilcox76607 collected $1.85 from pot
Wilcox76607: doesn't show hand 
*** SUMMARY ***
Total pot $1.85 | Rake $0 
Seat 1: deadmoneykid (button) folded before Flop (didn't bet)
Seat 2: chiyuki (small blind) folded before Flop
Seat 3: wtu1986 (big blind) folded before Flop
Seat 4: Dejacob folded before Flop (didn't bet)
Seat 5: timburonps folded before Flop
Seat 6: PetitAlejo folded before Flop (didn't bet)
Seat 7: Wilcox76607 collected ($1.85)
Seat 8: jethaz folded before Flop (didn't bet)
Seat 9: KeLevro0 folded before Flop (didn't bet)



PokerStars Zoom Hand #84299009467:  Hold'em No Limit ($0.10/$0.25) - 2012/08/05 13:49:58 JST [2012/08/05 0:49:58 ET]
Table 'Whirlpool' 9-max Seat #1 is the button
Seat 1: Nerkit ($11.50 in chips) 
Seat 2: Suhoff76 ($34.53 in chips) 
Seat 3: RomarioJa ($6.99 in chips) 
Seat 4: wtu1986 ($25 in chips) 
Seat 5: agurio ($36.86 in chips) 
Seat 6: KeLevro0 ($13.25 in chips) 
Seat 7: flyinprits ($49.24 in chips) 
Seat 8: hirozo ($26.85 in chips) 
Seat 9: chiyuki ($53.35 in chips) 
Suhoff76: posts small blind $0.10
RomarioJa: posts big blind $0.25
*** HOLE CARDS ***
Dealt to chiyuki [7s Ks]
wtu1986: folds 
agurio: folds 
KeLevro0: folds 
flyinprits: folds 
hirozo: folds 
chiyuki: raises $0.50 to $0.75
Nerkit: raises $1.50 to $2.25
Suhoff76: folds 
RomarioJa: folds 
chiyuki: folds 
Uncalled bet ($1.50) returned to Nerkit
Nerkit collected $1.85 from pot
Nerkit: doesn't show hand 
*** SUMMARY ***
Total pot $1.85 | Rake $0 
Seat 1: Nerkit (button) collected ($1.85)
Seat 2: Suhoff76 (small blind) folded before Flop
Seat 3: RomarioJa (big blind) folded before Flop
Seat 4: wtu1986 folded before Flop (didn't bet)
Seat 5: agurio folded before Flop (didn't bet)
Seat 6: KeLevro0 folded before Flop (didn't bet)
Seat 7: flyinprits folded before Flop (didn't bet)
Seat 8: hirozo folded before Flop (didn't bet)
Seat 9: chiyuki folded before Flop



PokerStars Zoom Hand #84299021393:  Hold'em No Limit ($0.10/$0.25) - 2012/08/05 13:50:47 JST [2012/08/05 0:50:47 ET]
Table 'Whirlpool' 9-max Seat #1 is the button
Seat 1: 2997qwer ($12.15 in chips) 
Seat 2: timburonps ($42.84 in chips) 
Seat 3: flyinprits ($56.31 in chips) 
Seat 4: munky3 ($26.82 in chips) 
Seat 5: PetitAlejo ($25.25 in chips) 
Seat 6: peng2astic ($10.46 in chips) 
Seat 7: fwani ($29.49 in chips) 
Seat 8: chiyuki ($52.60 in chips) 
Seat 9: deadmoneykid ($27.74 in chips) 
timburonps: posts small blind $0.10
flyinprits: posts big blind $0.25
*** HOLE CARDS ***
Dealt to chiyuki [3c Kd]
munky3: folds 
PetitAlejo: folds 
peng2astic: folds 
fwani: raises $0.35 to $0.60
chiyuki: folds 
deadmoneykid: folds 
2997qwer: folds 
timburonps: folds 
flyinprits: folds 
Uncalled bet ($0.35) returned to fwani
fwani collected $0.60 from pot
fwani: doesn't show hand 
*** SUMMARY ***
Total pot $0.60 | Rake $0 
Seat 1: 2997qwer (button) folded before Flop (didn't bet)
Seat 2: timburonps (small blind) folded before Flop
Seat 3: flyinprits (big blind) folded before Flop
Seat 4: munky3 folded before Flop (didn't bet)
Seat 5: PetitAlejo folded before Flop (didn't bet)
Seat 6: peng2astic folded before Flop (didn't bet)
Seat 7: fwani collected ($0.60)
Seat 8: chiyuki folded before Flop (didn't bet)
Seat 9: deadmoneykid folded before Flop (didn't bet)



PokerStars Zoom Hand #84299022451:  Hold'em No Limit ($0.10/$0.25) - 2012/08/05 13:50:51 JST [2012/08/05 0:50:51 ET]
Table 'Whirlpool' 9-max Seat #1 is the button
Seat 1: 2997qwer ($12.15 in chips) 
Seat 2: petersmiths ($46.16 in chips) 
Seat 3: peng2astic ($10.46 in chips) 
Seat 4: PetitAlejo ($25.25 in chips) 
Seat 5: ChrisCDee ($27.27 in chips) 
Seat 6: chiyuki ($52.60 in chips) 
Seat 7: Vahe50 ($28.17 in chips) 
Seat 8: TErr18 ($14.52 in chips) 
Seat 9: ladymadon107 ($18.07 in chips) 
petersmiths: posts small blind $0.10
peng2astic: posts big blind $0.25
*** HOLE CARDS ***
Dealt to chiyuki [Kc 2c]
PetitAlejo: folds 
ChrisCDee: raises $0.50 to $0.75
chiyuki: folds 
Vahe50: folds 
TErr18: folds 
ladymadon107: calls $0.75
2997qwer: folds 
petersmiths: calls $0.65
peng2astic: calls $0.50
*** FLOP *** [3d 6d Js]
petersmiths: checks 
peng2astic: checks 
ChrisCDee: checks 
ladymadon107: checks 
*** TURN *** [3d 6d Js] [6h]
petersmiths: bets $1.14
peng2astic: folds 
ChrisCDee: folds 
ladymadon107: folds 
Uncalled bet ($1.14) returned to petersmiths
petersmiths collected $2.86 from pot
petersmiths: doesn't show hand 
*** SUMMARY ***
Total pot $3 | Rake $0.14 
Board [3d 6d Js 6h]
Seat 1: 2997qwer (button) folded before Flop (didn't bet)
Seat 2: petersmiths (small blind) collected ($2.86)
Seat 3: peng2astic (big blind) folded on the Turn
Seat 4: PetitAlejo folded before Flop (didn't bet)
Seat 5: ChrisCDee folded on the Turn
Seat 6: chiyuki folded before Flop (didn't bet)
Seat 7: Vahe50 folded before Flop (didn't bet)
Seat 8: TErr18 folded before Flop (didn't bet)
Seat 9: ladymadon107 folded on the Turn



PokerStars Zoom Hand #84299026988:  Hold'em No Limit ($0.10/$0.25) - 2012/08/05 13:51:09 JST [2012/08/05 0:51:09 ET]
Table 'Whirlpool' 9-max Seat #1 is the button
Seat 1: Th3Fog ($53.07 in chips) 
Seat 2: NastyMcNast ($25 in chips) 
Seat 3: chiyuki ($52.60 in chips) 
Seat 4: Nerkit ($12.60 in chips) 
Seat 5: RikkStroken ($10 in chips) 
Seat 6: Alvinpe85 ($49.21 in chips) 
Seat 7: hirozo ($25.45 in chips) 
Seat 8: puffy5533 ($21.85 in chips) 
Seat 9: PetitAlejo ($25.35 in chips) 
NastyMcNast: posts small blind $0.10
chiyuki: posts big blind $0.25
*** HOLE CARDS ***
Dealt to chiyuki [6d Ks]
Nerkit: folds 
RikkStroken: folds 
Alvinpe85: folds 
hirozo: raises $0.50 to $0.75
puffy5533: folds 
PetitAlejo: folds 
Th3Fog: folds 
NastyMcNast: calls $0.65
chiyuki: folds 
*** FLOP *** [2s 5c 9s]
NastyMcNast: checks 
hirozo: bets $1.11
NastyMcNast: calls $1.11
*** TURN *** [2s 5c 9s] [6h]
NastyMcNast: checks 
hirozo: checks 
*** RIVER *** [2s 5c 9s 6h] [3c]
NastyMcNast: checks 
hirozo: checks 
*** SHOW DOWN ***
NastyMcNast: shows [Js Jc] (a pair of Jacks)
hirozo: mucks hand 
NastyMcNast collected $3.79 from pot
*** SUMMARY ***
Total pot $3.97 | Rake $0.18 
Board [2s 5c 9s 6h 3c]
Seat 1: Th3Fog (button) folded before Flop (didn't bet)
Seat 2: NastyMcNast (small blind) showed [Js Jc] and won ($3.79) with a pair of Jacks
Seat 3: chiyuki (big blind) folded before Flop
Seat 4: Nerkit folded before Flop (didn't bet)
Seat 5: RikkStroken folded before Flop (didn't bet)
Seat 6: Alvinpe85 folded before Flop (didn't bet)
Seat 7: hirozo mucked [Qs Ac]
Seat 8: puffy5533 folded before Flop (didn't bet)
Seat 9: PetitAlejo folded before Flop (didn't bet)



PokerStars Zoom Hand #84299031290:  Hold'em No Limit ($0.10/$0.25) - 2012/08/05 13:51:26 JST [2012/08/05 0:51:26 ET]
Table 'Whirlpool' 9-max Seat #1 is the button
Seat 1: solawind ($14.32 in chips) 
Seat 2: KeLevro0 ($13.35 in chips) 
Seat 3: Vahe50 ($28.17 in chips) 
Seat 4: Roglus ($70.37 in chips) 
Seat 5: chiyuki ($52.35 in chips) 
Seat 6: BlackZafiro ($28.17 in chips) 
Seat 7: RikkStroken ($12.55 in chips) 
Seat 8: Nerkit ($12.25 in chips) 
Seat 9: 2997qwer ($12.15 in chips) 
KeLevro0: posts small blind $0.10
Vahe50: posts big blind $0.25
*** HOLE CARDS ***
Dealt to chiyuki [7c 6s]
Roglus: raises $0.37 to $0.62
chiyuki: folds 
BlackZafiro: folds 
RikkStroken: folds 
Nerkit: folds 
2997qwer: folds 
solawind: folds 
KeLevro0: folds 
Vahe50: folds 
Uncalled bet ($0.37) returned to Roglus
Roglus collected $0.60 from pot
Roglus: doesn't show hand 
*** SUMMARY ***
Total pot $0.60 | Rake $0 
Seat 1: solawind (button) folded before Flop (didn't bet)
Seat 2: KeLevro0 (small blind) folded before Flop
Seat 3: Vahe50 (big blind) folded before Flop
Seat 4: Roglus collected ($0.60)
Seat 5: chiyuki folded before Flop (didn't bet)
Seat 6: BlackZafiro folded before Flop (didn't bet)
Seat 7: RikkStroken folded before Flop (didn't bet)
Seat 8: Nerkit folded before Flop (didn't bet)
Seat 9: 2997qwer folded before Flop (didn't bet)



PokerStars Zoom Hand #84299033347:  Hold'em No Limit ($0.10/$0.25) - 2012/08/05 13:51:34 JST [2012/08/05 0:51:34 ET]
Table 'Whirlpool' 9-max Seat #1 is the button
Seat 1: flyinprits ($55.96 in chips) 
Seat 2: Ellen1947 ($34.79 in chips) 
Seat 3: stankfist420 ($29.58 in chips) 
Seat 4: D@vidMed ($25.25 in chips) 
Seat 5: chiyuki ($52.35 in chips) 
Seat 6: KeLevro0 ($13.06 in chips) 
Seat 7: taksist889 ($15.47 in chips) 
Seat 8: peng2astic ($9.71 in chips) 
Seat 9: solawind ($14.32 in chips) 
Ellen1947: posts small blind $0.10
stankfist420: posts big blind $0.25
*** HOLE CARDS ***
Dealt to chiyuki [7d As]
D@vidMed: folds 
chiyuki: folds 
KeLevro0: folds 
taksist889: folds 
peng2astic: folds 
solawind: folds 
flyinprits: folds 
Ellen1947: raises $0.50 to $0.75
stankfist420: folds 
Uncalled bet ($0.50) returned to Ellen1947
Ellen1947 collected $0.50 from pot
Ellen1947: doesn't show hand 
*** SUMMARY ***
Total pot $0.50 | Rake $0 
Seat 1: flyinprits (button) folded before Flop (didn't bet)
Seat 2: Ellen1947 (small blind) collected ($0.50)
Seat 3: stankfist420 (big blind) folded before Flop
Seat 4: D@vidMed folded before Flop (didn't bet)
Seat 5: chiyuki folded before Flop (didn't bet)
Seat 6: KeLevro0 folded before Flop (didn't bet)
Seat 7: taksist889 folded before Flop (didn't bet)
Seat 8: peng2astic folded before Flop (didn't bet)
Seat 9: solawind folded before Flop (didn't bet)



PokerStars Zoom Hand #84299023750:  Hold'em No Limit ($0.10/$0.25) - 2012/08/05 13:50:56 JST [2012/08/05 0:50:56 ET]
Table 'Whirlpool' 9-max Seat #1 is the button
Seat 1: ygoegoe ($29.12 in chips) 
Seat 2: RikkStroken ($12.65 in chips) 
Seat 3: RomarioJa ($8.72 in chips) 
Seat 4: PetitAlejo ($25.25 in chips) 
Seat 5: timburonps ($28.65 in chips) 
Seat 6: NastyMcNast ($25.39 in chips) 
Seat 7: chiyuki ($52.60 in chips) 
Seat 8: Nerkit ($12.16 in chips) 
Seat 9: hirozo ($25.75 in chips) 
RikkStroken: posts small blind $0.10
RomarioJa: posts big blind $0.25
*** HOLE CARDS ***
Dealt to chiyuki [Kh Js]
PetitAlejo: folds 
timburonps: folds 
NastyMcNast: folds 
chiyuki: folds 
Nerkit: folds 
hirozo: folds 
ygoegoe: raises $0.37 to $0.62
RikkStroken: folds 
RomarioJa: calls $0.37
*** FLOP *** [Qd Ah 4d]
RomarioJa: checks 
ygoegoe: bets $0.70
RomarioJa: calls $0.70
*** TURN *** [Qd Ah 4d] [3s]
RomarioJa: checks 
ygoegoe: checks 
*** RIVER *** [Qd Ah 4d 3s] [9h]
RomarioJa: bets $0.60
ygoegoe: folds 
Uncalled bet ($0.60) returned to RomarioJa
RomarioJa collected $2.62 from pot
RomarioJa: doesn't show hand 
*** SUMMARY ***
Total pot $2.74 | Rake $0.12 
Board [Qd Ah 4d 3s 9h]
Seat 1: ygoegoe (button) folded on the River
Seat 2: RikkStroken (small blind) folded before Flop
Seat 3: RomarioJa (big blind) collected ($2.62)
Seat 4: PetitAlejo folded before Flop (didn't bet)
Seat 5: timburonps folded before Flop (didn't bet)
Seat 6: NastyMcNast folded before Flop (didn't bet)
Seat 7: chiyuki folded before Flop (didn't bet)
Seat 8: Nerkit folded before Flop (didn't bet)
Seat 9: hirozo folded before Flop (didn't bet)



PokerStars Zoom Hand #84299039201:  Hold'em No Limit ($0.10/$0.25) - 2012/08/05 13:51:58 JST [2012/08/05 0:51:58 ET]
Table 'Whirlpool' 9-max Seat #1 is the button
Seat 1: RomarioJa ($4.98 in chips) 
Seat 2: chiyuki ($52.35 in chips) 
Seat 3: taksist889 ($15.47 in chips) 
Seat 4: Lasutchik ($32.53 in chips) 
Seat 5: Wilcox76607 ($18.85 in chips) 
Seat 6: peng2astic ($9.61 in chips) 
Seat 7: slapshot2011 ($26.39 in chips) 
Seat 8: Suhoff76 ($40.88 in chips) 
Seat 9: RikkStroken ($13.50 in chips) 
chiyuki: posts small blind $0.10
taksist889: posts big blind $0.25
*** HOLE CARDS ***
Dealt to chiyuki [6c 2s]
Lasutchik: folds 
Wilcox76607: folds 
peng2astic: raises $9.36 to $9.61 and is all-in
slapshot2011: folds 
Suhoff76: folds 
RikkStroken: folds 
RomarioJa: folds 
chiyuki: folds 
taksist889: folds 
Uncalled bet ($9.36) returned to peng2astic
peng2astic collected $0.60 from pot
peng2astic: doesn't show hand 
*** SUMMARY ***
Total pot $0.60 | Rake $0 
Seat 1: RomarioJa (button) folded before Flop (didn't bet)
Seat 2: chiyuki (small blind) folded before Flop
Seat 3: taksist889 (big blind) folded before Flop
Seat 4: Lasutchik folded before Flop (didn't bet)
Seat 5: Wilcox76607 folded before Flop (didn't bet)
Seat 6: peng2astic collected ($0.60)
Seat 7: slapshot2011 folded before Flop (didn't bet)
Seat 8: Suhoff76 folded before Flop (didn't bet)
Seat 9: RikkStroken folded before Flop (didn't bet)



PokerStars Zoom Hand #84299040723:  Hold'em No Limit ($0.10/$0.25) - 2012/08/05 13:52:04 JST [2012/08/05 0:52:04 ET]
Table 'Whirlpool' 9-max Seat #1 is the button
Seat 1: chiyuki ($52.25 in chips) 
Seat 2: PetitAlejo ($25 in chips) 
Seat 3: Ellen1947 ($35.04 in chips) 
Seat 4: Wilcox76607 ($18.85 in chips) 
Seat 5: RikkStroken ($13.50 in chips) 
Seat 6: solawind ($14.32 in chips) 
Seat 7: Rudolf ($48.44 in chips) 
Seat 8: KeLevro0 ($13.25 in chips) 
Seat 9: Suhoff76 ($27.53 in chips) 
PetitAlejo: posts small blind $0.10
Ellen1947: posts big blind $0.25
*** HOLE CARDS ***
Dealt to chiyuki [Kh 2s]
Wilcox76607: folds 
RikkStroken: folds 
solawind: folds 
Rudolf: folds 
KeLevro0: folds 
Suhoff76: folds 
chiyuki: folds 
PetitAlejo: raises $0.50 to $0.75
Ellen1947: folds 
Uncalled bet ($0.50) returned to PetitAlejo
PetitAlejo collected $0.50 from pot
PetitAlejo: doesn't show hand 
*** SUMMARY ***
Total pot $0.50 | Rake $0 
Seat 1: chiyuki (button) folded before Flop (didn't bet)
Seat 2: PetitAlejo (small blind) collected ($0.50)
Seat 3: Ellen1947 (big blind) folded before Flop
Seat 4: Wilcox76607 folded before Flop (didn't bet)
Seat 5: RikkStroken folded before Flop (didn't bet)
Seat 6: solawind folded before Flop (didn't bet)
Seat 7: Rudolf folded before Flop (didn't bet)
Seat 8: KeLevro0 folded before Flop (didn't bet)
Seat 9: Suhoff76 folded before Flop (didn't bet)



PokerStars Zoom Hand #84299036921:  Hold'em No Limit ($0.10/$0.25) - 2012/08/05 13:51:49 JST [2012/08/05 0:51:49 ET]
Table 'Whirlpool' 9-max Seat #1 is the button
Seat 1: PetitAlejo ($25 in chips) 
Seat 2: RikkStroken ($13.60 in chips) 
Seat 3: D@vidMed ($25.25 in chips) 
Seat 4: Nerkit ($13.57 in chips) 
Seat 5: peng2astic ($9.61 in chips) 
Seat 6: timburonps ($42.74 in chips) 
Seat 7: Loholov ($15 in chips) 
Seat 8: silvno31 ($46.35 in chips) 
Seat 9: chiyuki ($52.35 in chips) 
RikkStroken: posts small blind $0.10
D@vidMed: posts big blind $0.25
*** HOLE CARDS ***
Dealt to chiyuki [2h Ac]
Nerkit: raises $0.50 to $0.75
peng2astic: folds 
timburonps: folds 
Loholov: folds 
silvno31: folds 
chiyuki: folds 
PetitAlejo: folds 
RikkStroken: folds 
D@vidMed: calls $0.50
*** FLOP *** [Qs 7c 3d]
D@vidMed: checks 
Nerkit: bets $1
D@vidMed: folds 
Uncalled bet ($1) returned to Nerkit
Nerkit collected $1.53 from pot
Nerkit: doesn't show hand 
*** SUMMARY ***
Total pot $1.60 | Rake $0.07 
Board [Qs 7c 3d]
Seat 1: PetitAlejo (button) folded before Flop (didn't bet)
Seat 2: RikkStroken (small blind) folded before Flop
Seat 3: D@vidMed (big blind) folded on the Flop
Seat 4: Nerkit collected ($1.53)
Seat 5: peng2astic folded before Flop (didn't bet)
Seat 6: timburonps folded before Flop (didn't bet)
Seat 7: Loholov folded before Flop (didn't bet)
Seat 8: silvno31 folded before Flop (didn't bet)
Seat 9: chiyuki folded before Flop (didn't bet)



PokerStars Zoom Hand #84299035864:  Hold'em No Limit ($0.10/$0.25) - 2012/08/05 13:51:44 JST [2012/08/05 0:51:44 ET]
Table 'Whirlpool' 9-max Seat #1 is the button
Seat 1: taksist889 ($15.47 in chips) 
Seat 2: peng2astic ($9.71 in chips) 
Seat 3: Dejacob ($30.93 in chips) 
Seat 4: chiyuki ($52.35 in chips) 
Seat 5: NastyMcNast ($25.14 in chips) 
Seat 6: BlOnDhOlIc ($39.56 in chips) 
Seat 7: gunbowler ($154.38 in chips) 
Seat 8: gandalfs9 ($23.25 in chips) 
Seat 9: flyinprits ($55.96 in chips) 
peng2astic: posts small blind $0.10
Dejacob: posts big blind $0.25
*** HOLE CARDS ***
Dealt to chiyuki [8s 9d]
chiyuki: folds 
NastyMcNast: raises $0.50 to $0.75
BlOnDhOlIc: raises $1.50 to $2.25
gunbowler: folds 
gandalfs9: calls $2.25
flyinprits: folds 
taksist889: folds 
peng2astic: folds 
Dejacob: folds 
NastyMcNast: calls $1.50
*** FLOP *** [2d 2s 5d]
NastyMcNast: checks 
BlOnDhOlIc: bets $4
gandalfs9: folds 
NastyMcNast: folds 
Uncalled bet ($4) returned to BlOnDhOlIc
BlOnDhOlIc collected $6.78 from pot
BlOnDhOlIc: doesn't show hand 
*** SUMMARY ***
Total pot $7.10 | Rake $0.32 
Board [2d 2s 5d]
Seat 1: taksist889 (button) folded before Flop (didn't bet)
Seat 2: peng2astic (small blind) folded before Flop
Seat 3: Dejacob (big blind) folded before Flop
Seat 4: chiyuki folded before Flop (didn't bet)
Seat 5: NastyMcNast folded on the Flop
Seat 6: BlOnDhOlIc collected ($6.78)
Seat 7: gunbowler folded before Flop (didn't bet)
Seat 8: gandalfs9 folded on the Flop
Seat 9: flyinprits folded before Flop (didn't bet)



PokerStars Zoom Hand #84299046291:  Hold'em No Limit ($0.10/$0.25) - 2012/08/05 13:52:26 JST [2012/08/05 0:52:26 ET]
Table 'Whirlpool' 9-max Seat #1 is the button
Seat 1: PetitAlejo ($25.75 in chips) 
Seat 2: munky3 ($26.89 in chips) 
Seat 3: chiyuki ($52.25 in chips) 
Seat 4: mariuka1 ($10.96 in chips) 
Seat 5: RikkStroken ($13.90 in chips) 
Seat 6: Loholov ($18.73 in chips) 
Seat 7: 2997qwer ($12.93 in chips) 
Seat 8: hirozo ($25 in chips) 
Seat 9: Anafim ($15.38 in chips) 
munky3: posts small blind $0.10
chiyuki: posts big blind $0.25
*** HOLE CARDS ***
Dealt to chiyuki [9s Qc]
mariuka1: folds 
RikkStroken: folds 
Loholov: folds 
2997qwer: raises $0.50 to $0.75
hirozo: folds 
Anafim: folds 
PetitAlejo: folds 
munky3: folds 
chiyuki: folds 
Uncalled bet ($0.50) returned to 2997qwer
2997qwer collected $0.60 from pot
2997qwer: doesn't show hand 
*** SUMMARY ***
Total pot $0.60 | Rake $0 
Seat 1: PetitAlejo (button) folded before Flop (didn't bet)
Seat 2: munky3 (small blind) folded before Flop
Seat 3: chiyuki (big blind) folded before Flop
Seat 4: mariuka1 folded before Flop (didn't bet)
Seat 5: RikkStroken folded before Flop (didn't bet)
Seat 6: Loholov folded before Flop (didn't bet)
Seat 7: 2997qwer collected ($0.60)
Seat 8: hirozo folded before Flop (didn't bet)
Seat 9: Anafim folded before Flop (didn't bet)



PokerStars Zoom Hand #84299053340:  Hold'em No Limit ($0.10/$0.25) - 2012/08/05 13:52:54 JST [2012/08/05 0:52:54 ET]
Table 'Whirlpool' 9-max Seat #1 is the button
Seat 1: carlosrbr ($22.46 in chips) 
Seat 2: PetitAlejo ($25.10 in chips) 
Seat 3: BlackZafiro ($27.42 in chips) 
Seat 4: Th3Fog ($22.09 in chips) 
Seat 5: cr0lox ($20.33 in chips) 
Seat 6: deadmoneykid ($29.68 in chips) 
Seat 7: chiyuki ($52 in chips) 
Seat 8: NastyMcNast ($25 in chips) 
Seat 9: wtu1986 ($25.39 in chips) 
PetitAlejo: posts small blind $0.10
BlackZafiro: posts big blind $0.25
*** HOLE CARDS ***
Dealt to chiyuki [4s 7h]
Th3Fog: folds 
cr0lox: folds 
deadmoneykid: folds 
chiyuki: folds 
NastyMcNast: folds 
wtu1986: folds 
carlosrbr: folds 
PetitAlejo: folds 
Uncalled bet ($0.15) returned to BlackZafiro
BlackZafiro collected $0.20 from pot
BlackZafiro: doesn't show hand 
*** SUMMARY ***
Total pot $0.20 | Rake $0 
Seat 1: carlosrbr (button) folded before Flop (didn't bet)
Seat 2: PetitAlejo (small blind) folded before Flop
Seat 3: BlackZafiro (big blind) collected ($0.20)
Seat 4: Th3Fog folded before Flop (didn't bet)
Seat 5: cr0lox folded before Flop (didn't bet)
Seat 6: deadmoneykid folded before Flop (didn't bet)
Seat 7: chiyuki folded before Flop (didn't bet)
Seat 8: NastyMcNast folded before Flop (didn't bet)
Seat 9: wtu1986 folded before Flop (didn't bet)



PokerStars Zoom Hand #84299056872:  Hold'em No Limit ($0.10/$0.25) - 2012/08/05 13:53:09 JST [2012/08/05 0:53:09 ET]
Table 'Whirlpool' 9-max Seat #1 is the button
Seat 1: Lasutchik ($7.73 in chips) 
Seat 2: 123progress ($24.75 in chips) 
Seat 3: BlackZafiro ($42.06 in chips) 
Seat 4: Rudolf ($48.09 in chips) 
Seat 5: RomarioJa ($5.33 in chips) 
Seat 6: agurio ($33.36 in chips) 
Seat 7: Roglus ($70.47 in chips) 
Seat 8: Dejacob ($53.33 in chips) 
Seat 9: chiyuki ($52 in chips) 
123progress: posts small blind $0.10
BlackZafiro: posts big blind $0.25
*** HOLE CARDS ***
Dealt to chiyuki [4h Ah]
Rudolf: folds 
RomarioJa: folds 
agurio: raises $0.75 to $1
Roglus: folds 
Dejacob: folds 
chiyuki: folds 
Lasutchik: folds 
123progress: folds 
BlackZafiro: folds 
Uncalled bet ($0.75) returned to agurio
agurio collected $0.60 from pot
agurio: doesn't show hand 
*** SUMMARY ***
Total pot $0.60 | Rake $0 
Seat 1: Lasutchik (button) folded before Flop (didn't bet)
Seat 2: 123progress (small blind) folded before Flop
Seat 3: BlackZafiro (big blind) folded before Flop
Seat 4: Rudolf folded before Flop (didn't bet)
Seat 5: RomarioJa folded before Flop (didn't bet)
Seat 6: agurio collected ($0.60)
Seat 7: Roglus folded before Flop (didn't bet)
Seat 8: Dejacob folded before Flop (didn't bet)
Seat 9: chiyuki folded before Flop (didn't bet)



PokerStars Zoom Hand #84299061175:  Hold'em No Limit ($0.10/$0.25) - 2012/08/05 13:53:26 JST [2012/08/05 0:53:26 ET]
Table 'Whirlpool' 9-max Seat #1 is the button
Seat 1: Suhoff76 ($39.68 in chips) 
Seat 2: RomarioJa ($5.33 in chips) 
Seat 3: giorgos_k ($15 in chips) 
Seat 4: PetitAlejo ($28.66 in chips) 
Seat 5: fwani ($29.84 in chips) 
Seat 6: chiyuki ($52 in chips) 
Seat 7: Nerkit ($13 in chips) 
Seat 8: Loholov ($17.55 in chips) 
Seat 9: jeff0923 ($24.95 in chips) 
RomarioJa: posts small blind $0.10
giorgos_k: posts big blind $0.25
*** HOLE CARDS ***
Dealt to chiyuki [Js Ah]
PetitAlejo: folds 
fwani: raises $0.35 to $0.60
chiyuki: folds 
Nerkit: folds 
Loholov: folds 
jeff0923: folds 
Suhoff76: folds 
RomarioJa: folds 
giorgos_k: folds 
Uncalled bet ($0.35) returned to fwani
fwani collected $0.60 from pot
fwani: doesn't show hand 
*** SUMMARY ***
Total pot $0.60 | Rake $0 
Seat 1: Suhoff76 (button) folded before Flop (didn't bet)
Seat 2: RomarioJa (small blind) folded before Flop
Seat 3: giorgos_k (big blind) folded before Flop
Seat 4: PetitAlejo folded before Flop (didn't bet)
Seat 5: fwani collected ($0.60)
Seat 6: chiyuki folded before Flop (didn't bet)
Seat 7: Nerkit folded before Flop (didn't bet)
Seat 8: Loholov folded before Flop (didn't bet)
Seat 9: jeff0923 folded before Flop (didn't bet)



PokerStars Zoom Hand #84299063429:  Hold'em No Limit ($0.10/$0.25) - 2012/08/05 13:53:35 JST [2012/08/05 0:53:35 ET]
Table 'Whirlpool' 9-max Seat #1 is the button
Seat 1: Nerkit ($15.85 in chips) 
Seat 2: chiyuki ($52 in chips) 
Seat 3: peng2astic ($9.46 in chips) 
Seat 4: hirozo ($27.56 in chips) 
Seat 5: NastyMcNast ($35.75 in chips) 
Seat 6: Loholov ($15 in chips) 
Seat 7: petersmiths ($49.98 in chips) 
Seat 8: RikkStroken ($13.15 in chips) 
Seat 9: Th3Fog ($22.09 in chips) 
chiyuki: posts small blind $0.10
peng2astic: posts big blind $0.25
*** HOLE CARDS ***
Dealt to chiyuki [8c Js]
hirozo: folds 
NastyMcNast: folds 
Loholov: folds 
petersmiths: folds 
RikkStroken: folds 
Th3Fog: folds 
Nerkit: folds 
chiyuki: folds 
Uncalled bet ($0.15) returned to peng2astic
peng2astic collected $0.20 from pot
peng2astic: doesn't show hand 
*** SUMMARY ***
Total pot $0.20 | Rake $0 
Seat 1: Nerkit (button) folded before Flop (didn't bet)
Seat 2: chiyuki (small blind) folded before Flop
Seat 3: peng2astic (big blind) collected ($0.20)
Seat 4: hirozo folded before Flop (didn't bet)
Seat 5: NastyMcNast folded before Flop (didn't bet)
Seat 6: Loholov folded before Flop (didn't bet)
Seat 7: petersmiths folded before Flop (didn't bet)
Seat 8: RikkStroken folded before Flop (didn't bet)
Seat 9: Th3Fog folded before Flop (didn't bet)



PokerStars Zoom Hand #84299065943:  Hold'em No Limit ($0.10/$0.25) - 2012/08/05 13:53:45 JST [2012/08/05 0:53:45 ET]
Table 'Whirlpool' 9-max Seat #1 is the button
Seat 1: Alvinpe85 ($36.38 in chips) 
Seat 2: Nerkit ($15.85 in chips) 
Seat 3: BlackZafiro ($25.24 in chips) 
Seat 4: chiyuki ($51.90 in chips) 
Seat 5: NastyMcNast ($25 in chips) 
Seat 6: Roglus ($70.22 in chips) 
Seat 7: Loholov ($17.55 in chips) 
Seat 8: timburonps ($42.74 in chips) 
Seat 9: leo2095 ($16.61 in chips) 
Nerkit: posts small blind $0.10
BlackZafiro: posts big blind $0.25
*** HOLE CARDS ***
Dealt to chiyuki [8s 3c]
chiyuki: folds 
NastyMcNast: folds 
Roglus: folds 
Loholov: raises $0.50 to $0.75
timburonps: folds 
leo2095: folds 
Alvinpe85: folds 
Nerkit: folds 
BlackZafiro: folds 
Uncalled bet ($0.50) returned to Loholov
Loholov collected $0.60 from pot
Loholov: doesn't show hand 
*** SUMMARY ***
Total pot $0.60 | Rake $0 
Seat 1: Alvinpe85 (button) folded before Flop (didn't bet)
Seat 2: Nerkit (small blind) folded before Flop
Seat 3: BlackZafiro (big blind) folded before Flop
Seat 4: chiyuki folded before Flop (didn't bet)
Seat 5: NastyMcNast folded before Flop (didn't bet)
Seat 6: Roglus folded before Flop (didn't bet)
Seat 7: Loholov collected ($0.60)
Seat 8: timburonps folded before Flop (didn't bet)
Seat 9: leo2095 folded before Flop (didn't bet)



PokerStars Zoom Hand #84299042976:  Hold'em No Limit ($0.10/$0.25) - 2012/08/05 13:52:13 JST [2012/08/05 0:52:13 ET]
Table 'Whirlpool' 9-max Seat #1 is the button
Seat 1: peng2astic ($9.96 in chips) 
Seat 2: slapshot2011 ($26.39 in chips) 
Seat 3: Déculotter69 ($14.25 in chips) 
Seat 4: chiyuki ($52.25 in chips) 
Seat 5: RomarioJa ($10.02 in chips) 
Seat 6: 123progress ($43.69 in chips) 
Seat 7: softdesign ($78.40 in chips) 
Seat 8: mariuka1 ($10.96 in chips) 
Seat 9: RikkStroken ($13.90 in chips) 
slapshot2011: posts small blind $0.10
Déculotter69: posts big blind $0.25
*** HOLE CARDS ***
Dealt to chiyuki [6d 9d]
chiyuki: folds 
RomarioJa: raises $0.37 to $0.62
123progress: folds 
softdesign: calls $0.62
mariuka1: folds 
RikkStroken: folds 
peng2astic: folds 
slapshot2011: calls $0.52
Déculotter69: folds 
*** FLOP *** [Qd 6c 9h]
slapshot2011: bets $0.75
RomarioJa: raises $1.05 to $1.80
softdesign: folds 
slapshot2011: calls $1.05
*** TURN *** [Qd 6c 9h] [7d]
slapshot2011: checks 
RomarioJa: checks 
*** RIVER *** [Qd 6c 9h 7d] [7c]
slapshot2011: bets $0.75
RomarioJa: calls $0.75
*** SHOW DOWN ***
slapshot2011: shows [Ks Qs] (two pair, Queens and Sevens)
RomarioJa: shows [Ad Qh] (two pair, Queens and Sevens - Ace kicker)
RomarioJa collected $6.89 from pot
*** SUMMARY ***
Total pot $7.21 | Rake $0.32 
Board [Qd 6c 9h 7d 7c]
Seat 1: peng2astic (button) folded before Flop (didn't bet)
Seat 2: slapshot2011 (small blind) showed [Ks Qs] and lost with two pair, Queens and Sevens
Seat 3: Déculotter69 (big blind) folded before Flop
Seat 4: chiyuki folded before Flop (didn't bet)
Seat 5: RomarioJa showed [Ad Qh] and won ($6.89) with two pair, Queens and Sevens
Seat 6: 123progress folded before Flop (didn't bet)
Seat 7: softdesign folded on the Flop
Seat 8: mariuka1 folded before Flop (didn't bet)
Seat 9: RikkStroken folded before Flop (didn't bet)



PokerStars Zoom Hand #84299066961:  Hold'em No Limit ($0.10/$0.25) - 2012/08/05 13:53:49 JST [2012/08/05 0:53:49 ET]
Table 'Whirlpool' 9-max Seat #1 is the button
Seat 1: Roglus ($70.22 in chips) 
Seat 2: giorgos_k ($14.75 in chips) 
Seat 3: PetitAlejo ($25.75 in chips) 
Seat 4: KeLevro0 ($13.01 in chips) 
Seat 5: agurio ($33.71 in chips) 
Seat 6: Vahe50 ($30.10 in chips) 
Seat 7: hirozo ($27.56 in chips) 
Seat 8: chiyuki ($51.90 in chips) 
Seat 9: Déculotter69 ($16.63 in chips) 
giorgos_k: posts small blind $0.10
PetitAlejo: posts big blind $0.25
*** HOLE CARDS ***
Dealt to chiyuki [2c Kd]
KeLevro0: folds 
agurio: folds 
Vahe50: folds 
hirozo: folds 
chiyuki: folds 
Déculotter69: raises $0.50 to $0.75
Roglus: folds 
giorgos_k: folds 
PetitAlejo: folds 
Uncalled bet ($0.50) returned to Déculotter69
Déculotter69 collected $0.60 from pot
Déculotter69: doesn't show hand 
*** SUMMARY ***
Total pot $0.60 | Rake $0 
Seat 1: Roglus (button) folded before Flop (didn't bet)
Seat 2: giorgos_k (small blind) folded before Flop
Seat 3: PetitAlejo (big blind) folded before Flop
Seat 4: KeLevro0 folded before Flop (didn't bet)
Seat 5: agurio folded before Flop (didn't bet)
Seat 6: Vahe50 folded before Flop (didn't bet)
Seat 7: hirozo folded before Flop (didn't bet)
Seat 8: chiyuki folded before Flop (didn't bet)
Seat 9: Déculotter69 collected ($0.60)



PokerStars Zoom Hand #84299059900:  Hold'em No Limit ($0.10/$0.25) - 2012/08/05 13:53:21 JST [2012/08/05 0:53:21 ET]
Table 'Whirlpool' 9-max Seat #1 is the button
Seat 1: chiyuki ($52 in chips) 
Seat 2: Anafim ($15.65 in chips) 
Seat 3: flyinprits ($45.22 in chips) 
Seat 4: ladymadon107 ($16.82 in chips) 
Seat 5: Nerkit ($13 in chips) 
Seat 6: DjJooni ($35.56 in chips) 
Seat 7: Wilcox76607 ($18.50 in chips) 
Seat 8: deadmoneykid ($27.49 in chips) 
Seat 9: Suhoff76 ($39.68 in chips) 
Anafim: posts small blind $0.10
flyinprits: posts big blind $0.25
*** HOLE CARDS ***
Dealt to chiyuki [5d Qs]
ladymadon107: calls $0.25
Nerkit: folds 
DjJooni: folds 
Wilcox76607: calls $0.25
deadmoneykid: folds 
Suhoff76: folds 
chiyuki: folds 
Anafim: folds 
flyinprits: checks 
*** FLOP *** [2h 4s 2s]
flyinprits: checks 
ladymadon107: checks 
Wilcox76607: bets $0.75
flyinprits: folds 
ladymadon107: folds 
Uncalled bet ($0.75) returned to Wilcox76607
Wilcox76607 collected $0.81 from pot
Wilcox76607: doesn't show hand 
*** SUMMARY ***
Total pot $0.85 | Rake $0.04 
Board [2h 4s 2s]
Seat 1: chiyuki (button) folded before Flop (didn't bet)
Seat 2: Anafim (small blind) folded before Flop
Seat 3: flyinprits (big blind) folded on the Flop
Seat 4: ladymadon107 folded on the Flop
Seat 5: Nerkit folded before Flop (didn't bet)
Seat 6: DjJooni folded before Flop (didn't bet)
Seat 7: Wilcox76607 collected ($0.81)
Seat 8: deadmoneykid folded before Flop (didn't bet)
Seat 9: Suhoff76 folded before Flop (didn't bet)



PokerStars Zoom Hand #84299044243:  Hold'em No Limit ($0.10/$0.25) - 2012/08/05 13:52:18 JST [2012/08/05 0:52:18 ET]
Table 'Whirlpool' 9-max Seat #1 is the button
Seat 1: Lasutchik ($32.43 in chips) 
Seat 2: Rudolf ($48.44 in chips) 
Seat 3: Faraz ($22.07 in chips) 
Seat 4: RikkStroken ($12.30 in chips) 
Seat 5: TErr18 ($12.80 in chips) 
Seat 6: munky3 ($26.89 in chips) 
Seat 7: Wilcox76607 ($18.85 in chips) 
Seat 8: chiyuki ($52.25 in chips) 
Seat 9: Ellen1947 ($34.79 in chips) 
Rudolf: posts small blind $0.10
Faraz: posts big blind $0.25
*** HOLE CARDS ***
Dealt to chiyuki [4d Ah]
RikkStroken: raises $0.25 to $0.50
TErr18: folds 
munky3: folds 
Wilcox76607: folds 
chiyuki: folds 
Ellen1947: calls $0.50
Lasutchik: folds 
Rudolf: folds 
Faraz: calls $0.25
*** FLOP *** [5c Qc 5s]
Faraz: checks 
RikkStroken: bets $1
Ellen1947: calls $1
Faraz: folds 
*** TURN *** [5c Qc 5s] [Th]
RikkStroken: checks 
Ellen1947: bets $1.72
RikkStroken: calls $1.72
*** RIVER *** [5c Qc 5s Th] [Tc]
RikkStroken: bets $1.25
Ellen1947: calls $1.25
*** SHOW DOWN ***
RikkStroken: shows [6c Ac] (a flush, Ace high)
Ellen1947: mucks hand 
RikkStroken collected $9.11 from pot
*** SUMMARY ***
Total pot $9.54 | Rake $0.43 
Board [5c Qc 5s Th Tc]
Seat 1: Lasutchik (button) folded before Flop (didn't bet)
Seat 2: Rudolf (small blind) folded before Flop
Seat 3: Faraz (big blind) folded on the Flop
Seat 4: RikkStroken showed [6c Ac] and won ($9.11) with a flush, Ace high
Seat 5: TErr18 folded before Flop (didn't bet)
Seat 6: munky3 folded before Flop (didn't bet)
Seat 7: Wilcox76607 folded before Flop (didn't bet)
Seat 8: chiyuki folded before Flop (didn't bet)
Seat 9: Ellen1947 mucked [Qd Jd]



PokerStars Zoom Hand #84299067733:  Hold'em No Limit ($0.10/$0.25) - 2012/08/05 13:53:52 JST [2012/08/05 0:53:52 ET]
Table 'Whirlpool' 9-max Seat #1 is the button
Seat 1: Nerkit ($11.56 in chips) 
Seat 2: 2997qwer ($14.87 in chips) 
Seat 3: chiyuki ($51.90 in chips) 
Seat 4: Loholov ($15 in chips) 
Seat 5: NastyMcNast ($35.75 in chips) 
Seat 6: kamikkaze ($12.75 in chips) 
Seat 7: Suhoff76 ($55.66 in chips) 
Seat 8: Lasutchik ($7.63 in chips) 
Seat 9: solawind ($13.22 in chips) 
2997qwer: posts small blind $0.10
chiyuki: posts big blind $0.25
*** HOLE CARDS ***
Dealt to chiyuki [8d Ks]
Loholov: folds 
NastyMcNast: folds 
kamikkaze: raises $0.38 to $0.63
Suhoff76: folds 
Lasutchik: folds 
solawind: folds 
Nerkit has timed out
Nerkit: folds 
2997qwer: folds 
chiyuki: folds 
Uncalled bet ($0.38) returned to kamikkaze
kamikkaze collected $0.60 from pot
kamikkaze: doesn't show hand 
*** SUMMARY ***
Total pot $0.60 | Rake $0 
Seat 1: Nerkit (button) folded before Flop (didn't bet)
Seat 2: 2997qwer (small blind) folded before Flop
Seat 3: chiyuki (big blind) folded before Flop
Seat 4: Loholov folded before Flop (didn't bet)
Seat 5: NastyMcNast folded before Flop (didn't bet)
Seat 6: kamikkaze collected ($0.60)
Seat 7: Suhoff76 folded before Flop (didn't bet)
Seat 8: Lasutchik folded before Flop (didn't bet)
Seat 9: solawind folded before Flop (didn't bet)



PokerStars Zoom Hand #84299064956:  Hold'em No Limit ($0.10/$0.25) - 2012/08/05 13:53:41 JST [2012/08/05 0:53:41 ET]
Table 'Whirlpool' 9-max Seat #1 is the button
Seat 1: hirozo ($25 in chips) 
Seat 2: Th3Fog ($22.09 in chips) 
Seat 3: gandalfs9 ($20 in chips) 
Seat 4: fwani ($25 in chips) 
Seat 5: chiyuki ($51.90 in chips) 
Seat 6: Lasutchik ($7.63 in chips) 
Seat 7: ll_LaMeR_ll ($65.52 in chips) 
Seat 8: 2997qwer ($10 in chips) 
Seat 9: ChrisCDee ($29.07 in chips) 
Th3Fog: posts small blind $0.10
gandalfs9: posts big blind $0.25
*** HOLE CARDS ***
Dealt to chiyuki [Qc 7d]
fwani: folds 
chiyuki: folds 
Lasutchik: folds 
ll_LaMeR_ll: raises $0.50 to $0.75
2997qwer: folds 
ChrisCDee: folds 
hirozo: folds 
Th3Fog: folds 
gandalfs9: calls $0.50
*** FLOP *** [Js Td 5d]
gandalfs9: checks 
ll_LaMeR_ll: bets $1
gandalfs9: calls $1
*** TURN *** [Js Td 5d] [Kc]
gandalfs9: checks 
ll_LaMeR_ll: bets $2
gandalfs9: raises $2 to $4
ll_LaMeR_ll: raises $5.37 to $9.37
gandalfs9: raises $8.88 to $18.25 and is all-in
ll_LaMeR_ll: calls $8.88
*** RIVER *** [Js Td 5d Kc] [5h]
*** SHOW DOWN ***
gandalfs9: shows [Th Ks] (two pair, Kings and Tens)
ll_LaMeR_ll: shows [Qd 9d] (a straight, Nine to King)
ll_LaMeR_ll collected $38.30 from pot
*** SUMMARY ***
Total pot $40.10 | Rake $1.80 
Board [Js Td 5d Kc 5h]
Seat 1: hirozo (button) folded before Flop (didn't bet)
Seat 2: Th3Fog (small blind) folded before Flop
Seat 3: gandalfs9 (big blind) showed [Th Ks] and lost with two pair, Kings and Tens
Seat 4: fwani folded before Flop (didn't bet)
Seat 5: chiyuki folded before Flop (didn't bet)
Seat 6: Lasutchik folded before Flop (didn't bet)
Seat 7: ll_LaMeR_ll showed [Qd 9d] and won ($38.30) with a straight, Nine to King
Seat 8: 2997qwer folded before Flop (didn't bet)
Seat 9: ChrisCDee folded before Flop (didn't bet)



PokerStars Zoom Hand #84299075259:  Hold'em No Limit ($0.10/$0.25) - 2012/08/05 13:54:23 JST [2012/08/05 0:54:23 ET]
Table 'Whirlpool' 9-max Seat #1 is the button
Seat 1: DjJooni ($38.30 in chips) 
Seat 2: timburonps ($27.03 in chips) 
Seat 3: Vahe50 ($30.10 in chips) 
Seat 4: BlackZafiro ($41.71 in chips) 
Seat 5: GoldNutter ($15.84 in chips) 
Seat 6: jeff0923 ($24.85 in chips) 
Seat 7: chiyuki ($51.65 in chips) 
Seat 8: 123progress ($25 in chips) 
Seat 9: D@vidMed ($51.09 in chips) 
timburonps: posts small blind $0.10
Vahe50: posts big blind $0.25
*** HOLE CARDS ***
Dealt to chiyuki [9s 4s]
BlackZafiro: folds 
GoldNutter: raises $0.25 to $0.50
jeff0923: calls $0.50
chiyuki: folds 
123progress: folds 
D@vidMed: raises $1.50 to $2
DjJooni: folds 
timburonps: folds 
Vahe50: folds 
GoldNutter: folds 
jeff0923: folds 
Uncalled bet ($1.50) returned to D@vidMed
D@vidMed collected $1.85 from pot
D@vidMed: doesn't show hand 
*** SUMMARY ***
Total pot $1.85 | Rake $0 
Seat 1: DjJooni (button) folded before Flop (didn't bet)
Seat 2: timburonps (small blind) folded before Flop
Seat 3: Vahe50 (big blind) folded before Flop
Seat 4: BlackZafiro folded before Flop (didn't bet)
Seat 5: GoldNutter folded before Flop
Seat 6: jeff0923 folded before Flop
Seat 7: chiyuki folded before Flop (didn't bet)
Seat 8: 123progress folded before Flop (didn't bet)
Seat 9: D@vidMed collected ($1.85)



PokerStars Zoom Hand #84299078605:  Hold'em No Limit ($0.10/$0.25) - 2012/08/05 13:54:36 JST [2012/08/05 0:54:36 ET]
Table 'Whirlpool' 9-max Seat #1 is the button
Seat 1: chiyuki ($51.65 in chips) 
Seat 2: Vahe50 ($15.80 in chips) 
Seat 3: Alvinpe85 ($36.28 in chips) 
Seat 4: BlackZafiro ($41.71 in chips) 
Seat 5: seula i ($42.25 in chips) 
Seat 6: KeLevro0 ($13.01 in chips) 
Seat 7: Dejacob ($49.58 in chips) 
Seat 8: PetitAlejo ($28.31 in chips) 
Seat 9: RikkStroken ($16.84 in chips) 
Vahe50: posts small blind $0.10
Alvinpe85: posts big blind $0.25
*** HOLE CARDS ***
Dealt to chiyuki [2h Qc]
BlackZafiro: folds 
seula i: folds 
KeLevro0: folds 
Dejacob: folds 
PetitAlejo: folds 
RikkStroken: raises $0.50 to $0.75
chiyuki: folds 
Vahe50: folds 
Alvinpe85: folds 
Uncalled bet ($0.50) returned to RikkStroken
RikkStroken collected $0.60 from pot
RikkStroken: doesn't show hand 
*** SUMMARY ***
Total pot $0.60 | Rake $0 
Seat 1: chiyuki (button) folded before Flop (didn't bet)
Seat 2: Vahe50 (small blind) folded before Flop
Seat 3: Alvinpe85 (big blind) folded before Flop
Seat 4: BlackZafiro folded before Flop (didn't bet)
Seat 5: seula i folded before Flop (didn't bet)
Seat 6: KeLevro0 folded before Flop (didn't bet)
Seat 7: Dejacob folded before Flop (didn't bet)
Seat 8: PetitAlejo folded before Flop (didn't bet)
Seat 9: RikkStroken collected ($0.60)



PokerStars Zoom Hand #84299076513:  Hold'em No Limit ($0.10/$0.25) - 2012/08/05 13:54:28 JST [2012/08/05 0:54:28 ET]
Table 'Whirlpool' 9-max Seat #1 is the button
Seat 1: Ellen1947 ($30.32 in chips) 
Seat 2: RomarioJa ($13.74 in chips) 
Seat 3: DjJooni ($38.30 in chips) 
Seat 4: deadmoneykid ($27.39 in chips) 
Seat 5: 2997qwer ($14.77 in chips) 
Seat 6: chiyuki ($51.65 in chips) 
Seat 7: PetitAlejo ($28.31 in chips) 
Seat 8: BlackZafiro ($41.71 in chips) 
Seat 9: KeLevro0 ($13.01 in chips) 
RomarioJa: posts small blind $0.10
DjJooni: posts big blind $0.25
*** HOLE CARDS ***
Dealt to chiyuki [Qh 7c]
deadmoneykid: folds 
2997qwer: folds 
chiyuki: folds 
PetitAlejo: folds 
BlackZafiro: folds 
KeLevro0: folds 
Ellen1947: folds 
RomarioJa: raises $0.37 to $0.62
DjJooni: calls $0.37
*** FLOP *** [2c Tc Kd]
RomarioJa: bets $0.77
DjJooni: folds 
Uncalled bet ($0.77) returned to RomarioJa
RomarioJa collected $1.18 from pot
RomarioJa: doesn't show hand 
*** SUMMARY ***
Total pot $1.24 | Rake $0.06 
Board [2c Tc Kd]
Seat 1: Ellen1947 (button) folded before Flop (didn't bet)
Seat 2: RomarioJa (small blind) collected ($1.18)
Seat 3: DjJooni (big blind) folded on the Flop
Seat 4: deadmoneykid folded before Flop (didn't bet)
Seat 5: 2997qwer folded before Flop (didn't bet)
Seat 6: chiyuki folded before Flop (didn't bet)
Seat 7: PetitAlejo folded before Flop (didn't bet)
Seat 8: BlackZafiro folded before Flop (didn't bet)
Seat 9: KeLevro0 folded before Flop (didn't bet)



PokerStars Zoom Hand #84299077546:  Hold'em No Limit ($0.10/$0.25) - 2012/08/05 13:54:32 JST [2012/08/05 0:54:32 ET]
Table 'Whirlpool' 9-max Seat #1 is the button
Seat 1: hirozo ($26.42 in chips) 
Seat 2: wildy29 ($18.23 in chips) 
Seat 3: Nerkit ($15.75 in chips) 
Seat 4: chiyuki ($51.65 in chips) 
Seat 5: TErr18 ($17.35 in chips) 
Seat 6: timburonps ($26.93 in chips) 
Seat 7: KeLevro0 ($13.01 in chips) 
Seat 8: ChrisCDee ($26.14 in chips) 
Seat 9: NastyMcNast ($35.65 in chips) 
wildy29: posts small blind $0.10
Nerkit: posts big blind $0.25
*** HOLE CARDS ***
Dealt to chiyuki [6h 5h]
chiyuki: folds 
TErr18: calls $0.25
timburonps: folds 
KeLevro0: folds 
ChrisCDee: folds 
NastyMcNast: folds 
hirozo: folds 
wildy29: calls $0.15
Nerkit: checks 
*** FLOP *** [As Jh 3d]
wildy29: checks 
Nerkit: checks 
TErr18: checks 
*** TURN *** [As Jh 3d] [8d]
wildy29: bets $0.25
Nerkit: folds 
TErr18: calls $0.25
*** RIVER *** [As Jh 3d 8d] [3h]
wildy29: bets $0.75
TErr18: folds 
Uncalled bet ($0.75) returned to wildy29
wildy29 collected $1.19 from pot
wildy29: doesn't show hand 
*** SUMMARY ***
Total pot $1.25 | Rake $0.06 
Board [As Jh 3d 8d 3h]
Seat 1: hirozo (button) folded before Flop (didn't bet)
Seat 2: wildy29 (small blind) collected ($1.19)
Seat 3: Nerkit (big blind) folded on the Turn
Seat 4: chiyuki folded before Flop (didn't bet)
Seat 5: TErr18 folded on the River
Seat 6: timburonps folded before Flop (didn't bet)
Seat 7: KeLevro0 folded before Flop (didn't bet)
Seat 8: ChrisCDee folded before Flop (didn't bet)
Seat 9: NastyMcNast folded before Flop (didn't bet)



PokerStars Zoom Hand #84299079615:  Hold'em No Limit ($0.10/$0.25) - 2012/08/05 13:54:40 JST [2012/08/05 0:54:40 ET]
Table 'Whirlpool' 9-max Seat #1 is the button
Seat 1: BlackZafiro ($41.71 in chips) 
Seat 2: chiyuki ($51.65 in chips) 
Seat 3: 123progress ($25 in chips) 
Seat 4: timburonps ($29.47 in chips) 
Seat 5: 2997qwer ($10.05 in chips) 
Seat 6: carlosrbr ($22.11 in chips) 
Seat 7: ChrisCDee ($26.14 in chips) 
Seat 8: RomarioJa ($5.33 in chips) 
Seat 9: PetitAlejo ($26.58 in chips) 
chiyuki: posts small blind $0.10
123progress: posts big blind $0.25
*** HOLE CARDS ***
Dealt to chiyuki [8s 8h]
timburonps: folds 
2997qwer: folds 
carlosrbr: folds 
ChrisCDee: folds 
RomarioJa: folds 
PetitAlejo: folds 
BlackZafiro: raises $0.37 to $0.62
chiyuki: raises $1.37 to $1.99
123progress: folds 
BlackZafiro: calls $1.37
*** FLOP *** [Qc Qd 2h]
chiyuki: bets $2.02
BlackZafiro: raises $2.02 to $4.04
chiyuki: calls $2.02
*** TURN *** [Qc Qd 2h] [4c]
chiyuki: checks 
BlackZafiro: checks 
*** RIVER *** [Qc Qd 2h 4c] [6s]
chiyuki: checks 
BlackZafiro: bets $7
chiyuki: folds 
Uncalled bet ($7) returned to BlackZafiro
BlackZafiro collected $11.76 from pot
BlackZafiro: doesn't show hand 
*** SUMMARY ***
Total pot $12.31 | Rake $0.55 
Board [Qc Qd 2h 4c 6s]
Seat 1: BlackZafiro (button) collected ($11.76)
Seat 2: chiyuki (small blind) folded on the River
Seat 3: 123progress (big blind) folded before Flop
Seat 4: timburonps folded before Flop (didn't bet)
Seat 5: 2997qwer folded before Flop (didn't bet)
Seat 6: carlosrbr folded before Flop (didn't bet)
Seat 7: ChrisCDee folded before Flop (didn't bet)
Seat 8: RomarioJa folded before Flop (didn't bet)
Seat 9: PetitAlejo folded before Flop (didn't bet)



PokerStars Zoom Hand #84299096320:  Hold'em No Limit ($0.10/$0.25) - 2012/08/05 13:55:55 JST [2012/08/05 0:55:55 ET]
Table 'Whirlpool' 9-max Seat #1 is the button
Seat 1: deadmoneykid ($39.77 in chips) 
Seat 2: mariuka1 ($12.72 in chips) 
Seat 3: Lasutchik ($34.10 in chips) 
Seat 4: RomarioJa ($7.75 in chips) 
Seat 5: DanielWhyte ($21.58 in chips) 
Seat 6: ll_LaMeR_ll ($75.82 in chips) 
Seat 7: hirozo ($29.12 in chips) 
Seat 8: Loholov ($19.15 in chips) 
Seat 9: chiyuki ($45.62 in chips) 
mariuka1: posts small blind $0.10
Lasutchik: posts big blind $0.25
*** HOLE CARDS ***
Dealt to chiyuki [Td As]
RomarioJa: folds 
DanielWhyte: folds 
ll_LaMeR_ll: folds 
hirozo: raises $0.50 to $0.75
Loholov: folds 
chiyuki: folds 
deadmoneykid: folds 
mariuka1: folds 
Lasutchik: folds 
Uncalled bet ($0.50) returned to hirozo
hirozo collected $0.60 from pot
hirozo: doesn't show hand 
*** SUMMARY ***
Total pot $0.60 | Rake $0 
Seat 1: deadmoneykid (button) folded before Flop (didn't bet)
Seat 2: mariuka1 (small blind) folded before Flop
Seat 3: Lasutchik (big blind) folded before Flop
Seat 4: RomarioJa folded before Flop (didn't bet)
Seat 5: DanielWhyte folded before Flop (didn't bet)
Seat 6: ll_LaMeR_ll folded before Flop (didn't bet)
Seat 7: hirozo collected ($0.60)
Seat 8: Loholov folded before Flop (didn't bet)
Seat 9: chiyuki folded before Flop (didn't bet)



PokerStars Zoom Hand #84299098378:  Hold'em No Limit ($0.10/$0.25) - 2012/08/05 13:56:05 JST [2012/08/05 0:56:05 ET]
Table 'Whirlpool' 9-max Seat #1 is the button
Seat 1: mariuka1 ($12.62 in chips) 
Seat 2: RikkStroken ($14.75 in chips) 
Seat 3: BlackZafiro ($47.44 in chips) 
Seat 4: NastyMcNast ($25 in chips) 
Seat 5: Suhoff76 ($38.78 in chips) 
Seat 6: roksmokndonk ($36.71 in chips) 
Seat 7: Lasutchik ($33.85 in chips) 
Seat 8: chiyuki ($45.62 in chips) 
Seat 9: deadmoneykid ($39.77 in chips) 
RikkStroken: posts small blind $0.10
BlackZafiro: posts big blind $0.25
*** HOLE CARDS ***
Dealt to chiyuki [Ts 6d]
NastyMcNast: folds 
Suhoff76: folds 
roksmokndonk: folds 
Lasutchik: folds 
chiyuki: folds 
deadmoneykid: folds 
mariuka1: folds 
RikkStroken: folds 
Uncalled bet ($0.15) returned to BlackZafiro
BlackZafiro collected $0.20 from pot
BlackZafiro: doesn't show hand 
*** SUMMARY ***
Total pot $0.20 | Rake $0 
Seat 1: mariuka1 (button) folded before Flop (didn't bet)
Seat 2: RikkStroken (small blind) folded before Flop
Seat 3: BlackZafiro (big blind) collected ($0.20)
Seat 4: NastyMcNast folded before Flop (didn't bet)
Seat 5: Suhoff76 folded before Flop (didn't bet)
Seat 6: roksmokndonk folded before Flop (didn't bet)
Seat 7: Lasutchik folded before Flop (didn't bet)
Seat 8: chiyuki folded before Flop (didn't bet)
Seat 9: deadmoneykid folded before Flop (didn't bet)



PokerStars Zoom Hand #84299099218:  Hold'em No Limit ($0.10/$0.25) - 2012/08/05 13:56:09 JST [2012/08/05 0:56:09 ET]
Table 'Whirlpool' 9-max Seat #1 is the button
Seat 1: BlOnDhOlIc ($45.33 in chips) 
Seat 2: flyinprits ($44.92 in chips) 
Seat 3: 123progress ($37.57 in chips) 
Seat 4: softdesign ($75.78 in chips) 
Seat 5: Loholov ($15.35 in chips) 
Seat 6: chiyuki ($45.62 in chips) 
Seat 7: roksmokndonk ($36.71 in chips) 
Seat 8: mariuka1 ($12.62 in chips) 
Seat 9: seula i ($25 in chips) 
flyinprits: posts small blind $0.10
123progress: posts big blind $0.25
*** HOLE CARDS ***
Dealt to chiyuki [Ts 5c]
softdesign: folds 
Loholov: folds 
chiyuki: folds 
roksmokndonk: folds 
mariuka1: folds 
seula i: raises $0.50 to $0.75
BlOnDhOlIc: folds 
flyinprits: folds 
123progress: folds 
Uncalled bet ($0.50) returned to seula i
seula i collected $0.60 from pot
seula i: doesn't show hand 
*** SUMMARY ***
Total pot $0.60 | Rake $0 
Seat 1: BlOnDhOlIc (button) folded before Flop (didn't bet)
Seat 2: flyinprits (small blind) folded before Flop
Seat 3: 123progress (big blind) folded before Flop
Seat 4: softdesign folded before Flop (didn't bet)
Seat 5: Loholov folded before Flop (didn't bet)
Seat 6: chiyuki folded before Flop (didn't bet)
Seat 7: roksmokndonk folded before Flop (didn't bet)
Seat 8: mariuka1 folded before Flop (didn't bet)
Seat 9: seula i collected ($0.60)



PokerStars Zoom Hand #84299102663:  Hold'em No Limit ($0.10/$0.25) - 2012/08/05 13:56:26 JST [2012/08/05 0:56:26 ET]
Table 'Whirlpool' 9-max Seat #1 is the button
Seat 1: deadmoneykid ($24.65 in chips) 
Seat 2: flyinprits ($35.66 in chips) 
Seat 3: cr0lox ($15.25 in chips) 
Seat 4: chiyuki ($45.62 in chips) 
Seat 5: NastyMcNast ($28.05 in chips) 
Seat 6: hirozo ($29.37 in chips) 
Seat 7: GoldNutter ($15.20 in chips) 
Seat 8: Loholov ($15.35 in chips) 
Seat 9: KeLevro0 ($14.10 in chips) 
flyinprits: posts small blind $0.10
cr0lox: posts big blind $0.25
*** HOLE CARDS ***
Dealt to chiyuki [4d 5d]
chiyuki: folds 
NastyMcNast: folds 
hirozo: folds 
GoldNutter: folds 
Loholov: folds 
KeLevro0: folds 
deadmoneykid: folds 
flyinprits: raises $0.50 to $0.75
cr0lox: folds 
Uncalled bet ($0.50) returned to flyinprits
flyinprits collected $0.50 from pot
flyinprits: doesn't show hand 
*** SUMMARY ***
Total pot $0.50 | Rake $0 
Seat 1: deadmoneykid (button) folded before Flop (didn't bet)
Seat 2: flyinprits (small blind) collected ($0.50)
Seat 3: cr0lox (big blind) folded before Flop
Seat 4: chiyuki folded before Flop (didn't bet)
Seat 5: NastyMcNast folded before Flop (didn't bet)
Seat 6: hirozo folded before Flop (didn't bet)
Seat 7: GoldNutter folded before Flop (didn't bet)
Seat 8: Loholov folded before Flop (didn't bet)
Seat 9: KeLevro0 folded before Flop (didn't bet)



PokerStars Zoom Hand #84299103661:  Hold'em No Limit ($0.10/$0.25) - 2012/08/05 13:56:31 JST [2012/08/05 0:56:31 ET]
Table 'Whirlpool' 9-max Seat #1 is the button
Seat 1: KeLevro0 ($14.10 in chips) 
Seat 2: solawind ($13.92 in chips) 
Seat 3: chiyuki ($45.62 in chips) 
Seat 4: NastyMcNast ($28.05 in chips) 
Seat 5: RomarioJa ($4.98 in chips) 
Seat 6: munky3 ($32.86 in chips) 
Seat 7: timburonps ($39.18 in chips) 
Seat 8: Déculotter69 ($20.25 in chips) 
Seat 9: wtu1986 ($25 in chips) 
solawind: posts small blind $0.10
chiyuki: posts big blind $0.25
*** HOLE CARDS ***
Dealt to chiyuki [Tc Qc]
NastyMcNast: folds 
RomarioJa: folds 
munky3: calls $0.25
timburonps: folds 
Déculotter69: folds 
wtu1986: folds 
KeLevro0: raises $0.42 to $0.67
solawind: folds 
chiyuki: calls $0.42
munky3: calls $0.42
*** FLOP *** [As Qs 3c]
chiyuki: checks 
munky3: checks 
KeLevro0: checks 
*** TURN *** [As Qs 3c] [8c]
chiyuki: bets $1.25
munky3: calls $1.25
KeLevro0: folds 
*** RIVER *** [As Qs 3c 8c] [8h]
chiyuki: bets $2.25
munky3: calls $2.25
*** SHOW DOWN ***
chiyuki: shows [Tc Qc] (two pair, Queens and Eights)
munky3: shows [6d Ad] (two pair, Aces and Eights)
munky3 collected $8.70 from pot
*** SUMMARY ***
Total pot $9.11 | Rake $0.41 
Board [As Qs 3c 8c 8h]
Seat 1: KeLevro0 (button) folded on the Turn
Seat 2: solawind (small blind) folded before Flop
Seat 3: chiyuki (big blind) showed [Tc Qc] and lost with two pair, Queens and Eights
Seat 4: NastyMcNast folded before Flop (didn't bet)
Seat 5: RomarioJa folded before Flop (didn't bet)
Seat 6: munky3 showed [6d Ad] and won ($8.70) with two pair, Aces and Eights
Seat 7: timburonps folded before Flop (didn't bet)
Seat 8: Déculotter69 folded before Flop (didn't bet)
Seat 9: wtu1986 folded before Flop (didn't bet)



PokerStars Zoom Hand #84299099821:  Hold'em No Limit ($0.10/$0.25) - 2012/08/05 13:56:12 JST [2012/08/05 0:56:12 ET]
Table 'Whirlpool' 9-max Seat #1 is the button
Seat 1: Noviekid ($24.98 in chips) 
Seat 2: agurio ($25 in chips) 
Seat 3: zaffaroots ($25 in chips) 
Seat 4: NastyMcNast ($25 in chips) 
Seat 5: Suhoff76 ($38.78 in chips) 
Seat 6: RikkStroken ($18.89 in chips) 
Seat 7: RomarioJa ($4.98 in chips) 
Seat 8: Dejacob ($34.74 in chips) 
Seat 9: chiyuki ($45.62 in chips) 
agurio: posts small blind $0.10
zaffaroots: posts big blind $0.25
*** HOLE CARDS ***
Dealt to chiyuki [Jc Ts]
NastyMcNast: folds 
Suhoff76: raises $0.32 to $0.57
RikkStroken: calls $0.57
RomarioJa: folds 
Dejacob: calls $0.57
chiyuki: folds 
Noviekid: folds 
agurio: folds 
zaffaroots: calls $0.32
*** FLOP *** [7c Qs Kd]
zaffaroots: checks 
Suhoff76: checks 
RikkStroken: checks 
Dejacob: bets $1.75
zaffaroots: folds 
Suhoff76: raises $3.80 to $5.55
RikkStroken: folds 
Dejacob: folds 
Uncalled bet ($3.80) returned to Suhoff76
Suhoff76 collected $5.62 from pot
Suhoff76: doesn't show hand 
*** SUMMARY ***
Total pot $5.88 | Rake $0.26 
Board [7c Qs Kd]
Seat 1: Noviekid (button) folded before Flop (didn't bet)
Seat 2: agurio (small blind) folded before Flop
Seat 3: zaffaroots (big blind) folded on the Flop
Seat 4: NastyMcNast folded before Flop (didn't bet)
Seat 5: Suhoff76 collected ($5.62)
Seat 6: RikkStroken folded on the Flop
Seat 7: RomarioJa folded before Flop (didn't bet)
Seat 8: Dejacob folded on the Flop
Seat 9: chiyuki folded before Flop (didn't bet)



PokerStars Zoom Hand #84299114731:  Hold'em No Limit ($0.10/$0.25) - 2012/08/05 13:57:25 JST [2012/08/05 0:57:25 ET]
Table 'Whirlpool' 9-max Seat #1 is the button
Seat 1: Loholov ($20.65 in chips) 
Seat 2: ygoegoe ($29.24 in chips) 
Seat 3: Dejacob ($32.42 in chips) 
Seat 4: Tom1999 ($15 in chips) 
Seat 5: Anafim ($12.50 in chips) 
Seat 6: NastyMcNast ($25 in chips) 
Seat 7: chiyuki ($41.45 in chips) 
Seat 8: giorgos_k ($15.91 in chips) 
Seat 9: Csabee21 ($26.38 in chips) 
ygoegoe: posts small blind $0.10
Dejacob: posts big blind $0.25
*** HOLE CARDS ***
Dealt to chiyuki [Ts Ac]
Tom1999: folds 
Anafim: folds 
NastyMcNast: folds 
chiyuki: raises $0.50 to $0.75
giorgos_k: calls $0.75
Csabee21: folds 
Loholov: folds 
ygoegoe: folds 
Dejacob: folds 
*** FLOP *** [Js 7h 6c]
chiyuki: checks 
giorgos_k: checks 
*** TURN *** [Js 7h 6c] [5s]
chiyuki: checks 
giorgos_k: checks 
*** RIVER *** [Js 7h 6c 5s] [Qc]
chiyuki: bets $0.88
giorgos_k: folds 
Uncalled bet ($0.88) returned to chiyuki
chiyuki collected $1.77 from pot
chiyuki: doesn't show hand 
*** SUMMARY ***
Total pot $1.85 | Rake $0.08 
Board [Js 7h 6c 5s Qc]
Seat 1: Loholov (button) folded before Flop (didn't bet)
Seat 2: ygoegoe (small blind) folded before Flop
Seat 3: Dejacob (big blind) folded before Flop
Seat 4: Tom1999 folded before Flop (didn't bet)
Seat 5: Anafim folded before Flop (didn't bet)
Seat 6: NastyMcNast folded before Flop (didn't bet)
Seat 7: chiyuki collected ($1.77)
Seat 8: giorgos_k folded on the River
Seat 9: Csabee21 folded before Flop (didn't bet)



PokerStars Zoom Hand #84299124396:  Hold'em No Limit ($0.10/$0.25) - 2012/08/05 13:58:13 JST [2012/08/05 0:58:13 ET]
Table 'Whirlpool' 9-max Seat #1 is the button
Seat 1: wtu1986 ($25 in chips) 
Seat 2: chiyuki ($42.47 in chips) 
Seat 3: ChrisCDee ($25.19 in chips) 
Seat 4: fwani ($42.44 in chips) 
Seat 5: KeLevro0 ($9.53 in chips) 
Seat 6: Lasutchik ($7.98 in chips) 
Seat 7: kamikkaze ($11.80 in chips) 
Seat 8: hirozo ($30.65 in chips) 
Seat 9: Th3Fog ($77.02 in chips) 
chiyuki: posts small blind $0.10
ChrisCDee: posts big blind $0.25
*** HOLE CARDS ***
Dealt to chiyuki [Qh 4s]
fwani: folds 
KeLevro0: folds 
Lasutchik: folds 
kamikkaze: folds 
hirozo: folds 
Th3Fog: folds 
wtu1986: folds 
chiyuki: folds 
Uncalled bet ($0.15) returned to ChrisCDee
ChrisCDee collected $0.20 from pot
ChrisCDee: doesn't show hand 
*** SUMMARY ***
Total pot $0.20 | Rake $0 
Seat 1: wtu1986 (button) folded before Flop (didn't bet)
Seat 2: chiyuki (small blind) folded before Flop
Seat 3: ChrisCDee (big blind) collected ($0.20)
Seat 4: fwani folded before Flop (didn't bet)
Seat 5: KeLevro0 folded before Flop (didn't bet)
Seat 6: Lasutchik folded before Flop (didn't bet)
Seat 7: kamikkaze folded before Flop (didn't bet)
Seat 8: hirozo folded before Flop (didn't bet)
Seat 9: Th3Fog folded before Flop (didn't bet)



PokerStars Zoom Hand #84299121739:  Hold'em No Limit ($0.10/$0.25) - 2012/08/05 13:58:00 JST [2012/08/05 0:58:00 ET]
Table 'Whirlpool' 9-max Seat #1 is the button
Seat 1: timburonps ($44.36 in chips) 
Seat 2: Suhoff76 ($37.96 in chips) 
Seat 3: deadmoneykid ($24.05 in chips) 
Seat 4: Déculotter69 ($19.10 in chips) 
Seat 5: Loholov ($20.65 in chips) 
Seat 6: kamikkaze ($14.30 in chips) 
Seat 7: seula i ($65.52 in chips) 
Seat 8: chiyuki ($42.47 in chips) 
Seat 9: D@vidMed ($52.09 in chips) 
Suhoff76: posts small blind $0.10
deadmoneykid: posts big blind $0.25
*** HOLE CARDS ***
Dealt to chiyuki [Qc Th]
Déculotter69: folds 
Loholov: folds 
kamikkaze: folds 
seula i: folds 
chiyuki: folds 
D@vidMed: folds 
timburonps: folds 
Suhoff76: raises $0.35 to $0.60
deadmoneykid: calls $0.35
*** FLOP *** [8c 2d Kc]
Suhoff76: bets $0.75
deadmoneykid: calls $0.75
*** TURN *** [8c 2d Kc] [8s]
Suhoff76: checks 
deadmoneykid: bets $1.50
Suhoff76: calls $1.50
*** RIVER *** [8c 2d Kc 8s] [3d]
Suhoff76: checks 
deadmoneykid: checks 
*** SHOW DOWN ***
Suhoff76: shows [Kd Jd] (two pair, Kings and Eights)
deadmoneykid: mucks hand 
Suhoff76 collected $5.44 from pot
*** SUMMARY ***
Total pot $5.70 | Rake $0.26 
Board [8c 2d Kc 8s 3d]
Seat 1: timburonps (button) folded before Flop (didn't bet)
Seat 2: Suhoff76 (small blind) showed [Kd Jd] and won ($5.44) with two pair, Kings and Eights
Seat 3: deadmoneykid (big blind) mucked [As Js]
Seat 4: Déculotter69 folded before Flop (didn't bet)
Seat 5: Loholov folded before Flop (didn't bet)
Seat 6: kamikkaze folded before Flop (didn't bet)
Seat 7: seula i folded before Flop (didn't bet)
Seat 8: chiyuki folded before Flop (didn't bet)
Seat 9: D@vidMed folded before Flop (didn't bet)



PokerStars Zoom Hand #84299122957:  Hold'em No Limit ($0.10/$0.25) - 2012/08/05 13:58:06 JST [2012/08/05 0:58:06 ET]
Table 'Whirlpool' 9-max Seat #1 is the button
Seat 1: chiyuki ($42.47 in chips) 
Seat 2: Dafleche ($15.04 in chips) 
Seat 3: 2997qwer ($11.80 in chips) 
Seat 4: Suhoff76 ($41.73 in chips) 
Seat 5: softdesign ($75.53 in chips) 
Seat 6: timburonps ($28.37 in chips) 
Seat 7: KeLevro0 ($13.53 in chips) 
Seat 8: slapshot2011 ($20.47 in chips) 
Seat 9: agurio ($27.20 in chips) 
Dafleche: posts small blind $0.10
2997qwer: posts big blind $0.25
*** HOLE CARDS ***
Dealt to chiyuki [3s Ah]
Suhoff76: folds 
softdesign: folds 
timburonps: folds 
KeLevro0: folds 
slapshot2011: calls $0.25
agurio: folds 
chiyuki: folds 
Dafleche: folds 
2997qwer: checks 
*** FLOP *** [4d 4c Ad]
2997qwer: checks 
slapshot2011: bets $0.50
2997qwer: folds 
Uncalled bet ($0.50) returned to slapshot2011
slapshot2011 collected $0.57 from pot
slapshot2011: doesn't show hand 
*** SUMMARY ***
Total pot $0.60 | Rake $0.03 
Board [4d 4c Ad]
Seat 1: chiyuki (button) folded before Flop (didn't bet)
Seat 2: Dafleche (small blind) folded before Flop
Seat 3: 2997qwer (big blind) folded on the Flop
Seat 4: Suhoff76 folded before Flop (didn't bet)
Seat 5: softdesign folded before Flop (didn't bet)
Seat 6: timburonps folded before Flop (didn't bet)
Seat 7: KeLevro0 folded before Flop (didn't bet)
Seat 8: slapshot2011 collected ($0.57)
Seat 9: agurio folded before Flop (didn't bet)



PokerStars Zoom Hand #84299127274:  Hold'em No Limit ($0.10/$0.25) - 2012/08/05 13:58:27 JST [2012/08/05 0:58:27 ET]
Table 'Whirlpool' 9-max Seat #1 is the button
Seat 1: 123progress ($30.60 in chips) 
Seat 2: solawind ($13.57 in chips) 
Seat 3: MrJarte ($25 in chips) 
Seat 4: D@vidMed ($52.09 in chips) 
Seat 5: chiyuki ($42.37 in chips) 
Seat 6: Th3Fog ($21.29 in chips) 
Seat 7: timburonps ($39.88 in chips) 
Seat 8: RikkStroken ($9.76 in chips) 
Seat 9: americoluz ($25.35 in chips) 
solawind: posts small blind $0.10
MrJarte: posts big blind $0.25
*** HOLE CARDS ***
Dealt to chiyuki [4s Ad]
D@vidMed: folds 
chiyuki: folds 
Th3Fog: folds 
timburonps: folds 
RikkStroken: folds 
americoluz: folds 
123progress: raises $0.37 to $0.62
solawind: folds 
MrJarte: folds 
Uncalled bet ($0.37) returned to 123progress
123progress collected $0.60 from pot
123progress: doesn't show hand 
*** SUMMARY ***
Total pot $0.60 | Rake $0 
Seat 1: 123progress (button) collected ($0.60)
Seat 2: solawind (small blind) folded before Flop
Seat 3: MrJarte (big blind) folded before Flop
Seat 4: D@vidMed folded before Flop (didn't bet)
Seat 5: chiyuki folded before Flop (didn't bet)
Seat 6: Th3Fog folded before Flop (didn't bet)
Seat 7: timburonps folded before Flop (didn't bet)
Seat 8: RikkStroken folded before Flop (didn't bet)
Seat 9: americoluz folded before Flop (didn't bet)



PokerStars Zoom Hand #84299131043:  Hold'em No Limit ($0.10/$0.25) - 2012/08/05 13:58:45 JST [2012/08/05 0:58:45 ET]
Table 'Whirlpool' 9-max Seat #1 is the button
Seat 1: BlOnDhOlIc ($57.10 in chips) 
Seat 2: Roglus ($19.78 in chips) 
Seat 3: chiyuki ($42.37 in chips) 
Seat 4: 2997qwer ($9.55 in chips) 
Seat 5: Lasutchik ($7.73 in chips) 
Seat 6: flyinprits ($44.07 in chips) 
Seat 7: hirozo ($28.27 in chips) 
Seat 8: KeLevro0 ($13.18 in chips) 
Seat 9: RikkStroken ($15 in chips) 
Roglus: posts small blind $0.10
chiyuki: posts big blind $0.25
*** HOLE CARDS ***
Dealt to chiyuki [9d 8d]
2997qwer: folds 
Lasutchik: folds 
flyinprits: folds 
hirozo: folds 
KeLevro0: folds 
RikkStroken: folds 
BlOnDhOlIc: folds 
Roglus: folds 
Uncalled bet ($0.15) returned to chiyuki
chiyuki collected $0.20 from pot
chiyuki: doesn't show hand 
*** SUMMARY ***
Total pot $0.20 | Rake $0 
Seat 1: BlOnDhOlIc (button) folded before Flop (didn't bet)
Seat 2: Roglus (small blind) folded before Flop
Seat 3: chiyuki (big blind) collected ($0.20)
Seat 4: 2997qwer folded before Flop (didn't bet)
Seat 5: Lasutchik folded before Flop (didn't bet)
Seat 6: flyinprits folded before Flop (didn't bet)
Seat 7: hirozo folded before Flop (didn't bet)
Seat 8: KeLevro0 folded before Flop (didn't bet)
Seat 9: RikkStroken folded before Flop (didn't bet)



PokerStars Zoom Hand #84299129553:  Hold'em No Limit ($0.10/$0.25) - 2012/08/05 13:58:38 JST [2012/08/05 0:58:38 ET]
Table 'Whirlpool' 9-max Seat #1 is the button
Seat 1: Dejacob ($47.88 in chips) 
Seat 2: fwani ($31.09 in chips) 
Seat 3: Suhoff76 ($52.04 in chips) 
Seat 4: chiyuki ($42.37 in chips) 
Seat 5: Landybob ($34.65 in chips) 
Seat 6: KeLevro0 ($12.15 in chips) 
Seat 7: deadmoneykid ($28.14 in chips) 
Seat 8: ll_LaMeR_ll ($74.56 in chips) 
Seat 9: ladymadon107 ($9.41 in chips) 
fwani: posts small blind $0.10
Suhoff76: posts big blind $0.25
*** HOLE CARDS ***
Dealt to chiyuki [Th 2d]
chiyuki: folds 
Landybob: raises $0.50 to $0.75
KeLevro0: folds 
deadmoneykid: folds 
ll_LaMeR_ll: folds 
ladymadon107: folds 
Dejacob: folds 
fwani: folds 
Suhoff76: folds 
Uncalled bet ($0.50) returned to Landybob
Landybob collected $0.60 from pot
Landybob: doesn't show hand 
*** SUMMARY ***
Total pot $0.60 | Rake $0 
Seat 1: Dejacob (button) folded before Flop (didn't bet)
Seat 2: fwani (small blind) folded before Flop
Seat 3: Suhoff76 (big blind) folded before Flop
Seat 4: chiyuki folded before Flop (didn't bet)
Seat 5: Landybob collected ($0.60)
Seat 6: KeLevro0 folded before Flop (didn't bet)
Seat 7: deadmoneykid folded before Flop (didn't bet)
Seat 8: ll_LaMeR_ll folded before Flop (didn't bet)
Seat 9: ladymadon107 folded before Flop (didn't bet)



PokerStars Zoom Hand #84299128341:  Hold'em No Limit ($0.10/$0.25) - 2012/08/05 13:58:32 JST [2012/08/05 0:58:32 ET]
Table 'Whirlpool' 9-max Seat #1 is the button
Seat 1: americoluz ($25.35 in chips) 
Seat 2: wtu1986 ($25 in chips) 
Seat 3: kamikkaze ($11.80 in chips) 
Seat 4: solawind ($13.47 in chips) 
Seat 5: Ellen1947 ($37.73 in chips) 
Seat 6: chiyuki ($42.37 in chips) 
Seat 7: Faraz ($29.54 in chips) 
Seat 8: Th3Fog ($77.02 in chips) 
Seat 9: ygoegoe ($28.89 in chips) 
wtu1986: posts small blind $0.10
kamikkaze: posts big blind $0.25
*** HOLE CARDS ***
Dealt to chiyuki [9c 3s]
solawind: folds 
Ellen1947: folds 
chiyuki: folds 
Faraz: folds 
Th3Fog: raises $0.47 to $0.72
ygoegoe: folds 
americoluz: folds 
wtu1986: folds 
kamikkaze: folds 
Uncalled bet ($0.47) returned to Th3Fog
Th3Fog collected $0.60 from pot
Th3Fog: doesn't show hand 
*** SUMMARY ***
Total pot $0.60 | Rake $0 
Seat 1: americoluz (button) folded before Flop (didn't bet)
Seat 2: wtu1986 (small blind) folded before Flop
Seat 3: kamikkaze (big blind) folded before Flop
Seat 4: solawind folded before Flop (didn't bet)
Seat 5: Ellen1947 folded before Flop (didn't bet)
Seat 6: chiyuki folded before Flop (didn't bet)
Seat 7: Faraz folded before Flop (didn't bet)
Seat 8: Th3Fog collected ($0.60)
Seat 9: ygoegoe folded before Flop (didn't bet)



PokerStars Zoom Hand #84299126036:  Hold'em No Limit ($0.10/$0.25) - 2012/08/05 13:58:21 JST [2012/08/05 0:58:21 ET]
Table 'Whirlpool' 9-max Seat #1 is the button
Seat 1: solawind ($13.57 in chips) 
Seat 2: hirozo ($30.65 in chips) 
Seat 3: Dejacob ($48.13 in chips) 
Seat 4: Suhoff76 ($52.14 in chips) 
Seat 5: Nerkit ($11.40 in chips) 
Seat 6: Loholov ($19.20 in chips) 
Seat 7: chiyuki ($42.37 in chips) 
Seat 8: Noviekid ($23.23 in chips) 
Seat 9: KeLevro0 ($12.15 in chips) 
hirozo: posts small blind $0.10
Dejacob: posts big blind $0.25
*** HOLE CARDS ***
Dealt to chiyuki [Ad 3d]
Suhoff76: folds 
Nerkit: raises $0.50 to $0.75
Loholov: folds 
chiyuki: folds 
Noviekid: calls $0.75
KeLevro0: folds 
solawind: folds 
hirozo: folds 
Dejacob: folds 
*** FLOP *** [Jh 3s Tc]
Nerkit: bets $1.05
Noviekid: raises $1.70 to $2.75
Nerkit: calls $1.70
*** TURN *** [Jh 3s Tc] [2h]
Nerkit: checks 
Noviekid: bets $4.75
Nerkit: raises $3.15 to $7.90 and is all-in
Noviekid: calls $3.15
*** RIVER *** [Jh 3s Tc 2h] [9c]
*** SHOW DOWN ***
Nerkit: shows [As Js] (a pair of Jacks)
Noviekid: shows [Jc Td] (two pair, Jacks and Tens)
Noviekid collected $22.11 from pot
*** SUMMARY ***
Total pot $23.15 | Rake $1.04 
Board [Jh 3s Tc 2h 9c]
Seat 1: solawind (button) folded before Flop (didn't bet)
Seat 2: hirozo (small blind) folded before Flop
Seat 3: Dejacob (big blind) folded before Flop
Seat 4: Suhoff76 folded before Flop (didn't bet)
Seat 5: Nerkit showed [As Js] and lost with a pair of Jacks
Seat 6: Loholov folded before Flop (didn't bet)
Seat 7: chiyuki folded before Flop (didn't bet)
Seat 8: Noviekid showed [Jc Td] and won ($22.11) with two pair, Jacks and Tens
Seat 9: KeLevro0 folded before Flop (didn't bet)



PokerStars Zoom Hand #84299133054:  Hold'em No Limit ($0.10/$0.25) - 2012/08/05 13:58:55 JST [2012/08/05 0:58:55 ET]
Table 'Whirlpool' 9-max Seat #1 is the button
Seat 1: chiyuki ($42.47 in chips) 
Seat 2: wtu1986 ($25 in chips) 
Seat 3: hirozo ($28.27 in chips) 
Seat 4: cR!Ma*aRm ($12.33 in chips) 
Seat 5: BlOnDhOlIc ($57.10 in chips) 
Seat 6: mariuka1 ($9.37 in chips) 
Seat 7: seula i ($25 in chips) 
Seat 8: Loholov ($15 in chips) 
Seat 9: KeLevro0 ($13.18 in chips) 
wtu1986: posts small blind $0.10
hirozo: posts big blind $0.25
*** HOLE CARDS ***
Dealt to chiyuki [7s Qs]
cR!Ma*aRm: raises $0.75 to $1
BlOnDhOlIc: folds 
mariuka1: folds 
seula i: folds 
Loholov: folds 
KeLevro0: folds 
chiyuki: folds 
wtu1986: folds 
hirozo: folds 
Uncalled bet ($0.75) returned to cR!Ma*aRm
cR!Ma*aRm collected $0.60 from pot
cR!Ma*aRm: doesn't show hand 
*** SUMMARY ***
Total pot $0.60 | Rake $0 
Seat 1: chiyuki (button) folded before Flop (didn't bet)
Seat 2: wtu1986 (small blind) folded before Flop
Seat 3: hirozo (big blind) folded before Flop
Seat 4: cR!Ma*aRm collected ($0.60)
Seat 5: BlOnDhOlIc folded before Flop (didn't bet)
Seat 6: mariuka1 folded before Flop (didn't bet)
Seat 7: seula i folded before Flop (didn't bet)
Seat 8: Loholov folded before Flop (didn't bet)
Seat 9: KeLevro0 folded before Flop (didn't bet)



PokerStars Zoom Hand #84299135275:  Hold'em No Limit ($0.10/$0.25) - 2012/08/05 13:59:07 JST [2012/08/05 0:59:07 ET]
Table 'Whirlpool' 9-max Seat #1 is the button
Seat 1: solawind ($13.47 in chips) 
Seat 2: chiyuki ($42.47 in chips) 
Seat 3: Dafleche ($14.94 in chips) 
Seat 4: taksist889 ($14.25 in chips) 
Seat 5: ygoegoe ($38.78 in chips) 
Seat 6: jeff0923 ($18.59 in chips) 
Seat 7: mariuka1 ($9.37 in chips) 
Seat 8: KeLevro0 ($9.53 in chips) 
Seat 9: PetitAlejo ($36.12 in chips) 
chiyuki: posts small blind $0.10
Dafleche: posts big blind $0.25
*** HOLE CARDS ***
Dealt to chiyuki [Qc 9s]
taksist889: folds 
ygoegoe: folds 
jeff0923: folds 
mariuka1: folds 
KeLevro0: raises $0.42 to $0.67
PetitAlejo: folds 
solawind: folds 
chiyuki: folds 
Dafleche: folds 
Uncalled bet ($0.42) returned to KeLevro0
KeLevro0 collected $0.60 from pot
KeLevro0: doesn't show hand 
*** SUMMARY ***
Total pot $0.60 | Rake $0 
Seat 1: solawind (button) folded before Flop (didn't bet)
Seat 2: chiyuki (small blind) folded before Flop
Seat 3: Dafleche (big blind) folded before Flop
Seat 4: taksist889 folded before Flop (didn't bet)
Seat 5: ygoegoe folded before Flop (didn't bet)
Seat 6: jeff0923 folded before Flop (didn't bet)
Seat 7: mariuka1 folded before Flop (didn't bet)
Seat 8: KeLevro0 collected ($0.60)
Seat 9: PetitAlejo folded before Flop (didn't bet)



PokerStars Zoom Hand #84299137928:  Hold'em No Limit ($0.10/$0.25) - 2012/08/05 13:59:20 JST [2012/08/05 0:59:20 ET]
Table 'Whirlpool' 9-max Seat #1 is the button
Seat 1: Faraz ($29.54 in chips) 
Seat 2: timburonps ($28.12 in chips) 
Seat 3: NastyMcNast ($27.53 in chips) 
Seat 4: Suhoff76 ($41.38 in chips) 
Seat 5: chiyuki ($42.37 in chips) 
Seat 6: Alvinpe85 ($37.23 in chips) 
Seat 7: KAKamiro ($42.72 in chips) 
Seat 8: Anafim ($15.20 in chips) 
Seat 9: ChrisCDee ($25.54 in chips) 
timburonps: posts small blind $0.10
NastyMcNast: posts big blind $0.25
*** HOLE CARDS ***
Dealt to chiyuki [Ks 5s]
Suhoff76: folds 
chiyuki: folds 
Alvinpe85: folds 
KAKamiro: folds 
Anafim: folds 
ChrisCDee: folds 
Faraz: folds 
timburonps: folds 
Uncalled bet ($0.15) returned to NastyMcNast
NastyMcNast collected $0.20 from pot
NastyMcNast: doesn't show hand 
*** SUMMARY ***
Total pot $0.20 | Rake $0 
Seat 1: Faraz (button) folded before Flop (didn't bet)
Seat 2: timburonps (small blind) folded before Flop
Seat 3: NastyMcNast (big blind) collected ($0.20)
Seat 4: Suhoff76 folded before Flop (didn't bet)
Seat 5: chiyuki folded before Flop (didn't bet)
Seat 6: Alvinpe85 folded before Flop (didn't bet)
Seat 7: KAKamiro folded before Flop (didn't bet)
Seat 8: Anafim folded before Flop (didn't bet)
Seat 9: ChrisCDee folded before Flop (didn't bet)



PokerStars Zoom Hand #84299140000:  Hold'em No Limit ($0.10/$0.25) - 2012/08/05 13:59:30 JST [2012/08/05 0:59:30 ET]
Table 'Whirlpool' 9-max Seat #1 is the button
Seat 1: fwani ($31.09 in chips) 
Seat 2: Lasutchik ($33.24 in chips) 
Seat 3: seula i ($39.45 in chips) 
Seat 4: 2997qwer ($12.50 in chips) 
Seat 5: KeLevro0 ($13.08 in chips) 
Seat 6: BlackZafiro ($46.44 in chips) 
Seat 7: BlOnDhOlIc ($62.02 in chips) 
Seat 8: hirozo ($25.10 in chips) 
Seat 9: chiyuki ($42.37 in chips) 
Lasutchik: posts small blind $0.10
seula i: posts big blind $0.25
*** HOLE CARDS ***
Dealt to chiyuki [8c 3h]
2997qwer: folds 
KeLevro0: folds 
BlackZafiro: raises $0.50 to $0.75
BlOnDhOlIc: folds 
hirozo: raises $1.60 to $2.35
chiyuki: folds 
fwani: folds 
Lasutchik: folds 
seula i: folds 
BlackZafiro: folds 
Uncalled bet ($1.60) returned to hirozo
hirozo collected $1.85 from pot
hirozo: doesn't show hand 
*** SUMMARY ***
Total pot $1.85 | Rake $0 
Seat 1: fwani (button) folded before Flop (didn't bet)
Seat 2: Lasutchik (small blind) folded before Flop
Seat 3: seula i (big blind) folded before Flop
Seat 4: 2997qwer folded before Flop (didn't bet)
Seat 5: KeLevro0 folded before Flop (didn't bet)
Seat 6: BlackZafiro folded before Flop
Seat 7: BlOnDhOlIc folded before Flop (didn't bet)
Seat 8: hirozo collected ($1.85)
Seat 9: chiyuki folded before Flop (didn't bet)



PokerStars Zoom Hand #84299142765:  Hold'em No Limit ($0.10/$0.25) - 2012/08/05 13:59:44 JST [2012/08/05 0:59:44 ET]
Table 'Whirlpool' 9-max Seat #1 is the button
Seat 1: Alvinpe85 ($60.67 in chips) 
Seat 2: BlOnDhOlIc ($62.02 in chips) 
Seat 3: chiyuki ($42.37 in chips) 
Seat 4: kamikkaze ($19.55 in chips) 
Seat 5: agurio ($25.11 in chips) 
Seat 6: hirozo ($28.02 in chips) 
Seat 7: KeLevro0 ($13.50 in chips) 
Seat 8: seula i ($25.10 in chips) 
Seat 9: fwani ($31.09 in chips) 
BlOnDhOlIc: posts small blind $0.10
chiyuki: posts big blind $0.25
*** HOLE CARDS ***
Dealt to chiyuki [Jh 2c]
kamikkaze: folds 
agurio: folds 
hirozo: folds 
KeLevro0: folds 
seula i: folds 
fwani: raises $0.35 to $0.60
Alvinpe85: folds 
BlOnDhOlIc: folds 
chiyuki: folds 
Uncalled bet ($0.35) returned to fwani
fwani collected $0.60 from pot
fwani: doesn't show hand 
*** SUMMARY ***
Total pot $0.60 | Rake $0 
Seat 1: Alvinpe85 (button) folded before Flop (didn't bet)
Seat 2: BlOnDhOlIc (small blind) folded before Flop
Seat 3: chiyuki (big blind) folded before Flop
Seat 4: kamikkaze folded before Flop (didn't bet)
Seat 5: agurio folded before Flop (didn't bet)
Seat 6: hirozo folded before Flop (didn't bet)
Seat 7: KeLevro0 folded before Flop (didn't bet)
Seat 8: seula i folded before Flop (didn't bet)
Seat 9: fwani collected ($0.60)



PokerStars Zoom Hand #84299141771:  Hold'em No Limit ($0.10/$0.25) - 2012/08/05 13:59:39 JST [2012/08/05 0:59:39 ET]
Table 'Whirlpool' 9-max Seat #1 is the button
Seat 1: Paranoix1990 ($16.39 in chips) 
Seat 2: Alvinpe85 ($60.77 in chips) 
Seat 3: RikkStroken ($16.40 in chips) 
Seat 4: Anafim ($15.20 in chips) 
Seat 5: Suhoff76 ($40.85 in chips) 
Seat 6: NastyMcNast ($27.63 in chips) 
Seat 7: kamikkaze ($19.55 in chips) 
Seat 8: chiyuki ($42.37 in chips) 
Seat 9: munky3 ($33.52 in chips) 
Alvinpe85: posts small blind $0.10
RikkStroken: posts big blind $0.25
*** HOLE CARDS ***
Dealt to chiyuki [8d 7c]
Anafim: raises $0.25 to $0.50
Suhoff76: calls $0.50
NastyMcNast: folds 
kamikkaze: folds 
chiyuki: folds 
munky3: folds 
Paranoix1990: folds 
Alvinpe85: folds 
RikkStroken: folds 
*** FLOP *** [7d 4c 5c]
Anafim: checks 
Suhoff76: checks 
*** TURN *** [7d 4c 5c] [6d]
Anafim: checks 
Suhoff76: bets $0.85
Anafim: folds 
Uncalled bet ($0.85) returned to Suhoff76
Suhoff76 collected $1.29 from pot
Suhoff76: doesn't show hand 
*** SUMMARY ***
Total pot $1.35 | Rake $0.06 
Board [7d 4c 5c 6d]
Seat 1: Paranoix1990 (button) folded before Flop (didn't bet)
Seat 2: Alvinpe85 (small blind) folded before Flop
Seat 3: RikkStroken (big blind) folded before Flop
Seat 4: Anafim folded on the Turn
Seat 5: Suhoff76 collected ($1.29)
Seat 6: NastyMcNast folded before Flop (didn't bet)
Seat 7: kamikkaze folded before Flop (didn't bet)
Seat 8: chiyuki folded before Flop (didn't bet)
Seat 9: munky3 folded before Flop (didn't bet)



PokerStars Zoom Hand #84299138548:  Hold'em No Limit ($0.10/$0.25) - 2012/08/05 13:59:23 JST [2012/08/05 0:59:23 ET]
Table 'Whirlpool' 9-max Seat #1 is the button
Seat 1: Tom1999 ($10.25 in chips) 
Seat 2: sparky5224 ($6.45 in chips) 
Seat 3: BlackZafiro ($25 in chips) 
Seat 4: Loholov ($15 in chips) 
Seat 5: chiyuki ($42.37 in chips) 
Seat 6: Nerkit ($12.50 in chips) 
Seat 7: Noviekid ($33.94 in chips) 
Seat 8: BlOnDhOlIc ($49.48 in chips) 
Seat 9: fwani ($25.79 in chips) 
sparky5224: posts small blind $0.10
BlackZafiro: posts big blind $0.25
*** HOLE CARDS ***
Dealt to chiyuki [5s Qd]
Loholov: raises $0.75 to $1
chiyuki: folds 
Nerkit: folds 
Noviekid: calls $1
BlOnDhOlIc: calls $1
fwani: calls $1
Tom1999: folds 
sparky5224: calls $0.90
BlackZafiro: folds 
*** FLOP *** [2s 8c 7h]
sparky5224: checks 
Loholov: bets $3.75
Noviekid: calls $3.75
BlOnDhOlIc: folds 
fwani: calls $3.75
sparky5224: folds 
*** TURN *** [2s 8c 7h] [4s]
Loholov: bets $10.25 and is all-in
Noviekid: folds 
fwani: folds 
Uncalled bet ($10.25) returned to Loholov
Loholov collected $15.76 from pot
Loholov: doesn't show hand 
*** SUMMARY ***
Total pot $16.50 | Rake $0.74 
Board [2s 8c 7h 4s]
Seat 1: Tom1999 (button) folded before Flop (didn't bet)
Seat 2: sparky5224 (small blind) folded on the Flop
Seat 3: BlackZafiro (big blind) folded before Flop
Seat 4: Loholov collected ($15.76)
Seat 5: chiyuki folded before Flop (didn't bet)
Seat 6: Nerkit folded before Flop (didn't bet)
Seat 7: Noviekid folded on the Turn
Seat 8: BlOnDhOlIc folded on the Flop
Seat 9: fwani folded on the Turn



PokerStars Zoom Hand #84299147742:  Hold'em No Limit ($0.10/$0.25) - 2012/08/05 14:00:04 JST [2012/08/05 1:00:04 ET]
Table 'Whirlpool' 9-max Seat #1 is the button
Seat 1: Tom1999 ($18.61 in chips) 
Seat 2: Anafim ($12.50 in chips) 
Seat 3: 2997qwer ($9.10 in chips) 
Seat 4: 123progress ($39.28 in chips) 
Seat 5: BlOnDhOlIc ($61.92 in chips) 
Seat 6: agurio ($25.11 in chips) 
Seat 7: chiyuki ($42.12 in chips) 
Seat 8: seula i ($25 in chips) 
Seat 9: sparky5224 ($5.45 in chips) 
Anafim: posts small blind $0.10
2997qwer: posts big blind $0.25
*** HOLE CARDS ***
Dealt to chiyuki [6h Ad]
123progress: folds 
BlOnDhOlIc: folds 
agurio: folds 
chiyuki: folds 
seula i: folds 
sparky5224: folds 
Tom1999: folds 
Anafim: folds 
Uncalled bet ($0.15) returned to 2997qwer
2997qwer collected $0.20 from pot
2997qwer: doesn't show hand 
*** SUMMARY ***
Total pot $0.20 | Rake $0 
Seat 1: Tom1999 (button) folded before Flop (didn't bet)
Seat 2: Anafim (small blind) folded before Flop
Seat 3: 2997qwer (big blind) collected ($0.20)
Seat 4: 123progress folded before Flop (didn't bet)
Seat 5: BlOnDhOlIc folded before Flop (didn't bet)
Seat 6: agurio folded before Flop (didn't bet)
Seat 7: chiyuki folded before Flop (didn't bet)
Seat 8: seula i folded before Flop (didn't bet)
Seat 9: sparky5224 folded before Flop (didn't bet)



PokerStars Zoom Hand #84299149824:  Hold'em No Limit ($0.10/$0.25) - 2012/08/05 14:00:14 JST [2012/08/05 1:00:14 ET]
Table 'Whirlpool' 9-max Seat #1 is the button
Seat 1: Anafim ($12.50 in chips) 
Seat 2: fezman ($18.28 in chips) 
Seat 3: RikkStroken ($15 in chips) 
Seat 4: chiyuki ($42.12 in chips) 
Seat 5: BlOnDhOlIc ($25.71 in chips) 
Seat 6: puffy5533 ($21.60 in chips) 
Seat 7: D@vidMed ($52.44 in chips) 
Seat 8: wtu1986 ($25.25 in chips) 
Seat 9: Landybob ($36.54 in chips) 
fezman: posts small blind $0.10
RikkStroken: posts big blind $0.25
*** HOLE CARDS ***
Dealt to chiyuki [2d Td]
chiyuki: folds 
BlOnDhOlIc: folds 
puffy5533: folds 
D@vidMed: raises $0.57 to $0.82
wtu1986: folds 
Landybob: folds 
Anafim: folds 
fezman: folds 
RikkStroken: folds 
Uncalled bet ($0.57) returned to D@vidMed
D@vidMed collected $0.60 from pot
D@vidMed: doesn't show hand 
*** SUMMARY ***
Total pot $0.60 | Rake $0 
Seat 1: Anafim (button) folded before Flop (didn't bet)
Seat 2: fezman (small blind) folded before Flop
Seat 3: RikkStroken (big blind) folded before Flop
Seat 4: chiyuki folded before Flop (didn't bet)
Seat 5: BlOnDhOlIc folded before Flop (didn't bet)
Seat 6: puffy5533 folded before Flop (didn't bet)
Seat 7: D@vidMed collected ($0.60)
Seat 8: wtu1986 folded before Flop (didn't bet)
Seat 9: Landybob folded before Flop (didn't bet)



PokerStars Zoom Hand #84299152241:  Hold'em No Limit ($0.10/$0.25) - 2012/08/05 14:00:25 JST [2012/08/05 1:00:25 ET]
Table 'Whirlpool' 9-max Seat #1 is the button
Seat 1: jeff0923 ($24.42 in chips) 
Seat 2: 123progress ($39.03 in chips) 
Seat 3: wtu1986 ($25.80 in chips) 
Seat 4: Paranoix1990 ($16.39 in chips) 
Seat 5: silvno31 ($44.19 in chips) 
Seat 6: chiyuki ($42.12 in chips) 
Seat 7: PetitAlejo ($28.27 in chips) 
Seat 8: fwani ($25 in chips) 
Seat 9: fezman ($18.18 in chips) 
123progress: posts small blind $0.10
wtu1986: posts big blind $0.25
*** HOLE CARDS ***
Dealt to chiyuki [7d Kd]
Paranoix1990: raises $0.25 to $0.50
silvno31: folds 
chiyuki: folds 
PetitAlejo: folds 
fwani: folds 
fezman: folds 
jeff0923: folds 
123progress: folds 
wtu1986: folds 
Uncalled bet ($0.25) returned to Paranoix1990
Paranoix1990 collected $0.60 from pot
Paranoix1990: doesn't show hand 
*** SUMMARY ***
Total pot $0.60 | Rake $0 
Seat 1: jeff0923 (button) folded before Flop (didn't bet)
Seat 2: 123progress (small blind) folded before Flop
Seat 3: wtu1986 (big blind) folded before Flop
Seat 4: Paranoix1990 collected ($0.60)
Seat 5: silvno31 folded before Flop (didn't bet)
Seat 6: chiyuki folded before Flop (didn't bet)
Seat 7: PetitAlejo folded before Flop (didn't bet)
Seat 8: fwani folded before Flop (didn't bet)
Seat 9: fezman folded before Flop (didn't bet)



PokerStars Zoom Hand #84299151154:  Hold'em No Limit ($0.10/$0.25) - 2012/08/05 14:00:20 JST [2012/08/05 1:00:20 ET]
Table 'Whirlpool' 9-max Seat #1 is the button
Seat 1: 2997qwer ($9.20 in chips) 
Seat 2: Dejacob ($28.40 in chips) 
Seat 3: Th3Fog ($77.12 in chips) 
Seat 4: kamikkaze ($19.45 in chips) 
Seat 5: ChrisCDee ($25.54 in chips) 
Seat 6: silvno31 ($44.19 in chips) 
Seat 7: KeLevro0 ($13.18 in chips) 
Seat 8: Alvinpe85 ($60.67 in chips) 
Seat 9: chiyuki ($42.12 in chips) 
Dejacob: posts small blind $0.10
Th3Fog: posts big blind $0.25
*** HOLE CARDS ***
Dealt to chiyuki [Qh 6d]
kamikkaze: folds 
ChrisCDee: folds 
silvno31: folds 
KeLevro0: folds 
Alvinpe85: folds 
chiyuki: folds 
2997qwer: raises $0.50 to $0.75
Dejacob: folds 
Th3Fog: folds 
Uncalled bet ($0.50) returned to 2997qwer
2997qwer collected $0.60 from pot
2997qwer: doesn't show hand 
*** SUMMARY ***
Total pot $0.60 | Rake $0 
Seat 1: 2997qwer (button) collected ($0.60)
Seat 2: Dejacob (small blind) folded before Flop
Seat 3: Th3Fog (big blind) folded before Flop
Seat 4: kamikkaze folded before Flop (didn't bet)
Seat 5: ChrisCDee folded before Flop (didn't bet)
Seat 6: silvno31 folded before Flop (didn't bet)
Seat 7: KeLevro0 folded before Flop (didn't bet)
Seat 8: Alvinpe85 folded before Flop (didn't bet)
Seat 9: chiyuki folded before Flop (didn't bet)



PokerStars Zoom Hand #84299154699:  Hold'em No Limit ($0.10/$0.25) - 2012/08/05 14:00:36 JST [2012/08/05 1:00:36 ET]
Table 'Whirlpool' 9-max Seat #1 is the button
Seat 1: chiyuki ($42.12 in chips) 
Seat 2: PetitAlejo ($35.72 in chips) 
Seat 3: Nec Arg ($25 in chips) 
Seat 4: Nerkit ($8.85 in chips) 
Seat 5: ygoegoe ($35.91 in chips) 
Seat 6: jeff0923 ($24.42 in chips) 
Seat 7: fwani ($25 in chips) 
Seat 8: D@vidMed ($52.79 in chips) 
Seat 9: flyinprits ($46.64 in chips) 
PetitAlejo: posts small blind $0.10
Nec Arg: posts big blind $0.25
*** HOLE CARDS ***
Dealt to chiyuki [4d Jc]
Nerkit: folds 
ygoegoe: folds 
jeff0923: folds 
fwani: folds 
D@vidMed: folds 
flyinprits: folds 
chiyuki: folds 
PetitAlejo: folds 
Uncalled bet ($0.15) returned to Nec Arg
Nec Arg collected $0.20 from pot
Nec Arg: doesn't show hand 
*** SUMMARY ***
Total pot $0.20 | Rake $0 
Seat 1: chiyuki (button) folded before Flop (didn't bet)
Seat 2: PetitAlejo (small blind) folded before Flop
Seat 3: Nec Arg (big blind) collected ($0.20)
Seat 4: Nerkit folded before Flop (didn't bet)
Seat 5: ygoegoe folded before Flop (didn't bet)
Seat 6: jeff0923 folded before Flop (didn't bet)
Seat 7: fwani folded before Flop (didn't bet)
Seat 8: D@vidMed folded before Flop (didn't bet)
Seat 9: flyinprits folded before Flop (didn't bet)



PokerStars Zoom Hand #84299156299:  Hold'em No Limit ($0.10/$0.25) - 2012/08/05 14:00:43 JST [2012/08/05 1:00:43 ET]
Table 'Whirlpool' 9-max Seat #1 is the button
Seat 1: Suhoff76 ($40.64 in chips) 
Seat 2: puffy5533 ($21.60 in chips) 
Seat 3: Perstenev ($13 in chips) 
Seat 4: Dejacob ($28.30 in chips) 
Seat 5: Roglus ($18.31 in chips) 
Seat 6: PetitAlejo ($28.27 in chips) 
Seat 7: Ellen1947 ($38.78 in chips) 
Seat 8: chiyuki ($42.02 in chips) 
Seat 9: Tom1999 ($10.25 in chips) 
puffy5533: posts small blind $0.10
Perstenev: posts big blind $0.25
*** HOLE CARDS ***
Dealt to chiyuki [2c Ks]
Dejacob: folds 
Roglus: folds 
PetitAlejo: folds 
Ellen1947: raises $0.50 to $0.75
chiyuki: folds 
Tom1999: folds 
Suhoff76: folds 
puffy5533: raises $1.75 to $2.50
Perstenev: folds 
Ellen1947: folds 
Uncalled bet ($1.75) returned to puffy5533
puffy5533 collected $1.75 from pot
puffy5533: doesn't show hand 
*** SUMMARY ***
Total pot $1.75 | Rake $0 
Seat 1: Suhoff76 (button) folded before Flop (didn't bet)
Seat 2: puffy5533 (small blind) collected ($1.75)
Seat 3: Perstenev (big blind) folded before Flop
Seat 4: Dejacob folded before Flop (didn't bet)
Seat 5: Roglus folded before Flop (didn't bet)
Seat 6: PetitAlejo folded before Flop (didn't bet)
Seat 7: Ellen1947 folded before Flop
Seat 8: chiyuki folded before Flop (didn't bet)
Seat 9: Tom1999 folded before Flop (didn't bet)



PokerStars Zoom Hand #84299155580:  Hold'em No Limit ($0.10/$0.25) - 2012/08/05 14:00:40 JST [2012/08/05 1:00:40 ET]
Table 'Whirlpool' 9-max Seat #1 is the button
Seat 1: BlOnDhOlIc ($48.48 in chips) 
Seat 2: chiyuki ($42.12 in chips) 
Seat 3: Paranoix1990 ($16.74 in chips) 
Seat 4: hirozo ($30.40 in chips) 
Seat 5: 2997qwer ($9.55 in chips) 
Seat 6: D@vidMed ($52.79 in chips) 
Seat 7: wtu1986 ($25.55 in chips) 
Seat 8: Anafim ($12.50 in chips) 
Seat 9: Faraz ($29.54 in chips) 
chiyuki: posts small blind $0.10
Paranoix1990: posts big blind $0.25
*** HOLE CARDS ***
Dealt to chiyuki [7s Jc]
hirozo: folds 
2997qwer: folds 
D@vidMed: folds 
wtu1986: folds 
Anafim: folds 
Faraz: raises $0.50 to $0.75
BlOnDhOlIc: folds 
chiyuki: folds 
Paranoix1990: calls $0.50
*** FLOP *** [3h 8s Td]
Paranoix1990: checks 
Faraz: bets $0.75
Paranoix1990: folds 
Uncalled bet ($0.75) returned to Faraz
Faraz collected $1.53 from pot
Faraz: doesn't show hand 
*** SUMMARY ***
Total pot $1.60 | Rake $0.07 
Board [3h 8s Td]
Seat 1: BlOnDhOlIc (button) folded before Flop (didn't bet)
Seat 2: chiyuki (small blind) folded before Flop
Seat 3: Paranoix1990 (big blind) folded on the Flop
Seat 4: hirozo folded before Flop (didn't bet)
Seat 5: 2997qwer folded before Flop (didn't bet)
Seat 6: D@vidMed folded before Flop (didn't bet)
Seat 7: wtu1986 folded before Flop (didn't bet)
Seat 8: Anafim folded before Flop (didn't bet)
Seat 9: Faraz collected ($1.53)



PokerStars Zoom Hand #84299160568:  Hold'em No Limit ($0.10/$0.25) - 2012/08/05 14:01:01 JST [2012/08/05 1:01:01 ET]
Table 'Whirlpool' 9-max Seat #1 is the button
Seat 1: kamikkaze ($19.20 in chips) 
Seat 2: Perstenev ($12.75 in chips) 
Seat 3: PetitAlejo ($28.27 in chips) 
Seat 4: RomarioJa ($6.40 in chips) 
Seat 5: flyinprits ($46.64 in chips) 
Seat 6: chiyuki ($42.02 in chips) 
Seat 7: agurio ($27.20 in chips) 
Seat 8: softdesign ($75.42 in chips) 
Seat 9: Nerkit ($12.01 in chips) 
Perstenev: posts small blind $0.10
PetitAlejo: posts big blind $0.25
*** HOLE CARDS ***
Dealt to chiyuki [Kd 2h]
RomarioJa: folds 
flyinprits: folds 
chiyuki: folds 
agurio: folds 
softdesign: raises $0.50 to $0.75
Nerkit: folds 
kamikkaze: folds 
Perstenev: folds 
PetitAlejo: folds 
Uncalled bet ($0.50) returned to softdesign
softdesign collected $0.60 from pot
softdesign: doesn't show hand 
*** SUMMARY ***
Total pot $0.60 | Rake $0 
Seat 1: kamikkaze (button) folded before Flop (didn't bet)
Seat 2: Perstenev (small blind) folded before Flop
Seat 3: PetitAlejo (big blind) folded before Flop
Seat 4: RomarioJa folded before Flop (didn't bet)
Seat 5: flyinprits folded before Flop (didn't bet)
Seat 6: chiyuki folded before Flop (didn't bet)
Seat 7: agurio folded before Flop (didn't bet)
Seat 8: softdesign collected ($0.60)
Seat 9: Nerkit folded before Flop (didn't bet)



PokerStars Zoom Hand #84299163292:  Hold'em No Limit ($0.10/$0.25) - 2012/08/05 14:01:12 JST [2012/08/05 1:01:12 ET]
Table 'Whirlpool' 9-max Seat #1 is the button
Seat 1: Paranoix1990 ($15.89 in chips) 
Seat 2: Wilcox76607 ($22.99 in chips) 
Seat 3: ChrisCDee ($25.79 in chips) 
Seat 4: Ellen1947 ($38.03 in chips) 
Seat 5: RikkStroken ($25.10 in chips) 
Seat 6: ladymadon107 ($6.91 in chips) 
Seat 7: chiyuki ($42.02 in chips) 
Seat 8: Nec Arg ($25 in chips) 
Seat 9: BlOnDhOlIc ($48.38 in chips) 
Wilcox76607: posts small blind $0.10
ChrisCDee: posts big blind $0.25
*** HOLE CARDS ***
Dealt to chiyuki [Qd 6c]
Ellen1947: folds 
RikkStroken: folds 
ladymadon107: calls $0.25
chiyuki: folds 
Nec Arg: folds 
BlOnDhOlIc: folds 
Paranoix1990: folds 
Wilcox76607: folds 
ChrisCDee: checks 
*** FLOP *** [Ac Jh Ah]
ChrisCDee: checks 
ladymadon107: checks 
*** TURN *** [Ac Jh Ah] [3c]
ChrisCDee: bets $0.34
ladymadon107: folds 
Uncalled bet ($0.34) returned to ChrisCDee
ChrisCDee collected $0.57 from pot
ChrisCDee: doesn't show hand 
*** SUMMARY ***
Total pot $0.60 | Rake $0.03 
Board [Ac Jh Ah 3c]
Seat 1: Paranoix1990 (button) folded before Flop (didn't bet)
Seat 2: Wilcox76607 (small blind) folded before Flop
Seat 3: ChrisCDee (big blind) collected ($0.57)
Seat 4: Ellen1947 folded before Flop (didn't bet)
Seat 5: RikkStroken folded before Flop (didn't bet)
Seat 6: ladymadon107 folded on the Turn
Seat 7: chiyuki folded before Flop (didn't bet)
Seat 8: Nec Arg folded before Flop (didn't bet)
Seat 9: BlOnDhOlIc folded before Flop (didn't bet)



PokerStars Zoom Hand #84299165464:  Hold'em No Limit ($0.10/$0.25) - 2012/08/05 14:01:21 JST [2012/08/05 1:01:21 ET]
Table 'Whirlpool' 9-max Seat #1 is the button
Seat 1: ygoegoe ($35.56 in chips) 
Seat 2: jeff0923 ($24.52 in chips) 
Seat 3: chiyuki ($42.02 in chips) 
Seat 4: fwani ($35.11 in chips) 
Seat 5: wtu1986 ($25.25 in chips) 
Seat 6: Perstenev ($12.65 in chips) 
Seat 7: Suhoff76 ($40.39 in chips) 
Seat 8: Faraz ($30.32 in chips) 
Seat 9: flyinprits ($46.64 in chips) 
jeff0923: posts small blind $0.10
chiyuki: posts big blind $0.25
*** HOLE CARDS ***
Dealt to chiyuki [8c 9s]
fwani: folds 
wtu1986: raises $0.50 to $0.75
Perstenev: folds 
Suhoff76: folds 
Faraz: calls $0.75
flyinprits: folds 
ygoegoe: folds 
jeff0923: folds 
chiyuki: folds 
*** FLOP *** [5s 5c Ts]
wtu1986: bets $1.15
Faraz: folds 
Uncalled bet ($1.15) returned to wtu1986
wtu1986 collected $1.77 from pot
wtu1986: doesn't show hand 
*** SUMMARY ***
Total pot $1.85 | Rake $0.08 
Board [5s 5c Ts]
Seat 1: ygoegoe (button) folded before Flop (didn't bet)
Seat 2: jeff0923 (small blind) folded before Flop
Seat 3: chiyuki (big blind) folded before Flop
Seat 4: fwani folded before Flop (didn't bet)
Seat 5: wtu1986 collected ($1.77)
Seat 6: Perstenev folded before Flop (didn't bet)
Seat 7: Suhoff76 folded before Flop (didn't bet)
Seat 8: Faraz folded on the Flop
Seat 9: flyinprits folded before Flop (didn't bet)



PokerStars Zoom Hand #84299159385:  Hold'em No Limit ($0.10/$0.25) - 2012/08/05 14:00:56 JST [2012/08/05 1:00:56 ET]
Table 'Whirlpool' 9-max Seat #1 is the button
Seat 1: Dejacob ($26.42 in chips) 
Seat 2: Th3Fog ($66.11 in chips) 
Seat 3: hirozo ($30.40 in chips) 
Seat 4: chiyuki ($42.02 in chips) 
Seat 5: BlOnDhOlIc ($48.48 in chips) 
Seat 6: Suhoff76 ($25 in chips) 
Seat 7: RomarioJa ($12.15 in chips) 
Seat 8: KAKamiro ($44.12 in chips) 
Seat 9: softdesign ($75.42 in chips) 
Th3Fog: posts small blind $0.10
hirozo: posts big blind $0.25
*** HOLE CARDS ***
Dealt to chiyuki [8c 9h]
chiyuki: folds 
BlOnDhOlIc: folds 
Suhoff76: folds 
RomarioJa: folds 
KAKamiro: raises $0.50 to $0.75
softdesign: folds 
Dejacob: raises $2 to $2.75
Th3Fog: folds 
hirozo: folds 
KAKamiro: calls $2
*** FLOP *** [Ad 7s Td]
KAKamiro: checks 
Dejacob: bets $3.75
KAKamiro: calls $3.75
*** TURN *** [Ad 7s Td] [Jd]
KAKamiro: checks 
Dejacob: checks 
*** RIVER *** [Ad 7s Td Jd] [3h]
KAKamiro: bets $8.25
Dejacob: calls $8.25
*** SHOW DOWN ***
KAKamiro: shows [Jc As] (two pair, Aces and Jacks)
Dejacob: mucks hand 
KAKamiro collected $28.51 from pot
*** SUMMARY ***
Total pot $29.85 | Rake $1.34 
Board [Ad 7s Td Jd 3h]
Seat 1: Dejacob (button) mucked [Ah Ks]
Seat 2: Th3Fog (small blind) folded before Flop
Seat 3: hirozo (big blind) folded before Flop
Seat 4: chiyuki folded before Flop (didn't bet)
Seat 5: BlOnDhOlIc folded before Flop (didn't bet)
Seat 6: Suhoff76 folded before Flop (didn't bet)
Seat 7: RomarioJa folded before Flop (didn't bet)
Seat 8: KAKamiro showed [Jc As] and won ($28.51) with two pair, Aces and Jacks
Seat 9: softdesign folded before Flop (didn't bet)



PokerStars Zoom Hand #84299172612:  Hold'em No Limit ($0.10/$0.25) - 2012/08/05 14:01:50 JST [2012/08/05 1:01:50 ET]
Table 'Whirlpool' 9-max Seat #1 is the button
Seat 1: giorgos_k ($38.85 in chips) 
Seat 2: chiyuki ($41.77 in chips) 
Seat 3: Anafim ($14.23 in chips) 
Seat 4: Déculotter69 ($15.47 in chips) 
Seat 5: KeLevro0 ($13.01 in chips) 
Seat 6: munky3 ($33.78 in chips) 
Seat 7: puffy5533 ($23.45 in chips) 
Seat 8: Landybob ($36.54 in chips) 
Seat 9: Lasutchik ($6.88 in chips) 
chiyuki: posts small blind $0.10
Anafim: posts big blind $0.25
*** HOLE CARDS ***
Dealt to chiyuki [7d Jh]
Déculotter69: folds 
KeLevro0: folds 
munky3: folds 
puffy5533: raises $0.50 to $0.75
Landybob: folds 
Lasutchik: folds 
giorgos_k: folds 
chiyuki: folds 
Anafim: folds 
Uncalled bet ($0.50) returned to puffy5533
puffy5533 collected $0.60 from pot
puffy5533: doesn't show hand 
*** SUMMARY ***
Total pot $0.60 | Rake $0 
Seat 1: giorgos_k (button) folded before Flop (didn't bet)
Seat 2: chiyuki (small blind) folded before Flop
Seat 3: Anafim (big blind) folded before Flop
Seat 4: Déculotter69 folded before Flop (didn't bet)
Seat 5: KeLevro0 folded before Flop (didn't bet)
Seat 6: munky3 folded before Flop (didn't bet)
Seat 7: puffy5533 collected ($0.60)
Seat 8: Landybob folded before Flop (didn't bet)
Seat 9: Lasutchik folded before Flop (didn't bet)



PokerStars Zoom Hand #84299175793:  Hold'em No Limit ($0.10/$0.25) - 2012/08/05 14:02:02 JST [2012/08/05 1:02:02 ET]
Table 'Whirlpool' 9-max Seat #1 is the button
Seat 1: roksmokndonk ($36 in chips) 
Seat 2: Dejacob ($41.64 in chips) 
Seat 3: Rudolf ($46.77 in chips) 
Seat 4: KeLevro0 ($12.48 in chips) 
Seat 5: 2997qwer ($9.95 in chips) 
Seat 6: chiyuki ($41.67 in chips) 
Seat 7: kamikkaze ($15 in chips) 
Seat 8: wtu1986 ($30.43 in chips) 
Seat 9: puffy5533 ($23.80 in chips) 
Dejacob: posts small blind $0.10
Rudolf: posts big blind $0.25
*** HOLE CARDS ***
Dealt to chiyuki [9h Ks]
KeLevro0: folds 
2997qwer: folds 
chiyuki: folds 
kamikkaze: folds 
wtu1986: raises $0.50 to $0.75
puffy5533: folds 
roksmokndonk: folds 
Dejacob: folds 
Rudolf: folds 
Uncalled bet ($0.50) returned to wtu1986
wtu1986 collected $0.60 from pot
wtu1986: doesn't show hand 
*** SUMMARY ***
Total pot $0.60 | Rake $0 
Seat 1: roksmokndonk (button) folded before Flop (didn't bet)
Seat 2: Dejacob (small blind) folded before Flop
Seat 3: Rudolf (big blind) folded before Flop
Seat 4: KeLevro0 folded before Flop (didn't bet)
Seat 5: 2997qwer folded before Flop (didn't bet)
Seat 6: chiyuki folded before Flop (didn't bet)
Seat 7: kamikkaze folded before Flop (didn't bet)
Seat 8: wtu1986 collected ($0.60)
Seat 9: puffy5533 folded before Flop (didn't bet)



PokerStars Zoom Hand #84299176599:  Hold'em No Limit ($0.10/$0.25) - 2012/08/05 14:02:05 JST [2012/08/05 1:02:05 ET]
Table 'Whirlpool' 9-max Seat #1 is the button
Seat 1: 123progress ($39.38 in chips) 
Seat 2: Leftymouse ($24.75 in chips) 
Seat 3: ladymadon107 ($6.66 in chips) 
Seat 4: leo2095 ($14.50 in chips) 
Seat 5: Suhoff76 ($39.82 in chips) 
Seat 6: peng2astic ($13.42 in chips) 
Seat 7: Loholov ($20.20 in chips) 
Seat 8: chiyuki ($41.67 in chips) 
Seat 9: cr0lox ($18.46 in chips) 
Leftymouse: posts small blind $0.10
ladymadon107: posts big blind $0.25
*** HOLE CARDS ***
Dealt to chiyuki [6d Qh]
leo2095: folds 
Suhoff76: folds 
peng2astic: folds 
Loholov: folds 
chiyuki: folds 
cr0lox: folds 
123progress: raises $0.50 to $0.75
Leftymouse: folds 
ladymadon107: folds 
Uncalled bet ($0.50) returned to 123progress
123progress collected $0.60 from pot
123progress: doesn't show hand 
*** SUMMARY ***
Total pot $0.60 | Rake $0 
Seat 1: 123progress (button) collected ($0.60)
Seat 2: Leftymouse (small blind) folded before Flop
Seat 3: ladymadon107 (big blind) folded before Flop
Seat 4: leo2095 folded before Flop (didn't bet)
Seat 5: Suhoff76 folded before Flop (didn't bet)
Seat 6: peng2astic folded before Flop (didn't bet)
Seat 7: Loholov folded before Flop (didn't bet)
Seat 8: chiyuki folded before Flop (didn't bet)
Seat 9: cr0lox folded before Flop (didn't bet)



PokerStars Zoom Hand #84299174846:  Hold'em No Limit ($0.10/$0.25) - 2012/08/05 14:01:59 JST [2012/08/05 1:01:59 ET]
Table 'Whirlpool' 9-max Seat #1 is the button
Seat 1: RomarioJa ($16.06 in chips) 
Seat 2: Tom1999 ($10.42 in chips) 
Seat 3: Perstenev ($11.90 in chips) 
Seat 4: Anafim ($13.98 in chips) 
Seat 5: mariuka1 ($7.76 in chips) 
Seat 6: hirozo ($27.20 in chips) 
Seat 7: chiyuki ($41.67 in chips) 
Seat 8: Paranoix1990 ($18.03 in chips) 
Seat 9: ChrisCDee ($26.11 in chips) 
Tom1999: posts small blind $0.10
Perstenev: posts big blind $0.25
*** HOLE CARDS ***
Dealt to chiyuki [7d 6s]
Anafim: folds 
mariuka1: folds 
hirozo: raises $0.50 to $0.75
chiyuki: folds 
Paranoix1990: folds 
ChrisCDee: folds 
RomarioJa: calls $0.75
Tom1999: folds 
Perstenev: folds 
*** FLOP *** [Jd 8d Ad]
hirozo: bets $1.18
RomarioJa: folds 
Uncalled bet ($1.18) returned to hirozo
hirozo collected $1.77 from pot
hirozo: doesn't show hand 
*** SUMMARY ***
Total pot $1.85 | Rake $0.08 
Board [Jd 8d Ad]
Seat 1: RomarioJa (button) folded on the Flop
Seat 2: Tom1999 (small blind) folded before Flop
Seat 3: Perstenev (big blind) folded before Flop
Seat 4: Anafim folded before Flop (didn't bet)
Seat 5: mariuka1 folded before Flop (didn't bet)
Seat 6: hirozo collected ($1.77)
Seat 7: chiyuki folded before Flop (didn't bet)
Seat 8: Paranoix1990 folded before Flop (didn't bet)
Seat 9: ChrisCDee folded before Flop (didn't bet)



PokerStars Zoom Hand #84299177891:  Hold'em No Limit ($0.10/$0.25) - 2012/08/05 14:02:10 JST [2012/08/05 1:02:10 ET]
Table 'Whirlpool' 9-max Seat #1 is the button
Seat 1: ll_LaMeR_ll ($69.73 in chips) 
Seat 2: Lasutchik ($34.31 in chips) 
Seat 3: KeLevro0 ($12.48 in chips) 
Seat 4: cr0lox ($18.46 in chips) 
Seat 5: chiyuki ($41.67 in chips) 
Seat 6: BlOnDhOlIc ($25 in chips) 
Seat 7: Perstenev ($12.30 in chips) 
Seat 8: leo2095 ($14.50 in chips) 
Seat 9: Suhoff76 ($39.82 in chips) 
Lasutchik: posts small blind $0.10
KeLevro0: posts big blind $0.25
*** HOLE CARDS ***
Dealt to chiyuki [8h 6s]
cr0lox: raises $0.50 to $0.75
chiyuki: folds 
BlOnDhOlIc: folds 
Perstenev: folds 
leo2095: folds 
Suhoff76: folds 
ll_LaMeR_ll: folds 
Lasutchik: folds 
KeLevro0: folds 
Uncalled bet ($0.50) returned to cr0lox
cr0lox collected $0.60 from pot
cr0lox: doesn't show hand 
*** SUMMARY ***
Total pot $0.60 | Rake $0 
Seat 1: ll_LaMeR_ll (button) folded before Flop (didn't bet)
Seat 2: Lasutchik (small blind) folded before Flop
Seat 3: KeLevro0 (big blind) folded before Flop
Seat 4: cr0lox collected ($0.60)
Seat 5: chiyuki folded before Flop (didn't bet)
Seat 6: BlOnDhOlIc folded before Flop (didn't bet)
Seat 7: Perstenev folded before Flop (didn't bet)
Seat 8: leo2095 folded before Flop (didn't bet)
Seat 9: Suhoff76 folded before Flop (didn't bet)



PokerStars Zoom Hand #84299171117:  Hold'em No Limit ($0.10/$0.25) - 2012/08/05 14:01:44 JST [2012/08/05 1:01:44 ET]
Table 'Whirlpool' 9-max Seat #1 is the button
Seat 1: chiyuki ($41.77 in chips) 
Seat 2: ChrisCDee ($31.48 in chips) 
Seat 3: taksist889 ($14.80 in chips) 
Seat 4: seula i ($65.80 in chips) 
Seat 5: Nec Arg ($24.75 in chips) 
Seat 6: 2997qwer ($9.95 in chips) 
Seat 7: BlackZafiro ($45.34 in chips) 
Seat 8: KeLevro0 ($13.01 in chips) 
Seat 9: Th3Fog ($18.14 in chips) 
ChrisCDee: posts small blind $0.10
taksist889: posts big blind $0.25
*** HOLE CARDS ***
Dealt to chiyuki [5c 3c]
seula i has timed out
seula i: folds 
Nec Arg: folds 
2997qwer: folds 
BlackZafiro: raises $0.50 to $0.75
KeLevro0: folds 
Th3Fog: calls $0.75
chiyuki: folds 
ChrisCDee: folds 
taksist889: folds 
*** FLOP *** [7c 5h As]
BlackZafiro: bets $1.06
Th3Fog: folds 
Uncalled bet ($1.06) returned to BlackZafiro
BlackZafiro collected $1.77 from pot
BlackZafiro: doesn't show hand 
*** SUMMARY ***
Total pot $1.85 | Rake $0.08 
Board [7c 5h As]
Seat 1: chiyuki (button) folded before Flop (didn't bet)
Seat 2: ChrisCDee (small blind) folded before Flop
Seat 3: taksist889 (big blind) folded before Flop
Seat 4: seula i folded before Flop (didn't bet)
Seat 5: Nec Arg folded before Flop (didn't bet)
Seat 6: 2997qwer folded before Flop (didn't bet)
Seat 7: BlackZafiro collected ($1.77)
Seat 8: KeLevro0 folded before Flop (didn't bet)
Seat 9: Th3Fog folded on the Flop



PokerStars Zoom Hand #84299179152:  Hold'em No Limit ($0.10/$0.25) - 2012/08/05 14:02:15 JST [2012/08/05 1:02:15 ET]
Table 'Whirlpool' 9-max Seat #1 is the button
Seat 1: PetitAlejo ($26.42 in chips) 
Seat 2: wtu1986 ($25 in chips) 
Seat 3: Suhoff76 ($39.82 in chips) 
Seat 4: jeff0923 ($23.80 in chips) 
Seat 5: BlOnDhOlIc ($25 in chips) 
Seat 6: giorgos_k ($13.77 in chips) 
Seat 7: Dejacob ($41.54 in chips) 
Seat 8: hirozo ($30.40 in chips) 
Seat 9: chiyuki ($41.67 in chips) 
wtu1986: posts small blind $0.10
Suhoff76: posts big blind $0.25
*** HOLE CARDS ***
Dealt to chiyuki [Qd 4d]
jeff0923: folds 
BlOnDhOlIc: folds 
giorgos_k: folds 
Dejacob: folds 
hirozo: folds 
chiyuki: folds 
PetitAlejo: raises $0.50 to $0.75
wtu1986: folds 
Suhoff76: folds 
Uncalled bet ($0.50) returned to PetitAlejo
PetitAlejo collected $0.60 from pot
PetitAlejo: doesn't show hand 
*** SUMMARY ***
Total pot $0.60 | Rake $0 
Seat 1: PetitAlejo (button) collected ($0.60)
Seat 2: wtu1986 (small blind) folded before Flop
Seat 3: Suhoff76 (big blind) folded before Flop
Seat 4: jeff0923 folded before Flop (didn't bet)
Seat 5: BlOnDhOlIc folded before Flop (didn't bet)
Seat 6: giorgos_k folded before Flop (didn't bet)
Seat 7: Dejacob folded before Flop (didn't bet)
Seat 8: hirozo folded before Flop (didn't bet)
Seat 9: chiyuki folded before Flop (didn't bet)



PokerStars Zoom Hand #84299184267:  Hold'em No Limit ($0.10/$0.25) - 2012/08/05 14:02:35 JST [2012/08/05 1:02:35 ET]
Table 'Whirlpool' 9-max Seat #1 is the button
Seat 1: chiyuki ($41.42 in chips) 
Seat 2: 2997qwer ($13 in chips) 
Seat 3: carlosrbr ($17.45 in chips) 
Seat 4: solawind ($9.02 in chips) 
Seat 5: hirozo ($31.02 in chips) 
Seat 6: DanielWhyte ($26.36 in chips) 
Seat 7: seula i ($25 in chips) 
Seat 8: Dejacob ($41.54 in chips) 
Seat 9: jeff0923 ($23.55 in chips) 
2997qwer: posts small blind $0.10
carlosrbr: posts big blind $0.25
*** HOLE CARDS ***
Dealt to chiyuki [Jd 4s]
solawind: folds 
hirozo: folds 
DanielWhyte: raises $0.25 to $0.50
seula i: folds 
Dejacob: folds 
jeff0923: folds 
chiyuki: folds 
2997qwer: folds 
carlosrbr: folds 
Uncalled bet ($0.25) returned to DanielWhyte
DanielWhyte collected $0.60 from pot
DanielWhyte: doesn't show hand 
*** SUMMARY ***
Total pot $0.60 | Rake $0 
Seat 1: chiyuki (button) folded before Flop (didn't bet)
Seat 2: 2997qwer (small blind) folded before Flop
Seat 3: carlosrbr (big blind) folded before Flop
Seat 4: solawind folded before Flop (didn't bet)
Seat 5: hirozo folded before Flop (didn't bet)
Seat 6: DanielWhyte collected ($0.60)
Seat 7: seula i folded before Flop (didn't bet)
Seat 8: Dejacob folded before Flop (didn't bet)
Seat 9: jeff0923 folded before Flop (didn't bet)



PokerStars Zoom Hand #84299185022:  Hold'em No Limit ($0.10/$0.25) - 2012/08/05 14:02:39 JST [2012/08/05 1:02:39 ET]
Table 'Whirlpool' 9-max Seat #1 is the button
Seat 1: Déculotter69 ($15.12 in chips) 
Seat 2: Wilcox76607 ($21.14 in chips) 
Seat 3: KeLevro0 ($9.18 in chips) 
Seat 4: chiyuki ($41.42 in chips) 
Seat 5: BlOnDhOlIc ($59.05 in chips) 
Seat 6: BlackZafiro ($46.36 in chips) 
Seat 7: Faraz ($28.70 in chips) 
Seat 8: Suhoff76 ($26.03 in chips) 
Seat 9: Scruf13 ($12.50 in chips) 
Wilcox76607: posts small blind $0.10
KeLevro0: posts big blind $0.25
*** HOLE CARDS ***
Dealt to chiyuki [Kc Kd]
chiyuki: raises $0.50 to $0.75
BlOnDhOlIc: folds 
BlackZafiro: folds 
Faraz: folds 
Suhoff76: folds 
Scruf13: folds 
Déculotter69: folds 
Wilcox76607: folds 
KeLevro0: folds 
Uncalled bet ($0.50) returned to chiyuki
chiyuki collected $0.60 from pot
chiyuki: doesn't show hand 
*** SUMMARY ***
Total pot $0.60 | Rake $0 
Seat 1: Déculotter69 (button) folded before Flop (didn't bet)
Seat 2: Wilcox76607 (small blind) folded before Flop
Seat 3: KeLevro0 (big blind) folded before Flop
Seat 4: chiyuki collected ($0.60)
Seat 5: BlOnDhOlIc folded before Flop (didn't bet)
Seat 6: BlackZafiro folded before Flop (didn't bet)
Seat 7: Faraz folded before Flop (didn't bet)
Seat 8: Suhoff76 folded before Flop (didn't bet)
Seat 9: Scruf13 folded before Flop (didn't bet)



PokerStars Zoom Hand #84299170348:  Hold'em No Limit ($0.10/$0.25) - 2012/08/05 14:01:41 JST [2012/08/05 1:01:41 ET]
Table 'Whirlpool' 9-max Seat #1 is the button
Seat 1: PetitAlejo ($35.52 in chips) 
Seat 2: softdesign ($75.77 in chips) 
Seat 3: kamikkaze ($16.06 in chips) 
Seat 4: mariuka1 ($7.76 in chips) 
Seat 5: Dafleche ($18.04 in chips) 
Seat 6: 123progress ($28.23 in chips) 
Seat 7: cR!Ma*aRm ($11.44 in chips) 
Seat 8: roksmokndonk ($36 in chips) 
Seat 9: chiyuki ($41.77 in chips) 
softdesign: posts small blind $0.10
kamikkaze: posts big blind $0.25
*** HOLE CARDS ***
Dealt to chiyuki [Kd 7s]
mariuka1: folds 
Dafleche: calls $0.25
123progress: folds 
cR!Ma*aRm: folds 
roksmokndonk: folds 
chiyuki: folds 
PetitAlejo: folds 
softdesign: raises $0.25 to $0.50
kamikkaze: folds 
Dafleche: calls $0.25
*** FLOP *** [3d 8c 3s]
softdesign: bets $1.50
Dafleche: folds 
Uncalled bet ($1.50) returned to softdesign
softdesign collected $1.19 from pot
softdesign: doesn't show hand 
*** SUMMARY ***
Total pot $1.25 | Rake $0.06 
Board [3d 8c 3s]
Seat 1: PetitAlejo (button) folded before Flop (didn't bet)
Seat 2: softdesign (small blind) collected ($1.19)
Seat 3: kamikkaze (big blind) folded before Flop
Seat 4: mariuka1 folded before Flop (didn't bet)
Seat 5: Dafleche folded on the Flop
Seat 6: 123progress folded before Flop (didn't bet)
Seat 7: cR!Ma*aRm folded before Flop (didn't bet)
Seat 8: roksmokndonk folded before Flop (didn't bet)
Seat 9: chiyuki folded before Flop (didn't bet)



PokerStars Zoom Hand #84299180666:  Hold'em No Limit ($0.10/$0.25) - 2012/08/05 14:02:21 JST [2012/08/05 1:02:21 ET]
Table 'Whirlpool' 9-max Seat #1 is the button
Seat 1: 2997qwer ($9.20 in chips) 
Seat 2: cR!Ma*aRm ($12.91 in chips) 
Seat 3: chiyuki ($41.67 in chips) 
Seat 4: giorgos_k ($13.77 in chips) 
Seat 5: Vahe50 ($15.02 in chips) 
Seat 6: Perstenev ($12.30 in chips) 
Seat 7: hirozo ($30.40 in chips) 
Seat 8: BlOnDhOlIc ($25 in chips) 
Seat 9: silvno31 ($46.79 in chips) 
cR!Ma*aRm: posts small blind $0.10
chiyuki: posts big blind $0.25
*** HOLE CARDS ***
Dealt to chiyuki [Kc 4h]
giorgos_k: folds 
Vahe50: folds 
Perstenev: folds 
hirozo: folds 
BlOnDhOlIc: raises $0.37 to $0.62
silvno31: folds 
2997qwer: folds 
cR!Ma*aRm: calls $0.52
chiyuki: folds 
*** FLOP *** [Jh 6h 5d]
cR!Ma*aRm: checks 
BlOnDhOlIc: bets $1
cR!Ma*aRm: calls $1
*** TURN *** [Jh 6h 5d] [Qd]
cR!Ma*aRm: checks 
BlOnDhOlIc: checks 
*** RIVER *** [Jh 6h 5d Qd] [9s]
cR!Ma*aRm: bets $0.75
BlOnDhOlIc: calls $0.75
*** SHOW DOWN ***
cR!Ma*aRm: shows [8d 7c] (a straight, Five to Nine)
BlOnDhOlIc: mucks hand 
cR!Ma*aRm collected $4.77 from pot
*** SUMMARY ***
Total pot $4.99 | Rake $0.22 
Board [Jh 6h 5d Qd 9s]
Seat 1: 2997qwer (button) folded before Flop (didn't bet)
Seat 2: cR!Ma*aRm (small blind) showed [8d 7c] and won ($4.77) with a straight, Five to Nine
Seat 3: chiyuki (big blind) folded before Flop
Seat 4: giorgos_k folded before Flop (didn't bet)
Seat 5: Vahe50 folded before Flop (didn't bet)
Seat 6: Perstenev folded before Flop (didn't bet)
Seat 7: hirozo folded before Flop (didn't bet)
Seat 8: BlOnDhOlIc mucked [Js Ad]
Seat 9: silvno31 folded before Flop (didn't bet)



PokerStars Zoom Hand #84299190737:  Hold'em No Limit ($0.10/$0.25) - 2012/08/05 14:03:01 JST [2012/08/05 1:03:01 ET]
Table 'Whirlpool' 9-max Seat #1 is the button
Seat 1: seula i ($25 in chips) 
Seat 2: kamikkaze ($13 in chips) 
Seat 3: Loholov ($20.10 in chips) 
Seat 4: Lasutchik ($6.63 in chips) 
Seat 5: chiyuki ($41.77 in chips) 
Seat 6: Perstenev ($5.42 in chips) 
Seat 7: Suhoff76 ($42.52 in chips) 
Seat 8: KeLevro0 ($12.48 in chips) 
Seat 9: RikkStroken ($24.65 in chips) 
kamikkaze: posts small blind $0.10
Loholov: posts big blind $0.25
*** HOLE CARDS ***
Dealt to chiyuki [Jd 7d]
Lasutchik: folds 
chiyuki: folds 
Perstenev: folds 
Suhoff76: folds 
KeLevro0: folds 
RikkStroken: raises $0.50 to $0.75
seula i: folds 
kamikkaze: folds 
Loholov: folds 
Uncalled bet ($0.50) returned to RikkStroken
RikkStroken collected $0.60 from pot
RikkStroken: doesn't show hand 
*** SUMMARY ***
Total pot $0.60 | Rake $0 
Seat 1: seula i (button) folded before Flop (didn't bet)
Seat 2: kamikkaze (small blind) folded before Flop
Seat 3: Loholov (big blind) folded before Flop
Seat 4: Lasutchik folded before Flop (didn't bet)
Seat 5: chiyuki folded before Flop (didn't bet)
Seat 6: Perstenev folded before Flop (didn't bet)
Seat 7: Suhoff76 folded before Flop (didn't bet)
Seat 8: KeLevro0 folded before Flop (didn't bet)
Seat 9: RikkStroken collected ($0.60)



PokerStars Zoom Hand #84299192310:  Hold'em No Limit ($0.10/$0.25) - 2012/08/05 14:03:07 JST [2012/08/05 1:03:07 ET]
Table 'Whirlpool' 9-max Seat #1 is the button
Seat 1: kamikkaze ($18.58 in chips) 
Seat 2: giorgos_k ($10.73 in chips) 
Seat 3: Th3Fog ($17.39 in chips) 
Seat 4: Lasutchik ($34.21 in chips) 
Seat 5: Ellen1947 ($29.65 in chips) 
Seat 6: roksmokndonk ($36.21 in chips) 
Seat 7: BlOnDhOlIc ($47.78 in chips) 
Seat 8: chiyuki ($41.77 in chips) 
Seat 9: Perstenev ($12.62 in chips) 
giorgos_k: posts small blind $0.10
Th3Fog: posts big blind $0.25
*** HOLE CARDS ***
Dealt to chiyuki [8c Ks]
Lasutchik: folds 
Ellen1947: folds 
roksmokndonk: calls $0.25
BlOnDhOlIc: raises $0.75 to $1
chiyuki: folds 
Perstenev: folds 
kamikkaze: folds 
giorgos_k: folds 
Th3Fog: folds 
roksmokndonk: calls $0.75
*** FLOP *** [4c 9c 2c]
roksmokndonk: checks 
BlOnDhOlIc: bets $1.50
roksmokndonk: folds 
Uncalled bet ($1.50) returned to BlOnDhOlIc
BlOnDhOlIc collected $2.24 from pot
BlOnDhOlIc: doesn't show hand 
*** SUMMARY ***
Total pot $2.35 | Rake $0.11 
Board [4c 9c 2c]
Seat 1: kamikkaze (button) folded before Flop (didn't bet)
Seat 2: giorgos_k (small blind) folded before Flop
Seat 3: Th3Fog (big blind) folded before Flop
Seat 4: Lasutchik folded before Flop (didn't bet)
Seat 5: Ellen1947 folded before Flop (didn't bet)
Seat 6: roksmokndonk folded on the Flop
Seat 7: BlOnDhOlIc collected ($2.24)
Seat 8: chiyuki folded before Flop (didn't bet)
Seat 9: Perstenev folded before Flop (didn't bet)



PokerStars Zoom Hand #84299194386:  Hold'em No Limit ($0.10/$0.25) - 2012/08/05 14:03:15 JST [2012/08/05 1:03:15 ET]
Table 'Whirlpool' 9-max Seat #1 is the button
Seat 1: wtu1986 ($25.35 in chips) 
Seat 2: Ellen1947 ($29.65 in chips) 
Seat 3: RomarioJa ($6.05 in chips) 
Seat 4: kkbruins0408 ($14.33 in chips) 
Seat 5: ygoegoe ($34.81 in chips) 
Seat 6: chiyuki ($41.77 in chips) 
Seat 7: BlackZafiro ($46.46 in chips) 
Seat 8: Suhoff76 ($31.60 in chips) 
Seat 9: KeLevro0 ($8.83 in chips) 
Ellen1947: posts small blind $0.10
RomarioJa: posts big blind $0.25
*** HOLE CARDS ***
Dealt to chiyuki [4s Ts]
kkbruins0408: calls $0.25
ygoegoe: folds 
chiyuki: folds 
BlackZafiro: folds 
Suhoff76: folds 
KeLevro0: folds 
wtu1986: folds 
Ellen1947: folds 
RomarioJa: checks 
*** FLOP *** [9c 8c Ah]
RomarioJa: checks 
kkbruins0408: bets $0.50
RomarioJa: folds 
Uncalled bet ($0.50) returned to kkbruins0408
kkbruins0408 collected $0.57 from pot
kkbruins0408: doesn't show hand 
*** SUMMARY ***
Total pot $0.60 | Rake $0.03 
Board [9c 8c Ah]
Seat 1: wtu1986 (button) folded before Flop (didn't bet)
Seat 2: Ellen1947 (small blind) folded before Flop
Seat 3: RomarioJa (big blind) folded on the Flop
Seat 4: kkbruins0408 collected ($0.57)
Seat 5: ygoegoe folded before Flop (didn't bet)
Seat 6: chiyuki folded before Flop (didn't bet)
Seat 7: BlackZafiro folded before Flop (didn't bet)
Seat 8: Suhoff76 folded before Flop (didn't bet)
Seat 9: KeLevro0 folded before Flop (didn't bet)



PokerStars Zoom Hand #84299195437:  Hold'em No Limit ($0.10/$0.25) - 2012/08/05 14:03:19 JST [2012/08/05 1:03:19 ET]
Table 'Whirlpool' 9-max Seat #1 is the button
Seat 1: wtu1986 ($27.04 in chips) 
Seat 2: chiyuki ($41.77 in chips) 
Seat 3: kamikkaze ($14.65 in chips) 
Seat 4: Roglus ($19.80 in chips) 
Seat 5: Suhoff76 ($26.03 in chips) 
Seat 6: solawind ($8.67 in chips) 
Seat 7: seula i ($36.75 in chips) 
Seat 8: Lasutchik ($6.53 in chips) 
Seat 9: cR!Ma*aRm ($15.31 in chips) 
chiyuki: posts small blind $0.10
kamikkaze: posts big blind $0.25
*** HOLE CARDS ***
Dealt to chiyuki [5c 5s]
Roglus: folds 
Suhoff76: folds 
solawind: folds 
seula i: folds 
Lasutchik: raises $0.50 to $0.75
cR!Ma*aRm: calls $0.75
wtu1986: folds 
chiyuki: calls $0.65
kamikkaze: folds 
*** FLOP *** [Js 6s Ts]
chiyuki: checks 
Lasutchik: checks 
cR!Ma*aRm: bets $0.75
chiyuki: folds 
Lasutchik: calls $0.75
*** TURN *** [Js 6s Ts] [7s]
Lasutchik: bets $2
cR!Ma*aRm: calls $2
*** RIVER *** [Js 6s Ts 7s] [8c]
Lasutchik: checks 
cR!Ma*aRm: checks 
*** SHOW DOWN ***
Lasutchik: shows [Ac Kd] (high card Ace)
cR!Ma*aRm: shows [Td 7d] (two pair, Tens and Sevens)
cR!Ma*aRm collected $7.64 from pot
*** SUMMARY ***
Total pot $8 | Rake $0.36 
Board [Js 6s Ts 7s 8c]
Seat 1: wtu1986 (button) folded before Flop (didn't bet)
Seat 2: chiyuki (small blind) folded on the Flop
Seat 3: kamikkaze (big blind) folded before Flop
Seat 4: Roglus folded before Flop (didn't bet)
Seat 5: Suhoff76 folded before Flop (didn't bet)
Seat 6: solawind folded before Flop (didn't bet)
Seat 7: seula i folded before Flop (didn't bet)
Seat 8: Lasutchik showed [Ac Kd] and lost with high card Ace
Seat 9: cR!Ma*aRm showed [Td 7d] and won ($7.64) with two pair, Tens and Sevens



PokerStars Zoom Hand #84299207563:  Hold'em No Limit ($0.10/$0.25) - 2012/08/05 14:04:06 JST [2012/08/05 1:04:06 ET]
Table 'Whirlpool' 9-max Seat #1 is the button
Seat 1: BlackZafiro ($46.36 in chips) 
Seat 2: RomarioJa ($12.25 in chips) 
Seat 3: BlOnDhOlIc ($25.70 in chips) 
Seat 4: chiyuki ($41.02 in chips) 
Seat 5: Loholov ($15 in chips) 
Seat 6: Perstenev ($12.57 in chips) 
Seat 7: puffy5533 ($20.45 in chips) 
Seat 8: Th3Fog ($17.04 in chips) 
Seat 9: Csabee21 ($25.29 in chips) 
RomarioJa: posts small blind $0.10
BlOnDhOlIc: posts big blind $0.25
*** HOLE CARDS ***
Dealt to chiyuki [9s 6s]
chiyuki: folds 
Loholov: folds 
Perstenev: folds 
puffy5533: folds 
Th3Fog: folds 
Csabee21: folds 
BlackZafiro: raises $0.37 to $0.62
RomarioJa: folds 
BlOnDhOlIc: folds 
Uncalled bet ($0.37) returned to BlackZafiro
BlackZafiro collected $0.60 from pot
BlackZafiro: doesn't show hand 
*** SUMMARY ***
Total pot $0.60 | Rake $0 
Seat 1: BlackZafiro (button) collected ($0.60)
Seat 2: RomarioJa (small blind) folded before Flop
Seat 3: BlOnDhOlIc (big blind) folded before Flop
Seat 4: chiyuki folded before Flop (didn't bet)
Seat 5: Loholov folded before Flop (didn't bet)
Seat 6: Perstenev folded before Flop (didn't bet)
Seat 7: puffy5533 folded before Flop (didn't bet)
Seat 8: Th3Fog folded before Flop (didn't bet)
Seat 9: Csabee21 folded before Flop (didn't bet)



PokerStars Zoom Hand #84299204688:  Hold'em No Limit ($0.10/$0.25) - 2012/08/05 14:03:55 JST [2012/08/05 1:03:55 ET]
Table 'Whirlpool' 9-max Seat #1 is the button
Seat 1: hirozo ($30.27 in chips) 
Seat 2: Nerkit ($12.97 in chips) 
Seat 3: PetitAlejo ($34.52 in chips) 
Seat 4: Dejacob ($49.90 in chips) 
Seat 5: Faraz ($26.30 in chips) 
Seat 6: puffy5533 ($20.45 in chips) 
Seat 7: chiyuki ($41.02 in chips) 
Seat 8: RomarioJa ($11.96 in chips) 
Seat 9: kamikkaze ($14.30 in chips) 
Nerkit: posts small blind $0.10
PetitAlejo: posts big blind $0.25
*** HOLE CARDS ***
Dealt to chiyuki [4c 3c]
Dejacob: folds 
Faraz: folds 
puffy5533: folds 
chiyuki: folds 
RomarioJa: folds 
kamikkaze: folds 
hirozo: raises $0.25 to $0.50
Nerkit: folds 
PetitAlejo: calls $0.25
*** FLOP *** [8c 9d Td]
PetitAlejo: checks 
hirozo: bets $0.70
PetitAlejo: raises $1.22 to $1.92
hirozo: folds 
Uncalled bet ($1.22) returned to PetitAlejo
PetitAlejo collected $2.39 from pot
PetitAlejo: doesn't show hand 
*** SUMMARY ***
Total pot $2.50 | Rake $0.11 
Board [8c 9d Td]
Seat 1: hirozo (button) folded on the Flop
Seat 2: Nerkit (small blind) folded before Flop
Seat 3: PetitAlejo (big blind) collected ($2.39)
Seat 4: Dejacob folded before Flop (didn't bet)
Seat 5: Faraz folded before Flop (didn't bet)
Seat 6: puffy5533 folded before Flop (didn't bet)
Seat 7: chiyuki folded before Flop (didn't bet)
Seat 8: RomarioJa folded before Flop (didn't bet)
Seat 9: kamikkaze folded before Flop (didn't bet)



PokerStars Zoom Hand #84299217764:  Hold'em No Limit ($0.10/$0.25) - 2012/08/05 14:04:45 JST [2012/08/05 1:04:45 ET]
Table 'Whirlpool' 9-max Seat #1 is the button
Seat 1: chiyuki ($40.77 in chips) 
Seat 2: flyinprits ($44.04 in chips) 
Seat 3: solawind ($16.56 in chips) 
Seat 4: RomarioJa ($6.05 in chips) 
Seat 5: hirozo ($26.17 in chips) 
Seat 6: Perstenev ($12.52 in chips) 
Seat 7: mariuka1 ($8.49 in chips) 
Seat 8: DanielWhyte ($26.26 in chips) 
Seat 9: Tom1999 ($14.02 in chips) 
flyinprits: posts small blind $0.10
solawind: posts big blind $0.25
*** HOLE CARDS ***
Dealt to chiyuki [5s 2s]
RomarioJa: folds 
hirozo: folds 
Perstenev: folds 
mariuka1: folds 
DanielWhyte: folds 
Tom1999: folds 
chiyuki: folds 
flyinprits: folds 
Uncalled bet ($0.15) returned to solawind
solawind collected $0.20 from pot
solawind: doesn't show hand 
*** SUMMARY ***
Total pot $0.20 | Rake $0 
Seat 1: chiyuki (button) folded before Flop (didn't bet)
Seat 2: flyinprits (small blind) folded before Flop
Seat 3: solawind (big blind) collected ($0.20)
Seat 4: RomarioJa folded before Flop (didn't bet)
Seat 5: hirozo folded before Flop (didn't bet)
Seat 6: Perstenev folded before Flop (didn't bet)
Seat 7: mariuka1 folded before Flop (didn't bet)
Seat 8: DanielWhyte folded before Flop (didn't bet)
Seat 9: Tom1999 folded before Flop (didn't bet)



PokerStars Zoom Hand #84299209903:  Hold'em No Limit ($0.10/$0.25) - 2012/08/05 14:04:15 JST [2012/08/05 1:04:15 ET]
Table 'Whirlpool' 9-max Seat #1 is the button
Seat 1: Anafim ($12.75 in chips) 
Seat 2: Vahe50 ($10.97 in chips) 
Seat 3: chiyuki ($41.02 in chips) 
Seat 4: PetitAlejo ($30.63 in chips) 
Seat 5: deadmoneykid ($24.65 in chips) 
Seat 6: fezman ($7.78 in chips) 
Seat 7: RomarioJa ($11.71 in chips) 
Seat 8: puffy5533 ($20.45 in chips) 
Seat 9: solawind ($16.56 in chips) 
Vahe50: posts small blind $0.10
chiyuki: posts big blind $0.25
*** HOLE CARDS ***
Dealt to chiyuki [Tc Js]
PetitAlejo: folds 
deadmoneykid: raises $0.50 to $0.75
fezman: folds 
RomarioJa: folds 
puffy5533: folds 
solawind: folds 
Anafim: calls $0.75
Vahe50: folds 
chiyuki: folds 
*** FLOP *** [8d 2s 5d]
deadmoneykid: bets $1.50
Anafim: folds 
Uncalled bet ($1.50) returned to deadmoneykid
deadmoneykid collected $1.77 from pot
deadmoneykid: doesn't show hand 
*** SUMMARY ***
Total pot $1.85 | Rake $0.08 
Board [8d 2s 5d]
Seat 1: Anafim (button) folded on the Flop
Seat 2: Vahe50 (small blind) folded before Flop
Seat 3: chiyuki (big blind) folded before Flop
Seat 4: PetitAlejo folded before Flop (didn't bet)
Seat 5: deadmoneykid collected ($1.77)
Seat 6: fezman folded before Flop (didn't bet)
Seat 7: RomarioJa folded before Flop (didn't bet)
Seat 8: puffy5533 folded before Flop (didn't bet)
Seat 9: solawind folded before Flop (didn't bet)



PokerStars Zoom Hand #84299208867:  Hold'em No Limit ($0.10/$0.25) - 2012/08/05 14:04:11 JST [2012/08/05 1:04:11 ET]
Table 'Whirlpool' 9-max Seat #1 is the button
Seat 1: BlOnDhOlIc ($48.92 in chips) 
Seat 2: Th3Fog ($74.46 in chips) 
Seat 3: wtu1986 ($26.94 in chips) 
Seat 4: solawind ($16.56 in chips) 
Seat 5: taksist889 ($18.25 in chips) 
Seat 6: seula i ($25 in chips) 
Seat 7: fezman ($7.78 in chips) 
Seat 8: Anafim ($12.75 in chips) 
Seat 9: chiyuki ($41.02 in chips) 
Th3Fog: posts small blind $0.10
wtu1986: posts big blind $0.25
*** HOLE CARDS ***
Dealt to chiyuki [4h Kh]
solawind: folds 
taksist889: folds 
seula i: calls $0.25
fezman: folds 
Anafim: folds 
chiyuki: folds 
BlOnDhOlIc: raises $0.75 to $1
Th3Fog: folds 
wtu1986: folds 
seula i: calls $0.75
*** FLOP *** [9s 6s Kc]
seula i: checks 
BlOnDhOlIc: checks 
*** TURN *** [9s 6s Kc] [8h]
seula i: bets $1.50
BlOnDhOlIc: calls $1.50
*** RIVER *** [9s 6s Kc 8h] [9c]
seula i: bets $5.50
BlOnDhOlIc: folds 
Uncalled bet ($5.50) returned to seula i
seula i collected $5.11 from pot
seula i: doesn't show hand 
*** SUMMARY ***
Total pot $5.35 | Rake $0.24 
Board [9s 6s Kc 8h 9c]
Seat 1: BlOnDhOlIc (button) folded on the River
Seat 2: Th3Fog (small blind) folded before Flop
Seat 3: wtu1986 (big blind) folded before Flop
Seat 4: solawind folded before Flop (didn't bet)
Seat 5: taksist889 folded before Flop (didn't bet)
Seat 6: seula i collected ($5.11)
Seat 7: fezman folded before Flop (didn't bet)
Seat 8: Anafim folded before Flop (didn't bet)
Seat 9: chiyuki folded before Flop (didn't bet)



PokerStars Zoom Hand #84299218793:  Hold'em No Limit ($0.10/$0.25) - 2012/08/05 14:04:49 JST [2012/08/05 1:04:49 ET]
Table 'Whirlpool' 9-max Seat #1 is the button
Seat 1: PetitAlejo ($30.53 in chips) 
Seat 2: D@vidMed ($57.60 in chips) 
Seat 3: flyinprits ($43.94 in chips) 
Seat 4: Faraz ($26.30 in chips) 
Seat 5: Th3Fog ($17.39 in chips) 
Seat 6: Ellen1947 ($29.90 in chips) 
Seat 7: 123progress ($26.51 in chips) 
Seat 8: chiyuki ($40.77 in chips) 
Seat 9: cr0lox ($22.10 in chips) 
D@vidMed: posts small blind $0.10
flyinprits: posts big blind $0.25
*** HOLE CARDS ***
Dealt to chiyuki [Kd Kc]
Faraz: raises $0.50 to $0.75
Th3Fog: calls $0.75
Ellen1947: folds 
123progress: folds 
chiyuki: raises $2.25 to $3
cr0lox: folds 
PetitAlejo: folds 
D@vidMed: folds 
flyinprits: folds 
Faraz: calls $2.25
Th3Fog: folds 
*** FLOP *** [Qc Ah 6c]
Faraz: checks 
chiyuki: checks 
*** TURN *** [Qc Ah 6c] [2h]
Faraz: bets $0.75
chiyuki: calls $0.75
*** RIVER *** [Qc Ah 6c 2h] [3c]
Faraz: checks 
chiyuki: checks 
*** SHOW DOWN ***
Faraz: shows [Ts Td] (a pair of Tens)
chiyuki: shows [Kd Kc] (a pair of Kings)
chiyuki collected $8.21 from pot
*** SUMMARY ***
Total pot $8.60 | Rake $0.39 
Board [Qc Ah 6c 2h 3c]
Seat 1: PetitAlejo (button) folded before Flop (didn't bet)
Seat 2: D@vidMed (small blind) folded before Flop
Seat 3: flyinprits (big blind) folded before Flop
Seat 4: Faraz showed [Ts Td] and lost with a pair of Tens
Seat 5: Th3Fog folded before Flop
Seat 6: Ellen1947 folded before Flop (didn't bet)
Seat 7: 123progress folded before Flop (didn't bet)
Seat 8: chiyuki showed [Kd Kc] and won ($8.21) with a pair of Kings
Seat 9: cr0lox folded before Flop (didn't bet)



PokerStars Zoom Hand #84299239279:  Hold'em No Limit ($0.10/$0.25) - 2012/08/05 14:06:08 JST [2012/08/05 1:06:08 ET]
Table 'Whirlpool' 9-max Seat #1 is the button
Seat 1: 2997qwer ($8.50 in chips) 
Seat 2: seula i ($36.85 in chips) 
Seat 3: Suhoff76 ($42.66 in chips) 
Seat 4: Vahe50 ($10.97 in chips) 
Seat 5: Th3Fog ($49.06 in chips) 
Seat 6: chiyuki ($45.13 in chips) 
Seat 7: wtu1986 ($24.55 in chips) 
Seat 8: Ellen1947 ($29.90 in chips) 
Seat 9: Loholov ($16.73 in chips) 
seula i: posts small blind $0.10
Suhoff76: posts big blind $0.25
*** HOLE CARDS ***
Dealt to chiyuki [8s Jc]
Vahe50: folds 
Th3Fog: folds 
chiyuki: folds 
wtu1986: folds 
Ellen1947: folds 
Loholov: folds 
2997qwer: raises $0.50 to $0.75
seula i: folds 
Suhoff76: folds 
Uncalled bet ($0.50) returned to 2997qwer
2997qwer collected $0.60 from pot
2997qwer: doesn't show hand 
*** SUMMARY ***
Total pot $0.60 | Rake $0 
Seat 1: 2997qwer (button) collected ($0.60)
Seat 2: seula i (small blind) folded before Flop
Seat 3: Suhoff76 (big blind) folded before Flop
Seat 4: Vahe50 folded before Flop (didn't bet)
Seat 5: Th3Fog folded before Flop (didn't bet)
Seat 6: chiyuki folded before Flop (didn't bet)
Seat 7: wtu1986 folded before Flop (didn't bet)
Seat 8: Ellen1947 folded before Flop (didn't bet)
Seat 9: Loholov folded before Flop (didn't bet)



PokerStars Zoom Hand #84299240799:  Hold'em No Limit ($0.10/$0.25) - 2012/08/05 14:06:14 JST [2012/08/05 1:06:14 ET]
Table 'Whirlpool' 9-max Seat #1 is the button
Seat 1: deadmoneykid ($21.05 in chips) 
Seat 2: Nerkit ($11.75 in chips) 
Seat 3: KeLevro0 ($12.53 in chips) 
Seat 4: Perstenev ($13.72 in chips) 
Seat 5: chiyuki ($45.13 in chips) 
Seat 6: agurio ($25.68 in chips) 
Seat 7: BlOnDhOlIc ($61.96 in chips) 
Seat 8: Dan Royal ($29.36 in chips) 
Seat 9: Dejacob ($25 in chips) 
Nerkit: posts small blind $0.10
KeLevro0: posts big blind $0.25
*** HOLE CARDS ***
Dealt to chiyuki [6s 7d]
Perstenev: folds 
chiyuki: folds 
agurio: folds 
BlOnDhOlIc: folds 
Dan Royal: folds 
Dejacob: folds 
deadmoneykid: folds 
Nerkit: folds 
Uncalled bet ($0.15) returned to KeLevro0
KeLevro0 collected $0.20 from pot
KeLevro0: doesn't show hand 
*** SUMMARY ***
Total pot $0.20 | Rake $0 
Seat 1: deadmoneykid (button) folded before Flop (didn't bet)
Seat 2: Nerkit (small blind) folded before Flop
Seat 3: KeLevro0 (big blind) collected ($0.20)
Seat 4: Perstenev folded before Flop (didn't bet)
Seat 5: chiyuki folded before Flop (didn't bet)
Seat 6: agurio folded before Flop (didn't bet)
Seat 7: BlOnDhOlIc folded before Flop (didn't bet)
Seat 8: Dan Royal folded before Flop (didn't bet)
Seat 9: Dejacob folded before Flop (didn't bet)



PokerStars Zoom Hand #84299243238:  Hold'em No Limit ($0.10/$0.25) - 2012/08/05 14:06:24 JST [2012/08/05 1:06:24 ET]
Table 'Whirlpool' 9-max Seat #1 is the button
Seat 1: giorgos_k ($16.12 in chips) 
Seat 2: BlackZafiro ($25.10 in chips) 
Seat 3: ygoegoe ($27.16 in chips) 
Seat 4: chiyuki ($45.13 in chips) 
Seat 5: Landybob ($35.88 in chips) 
Seat 6: Th3Fog ($16.29 in chips) 
Seat 7: Loholov ($16.73 in chips) 
Seat 8: wtu1986 ($28.13 in chips) 
Seat 9: leo2095 ($14.42 in chips) 
BlackZafiro: posts small blind $0.10
ygoegoe: posts big blind $0.25
*** HOLE CARDS ***
Dealt to chiyuki [Td 2d]
chiyuki: folds 
Landybob: folds 
Th3Fog: folds 
Loholov: folds 
wtu1986: folds 
leo2095: folds 
giorgos_k: folds 
BlackZafiro: folds 
Uncalled bet ($0.15) returned to ygoegoe
ygoegoe collected $0.20 from pot
ygoegoe: doesn't show hand 
*** SUMMARY ***
Total pot $0.20 | Rake $0 
Seat 1: giorgos_k (button) folded before Flop (didn't bet)
Seat 2: BlackZafiro (small blind) folded before Flop
Seat 3: ygoegoe (big blind) collected ($0.20)
Seat 4: chiyuki folded before Flop (didn't bet)
Seat 5: Landybob folded before Flop (didn't bet)
Seat 6: Th3Fog folded before Flop (didn't bet)
Seat 7: Loholov folded before Flop (didn't bet)
Seat 8: wtu1986 folded before Flop (didn't bet)
Seat 9: leo2095 folded before Flop (didn't bet)



PokerStars Zoom Hand #84299241923:  Hold'em No Limit ($0.10/$0.25) - 2012/08/05 14:06:19 JST [2012/08/05 1:06:19 ET]
Table 'Whirlpool' 9-max Seat #1 is the button
Seat 1: seula i ($36.75 in chips) 
Seat 2: Perstenev ($13.72 in chips) 
Seat 3: RikkStroken ($21.22 in chips) 
Seat 4: chiyuki ($45.13 in chips) 
Seat 5: Dan Royal ($29.36 in chips) 
Seat 6: wtu1986 ($24.55 in chips) 
Seat 7: RomarioJa ($11.26 in chips) 
Seat 8: agurio ($25.68 in chips) 
Seat 9: Csabee21 ($25.29 in chips) 
Perstenev: posts small blind $0.10
RikkStroken: posts big blind $0.25
*** HOLE CARDS ***
Dealt to chiyuki [2c 3h]
chiyuki: folds 
Dan Royal: folds 
wtu1986: folds 
RomarioJa: folds 
agurio: folds 
Csabee21: folds 
seula i: folds 
Perstenev: folds 
Uncalled bet ($0.15) returned to RikkStroken
RikkStroken collected $0.20 from pot
RikkStroken: doesn't show hand 
*** SUMMARY ***
Total pot $0.20 | Rake $0 
Seat 1: seula i (button) folded before Flop (didn't bet)
Seat 2: Perstenev (small blind) folded before Flop
Seat 3: RikkStroken (big blind) collected ($0.20)
Seat 4: chiyuki folded before Flop (didn't bet)
Seat 5: Dan Royal folded before Flop (didn't bet)
Seat 6: wtu1986 folded before Flop (didn't bet)
Seat 7: RomarioJa folded before Flop (didn't bet)
Seat 8: agurio folded before Flop (didn't bet)
Seat 9: Csabee21 folded before Flop (didn't bet)



PokerStars Zoom Hand #84299244270:  Hold'em No Limit ($0.10/$0.25) - 2012/08/05 14:06:28 JST [2012/08/05 1:06:28 ET]
Table 'Whirlpool' 9-max Seat #1 is the button
Seat 1: 2997qwer ($12.15 in chips) 
Seat 2: Landybob ($35.88 in chips) 
Seat 3: silvno31 ($41.04 in chips) 
Seat 4: seula i ($27.26 in chips) 
Seat 5: Tom1999 ($9.63 in chips) 
Seat 6: munky3 ($34.47 in chips) 
Seat 7: chiyuki ($45.13 in chips) 
Seat 8: deadmoneykid ($24.15 in chips) 
Seat 9: agurio ($25.68 in chips) 
Landybob: posts small blind $0.10
silvno31: posts big blind $0.25
*** HOLE CARDS ***
Dealt to chiyuki [6s 5c]
seula i: raises $0.25 to $0.50
Tom1999: folds 
munky3: folds 
chiyuki: folds 
deadmoneykid: folds 
agurio: folds 
2997qwer: folds 
Landybob: folds 
silvno31: folds 
Uncalled bet ($0.25) returned to seula i
seula i collected $0.60 from pot
seula i: doesn't show hand 
*** SUMMARY ***
Total pot $0.60 | Rake $0 
Seat 1: 2997qwer (button) folded before Flop (didn't bet)
Seat 2: Landybob (small blind) folded before Flop
Seat 3: silvno31 (big blind) folded before Flop
Seat 4: seula i collected ($0.60)
Seat 5: Tom1999 folded before Flop (didn't bet)
Seat 6: munky3 folded before Flop (didn't bet)
Seat 7: chiyuki folded before Flop (didn't bet)
Seat 8: deadmoneykid folded before Flop (didn't bet)
Seat 9: agurio folded before Flop (didn't bet)



PokerStars Zoom Hand #84299245670:  Hold'em No Limit ($0.10/$0.25) - 2012/08/05 14:06:33 JST [2012/08/05 1:06:33 ET]
Table 'Whirlpool' 9-max Seat #1 is the button
Seat 1: kamikkaze ($18.13 in chips) 
Seat 2: 2997qwer ($12.25 in chips) 
Seat 3: chiyuki ($45.13 in chips) 
Seat 4: 123progress ($39.30 in chips) 
Seat 5: BlOnDhOlIc ($45.57 in chips) 
Seat 6: KeLevro0 ($12.15 in chips) 
Seat 7: agurio ($25.68 in chips) 
Seat 8: Ellen1947 ($36.86 in chips) 
Seat 9: Landybob ($35.78 in chips) 
2997qwer: posts small blind $0.10
chiyuki: posts big blind $0.25
*** HOLE CARDS ***
Dealt to chiyuki [2d 9d]
123progress has timed out
123progress: folds 
BlOnDhOlIc: folds 
KeLevro0: folds 
agurio: folds 
Ellen1947: folds 
Landybob: folds 
kamikkaze: raises $0.50 to $0.75
2997qwer: folds 
chiyuki: folds 
Uncalled bet ($0.50) returned to kamikkaze
kamikkaze collected $0.60 from pot
kamikkaze: doesn't show hand 
*** SUMMARY ***
Total pot $0.60 | Rake $0 
Seat 1: kamikkaze (button) collected ($0.60)
Seat 2: 2997qwer (small blind) folded before Flop
Seat 3: chiyuki (big blind) folded before Flop
Seat 4: 123progress folded before Flop (didn't bet)
Seat 5: BlOnDhOlIc folded before Flop (didn't bet)
Seat 6: KeLevro0 folded before Flop (didn't bet)
Seat 7: agurio folded before Flop (didn't bet)
Seat 8: Ellen1947 folded before Flop (didn't bet)
Seat 9: Landybob folded before Flop (didn't bet)



PokerStars Zoom Hand #84299238299:  Hold'em No Limit ($0.10/$0.25) - 2012/08/05 14:06:04 JST [2012/08/05 1:06:04 ET]
Table 'Whirlpool' 9-max Seat #1 is the button
Seat 1: carlosrbr ($19.89 in chips) 
Seat 2: chiyuki ($45.23 in chips) 
Seat 3: puffy5533 ($21.20 in chips) 
Seat 4: Perstenev ($13.72 in chips) 
Seat 5: RomarioJa ($5.70 in chips) 
Seat 6: seula i ($66.37 in chips) 
Seat 7: Th3Fog ($49.06 in chips) 
Seat 8: giorgos_k ($42.39 in chips) 
Seat 9: hirozo ($30.65 in chips) 
chiyuki: posts small blind $0.10
puffy5533: posts big blind $0.25
*** HOLE CARDS ***
Dealt to chiyuki [4c 2d]
Perstenev: folds 
RomarioJa: folds 
seula i: folds 
Th3Fog: folds 
giorgos_k: calls $0.25
hirozo: calls $0.25
carlosrbr: raises $1 to $1.25
chiyuki: folds 
puffy5533: folds 
giorgos_k: calls $1
hirozo: calls $1
*** FLOP *** [7c 6h Ac]
giorgos_k: bets $1.25
hirozo: calls $1.25
carlosrbr: folds 
*** TURN *** [7c 6h Ac] [9c]
giorgos_k: bets $1.25
hirozo: calls $1.25
*** RIVER *** [7c 6h Ac 9c] [8c]
giorgos_k: checks 
hirozo: checks 
*** SHOW DOWN ***
giorgos_k: shows [As Qs] (a pair of Aces)
hirozo: shows [7d 9d] (two pair, Nines and Sevens)
hirozo collected $8.69 from pot
*** SUMMARY ***
Total pot $9.10 | Rake $0.41 
Board [7c 6h Ac 9c 8c]
Seat 1: carlosrbr (button) folded on the Flop
Seat 2: chiyuki (small blind) folded before Flop
Seat 3: puffy5533 (big blind) folded before Flop
Seat 4: Perstenev folded before Flop (didn't bet)
Seat 5: RomarioJa folded before Flop (didn't bet)
Seat 6: seula i folded before Flop (didn't bet)
Seat 7: Th3Fog folded before Flop (didn't bet)
Seat 8: giorgos_k showed [As Qs] and lost with a pair of Aces
Seat 9: hirozo showed [7d 9d] and won ($8.69) with two pair, Nines and Sevens



PokerStars Zoom Hand #84299252537:  Hold'em No Limit ($0.10/$0.25) - 2012/08/05 14:06:59 JST [2012/08/05 1:06:59 ET]
Table 'Whirlpool' 9-max Seat #1 is the button
Seat 1: Tom1999 ($22.26 in chips) 
Seat 2: ygoegoe ($35.24 in chips) 
Seat 3: kamikkaze ($10.61 in chips) 
Seat 4: BlOnDhOlIc ($25.18 in chips) 
Seat 5: Paranoix1990 ($11.68 in chips) 
Seat 6: Roglus ($15.03 in chips) 
Seat 7: 2997qwer ($12.15 in chips) 
Seat 8: PetitAlejo ($35.56 in chips) 
Seat 9: chiyuki ($44.88 in chips) 
ygoegoe: posts small blind $0.10
kamikkaze: posts big blind $0.25
*** HOLE CARDS ***
Dealt to chiyuki [8s Qc]
BlOnDhOlIc: folds 
Paranoix1990: folds 
Roglus: folds 
2997qwer: folds 
PetitAlejo: folds 
chiyuki: folds 
Tom1999: folds 
ygoegoe: folds 
Uncalled bet ($0.15) returned to kamikkaze
kamikkaze collected $0.20 from pot
kamikkaze: doesn't show hand 
*** SUMMARY ***
Total pot $0.20 | Rake $0 
Seat 1: Tom1999 (button) folded before Flop (didn't bet)
Seat 2: ygoegoe (small blind) folded before Flop
Seat 3: kamikkaze (big blind) collected ($0.20)
Seat 4: BlOnDhOlIc folded before Flop (didn't bet)
Seat 5: Paranoix1990 folded before Flop (didn't bet)
Seat 6: Roglus folded before Flop (didn't bet)
Seat 7: 2997qwer folded before Flop (didn't bet)
Seat 8: PetitAlejo folded before Flop (didn't bet)
Seat 9: chiyuki folded before Flop (didn't bet)



PokerStars Zoom Hand #84299254408:  Hold'em No Limit ($0.10/$0.25) - 2012/08/05 14:07:06 JST [2012/08/05 1:07:06 ET]
Table 'Whirlpool' 9-max Seat #1 is the button
Seat 1: chiyuki ($44.88 in chips) 
Seat 2: Tom1999 ($22.26 in chips) 
Seat 3: Ellen1947 ($29.90 in chips) 
Seat 4: Nerkit ($15.80 in chips) 
Seat 5: peng2astic ($17.91 in chips) 
Seat 6: solawind ($11.21 in chips) 
Seat 7: BlOnDhOlIc ($58.30 in chips) 
Seat 8: 2997qwer ($8.85 in chips) 
Seat 9: jallu435 ($24.25 in chips) 
Tom1999: posts small blind $0.10
Ellen1947: posts big blind $0.25
*** HOLE CARDS ***
Dealt to chiyuki [9c 4h]
Nerkit: folds 
peng2astic: raises $0.75 to $1
solawind: folds 
BlOnDhOlIc: folds 
2997qwer: folds 
jallu435: folds 
chiyuki: folds 
Tom1999: folds 
Ellen1947: folds 
Uncalled bet ($0.75) returned to peng2astic
peng2astic collected $0.60 from pot
peng2astic: doesn't show hand 
*** SUMMARY ***
Total pot $0.60 | Rake $0 
Seat 1: chiyuki (button) folded before Flop (didn't bet)
Seat 2: Tom1999 (small blind) folded before Flop
Seat 3: Ellen1947 (big blind) folded before Flop
Seat 4: Nerkit folded before Flop (didn't bet)
Seat 5: peng2astic collected ($0.60)
Seat 6: solawind folded before Flop (didn't bet)
Seat 7: BlOnDhOlIc folded before Flop (didn't bet)
Seat 8: 2997qwer folded before Flop (didn't bet)
Seat 9: jallu435 folded before Flop (didn't bet)



PokerStars Zoom Hand #84299255401:  Hold'em No Limit ($0.10/$0.25) - 2012/08/05 14:07:10 JST [2012/08/05 1:07:10 ET]
Table 'Whirlpool' 9-max Seat #1 is the button
Seat 1: Roglus ($15.03 in chips) 
Seat 2: agurio ($25.78 in chips) 
Seat 3: Nerkit ($11.65 in chips) 
Seat 4: Dejacob ($25.60 in chips) 
Seat 5: solawind ($11.21 in chips) 
Seat 6: chiyuki ($44.88 in chips) 
Seat 7: wtu1986 ($24.65 in chips) 
Seat 8: Tom1999 ($22.16 in chips) 
Seat 9: RikkStroken ($30.83 in chips) 
agurio: posts small blind $0.10
Nerkit: posts big blind $0.25
*** HOLE CARDS ***
Dealt to chiyuki [Kh 5h]
Dejacob: folds 
solawind: folds 
chiyuki: folds 
wtu1986: folds 
Tom1999: folds 
RikkStroken: folds 
Roglus: folds 
agurio: folds 
Uncalled bet ($0.15) returned to Nerkit
Nerkit collected $0.20 from pot
Nerkit: doesn't show hand 
*** SUMMARY ***
Total pot $0.20 | Rake $0 
Seat 1: Roglus (button) folded before Flop (didn't bet)
Seat 2: agurio (small blind) folded before Flop
Seat 3: Nerkit (big blind) collected ($0.20)
Seat 4: Dejacob folded before Flop (didn't bet)
Seat 5: solawind folded before Flop (didn't bet)
Seat 6: chiyuki folded before Flop (didn't bet)
Seat 7: wtu1986 folded before Flop (didn't bet)
Seat 8: Tom1999 folded before Flop (didn't bet)
Seat 9: RikkStroken folded before Flop (didn't bet)



PokerStars Zoom Hand #84299256432:  Hold'em No Limit ($0.10/$0.25) - 2012/08/05 14:07:14 JST [2012/08/05 1:07:14 ET]
Table 'Whirlpool' 9-max Seat #1 is the button
Seat 1: ygoegoe ($35.14 in chips) 
Seat 2: chiyuki ($44.88 in chips) 
Seat 3: jeff0923 ($24.68 in chips) 
Seat 4: Roglus ($15.03 in chips) 
Seat 5: cR!Ma*aRm ($21.79 in chips) 
Seat 6: troms20 ($25 in chips) 
Seat 7: KeLevro0 ($12.53 in chips) 
Seat 8: 2997qwer ($12.40 in chips) 
Seat 9: PetitAlejo ($25.29 in chips) 
chiyuki: posts small blind $0.10
jeff0923: posts big blind $0.25
*** HOLE CARDS ***
Dealt to chiyuki [4s 4h]
Roglus: folds 
cR!Ma*aRm: raises $0.25 to $0.50
troms20: folds 
KeLevro0: folds 
2997qwer: folds 
PetitAlejo: folds 
ygoegoe: folds 
chiyuki: calls $0.40
jeff0923: folds 
*** FLOP *** [5d 2c 3h]
chiyuki: checks 
cR!Ma*aRm: bets $0.25
chiyuki: raises $0.75 to $1
cR!Ma*aRm: folds 
Uncalled bet ($0.75) returned to chiyuki
chiyuki collected $1.67 from pot
chiyuki: doesn't show hand 
*** SUMMARY ***
Total pot $1.75 | Rake $0.08 
Board [5d 2c 3h]
Seat 1: ygoegoe (button) folded before Flop (didn't bet)
Seat 2: chiyuki (small blind) collected ($1.67)
Seat 3: jeff0923 (big blind) folded before Flop
Seat 4: Roglus folded before Flop (didn't bet)
Seat 5: cR!Ma*aRm folded on the Flop
Seat 6: troms20 folded before Flop (didn't bet)
Seat 7: KeLevro0 folded before Flop (didn't bet)
Seat 8: 2997qwer folded before Flop (didn't bet)
Seat 9: PetitAlejo folded before Flop (didn't bet)



PokerStars Zoom Hand #84299268344:  Hold'em No Limit ($0.10/$0.25) - 2012/08/05 14:08:01 JST [2012/08/05 1:08:01 ET]
Table 'Whirlpool' 9-max Seat #1 is the button
Seat 1: Nerkit ($12.50 in chips) 
Seat 2: Landybob ($37.51 in chips) 
Seat 3: kamikkaze ($10.61 in chips) 
Seat 4: 2997qwer ($12.62 in chips) 
Seat 5: Loholov ($19.24 in chips) 
Seat 6: Vahe50 ($13.50 in chips) 
Seat 7: agurio ($26.92 in chips) 
Seat 8: chiyuki ($45.80 in chips) 
Seat 9: Perstenev ($12.17 in chips) 
Landybob: posts small blind $0.10
kamikkaze: posts big blind $0.25
*** HOLE CARDS ***
Dealt to chiyuki [5c 3d]
2997qwer: folds 
Loholov: folds 
Vahe50: folds 
agurio: raises $0.75 to $1
chiyuki: folds 
Perstenev: folds 
Nerkit: folds 
Landybob: folds 
kamikkaze: folds 
Uncalled bet ($0.75) returned to agurio
agurio collected $0.60 from pot
agurio: doesn't show hand 
*** SUMMARY ***
Total pot $0.60 | Rake $0 
Seat 1: Nerkit (button) folded before Flop (didn't bet)
Seat 2: Landybob (small blind) folded before Flop
Seat 3: kamikkaze (big blind) folded before Flop
Seat 4: 2997qwer folded before Flop (didn't bet)
Seat 5: Loholov folded before Flop (didn't bet)
Seat 6: Vahe50 folded before Flop (didn't bet)
Seat 7: agurio collected ($0.60)
Seat 8: chiyuki folded before Flop (didn't bet)
Seat 9: Perstenev folded before Flop (didn't bet)



PokerStars Zoom Hand #84299269621:  Hold'em No Limit ($0.10/$0.25) - 2012/08/05 14:08:06 JST [2012/08/05 1:08:06 ET]
Table 'Whirlpool' 9-max Seat #1 is the button
Seat 1: 2997qwer ($12.62 in chips) 
Seat 2: smartrisk15 ($12.25 in chips) 
Seat 3: eyesJeJa ($25 in chips) 
Seat 4: Th3Fog ($48.71 in chips) 
Seat 5: hirozo ($29.57 in chips) 
Seat 6: BlackZafiro ($25 in chips) 
Seat 7: chiyuki ($45.80 in chips) 
Seat 8: deadmoneykid ($21.63 in chips) 
Seat 9: BlOnDhOlIc ($57.95 in chips) 
smartrisk15: posts small blind $0.10
eyesJeJa: posts big blind $0.25
*** HOLE CARDS ***
Dealt to chiyuki [4c 9c]
Th3Fog: folds 
hirozo: folds 
BlackZafiro: folds 
chiyuki: folds 
deadmoneykid: folds 
BlOnDhOlIc: folds 
2997qwer: raises $0.50 to $0.75
smartrisk15: folds 
eyesJeJa: folds 
Uncalled bet ($0.50) returned to 2997qwer
2997qwer collected $0.60 from pot
2997qwer: doesn't show hand 
*** SUMMARY ***
Total pot $0.60 | Rake $0 
Seat 1: 2997qwer (button) collected ($0.60)
Seat 2: smartrisk15 (small blind) folded before Flop
Seat 3: eyesJeJa (big blind) folded before Flop
Seat 4: Th3Fog folded before Flop (didn't bet)
Seat 5: hirozo folded before Flop (didn't bet)
Seat 6: BlackZafiro folded before Flop (didn't bet)
Seat 7: chiyuki folded before Flop (didn't bet)
Seat 8: deadmoneykid folded before Flop (didn't bet)
Seat 9: BlOnDhOlIc folded before Flop (didn't bet)



PokerStars Zoom Hand #84299271671:  Hold'em No Limit ($0.10/$0.25) - 2012/08/05 14:08:14 JST [2012/08/05 1:08:14 ET]
Table 'Whirlpool' 9-max Seat #1 is the button
Seat 1: troms20 ($25 in chips) 
Seat 2: munky3 ($38.54 in chips) 
Seat 3: Déculotter69 ($18.55 in chips) 
Seat 4: puffy5533 ($21.77 in chips) 
Seat 5: chiyuki ($45.80 in chips) 
Seat 6: kamikkaze ($10.36 in chips) 
Seat 7: BlOnDhOlIc ($72.61 in chips) 
Seat 8: Nerkit ($12.50 in chips) 
Seat 9: jeff0923 ($23.65 in chips) 
munky3: posts small blind $0.10
Déculotter69: posts big blind $0.25
*** HOLE CARDS ***
Dealt to chiyuki [2d 7h]
puffy5533: folds 
chiyuki: folds 
kamikkaze: folds 
BlOnDhOlIc: raises $0.25 to $0.50
Nerkit has timed out
Nerkit: folds 
jeff0923: calls $0.50
troms20: folds 
munky3: folds 
Déculotter69: folds 
*** FLOP *** [8d Kc Qh]
BlOnDhOlIc: bets $0.64
jeff0923: calls $0.64
*** TURN *** [8d Kc Qh] [5h]
BlOnDhOlIc: checks 
jeff0923: checks 
*** RIVER *** [8d Kc Qh 5h] [9d]
BlOnDhOlIc: checks 
jeff0923: checks 
*** SHOW DOWN ***
BlOnDhOlIc: shows [As 3s] (high card Ace)
jeff0923: shows [8h Ah] (a pair of Eights)
jeff0923 collected $2.51 from pot
*** SUMMARY ***
Total pot $2.63 | Rake $0.12 
Board [8d Kc Qh 5h 9d]
Seat 1: troms20 (button) folded before Flop (didn't bet)
Seat 2: munky3 (small blind) folded before Flop
Seat 3: Déculotter69 (big blind) folded before Flop
Seat 4: puffy5533 folded before Flop (didn't bet)
Seat 5: chiyuki folded before Flop (didn't bet)
Seat 6: kamikkaze folded before Flop (didn't bet)
Seat 7: BlOnDhOlIc showed [As 3s] and lost with high card Ace
Seat 8: Nerkit folded before Flop (didn't bet)
Seat 9: jeff0923 showed [8h Ah] and won ($2.51) with a pair of Eights



PokerStars Zoom Hand #84299274988:  Hold'em No Limit ($0.10/$0.25) - 2012/08/05 14:08:27 JST [2012/08/05 1:08:27 ET]
Table 'Whirlpool' 9-max Seat #1 is the button
Seat 1: PetitAlejo ($34.76 in chips) 
Seat 2: ChrisCDee ($32.78 in chips) 
Seat 3: chiyuki ($45.80 in chips) 
Seat 4: kamikkaze ($35.05 in chips) 
Seat 5: Th3Fog ($72.21 in chips) 
Seat 6: Dejacob ($25 in chips) 
Seat 7: Spartacus675 ($24.65 in chips) 
Seat 8: RomarioJa ($11.61 in chips) 
Seat 9: BlackZafiro ($45.26 in chips) 
ChrisCDee: posts small blind $0.10
chiyuki: posts big blind $0.25
*** HOLE CARDS ***
Dealt to chiyuki [Jc Tc]
kamikkaze: folds 
Th3Fog: folds 
Dejacob: folds 
Spartacus675: raises $0.50 to $0.75
RomarioJa: folds 
BlackZafiro: folds 
PetitAlejo: folds 
ChrisCDee: calls $0.65
chiyuki: folds 
*** FLOP *** [Qc Kd 2h]
ChrisCDee: checks 
Spartacus675: bets $1
ChrisCDee: folds 
Uncalled bet ($1) returned to Spartacus675
Spartacus675 collected $1.67 from pot
Spartacus675: doesn't show hand 
*** SUMMARY ***
Total pot $1.75 | Rake $0.08 
Board [Qc Kd 2h]
Seat 1: PetitAlejo (button) folded before Flop (didn't bet)
Seat 2: ChrisCDee (small blind) folded on the Flop
Seat 3: chiyuki (big blind) folded before Flop
Seat 4: kamikkaze folded before Flop (didn't bet)
Seat 5: Th3Fog folded before Flop (didn't bet)
Seat 6: Dejacob folded before Flop (didn't bet)
Seat 7: Spartacus675 collected ($1.67)
Seat 8: RomarioJa folded before Flop (didn't bet)
Seat 9: BlackZafiro folded before Flop (didn't bet)



PokerStars Zoom Hand #84299285934:  Hold'em No Limit ($0.10/$0.25) - 2012/08/05 14:09:10 JST [2012/08/05 1:09:10 ET]
Table 'Whirlpool' 9-max Seat #1 is the button
Seat 1: troms20 ($24.75 in chips) 
Seat 2: chiyuki ($45.55 in chips) 
Seat 3: flyinprits ($36.84 in chips) 
Seat 4: munky3 ($37.31 in chips) 
Seat 5: Scruf13 ($12.39 in chips) 
Seat 6: ladymadon107 ($6.58 in chips) 
Seat 7: Perstenev ($12.85 in chips) 
Seat 8: BlackZafiro ($45.26 in chips) 
Seat 9: RomarioJa ($9.37 in chips) 
chiyuki: posts small blind $0.10
flyinprits: posts big blind $0.25
*** HOLE CARDS ***
Dealt to chiyuki [8c 9s]
munky3: folds 
Scruf13: raises $0.75 to $1
ladymadon107: folds 
Perstenev: folds 
BlackZafiro: folds 
RomarioJa: folds 
troms20: folds 
chiyuki: folds 
flyinprits: folds 
Uncalled bet ($0.75) returned to Scruf13
Scruf13 collected $0.60 from pot
Scruf13: doesn't show hand 
*** SUMMARY ***
Total pot $0.60 | Rake $0 
Seat 1: troms20 (button) folded before Flop (didn't bet)
Seat 2: chiyuki (small blind) folded before Flop
Seat 3: flyinprits (big blind) folded before Flop
Seat 4: munky3 folded before Flop (didn't bet)
Seat 5: Scruf13 collected ($0.60)
Seat 6: ladymadon107 folded before Flop (didn't bet)
Seat 7: Perstenev folded before Flop (didn't bet)
Seat 8: BlackZafiro folded before Flop (didn't bet)
Seat 9: RomarioJa folded before Flop (didn't bet)



PokerStars Zoom Hand #84299278134:  Hold'em No Limit ($0.10/$0.25) - 2012/08/05 14:08:40 JST [2012/08/05 1:08:40 ET]
Table 'Whirlpool' 9-max Seat #1 is the button
Seat 1: ll_LaMeR_ll ($65.16 in chips) 
Seat 2: RikkStroken ($20.97 in chips) 
Seat 3: 123progress ($25.26 in chips) 
Seat 4: Roglus ($81.21 in chips) 
Seat 5: PakisR ($11.65 in chips) 
Seat 6: Csabee21 ($22.04 in chips) 
Seat 7: wtu1986 ($28.10 in chips) 
Seat 8: chiyuki ($45.55 in chips) 
Seat 9: ygoegoe ($27.86 in chips) 
RikkStroken: posts small blind $0.10
123progress: posts big blind $0.25
*** HOLE CARDS ***
Dealt to chiyuki [Kd Tc]
Roglus: calls $0.25
PakisR: folds 
Csabee21: folds 
wtu1986: folds 
chiyuki: folds 
ygoegoe: folds 
ll_LaMeR_ll: folds 
RikkStroken: calls $0.15
123progress: checks 
*** FLOP *** [3c 2d 9d]
RikkStroken: bets $0.75
123progress: folds 
Roglus: folds 
Uncalled bet ($0.75) returned to RikkStroken
RikkStroken collected $0.72 from pot
RikkStroken: doesn't show hand 
*** SUMMARY ***
Total pot $0.75 | Rake $0.03 
Board [3c 2d 9d]
Seat 1: ll_LaMeR_ll (button) folded before Flop (didn't bet)
Seat 2: RikkStroken (small blind) collected ($0.72)
Seat 3: 123progress (big blind) folded on the Flop
Seat 4: Roglus folded on the Flop
Seat 5: PakisR folded before Flop (didn't bet)
Seat 6: Csabee21 folded before Flop (didn't bet)
Seat 7: wtu1986 folded before Flop (didn't bet)
Seat 8: chiyuki folded before Flop (didn't bet)
Seat 9: ygoegoe folded before Flop (didn't bet)



PokerStars Zoom Hand #84299273422:  Hold'em No Limit ($0.10/$0.25) - 2012/08/05 14:08:21 JST [2012/08/05 1:08:21 ET]
Table 'Whirlpool' 9-max Seat #1 is the button
Seat 1: Anafim ($12.50 in chips) 
Seat 2: wtu1986 ($25.88 in chips) 
Seat 3: Perstenev ($12.17 in chips) 
Seat 4: deadmoneykid ($21.63 in chips) 
Seat 5: chiyuki ($45.80 in chips) 
Seat 6: BlOnDhOlIc ($25 in chips) 
Seat 7: Th3Fog ($72.21 in chips) 
Seat 8: agurio ($27.27 in chips) 
Seat 9: Dan Royal ($29.36 in chips) 
wtu1986: posts small blind $0.10
Perstenev: posts big blind $0.25
*** HOLE CARDS ***
Dealt to chiyuki [8h 6d]
deadmoneykid: calls $0.25
chiyuki: folds 
BlOnDhOlIc: raises $0.75 to $1
Th3Fog: folds 
agurio: folds 
Dan Royal: folds 
Anafim: folds 
wtu1986: folds 
Perstenev: folds 
deadmoneykid: calls $0.75
*** FLOP *** [6h 9s 3c]
deadmoneykid: checks 
BlOnDhOlIc: bets $1.50
deadmoneykid: folds 
Uncalled bet ($1.50) returned to BlOnDhOlIc
BlOnDhOlIc collected $2.24 from pot
BlOnDhOlIc: doesn't show hand 
*** SUMMARY ***
Total pot $2.35 | Rake $0.11 
Board [6h 9s 3c]
Seat 1: Anafim (button) folded before Flop (didn't bet)
Seat 2: wtu1986 (small blind) folded before Flop
Seat 3: Perstenev (big blind) folded before Flop
Seat 4: deadmoneykid folded on the Flop
Seat 5: chiyuki folded before Flop (didn't bet)
Seat 6: BlOnDhOlIc collected ($2.24)
Seat 7: Th3Fog folded before Flop (didn't bet)
Seat 8: agurio folded before Flop (didn't bet)
Seat 9: Dan Royal folded before Flop (didn't bet)



PokerStars Zoom Hand #84299289929:  Hold'em No Limit ($0.10/$0.25) - 2012/08/05 14:09:25 JST [2012/08/05 1:09:25 ET]
Table 'Whirlpool' 9-max Seat #1 is the button
Seat 1: Tom1999 ($7.28 in chips) 
Seat 2: 2997qwer ($12.90 in chips) 
Seat 3: Perstenev ($11.50 in chips) 
Seat 4: hirozo ($29.57 in chips) 
Seat 5: RomarioJa ($11.96 in chips) 
Seat 6: chiyuki ($45.45 in chips) 
Seat 7: 123progress ($25.01 in chips) 
Seat 8: Dejacob ($58.09 in chips) 
Seat 9: BlackZafiro ($25 in chips) 
2997qwer: posts small blind $0.10
Perstenev: posts big blind $0.25
*** HOLE CARDS ***
Dealt to chiyuki [Kd 4c]
hirozo: folds 
RomarioJa: folds 
chiyuki: folds 
123progress: raises $0.37 to $0.62
Dejacob: folds 
BlackZafiro: folds 
Tom1999: folds 
2997qwer: folds 
Perstenev: folds 
Uncalled bet ($0.37) returned to 123progress
123progress collected $0.60 from pot
123progress: doesn't show hand 
*** SUMMARY ***
Total pot $0.60 | Rake $0 
Seat 1: Tom1999 (button) folded before Flop (didn't bet)
Seat 2: 2997qwer (small blind) folded before Flop
Seat 3: Perstenev (big blind) folded before Flop
Seat 4: hirozo folded before Flop (didn't bet)
Seat 5: RomarioJa folded before Flop (didn't bet)
Seat 6: chiyuki folded before Flop (didn't bet)
Seat 7: 123progress collected ($0.60)
Seat 8: Dejacob folded before Flop (didn't bet)
Seat 9: BlackZafiro folded before Flop (didn't bet)



PokerStars Zoom Hand #84299291717:  Hold'em No Limit ($0.10/$0.25) - 2012/08/05 14:09:32 JST [2012/08/05 1:09:32 ET]
Table 'Whirlpool' 9-max Seat #1 is the button
Seat 1: 2997qwer ($12.62 in chips) 
Seat 2: cr0lox ($20.40 in chips) 
Seat 3: Scruf13 ($12.64 in chips) 
Seat 4: BlackZafiro ($25 in chips) 
Seat 5: agurio ($27.62 in chips) 
Seat 6: flyinprits ($40.84 in chips) 
Seat 7: eyesJeJa ($25 in chips) 
Seat 8: ladymadon107 ($6.93 in chips) 
Seat 9: chiyuki ($45.45 in chips) 
cr0lox: posts small blind $0.10
Scruf13: posts big blind $0.25
*** HOLE CARDS ***
Dealt to chiyuki [6h 9c]
BlackZafiro: folds 
agurio: folds 
flyinprits: folds 
eyesJeJa: folds 
ladymadon107: folds 
chiyuki: folds 
2997qwer: folds 
cr0lox: folds 
Uncalled bet ($0.15) returned to Scruf13
Scruf13 collected $0.20 from pot
Scruf13: doesn't show hand 
*** SUMMARY ***
Total pot $0.20 | Rake $0 
Seat 1: 2997qwer (button) folded before Flop (didn't bet)
Seat 2: cr0lox (small blind) folded before Flop
Seat 3: Scruf13 (big blind) collected ($0.20)
Seat 4: BlackZafiro folded before Flop (didn't bet)
Seat 5: agurio folded before Flop (didn't bet)
Seat 6: flyinprits folded before Flop (didn't bet)
Seat 7: eyesJeJa folded before Flop (didn't bet)
Seat 8: ladymadon107 folded before Flop (didn't bet)
Seat 9: chiyuki folded before Flop (didn't bet)



PokerStars Zoom Hand #84299283829:  Hold'em No Limit ($0.10/$0.25) - 2012/08/05 14:09:02 JST [2012/08/05 1:09:02 ET]
Table 'Whirlpool' 9-max Seat #1 is the button
Seat 1: chiyuki ($45.55 in chips) 
Seat 2: KeLevro0 ($12.15 in chips) 
Seat 3: silvno31 ($37.39 in chips) 
Seat 4: kkbruins0408 ($10.30 in chips) 
Seat 5: PetitAlejo ($35.46 in chips) 
Seat 6: 2997qwer ($12.90 in chips) 
Seat 7: agurio ($27.27 in chips) 
Seat 8: munky3 ($37.31 in chips) 
Seat 9: RikkStroken ($31.53 in chips) 
KeLevro0: posts small blind $0.10
silvno31: posts big blind $0.25
*** HOLE CARDS ***
Dealt to chiyuki [4h Qh]
kkbruins0408: calls $0.25
PetitAlejo: folds 
2997qwer: folds 
agurio: folds 
munky3: folds 
RikkStroken: raises $0.75 to $1
chiyuki: folds 
KeLevro0: folds 
silvno31: calls $0.75
kkbruins0408: calls $0.75
*** FLOP *** [6h 5d 5c]
silvno31: checks 
kkbruins0408: bets $9.30 and is all-in
RikkStroken: calls $9.30
silvno31: folds 
*** TURN *** [6h 5d 5c] [7d]
*** RIVER *** [6h 5d 5c 7d] [Ad]
*** SHOW DOWN ***
kkbruins0408: shows [Ac 7h] (two pair, Aces and Sevens)
RikkStroken: shows [8c 8h] (two pair, Eights and Fives)
kkbruins0408 collected $20.72 from pot
*** SUMMARY ***
Total pot $21.70 | Rake $0.98 
Board [6h 5d 5c 7d Ad]
Seat 1: chiyuki (button) folded before Flop (didn't bet)
Seat 2: KeLevro0 (small blind) folded before Flop
Seat 3: silvno31 (big blind) folded on the Flop
Seat 4: kkbruins0408 showed [Ac 7h] and won ($20.72) with two pair, Aces and Sevens
Seat 5: PetitAlejo folded before Flop (didn't bet)
Seat 6: 2997qwer folded before Flop (didn't bet)
Seat 7: agurio folded before Flop (didn't bet)
Seat 8: munky3 folded before Flop (didn't bet)
Seat 9: RikkStroken showed [8c 8h] and lost with two pair, Eights and Fives



PokerStars Zoom Hand #84299293268:  Hold'em No Limit ($0.10/$0.25) - 2012/08/05 14:09:38 JST [2012/08/05 1:09:38 ET]
Table 'Whirlpool' 9-max Seat #1 is the button
Seat 1: KeLevro0 ($12.25 in chips) 
Seat 2: silvno31 ($36.39 in chips) 
Seat 3: 2997qwer ($12.80 in chips) 
Seat 4: Tom1999 ($7.28 in chips) 
Seat 5: chiyuki ($45.45 in chips) 
Seat 6: GoldNutter ($26.19 in chips) 
Seat 7: troms20 ($29.53 in chips) 
Seat 8: PetitAlejo ($34.51 in chips) 
Seat 9: wtu1986 ($28 in chips) 
silvno31: posts small blind $0.10
2997qwer: posts big blind $0.25
*** HOLE CARDS ***
Dealt to chiyuki [Jd 6c]
Tom1999: folds 
chiyuki: folds 
GoldNutter: folds 
troms20: folds 
PetitAlejo: folds 
wtu1986: folds 
KeLevro0: folds 
silvno31: folds 
Uncalled bet ($0.15) returned to 2997qwer
2997qwer collected $0.20 from pot
2997qwer: doesn't show hand 
*** SUMMARY ***
Total pot $0.20 | Rake $0 
Seat 1: KeLevro0 (button) folded before Flop (didn't bet)
Seat 2: silvno31 (small blind) folded before Flop
Seat 3: 2997qwer (big blind) collected ($0.20)
Seat 4: Tom1999 folded before Flop (didn't bet)
Seat 5: chiyuki folded before Flop (didn't bet)
Seat 6: GoldNutter folded before Flop (didn't bet)
Seat 7: troms20 folded before Flop (didn't bet)
Seat 8: PetitAlejo folded before Flop (didn't bet)
Seat 9: wtu1986 folded before Flop (didn't bet)



PokerStars Zoom Hand #84299288373:  Hold'em No Limit ($0.10/$0.25) - 2012/08/05 14:09:19 JST [2012/08/05 1:09:19 ET]
Table 'Whirlpool' 9-max Seat #1 is the button
Seat 1: PetitAlejo ($26.66 in chips) 
Seat 2: Csabee21 ($21.79 in chips) 
Seat 3: munky3 ($37.31 in chips) 
Seat 4: ygoegoe ($28.21 in chips) 
Seat 5: Dejacob ($58.09 in chips) 
Seat 6: 2997qwer ($12.90 in chips) 
Seat 7: chiyuki ($45.45 in chips) 
Seat 8: Tom1999 ($7.28 in chips) 
Seat 9: smartrisk15 ($5.04 in chips) 
Csabee21: posts small blind $0.10
munky3: posts big blind $0.25
*** HOLE CARDS ***
Dealt to chiyuki [Th 9h]
ygoegoe: folds 
Dejacob: folds 
2997qwer: folds 
chiyuki: folds 
Tom1999: folds 
smartrisk15: calls $0.25
PetitAlejo: folds 
Csabee21: calls $0.15
munky3: checks 
*** FLOP *** [6c 9c 9d]
Csabee21: checks 
munky3: checks 
smartrisk15: bets $0.75
Csabee21: folds 
munky3: folds 
Uncalled bet ($0.75) returned to smartrisk15
smartrisk15 collected $0.72 from pot
smartrisk15: doesn't show hand 
*** SUMMARY ***
Total pot $0.75 | Rake $0.03 
Board [6c 9c 9d]
Seat 1: PetitAlejo (button) folded before Flop (didn't bet)
Seat 2: Csabee21 (small blind) folded on the Flop
Seat 3: munky3 (big blind) folded on the Flop
Seat 4: ygoegoe folded before Flop (didn't bet)
Seat 5: Dejacob folded before Flop (didn't bet)
Seat 6: 2997qwer folded before Flop (didn't bet)
Seat 7: chiyuki folded before Flop (didn't bet)
Seat 8: Tom1999 folded before Flop (didn't bet)
Seat 9: smartrisk15 collected ($0.72)



PokerStars Zoom Hand #84299287039:  Hold'em No Limit ($0.10/$0.25) - 2012/08/05 14:09:14 JST [2012/08/05 1:09:14 ET]
Table 'Whirlpool' 9-max Seat #1 is the button
Seat 1: 2997qwer ($12.90 in chips) 
Seat 2: Loholov ($17.76 in chips) 
Seat 3: Nerkit ($12.50 in chips) 
Seat 4: Th3Fog ($73.19 in chips) 
Seat 5: Perstenev ($12.85 in chips) 
Seat 6: Dejacob ($58.09 in chips) 
Seat 7: seula i ($31.90 in chips) 
Seat 8: Ellen1947 ($36.36 in chips) 
Seat 9: chiyuki ($45.45 in chips) 
Loholov: posts small blind $0.10
Nerkit: posts big blind $0.25
*** HOLE CARDS ***
Dealt to chiyuki [Kc 6s]
Th3Fog: raises $0.47 to $0.72
Perstenev: folds 
Dejacob: folds 
seula i: folds 
Ellen1947: folds 
chiyuki: folds 
2997qwer: folds 
Loholov: calls $0.62
Nerkit: folds 
*** FLOP *** [Qs 2d 8c]
Loholov: checks 
Th3Fog: bets $0.94
Loholov: calls $0.94
*** TURN *** [Qs 2d 8c] [Td]
Loholov: checks 
Th3Fog: checks 
*** RIVER *** [Qs 2d 8c Td] [Qc]
Loholov: bets $1.50
Th3Fog: folds 
Uncalled bet ($1.50) returned to Loholov
Loholov collected $3.41 from pot
Loholov: doesn't show hand 
*** SUMMARY ***
Total pot $3.57 | Rake $0.16 
Board [Qs 2d 8c Td Qc]
Seat 1: 2997qwer (button) folded before Flop (didn't bet)
Seat 2: Loholov (small blind) collected ($3.41)
Seat 3: Nerkit (big blind) folded before Flop
Seat 4: Th3Fog folded on the River
Seat 5: Perstenev folded before Flop (didn't bet)
Seat 6: Dejacob folded before Flop (didn't bet)
Seat 7: seula i folded before Flop (didn't bet)
Seat 8: Ellen1947 folded before Flop (didn't bet)
Seat 9: chiyuki folded before Flop (didn't bet)



PokerStars Zoom Hand #84299294029:  Hold'em No Limit ($0.10/$0.25) - 2012/08/05 14:09:41 JST [2012/08/05 1:09:41 ET]
Table 'Whirlpool' 9-max Seat #1 is the button
Seat 1: 2997qwer ($12.15 in chips) 
Seat 2: Ellen1947 ($36.36 in chips) 
Seat 3: chiyuki ($45.45 in chips) 
Seat 4: cr0lox ($20.30 in chips) 
Seat 5: hirozo ($32.11 in chips) 
Seat 6: troms20 ($22.30 in chips) 
Seat 7: puffy5533 ($22.47 in chips) 
Seat 8: simonzez ($50.60 in chips) 
Seat 9: Tom1999 ($7.28 in chips) 
Ellen1947: posts small blind $0.10
chiyuki: posts big blind $0.25
*** HOLE CARDS ***
Dealt to chiyuki [8h Qs]
cr0lox: folds 
hirozo: folds 
troms20: folds 
puffy5533: folds 
simonzez: folds 
Tom1999: folds 
2997qwer: raises $0.50 to $0.75
Ellen1947: folds 
chiyuki: folds 
Uncalled bet ($0.50) returned to 2997qwer
2997qwer collected $0.60 from pot
2997qwer: doesn't show hand 
*** SUMMARY ***
Total pot $0.60 | Rake $0 
Seat 1: 2997qwer (button) collected ($0.60)
Seat 2: Ellen1947 (small blind) folded before Flop
Seat 3: chiyuki (big blind) folded before Flop
Seat 4: cr0lox folded before Flop (didn't bet)
Seat 5: hirozo folded before Flop (didn't bet)
Seat 6: troms20 folded before Flop (didn't bet)
Seat 7: puffy5533 folded before Flop (didn't bet)
Seat 8: simonzez folded before Flop (didn't bet)
Seat 9: Tom1999 folded before Flop (didn't bet)



PokerStars Zoom Hand #84299297943:  Hold'em No Limit ($0.10/$0.25) - 2012/08/05 14:09:57 JST [2012/08/05 1:09:57 ET]
Table 'Whirlpool' 9-max Seat #1 is the button
Seat 1: troms20 ($29.53 in chips) 
Seat 2: Vahe50 ($9.70 in chips) 
Seat 3: Ellen1947 ($36.26 in chips) 
Seat 4: chiyuki ($45.20 in chips) 
Seat 5: DanielWhyte ($20.31 in chips) 
Seat 6: Landybob ($36.81 in chips) 
Seat 7: eyesJeJa ($27.25 in chips) 
Seat 8: Roglus ($29.28 in chips) 
Seat 9: Dejacob ($39.30 in chips) 
Vahe50: posts small blind $0.10
Ellen1947: posts big blind $0.25
*** HOLE CARDS ***
Dealt to chiyuki [3d 5h]
chiyuki: folds 
DanielWhyte: raises $0.50 to $0.75
Landybob: folds 
eyesJeJa: folds 
Roglus: folds 
Dejacob: folds 
troms20: folds 
Vahe50: folds 
Ellen1947: folds 
Uncalled bet ($0.50) returned to DanielWhyte
DanielWhyte collected $0.60 from pot
DanielWhyte: doesn't show hand 
*** SUMMARY ***
Total pot $0.60 | Rake $0 
Seat 1: troms20 (button) folded before Flop (didn't bet)
Seat 2: Vahe50 (small blind) folded before Flop
Seat 3: Ellen1947 (big blind) folded before Flop
Seat 4: chiyuki folded before Flop (didn't bet)
Seat 5: DanielWhyte collected ($0.60)
Seat 6: Landybob folded before Flop (didn't bet)
Seat 7: eyesJeJa folded before Flop (didn't bet)
Seat 8: Roglus folded before Flop (didn't bet)
Seat 9: Dejacob folded before Flop (didn't bet)



PokerStars Zoom Hand #84299299477:  Hold'em No Limit ($0.10/$0.25) - 2012/08/05 14:10:03 JST [2012/08/05 1:10:03 ET]
Table 'Whirlpool' 9-max Seat #1 is the button
Seat 1: chiyuki ($45.20 in chips) 
Seat 2: hirozo ($29.32 in chips) 
Seat 3: RomarioJa ($9.37 in chips) 
Seat 4: Loholov ($15 in chips) 
Seat 5: troms20 ($29.53 in chips) 
Seat 6: agurio ($27.62 in chips) 
Seat 7: PetitAlejo ($26.66 in chips) 
Seat 8: silvno31 ($36.64 in chips) 
Seat 9: Th3Fog ($47.14 in chips) 
hirozo: posts small blind $0.10
RomarioJa: posts big blind $0.25
*** HOLE CARDS ***
Dealt to chiyuki [As Ah]
Loholov: folds 
troms20: folds 
agurio: folds 
PetitAlejo: folds 
silvno31: folds 
Th3Fog: folds 
chiyuki: raises $0.50 to $0.75
hirozo: calls $0.65
RomarioJa: folds 
*** FLOP *** [6h Ts 4h]
hirozo: checks 
chiyuki: bets $1.25
hirozo: calls $1.25
*** TURN *** [6h Ts 4h] [7d]
hirozo: checks 
chiyuki: checks 
*** RIVER *** [6h Ts 4h 7d] [Qd]
hirozo: bets $2.71
chiyuki: raises $2.79 to $5.50
hirozo: folds 
Uncalled bet ($2.79) returned to chiyuki
chiyuki collected $9.23 from pot
chiyuki: doesn't show hand 
*** SUMMARY ***
Total pot $9.67 | Rake $0.44 
Board [6h Ts 4h 7d Qd]
Seat 1: chiyuki (button) collected ($9.23)
Seat 2: hirozo (small blind) folded on the River
Seat 3: RomarioJa (big blind) folded before Flop
Seat 4: Loholov folded before Flop (didn't bet)
Seat 5: troms20 folded before Flop (didn't bet)
Seat 6: agurio folded before Flop (didn't bet)
Seat 7: PetitAlejo folded before Flop (didn't bet)
Seat 8: silvno31 folded before Flop (didn't bet)
Seat 9: Th3Fog folded before Flop (didn't bet)



PokerStars Zoom Hand #84299321676:  Hold'em No Limit ($0.10/$0.25) - 2012/08/05 14:11:31 JST [2012/08/05 1:11:31 ET]
Table 'Whirlpool' 9-max Seat #1 is the button
Seat 1: phate-1up ($25 in chips) 
Seat 2: chiyuki ($49.72 in chips) 
Seat 3: wtu1986 ($31.52 in chips) 
Seat 4: Loholov ($19.26 in chips) 
Seat 5: WARIBANA7777 ($15 in chips) 
Seat 6: hirozo ($30.22 in chips) 
Seat 7: craden500 ($15.03 in chips) 
Seat 8: Faraz ($22.07 in chips) 
Seat 9: 2997qwer ($11.40 in chips) 
chiyuki: posts small blind $0.10
wtu1986: posts big blind $0.25
*** HOLE CARDS ***
Dealt to chiyuki [Ks 2d]
Loholov: folds 
WARIBANA7777: folds 
hirozo: folds 
craden500: folds 
Faraz: folds 
2997qwer: folds 
phate-1up: folds 
chiyuki: folds 
Uncalled bet ($0.15) returned to wtu1986
wtu1986 collected $0.20 from pot
wtu1986: doesn't show hand 
*** SUMMARY ***
Total pot $0.20 | Rake $0 
Seat 1: phate-1up (button) folded before Flop (didn't bet)
Seat 2: chiyuki (small blind) folded before Flop
Seat 3: wtu1986 (big blind) collected ($0.20)
Seat 4: Loholov folded before Flop (didn't bet)
Seat 5: WARIBANA7777 folded before Flop (didn't bet)
Seat 6: hirozo folded before Flop (didn't bet)
Seat 7: craden500 folded before Flop (didn't bet)
Seat 8: Faraz folded before Flop (didn't bet)
Seat 9: 2997qwer folded before Flop (didn't bet)



PokerStars Zoom Hand #84299324985:  Hold'em No Limit ($0.10/$0.25) - 2012/08/05 14:11:44 JST [2012/08/05 1:11:44 ET]
Table 'Whirlpool' 9-max Seat #1 is the button
Seat 1: RikkStroken ($21.04 in chips) 
Seat 2: Scruf13 ($12.69 in chips) 
Seat 3: seula i ($25 in chips) 
Seat 4: hirozo ($25 in chips) 
Seat 5: Wilcox76607 ($24 in chips) 
Seat 6: Vahe50 ($15.72 in chips) 
Seat 7: troms20 ($26.75 in chips) 
Seat 8: chiyuki ($49.62 in chips) 
Seat 9: slapshot2011 ($31.52 in chips) 
Scruf13: posts small blind $0.10
seula i: posts big blind $0.25
*** HOLE CARDS ***
Dealt to chiyuki [3s Qd]
hirozo: folds 
Wilcox76607: raises $0.50 to $0.75
Vahe50: folds 
troms20: folds 
chiyuki: folds 
slapshot2011: folds 
RikkStroken: folds 
Scruf13: folds 
seula i: folds 
Uncalled bet ($0.50) returned to Wilcox76607
Wilcox76607 collected $0.60 from pot
Wilcox76607: doesn't show hand 
*** SUMMARY ***
Total pot $0.60 | Rake $0 
Seat 1: RikkStroken (button) folded before Flop (didn't bet)
Seat 2: Scruf13 (small blind) folded before Flop
Seat 3: seula i (big blind) folded before Flop
Seat 4: hirozo folded before Flop (didn't bet)
Seat 5: Wilcox76607 collected ($0.60)
Seat 6: Vahe50 folded before Flop (didn't bet)
Seat 7: troms20 folded before Flop (didn't bet)
Seat 8: chiyuki folded before Flop (didn't bet)
Seat 9: slapshot2011 folded before Flop (didn't bet)



PokerStars Zoom Hand #84299323667:  Hold'em No Limit ($0.10/$0.25) - 2012/08/05 14:11:39 JST [2012/08/05 1:11:39 ET]
Table 'Whirlpool' 9-max Seat #1 is the button
Seat 1: ygoegoe ($28.56 in chips) 
Seat 2: Th3Fog ($46.89 in chips) 
Seat 3: craden500 ($15.03 in chips) 
Seat 4: munky3 ($40.02 in chips) 
Seat 5: 2997qwer ($11.40 in chips) 
Seat 6: chiyuki ($49.62 in chips) 
Seat 7: Wilcox76607 ($24 in chips) 
Seat 8: kamikkaze ($15.10 in chips) 
Seat 9: troms20 ($26.75 in chips) 
Th3Fog: posts small blind $0.10
craden500: posts big blind $0.25
*** HOLE CARDS ***
Dealt to chiyuki [5c 7c]
munky3: folds 
2997qwer: folds 
chiyuki: folds 
Wilcox76607: folds 
kamikkaze: folds 
troms20: folds 
ygoegoe: folds 
Th3Fog: raises $0.25 to $0.50
craden500: raises $0.75 to $1.25
Th3Fog: calls $0.75
*** FLOP *** [6d 3c 5d]
Th3Fog: checks 
craden500: bets $1.25
Th3Fog: folds 
Uncalled bet ($1.25) returned to craden500
craden500 collected $2.39 from pot
craden500: doesn't show hand 
*** SUMMARY ***
Total pot $2.50 | Rake $0.11 
Board [6d 3c 5d]
Seat 1: ygoegoe (button) folded before Flop (didn't bet)
Seat 2: Th3Fog (small blind) folded on the Flop
Seat 3: craden500 (big blind) collected ($2.39)
Seat 4: munky3 folded before Flop (didn't bet)
Seat 5: 2997qwer folded before Flop (didn't bet)
Seat 6: chiyuki folded before Flop (didn't bet)
Seat 7: Wilcox76607 folded before Flop (didn't bet)
Seat 8: kamikkaze folded before Flop (didn't bet)
Seat 9: troms20 folded before Flop (didn't bet)



PokerStars Zoom Hand #84299327590:  Hold'em No Limit ($0.10/$0.25) - 2012/08/05 14:11:54 JST [2012/08/05 1:11:54 ET]
Table 'Whirlpool' 9-max Seat #1 is the button
Seat 1: troms20 ($21.20 in chips) 
Seat 2: eyesJeJa ($26.55 in chips) 
Seat 3: ygoegoe ($28.56 in chips) 
Seat 4: BlOnDhOlIc ($63.16 in chips) 
Seat 5: chiyuki ($49.62 in chips) 
Seat 6: slapshot2011 ($31.52 in chips) 
Seat 7: Dejacob ($25 in chips) 
Seat 8: PetitAlejo ($34.01 in chips) 
Seat 9: RikkStroken ($21.04 in chips) 
eyesJeJa: posts small blind $0.10
ygoegoe: posts big blind $0.25
*** HOLE CARDS ***
Dealt to chiyuki [Td Ad]
BlOnDhOlIc: folds 
chiyuki: raises $0.50 to $0.75
slapshot2011: calls $0.75
Dejacob: folds 
PetitAlejo: folds 
RikkStroken: folds 
troms20: folds 
eyesJeJa: folds 
ygoegoe: folds 
*** FLOP *** [9c 4h 9h]
chiyuki: checks 
slapshot2011: bets $0.75
chiyuki: calls $0.75
*** TURN *** [9c 4h 9h] [Qh]
chiyuki: checks 
slapshot2011: bets $0.75
chiyuki: folds 
Uncalled bet ($0.75) returned to slapshot2011
slapshot2011 collected $3.20 from pot
slapshot2011: doesn't show hand 
*** SUMMARY ***
Total pot $3.35 | Rake $0.15 
Board [9c 4h 9h Qh]
Seat 1: troms20 (button) folded before Flop (didn't bet)
Seat 2: eyesJeJa (small blind) folded before Flop
Seat 3: ygoegoe (big blind) folded before Flop
Seat 4: BlOnDhOlIc folded before Flop (didn't bet)
Seat 5: chiyuki folded on the Turn
Seat 6: slapshot2011 collected ($3.20)
Seat 7: Dejacob folded before Flop (didn't bet)
Seat 8: PetitAlejo folded before Flop (didn't bet)
Seat 9: RikkStroken folded before Flop (didn't bet)



PokerStars Zoom Hand #84299335472:  Hold'em No Limit ($0.10/$0.25) - 2012/08/05 14:12:26 JST [2012/08/05 1:12:26 ET]
Table 'Whirlpool' 9-max Seat #1 is the button
Seat 1: KeLevro0 ($10.63 in chips) 
Seat 2: Roglus ($29.38 in chips) 
Seat 3: chiyuki ($48.12 in chips) 
Seat 4: Dejacob ($25.78 in chips) 
Seat 5: deadmoneykid ($26.35 in chips) 
Seat 6: kamikkaze ($14.22 in chips) 
Seat 7: RomarioJa ($11.61 in chips) 
Seat 8: Ellen1947 ($45.19 in chips) 
Seat 9: Perstenev ($21.07 in chips) 
Roglus: posts small blind $0.10
chiyuki: posts big blind $0.25
*** HOLE CARDS ***
Dealt to chiyuki [Jc 2h]
Dejacob: folds 
deadmoneykid: folds 
kamikkaze: folds 
RomarioJa: folds 
Ellen1947: folds 
Perstenev: folds 
KeLevro0: folds 
Roglus: folds 
Uncalled bet ($0.15) returned to chiyuki
chiyuki collected $0.20 from pot
chiyuki: doesn't show hand 
*** SUMMARY ***
Total pot $0.20 | Rake $0 
Seat 1: KeLevro0 (button) folded before Flop (didn't bet)
Seat 2: Roglus (small blind) folded before Flop
Seat 3: chiyuki (big blind) collected ($0.20)
Seat 4: Dejacob folded before Flop (didn't bet)
Seat 5: deadmoneykid folded before Flop (didn't bet)
Seat 6: kamikkaze folded before Flop (didn't bet)
Seat 7: RomarioJa folded before Flop (didn't bet)
Seat 8: Ellen1947 folded before Flop (didn't bet)
Seat 9: Perstenev folded before Flop (didn't bet)



PokerStars Zoom Hand #84299334454:  Hold'em No Limit ($0.10/$0.25) - 2012/08/05 14:12:22 JST [2012/08/05 1:12:22 ET]
Table 'Whirlpool' 9-max Seat #1 is the button
Seat 1: eyesJeJa ($27.40 in chips) 
Seat 2: Paranoix1990 ($23.18 in chips) 
Seat 3: Nerkit ($11.70 in chips) 
Seat 4: Perstenev ($18.11 in chips) 
Seat 5: DONK1967 ($24.63 in chips) 
Seat 6: phate-1up ($25 in chips) 
Seat 7: chiyuki ($48.12 in chips) 
Seat 8: hirozo ($25 in chips) 
Seat 9: RikkStroken ($14.33 in chips) 
Paranoix1990: posts small blind $0.10
Nerkit: posts big blind $0.25
*** HOLE CARDS ***
Dealt to chiyuki [9h Ts]
Perstenev: folds 
DONK1967: folds 
phate-1up: folds 
chiyuki: folds 
hirozo: folds 
RikkStroken: folds 
eyesJeJa: folds 
Paranoix1990: calls $0.15
Nerkit: checks 
*** FLOP *** [2s Jh 6s]
Paranoix1990: bets $0.50
Nerkit: folds 
Uncalled bet ($0.50) returned to Paranoix1990
Paranoix1990 collected $0.48 from pot
Paranoix1990: doesn't show hand 
*** SUMMARY ***
Total pot $0.50 | Rake $0.02 
Board [2s Jh 6s]
Seat 1: eyesJeJa (button) folded before Flop (didn't bet)
Seat 2: Paranoix1990 (small blind) collected ($0.48)
Seat 3: Nerkit (big blind) folded on the Flop
Seat 4: Perstenev folded before Flop (didn't bet)
Seat 5: DONK1967 folded before Flop (didn't bet)
Seat 6: phate-1up folded before Flop (didn't bet)
Seat 7: chiyuki folded before Flop (didn't bet)
Seat 8: hirozo folded before Flop (didn't bet)
Seat 9: RikkStroken folded before Flop (didn't bet)



PokerStars Zoom Hand #84299340884:  Hold'em No Limit ($0.10/$0.25) - 2012/08/05 14:12:48 JST [2012/08/05 1:12:48 ET]
Table 'Whirlpool' 9-max Seat #1 is the button
Seat 1: chiyuki ($48.22 in chips) 
Seat 2: cr0lox ($19.97 in chips) 
Seat 3: seula i ($25.35 in chips) 
Seat 4: BlOnDhOlIc ($51.50 in chips) 
Seat 5: Landybob ($38.61 in chips) 
Seat 6: phate-1up ($25 in chips) 
Seat 7: Perstenev ($13.77 in chips) 
Seat 8: hirozo ($29.61 in chips) 
Seat 9: troms20 ($26.40 in chips) 
cr0lox: posts small blind $0.10
seula i: posts big blind $0.25
*** HOLE CARDS ***
Dealt to chiyuki [Qs 9h]
BlOnDhOlIc: raises $0.37 to $0.62
Landybob: folds 
phate-1up: folds 
Perstenev: folds 
hirozo: folds 
troms20: folds 
chiyuki: folds 
cr0lox: folds 
seula i: folds 
Uncalled bet ($0.37) returned to BlOnDhOlIc
BlOnDhOlIc collected $0.60 from pot
BlOnDhOlIc: doesn't show hand 
*** SUMMARY ***
Total pot $0.60 | Rake $0 
Seat 1: chiyuki (button) folded before Flop (didn't bet)
Seat 2: cr0lox (small blind) folded before Flop
Seat 3: seula i (big blind) folded before Flop
Seat 4: BlOnDhOlIc collected ($0.60)
Seat 5: Landybob folded before Flop (didn't bet)
Seat 6: phate-1up folded before Flop (didn't bet)
Seat 7: Perstenev folded before Flop (didn't bet)
Seat 8: hirozo folded before Flop (didn't bet)
Seat 9: troms20 folded before Flop (didn't bet)



PokerStars Zoom Hand #84299345187:  Hold'em No Limit ($0.10/$0.25) - 2012/08/05 14:13:05 JST [2012/08/05 1:13:05 ET]
Table 'Whirlpool' 9-max Seat #1 is the button
Seat 1: Déculotter69 ($17.77 in chips) 
Seat 2: RikkStroken ($24.68 in chips) 
Seat 3: seula i ($63.89 in chips) 
Seat 4: chiyuki ($48.22 in chips) 
Seat 5: troms20 ($20.85 in chips) 
Seat 6: 2997qwer ($11.80 in chips) 
Seat 7: peng2astic ($8.78 in chips) 
Seat 8: ygoegoe ($33.75 in chips) 
Seat 9: Nerkit ($11.45 in chips) 
RikkStroken: posts small blind $0.10
seula i: posts big blind $0.25
*** HOLE CARDS ***
Dealt to chiyuki [Jh Qs]
chiyuki: folds 
troms20: folds 
2997qwer: folds 
peng2astic: folds 
ygoegoe: folds 
Nerkit: folds 
Déculotter69: raises $0.50 to $0.75
RikkStroken: folds 
seula i: folds 
Uncalled bet ($0.50) returned to Déculotter69
Déculotter69 collected $0.60 from pot
Déculotter69: doesn't show hand 
*** SUMMARY ***
Total pot $0.60 | Rake $0 
Seat 1: Déculotter69 (button) collected ($0.60)
Seat 2: RikkStroken (small blind) folded before Flop
Seat 3: seula i (big blind) folded before Flop
Seat 4: chiyuki folded before Flop (didn't bet)
Seat 5: troms20 folded before Flop (didn't bet)
Seat 6: 2997qwer folded before Flop (didn't bet)
Seat 7: peng2astic folded before Flop (didn't bet)
Seat 8: ygoegoe folded before Flop (didn't bet)
Seat 9: Nerkit folded before Flop (didn't bet)



PokerStars Zoom Hand #84299349423:  Hold'em No Limit ($0.10/$0.25) - 2012/08/05 14:13:22 JST [2012/08/05 1:13:22 ET]
Table 'Whirlpool' 9-max Seat #1 is the button
Seat 1: roksmokndonk ($33.96 in chips) 
Seat 2: JLajoie ($24.75 in chips) 
Seat 3: PetitAlejo ($35.46 in chips) 
Seat 4: Lasutchik ($52.60 in chips) 
Seat 5: chiyuki ($48.22 in chips) 
Seat 6: hirozo ($25.13 in chips) 
Seat 7: mariuka1 ($13.82 in chips) 
Seat 8: Loholov ($18.25 in chips) 
Seat 9: BlOnDhOlIc ($60.66 in chips) 
JLajoie: posts small blind $0.10
PetitAlejo: posts big blind $0.25
*** HOLE CARDS ***
Dealt to chiyuki [2c 7d]
Lasutchik: folds 
chiyuki: folds 
hirozo: folds 
mariuka1: folds 
Loholov: folds 
BlOnDhOlIc: folds 
roksmokndonk: folds 
JLajoie: folds 
Uncalled bet ($0.15) returned to PetitAlejo
PetitAlejo collected $0.20 from pot
PetitAlejo: doesn't show hand 
*** SUMMARY ***
Total pot $0.20 | Rake $0 
Seat 1: roksmokndonk (button) folded before Flop (didn't bet)
Seat 2: JLajoie (small blind) folded before Flop
Seat 3: PetitAlejo (big blind) collected ($0.20)
Seat 4: Lasutchik folded before Flop (didn't bet)
Seat 5: chiyuki folded before Flop (didn't bet)
Seat 6: hirozo folded before Flop (didn't bet)
Seat 7: mariuka1 folded before Flop (didn't bet)
Seat 8: Loholov folded before Flop (didn't bet)
Seat 9: BlOnDhOlIc folded before Flop (didn't bet)



PokerStars Zoom Hand #84299354049:  Hold'em No Limit ($0.10/$0.25) - 2012/08/05 14:13:41 JST [2012/08/05 1:13:41 ET]
Table 'Whirlpool' 9-max Seat #1 is the button
Seat 1: Scruf13 ($11.94 in chips) 
Seat 2: BlOnDhOlIc ($60.66 in chips) 
Seat 3: Anafim ($13.29 in chips) 
Seat 4: Nerkit ($11.45 in chips) 
Seat 5: ChrisCDee ($57.34 in chips) 
Seat 6: chiyuki ($48.12 in chips) 
Seat 7: Wilcox76607 ($21.38 in chips) 
Seat 8: softdesign ($73.92 in chips) 
Seat 9: Rudolf ($41.87 in chips) 
BlOnDhOlIc: posts small blind $0.10
Anafim: posts big blind $0.25
*** HOLE CARDS ***
Dealt to chiyuki [2h Ts]
Nerkit: folds 
ChrisCDee: folds 
chiyuki: folds 
Wilcox76607: raises $0.50 to $0.75
softdesign: folds 
Rudolf: folds 
Scruf13: folds 
BlOnDhOlIc: folds 
Anafim: folds 
Uncalled bet ($0.50) returned to Wilcox76607
Wilcox76607 collected $0.60 from pot
Wilcox76607: doesn't show hand 
*** SUMMARY ***
Total pot $0.60 | Rake $0 
Seat 1: Scruf13 (button) folded before Flop (didn't bet)
Seat 2: BlOnDhOlIc (small blind) folded before Flop
Seat 3: Anafim (big blind) folded before Flop
Seat 4: Nerkit folded before Flop (didn't bet)
Seat 5: ChrisCDee folded before Flop (didn't bet)
Seat 6: chiyuki folded before Flop (didn't bet)
Seat 7: Wilcox76607 collected ($0.60)
Seat 8: softdesign folded before Flop (didn't bet)
Seat 9: Rudolf folded before Flop (didn't bet)



PokerStars Zoom Hand #84299350469:  Hold'em No Limit ($0.10/$0.25) - 2012/08/05 14:13:26 JST [2012/08/05 1:13:26 ET]
Table 'Whirlpool' 9-max Seat #1 is the button
Seat 1: Suhoff76 ($25 in chips) 
Seat 2: chiyuki ($48.22 in chips) 
Seat 3: roksmokndonk ($33.96 in chips) 
Seat 4: RomarioJa ($11.88 in chips) 
Seat 5: eyesJeJa ($25 in chips) 
Seat 6: RikkStroken ($23.08 in chips) 
Seat 7: Perstenev ($13.77 in chips) 
Seat 8: troms20 ($27.19 in chips) 
Seat 9: JLajoie ($24.65 in chips) 
chiyuki: posts small blind $0.10
roksmokndonk: posts big blind $0.25
*** HOLE CARDS ***
Dealt to chiyuki [5h Tc]
RomarioJa: folds 
eyesJeJa: raises $0.50 to $0.75
RikkStroken: folds 
Perstenev: folds 
troms20: folds 
JLajoie: folds 
Suhoff76: folds 
chiyuki: folds 
roksmokndonk: calls $0.50
*** FLOP *** [4h Kc 3c]
roksmokndonk: checks 
eyesJeJa: bets $1
roksmokndonk: folds 
Uncalled bet ($1) returned to eyesJeJa
eyesJeJa collected $1.53 from pot
eyesJeJa: doesn't show hand 
*** SUMMARY ***
Total pot $1.60 | Rake $0.07 
Board [4h Kc 3c]
Seat 1: Suhoff76 (button) folded before Flop (didn't bet)
Seat 2: chiyuki (small blind) folded before Flop
Seat 3: roksmokndonk (big blind) folded on the Flop
Seat 4: RomarioJa folded before Flop (didn't bet)
Seat 5: eyesJeJa collected ($1.53)
Seat 6: RikkStroken folded before Flop (didn't bet)
Seat 7: Perstenev folded before Flop (didn't bet)
Seat 8: troms20 folded before Flop (didn't bet)
Seat 9: JLajoie folded before Flop (didn't bet)



PokerStars Zoom Hand #84299355515:  Hold'em No Limit ($0.10/$0.25) - 2012/08/05 14:13:47 JST [2012/08/05 1:13:47 ET]
Table 'Whirlpool' 9-max Seat #1 is the button
Seat 1: eyesJeJa ($28.84 in chips) 
Seat 2: Landybob ($38.36 in chips) 
Seat 3: ChrisCDee ($57.34 in chips) 
Seat 4: Th3Fog ($14.67 in chips) 
Seat 5: DanielWhyte ($26.27 in chips) 
Seat 6: Roglus ($80.33 in chips) 
Seat 7: chiyuki ($48.12 in chips) 
Seat 8: PetitAlejo ($31.32 in chips) 
Seat 9: agurio ($27.03 in chips) 
Landybob: posts small blind $0.10
ChrisCDee: posts big blind $0.25
*** HOLE CARDS ***
Dealt to chiyuki [9s Td]
Th3Fog: folds 
DanielWhyte: folds 
Roglus: folds 
chiyuki: folds 
PetitAlejo: folds 
agurio: folds 
eyesJeJa: folds 
Landybob: folds 
Uncalled bet ($0.15) returned to ChrisCDee
ChrisCDee collected $0.20 from pot
ChrisCDee: doesn't show hand 
*** SUMMARY ***
Total pot $0.20 | Rake $0 
Seat 1: eyesJeJa (button) folded before Flop (didn't bet)
Seat 2: Landybob (small blind) folded before Flop
Seat 3: ChrisCDee (big blind) collected ($0.20)
Seat 4: Th3Fog folded before Flop (didn't bet)
Seat 5: DanielWhyte folded before Flop (didn't bet)
Seat 6: Roglus folded before Flop (didn't bet)
Seat 7: chiyuki folded before Flop (didn't bet)
Seat 8: PetitAlejo folded before Flop (didn't bet)
Seat 9: agurio folded before Flop (didn't bet)



PokerStars Zoom Hand #84299352014:  Hold'em No Limit ($0.10/$0.25) - 2012/08/05 14:13:33 JST [2012/08/05 1:13:33 ET]
Table 'Whirlpool' 9-max Seat #1 is the button
Seat 1: leo2095 ($12.87 in chips) 
Seat 2: seula i ($25.10 in chips) 
Seat 3: RomarioJa ($11.88 in chips) 
Seat 4: ChrisCDee ($57.34 in chips) 
Seat 5: troms20 ($27.19 in chips) 
Seat 6: Dejacob ($25.93 in chips) 
Seat 7: Déculotter69 ($18.12 in chips) 
Seat 8: chiyuki ($48.12 in chips) 
Seat 9: Suhoff76 ($25 in chips) 
seula i: posts small blind $0.10
RomarioJa: posts big blind $0.25
*** HOLE CARDS ***
Dealt to chiyuki [3h Jd]
ChrisCDee: folds 
troms20: folds 
Dejacob: folds 
Déculotter69: raises $0.50 to $0.75
chiyuki: folds 
Suhoff76: raises $1.55 to $2.30
leo2095: folds 
seula i: folds 
RomarioJa: folds 
Déculotter69: folds 
Uncalled bet ($1.55) returned to Suhoff76
Suhoff76 collected $1.85 from pot
Suhoff76: doesn't show hand 
*** SUMMARY ***
Total pot $1.85 | Rake $0 
Seat 1: leo2095 (button) folded before Flop (didn't bet)
Seat 2: seula i (small blind) folded before Flop
Seat 3: RomarioJa (big blind) folded before Flop
Seat 4: ChrisCDee folded before Flop (didn't bet)
Seat 5: troms20 folded before Flop (didn't bet)
Seat 6: Dejacob folded before Flop (didn't bet)
Seat 7: Déculotter69 folded before Flop
Seat 8: chiyuki folded before Flop (didn't bet)
Seat 9: Suhoff76 collected ($1.85)



PokerStars Zoom Hand #84299357039:  Hold'em No Limit ($0.10/$0.25) - 2012/08/05 14:13:53 JST [2012/08/05 1:13:53 ET]
Table 'Whirlpool' 9-max Seat #1 is the button
Seat 1: RikkStroken ($13.58 in chips) 
Seat 2: eyesJeJa ($28.84 in chips) 
Seat 3: BlOnDhOlIc ($60.56 in chips) 
Seat 4: chiyuki ($48.12 in chips) 
Seat 5: Faraz ($18.82 in chips) 
Seat 6: taksist889 ($37.91 in chips) 
Seat 7: Dejacob ($26.39 in chips) 
Seat 8: Roglus ($80.33 in chips) 
Seat 9: kamikkaze ($14.85 in chips) 
eyesJeJa: posts small blind $0.10
BlOnDhOlIc: posts big blind $0.25
*** HOLE CARDS ***
Dealt to chiyuki [Ts 4s]
chiyuki: folds 
Faraz: raises $0.25 to $0.50
taksist889: folds 
Dejacob: folds 
Roglus: folds 
kamikkaze: folds 
RikkStroken: folds 
eyesJeJa: folds 
BlOnDhOlIc: folds 
Uncalled bet ($0.25) returned to Faraz
Faraz collected $0.60 from pot
Faraz: doesn't show hand 
*** SUMMARY ***
Total pot $0.60 | Rake $0 
Seat 1: RikkStroken (button) folded before Flop (didn't bet)
Seat 2: eyesJeJa (small blind) folded before Flop
Seat 3: BlOnDhOlIc (big blind) folded before Flop
Seat 4: chiyuki folded before Flop (didn't bet)
Seat 5: Faraz collected ($0.60)
Seat 6: taksist889 folded before Flop (didn't bet)
Seat 7: Dejacob folded before Flop (didn't bet)
Seat 8: Roglus folded before Flop (didn't bet)
Seat 9: kamikkaze folded before Flop (didn't bet)



PokerStars Zoom Hand #84299348171:  Hold'em No Limit ($0.10/$0.25) - 2012/08/05 14:13:17 JST [2012/08/05 1:13:17 ET]
Table 'Whirlpool' 9-max Seat #1 is the button
Seat 1: Perstenev ($18.11 in chips) 
Seat 2: Csabee21 ($26.54 in chips) 
Seat 3: kamikkaze ($15.10 in chips) 
Seat 4: PetitAlejo ($31.57 in chips) 
Seat 5: seula i ($25 in chips) 
Seat 6: hirozo ($34.40 in chips) 
Seat 7: ygoegoe ($33.75 in chips) 
Seat 8: BlOnDhOlIc ($60.66 in chips) 
Seat 9: chiyuki ($48.22 in chips) 
Csabee21: posts small blind $0.10
kamikkaze: posts big blind $0.25
*** HOLE CARDS ***
Dealt to chiyuki [9c 8h]
PetitAlejo: folds 
seula i: folds 
hirozo: folds 
ygoegoe: folds 
BlOnDhOlIc: folds 
chiyuki: folds 
Perstenev: calls $0.25
Csabee21: raises $0.50 to $0.75
kamikkaze: folds 
Perstenev: calls $0.50
*** FLOP *** [Js 7d Jd]
Csabee21: bets $1.25
Perstenev: calls $1.25
*** TURN *** [Js 7d Jd] [Ks]
Csabee21: checks 
Perstenev: checks 
*** RIVER *** [Js 7d Jd Ks] [4s]
Csabee21: checks 
Perstenev: bets $3.04
Csabee21: folds 
Uncalled bet ($3.04) returned to Perstenev
Perstenev collected $4.06 from pot
Perstenev: doesn't show hand 
*** SUMMARY ***
Total pot $4.25 | Rake $0.19 
Board [Js 7d Jd Ks 4s]
Seat 1: Perstenev (button) collected ($4.06)
Seat 2: Csabee21 (small blind) folded on the River
Seat 3: kamikkaze (big blind) folded before Flop
Seat 4: PetitAlejo folded before Flop (didn't bet)
Seat 5: seula i folded before Flop (didn't bet)
Seat 6: hirozo folded before Flop (didn't bet)
Seat 7: ygoegoe folded before Flop (didn't bet)
Seat 8: BlOnDhOlIc folded before Flop (didn't bet)
Seat 9: chiyuki folded before Flop (didn't bet)



PokerStars Zoom Hand #84299357783:  Hold'em No Limit ($0.10/$0.25) - 2012/08/05 14:13:56 JST [2012/08/05 1:13:56 ET]
Table 'Whirlpool' 9-max Seat #1 is the button
Seat 1: BlOnDhOlIc ($52.31 in chips) 
Seat 2: Nerkit ($11.45 in chips) 
Seat 3: chiyuki ($48.12 in chips) 
Seat 4: Loholov ($15 in chips) 
Seat 5: slapshot2011 ($35.54 in chips) 
Seat 6: 4thepeople ($21.03 in chips) 
Seat 7: roksmokndonk ($33.11 in chips) 
Seat 8: eyesJeJa ($25.78 in chips) 
Seat 9: KeLevro0 ($11.80 in chips) 
Nerkit: posts small blind $0.10
chiyuki: posts big blind $0.25
*** HOLE CARDS ***
Dealt to chiyuki [Js Ts]
Loholov: raises $0.75 to $1
slapshot2011: folds 
4thepeople: folds 
roksmokndonk: folds 
eyesJeJa: folds 
KeLevro0: folds 
BlOnDhOlIc: folds 
Nerkit: folds 
chiyuki: folds 
Uncalled bet ($0.75) returned to Loholov
Loholov collected $0.60 from pot
Loholov: doesn't show hand 
*** SUMMARY ***
Total pot $0.60 | Rake $0 
Seat 1: BlOnDhOlIc (button) folded before Flop (didn't bet)
Seat 2: Nerkit (small blind) folded before Flop
Seat 3: chiyuki (big blind) folded before Flop
Seat 4: Loholov collected ($0.60)
Seat 5: slapshot2011 folded before Flop (didn't bet)
Seat 6: 4thepeople folded before Flop (didn't bet)
Seat 7: roksmokndonk folded before Flop (didn't bet)
Seat 8: eyesJeJa folded before Flop (didn't bet)
Seat 9: KeLevro0 folded before Flop (didn't bet)



PokerStars Zoom Hand #84299361537:  Hold'em No Limit ($0.10/$0.25) - 2012/08/05 14:14:11 JST [2012/08/05 1:14:11 ET]
Table 'Whirlpool' 9-max Seat #1 is the button
Seat 1: mariuka1 ($13.47 in chips) 
Seat 2: WARIBANA7777 ($13.55 in chips) 
Seat 3: ygoegoe ($33.65 in chips) 
Seat 4: Spartacus675 ($29.17 in chips) 
Seat 5: Déculotter69 ($17.37 in chips) 
Seat 6: 2997qwer ($11.45 in chips) 
Seat 7: JLajoie ($25 in chips) 
Seat 8: RomarioJa ($15.96 in chips) 
Seat 9: chiyuki ($47.87 in chips) 
WARIBANA7777: posts small blind $0.10
ygoegoe: posts big blind $0.25
*** HOLE CARDS ***
Dealt to chiyuki [7s 4h]
Spartacus675: folds 
Déculotter69: raises $0.50 to $0.75
2997qwer: folds 
JLajoie: folds 
RomarioJa: folds 
chiyuki: folds 
mariuka1: folds 
WARIBANA7777: folds 
ygoegoe: folds 
Uncalled bet ($0.50) returned to Déculotter69
Déculotter69 collected $0.60 from pot
Déculotter69: doesn't show hand 
*** SUMMARY ***
Total pot $0.60 | Rake $0 
Seat 1: mariuka1 (button) folded before Flop (didn't bet)
Seat 2: WARIBANA7777 (small blind) folded before Flop
Seat 3: ygoegoe (big blind) folded before Flop
Seat 4: Spartacus675 folded before Flop (didn't bet)
Seat 5: Déculotter69 collected ($0.60)
Seat 6: 2997qwer folded before Flop (didn't bet)
Seat 7: JLajoie folded before Flop (didn't bet)
Seat 8: RomarioJa folded before Flop (didn't bet)
Seat 9: chiyuki folded before Flop (didn't bet)



PokerStars Zoom Hand #84299360599:  Hold'em No Limit ($0.10/$0.25) - 2012/08/05 14:14:07 JST [2012/08/05 1:14:07 ET]
Table 'Whirlpool' 9-max Seat #1 is the button
Seat 1: chiyuki ($47.87 in chips) 
Seat 2: Loholov ($16.61 in chips) 
Seat 3: Roglus ($47.32 in chips) 
Seat 4: KeLevro0 ($17.49 in chips) 
Seat 5: 2997qwer ($11.45 in chips) 
Seat 6: WARIBANA7777 ($13.55 in chips) 
Seat 7: silvno31 ($40.57 in chips) 
Seat 8: Suhoff76 ($26.10 in chips) 
Seat 9: Dejacob ($36.63 in chips) 
Loholov: posts small blind $0.10
Roglus: posts big blind $0.25
*** HOLE CARDS ***
Dealt to chiyuki [8c Jh]
KeLevro0: raises $0.42 to $0.67
2997qwer: folds 
WARIBANA7777: folds 
silvno31: calls $0.67
Suhoff76: folds 
Dejacob: calls $0.67
chiyuki: folds 
Loholov: folds 
Roglus: calls $0.42
*** FLOP *** [4h Qc 8h]
Roglus: checks 
KeLevro0: checks 
silvno31: checks 
Dejacob: bets $2
Roglus: calls $2
KeLevro0: folds 
silvno31: folds 
*** TURN *** [4h Qc 8h] [4s]
Roglus: checks 
Dejacob: bets $4.25
Roglus: calls $4.25
*** RIVER *** [4h Qc 8h 4s] [7d]
Roglus: checks 
Dejacob: bets $9.25
Roglus: folds 
Uncalled bet ($9.25) returned to Dejacob
Dejacob collected $14.59 from pot
Dejacob: doesn't show hand 
*** SUMMARY ***
Total pot $15.28 | Rake $0.69 
Board [4h Qc 8h 4s 7d]
Seat 1: chiyuki (button) folded before Flop (didn't bet)
Seat 2: Loholov (small blind) folded before Flop
Seat 3: Roglus (big blind) folded on the River
Seat 4: KeLevro0 folded on the Flop
Seat 5: 2997qwer folded before Flop (didn't bet)
Seat 6: WARIBANA7777 folded before Flop (didn't bet)
Seat 7: silvno31 folded on the Flop
Seat 8: Suhoff76 folded before Flop (didn't bet)
Seat 9: Dejacob collected ($14.59)



PokerStars Zoom Hand #84299363081:  Hold'em No Limit ($0.10/$0.25) - 2012/08/05 14:14:18 JST [2012/08/05 1:14:18 ET]
Table 'Whirlpool' 9-max Seat #1 is the button
Seat 1: Loholov ($16.51 in chips) 
Seat 2: chiyuki ($47.87 in chips) 
Seat 3: Ellen1947 ($41.05 in chips) 
Seat 4: DanielWhyte ($26.27 in chips) 
Seat 5: kamikkaze ($30.34 in chips) 
Seat 6: ChrisCDee ($28.68 in chips) 
Seat 7: Anafim ($12.50 in chips) 
Seat 8: BlOnDhOlIc ($78.69 in chips) 
Seat 9: Perstenev ($20.17 in chips) 
chiyuki: posts small blind $0.10
Ellen1947: posts big blind $0.25
*** HOLE CARDS ***
Dealt to chiyuki [6s 6h]
DanielWhyte: calls $0.25
kamikkaze: folds 
ChrisCDee: folds 
Anafim: raises $0.25 to $0.50
BlOnDhOlIc: folds 
Perstenev: folds 
Loholov: folds 
chiyuki: calls $0.40
Ellen1947: calls $0.25
DanielWhyte: calls $0.25
*** FLOP *** [7s Td 4s]
chiyuki: checks 
Ellen1947: checks 
DanielWhyte: bets $0.50
Anafim: folds 
chiyuki: calls $0.50
Ellen1947: folds 
*** TURN *** [7s Td 4s] [2h]
chiyuki: checks 
DanielWhyte: bets $0.75
chiyuki: calls $0.75
*** RIVER *** [7s Td 4s 2h] [Kc]
chiyuki: checks 
DanielWhyte: bets $1.25
chiyuki: folds 
Uncalled bet ($1.25) returned to DanielWhyte
DanielWhyte collected $4.30 from pot
DanielWhyte: doesn't show hand 
*** SUMMARY ***
Total pot $4.50 | Rake $0.20 
Board [7s Td 4s 2h Kc]
Seat 1: Loholov (button) folded before Flop (didn't bet)
Seat 2: chiyuki (small blind) folded on the River
Seat 3: Ellen1947 (big blind) folded on the Flop
Seat 4: DanielWhyte collected ($4.30)
Seat 5: kamikkaze folded before Flop (didn't bet)
Seat 6: ChrisCDee folded before Flop (didn't bet)
Seat 7: Anafim folded on the Flop
Seat 8: BlOnDhOlIc folded before Flop (didn't bet)
Seat 9: Perstenev folded before Flop (didn't bet)



PokerStars Zoom Hand #84299379923:  Hold'em No Limit ($0.10/$0.25) - 2012/08/05 14:15:25 JST [2012/08/05 1:15:25 ET]
Table 'Whirlpool' 9-max Seat #1 is the button
Seat 1: D@vidMed ($70.99 in chips) 
Seat 2: Faraz ($18.52 in chips) 
Seat 3: agurio ($27.03 in chips) 
Seat 4: JLajoie ($24.75 in chips) 
Seat 5: chiyuki ($46.12 in chips) 
Seat 6: gunbowler ($145.80 in chips) 
Seat 7: Roglus ($40.30 in chips) 
Seat 8: Jene4kaBest ($12.15 in chips) 
Seat 9: acamrash ($16.54 in chips) 
Faraz: posts small blind $0.10
agurio: posts big blind $0.25
*** HOLE CARDS ***
Dealt to chiyuki [Ks Jd]
JLajoie: folds 
chiyuki: folds 
gunbowler: folds 
Roglus: raises $0.50 to $0.75
Jene4kaBest: folds 
acamrash: folds 
D@vidMed: folds 
Faraz: folds 
agurio: folds 
Uncalled bet ($0.50) returned to Roglus
Roglus collected $0.60 from pot
Roglus: doesn't show hand 
*** SUMMARY ***
Total pot $0.60 | Rake $0 
Seat 1: D@vidMed (button) folded before Flop (didn't bet)
Seat 2: Faraz (small blind) folded before Flop
Seat 3: agurio (big blind) folded before Flop
Seat 4: JLajoie folded before Flop (didn't bet)
Seat 5: chiyuki folded before Flop (didn't bet)
Seat 6: gunbowler folded before Flop (didn't bet)
Seat 7: Roglus collected ($0.60)
Seat 8: Jene4kaBest folded before Flop (didn't bet)
Seat 9: acamrash folded before Flop (didn't bet)



PokerStars Zoom Hand #84299382131:  Hold'em No Limit ($0.10/$0.25) - 2012/08/05 14:15:34 JST [2012/08/05 1:15:34 ET]
Table 'Whirlpool' 9-max Seat #1 is the button
Seat 1: troms20 ($21.84 in chips) 
Seat 2: eyesJeJa ($26.32 in chips) 
Seat 3: seula i ($25 in chips) 
Seat 4: deadmoneykid ($24.30 in chips) 
Seat 5: Perstenev ($19.57 in chips) 
Seat 6: flyinprits ($30.44 in chips) 
Seat 7: chiyuki ($46.12 in chips) 
Seat 8: KeLevro0 ($11.45 in chips) 
Seat 9: giorgos_k ($13.38 in chips) 
eyesJeJa: posts small blind $0.10
seula i: posts big blind $0.25
*** HOLE CARDS ***
Dealt to chiyuki [7d 4d]
deadmoneykid: folds 
Perstenev: folds 
flyinprits: folds 
chiyuki: folds 
KeLevro0: folds 
giorgos_k: folds 
troms20: folds 
eyesJeJa: folds 
Uncalled bet ($0.15) returned to seula i
seula i collected $0.20 from pot
seula i: doesn't show hand 
*** SUMMARY ***
Total pot $0.20 | Rake $0 
Seat 1: troms20 (button) folded before Flop (didn't bet)
Seat 2: eyesJeJa (small blind) folded before Flop
Seat 3: seula i (big blind) collected ($0.20)
Seat 4: deadmoneykid folded before Flop (didn't bet)
Seat 5: Perstenev folded before Flop (didn't bet)
Seat 6: flyinprits folded before Flop (didn't bet)
Seat 7: chiyuki folded before Flop (didn't bet)
Seat 8: KeLevro0 folded before Flop (didn't bet)
Seat 9: giorgos_k folded before Flop (didn't bet)



PokerStars Zoom Hand #84299385433:  Hold'em No Limit ($0.10/$0.25) - 2012/08/05 14:15:47 JST [2012/08/05 1:15:47 ET]
Table 'Whirlpool' 9-max Seat #1 is the button
Seat 1: silvno31 ($39.90 in chips) 
Seat 2: Suhoff76 ($25 in chips) 
Seat 3: chiyuki ($46.12 in chips) 
Seat 4: wtu1986 ($32.57 in chips) 
Seat 5: mariuka1 ($15.85 in chips) 
Seat 6: fezman ($16.83 in chips) 
Seat 7: PetitAlejo ($35.51 in chips) 
Seat 8: kamikkaze ($30.97 in chips) 
Seat 9: eyesJeJa ($26.22 in chips) 
Suhoff76: posts small blind $0.10
chiyuki: posts big blind $0.25
*** HOLE CARDS ***
Dealt to chiyuki [8d 9s]
wtu1986: folds 
mariuka1: folds 
fezman: folds 
PetitAlejo: folds 
kamikkaze: folds 
eyesJeJa: folds 
silvno31: folds 
Suhoff76: folds 
Uncalled bet ($0.15) returned to chiyuki
chiyuki collected $0.20 from pot
chiyuki: doesn't show hand 
*** SUMMARY ***
Total pot $0.20 | Rake $0 
Seat 1: silvno31 (button) folded before Flop (didn't bet)
Seat 2: Suhoff76 (small blind) folded before Flop
Seat 3: chiyuki (big blind) collected ($0.20)
Seat 4: wtu1986 folded before Flop (didn't bet)
Seat 5: mariuka1 folded before Flop (didn't bet)
Seat 6: fezman folded before Flop (didn't bet)
Seat 7: PetitAlejo folded before Flop (didn't bet)
Seat 8: kamikkaze folded before Flop (didn't bet)
Seat 9: eyesJeJa folded before Flop (didn't bet)



PokerStars Zoom Hand #84299380909:  Hold'em No Limit ($0.10/$0.25) - 2012/08/05 14:15:29 JST [2012/08/05 1:15:29 ET]
Table 'Whirlpool' 9-max Seat #1 is the button
Seat 1: giorgos_k ($13.38 in chips) 
Seat 2: Nerkit ($12.52 in chips) 
Seat 3: johnbaco1209 ($24.58 in chips) 
Seat 4: Rudolf ($41.52 in chips) 
Seat 5: Anafim ($12.50 in chips) 
Seat 6: mariuka1 ($15.85 in chips) 
Seat 7: acamrash ($12.50 in chips) 
Seat 8: chiyuki ($46.12 in chips) 
Seat 9: Dafleche ($14.41 in chips) 
Nerkit: posts small blind $0.10
johnbaco1209: posts big blind $0.25
*** HOLE CARDS ***
Dealt to chiyuki [Qd 9s]
Rudolf: folds 
Anafim: folds 
mariuka1: folds 
acamrash: folds 
chiyuki: folds 
Dafleche: folds 
giorgos_k: folds 
Nerkit: raises $0.37 to $0.62
johnbaco1209: folds 
Uncalled bet ($0.37) returned to Nerkit
Nerkit collected $0.50 from pot
Nerkit: doesn't show hand 
*** SUMMARY ***
Total pot $0.50 | Rake $0 
Seat 1: giorgos_k (button) folded before Flop (didn't bet)
Seat 2: Nerkit (small blind) collected ($0.50)
Seat 3: johnbaco1209 (big blind) folded before Flop
Seat 4: Rudolf folded before Flop (didn't bet)
Seat 5: Anafim folded before Flop (didn't bet)
Seat 6: mariuka1 folded before Flop (didn't bet)
Seat 7: acamrash folded before Flop (didn't bet)
Seat 8: chiyuki folded before Flop (didn't bet)
Seat 9: Dafleche folded before Flop (didn't bet)



PokerStars Zoom Hand #84299383891:  Hold'em No Limit ($0.10/$0.25) - 2012/08/05 14:15:41 JST [2012/08/05 1:15:41 ET]
Table 'Whirlpool' 9-max Seat #1 is the button
Seat 1: eyesJeJa ($29.52 in chips) 
Seat 2: BlOnDhOlIc ($78.79 in chips) 
Seat 3: acamrash ($9.13 in chips) 
Seat 4: DONK1967 ($17.33 in chips) 
Seat 5: RikkStroken ($13.66 in chips) 
Seat 6: chiyuki ($46.12 in chips) 
Seat 7: Perstenev ($12.92 in chips) 
Seat 8: rellik1981 ($32.32 in chips) 
Seat 9: PetitAlejo ($29.74 in chips) 
BlOnDhOlIc: posts small blind $0.10
acamrash: posts big blind $0.25
*** HOLE CARDS ***
Dealt to chiyuki [Js Qs]
DONK1967: folds 
RikkStroken: folds 
chiyuki: folds 
Perstenev: folds 
rellik1981: folds 
PetitAlejo: folds 
eyesJeJa: folds 
BlOnDhOlIc: raises $0.25 to $0.50
acamrash: folds 
Uncalled bet ($0.25) returned to BlOnDhOlIc
BlOnDhOlIc collected $0.50 from pot
BlOnDhOlIc: doesn't show hand 
*** SUMMARY ***
Total pot $0.50 | Rake $0 
Seat 1: eyesJeJa (button) folded before Flop (didn't bet)
Seat 2: BlOnDhOlIc (small blind) collected ($0.50)
Seat 3: acamrash (big blind) folded before Flop
Seat 4: DONK1967 folded before Flop (didn't bet)
Seat 5: RikkStroken folded before Flop (didn't bet)
Seat 6: chiyuki folded before Flop (didn't bet)
Seat 7: Perstenev folded before Flop (didn't bet)
Seat 8: rellik1981 folded before Flop (didn't bet)
Seat 9: PetitAlejo folded before Flop (didn't bet)



PokerStars Zoom Hand #84299387381:  Hold'em No Limit ($0.10/$0.25) - 2012/08/05 14:15:56 JST [2012/08/05 1:15:56 ET]
Table 'Whirlpool' 9-max Seat #1 is the button
Seat 1: chiyuki ($46.22 in chips) 
Seat 2: Suhoff76 ($25.50 in chips) 
Seat 3: poorpoor6551 ($25 in chips) 
Seat 4: PetitAlejo ($35.51 in chips) 
Seat 5: Loholov ($17.90 in chips) 
Seat 6: leo2095 ($11.77 in chips) 
Seat 7: troms20 ($21.49 in chips) 
Seat 8: jeff0923 ($24.79 in chips) 
Seat 9: eyesJeJa ($29.52 in chips) 
Suhoff76: posts small blind $0.10
poorpoor6551: posts big blind $0.25
*** HOLE CARDS ***
Dealt to chiyuki [9d 6c]
PetitAlejo: folds 
Loholov: folds 
leo2095: folds 
troms20: folds 
jeff0923: folds 
eyesJeJa: folds 
chiyuki: folds 
Suhoff76: folds 
Uncalled bet ($0.15) returned to poorpoor6551
poorpoor6551 collected $0.20 from pot
poorpoor6551: doesn't show hand 
*** SUMMARY ***
Total pot $0.20 | Rake $0 
Seat 1: chiyuki (button) folded before Flop (didn't bet)
Seat 2: Suhoff76 (small blind) folded before Flop
Seat 3: poorpoor6551 (big blind) collected ($0.20)
Seat 4: PetitAlejo folded before Flop (didn't bet)
Seat 5: Loholov folded before Flop (didn't bet)
Seat 6: leo2095 folded before Flop (didn't bet)
Seat 7: troms20 folded before Flop (didn't bet)
Seat 8: jeff0923 folded before Flop (didn't bet)
Seat 9: eyesJeJa folded before Flop (didn't bet)



PokerStars Zoom Hand #84299389093:  Hold'em No Limit ($0.10/$0.25) - 2012/08/05 14:16:03 JST [2012/08/05 1:16:03 ET]
Table 'Whirlpool' 9-max Seat #1 is the button
Seat 1: Nerkit ($10.75 in chips) 
Seat 2: hirozo ($25 in chips) 
Seat 3: D@vidMed ($70.89 in chips) 
Seat 4: acamrash ($12.50 in chips) 
Seat 5: eyesJeJa ($26.22 in chips) 
Seat 6: PetitAlejo ($29.74 in chips) 
Seat 7: agurio ($26.68 in chips) 
Seat 8: wtu1986 ($32.67 in chips) 
Seat 9: chiyuki ($46.22 in chips) 
hirozo: posts small blind $0.10
D@vidMed: posts big blind $0.25
*** HOLE CARDS ***
Dealt to chiyuki [5d 9c]
acamrash: folds 
eyesJeJa: folds 
PetitAlejo: folds 
agurio: folds 
wtu1986: folds 
chiyuki: folds 
Nerkit: folds 
hirozo: raises $0.25 to $0.50
D@vidMed: folds 
Uncalled bet ($0.25) returned to hirozo
hirozo collected $0.50 from pot
hirozo: doesn't show hand 
*** SUMMARY ***
Total pot $0.50 | Rake $0 
Seat 1: Nerkit (button) folded before Flop (didn't bet)
Seat 2: hirozo (small blind) collected ($0.50)
Seat 3: D@vidMed (big blind) folded before Flop
Seat 4: acamrash folded before Flop (didn't bet)
Seat 5: eyesJeJa folded before Flop (didn't bet)
Seat 6: PetitAlejo folded before Flop (didn't bet)
Seat 7: agurio folded before Flop (didn't bet)
Seat 8: wtu1986 folded before Flop (didn't bet)
Seat 9: chiyuki folded before Flop (didn't bet)



PokerStars Zoom Hand #84299390381:  Hold'em No Limit ($0.10/$0.25) - 2012/08/05 14:16:08 JST [2012/08/05 1:16:08 ET]
Table 'Whirlpool' 9-max Seat #1 is the button
Seat 1: flyinprits ($30.19 in chips) 
Seat 2: chiyuki ($46.22 in chips) 
Seat 3: acamrash ($12.50 in chips) 
Seat 4: Anafim ($12.59 in chips) 
Seat 5: Dejacob ($44.55 in chips) 
Seat 6: KCDOGG10 ($12.20 in chips) 
Seat 7: Suhoff76 ($25 in chips) 
Seat 8: agurio ($26.68 in chips) 
Seat 9: giorgos_k ($13.73 in chips) 
chiyuki: posts small blind $0.10
acamrash: posts big blind $0.25
*** HOLE CARDS ***
Dealt to chiyuki [3h Kh]
Anafim: folds 
Dejacob: folds 
KCDOGG10: folds 
Suhoff76: raises $0.50 to $0.75
agurio: folds 
giorgos_k: folds 
flyinprits: calls $0.75
chiyuki: folds 
acamrash: folds 
*** FLOP *** [Kd Tc 8d]
Suhoff76: bets $1.36
flyinprits: folds 
Uncalled bet ($1.36) returned to Suhoff76
Suhoff76 collected $1.77 from pot
Suhoff76: doesn't show hand 
*** SUMMARY ***
Total pot $1.85 | Rake $0.08 
Board [Kd Tc 8d]
Seat 1: flyinprits (button) folded on the Flop
Seat 2: chiyuki (small blind) folded before Flop
Seat 3: acamrash (big blind) folded before Flop
Seat 4: Anafim folded before Flop (didn't bet)
Seat 5: Dejacob folded before Flop (didn't bet)
Seat 6: KCDOGG10 folded before Flop (didn't bet)
Seat 7: Suhoff76 collected ($1.77)
Seat 8: agurio folded before Flop (didn't bet)
Seat 9: giorgos_k folded before Flop (didn't bet)



PokerStars Zoom Hand #84299393629:  Hold'em No Limit ($0.10/$0.25) - 2012/08/05 14:16:21 JST [2012/08/05 1:16:21 ET]
Table 'Whirlpool' 9-max Seat #1 is the button
Seat 1: KCDOGG10 ($12.20 in chips) 
Seat 2: RikkStroken ($27.31 in chips) 
Seat 3: flyinprits ($35.11 in chips) 
Seat 4: phate-1up ($25 in chips) 
Seat 5: Roglus ($40.40 in chips) 
Seat 6: Suhoff76 ($25 in chips) 
Seat 7: chiyuki ($46.12 in chips) 
Seat 8: Nerkit ($9.53 in chips) 
Seat 9: Vahe50 ($20.16 in chips) 
RikkStroken: posts small blind $0.10
flyinprits: posts big blind $0.25
*** HOLE CARDS ***
Dealt to chiyuki [8s 5c]
phate-1up: folds 
Roglus: folds 
Suhoff76: folds 
chiyuki: folds 
Nerkit: folds 
Vahe50: folds 
KCDOGG10: folds 
RikkStroken: folds 
Uncalled bet ($0.15) returned to flyinprits
flyinprits collected $0.20 from pot
flyinprits: doesn't show hand 
*** SUMMARY ***
Total pot $0.20 | Rake $0 
Seat 1: KCDOGG10 (button) folded before Flop (didn't bet)
Seat 2: RikkStroken (small blind) folded before Flop
Seat 3: flyinprits (big blind) collected ($0.20)
Seat 4: phate-1up folded before Flop (didn't bet)
Seat 5: Roglus folded before Flop (didn't bet)
Seat 6: Suhoff76 folded before Flop (didn't bet)
Seat 7: chiyuki folded before Flop (didn't bet)
Seat 8: Nerkit folded before Flop (didn't bet)
Seat 9: Vahe50 folded before Flop (didn't bet)



PokerStars Zoom Hand #84299398060:  Hold'em No Limit ($0.10/$0.25) - 2012/08/05 14:16:39 JST [2012/08/05 1:16:39 ET]
Table 'Whirlpool' 9-max Seat #1 is the button
Seat 1: phate-1up ($25.45 in chips) 
Seat 2: eyesJeJa ($29.27 in chips) 
Seat 3: RikkStroken ($27.21 in chips) 
Seat 4: chiyuki ($46.12 in chips) 
Seat 5: JLajoie ($24.89 in chips) 
Seat 6: KeLevro0 ($10.78 in chips) 
Seat 7: Suhoff76 ($30.94 in chips) 
Seat 8: craden500 ($20.20 in chips) 
Seat 9: D@vidMed ($70.54 in chips) 
eyesJeJa: posts small blind $0.10
RikkStroken: posts big blind $0.25
*** HOLE CARDS ***
Dealt to chiyuki [9d Td]
chiyuki: folds 
JLajoie: raises $0.75 to $1
KeLevro0: folds 
Suhoff76: folds 
craden500: folds 
D@vidMed: folds 
phate-1up: folds 
eyesJeJa: folds 
RikkStroken: folds 
Uncalled bet ($0.75) returned to JLajoie
JLajoie collected $0.60 from pot
JLajoie: doesn't show hand 
*** SUMMARY ***
Total pot $0.60 | Rake $0 
Seat 1: phate-1up (button) folded before Flop (didn't bet)
Seat 2: eyesJeJa (small blind) folded before Flop
Seat 3: RikkStroken (big blind) folded before Flop
Seat 4: chiyuki folded before Flop (didn't bet)
Seat 5: JLajoie collected ($0.60)
Seat 6: KeLevro0 folded before Flop (didn't bet)
Seat 7: Suhoff76 folded before Flop (didn't bet)
Seat 8: craden500 folded before Flop (didn't bet)
Seat 9: D@vidMed folded before Flop (didn't bet)



PokerStars Zoom Hand #84299397038:  Hold'em No Limit ($0.10/$0.25) - 2012/08/05 14:16:35 JST [2012/08/05 1:16:35 ET]
Table 'Whirlpool' 9-max Seat #1 is the button
Seat 1: PetitAlejo ($35.73 in chips) 
Seat 2: RomarioJa ($11.26 in chips) 
Seat 3: agurio ($28.37 in chips) 
Seat 4: taksist889 ($42.30 in chips) 
Seat 5: chiyuki ($46.12 in chips) 
Seat 6: acamrash ($12.15 in chips) 
Seat 7: seula i ($25 in chips) 
Seat 8: flyinprits ($29.44 in chips) 
Seat 9: kkbruins0408 ($12.50 in chips) 
RomarioJa: posts small blind $0.10
agurio: posts big blind $0.25
*** HOLE CARDS ***
Dealt to chiyuki [Qc 5c]
taksist889: raises $0.50 to $0.75
chiyuki: folds 
acamrash: folds 
seula i: folds 
flyinprits: folds 
kkbruins0408: folds 
PetitAlejo: folds 
RomarioJa: folds 
agurio: folds 
Uncalled bet ($0.50) returned to taksist889
taksist889 collected $0.60 from pot
taksist889: doesn't show hand 
*** SUMMARY ***
Total pot $0.60 | Rake $0 
Seat 1: PetitAlejo (button) folded before Flop (didn't bet)
Seat 2: RomarioJa (small blind) folded before Flop
Seat 3: agurio (big blind) folded before Flop
Seat 4: taksist889 collected ($0.60)
Seat 5: chiyuki folded before Flop (didn't bet)
Seat 6: acamrash folded before Flop (didn't bet)
Seat 7: seula i folded before Flop (didn't bet)
Seat 8: flyinprits folded before Flop (didn't bet)
Seat 9: kkbruins0408 folded before Flop (didn't bet)



PokerStars Zoom Hand #84299395853:  Hold'em No Limit ($0.10/$0.25) - 2012/08/05 14:16:30 JST [2012/08/05 1:16:30 ET]
Table 'Whirlpool' 9-max Seat #1 is the button
Seat 1: BlOnDhOlIc ($60.21 in chips) 
Seat 2: hirozo ($35.78 in chips) 
Seat 3: KCDOGG10 ($12.20 in chips) 
Seat 4: Th3Fog ($46.86 in chips) 
Seat 5: kamikkaze ($15.62 in chips) 
Seat 6: Nerkit ($9.53 in chips) 
Seat 7: deadmoneykid ($23.95 in chips) 
Seat 8: chiyuki ($46.12 in chips) 
Seat 9: ChrisCDee ($26.13 in chips) 
hirozo: posts small blind $0.10
KCDOGG10: posts big blind $0.25
*** HOLE CARDS ***
Dealt to chiyuki [6h 9h]
Th3Fog: folds 
kamikkaze: raises $0.38 to $0.63
Nerkit: folds 
deadmoneykid: folds 
chiyuki: folds 
ChrisCDee: calls $0.63
BlOnDhOlIc: folds 
hirozo: folds 
KCDOGG10: folds 
*** FLOP *** [Kh Th As]
kamikkaze: bets $0.56
ChrisCDee: folds 
Uncalled bet ($0.56) returned to kamikkaze
kamikkaze collected $1.54 from pot
kamikkaze: doesn't show hand 
*** SUMMARY ***
Total pot $1.61 | Rake $0.07 
Board [Kh Th As]
Seat 1: BlOnDhOlIc (button) folded before Flop (didn't bet)
Seat 2: hirozo (small blind) folded before Flop
Seat 3: KCDOGG10 (big blind) folded before Flop
Seat 4: Th3Fog folded before Flop (didn't bet)
Seat 5: kamikkaze collected ($1.54)
Seat 6: Nerkit folded before Flop (didn't bet)
Seat 7: deadmoneykid folded before Flop (didn't bet)
Seat 8: chiyuki folded before Flop (didn't bet)
Seat 9: ChrisCDee folded on the Flop



PokerStars Zoom Hand #84299399122:  Hold'em No Limit ($0.10/$0.25) - 2012/08/05 14:16:43 JST [2012/08/05 1:16:43 ET]
Table 'Whirlpool' 9-max Seat #1 is the button
Seat 1: eyesJeJa ($29.17 in chips) 
Seat 2: craden500 ($20.20 in chips) 
Seat 3: chiyuki ($46.12 in chips) 
Seat 4: Dafleche ($15.21 in chips) 
Seat 5: flyinprits ($35.21 in chips) 
Seat 6: Nerkit ($10.50 in chips) 
Seat 7: 4ydo yogurt ($18.02 in chips) 
Seat 8: Th3Fog ($46.86 in chips) 
Seat 9: slapshot2011 ($33.69 in chips) 
craden500: posts small blind $0.10
chiyuki: posts big blind $0.25
*** HOLE CARDS ***
Dealt to chiyuki [2c 9c]
Dafleche: calls $0.25
flyinprits: folds 
Nerkit: folds 
4ydo yogurt: folds 
Th3Fog: folds 
slapshot2011: folds 
eyesJeJa: calls $0.25
craden500: folds 
chiyuki: checks 
*** FLOP *** [8d 8h 7d]
chiyuki: checks 
Dafleche: bets $0.25
eyesJeJa: folds 
chiyuki: folds 
Uncalled bet ($0.25) returned to Dafleche
Dafleche collected $0.81 from pot
Dafleche: doesn't show hand 
*** SUMMARY ***
Total pot $0.85 | Rake $0.04 
Board [8d 8h 7d]
Seat 1: eyesJeJa (button) folded on the Flop
Seat 2: craden500 (small blind) folded before Flop
Seat 3: chiyuki (big blind) folded on the Flop
Seat 4: Dafleche collected ($0.81)
Seat 5: flyinprits folded before Flop (didn't bet)
Seat 6: Nerkit folded before Flop (didn't bet)
Seat 7: 4ydo yogurt folded before Flop (didn't bet)
Seat 8: Th3Fog folded before Flop (didn't bet)
Seat 9: slapshot2011 folded before Flop (didn't bet)



PokerStars Zoom Hand #84299394611:  Hold'em No Limit ($0.10/$0.25) - 2012/08/05 14:16:25 JST [2012/08/05 1:16:25 ET]
Table 'Whirlpool' 9-max Seat #1 is the button
Seat 1: seula i ($29.75 in chips) 
Seat 2: Roglus ($40.40 in chips) 
Seat 3: phate-1up ($25 in chips) 
Seat 4: hirozo ($35.78 in chips) 
Seat 5: agurio ($26.68 in chips) 
Seat 6: chiyuki ($46.12 in chips) 
Seat 7: eyesJeJa ($25 in chips) 
Seat 8: Suhoff76 ($25 in chips) 
Seat 9: Nerkit ($10.75 in chips) 
Roglus: posts small blind $0.10
phate-1up: posts big blind $0.25
*** HOLE CARDS ***
Dealt to chiyuki [4h 8s]
hirozo: folds 
agurio: folds 
chiyuki: folds 
eyesJeJa: folds 
Suhoff76: folds 
Nerkit: folds 
seula i: raises $0.25 to $0.50
Roglus: raises $0.75 to $1.25
phate-1up: folds 
seula i: calls $0.75
*** FLOP *** [Ac 3s Kc]
Roglus: bets $1.75
seula i: calls $1.75
*** TURN *** [Ac 3s Kc] [7d]
Roglus: checks 
seula i: checks 
*** RIVER *** [Ac 3s Kc 7d] [Jh]
Roglus: bets $3.25
seula i: folds 
Uncalled bet ($3.25) returned to Roglus
Roglus collected $5.97 from pot
Roglus: doesn't show hand 
*** SUMMARY ***
Total pot $6.25 | Rake $0.28 
Board [Ac 3s Kc 7d Jh]
Seat 1: seula i (button) folded on the River
Seat 2: Roglus (small blind) collected ($5.97)
Seat 3: phate-1up (big blind) folded before Flop
Seat 4: hirozo folded before Flop (didn't bet)
Seat 5: agurio folded before Flop (didn't bet)
Seat 6: chiyuki folded before Flop (didn't bet)
Seat 7: eyesJeJa folded before Flop (didn't bet)
Seat 8: Suhoff76 folded before Flop (didn't bet)
Seat 9: Nerkit folded before Flop (didn't bet)



PokerStars Zoom Hand #84299404818:  Hold'em No Limit ($0.10/$0.25) - 2012/08/05 14:17:07 JST [2012/08/05 1:17:07 ET]
Table 'Whirlpool' 9-max Seat #1 is the button
Seat 1: Dejacob ($29.61 in chips) 
Seat 2: Th3Fog ($74.68 in chips) 
Seat 3: RomarioJa ($11.16 in chips) 
Seat 4: chiyuki ($45.87 in chips) 
Seat 5: acamrash ($13.73 in chips) 
Seat 6: kamikkaze ($32.56 in chips) 
Seat 7: simonzez ($47.62 in chips) 
Seat 8: PetitAlejo ($35.73 in chips) 
Seat 9: troms20 ($28.30 in chips) 
Th3Fog: posts small blind $0.10
RomarioJa: posts big blind $0.25
*** HOLE CARDS ***
Dealt to chiyuki [Ad 6h]
chiyuki: folds 
acamrash: folds 
kamikkaze: folds 
simonzez: folds 
PetitAlejo: folds 
troms20: folds 
Dejacob: folds 
Th3Fog: raises $0.47 to $0.72
RomarioJa: folds 
Uncalled bet ($0.47) returned to Th3Fog
Th3Fog collected $0.50 from pot
Th3Fog: doesn't show hand 
*** SUMMARY ***
Total pot $0.50 | Rake $0 
Seat 1: Dejacob (button) folded before Flop (didn't bet)
Seat 2: Th3Fog (small blind) collected ($0.50)
Seat 3: RomarioJa (big blind) folded before Flop
Seat 4: chiyuki folded before Flop (didn't bet)
Seat 5: acamrash folded before Flop (didn't bet)
Seat 6: kamikkaze folded before Flop (didn't bet)
Seat 7: simonzez folded before Flop (didn't bet)
Seat 8: PetitAlejo folded before Flop (didn't bet)
Seat 9: troms20 folded before Flop (didn't bet)



PokerStars Zoom Hand #84299406055:  Hold'em No Limit ($0.10/$0.25) - 2012/08/05 14:17:12 JST [2012/08/05 1:17:12 ET]
Table 'Whirlpool' 9-max Seat #1 is the button
Seat 1: PetitAlejo ($35.73 in chips) 
Seat 2: chiyuki ($45.87 in chips) 
Seat 3: Lasutchik ($58.78 in chips) 
Seat 4: eyesJeJa ($25.35 in chips) 
Seat 5: ChrisCDee ($25.50 in chips) 
Seat 6: Nerkit ($11.90 in chips) 
Seat 7: Ellen1947 ($28.05 in chips) 
Seat 8: hirozo ($35.43 in chips) 
Seat 9: luriks27 ($24.92 in chips) 
chiyuki: posts small blind $0.10
Lasutchik: posts big blind $0.25
*** HOLE CARDS ***
Dealt to chiyuki [Qc Kd]
eyesJeJa: folds 
ChrisCDee: raises $0.50 to $0.75
Nerkit: folds 
Ellen1947: folds 
hirozo: folds 
luriks27: folds 
PetitAlejo: folds 
chiyuki: folds 
Lasutchik: folds 
Uncalled bet ($0.50) returned to ChrisCDee
ChrisCDee collected $0.60 from pot
ChrisCDee: doesn't show hand 
*** SUMMARY ***
Total pot $0.60 | Rake $0 
Seat 1: PetitAlejo (button) folded before Flop (didn't bet)
Seat 2: chiyuki (small blind) folded before Flop
Seat 3: Lasutchik (big blind) folded before Flop
Seat 4: eyesJeJa folded before Flop (didn't bet)
Seat 5: ChrisCDee collected ($0.60)
Seat 6: Nerkit folded before Flop (didn't bet)
Seat 7: Ellen1947 folded before Flop (didn't bet)
Seat 8: hirozo folded before Flop (didn't bet)
Seat 9: luriks27 folded before Flop (didn't bet)



PokerStars Zoom Hand #84299409869:  Hold'em No Limit ($0.10/$0.25) - 2012/08/05 14:17:27 JST [2012/08/05 1:17:27 ET]
Table 'Whirlpool' 9-max Seat #1 is the button
Seat 1: chiyuki ($45.77 in chips) 
Seat 2: luriks27 ($24.92 in chips) 
Seat 3: Jene4kaBest ($13.36 in chips) 
Seat 4: roksmokndonk ($33.11 in chips) 
Seat 5: silvno31 ($36.65 in chips) 
Seat 6: Loholov ($15 in chips) 
Seat 7: Dejacob ($29.26 in chips) 
Seat 8: Tom1999 ($27.84 in chips) 
Seat 9: Th3Fog ($74.93 in chips) 
luriks27: posts small blind $0.10
Jene4kaBest: posts big blind $0.25
*** HOLE CARDS ***
Dealt to chiyuki [3h 5s]
roksmokndonk: folds 
silvno31: folds 
Loholov: folds 
Dejacob: raises $0.50 to $0.75
Tom1999: folds 
Th3Fog: folds 
chiyuki: folds 
luriks27: folds 
Jene4kaBest: folds 
Uncalled bet ($0.50) returned to Dejacob
Dejacob collected $0.60 from pot
Dejacob: doesn't show hand 
*** SUMMARY ***
Total pot $0.60 | Rake $0 
Seat 1: chiyuki (button) folded before Flop (didn't bet)
Seat 2: luriks27 (small blind) folded before Flop
Seat 3: Jene4kaBest (big blind) folded before Flop
Seat 4: roksmokndonk folded before Flop (didn't bet)
Seat 5: silvno31 folded before Flop (didn't bet)
Seat 6: Loholov folded before Flop (didn't bet)
Seat 7: Dejacob collected ($0.60)
Seat 8: Tom1999 folded before Flop (didn't bet)
Seat 9: Th3Fog folded before Flop (didn't bet)



PokerStars Zoom Hand #84299410647:  Hold'em No Limit ($0.10/$0.25) - 2012/08/05 14:17:30 JST [2012/08/05 1:17:30 ET]
Table 'Whirlpool' 9-max Seat #1 is the button
Seat 1: Noviekid ($54.23 in chips) 
Seat 2: Suhoff76 ($25 in chips) 
Seat 3: Faraz ($20.80 in chips) 
Seat 4: Tom1999 ($27.84 in chips) 
Seat 5: phate-1up ($34.59 in chips) 
Seat 6: hirozo ($35.43 in chips) 
Seat 7: PetitAlejo ($29.39 in chips) 
Seat 8: acamrash ($31.35 in chips) 
Seat 9: chiyuki ($45.77 in chips) 
Suhoff76: posts small blind $0.10
Faraz: posts big blind $0.25
*** HOLE CARDS ***
Dealt to chiyuki [4d 9h]
Tom1999: folds 
phate-1up: folds 
hirozo: folds 
PetitAlejo: folds 
acamrash: folds 
chiyuki: folds 
Noviekid: raises $0.25 to $0.50
Suhoff76: folds 
Faraz: folds 
Uncalled bet ($0.25) returned to Noviekid
Noviekid collected $0.60 from pot
Noviekid: doesn't show hand 
*** SUMMARY ***
Total pot $0.60 | Rake $0 
Seat 1: Noviekid (button) collected ($0.60)
Seat 2: Suhoff76 (small blind) folded before Flop
Seat 3: Faraz (big blind) folded before Flop
Seat 4: Tom1999 folded before Flop (didn't bet)
Seat 5: phate-1up folded before Flop (didn't bet)
Seat 6: hirozo folded before Flop (didn't bet)
Seat 7: PetitAlejo folded before Flop (didn't bet)
Seat 8: acamrash folded before Flop (didn't bet)
Seat 9: chiyuki folded before Flop (didn't bet)



PokerStars Zoom Hand #84299411360:  Hold'em No Limit ($0.10/$0.25) - 2012/08/05 14:17:33 JST [2012/08/05 1:17:33 ET]
Table 'Whirlpool' 9-max Seat #1 is the button
Seat 1: peng2astic ($7.22 in chips) 
Seat 2: seula i ($25.70 in chips) 
Seat 3: ChrisCDee ($25.85 in chips) 
Seat 4: chiyuki ($45.77 in chips) 
Seat 5: carlosrbr ($55.17 in chips) 
Seat 6: luriks27 ($24.82 in chips) 
Seat 7: kamikkaze ($16.78 in chips) 
Seat 8: RikkStroken ($13.86 in chips) 
Seat 9: wtu1986 ($32.67 in chips) 
seula i: posts small blind $0.10
ChrisCDee: posts big blind $0.25
*** HOLE CARDS ***
Dealt to chiyuki [Kh 9c]
chiyuki: folds 
carlosrbr: folds 
luriks27: folds 
kamikkaze: folds 
RikkStroken: folds 
wtu1986: raises $0.37 to $0.62
peng2astic: folds 
seula i: folds 
ChrisCDee: folds 
Uncalled bet ($0.37) returned to wtu1986
wtu1986 collected $0.60 from pot
wtu1986: doesn't show hand 
*** SUMMARY ***
Total pot $0.60 | Rake $0 
Seat 1: peng2astic (button) folded before Flop (didn't bet)
Seat 2: seula i (small blind) folded before Flop
Seat 3: ChrisCDee (big blind) folded before Flop
Seat 4: chiyuki folded before Flop (didn't bet)
Seat 5: carlosrbr folded before Flop (didn't bet)
Seat 6: luriks27 folded before Flop (didn't bet)
Seat 7: kamikkaze folded before Flop (didn't bet)
Seat 8: RikkStroken folded before Flop (didn't bet)
Seat 9: wtu1986 collected ($0.60)



PokerStars Zoom Hand #84299414861:  Hold'em No Limit ($0.10/$0.25) - 2012/08/05 14:17:47 JST [2012/08/05 1:17:47 ET]
Table 'Whirlpool' 9-max Seat #1 is the button
Seat 1: eyesJeJa ($25 in chips) 
Seat 2: BlOnDhOlIc ($59.96 in chips) 
Seat 3: Roglus ($43.37 in chips) 
Seat 4: phate-1up ($25 in chips) 
Seat 5: ChrisCDee ($68.48 in chips) 
Seat 6: kamikkaze ($32.56 in chips) 
Seat 7: Faraz ($20.55 in chips) 
Seat 8: chiyuki ($45.77 in chips) 
Seat 9: Tom1999 ($27.59 in chips) 
BlOnDhOlIc: posts small blind $0.10
Roglus: posts big blind $0.25
*** HOLE CARDS ***
Dealt to chiyuki [Qc 6d]
phate-1up: folds 
ChrisCDee: folds 
kamikkaze: folds 
Faraz: folds 
chiyuki: folds 
Tom1999: folds 
eyesJeJa: folds 
BlOnDhOlIc: raises $0.25 to $0.50
Roglus: folds 
Uncalled bet ($0.25) returned to BlOnDhOlIc
BlOnDhOlIc collected $0.50 from pot
BlOnDhOlIc: doesn't show hand 
*** SUMMARY ***
Total pot $0.50 | Rake $0 
Seat 1: eyesJeJa (button) folded before Flop (didn't bet)
Seat 2: BlOnDhOlIc (small blind) collected ($0.50)
Seat 3: Roglus (big blind) folded before Flop
Seat 4: phate-1up folded before Flop (didn't bet)
Seat 5: ChrisCDee folded before Flop (didn't bet)
Seat 6: kamikkaze folded before Flop (didn't bet)
Seat 7: Faraz folded before Flop (didn't bet)
Seat 8: chiyuki folded before Flop (didn't bet)
Seat 9: Tom1999 folded before Flop (didn't bet)



PokerStars Zoom Hand #84299413378:  Hold'em No Limit ($0.10/$0.25) - 2012/08/05 14:17:41 JST [2012/08/05 1:17:41 ET]
Table 'Whirlpool' 9-max Seat #1 is the button
Seat 1: Wilcox76607 ($21.75 in chips) 
Seat 2: Th3Fog ($17.11 in chips) 
Seat 3: PetitAlejo ($35.73 in chips) 
Seat 4: deadmoneykid ($23.45 in chips) 
Seat 5: chiyuki ($45.77 in chips) 
Seat 6: phate-1up ($25 in chips) 
Seat 7: RikkStroken ($11.45 in chips) 
Seat 8: Dejacob ($29.61 in chips) 
Seat 9: kamikkaze ($32.56 in chips) 
Th3Fog: posts small blind $0.10
PetitAlejo: posts big blind $0.25
*** HOLE CARDS ***
Dealt to chiyuki [7s Qs]
deadmoneykid: folds 
chiyuki: folds 
phate-1up: folds 
RikkStroken: folds 
Dejacob: folds 
kamikkaze: folds 
Wilcox76607: folds 
Th3Fog: raises $0.25 to $0.50
PetitAlejo: calls $0.25
*** FLOP *** [8s 6c 8h]
Th3Fog: bets $0.42
PetitAlejo: folds 
Uncalled bet ($0.42) returned to Th3Fog
Th3Fog collected $0.96 from pot
Th3Fog: doesn't show hand 
*** SUMMARY ***
Total pot $1 | Rake $0.04 
Board [8s 6c 8h]
Seat 1: Wilcox76607 (button) folded before Flop (didn't bet)
Seat 2: Th3Fog (small blind) collected ($0.96)
Seat 3: PetitAlejo (big blind) folded on the Flop
Seat 4: deadmoneykid folded before Flop (didn't bet)
Seat 5: chiyuki folded before Flop (didn't bet)
Seat 6: phate-1up folded before Flop (didn't bet)
Seat 7: RikkStroken folded before Flop (didn't bet)
Seat 8: Dejacob folded before Flop (didn't bet)
Seat 9: kamikkaze folded before Flop (didn't bet)



PokerStars Zoom Hand #84299416840:  Hold'em No Limit ($0.10/$0.25) - 2012/08/05 14:17:55 JST [2012/08/05 1:17:55 ET]
Table 'Whirlpool' 9-max Seat #1 is the button
Seat 1: Suhoff76 ($26.38 in chips) 
Seat 2: Perstenev ($13.54 in chips) 
Seat 3: chiyuki ($45.77 in chips) 
Seat 4: Tom1999 ($27.59 in chips) 
Seat 5: Loholov ($15 in chips) 
Seat 6: troms20 ($28.05 in chips) 
Seat 7: Scruf13 ($10.09 in chips) 
Seat 8: Anafim ($12.50 in chips) 
Seat 9: slapshot2011 ($33.19 in chips) 
Perstenev: posts small blind $0.10
chiyuki: posts big blind $0.25
*** HOLE CARDS ***
Dealt to chiyuki [Kc Td]
Tom1999: folds 
Loholov: folds 
troms20: folds 
Scruf13: raises $0.50 to $0.75
Anafim: folds 
slapshot2011: folds 
Suhoff76: folds 
Perstenev: folds 
chiyuki: folds 
Uncalled bet ($0.50) returned to Scruf13
Scruf13 collected $0.60 from pot
Scruf13: doesn't show hand 
*** SUMMARY ***
Total pot $0.60 | Rake $0 
Seat 1: Suhoff76 (button) folded before Flop (didn't bet)
Seat 2: Perstenev (small blind) folded before Flop
Seat 3: chiyuki (big blind) folded before Flop
Seat 4: Tom1999 folded before Flop (didn't bet)
Seat 5: Loholov folded before Flop (didn't bet)
Seat 6: troms20 folded before Flop (didn't bet)
Seat 7: Scruf13 collected ($0.60)
Seat 8: Anafim folded before Flop (didn't bet)
Seat 9: slapshot2011 folded before Flop (didn't bet)



PokerStars Zoom Hand #84299415864:  Hold'em No Limit ($0.10/$0.25) - 2012/08/05 14:17:51 JST [2012/08/05 1:17:51 ET]
Table 'Whirlpool' 9-max Seat #1 is the button
Seat 1: hirozo ($33.22 in chips) 
Seat 2: Vahe50 ($33.32 in chips) 
Seat 3: Lasutchik ($8.91 in chips) 
Seat 4: Ellen1947 ($28.05 in chips) 
Seat 5: jeff0923 ($25.10 in chips) 
Seat 6: el pore 5 ($16.52 in chips) 
Seat 7: chiyuki ($45.77 in chips) 
Seat 8: Perstenev ($13.54 in chips) 
Seat 9: eyesJeJa ($25 in chips) 
Vahe50: posts small blind $0.10
Lasutchik: posts big blind $0.25
*** HOLE CARDS ***
Dealt to chiyuki [4d 7d]
Ellen1947: folds 
jeff0923: folds 
el pore 5: folds 
chiyuki: folds 
Perstenev: folds 
eyesJeJa: folds 
hirozo: folds 
Vahe50: raises $0.50 to $0.75
Lasutchik: folds 
Uncalled bet ($0.50) returned to Vahe50
Vahe50 collected $0.50 from pot
Vahe50: doesn't show hand 
*** SUMMARY ***
Total pot $0.50 | Rake $0 
Seat 1: hirozo (button) folded before Flop (didn't bet)
Seat 2: Vahe50 (small blind) collected ($0.50)
Seat 3: Lasutchik (big blind) folded before Flop
Seat 4: Ellen1947 folded before Flop (didn't bet)
Seat 5: jeff0923 folded before Flop (didn't bet)
Seat 6: el pore 5 folded before Flop (didn't bet)
Seat 7: chiyuki folded before Flop (didn't bet)
Seat 8: Perstenev folded before Flop (didn't bet)
Seat 9: eyesJeJa folded before Flop (didn't bet)



PokerStars Zoom Hand #84299422778:  Hold'em No Limit ($0.10/$0.25) - 2012/08/05 14:18:20 JST [2012/08/05 1:18:20 ET]
Table 'Whirlpool' 9-max Seat #1 is the button
Seat 1: ChrisCDee ($68.38 in chips) 
Seat 2: chiyuki ($45.52 in chips) 
Seat 3: ladymadon107 ($4.31 in chips) 
Seat 4: cr0lox ($20.87 in chips) 
Seat 5: troms20 ($21.84 in chips) 
Seat 6: Scruf13 ($10.44 in chips) 
Seat 7: Nerkit ($11.55 in chips) 
Seat 8: Lasutchik ($58.43 in chips) 
Seat 9: BlOnDhOlIc ($38.56 in chips) 
chiyuki: posts small blind $0.10
ladymadon107: posts big blind $0.25
*** HOLE CARDS ***
Dealt to chiyuki [Jc 8s]
cr0lox: folds 
troms20: folds 
Scruf13: folds 
Nerkit: folds 
Lasutchik: raises $0.50 to $0.75
BlOnDhOlIc: folds 
ChrisCDee: folds 
chiyuki: folds 
ladymadon107: folds 
Uncalled bet ($0.50) returned to Lasutchik
Lasutchik collected $0.60 from pot
Lasutchik: doesn't show hand 
*** SUMMARY ***
Total pot $0.60 | Rake $0 
Seat 1: ChrisCDee (button) folded before Flop (didn't bet)
Seat 2: chiyuki (small blind) folded before Flop
Seat 3: ladymadon107 (big blind) folded before Flop
Seat 4: cr0lox folded before Flop (didn't bet)
Seat 5: troms20 folded before Flop (didn't bet)
Seat 6: Scruf13 folded before Flop (didn't bet)
Seat 7: Nerkit folded before Flop (didn't bet)
Seat 8: Lasutchik collected ($0.60)
Seat 9: BlOnDhOlIc folded before Flop (didn't bet)



PokerStars Zoom Hand #84299427219:  Hold'em No Limit ($0.10/$0.25) - 2012/08/05 14:18:38 JST [2012/08/05 1:18:38 ET]
Table 'Whirlpool' 9-max Seat #1 is the button
Seat 1: chiyuki ($45.42 in chips) 
Seat 2: Perstenev ($12.75 in chips) 
Seat 3: kkbruins0408 ($14.01 in chips) 
Seat 4: ygoegoe ($27.56 in chips) 
Seat 5: RomarioJa ($12.25 in chips) 
Seat 6: seula i ($26.45 in chips) 
Seat 7: Spartacus675 ($29.84 in chips) 
Seat 8: troms20 ($27.18 in chips) 
Seat 9: ChrisCDee ($68.38 in chips) 
Perstenev: posts small blind $0.10
kkbruins0408: posts big blind $0.25
*** HOLE CARDS ***
Dealt to chiyuki [7c 9d]
ygoegoe: folds 
RomarioJa: folds 
seula i: folds 
Spartacus675: folds 
troms20: folds 
ChrisCDee: folds 
chiyuki: folds 
Perstenev: folds 
Uncalled bet ($0.15) returned to kkbruins0408
kkbruins0408 collected $0.20 from pot
kkbruins0408: doesn't show hand 
*** SUMMARY ***
Total pot $0.20 | Rake $0 
Seat 1: chiyuki (button) folded before Flop (didn't bet)
Seat 2: Perstenev (small blind) folded before Flop
Seat 3: kkbruins0408 (big blind) collected ($0.20)
Seat 4: ygoegoe folded before Flop (didn't bet)
Seat 5: RomarioJa folded before Flop (didn't bet)
Seat 6: seula i folded before Flop (didn't bet)
Seat 7: Spartacus675 folded before Flop (didn't bet)
Seat 8: troms20 folded before Flop (didn't bet)
Seat 9: ChrisCDee folded before Flop (didn't bet)



PokerStars Zoom Hand #84299430278:  Hold'em No Limit ($0.10/$0.25) - 2012/08/05 14:18:50 JST [2012/08/05 1:18:50 ET]
Table 'Whirlpool' 9-max Seat #1 is the button
Seat 1: D@vidMed ($69.94 in chips) 
Seat 2: acamrash ($16.09 in chips) 
Seat 3: Nerkit ($11.55 in chips) 
Seat 4: seula i ($26.45 in chips) 
Seat 5: chiyuki ($45.42 in chips) 
Seat 6: Roglus ($42.27 in chips) 
Seat 7: peng2astic ($9.40 in chips) 
Seat 8: Perstenev ($12.65 in chips) 
Seat 9: eyesJeJa ($25.12 in chips) 
acamrash: posts small blind $0.10
Nerkit: posts big blind $0.25
*** HOLE CARDS ***
Dealt to chiyuki [8s 5h]
seula i: folds 
chiyuki: folds 
Roglus: folds 
peng2astic: folds 
Perstenev: folds 
eyesJeJa: folds 
D@vidMed: folds 
acamrash: folds 
Uncalled bet ($0.15) returned to Nerkit
Nerkit collected $0.20 from pot
Nerkit: doesn't show hand 
*** SUMMARY ***
Total pot $0.20 | Rake $0 
Seat 1: D@vidMed (button) folded before Flop (didn't bet)
Seat 2: acamrash (small blind) folded before Flop
Seat 3: Nerkit (big blind) collected ($0.20)
Seat 4: seula i folded before Flop (didn't bet)
Seat 5: chiyuki folded before Flop (didn't bet)
Seat 6: Roglus folded before Flop (didn't bet)
Seat 7: peng2astic folded before Flop (didn't bet)
Seat 8: Perstenev folded before Flop (didn't bet)
Seat 9: eyesJeJa folded before Flop (didn't bet)



PokerStars Zoom Hand #84299425717:  Hold'em No Limit ($0.10/$0.25) - 2012/08/05 14:18:32 JST [2012/08/05 1:18:32 ET]
Table 'Whirlpool' 9-max Seat #1 is the button
Seat 1: fezman ($14.23 in chips) 
Seat 2: Perstenev ($13.44 in chips) 
Seat 3: taksist889 ($25 in chips) 
Seat 4: Ellen1947 ($41.07 in chips) 
Seat 5: D@vidMed ($70.19 in chips) 
Seat 6: chiyuki ($45.42 in chips) 
Seat 7: BlOnDhOlIc ($38.56 in chips) 
Seat 8: PetitAlejo ($35.13 in chips) 
Seat 9: kamikkaze ($12.45 in chips) 
Perstenev: posts small blind $0.10
taksist889: posts big blind $0.25
*** HOLE CARDS ***
Dealt to chiyuki [7d 9s]
Ellen1947: folds 
D@vidMed: folds 
chiyuki: folds 
BlOnDhOlIc: raises $0.25 to $0.50
PetitAlejo: folds 
kamikkaze: folds 
fezman: folds 
Perstenev: folds 
taksist889: raises $1.50 to $2
BlOnDhOlIc: folds 
Uncalled bet ($1.50) returned to taksist889
taksist889 collected $1.10 from pot
taksist889: doesn't show hand 
*** SUMMARY ***
Total pot $1.10 | Rake $0 
Seat 1: fezman (button) folded before Flop (didn't bet)
Seat 2: Perstenev (small blind) folded before Flop
Seat 3: taksist889 (big blind) collected ($1.10)
Seat 4: Ellen1947 folded before Flop (didn't bet)
Seat 5: D@vidMed folded before Flop (didn't bet)
Seat 6: chiyuki folded before Flop (didn't bet)
Seat 7: BlOnDhOlIc folded before Flop
Seat 8: PetitAlejo folded before Flop (didn't bet)
Seat 9: kamikkaze folded before Flop (didn't bet)



PokerStars Zoom Hand #84299428234:  Hold'em No Limit ($0.10/$0.25) - 2012/08/05 14:18:42 JST [2012/08/05 1:18:42 ET]
Table 'Whirlpool' 9-max Seat #1 is the button
Seat 1: Perstenev ($12.65 in chips) 
Seat 2: phate-1up ($25 in chips) 
Seat 3: Suhoff76 ($26.73 in chips) 
Seat 4: ygoegoe ($27.56 in chips) 
Seat 5: Dejacob ($39.13 in chips) 
Seat 6: wtu1986 ($32.27 in chips) 
Seat 7: RomarioJa ($12.25 in chips) 
Seat 8: deadmoneykid ($23.02 in chips) 
Seat 9: chiyuki ($45.42 in chips) 
phate-1up: posts small blind $0.10
Suhoff76: posts big blind $0.25
*** HOLE CARDS ***
Dealt to chiyuki [Qc 5s]
ygoegoe: folds 
Dejacob: folds 
wtu1986: folds 
RomarioJa: raises $0.37 to $0.62
deadmoneykid: folds 
chiyuki: folds 
Perstenev: folds 
phate-1up: folds 
Suhoff76: folds 
Uncalled bet ($0.37) returned to RomarioJa
RomarioJa collected $0.60 from pot
RomarioJa: doesn't show hand 
*** SUMMARY ***
Total pot $0.60 | Rake $0 
Seat 1: Perstenev (button) folded before Flop (didn't bet)
Seat 2: phate-1up (small blind) folded before Flop
Seat 3: Suhoff76 (big blind) folded before Flop
Seat 4: ygoegoe folded before Flop (didn't bet)
Seat 5: Dejacob folded before Flop (didn't bet)
Seat 6: wtu1986 folded before Flop (didn't bet)
Seat 7: RomarioJa collected ($0.60)
Seat 8: deadmoneykid folded before Flop (didn't bet)
Seat 9: chiyuki folded before Flop (didn't bet)



PokerStars Zoom Hand #84299434538:  Hold'em No Limit ($0.10/$0.25) - 2012/08/05 14:19:07 JST [2012/08/05 1:19:07 ET]
Table 'Whirlpool' 9-max Seat #1 is the button
Seat 1: kkbruins0408 ($14.01 in chips) 
Seat 2: kamikkaze ($12.20 in chips) 
Seat 3: Ellen1947 ($41.07 in chips) 
Seat 4: Suhoff76 ($25 in chips) 
Seat 5: PetitAlejo ($36.11 in chips) 
Seat 6: Loholov ($33.64 in chips) 
Seat 7: chiyuki ($45.42 in chips) 
Seat 8: wildy29 ($13.41 in chips) 
Seat 9: Dejacob ($39.03 in chips) 
kamikkaze: posts small blind $0.10
Ellen1947: posts big blind $0.25
*** HOLE CARDS ***
Dealt to chiyuki [4h 6h]
Suhoff76: folds 
PetitAlejo: folds 
Loholov: folds 
chiyuki: folds 
wildy29: raises $0.75 to $1
Dejacob: calls $1
kkbruins0408: folds 
kamikkaze: folds 
Ellen1947: folds 
*** FLOP *** [9s 2s Ad]
wildy29: checks 
Dejacob: bets $1.75
wildy29: folds 
Uncalled bet ($1.75) returned to Dejacob
Dejacob collected $2.24 from pot
Dejacob: doesn't show hand 
*** SUMMARY ***
Total pot $2.35 | Rake $0.11 
Board [9s 2s Ad]
Seat 1: kkbruins0408 (button) folded before Flop (didn't bet)
Seat 2: kamikkaze (small blind) folded before Flop
Seat 3: Ellen1947 (big blind) folded before Flop
Seat 4: Suhoff76 folded before Flop (didn't bet)
Seat 5: PetitAlejo folded before Flop (didn't bet)
Seat 6: Loholov folded before Flop (didn't bet)
Seat 7: chiyuki folded before Flop (didn't bet)
Seat 8: wildy29 folded on the Flop
Seat 9: Dejacob collected ($2.24)



PokerStars Zoom Hand #84299436026:  Hold'em No Limit ($0.10/$0.25) - 2012/08/05 14:19:13 JST [2012/08/05 1:19:13 ET]
Table 'Whirlpool' 9-max Seat #1 is the button
Seat 1: chiyuki ($45.42 in chips) 
Seat 2: Loholov ($33.64 in chips) 
Seat 3: craden500 ($19.20 in chips) 
Seat 4: Vahe50 ($19.81 in chips) 
Seat 5: RomarioJa ($13.78 in chips) 
Seat 6: carlosrbr ($50.80 in chips) 
Seat 7: KeLevro0 ($11.47 in chips) 
Seat 8: Perstenev ($12.67 in chips) 
Seat 9: Jene4kaBest ($12.66 in chips) 
Loholov: posts small blind $0.10
craden500: posts big blind $0.25
*** HOLE CARDS ***
Dealt to chiyuki [4s Kh]
Vahe50: folds 
RomarioJa: folds 
carlosrbr: calls $0.25
KeLevro0: folds 
Perstenev: folds 
Jene4kaBest: folds 
chiyuki: folds 
Loholov: folds 
craden500: checks 
*** FLOP *** [Qh Qs As]
craden500: checks 
carlosrbr: bets $0.50
craden500: folds 
Uncalled bet ($0.50) returned to carlosrbr
carlosrbr collected $0.57 from pot
carlosrbr: doesn't show hand 
*** SUMMARY ***
Total pot $0.60 | Rake $0.03 
Board [Qh Qs As]
Seat 1: chiyuki (button) folded before Flop (didn't bet)
Seat 2: Loholov (small blind) folded before Flop
Seat 3: craden500 (big blind) folded on the Flop
Seat 4: Vahe50 folded before Flop (didn't bet)
Seat 5: RomarioJa folded before Flop (didn't bet)
Seat 6: carlosrbr collected ($0.57)
Seat 7: KeLevro0 folded before Flop (didn't bet)
Seat 8: Perstenev folded before Flop (didn't bet)
Seat 9: Jene4kaBest folded before Flop (didn't bet)



PokerStars Zoom Hand #84299437276:  Hold'em No Limit ($0.10/$0.25) - 2012/08/05 14:19:18 JST [2012/08/05 1:19:18 ET]
Table 'Whirlpool' 9-max Seat #1 is the button
Seat 1: RomarioJa ($12.50 in chips) 
Seat 2: el pore 5 ($14.52 in chips) 
Seat 3: chiyuki ($45.42 in chips) 
Seat 4: Suhoff76 ($26.48 in chips) 
Seat 5: Dejacob ($32.33 in chips) 
Seat 6: Ellen1947 ($28.05 in chips) 
Seat 7: seula i ($27.74 in chips) 
Seat 8: Jene4kaBest ($12.66 in chips) 
Seat 9: goddaz116 ($11.30 in chips) 
el pore 5: posts small blind $0.10
chiyuki: posts big blind $0.25
*** HOLE CARDS ***
Dealt to chiyuki [3h 5c]
Suhoff76: folds 
Dejacob: raises $0.50 to $0.75
Ellen1947: folds 
seula i: folds 
Jene4kaBest: folds 
goddaz116: folds 
RomarioJa: folds 
el pore 5: raises $3.50 to $4.25
chiyuki: folds 
Dejacob: folds 
Uncalled bet ($3.50) returned to el pore 5
el pore 5 collected $1.75 from pot
el pore 5: doesn't show hand 
*** SUMMARY ***
Total pot $1.75 | Rake $0 
Seat 1: RomarioJa (button) folded before Flop (didn't bet)
Seat 2: el pore 5 (small blind) collected ($1.75)
Seat 3: chiyuki (big blind) folded before Flop
Seat 4: Suhoff76 folded before Flop (didn't bet)
Seat 5: Dejacob folded before Flop
Seat 6: Ellen1947 folded before Flop (didn't bet)
Seat 7: seula i folded before Flop (didn't bet)
Seat 8: Jene4kaBest folded before Flop (didn't bet)
Seat 9: goddaz116 folded before Flop (didn't bet)



PokerStars Zoom Hand #84299442568:  Hold'em No Limit ($0.10/$0.25) - 2012/08/05 14:19:40 JST [2012/08/05 1:19:40 ET]
Table 'Whirlpool' 9-max Seat #1 is the button
Seat 1: WARIBANA7777 ($14.09 in chips) 
Seat 2: Ellen1947 ($40.82 in chips) 
Seat 3: PetitAlejo ($36.11 in chips) 
Seat 4: Jene4kaBest ($12.66 in chips) 
Seat 5: Loholov ($21.94 in chips) 
Seat 6: chiyuki ($45.17 in chips) 
Seat 7: phate-1up ($27.07 in chips) 
Seat 8: Dan Royal ($41.49 in chips) 
Seat 9: deadmoneykid ($23.38 in chips) 
Ellen1947: posts small blind $0.10
PetitAlejo: posts big blind $0.25
*** HOLE CARDS ***
Dealt to chiyuki [8h Th]
Jene4kaBest: folds 
Loholov: folds 
chiyuki: folds 
phate-1up: folds 
Dan Royal: folds 
deadmoneykid: folds 
WARIBANA7777: folds 
Ellen1947: folds 
Uncalled bet ($0.15) returned to PetitAlejo
PetitAlejo collected $0.20 from pot
PetitAlejo: doesn't show hand 
*** SUMMARY ***
Total pot $0.20 | Rake $0 
Seat 1: WARIBANA7777 (button) folded before Flop (didn't bet)
Seat 2: Ellen1947 (small blind) folded before Flop
Seat 3: PetitAlejo (big blind) collected ($0.20)
Seat 4: Jene4kaBest folded before Flop (didn't bet)
Seat 5: Loholov folded before Flop (didn't bet)
Seat 6: chiyuki folded before Flop (didn't bet)
Seat 7: phate-1up folded before Flop (didn't bet)
Seat 8: Dan Royal folded before Flop (didn't bet)
Seat 9: deadmoneykid folded before Flop (didn't bet)



PokerStars Zoom Hand #84299431582:  Hold'em No Limit ($0.10/$0.25) - 2012/08/05 14:18:55 JST [2012/08/05 1:18:55 ET]
Table 'Whirlpool' 9-max Seat #1 is the button
Seat 1: Dafleche ($15.07 in chips) 
Seat 2: Loholov ($16.85 in chips) 
Seat 3: leo2095 ($11.57 in chips) 
Seat 4: chiyuki ($45.42 in chips) 
Seat 5: peng2astic ($9.40 in chips) 
Seat 6: Ellen1947 ($28.05 in chips) 
Seat 7: Suhoff76 ($26.48 in chips) 
Seat 8: eyesJeJa ($25.12 in chips) 
Seat 9: Roglus ($42.27 in chips) 
Loholov: posts small blind $0.10
leo2095: posts big blind $0.25
*** HOLE CARDS ***
Dealt to chiyuki [Kc Qd]
chiyuki: folds 
peng2astic: raises $0.50 to $0.75
Ellen1947: folds 
Suhoff76: folds 
eyesJeJa: folds 
Roglus: raises $1.25 to $2
Dafleche: folds 
Loholov: folds 
leo2095: folds 
peng2astic: calls $1.25
*** FLOP *** [Jd 8d Qh]
peng2astic: checks 
Roglus: bets $2.82
peng2astic: calls $2.82
*** TURN *** [Jd 8d Qh] [7s]
peng2astic: checks 
Roglus: bets $3.33
peng2astic: raises $1.25 to $4.58 and is all-in
Roglus: calls $1.25
*** RIVER *** [Jd 8d Qh 7s] [Kh]
*** SHOW DOWN ***
peng2astic: shows [Th 9c] (a straight, Nine to King)
Roglus: shows [Jc Js] (three of a kind, Jacks)
peng2astic collected $18.29 from pot
*** SUMMARY ***
Total pot $19.15 | Rake $0.86 
Board [Jd 8d Qh 7s Kh]
Seat 1: Dafleche (button) folded before Flop (didn't bet)
Seat 2: Loholov (small blind) folded before Flop
Seat 3: leo2095 (big blind) folded before Flop
Seat 4: chiyuki folded before Flop (didn't bet)
Seat 5: peng2astic showed [Th 9c] and won ($18.29) with a straight, Nine to King
Seat 6: Ellen1947 folded before Flop (didn't bet)
Seat 7: Suhoff76 folded before Flop (didn't bet)
Seat 8: eyesJeJa folded before Flop (didn't bet)
Seat 9: Roglus showed [Jc Js] and lost with three of a kind, Jacks



PokerStars Zoom Hand #84299433094:  Hold'em No Limit ($0.10/$0.25) - 2012/08/05 14:19:01 JST [2012/08/05 1:19:01 ET]
Table 'Whirlpool' 9-max Seat #1 is the button
Seat 1: BlOnDhOlIc ($38.06 in chips) 
Seat 2: seula i ($26.45 in chips) 
Seat 3: el pore 5 ($14.77 in chips) 
Seat 4: hirozo ($33.57 in chips) 
Seat 5: Lasutchik ($8.66 in chips) 
Seat 6: wtu1986 ($25.18 in chips) 
Seat 7: phate-1up ($34.59 in chips) 
Seat 8: chiyuki ($45.42 in chips) 
Seat 9: Nerkit ($10.05 in chips) 
seula i: posts small blind $0.10
el pore 5: posts big blind $0.25
*** HOLE CARDS ***
Dealt to chiyuki [Kh 9c]
hirozo: folds 
Lasutchik: folds 
wtu1986: folds 
phate-1up: folds 
chiyuki: folds 
Nerkit: raises $0.50 to $0.75
BlOnDhOlIc: folds 
seula i: raises $2 to $2.75
el pore 5: folds 
Nerkit: calls $2
*** FLOP *** [9d Th Qc]
seula i: bets $3.25
Nerkit: calls $3.25
*** TURN *** [9d Th Qc] [5c]
seula i: bets $5
Nerkit: calls $4.05 and is all-in
Uncalled bet ($0.95) returned to seula i
*** RIVER *** [9d Th Qc 5c] [3d]
*** SHOW DOWN ***
seula i: shows [Ac Kc] (high card Ace)
Nerkit: shows [Ah Qd] (a pair of Queens)
Nerkit collected $19.43 from pot
*** SUMMARY ***
Total pot $20.35 | Rake $0.92 
Board [9d Th Qc 5c 3d]
Seat 1: BlOnDhOlIc (button) folded before Flop (didn't bet)
Seat 2: seula i (small blind) showed [Ac Kc] and lost with high card Ace
Seat 3: el pore 5 (big blind) folded before Flop
Seat 4: hirozo folded before Flop (didn't bet)
Seat 5: Lasutchik folded before Flop (didn't bet)
Seat 6: wtu1986 folded before Flop (didn't bet)
Seat 7: phate-1up folded before Flop (didn't bet)
Seat 8: chiyuki folded before Flop (didn't bet)
Seat 9: Nerkit showed [Ah Qd] and won ($19.43) with a pair of Queens



PokerStars Zoom Hand #84299447495:  Hold'em No Limit ($0.10/$0.25) - 2012/08/05 14:20:00 JST [2012/08/05 1:20:00 ET]
Table 'Whirlpool' 9-max Seat #1 is the button
Seat 1: Loholov ($16.50 in chips) 
Seat 2: KeLevro0 ($12.25 in chips) 
Seat 3: softdesign ($70.03 in chips) 
Seat 4: Landybob ($43.40 in chips) 
Seat 5: acamrash ($11.45 in chips) 
Seat 6: chiyuki ($45.07 in chips) 
Seat 7: wtu1986 ($32.10 in chips) 
Seat 8: silvno31 ($34.50 in chips) 
Seat 9: Dan Royal ($41.24 in chips) 
KeLevro0: posts small blind $0.10
softdesign: posts big blind $0.25
*** HOLE CARDS ***
Dealt to chiyuki [Jh 5d]
Landybob: folds 
acamrash: folds 
chiyuki: folds 
wtu1986: folds 
silvno31: folds 
Dan Royal: folds 
Loholov: folds 
KeLevro0: folds 
Uncalled bet ($0.15) returned to softdesign
softdesign collected $0.20 from pot
softdesign: doesn't show hand 
*** SUMMARY ***
Total pot $0.20 | Rake $0 
Seat 1: Loholov (button) folded before Flop (didn't bet)
Seat 2: KeLevro0 (small blind) folded before Flop
Seat 3: softdesign (big blind) collected ($0.20)
Seat 4: Landybob folded before Flop (didn't bet)
Seat 5: acamrash folded before Flop (didn't bet)
Seat 6: chiyuki folded before Flop (didn't bet)
Seat 7: wtu1986 folded before Flop (didn't bet)
Seat 8: silvno31 folded before Flop (didn't bet)
Seat 9: Dan Royal folded before Flop (didn't bet)



PokerStars Zoom Hand #84299444563:  Hold'em No Limit ($0.10/$0.25) - 2012/08/05 14:19:48 JST [2012/08/05 1:19:48 ET]
Table 'Whirlpool' 9-max Seat #1 is the button
Seat 1: wtu1986 ($32.10 in chips) 
Seat 2: kamikkaze ($31.12 in chips) 
Seat 3: ygoegoe ($27.46 in chips) 
Seat 4: hirozo ($35.93 in chips) 
Seat 5: Dejacob ($25.92 in chips) 
Seat 6: Loholov ($16.50 in chips) 
Seat 7: slapshot2011 ($31.84 in chips) 
Seat 8: chiyuki ($45.07 in chips) 
Seat 9: Ellen1947 ($40.72 in chips) 
kamikkaze: posts small blind $0.10
ygoegoe: posts big blind $0.25
*** HOLE CARDS ***
Dealt to chiyuki [9c Ks]
hirozo: folds 
Dejacob: folds 
Loholov: folds 
slapshot2011: calls $0.25
chiyuki: folds 
Ellen1947: folds 
wtu1986: folds 
kamikkaze: folds 
ygoegoe: checks 
*** FLOP *** [3d 4s Qs]
ygoegoe: checks 
slapshot2011: checks 
*** TURN *** [3d 4s Qs] [Th]
ygoegoe: checks 
slapshot2011: bets $0.75
ygoegoe: folds 
Uncalled bet ($0.75) returned to slapshot2011
slapshot2011 collected $0.57 from pot
slapshot2011: doesn't show hand 
*** SUMMARY ***
Total pot $0.60 | Rake $0.03 
Board [3d 4s Qs Th]
Seat 1: wtu1986 (button) folded before Flop (didn't bet)
Seat 2: kamikkaze (small blind) folded before Flop
Seat 3: ygoegoe (big blind) folded on the Turn
Seat 4: hirozo folded before Flop (didn't bet)
Seat 5: Dejacob folded before Flop (didn't bet)
Seat 6: Loholov folded before Flop (didn't bet)
Seat 7: slapshot2011 collected ($0.57)
Seat 8: chiyuki folded before Flop (didn't bet)
Seat 9: Ellen1947 folded before Flop (didn't bet)



PokerStars Zoom Hand #84299443289:  Hold'em No Limit ($0.10/$0.25) - 2012/08/05 14:19:43 JST [2012/08/05 1:19:43 ET]
Table 'Whirlpool' 9-max Seat #1 is the button
Seat 1: Perstenev ($11.49 in chips) 
Seat 2: chiyuki ($45.17 in chips) 
Seat 3: jeff0923 ($25.76 in chips) 
Seat 4: seula i ($60.19 in chips) 
Seat 5: hirozo ($35.93 in chips) 
Seat 6: Vadge-Basher ($7.62 in chips) 
Seat 7: ygoegoe ($27.46 in chips) 
Seat 8: kamikkaze ($31.12 in chips) 
Seat 9: wildy29 ($12.41 in chips) 
chiyuki: posts small blind $0.10
jeff0923: posts big blind $0.25
*** HOLE CARDS ***
Dealt to chiyuki [5d 6s]
seula i: raises $0.75 to $1
hirozo: folds 
Vadge-Basher: calls $1
ygoegoe: folds 
kamikkaze: folds 
wildy29: calls $1
Perstenev: folds 
chiyuki: folds 
jeff0923: folds 
*** FLOP *** [Jd Ts 8h]
seula i: bets $1.75
Vadge-Basher: raises $4.87 to $6.62 and is all-in
wildy29: folds 
seula i: calls $4.87
*** TURN *** [Jd Ts 8h] [7d]
*** RIVER *** [Jd Ts 8h 7d] [Qd]
*** SHOW DOWN ***
seula i: shows [Kd As] (a straight, Ten to Ace)
Vadge-Basher: shows [Js 9s] (a straight, Eight to Queen)
seula i collected $15.84 from pot
*** SUMMARY ***
Total pot $16.59 | Rake $0.75 
Board [Jd Ts 8h 7d Qd]
Seat 1: Perstenev (button) folded before Flop (didn't bet)
Seat 2: chiyuki (small blind) folded before Flop
Seat 3: jeff0923 (big blind) folded before Flop
Seat 4: seula i showed [Kd As] and won ($15.84) with a straight, Ten to Ace
Seat 5: hirozo folded before Flop (didn't bet)
Seat 6: Vadge-Basher showed [Js 9s] and lost with a straight, Eight to Queen
Seat 7: ygoegoe folded before Flop (didn't bet)
Seat 8: kamikkaze folded before Flop (didn't bet)
Seat 9: wildy29 folded on the Flop



PokerStars Zoom Hand #84299446786:  Hold'em No Limit ($0.10/$0.25) - 2012/08/05 14:19:57 JST [2012/08/05 1:19:57 ET]
Table 'Whirlpool' 9-max Seat #1 is the button
Seat 1: acamrash ($12.41 in chips) 
Seat 2: johnbaco1209 ($18.79 in chips) 
Seat 3: Dejacob ($40.27 in chips) 
Seat 4: chiyuki ($45.07 in chips) 
Seat 5: fezman ($14.23 in chips) 
Seat 6: Perstenev ($12.65 in chips) 
Seat 7: troms20 ($57.58 in chips) 
Seat 8: Déculotter69 ($17.02 in chips) 
Seat 9: Suhoff76 ($25 in chips) 
johnbaco1209: posts small blind $0.10
Dejacob: posts big blind $0.25
*** HOLE CARDS ***
Dealt to chiyuki [6c Qh]
chiyuki: folds 
fezman: folds 
Perstenev: calls $0.25
troms20: folds 
Déculotter69: folds 
Suhoff76: folds 
acamrash: folds 
johnbaco1209: folds 
Dejacob: checks 
*** FLOP *** [Kc Ah 5s]
Dejacob: checks 
Perstenev: bets $0.28
Dejacob: folds 
Uncalled bet ($0.28) returned to Perstenev
Perstenev collected $0.57 from pot
Perstenev: doesn't show hand 
*** SUMMARY ***
Total pot $0.60 | Rake $0.03 
Board [Kc Ah 5s]
Seat 1: acamrash (button) folded before Flop (didn't bet)
Seat 2: johnbaco1209 (small blind) folded before Flop
Seat 3: Dejacob (big blind) folded on the Flop
Seat 4: chiyuki folded before Flop (didn't bet)
Seat 5: fezman folded before Flop (didn't bet)
Seat 6: Perstenev collected ($0.57)
Seat 7: troms20 folded before Flop (didn't bet)
Seat 8: Déculotter69 folded before Flop (didn't bet)
Seat 9: Suhoff76 folded before Flop (didn't bet)



PokerStars Zoom Hand #84299449189:  Hold'em No Limit ($0.10/$0.25) - 2012/08/05 14:20:07 JST [2012/08/05 1:20:07 ET]
Table 'Whirlpool' 9-max Seat #1 is the button
Seat 1: RomarioJa ($14.36 in chips) 
Seat 2: phate-1up ($26.85 in chips) 
Seat 3: Loholov ($15 in chips) 
Seat 4: Ellen1947 ($40.72 in chips) 
Seat 5: RikkStroken ($21.31 in chips) 
Seat 6: johnbaco1209 ($18.69 in chips) 
Seat 7: chiyuki ($45.07 in chips) 
Seat 8: acamrash ($12.41 in chips) 
Seat 9: Jene4kaBest ($12.41 in chips) 
phate-1up: posts small blind $0.10
Loholov: posts big blind $0.25
*** HOLE CARDS ***
Dealt to chiyuki [Tc 4c]
Ellen1947: folds 
RikkStroken: folds 
johnbaco1209: folds 
chiyuki: folds 
acamrash: folds 
Jene4kaBest: folds 
RomarioJa: folds 
phate-1up: raises $0.50 to $0.75
Loholov: folds 
Uncalled bet ($0.50) returned to phate-1up
phate-1up collected $0.50 from pot
phate-1up: doesn't show hand 
*** SUMMARY ***
Total pot $0.50 | Rake $0 
Seat 1: RomarioJa (button) folded before Flop (didn't bet)
Seat 2: phate-1up (small blind) collected ($0.50)
Seat 3: Loholov (big blind) folded before Flop
Seat 4: Ellen1947 folded before Flop (didn't bet)
Seat 5: RikkStroken folded before Flop (didn't bet)
Seat 6: johnbaco1209 folded before Flop (didn't bet)
Seat 7: chiyuki folded before Flop (didn't bet)
Seat 8: acamrash folded before Flop (didn't bet)
Seat 9: Jene4kaBest folded before Flop (didn't bet)



PokerStars Zoom Hand #84299446064:  Hold'em No Limit ($0.10/$0.25) - 2012/08/05 14:19:54 JST [2012/08/05 1:19:54 ET]
Table 'Whirlpool' 9-max Seat #1 is the button
Seat 1: Perstenev ($12.65 in chips) 
Seat 2: peng2astic ($18.29 in chips) 
Seat 3: PetitAlejo ($29.52 in chips) 
Seat 4: kamikkaze ($31.02 in chips) 
Seat 5: Nerkit ($12.50 in chips) 
Seat 6: Th3Fog ($73.93 in chips) 
Seat 7: KeLevro0 ($12.15 in chips) 
Seat 8: dushvan ($30.32 in chips) 
Seat 9: chiyuki ($45.07 in chips) 
peng2astic: posts small blind $0.10
PetitAlejo: posts big blind $0.25
*** HOLE CARDS ***
Dealt to chiyuki [As 2h]
kamikkaze: folds 
Nerkit: folds 
Th3Fog: folds 
KeLevro0: folds 
dushvan: raises $0.50 to $0.75
chiyuki: folds 
Perstenev: folds 
peng2astic: calls $0.65
PetitAlejo: folds 
*** FLOP *** [Qh 2c 4s]
peng2astic: bets $1.50
dushvan: folds 
Uncalled bet ($1.50) returned to peng2astic
peng2astic collected $1.67 from pot
peng2astic: doesn't show hand 
*** SUMMARY ***
Total pot $1.75 | Rake $0.08 
Board [Qh 2c 4s]
Seat 1: Perstenev (button) folded before Flop (didn't bet)
Seat 2: peng2astic (small blind) collected ($1.67)
Seat 3: PetitAlejo (big blind) folded before Flop
Seat 4: kamikkaze folded before Flop (didn't bet)
Seat 5: Nerkit folded before Flop (didn't bet)
Seat 6: Th3Fog folded before Flop (didn't bet)
Seat 7: KeLevro0 folded before Flop (didn't bet)
Seat 8: dushvan folded on the Flop
Seat 9: chiyuki folded before Flop (didn't bet)



PokerStars Zoom Hand #84299450162:  Hold'em No Limit ($0.10/$0.25) - 2012/08/05 14:20:11 JST [2012/08/05 1:20:11 ET]
Table 'Whirlpool' 9-max Seat #1 is the button
Seat 1: chiyuki ($45.07 in chips) 
Seat 2: hirozo ($33.22 in chips) 
Seat 3: D@vidMed ($67.84 in chips) 
Seat 4: Dejacob ($25 in chips) 
Seat 5: silvno31 ($34.50 in chips) 
Seat 6: wtu1986 ($32.10 in chips) 
Seat 7: acamrash ($11.35 in chips) 
Seat 8: Perstenev ($13.26 in chips) 
Seat 9: leo2095 ($14.21 in chips) 
hirozo: posts small blind $0.10
D@vidMed: posts big blind $0.25
*** HOLE CARDS ***
Dealt to chiyuki [Js 9s]
Dejacob: folds 
silvno31: folds 
wtu1986: folds 
acamrash: folds 
Perstenev: folds 
leo2095: folds 
chiyuki: raises $0.50 to $0.75
hirozo: folds 
D@vidMed: calls $0.50
*** FLOP *** [9c Kh 9d]
D@vidMed: checks 
chiyuki: bets $1
D@vidMed: folds 
Uncalled bet ($1) returned to chiyuki
chiyuki collected $1.53 from pot
chiyuki: doesn't show hand 
*** SUMMARY ***
Total pot $1.60 | Rake $0.07 
Board [9c Kh 9d]
Seat 1: chiyuki (button) collected ($1.53)
Seat 2: hirozo (small blind) folded before Flop
Seat 3: D@vidMed (big blind) folded on the Flop
Seat 4: Dejacob folded before Flop (didn't bet)
Seat 5: silvno31 folded before Flop (didn't bet)
Seat 6: wtu1986 folded before Flop (didn't bet)
Seat 7: acamrash folded before Flop (didn't bet)
Seat 8: Perstenev folded before Flop (didn't bet)
Seat 9: leo2095 folded before Flop (didn't bet)



PokerStars Zoom Hand #84299467591:  Hold'em No Limit ($0.10/$0.25) - 2012/08/05 14:21:22 JST [2012/08/05 1:21:22 ET]
Table 'Whirlpool' 9-max Seat #1 is the button
Seat 1: johnbaco1209 ($36.39 in chips) 
Seat 2: Lasutchik ($8.06 in chips) 
Seat 3: chiyuki ($45.85 in chips) 
Seat 4: deadmoneykid ($22.67 in chips) 
Seat 5: Dejacob ($25.92 in chips) 
Seat 6: RikkStroken ($28.66 in chips) 
Seat 7: seula i ($25 in chips) 
Seat 8: RomarioJa ($10.56 in chips) 
Seat 9: Suhoff76 ($25 in chips) 
Lasutchik: posts small blind $0.10
chiyuki: posts big blind $0.25
*** HOLE CARDS ***
Dealt to chiyuki [Ks 6d]
deadmoneykid: folds 
Dejacob: folds 
RikkStroken: folds 
seula i: folds 
RomarioJa: folds 
Suhoff76: folds 
johnbaco1209: raises $0.50 to $0.75
Lasutchik: folds 
chiyuki: folds 
Uncalled bet ($0.50) returned to johnbaco1209
johnbaco1209 collected $0.60 from pot
johnbaco1209: doesn't show hand 
*** SUMMARY ***
Total pot $0.60 | Rake $0 
Seat 1: johnbaco1209 (button) collected ($0.60)
Seat 2: Lasutchik (small blind) folded before Flop
Seat 3: chiyuki (big blind) folded before Flop
Seat 4: deadmoneykid folded before Flop (didn't bet)
Seat 5: Dejacob folded before Flop (didn't bet)
Seat 6: RikkStroken folded before Flop (didn't bet)
Seat 7: seula i folded before Flop (didn't bet)
Seat 8: RomarioJa folded before Flop (didn't bet)
Seat 9: Suhoff76 folded before Flop (didn't bet)



PokerStars Zoom Hand #84299471617:  Hold'em No Limit ($0.10/$0.25) - 2012/08/05 14:21:38 JST [2012/08/05 1:21:38 ET]
Table 'Whirlpool' 9-max Seat #1 is the button
Seat 1: silvno31 ($34.50 in chips) 
Seat 2: RikkStroken ($19.41 in chips) 
Seat 3: deadmoneykid ($31.05 in chips) 
Seat 4: hirozo ($32.87 in chips) 
Seat 5: chiyuki ($45.60 in chips) 
Seat 6: wtu1986 ($31.49 in chips) 
Seat 7: Suhoff76 ($25 in chips) 
Seat 8: Th3Fog ($73.18 in chips) 
Seat 9: troms20 ($21.49 in chips) 
RikkStroken: posts small blind $0.10
deadmoneykid: posts big blind $0.25
*** HOLE CARDS ***
Dealt to chiyuki [Qs 7s]
hirozo: folds 
chiyuki: folds 
wtu1986: folds 
Suhoff76: folds 
Th3Fog: folds 
troms20: raises $0.50 to $0.75
silvno31: folds 
RikkStroken: folds 
deadmoneykid: folds 
Uncalled bet ($0.50) returned to troms20
troms20 collected $0.60 from pot
troms20: doesn't show hand 
*** SUMMARY ***
Total pot $0.60 | Rake $0 
Seat 1: silvno31 (button) folded before Flop (didn't bet)
Seat 2: RikkStroken (small blind) folded before Flop
Seat 3: deadmoneykid (big blind) folded before Flop
Seat 4: hirozo folded before Flop (didn't bet)
Seat 5: chiyuki folded before Flop (didn't bet)
Seat 6: wtu1986 folded before Flop (didn't bet)
Seat 7: Suhoff76 folded before Flop (didn't bet)
Seat 8: Th3Fog folded before Flop (didn't bet)
Seat 9: troms20 collected ($0.60)



PokerStars Zoom Hand #84299473351:  Hold'em No Limit ($0.10/$0.25) - 2012/08/05 14:21:45 JST [2012/08/05 1:21:45 ET]
Table 'Whirlpool' 9-max Seat #1 is the button
Seat 1: PetitAlejo ($50.11 in chips) 
Seat 2: chiyuki ($45.60 in chips) 
Seat 3: Th3Fog ($50.10 in chips) 
Seat 4: wtu1986 ($31.49 in chips) 
Seat 5: RikkStroken ($6.40 in chips) 
Seat 6: Noviekid ($91.17 in chips) 
Seat 7: Suhoff76 ($28.04 in chips) 
Seat 8: Perstenev ($11.97 in chips) 
Seat 9: RomarioJa ($14.71 in chips) 
chiyuki: posts small blind $0.10
Th3Fog: posts big blind $0.25
*** HOLE CARDS ***
Dealt to chiyuki [Td Kh]
wtu1986: folds 
RikkStroken: folds 
Noviekid: folds 
Suhoff76: folds 
Perstenev: folds 
RomarioJa: folds 
PetitAlejo: raises $0.50 to $0.75
chiyuki: folds 
Th3Fog: folds 
Uncalled bet ($0.50) returned to PetitAlejo
PetitAlejo collected $0.60 from pot
PetitAlejo: doesn't show hand 
*** SUMMARY ***
Total pot $0.60 | Rake $0 
Seat 1: PetitAlejo (button) collected ($0.60)
Seat 2: chiyuki (small blind) folded before Flop
Seat 3: Th3Fog (big blind) folded before Flop
Seat 4: wtu1986 folded before Flop (didn't bet)
Seat 5: RikkStroken folded before Flop (didn't bet)
Seat 6: Noviekid folded before Flop (didn't bet)
Seat 7: Suhoff76 folded before Flop (didn't bet)
Seat 8: Perstenev folded before Flop (didn't bet)
Seat 9: RomarioJa folded before Flop (didn't bet)



PokerStars Zoom Hand #84299477542:  Hold'em No Limit ($0.10/$0.25) - 2012/08/05 14:22:02 JST [2012/08/05 1:22:02 ET]
Table 'Whirlpool' 9-max Seat #1 is the button
Seat 1: Suhoff76 ($25 in chips) 
Seat 2: KCDOGG10 ($11.65 in chips) 
Seat 3: craden500 ($17.70 in chips) 
Seat 4: Perstenev ($11.97 in chips) 
Seat 5: acamrash ($11.65 in chips) 
Seat 6: ygoegoe ($28.03 in chips) 
Seat 7: PetitAlejo ($50.46 in chips) 
Seat 8: wtu1986 ($32.05 in chips) 
Seat 9: chiyuki ($45.50 in chips) 
KCDOGG10: posts small blind $0.10
craden500: posts big blind $0.25
*** HOLE CARDS ***
Dealt to chiyuki [9c 5d]
Perstenev: folds 
acamrash: folds 
ygoegoe: folds 
PetitAlejo: folds 
wtu1986: folds 
chiyuki: folds 
Suhoff76: folds 
KCDOGG10: folds 
Uncalled bet ($0.15) returned to craden500
craden500 collected $0.20 from pot
craden500: doesn't show hand 
*** SUMMARY ***
Total pot $0.20 | Rake $0 
Seat 1: Suhoff76 (button) folded before Flop (didn't bet)
Seat 2: KCDOGG10 (small blind) folded before Flop
Seat 3: craden500 (big blind) collected ($0.20)
Seat 4: Perstenev folded before Flop (didn't bet)
Seat 5: acamrash folded before Flop (didn't bet)
Seat 6: ygoegoe folded before Flop (didn't bet)
Seat 7: PetitAlejo folded before Flop (didn't bet)
Seat 8: wtu1986 folded before Flop (didn't bet)
Seat 9: chiyuki folded before Flop (didn't bet)



PokerStars Zoom Hand #84299463899:  Hold'em No Limit ($0.10/$0.25) - 2012/08/05 14:21:07 JST [2012/08/05 1:21:07 ET]
Table 'Whirlpool' 9-max Seat #1 is the button
Seat 1: flyinprits ($28.69 in chips) 
Seat 2: dushvan ($29.57 in chips) 
Seat 3: mariuka1 ($12.15 in chips) 
Seat 4: peng2astic ($19.21 in chips) 
Seat 5: chiyuki ($45.85 in chips) 
Seat 6: Dan Royal ($42.16 in chips) 
Seat 7: jeff0923 ($25.73 in chips) 
Seat 8: Perstenev ($13.21 in chips) 
Seat 9: fezman ($13.38 in chips) 
dushvan: posts small blind $0.10
mariuka1: posts big blind $0.25
*** HOLE CARDS ***
Dealt to chiyuki [8h Qs]
peng2astic: folds 
chiyuki: folds 
Dan Royal: folds 
jeff0923: calls $0.25
Perstenev: folds 
fezman: raises $0.50 to $0.75
flyinprits: folds 
dushvan: folds 
mariuka1: folds 
jeff0923: calls $0.50
*** FLOP *** [7c 5c Kh]
jeff0923: checks 
fezman: bets $1.25
jeff0923: calls $1.25
*** TURN *** [7c 5c Kh] [Qd]
jeff0923: checks 
fezman: bets $1.50
jeff0923: calls $1.50
*** RIVER *** [7c 5c Kh Qd] [7d]
jeff0923: checks 
fezman: checks 
*** SHOW DOWN ***
jeff0923: shows [Jc Qc] (two pair, Queens and Sevens)
fezman: shows [Js Kc] (two pair, Kings and Sevens)
fezman collected $7.02 from pot
*** SUMMARY ***
Total pot $7.35 | Rake $0.33 
Board [7c 5c Kh Qd 7d]
Seat 1: flyinprits (button) folded before Flop (didn't bet)
Seat 2: dushvan (small blind) folded before Flop
Seat 3: mariuka1 (big blind) folded before Flop
Seat 4: peng2astic folded before Flop (didn't bet)
Seat 5: chiyuki folded before Flop (didn't bet)
Seat 6: Dan Royal folded before Flop (didn't bet)
Seat 7: jeff0923 showed [Jc Qc] and lost with two pair, Queens and Sevens
Seat 8: Perstenev folded before Flop (didn't bet)
Seat 9: fezman showed [Js Kc] and won ($7.02) with two pair, Kings and Sevens



PokerStars Zoom Hand #84299478325:  Hold'em No Limit ($0.10/$0.25) - 2012/08/05 14:22:05 JST [2012/08/05 1:22:05 ET]
Table 'Whirlpool' 9-max Seat #1 is the button
Seat 1: RikkStroken ($19.31 in chips) 
Seat 2: hirozo ($36.38 in chips) 
Seat 3: leo2095 ($13.54 in chips) 
Seat 4: troms20 ($21.84 in chips) 
Seat 5: slapshot2011 ($31.48 in chips) 
Seat 6: KeLevro0 ($11.13 in chips) 
Seat 7: chiyuki ($45.50 in chips) 
Seat 8: Dejacob ($46.61 in chips) 
Seat 9: Nerkit ($13.39 in chips) 
hirozo: posts small blind $0.10
leo2095: posts big blind $0.25
*** HOLE CARDS ***
Dealt to chiyuki [Ts 9c]
troms20: folds 
slapshot2011: folds 
KeLevro0: folds 
chiyuki: folds 
Dejacob: folds 
Nerkit: folds 
RikkStroken: folds 
hirozo: raises $0.25 to $0.50
leo2095: folds 
Uncalled bet ($0.25) returned to hirozo
hirozo collected $0.50 from pot
hirozo: doesn't show hand 
*** SUMMARY ***
Total pot $0.50 | Rake $0 
Seat 1: RikkStroken (button) folded before Flop (didn't bet)
Seat 2: hirozo (small blind) collected ($0.50)
Seat 3: leo2095 (big blind) folded before Flop
Seat 4: troms20 folded before Flop (didn't bet)
Seat 5: slapshot2011 folded before Flop (didn't bet)
Seat 6: KeLevro0 folded before Flop (didn't bet)
Seat 7: chiyuki folded before Flop (didn't bet)
Seat 8: Dejacob folded before Flop (didn't bet)
Seat 9: Nerkit folded before Flop (didn't bet)



PokerStars Zoom Hand #84299479817:  Hold'em No Limit ($0.10/$0.25) - 2012/08/05 14:22:11 JST [2012/08/05 1:22:11 ET]
Table 'Whirlpool' 9-max Seat #1 is the button
Seat 1: chiyuki ($45.50 in chips) 
Seat 2: Paranoix1990 ($5.82 in chips) 
Seat 3: acamrash ($11.65 in chips) 
Seat 4: Faraz ($21.55 in chips) 
Seat 5: Suhoff76 ($25 in chips) 
Seat 6: PetitAlejo ($33.51 in chips) 
Seat 7: Lasutchik ($7.21 in chips) 
Seat 8: Jene4kaBest ($11.56 in chips) 
Seat 9: Dafleche ($28.72 in chips) 
Paranoix1990: posts small blind $0.10
acamrash: posts big blind $0.25
*** HOLE CARDS ***
Dealt to chiyuki [3d 7c]
Faraz: folds 
Suhoff76: folds 
PetitAlejo: folds 
Lasutchik: folds 
Jene4kaBest: folds 
Dafleche: folds 
chiyuki: folds 
Paranoix1990: folds 
Uncalled bet ($0.15) returned to acamrash
acamrash collected $0.20 from pot
acamrash: doesn't show hand 
*** SUMMARY ***
Total pot $0.20 | Rake $0 
Seat 1: chiyuki (button) folded before Flop (didn't bet)
Seat 2: Paranoix1990 (small blind) folded before Flop
Seat 3: acamrash (big blind) collected ($0.20)
Seat 4: Faraz folded before Flop (didn't bet)
Seat 5: Suhoff76 folded before Flop (didn't bet)
Seat 6: PetitAlejo folded before Flop (didn't bet)
Seat 7: Lasutchik folded before Flop (didn't bet)
Seat 8: Jene4kaBest folded before Flop (didn't bet)
Seat 9: Dafleche folded before Flop (didn't bet)



PokerStars Zoom Hand #84299480857:  Hold'em No Limit ($0.10/$0.25) - 2012/08/05 14:22:15 JST [2012/08/05 1:22:15 ET]
Table 'Whirlpool' 9-max Seat #1 is the button
Seat 1: PetitAlejo ($33.51 in chips) 
Seat 2: D@vidMed ($65.52 in chips) 
Seat 3: KCDOGG10 ($11.55 in chips) 
Seat 4: chiyuki ($45.50 in chips) 
Seat 5: wtu1986 ($31.39 in chips) 
Seat 6: kamikkaze ($31.37 in chips) 
Seat 7: Suhoff76 ($25 in chips) 
Seat 8: 4thepeople ($24.08 in chips) 
Seat 9: RomarioJa ($10.21 in chips) 
D@vidMed: posts small blind $0.10
KCDOGG10: posts big blind $0.25
*** HOLE CARDS ***
Dealt to chiyuki [Qd 2c]
chiyuki: folds 
wtu1986: raises $0.50 to $0.75
kamikkaze: folds 
Suhoff76: folds 
4thepeople: folds 
RomarioJa: folds 
PetitAlejo: folds 
D@vidMed: folds 
KCDOGG10: folds 
Uncalled bet ($0.50) returned to wtu1986
wtu1986 collected $0.60 from pot
wtu1986: doesn't show hand 
*** SUMMARY ***
Total pot $0.60 | Rake $0 
Seat 1: PetitAlejo (button) folded before Flop (didn't bet)
Seat 2: D@vidMed (small blind) folded before Flop
Seat 3: KCDOGG10 (big blind) folded before Flop
Seat 4: chiyuki folded before Flop (didn't bet)
Seat 5: wtu1986 collected ($0.60)
Seat 6: kamikkaze folded before Flop (didn't bet)
Seat 7: Suhoff76 folded before Flop (didn't bet)
Seat 8: 4thepeople folded before Flop (didn't bet)
Seat 9: RomarioJa folded before Flop (didn't bet)



PokerStars Zoom Hand #84299487003:  Hold'em No Limit ($0.10/$0.25) - 2012/08/05 14:22:40 JST [2012/08/05 1:22:40 ET]
Table 'Whirlpool' 9-max Seat #1 is the button
Seat 1: RomarioJa ($10.21 in chips) 
Seat 2: deadmoneykid ($29.40 in chips) 
Seat 3: Roglus ($14.72 in chips) 
Seat 4: Loholov ($17.79 in chips) 
Seat 5: taksist889 ($26.43 in chips) 
Seat 6: chiyuki ($45.25 in chips) 
Seat 7: RikkStroken ($28.41 in chips) 
Seat 8: wtu1986 ($31.74 in chips) 
Seat 9: bonethugs699 ($18.15 in chips) 
deadmoneykid: posts small blind $0.10
Roglus: posts big blind $0.25
*** HOLE CARDS ***
Dealt to chiyuki [8d 6s]
Loholov: folds 
taksist889: raises $0.50 to $0.75
chiyuki: folds 
RikkStroken: folds 
wtu1986: folds 
bonethugs699: folds 
RomarioJa: folds 
deadmoneykid: folds 
Roglus: folds 
Uncalled bet ($0.50) returned to taksist889
taksist889 collected $0.60 from pot
taksist889: doesn't show hand 
*** SUMMARY ***
Total pot $0.60 | Rake $0 
Seat 1: RomarioJa (button) folded before Flop (didn't bet)
Seat 2: deadmoneykid (small blind) folded before Flop
Seat 3: Roglus (big blind) folded before Flop
Seat 4: Loholov folded before Flop (didn't bet)
Seat 5: taksist889 collected ($0.60)
Seat 6: chiyuki folded before Flop (didn't bet)
Seat 7: RikkStroken folded before Flop (didn't bet)
Seat 8: wtu1986 folded before Flop (didn't bet)
Seat 9: bonethugs699 folded before Flop (didn't bet)



PokerStars Zoom Hand #84299488489:  Hold'em No Limit ($0.10/$0.25) - 2012/08/05 14:22:46 JST [2012/08/05 1:22:46 ET]
Table 'Whirlpool' 9-max Seat #1 is the button
Seat 1: kamikkaze ($14.65 in chips) 
Seat 2: troms20 ($54.65 in chips) 
Seat 3: silvno31 ($34.85 in chips) 
Seat 4: chiyuki ($45.25 in chips) 
Seat 5: Roglus ($14.47 in chips) 
Seat 6: WARIBANA7777 ($13.29 in chips) 
Seat 7: RomarioJa ($12.96 in chips) 
Seat 8: jeff0923 ($21.98 in chips) 
Seat 9: loca-loca888 ($39.63 in chips) 
troms20: posts small blind $0.10
silvno31: posts big blind $0.25
*** HOLE CARDS ***
Dealt to chiyuki [5d Jh]
chiyuki: folds 
Roglus: folds 
WARIBANA7777: folds 
RomarioJa: raises $0.37 to $0.62
jeff0923: folds 
loca-loca888: folds 
kamikkaze: folds 
troms20: folds 
silvno31: folds 
Uncalled bet ($0.37) returned to RomarioJa
RomarioJa collected $0.60 from pot
RomarioJa: doesn't show hand 
*** SUMMARY ***
Total pot $0.60 | Rake $0 
Seat 1: kamikkaze (button) folded before Flop (didn't bet)
Seat 2: troms20 (small blind) folded before Flop
Seat 3: silvno31 (big blind) folded before Flop
Seat 4: chiyuki folded before Flop (didn't bet)
Seat 5: Roglus folded before Flop (didn't bet)
Seat 6: WARIBANA7777 folded before Flop (didn't bet)
Seat 7: RomarioJa collected ($0.60)
Seat 8: jeff0923 folded before Flop (didn't bet)
Seat 9: loca-loca888 folded before Flop (didn't bet)



PokerStars Zoom Hand #84299479089:  Hold'em No Limit ($0.10/$0.25) - 2012/08/05 14:22:08 JST [2012/08/05 1:22:08 ET]
Table 'Whirlpool' 9-max Seat #1 is the button
Seat 1: softdesign ($69.13 in chips) 
Seat 2: Th3Fog ($16.12 in chips) 
Seat 3: peng2astic ($16.96 in chips) 
Seat 4: kamikkaze ($14.90 in chips) 
Seat 5: KCDOGG10 ($11.55 in chips) 
Seat 6: wtu1986 ($32.05 in chips) 
Seat 7: Loholov ($26.56 in chips) 
Seat 8: chiyuki ($45.50 in chips) 
Seat 9: Perstenev ($11.97 in chips) 
Th3Fog: posts small blind $0.10
peng2astic: posts big blind $0.25
*** HOLE CARDS ***
Dealt to chiyuki [Kc 4d]
kamikkaze: folds 
KCDOGG10: folds 
wtu1986: folds 
Loholov: folds 
chiyuki: folds 
Perstenev: folds 
softdesign: raises $0.75 to $1
Th3Fog: folds 
peng2astic: raises $15.96 to $16.96 and is all-in
softdesign: calls $15.96
*** FLOP *** [2s 3s 3h]
*** TURN *** [2s 3s 3h] [7h]
*** RIVER *** [2s 3s 3h 7h] [Kd]
*** SHOW DOWN ***
peng2astic: shows [Qd Ad] (a pair of Threes)
softdesign: shows [Qc As] (a pair of Threes)
peng2astic collected $16.25 from pot
softdesign collected $16.24 from pot
*** SUMMARY ***
Total pot $34.02 | Rake $1.53 
Board [2s 3s 3h 7h Kd]
Seat 1: softdesign (button) showed [Qc As] and won ($16.24) with a pair of Threes
Seat 2: Th3Fog (small blind) folded before Flop
Seat 3: peng2astic (big blind) showed [Qd Ad] and won ($16.25) with a pair of Threes
Seat 4: kamikkaze folded before Flop (didn't bet)
Seat 5: KCDOGG10 folded before Flop (didn't bet)
Seat 6: wtu1986 folded before Flop (didn't bet)
Seat 7: Loholov folded before Flop (didn't bet)
Seat 8: chiyuki folded before Flop (didn't bet)
Seat 9: Perstenev folded before Flop (didn't bet)



PokerStars Zoom Hand #84299484326:  Hold'em No Limit ($0.10/$0.25) - 2012/08/05 14:22:29 JST [2012/08/05 1:22:29 ET]
Table 'Whirlpool' 9-max Seat #1 is the button
Seat 1: Suhoff76 ($25 in chips) 
Seat 2: el pore 5 ($14.44 in chips) 
Seat 3: chiyuki ($45.50 in chips) 
Seat 4: Ellen1947 ($39.12 in chips) 
Seat 5: dushvan ($29.57 in chips) 
Seat 6: Loholov ($15.25 in chips) 
Seat 7: Th3Fog ($16.02 in chips) 
Seat 8: hirozo ($36.63 in chips) 
Seat 9: phate-1up ($25 in chips) 
el pore 5: posts small blind $0.10
chiyuki: posts big blind $0.25
*** HOLE CARDS ***
Dealt to chiyuki [4c 9d]
Ellen1947: folds 
dushvan: raises $0.50 to $0.75
Loholov: folds 
Th3Fog: folds 
hirozo: folds 
phate-1up: folds 
Suhoff76: folds 
el pore 5: calls $0.65
chiyuki: folds 
*** FLOP *** [Jh 7s Qs]
el pore 5: checks 
dushvan: checks 
*** TURN *** [Jh 7s Qs] [3d]
el pore 5: bets $0.50
dushvan: calls $0.50
*** RIVER *** [Jh 7s Qs 3d] [Kd]
el pore 5: bets $0.50
dushvan: folds 
Uncalled bet ($0.50) returned to el pore 5
el pore 5 collected $2.63 from pot
el pore 5: doesn't show hand 
*** SUMMARY ***
Total pot $2.75 | Rake $0.12 
Board [Jh 7s Qs 3d Kd]
Seat 1: Suhoff76 (button) folded before Flop (didn't bet)
Seat 2: el pore 5 (small blind) collected ($2.63)
Seat 3: chiyuki (big blind) folded before Flop
Seat 4: Ellen1947 folded before Flop (didn't bet)
Seat 5: dushvan folded on the River
Seat 6: Loholov folded before Flop (didn't bet)
Seat 7: Th3Fog folded before Flop (didn't bet)
Seat 8: hirozo folded before Flop (didn't bet)
Seat 9: phate-1up folded before Flop (didn't bet)



PokerStars Zoom Hand #84299490225:  Hold'em No Limit ($0.10/$0.25) - 2012/08/05 14:22:53 JST [2012/08/05 1:22:53 ET]
Table 'Whirlpool' 9-max Seat #1 is the button
Seat 1: taksist889 ($26.78 in chips) 
Seat 2: chiyuki ($45.25 in chips) 
Seat 3: Nerkit ($12.49 in chips) 
Seat 4: Ellen1947 ($28.16 in chips) 
Seat 5: kamikkaze ($14.65 in chips) 
Seat 6: AlfredE525 ($13.79 in chips) 
Seat 7: KCDOGG10 ($11.30 in chips) 
Seat 8: loca-loca888 ($39.63 in chips) 
Seat 9: wtu1986 ($24.90 in chips) 
chiyuki: posts small blind $0.10
Nerkit: posts big blind $0.25
*** HOLE CARDS ***
Dealt to chiyuki [3c 8c]
Ellen1947: folds 
kamikkaze: folds 
AlfredE525: raises $0.37 to $0.62
KCDOGG10: folds 
loca-loca888: folds 
wtu1986: folds 
taksist889: folds 
chiyuki: folds 
Nerkit: calls $0.37
*** FLOP *** [8d 5d 9c]
Nerkit: checks 
AlfredE525: bets $0.64
Nerkit: folds 
Uncalled bet ($0.64) returned to AlfredE525
AlfredE525 collected $1.28 from pot
AlfredE525: doesn't show hand 
*** SUMMARY ***
Total pot $1.34 | Rake $0.06 
Board [8d 5d 9c]
Seat 1: taksist889 (button) folded before Flop (didn't bet)
Seat 2: chiyuki (small blind) folded before Flop
Seat 3: Nerkit (big blind) folded on the Flop
Seat 4: Ellen1947 folded before Flop (didn't bet)
Seat 5: kamikkaze folded before Flop (didn't bet)
Seat 6: AlfredE525 collected ($1.28)
Seat 7: KCDOGG10 folded before Flop (didn't bet)
Seat 8: loca-loca888 folded before Flop (didn't bet)
Seat 9: wtu1986 folded before Flop (didn't bet)



PokerStars Zoom Hand #84299494691:  Hold'em No Limit ($0.10/$0.25) - 2012/08/05 14:23:12 JST [2012/08/05 1:23:12 ET]
Table 'Whirlpool' 9-max Seat #1 is the button
Seat 1: Noviekid ($89.42 in chips) 
Seat 2: Metasploit ($24.65 in chips) 
Seat 3: KeLevro0 ($12.51 in chips) 
Seat 4: Dejacob ($31.36 in chips) 
Seat 5: chiyuki ($45.15 in chips) 
Seat 6: ygoegoe ($27.06 in chips) 
Seat 7: roksmokndonk ($29.04 in chips) 
Seat 8: phate-1up ($29.13 in chips) 
Seat 9: troms20 ($44.84 in chips) 
Metasploit: posts small blind $0.10
KeLevro0: posts big blind $0.25
*** HOLE CARDS ***
Dealt to chiyuki [6h Ad]
Dejacob: folds 
chiyuki: folds 
ygoegoe: folds 
roksmokndonk: folds 
phate-1up: raises $0.50 to $0.75
troms20: folds 
Noviekid: calls $0.75
Metasploit: folds 
KeLevro0: folds 
*** FLOP *** [5h Ac 3d]
phate-1up: bets $1.25
Noviekid: folds 
Uncalled bet ($1.25) returned to phate-1up
phate-1up collected $1.77 from pot
phate-1up: doesn't show hand 
*** SUMMARY ***
Total pot $1.85 | Rake $0.08 
Board [5h Ac 3d]
Seat 1: Noviekid (button) folded on the Flop
Seat 2: Metasploit (small blind) folded before Flop
Seat 3: KeLevro0 (big blind) folded before Flop
Seat 4: Dejacob folded before Flop (didn't bet)
Seat 5: chiyuki folded before Flop (didn't bet)
Seat 6: ygoegoe folded before Flop (didn't bet)
Seat 7: roksmokndonk folded before Flop (didn't bet)
Seat 8: phate-1up collected ($1.77)
Seat 9: troms20 folded before Flop (didn't bet)



PokerStars Zoom Hand #84299498940:  Hold'em No Limit ($0.10/$0.25) - 2012/08/05 14:23:29 JST [2012/08/05 1:23:29 ET]
Table 'Whirlpool' 9-max Seat #1 is the button
Seat 1: chiyuki ($45.15 in chips) 
Seat 2: loca-loca888 ($39.63 in chips) 
Seat 3: kamikkaze ($14.55 in chips) 
Seat 4: hirozo ($32.87 in chips) 
Seat 5: Dan Royal ($41.68 in chips) 
Seat 6: 4thepeople ($22.24 in chips) 
Seat 7: Landybob ($42.65 in chips) 
Seat 8: KeLevro0 ($9.20 in chips) 
Seat 9: softdesign ($67.66 in chips) 
loca-loca888: posts small blind $0.10
kamikkaze: posts big blind $0.25
*** HOLE CARDS ***
Dealt to chiyuki [3h 2c]
hirozo: folds 
Dan Royal: folds 
4thepeople: folds 
Landybob: folds 
KeLevro0: folds 
softdesign: folds 
chiyuki: folds 
loca-loca888: raises $0.75 to $1
kamikkaze: folds 
Uncalled bet ($0.75) returned to loca-loca888
loca-loca888 collected $0.50 from pot
loca-loca888: doesn't show hand 
*** SUMMARY ***
Total pot $0.50 | Rake $0 
Seat 1: chiyuki (button) folded before Flop (didn't bet)
Seat 2: loca-loca888 (small blind) collected ($0.50)
Seat 3: kamikkaze (big blind) folded before Flop
Seat 4: hirozo folded before Flop (didn't bet)
Seat 5: Dan Royal folded before Flop (didn't bet)
Seat 6: 4thepeople folded before Flop (didn't bet)
Seat 7: Landybob folded before Flop (didn't bet)
Seat 8: KeLevro0 folded before Flop (didn't bet)
Seat 9: softdesign folded before Flop (didn't bet)



PokerStars Zoom Hand #84299496410:  Hold'em No Limit ($0.10/$0.25) - 2012/08/05 14:23:19 JST [2012/08/05 1:23:19 ET]
Table 'Whirlpool' 9-max Seat #1 is the button
Seat 1: troms20 ($29.75 in chips) 
Seat 2: phate-1up ($37.51 in chips) 
Seat 3: Jene4kaBest ($11.16 in chips) 
Seat 4: leo2095 ($13.64 in chips) 
Seat 5: flyinprits ($25.69 in chips) 
Seat 6: Dejacob ($27.51 in chips) 
Seat 7: hirozo ($33.57 in chips) 
Seat 8: el pore 5 ($15.82 in chips) 
Seat 9: chiyuki ($45.15 in chips) 
phate-1up: posts small blind $0.10
Jene4kaBest: posts big blind $0.25
*** HOLE CARDS ***
Dealt to chiyuki [7d Ah]
leo2095: folds 
flyinprits: folds 
Dejacob: raises $0.50 to $0.75
hirozo: folds 
el pore 5: calls $0.75
chiyuki: folds 
troms20: folds 
phate-1up: folds 
Jene4kaBest: folds 
*** FLOP *** [6d 8h 4c]
Dejacob: bets $1.25
el pore 5: folds 
Uncalled bet ($1.25) returned to Dejacob
Dejacob collected $1.77 from pot
Dejacob: doesn't show hand 
*** SUMMARY ***
Total pot $1.85 | Rake $0.08 
Board [6d 8h 4c]
Seat 1: troms20 (button) folded before Flop (didn't bet)
Seat 2: phate-1up (small blind) folded before Flop
Seat 3: Jene4kaBest (big blind) folded before Flop
Seat 4: leo2095 folded before Flop (didn't bet)
Seat 5: flyinprits folded before Flop (didn't bet)
Seat 6: Dejacob collected ($1.77)
Seat 7: hirozo folded before Flop (didn't bet)
Seat 8: el pore 5 folded on the Flop
Seat 9: chiyuki folded before Flop (didn't bet)



PokerStars Zoom Hand #84299497915:  Hold'em No Limit ($0.10/$0.25) - 2012/08/05 14:23:25 JST [2012/08/05 1:23:25 ET]
Table 'Whirlpool' 9-max Seat #1 is the button
Seat 1: 4thepeople ($22.24 in chips) 
Seat 2: wtu1986 ($31.84 in chips) 
Seat 3: Paranoix1990 ($6.04 in chips) 
Seat 4: PetitAlejo ($29.76 in chips) 
Seat 5: WARIBANA7777 ($13.04 in chips) 
Seat 6: troms20 ($29.75 in chips) 
Seat 7: peng2astic ($20.86 in chips) 
Seat 8: chiyuki ($45.15 in chips) 
Seat 9: Loholov ($16 in chips) 
wtu1986: posts small blind $0.10
Paranoix1990: posts big blind $0.25
*** HOLE CARDS ***
Dealt to chiyuki [Jh 8c]
PetitAlejo: raises $0.50 to $0.75
WARIBANA7777: folds 
troms20: folds 
peng2astic: calls $0.75
chiyuki: folds 
Loholov: folds 
4thepeople: folds 
wtu1986: folds 
Paranoix1990: calls $0.50
*** FLOP *** [4s 5s 2h]
Paranoix1990: checks 
PetitAlejo: bets $1.50
peng2astic: calls $1.50
Paranoix1990: raises $1.75 to $3.25
PetitAlejo: folds 
peng2astic: folds 
Uncalled bet ($1.75) returned to Paranoix1990
Paranoix1990 collected $6.54 from pot
Paranoix1990: doesn't show hand 
*** SUMMARY ***
Total pot $6.85 | Rake $0.31 
Board [4s 5s 2h]
Seat 1: 4thepeople (button) folded before Flop (didn't bet)
Seat 2: wtu1986 (small blind) folded before Flop
Seat 3: Paranoix1990 (big blind) collected ($6.54)
Seat 4: PetitAlejo folded on the Flop
Seat 5: WARIBANA7777 folded before Flop (didn't bet)
Seat 6: troms20 folded before Flop (didn't bet)
Seat 7: peng2astic folded on the Flop
Seat 8: chiyuki folded before Flop (didn't bet)
Seat 9: Loholov folded before Flop (didn't bet)



PokerStars Zoom Hand #84299504425:  Hold'em No Limit ($0.10/$0.25) - 2012/08/05 14:23:51 JST [2012/08/05 1:23:51 ET]
Table 'Whirlpool' 9-max Seat #1 is the button
Seat 1: Roglus ($15.29 in chips) 
Seat 2: hl77777 ($13.56 in chips) 
Seat 3: chiyuki ($45.15 in chips) 
Seat 4: PetitAlejo ($49.71 in chips) 
Seat 5: WARIBANA7777 ($12.94 in chips) 
Seat 6: ll_LaMeR_ll ($42.21 in chips) 
Seat 7: troms20 ($21.03 in chips) 
Seat 8: Suhoff76 ($26.82 in chips) 
Seat 9: Nerkit ($12.22 in chips) 
hl77777: posts small blind $0.10
chiyuki: posts big blind $0.25
*** HOLE CARDS ***
Dealt to chiyuki [Jc 9d]
PetitAlejo: folds 
WARIBANA7777: folds 
ll_LaMeR_ll: raises $0.50 to $0.75
troms20: folds 
Suhoff76: folds 
Nerkit: folds 
Roglus: calls $0.75
hl77777: folds 
chiyuki: folds 
*** FLOP *** [8d Jd 4c]
ll_LaMeR_ll: bets $1
Roglus: calls $1
*** TURN *** [8d Jd 4c] [Ks]
ll_LaMeR_ll: checks 
Roglus: checks 
*** RIVER *** [8d Jd 4c Ks] [6d]
ll_LaMeR_ll: bets $3.20
Roglus: folds 
Uncalled bet ($3.20) returned to ll_LaMeR_ll
ll_LaMeR_ll collected $3.68 from pot
ll_LaMeR_ll: doesn't show hand 
*** SUMMARY ***
Total pot $3.85 | Rake $0.17 
Board [8d Jd 4c Ks 6d]
Seat 1: Roglus (button) folded on the River
Seat 2: hl77777 (small blind) folded before Flop
Seat 3: chiyuki (big blind) folded before Flop
Seat 4: PetitAlejo folded before Flop (didn't bet)
Seat 5: WARIBANA7777 folded before Flop (didn't bet)
Seat 6: ll_LaMeR_ll collected ($3.68)
Seat 7: troms20 folded before Flop (didn't bet)
Seat 8: Suhoff76 folded before Flop (didn't bet)
Seat 9: Nerkit folded before Flop (didn't bet)



PokerStars Zoom Hand #84299509129:  Hold'em No Limit ($0.10/$0.25) - 2012/08/05 14:24:10 JST [2012/08/05 1:24:10 ET]
Table 'Whirlpool' 9-max Seat #1 is the button
Seat 1: Dejacob ($28.18 in chips) 
Seat 2: wtu1986 ($33.17 in chips) 
Seat 3: KCDOGG10 ($6.65 in chips) 
Seat 4: kamikkaze ($32.28 in chips) 
Seat 5: seula i ($25.01 in chips) 
Seat 6: chiyuki ($44.90 in chips) 
Seat 7: KeLevro0 ($8.95 in chips) 
Seat 8: Vahe50 ($4.45 in chips) 
Seat 9: RomarioJa ($30.29 in chips) 
wtu1986: posts small blind $0.10
KCDOGG10: posts big blind $0.25
*** HOLE CARDS ***
Dealt to chiyuki [Ks Tc]
kamikkaze: folds 
seula i: folds 
chiyuki: folds 
KeLevro0: folds 
Vahe50: folds 
RomarioJa: folds 
Dejacob: folds 
wtu1986: raises $0.37 to $0.62
KCDOGG10: folds 
Uncalled bet ($0.37) returned to wtu1986
wtu1986 collected $0.50 from pot
wtu1986: doesn't show hand 
*** SUMMARY ***
Total pot $0.50 | Rake $0 
Seat 1: Dejacob (button) folded before Flop (didn't bet)
Seat 2: wtu1986 (small blind) collected ($0.50)
Seat 3: KCDOGG10 (big blind) folded before Flop
Seat 4: kamikkaze folded before Flop (didn't bet)
Seat 5: seula i folded before Flop (didn't bet)
Seat 6: chiyuki folded before Flop (didn't bet)
Seat 7: KeLevro0 folded before Flop (didn't bet)
Seat 8: Vahe50 folded before Flop (didn't bet)
Seat 9: RomarioJa folded before Flop (didn't bet)



PokerStars Zoom Hand #84299510348:  Hold'em No Limit ($0.10/$0.25) - 2012/08/05 14:24:15 JST [2012/08/05 1:24:15 ET]
Table 'Whirlpool' 9-max Seat #1 is the button
Seat 1: KeLevro0 ($8.95 in chips) 
Seat 2: D@vidMed ($65.43 in chips) 
Seat 3: PillZ86 ($13.45 in chips) 
Seat 4: kamikkaze ($16.57 in chips) 
Seat 5: ladymadon107 ($5.25 in chips) 
Seat 6: chiyuki ($44.90 in chips) 
Seat 7: 1Karina1 ($25 in chips) 
Seat 8: RomarioJa ($30.29 in chips) 
Seat 9: Suhoff76 ($26.72 in chips) 
D@vidMed: posts small blind $0.10
PillZ86: posts big blind $0.25
*** HOLE CARDS ***
Dealt to chiyuki [Jh 4s]
kamikkaze: folds 
ladymadon107: folds 
chiyuki: folds 
1Karina1: folds 
RomarioJa: raises $0.50 to $0.75
Suhoff76: folds 
KeLevro0: folds 
D@vidMed: folds 
PillZ86: folds 
Uncalled bet ($0.50) returned to RomarioJa
RomarioJa collected $0.60 from pot
RomarioJa: doesn't show hand 
*** SUMMARY ***
Total pot $0.60 | Rake $0 
Seat 1: KeLevro0 (button) folded before Flop (didn't bet)
Seat 2: D@vidMed (small blind) folded before Flop
Seat 3: PillZ86 (big blind) folded before Flop
Seat 4: kamikkaze folded before Flop (didn't bet)
Seat 5: ladymadon107 folded before Flop (didn't bet)
Seat 6: chiyuki folded before Flop (didn't bet)
Seat 7: 1Karina1 folded before Flop (didn't bet)
Seat 8: RomarioJa collected ($0.60)
Seat 9: Suhoff76 folded before Flop (didn't bet)



PokerStars Zoom Hand #84299500944:  Hold'em No Limit ($0.10/$0.25) - 2012/08/05 14:23:37 JST [2012/08/05 1:23:37 ET]
Table 'Whirlpool' 9-max Seat #1 is the button
Seat 1: Déculotter69 ($17.91 in chips) 
Seat 2: Th3Fog ($49.75 in chips) 
Seat 3: hirozo ($36.63 in chips) 
Seat 4: Dan Royal ($41.68 in chips) 
Seat 5: softdesign ($67.66 in chips) 
Seat 6: ygoegoe ($30.59 in chips) 
Seat 7: chiyuki ($45.15 in chips) 
Seat 8: Noviekid ($88.67 in chips) 
Seat 9: KeLevro0 ($9.02 in chips) 
Th3Fog: posts small blind $0.10
hirozo: posts big blind $0.25
*** HOLE CARDS ***
Dealt to chiyuki [7h 7d]
Dan Royal: folds 
softdesign: folds 
ygoegoe: raises $0.50 to $0.75
chiyuki: folds 
Noviekid: folds 
KeLevro0: folds 
Déculotter69: calls $0.75
Th3Fog: folds 
hirozo: folds 
*** FLOP *** [Jd 8d Js]
ygoegoe: checks 
Déculotter69: bets $1
ygoegoe: raises $1.50 to $2.50
Déculotter69: calls $1.50
*** TURN *** [Jd 8d Js] [Qc]
ygoegoe: checks 
Déculotter69: bets $3.66
ygoegoe: folds 
Uncalled bet ($3.66) returned to Déculotter69
Déculotter69 collected $6.54 from pot
Déculotter69: doesn't show hand 
*** SUMMARY ***
Total pot $6.85 | Rake $0.31 
Board [Jd 8d Js Qc]
Seat 1: Déculotter69 (button) collected ($6.54)
Seat 2: Th3Fog (small blind) folded before Flop
Seat 3: hirozo (big blind) folded before Flop
Seat 4: Dan Royal folded before Flop (didn't bet)
Seat 5: softdesign folded before Flop (didn't bet)
Seat 6: ygoegoe folded on the Turn
Seat 7: chiyuki folded before Flop (didn't bet)
Seat 8: Noviekid folded before Flop (didn't bet)
Seat 9: KeLevro0 folded before Flop (didn't bet)



PokerStars Zoom Hand #84299513646:  Hold'em No Limit ($0.10/$0.25) - 2012/08/05 14:24:29 JST [2012/08/05 1:24:29 ET]
Table 'Whirlpool' 9-max Seat #1 is the button
Seat 1: Lasutchik ($7.21 in chips) 
Seat 2: seula i ($65.59 in chips) 
Seat 3: silvno31 ($35.63 in chips) 
Seat 4: Suhoff76 ($25 in chips) 
Seat 5: Perstenev ($20.67 in chips) 
Seat 6: Loholov ($20.43 in chips) 
Seat 7: 1Karina1 ($25 in chips) 
Seat 8: flyinprits ($25.44 in chips) 
Seat 9: chiyuki ($44.80 in chips) 
seula i: posts small blind $0.10
silvno31: posts big blind $0.25
*** HOLE CARDS ***
Dealt to chiyuki [7s 2c]
Suhoff76: folds 
Perstenev: folds 
Loholov: folds 
1Karina1: folds 
flyinprits: folds 
chiyuki: folds 
Lasutchik: folds 
seula i: folds 
Uncalled bet ($0.15) returned to silvno31
silvno31 collected $0.20 from pot
silvno31: doesn't show hand 
*** SUMMARY ***
Total pot $0.20 | Rake $0 
Seat 1: Lasutchik (button) folded before Flop (didn't bet)
Seat 2: seula i (small blind) folded before Flop
Seat 3: silvno31 (big blind) collected ($0.20)
Seat 4: Suhoff76 folded before Flop (didn't bet)
Seat 5: Perstenev folded before Flop (didn't bet)
Seat 6: Loholov folded before Flop (didn't bet)
Seat 7: 1Karina1 folded before Flop (didn't bet)
Seat 8: flyinprits folded before Flop (didn't bet)
Seat 9: chiyuki folded before Flop (didn't bet)



PokerStars Zoom Hand #84299511393:  Hold'em No Limit ($0.10/$0.25) - 2012/08/05 14:24:19 JST [2012/08/05 1:24:19 ET]
Table 'Whirlpool' 9-max Seat #1 is the button
Seat 1: phate-1up ($37.06 in chips) 
Seat 2: chiyuki ($44.90 in chips) 
Seat 3: Th3Fog ($49.65 in chips) 
Seat 4: hirozo ($32.82 in chips) 
Seat 5: D@vidMed ($65.33 in chips) 
Seat 6: KeLevro0 ($8.95 in chips) 
Seat 7: WARIBANA7777 ($12.69 in chips) 
Seat 8: PetitAlejo ($33.16 in chips) 
Seat 9: Dejacob ($28.18 in chips) 
chiyuki: posts small blind $0.10
Th3Fog: posts big blind $0.25
*** HOLE CARDS ***
Dealt to chiyuki [9c Js]
hirozo: folds 
D@vidMed: folds 
KeLevro0: folds 
WARIBANA7777: folds 
PetitAlejo: folds 
Dejacob: folds 
phate-1up: raises $0.50 to $0.75
chiyuki: folds 
Th3Fog: raises $1.25 to $2
phate-1up: calls $1.25
*** FLOP *** [Kh 6d 2h]
Th3Fog: bets $1.72
phate-1up: calls $1.72
*** TURN *** [Kh 6d 2h] [5d]
Th3Fog: checks 
phate-1up: checks 
*** RIVER *** [Kh 6d 2h 5d] [8c]
Th3Fog: checks 
phate-1up: checks 
*** SHOW DOWN ***
Th3Fog: shows [Jd Jh] (a pair of Jacks)
phate-1up: mucks hand 
Th3Fog collected $7.20 from pot
*** SUMMARY ***
Total pot $7.54 | Rake $0.34 
Board [Kh 6d 2h 5d 8c]
Seat 1: phate-1up (button) mucked [9d 9s]
Seat 2: chiyuki (small blind) folded before Flop
Seat 3: Th3Fog (big blind) showed [Jd Jh] and won ($7.20) with a pair of Jacks
Seat 4: hirozo folded before Flop (didn't bet)
Seat 5: D@vidMed folded before Flop (didn't bet)
Seat 6: KeLevro0 folded before Flop (didn't bet)
Seat 7: WARIBANA7777 folded before Flop (didn't bet)
Seat 8: PetitAlejo folded before Flop (didn't bet)
Seat 9: Dejacob folded before Flop (didn't bet)



PokerStars Zoom Hand #84299518147:  Hold'em No Limit ($0.10/$0.25) - 2012/08/05 14:24:47 JST [2012/08/05 1:24:47 ET]
Table 'Whirlpool' 9-max Seat #1 is the button
Seat 1: ygoegoe ($27.34 in chips) 
Seat 2: PetitAlejo ($33.16 in chips) 
Seat 3: chiyuki ($44.80 in chips) 
Seat 4: hirozo ($32.82 in chips) 
Seat 5: RikkStroken ($28 in chips) 
Seat 6: RomarioJa ($30.64 in chips) 
Seat 7: deadmoneykid ($22.84 in chips) 
Seat 8: Suhoff76 ($25 in chips) 
Seat 9: cr0lox ($17.88 in chips) 
PetitAlejo: posts small blind $0.10
chiyuki: posts big blind $0.25
*** HOLE CARDS ***
Dealt to chiyuki [8d Kc]
hirozo: raises $0.50 to $0.75
RikkStroken: folds 
RomarioJa: folds 
deadmoneykid: folds 
Suhoff76: folds 
cr0lox: folds 
ygoegoe: folds 
PetitAlejo: folds 
chiyuki: folds 
Uncalled bet ($0.50) returned to hirozo
hirozo collected $0.60 from pot
hirozo: doesn't show hand 
*** SUMMARY ***
Total pot $0.60 | Rake $0 
Seat 1: ygoegoe (button) folded before Flop (didn't bet)
Seat 2: PetitAlejo (small blind) folded before Flop
Seat 3: chiyuki (big blind) folded before Flop
Seat 4: hirozo collected ($0.60)
Seat 5: RikkStroken folded before Flop (didn't bet)
Seat 6: RomarioJa folded before Flop (didn't bet)
Seat 7: deadmoneykid folded before Flop (didn't bet)
Seat 8: Suhoff76 folded before Flop (didn't bet)
Seat 9: cr0lox folded before Flop (didn't bet)



PokerStars Zoom Hand #84299515675:  Hold'em No Limit ($0.10/$0.25) - 2012/08/05 14:24:37 JST [2012/08/05 1:24:37 ET]
Table 'Whirlpool' 9-max Seat #1 is the button
Seat 1: Nerkit ($9.73 in chips) 
Seat 2: Spartacus675 ($28.76 in chips) 
Seat 3: Loholov ($20.43 in chips) 
Seat 4: chiyuki ($44.80 in chips) 
Seat 5: Perstenev ($9.67 in chips) 
Seat 6: PetitAlejo ($33.16 in chips) 
Seat 7: softdesign ($67.41 in chips) 
Seat 8: loca-loca888 ($39.98 in chips) 
Seat 9: troms20 ($21.03 in chips) 
Spartacus675: posts small blind $0.10
Loholov: posts big blind $0.25
*** HOLE CARDS ***
Dealt to chiyuki [9h 7s]
chiyuki: folds 
Perstenev: folds 
PetitAlejo: folds 
softdesign: folds 
loca-loca888: calls $0.25
troms20: folds 
Nerkit: folds 
Spartacus675: folds 
Loholov: checks 
*** FLOP *** [Qs 5c Qd]
Loholov: checks 
loca-loca888: bets $0.25
Loholov: folds 
Uncalled bet ($0.25) returned to loca-loca888
loca-loca888 collected $0.57 from pot
loca-loca888: doesn't show hand 
*** SUMMARY ***
Total pot $0.60 | Rake $0.03 
Board [Qs 5c Qd]
Seat 1: Nerkit (button) folded before Flop (didn't bet)
Seat 2: Spartacus675 (small blind) folded before Flop
Seat 3: Loholov (big blind) folded on the Flop
Seat 4: chiyuki folded before Flop (didn't bet)
Seat 5: Perstenev folded before Flop (didn't bet)
Seat 6: PetitAlejo folded before Flop (didn't bet)
Seat 7: softdesign folded before Flop (didn't bet)
Seat 8: loca-loca888 collected ($0.57)
Seat 9: troms20 folded before Flop (didn't bet)



PokerStars Zoom Hand #84299512133:  Hold'em No Limit ($0.10/$0.25) - 2012/08/05 14:24:23 JST [2012/08/05 1:24:23 ET]
Table 'Whirlpool' 9-max Seat #1 is the button
Seat 1: timbof7 ($24.98 in chips) 
Seat 2: yane73 ($9.50 in chips) 
Seat 3: wildy29 ($9.87 in chips) 
Seat 4: cr0lox ($17.98 in chips) 
Seat 5: chiyuki ($44.80 in chips) 
Seat 6: dushvan ($27.97 in chips) 
Seat 7: Perstenev ($9.67 in chips) 
Seat 8: RomarioJa ($13.06 in chips) 
Seat 9: Ellen1947 ($38.87 in chips) 
yane73: posts small blind $0.10
wildy29: posts big blind $0.25
*** HOLE CARDS ***
Dealt to chiyuki [Kh Ts]
cr0lox: folds 
chiyuki: folds 
dushvan: folds 
Perstenev: folds 
RomarioJa: raises $0.45 to $0.70
Ellen1947: folds 
timbof7: folds 
yane73: raises $0.55 to $1.25
wildy29: folds 
RomarioJa: calls $0.55
*** FLOP *** [8d 2d 9h]
yane73: bets $2.50
RomarioJa: folds 
Uncalled bet ($2.50) returned to yane73
yane73 collected $2.63 from pot
yane73: doesn't show hand 
*** SUMMARY ***
Total pot $2.75 | Rake $0.12 
Board [8d 2d 9h]
Seat 1: timbof7 (button) folded before Flop (didn't bet)
Seat 2: yane73 (small blind) collected ($2.63)
Seat 3: wildy29 (big blind) folded before Flop
Seat 4: cr0lox folded before Flop (didn't bet)
Seat 5: chiyuki folded before Flop (didn't bet)
Seat 6: dushvan folded before Flop (didn't bet)
Seat 7: Perstenev folded before Flop (didn't bet)
Seat 8: RomarioJa folded on the Flop
Seat 9: Ellen1947 folded before Flop (didn't bet)



PokerStars Zoom Hand #84299522341:  Hold'em No Limit ($0.10/$0.25) - 2012/08/05 14:25:04 JST [2012/08/05 1:25:04 ET]
Table 'Whirlpool' 9-max Seat #1 is the button
Seat 1: AlfredE525 ($14.76 in chips) 
Seat 2: KeLevro0 ($11.24 in chips) 
Seat 3: leo2095 ($32.98 in chips) 
Seat 4: ChrisCDee ($36.13 in chips) 
Seat 5: Lasutchik ($7.21 in chips) 
Seat 6: wtu1986 ($25.22 in chips) 
Seat 7: flyinprits ($25.44 in chips) 
Seat 8: chiyuki ($44.55 in chips) 
Seat 9: PetitAlejo ($32.61 in chips) 
KeLevro0: posts small blind $0.10
leo2095: posts big blind $0.25
*** HOLE CARDS ***
Dealt to chiyuki [3d Ac]
ChrisCDee: folds 
Lasutchik: folds 
wtu1986: folds 
flyinprits: folds 
chiyuki: folds 
PetitAlejo: folds 
AlfredE525: folds 
KeLevro0: folds 
Uncalled bet ($0.15) returned to leo2095
leo2095 collected $0.20 from pot
leo2095: doesn't show hand 
*** SUMMARY ***
Total pot $0.20 | Rake $0 
Seat 1: AlfredE525 (button) folded before Flop (didn't bet)
Seat 2: KeLevro0 (small blind) folded before Flop
Seat 3: leo2095 (big blind) collected ($0.20)
Seat 4: ChrisCDee folded before Flop (didn't bet)
Seat 5: Lasutchik folded before Flop (didn't bet)
Seat 6: wtu1986 folded before Flop (didn't bet)
Seat 7: flyinprits folded before Flop (didn't bet)
Seat 8: chiyuki folded before Flop (didn't bet)
Seat 9: PetitAlejo folded before Flop (didn't bet)



PokerStars Zoom Hand #84299527063:  Hold'em No Limit ($0.10/$0.25) - 2012/08/05 14:25:23 JST [2012/08/05 1:25:23 ET]
Table 'Whirlpool' 9-max Seat #1 is the button
Seat 1: 1Karina1 ($25 in chips) 
Seat 2: Perstenev ($12.66 in chips) 
Seat 3: seula i ($31.38 in chips) 
Seat 4: hirozo ($35.53 in chips) 
Seat 5: Loholov ($17.04 in chips) 
Seat 6: Dejacob ($25 in chips) 
Seat 7: chiyuki ($44.55 in chips) 
Seat 8: roksmokndonk ($28.07 in chips) 
Seat 9: KeLevro0 ($9.77 in chips) 
Perstenev: posts small blind $0.10
seula i: posts big blind $0.25
*** HOLE CARDS ***
Dealt to chiyuki [3s 4d]
hirozo: folds 
Loholov: folds 
Dejacob: folds 
chiyuki: folds 
roksmokndonk: raises $0.50 to $0.75
KeLevro0: folds 
1Karina1: folds 
Perstenev: folds 
seula i: folds 
Uncalled bet ($0.50) returned to roksmokndonk
roksmokndonk collected $0.60 from pot
roksmokndonk: doesn't show hand 
*** SUMMARY ***
Total pot $0.60 | Rake $0 
Seat 1: 1Karina1 (button) folded before Flop (didn't bet)
Seat 2: Perstenev (small blind) folded before Flop
Seat 3: seula i (big blind) folded before Flop
Seat 4: hirozo folded before Flop (didn't bet)
Seat 5: Loholov folded before Flop (didn't bet)
Seat 6: Dejacob folded before Flop (didn't bet)
Seat 7: chiyuki folded before Flop (didn't bet)
Seat 8: roksmokndonk collected ($0.60)
Seat 9: KeLevro0 folded before Flop (didn't bet)



PokerStars Zoom Hand #84299523582:  Hold'em No Limit ($0.10/$0.25) - 2012/08/05 14:25:09 JST [2012/08/05 1:25:09 ET]
Table 'Whirlpool' 9-max Seat #1 is the button
Seat 1: chiyuki ($44.55 in chips) 
Seat 2: Nerkit ($9.48 in chips) 
Seat 3: WARIBANA7777 ($12.59 in chips) 
Seat 4: flyinprits ($25.44 in chips) 
Seat 5: Suhoff76 ($26.82 in chips) 
Seat 6: PetitAlejo ($50.46 in chips) 
Seat 7: 4thepeople ($29.13 in chips) 
Seat 8: phate-1up ($28.75 in chips) 
Seat 9: Perstenev ($9.32 in chips) 
Nerkit: posts small blind $0.10
WARIBANA7777: posts big blind $0.25
*** HOLE CARDS ***
Dealt to chiyuki [6d 3h]
flyinprits: folds 
Suhoff76: folds 
PetitAlejo: folds 
4thepeople: folds 
phate-1up: folds 
Perstenev: calls $0.25
chiyuki: folds 
Nerkit: calls $0.15
WARIBANA7777: checks 
*** FLOP *** [5d 7s Qs]
Nerkit: checks 
WARIBANA7777: checks 
Perstenev: checks 
*** TURN *** [5d 7s Qs] [Kc]
Nerkit: checks 
WARIBANA7777: checks 
Perstenev: checks 
*** RIVER *** [5d 7s Qs Kc] [6h]
Nerkit: checks 
WARIBANA7777: checks 
Perstenev: checks 
*** SHOW DOWN ***
Nerkit: shows [9c 9d] (a pair of Nines)
WARIBANA7777: mucks hand 
Perstenev: mucks hand 
Nerkit collected $0.72 from pot
*** SUMMARY ***
Total pot $0.75 | Rake $0.03 
Board [5d 7s Qs Kc 6h]
Seat 1: chiyuki (button) folded before Flop (didn't bet)
Seat 2: Nerkit (small blind) showed [9c 9d] and won ($0.72) with a pair of Nines
Seat 3: WARIBANA7777 (big blind) mucked [5s Td]
Seat 4: flyinprits folded before Flop (didn't bet)
Seat 5: Suhoff76 folded before Flop (didn't bet)
Seat 6: PetitAlejo folded before Flop (didn't bet)
Seat 7: 4thepeople folded before Flop (didn't bet)
Seat 8: phate-1up folded before Flop (didn't bet)
Seat 9: Perstenev mucked [2s 2c]



PokerStars Zoom Hand #84299517123:  Hold'em No Limit ($0.10/$0.25) - 2012/08/05 14:24:43 JST [2012/08/05 1:24:43 ET]
Table 'Whirlpool' 9-max Seat #1 is the button
Seat 1: seula i ($65.49 in chips) 
Seat 2: Dejacob ($27.39 in chips) 
Seat 3: phate-1up ($29.10 in chips) 
Seat 4: ygoegoe ($27.34 in chips) 
Seat 5: chiyuki ($44.80 in chips) 
Seat 6: KeLevro0 ($11.49 in chips) 
Seat 7: Lasutchik ($7.21 in chips) 
Seat 8: Perstenev ($20.57 in chips) 
Seat 9: kamikkaze ($31.93 in chips) 
Dejacob: posts small blind $0.10
phate-1up: posts big blind $0.25
*** HOLE CARDS ***
Dealt to chiyuki [Ah 2h]
ygoegoe: folds 
chiyuki: folds 
KeLevro0: folds 
Lasutchik: folds 
Perstenev: folds 
kamikkaze: folds 
seula i: raises $0.50 to $0.75
Dejacob: calls $0.65
phate-1up: folds 
*** FLOP *** [2d 7s Th]
Dejacob: checks 
seula i: bets $1.25
Dejacob: calls $1.25
*** TURN *** [2d 7s Th] [5h]
Dejacob: checks 
seula i: checks 
*** RIVER *** [2d 7s Th 5h] [Kd]
Dejacob: checks 
seula i: checks 
*** SHOW DOWN ***
Dejacob: shows [7h 9h] (a pair of Sevens)
seula i: mucks hand 
Dejacob collected $4.06 from pot
*** SUMMARY ***
Total pot $4.25 | Rake $0.19 
Board [2d 7s Th 5h Kd]
Seat 1: seula i (button) mucked [9d Qd]
Seat 2: Dejacob (small blind) showed [7h 9h] and won ($4.06) with a pair of Sevens
Seat 3: phate-1up (big blind) folded before Flop
Seat 4: ygoegoe folded before Flop (didn't bet)
Seat 5: chiyuki folded before Flop (didn't bet)
Seat 6: KeLevro0 folded before Flop (didn't bet)
Seat 7: Lasutchik folded before Flop (didn't bet)
Seat 8: Perstenev folded before Flop (didn't bet)
Seat 9: kamikkaze folded before Flop (didn't bet)



PokerStars Zoom Hand #84299528039:  Hold'em No Limit ($0.10/$0.25) - 2012/08/05 14:25:27 JST [2012/08/05 1:25:27 ET]
Table 'Whirlpool' 9-max Seat #1 is the button
Seat 1: peng2astic ($19.97 in chips) 
Seat 2: chiyuki ($44.55 in chips) 
Seat 3: hirozo ($35.53 in chips) 
Seat 4: RikkStroken ($26.96 in chips) 
Seat 5: Lasutchik ($70.74 in chips) 
Seat 6: Roglus ($66.68 in chips) 
Seat 7: JLajoie ($26.38 in chips) 
Seat 8: timbof7 ($23.23 in chips) 
Seat 9: RomarioJa ($13.45 in chips) 
chiyuki: posts small blind $0.10
hirozo: posts big blind $0.25
*** HOLE CARDS ***
Dealt to chiyuki [8s 4s]
RikkStroken: folds 
Lasutchik: folds 
Roglus: folds 
JLajoie: folds 
timbof7: folds 
RomarioJa: raises $0.50 to $0.75
peng2astic: folds 
chiyuki: folds 
hirozo: calls $0.50
*** FLOP *** [Js 7d 5s]
hirozo: bets $1.02
RomarioJa: folds 
Uncalled bet ($1.02) returned to hirozo
hirozo collected $1.53 from pot
hirozo: doesn't show hand 
*** SUMMARY ***
Total pot $1.60 | Rake $0.07 
Board [Js 7d 5s]
Seat 1: peng2astic (button) folded before Flop (didn't bet)
Seat 2: chiyuki (small blind) folded before Flop
Seat 3: hirozo (big blind) collected ($1.53)
Seat 4: RikkStroken folded before Flop (didn't bet)
Seat 5: Lasutchik folded before Flop (didn't bet)
Seat 6: Roglus folded before Flop (didn't bet)
Seat 7: JLajoie folded before Flop (didn't bet)
Seat 8: timbof7 folded before Flop (didn't bet)
Seat 9: RomarioJa folded on the Flop



PokerStars Zoom Hand #84299530552:  Hold'em No Limit ($0.10/$0.25) - 2012/08/05 14:25:38 JST [2012/08/05 1:25:38 ET]
Table 'Whirlpool' 9-max Seat #1 is the button
Seat 1: Dan Royal ($41.33 in chips) 
Seat 2: PetitAlejo ($28.36 in chips) 
Seat 3: wtu1986 ($33.77 in chips) 
Seat 4: chiyuki ($44.45 in chips) 
Seat 5: Th3Fog ($53.48 in chips) 
Seat 6: Vahe50 ($25.25 in chips) 
Seat 7: Perstenev ($20.22 in chips) 
Seat 8: Suhoff76 ($25 in chips) 
Seat 9: caro196661cv ($28.22 in chips) 
PetitAlejo: posts small blind $0.10
wtu1986: posts big blind $0.25
*** HOLE CARDS ***
Dealt to chiyuki [Ad Th]
chiyuki: folds 
Th3Fog: folds 
Vahe50: folds 
Perstenev: raises $0.75 to $1
Suhoff76: folds 
caro196661cv: folds 
Dan Royal: folds 
PetitAlejo: folds 
wtu1986: folds 
Uncalled bet ($0.75) returned to Perstenev
Perstenev collected $0.60 from pot
Perstenev: doesn't show hand 
*** SUMMARY ***
Total pot $0.60 | Rake $0 
Seat 1: Dan Royal (button) folded before Flop (didn't bet)
Seat 2: PetitAlejo (small blind) folded before Flop
Seat 3: wtu1986 (big blind) folded before Flop
Seat 4: chiyuki folded before Flop (didn't bet)
Seat 5: Th3Fog folded before Flop (didn't bet)
Seat 6: Vahe50 folded before Flop (didn't bet)
Seat 7: Perstenev collected ($0.60)
Seat 8: Suhoff76 folded before Flop (didn't bet)
Seat 9: caro196661cv folded before Flop (didn't bet)



PokerStars Zoom Hand #84299532015:  Hold'em No Limit ($0.10/$0.25) - 2012/08/05 14:25:44 JST [2012/08/05 1:25:44 ET]
Table 'Whirlpool' 9-max Seat #1 is the button
Seat 1: 1Karina1 ($25 in chips) 
Seat 2: Perstenev ($13.13 in chips) 
Seat 3: Paranoix1990 ($9.83 in chips) 
Seat 4: loca-loca888 ($39.80 in chips) 
Seat 5: Dejacob ($25.10 in chips) 
Seat 6: KeLevro0 ($9.77 in chips) 
Seat 7: Lasutchik ($70.74 in chips) 
Seat 8: DanielWhyte ($40.91 in chips) 
Seat 9: chiyuki ($44.45 in chips) 
Perstenev: posts small blind $0.10
Paranoix1990: posts big blind $0.25
*** HOLE CARDS ***
Dealt to chiyuki [Qd Qc]
loca-loca888: raises $0.54 to $0.79
Dejacob: folds 
KeLevro0: folds 
Lasutchik: folds 
DanielWhyte: folds 
chiyuki: raises $1.54 to $2.33
1Karina1: folds 
Perstenev: folds 
Paranoix1990: folds 
loca-loca888: calls $1.54
*** FLOP *** [2h 9d 6c]
loca-loca888: checks 
chiyuki: bets $2.50
loca-loca888: raises $7.50 to $10
chiyuki: folds 
Uncalled bet ($7.50) returned to loca-loca888
loca-loca888 collected $9.56 from pot
loca-loca888: doesn't show hand 
*** SUMMARY ***
Total pot $10.01 | Rake $0.45 
Board [2h 9d 6c]
Seat 1: 1Karina1 (button) folded before Flop (didn't bet)
Seat 2: Perstenev (small blind) folded before Flop
Seat 3: Paranoix1990 (big blind) folded before Flop
Seat 4: loca-loca888 collected ($9.56)
Seat 5: Dejacob folded before Flop (didn't bet)
Seat 6: KeLevro0 folded before Flop (didn't bet)
Seat 7: Lasutchik folded before Flop (didn't bet)
Seat 8: DanielWhyte folded before Flop (didn't bet)
Seat 9: chiyuki folded on the Flop



PokerStars Zoom Hand #84299555824:  Hold'em No Limit ($0.10/$0.25) - 2012/08/05 14:27:22 JST [2012/08/05 1:27:22 ET]
Table 'Whirlpool' 9-max Seat #1 is the button
Seat 1: seula i ($35.96 in chips) 
Seat 2: Perstenev ($12.03 in chips) 
Seat 3: puffy5533 ($25 in chips) 
Seat 4: phate-1up ($41.09 in chips) 
Seat 5: PillZ86 ($8.70 in chips) 
Seat 6: Loholov ($15.70 in chips) 
Seat 7: chiyuki ($39.62 in chips) 
Seat 8: Nerkit ($11.17 in chips) 
Seat 9: RomarioJa ($12.70 in chips) 
Perstenev: posts small blind $0.10
puffy5533: posts big blind $0.25
*** HOLE CARDS ***
Dealt to chiyuki [4s 3c]
phate-1up: raises $0.50 to $0.75
PillZ86: folds 
Loholov: folds 
chiyuki: folds 
Nerkit: folds 
RomarioJa: folds 
seula i: folds 
Perstenev: folds 
puffy5533: folds 
Uncalled bet ($0.50) returned to phate-1up
phate-1up collected $0.60 from pot
phate-1up: doesn't show hand 
*** SUMMARY ***
Total pot $0.60 | Rake $0 
Seat 1: seula i (button) folded before Flop (didn't bet)
Seat 2: Perstenev (small blind) folded before Flop
Seat 3: puffy5533 (big blind) folded before Flop
Seat 4: phate-1up collected ($0.60)
Seat 5: PillZ86 folded before Flop (didn't bet)
Seat 6: Loholov folded before Flop (didn't bet)
Seat 7: chiyuki folded before Flop (didn't bet)
Seat 8: Nerkit folded before Flop (didn't bet)
Seat 9: RomarioJa folded before Flop (didn't bet)



PokerStars Zoom Hand #84299561006:  Hold'em No Limit ($0.10/$0.25) - 2012/08/05 14:27:43 JST [2012/08/05 1:27:43 ET]
Table 'Whirlpool' 9-max Seat #1 is the button
Seat 1: Dejacob ($28.56 in chips) 
Seat 2: hirozo ($36.31 in chips) 
Seat 3: chiyuki ($39.62 in chips) 
Seat 4: BlOnDhOlIc ($35.71 in chips) 
Seat 5: troms20 ($53.01 in chips) 
Seat 6: kamikkaze ($15.80 in chips) 
Seat 7: peng2astic ($20.67 in chips) 
Seat 8: ygoegoe ($25.25 in chips) 
Seat 9: 4plankton ($17.28 in chips) 
hirozo: posts small blind $0.10
chiyuki: posts big blind $0.25
*** HOLE CARDS ***
Dealt to chiyuki [6h 5d]
BlOnDhOlIc: folds 
troms20: raises $0.50 to $0.75
kamikkaze: folds 
peng2astic: folds 
ygoegoe: folds 
4plankton: folds 
Dejacob: folds 
hirozo: folds 
chiyuki: folds 
Uncalled bet ($0.50) returned to troms20
troms20 collected $0.60 from pot
troms20: doesn't show hand 
*** SUMMARY ***
Total pot $0.60 | Rake $0 
Seat 1: Dejacob (button) folded before Flop (didn't bet)
Seat 2: hirozo (small blind) folded before Flop
Seat 3: chiyuki (big blind) folded before Flop
Seat 4: BlOnDhOlIc folded before Flop (didn't bet)
Seat 5: troms20 collected ($0.60)
Seat 6: kamikkaze folded before Flop (didn't bet)
Seat 7: peng2astic folded before Flop (didn't bet)
Seat 8: ygoegoe folded before Flop (didn't bet)
Seat 9: 4plankton folded before Flop (didn't bet)



PokerStars Zoom Hand #84299558338:  Hold'em No Limit ($0.10/$0.25) - 2012/08/05 14:27:32 JST [2012/08/05 1:27:32 ET]
Table 'Whirlpool' 9-max Seat #1 is the button
Seat 1: chiyuki ($39.62 in chips) 
Seat 2: Lasutchik ($70.96 in chips) 
Seat 3: 1Karina1 ($25.32 in chips) 
Seat 4: Suhoff76 ($25 in chips) 
Seat 5: caro196661cv ($29.14 in chips) 
Seat 6: Dejacob ($28.56 in chips) 
Seat 7: acamrash ($10.04 in chips) 
Seat 8: Spartacus675 ($29.16 in chips) 
Seat 9: Loholov ($15 in chips) 
Lasutchik: posts small blind $0.10
1Karina1: posts big blind $0.25
*** HOLE CARDS ***
Dealt to chiyuki [Qh 8d]
Suhoff76: folds 
caro196661cv: folds 
Dejacob: folds 
acamrash: raises $0.36 to $0.61
Spartacus675: folds 
Loholov: folds 
chiyuki: folds 
Lasutchik: folds 
1Karina1: folds 
Uncalled bet ($0.36) returned to acamrash
acamrash collected $0.60 from pot
acamrash: doesn't show hand 
*** SUMMARY ***
Total pot $0.60 | Rake $0 
Seat 1: chiyuki (button) folded before Flop (didn't bet)
Seat 2: Lasutchik (small blind) folded before Flop
Seat 3: 1Karina1 (big blind) folded before Flop
Seat 4: Suhoff76 folded before Flop (didn't bet)
Seat 5: caro196661cv folded before Flop (didn't bet)
Seat 6: Dejacob folded before Flop (didn't bet)
Seat 7: acamrash collected ($0.60)
Seat 8: Spartacus675 folded before Flop (didn't bet)
Seat 9: Loholov folded before Flop (didn't bet)



PokerStars Zoom Hand #84299564928:  Hold'em No Limit ($0.10/$0.25) - 2012/08/05 14:28:00 JST [2012/08/05 1:28:00 ET]
Table 'Whirlpool' 9-max Seat #1 is the button
Seat 1: Th3Fog ($18.29 in chips) 
Seat 2: Perstenev ($22.87 in chips) 
Seat 3: Suhoff76 ($25 in chips) 
Seat 4: Nerkit ($10.92 in chips) 
Seat 5: AlfredE525 ($13.38 in chips) 
Seat 6: chiyuki ($39.37 in chips) 
Seat 7: Alvinpe85 ($61.47 in chips) 
Seat 8: 4plankton ($17.28 in chips) 
Seat 9: wtu1986 ($24.52 in chips) 
Perstenev: posts small blind $0.10
Suhoff76: posts big blind $0.25
*** HOLE CARDS ***
Dealt to chiyuki [Kd 8s]
Nerkit: folds 
AlfredE525: raises $0.37 to $0.62
chiyuki: folds 
Alvinpe85: folds 
4plankton: folds 
wtu1986: folds 
Th3Fog: folds 
Perstenev: folds 
Suhoff76: folds 
Uncalled bet ($0.37) returned to AlfredE525
AlfredE525 collected $0.60 from pot
AlfredE525: doesn't show hand 
*** SUMMARY ***
Total pot $0.60 | Rake $0 
Seat 1: Th3Fog (button) folded before Flop (didn't bet)
Seat 2: Perstenev (small blind) folded before Flop
Seat 3: Suhoff76 (big blind) folded before Flop
Seat 4: Nerkit folded before Flop (didn't bet)
Seat 5: AlfredE525 collected ($0.60)
Seat 6: chiyuki folded before Flop (didn't bet)
Seat 7: Alvinpe85 folded before Flop (didn't bet)
Seat 8: 4plankton folded before Flop (didn't bet)
Seat 9: wtu1986 folded before Flop (didn't bet)



PokerStars Zoom Hand #84299566607:  Hold'em No Limit ($0.10/$0.25) - 2012/08/05 14:28:07 JST [2012/08/05 1:28:07 ET]
Table 'Whirlpool' 9-max Seat #1 is the button
Seat 1: 1Karina1 ($25.07 in chips) 
Seat 2: Nerkit ($10.92 in chips) 
Seat 3: hirozo ($25.57 in chips) 
Seat 4: Perstenev ($11.45 in chips) 
Seat 5: chiyuki ($39.37 in chips) 
Seat 6: Suhoff76 ($32.41 in chips) 
Seat 7: Th3Fog ($66.61 in chips) 
Seat 8: seula i ($35.96 in chips) 
Seat 9: Alvinpe85 ($39.91 in chips) 
Nerkit: posts small blind $0.10
hirozo: posts big blind $0.25
*** HOLE CARDS ***
Dealt to chiyuki [4h 4c]
Perstenev: folds 
chiyuki: raises $0.50 to $0.75
Suhoff76: folds 
Th3Fog: folds 
seula i: folds 
Alvinpe85: folds 
1Karina1: folds 
Nerkit: folds 
hirozo: folds 
Uncalled bet ($0.50) returned to chiyuki
chiyuki collected $0.60 from pot
chiyuki: doesn't show hand 
*** SUMMARY ***
Total pot $0.60 | Rake $0 
Seat 1: 1Karina1 (button) folded before Flop (didn't bet)
Seat 2: Nerkit (small blind) folded before Flop
Seat 3: hirozo (big blind) folded before Flop
Seat 4: Perstenev folded before Flop (didn't bet)
Seat 5: chiyuki collected ($0.60)
Seat 6: Suhoff76 folded before Flop (didn't bet)
Seat 7: Th3Fog folded before Flop (didn't bet)
Seat 8: seula i folded before Flop (didn't bet)
Seat 9: Alvinpe85 folded before Flop (didn't bet)



PokerStars Zoom Hand #84299559335:  Hold'em No Limit ($0.10/$0.25) - 2012/08/05 14:27:36 JST [2012/08/05 1:27:36 ET]
Table 'Whirlpool' 9-max Seat #1 is the button
Seat 1: wtu1986 ($33.17 in chips) 
Seat 2: PetitAlejo ($31.96 in chips) 
Seat 3: RomarioJa ($12.50 in chips) 
Seat 4: hirozo ($36.31 in chips) 
Seat 5: ChrisCDee ($38.63 in chips) 
Seat 6: peng2astic ($20.67 in chips) 
Seat 7: Dejacob ($28.56 in chips) 
Seat 8: chiyuki ($39.62 in chips) 
Seat 9: seula i ($35.96 in chips) 
PetitAlejo: posts small blind $0.10
RomarioJa: posts big blind $0.25
*** HOLE CARDS ***
Dealt to chiyuki [5s 3s]
hirozo: folds 
ChrisCDee: folds 
peng2astic: folds 
Dejacob: folds 
chiyuki: folds 
seula i: folds 
wtu1986: raises $0.37 to $0.62
PetitAlejo: folds 
RomarioJa: calls $0.37
*** FLOP *** [Ad Kh 6d]
RomarioJa: checks 
wtu1986: bets $0.83
RomarioJa: raises $2.17 to $3
wtu1986: folds 
Uncalled bet ($2.17) returned to RomarioJa
RomarioJa collected $2.86 from pot
RomarioJa: doesn't show hand 
*** SUMMARY ***
Total pot $3 | Rake $0.14 
Board [Ad Kh 6d]
Seat 1: wtu1986 (button) folded on the Flop
Seat 2: PetitAlejo (small blind) folded before Flop
Seat 3: RomarioJa (big blind) collected ($2.86)
Seat 4: hirozo folded before Flop (didn't bet)
Seat 5: ChrisCDee folded before Flop (didn't bet)
Seat 6: peng2astic folded before Flop (didn't bet)
Seat 7: Dejacob folded before Flop (didn't bet)
Seat 8: chiyuki folded before Flop (didn't bet)
Seat 9: seula i folded before Flop (didn't bet)



PokerStars Zoom Hand #84299573027:  Hold'em No Limit ($0.10/$0.25) - 2012/08/05 14:28:33 JST [2012/08/05 1:28:33 ET]
Table 'Whirlpool' 9-max Seat #1 is the button
Seat 1: Loholov ($15 in chips) 
Seat 2: kamikkaze ($18.48 in chips) 
Seat 3: seula i ($33.99 in chips) 
Seat 4: chiyuki ($39.72 in chips) 
Seat 5: ygoegoe ($28.01 in chips) 
Seat 6: acamrash ($10.39 in chips) 
Seat 7: Vahe50 ($25.99 in chips) 
Seat 8: phate-1up ($41.09 in chips) 
Seat 9: KeLevro0 ($13.52 in chips) 
kamikkaze: posts small blind $0.10
seula i: posts big blind $0.25
*** HOLE CARDS ***
Dealt to chiyuki [7d 7c]
chiyuki: raises $0.50 to $0.75
ygoegoe: calls $0.75
acamrash: folds 
Vahe50: folds 
phate-1up: folds 
KeLevro0: folds 
Loholov: folds 
kamikkaze: folds 
seula i: folds 
*** FLOP *** [3c 5d 5s]
chiyuki: bets $1
ygoegoe: folds 
Uncalled bet ($1) returned to chiyuki
chiyuki collected $1.77 from pot
chiyuki: doesn't show hand 
*** SUMMARY ***
Total pot $1.85 | Rake $0.08 
Board [3c 5d 5s]
Seat 1: Loholov (button) folded before Flop (didn't bet)
Seat 2: kamikkaze (small blind) folded before Flop
Seat 3: seula i (big blind) folded before Flop
Seat 4: chiyuki collected ($1.77)
Seat 5: ygoegoe folded on the Flop
Seat 6: acamrash folded before Flop (didn't bet)
Seat 7: Vahe50 folded before Flop (didn't bet)
Seat 8: phate-1up folded before Flop (didn't bet)
Seat 9: KeLevro0 folded before Flop (didn't bet)



PokerStars Zoom Hand #84299579873:  Hold'em No Limit ($0.10/$0.25) - 2012/08/05 14:29:01 JST [2012/08/05 1:29:01 ET]
Table 'Whirlpool' 9-max Seat #1 is the button
Seat 1: ZhukOFFskI ($24.90 in chips) 
Seat 2: chiyuki ($40.74 in chips) 
Seat 3: Suhoff76 ($28.30 in chips) 
Seat 4: Nerkit ($10.57 in chips) 
Seat 5: kamikkaze ($32.07 in chips) 
Seat 6: phate-1up ($33.17 in chips) 
Seat 7: KrystalAA ($12.50 in chips) 
Seat 8: pef1331 ($29.64 in chips) 
Seat 9: deadmoneykid ($22.14 in chips) 
chiyuki: posts small blind $0.10
Suhoff76: posts big blind $0.25
*** HOLE CARDS ***
Dealt to chiyuki [2h Jh]
Nerkit: raises $0.50 to $0.75
kamikkaze: folds 
phate-1up: folds 
KrystalAA: folds 
pef1331: folds 
deadmoneykid: folds 
ZhukOFFskI: folds 
chiyuki: folds 
Suhoff76: folds 
Uncalled bet ($0.50) returned to Nerkit
Nerkit collected $0.60 from pot
Nerkit: doesn't show hand 
*** SUMMARY ***
Total pot $0.60 | Rake $0 
Seat 1: ZhukOFFskI (button) folded before Flop (didn't bet)
Seat 2: chiyuki (small blind) folded before Flop
Seat 3: Suhoff76 (big blind) folded before Flop
Seat 4: Nerkit collected ($0.60)
Seat 5: kamikkaze folded before Flop (didn't bet)
Seat 6: phate-1up folded before Flop (didn't bet)
Seat 7: KrystalAA folded before Flop (didn't bet)
Seat 8: pef1331 folded before Flop (didn't bet)
Seat 9: deadmoneykid folded before Flop (didn't bet)



PokerStars Zoom Hand #84299585955:  Hold'em No Limit ($0.10/$0.25) - 2012/08/05 14:29:27 JST [2012/08/05 1:29:27 ET]
Table 'Whirlpool' 9-max Seat #1 is the button
Seat 1: Suhoff76 ($28.05 in chips) 
Seat 2: flyinprits ($27.77 in chips) 
Seat 3: Perstenev ($11.58 in chips) 
Seat 4: chiyuki ($40.64 in chips) 
Seat 5: 1Karina1 ($25.10 in chips) 
Seat 6: JLajoie ($26.39 in chips) 
Seat 7: Nerkit ($14.48 in chips) 
Seat 8: KeLevro0 ($9.84 in chips) 
Seat 9: kamikkaze ($15.62 in chips) 
flyinprits: posts small blind $0.10
Perstenev: posts big blind $0.25
*** HOLE CARDS ***
Dealt to chiyuki [3d As]
chiyuki: folds 
1Karina1: folds 
JLajoie: folds 
Nerkit: folds 
KeLevro0: folds 
kamikkaze: folds 
Suhoff76: folds 
flyinprits: folds 
Uncalled bet ($0.15) returned to Perstenev
Perstenev collected $0.20 from pot
Perstenev: doesn't show hand 
*** SUMMARY ***
Total pot $0.20 | Rake $0 
Seat 1: Suhoff76 (button) folded before Flop (didn't bet)
Seat 2: flyinprits (small blind) folded before Flop
Seat 3: Perstenev (big blind) collected ($0.20)
Seat 4: chiyuki folded before Flop (didn't bet)
Seat 5: 1Karina1 folded before Flop (didn't bet)
Seat 6: JLajoie folded before Flop (didn't bet)
Seat 7: Nerkit folded before Flop (didn't bet)
Seat 8: KeLevro0 folded before Flop (didn't bet)
Seat 9: kamikkaze folded before Flop (didn't bet)



PokerStars Zoom Hand #84299581378:  Hold'em No Limit ($0.10/$0.25) - 2012/08/05 14:29:08 JST [2012/08/05 1:29:08 ET]
Table 'Whirlpool' 9-max Seat #1 is the button
Seat 1: RikkStroken ($11.91 in chips) 
Seat 2: Lasutchik ($70.36 in chips) 
Seat 3: kamikkaze ($18.38 in chips) 
Seat 4: DanielWhyte ($38.96 in chips) 
Seat 5: 1Karina1 ($25 in chips) 
Seat 6: Yogi707 ($13.80 in chips) 
Seat 7: JLajoie ($36.99 in chips) 
Seat 8: RomarioJa ($14.92 in chips) 
Seat 9: chiyuki ($40.64 in chips) 
Lasutchik: posts small blind $0.10
kamikkaze: posts big blind $0.25
*** HOLE CARDS ***
Dealt to chiyuki [6s Ah]
DanielWhyte: folds 
1Karina1: folds 
Yogi707: folds 
JLajoie: folds 
RomarioJa: folds 
chiyuki: folds 
RikkStroken: raises $0.50 to $0.75
Lasutchik: folds 
kamikkaze: folds 
Uncalled bet ($0.50) returned to RikkStroken
RikkStroken collected $0.60 from pot
RikkStroken: doesn't show hand 
*** SUMMARY ***
Total pot $0.60 | Rake $0 
Seat 1: RikkStroken (button) collected ($0.60)
Seat 2: Lasutchik (small blind) folded before Flop
Seat 3: kamikkaze (big blind) folded before Flop
Seat 4: DanielWhyte folded before Flop (didn't bet)
Seat 5: 1Karina1 folded before Flop (didn't bet)
Seat 6: Yogi707 folded before Flop (didn't bet)
Seat 7: JLajoie folded before Flop (didn't bet)
Seat 8: RomarioJa folded before Flop (didn't bet)
Seat 9: chiyuki folded before Flop (didn't bet)



PokerStars Zoom Hand #84299583782:  Hold'em No Limit ($0.10/$0.25) - 2012/08/05 14:29:18 JST [2012/08/05 1:29:18 ET]
Table 'Whirlpool' 9-max Seat #1 is the button
Seat 1: BlOnDhOlIc ($58.64 in chips) 
Seat 2: KrystalAA ($11.75 in chips) 
Seat 3: Lasutchik ($12.50 in chips) 
Seat 4: pef1331 ($29.64 in chips) 
Seat 5: hirozo ($39.03 in chips) 
Seat 6: yane73 ($14.02 in chips) 
Seat 7: Dafleche ($18.60 in chips) 
Seat 8: chiyuki ($40.64 in chips) 
Seat 9: kamikkaze ($15.55 in chips) 
KrystalAA: posts small blind $0.10
Lasutchik: posts big blind $0.25
*** HOLE CARDS ***
Dealt to chiyuki [7s Th]
pef1331: folds 
hirozo: folds 
yane73: raises $0.25 to $0.50
Dafleche: folds 
chiyuki: folds 
kamikkaze: folds 
BlOnDhOlIc: folds 
KrystalAA: folds 
Lasutchik: folds 
Uncalled bet ($0.25) returned to yane73
yane73 collected $0.60 from pot
yane73: doesn't show hand 
*** SUMMARY ***
Total pot $0.60 | Rake $0 
Seat 1: BlOnDhOlIc (button) folded before Flop (didn't bet)
Seat 2: KrystalAA (small blind) folded before Flop
Seat 3: Lasutchik (big blind) folded before Flop
Seat 4: pef1331 folded before Flop (didn't bet)
Seat 5: hirozo folded before Flop (didn't bet)
Seat 6: yane73 collected ($0.60)
Seat 7: Dafleche folded before Flop (didn't bet)
Seat 8: chiyuki folded before Flop (didn't bet)
Seat 9: kamikkaze folded before Flop (didn't bet)



PokerStars Zoom Hand #84299586713:  Hold'em No Limit ($0.10/$0.25) - 2012/08/05 14:29:30 JST [2012/08/05 1:29:30 ET]
Table 'Whirlpool' 9-max Seat #1 is the button
Seat 1: chiyuki ($40.64 in chips) 
Seat 2: 1Karina1 ($26.53 in chips) 
Seat 3: hirozo ($39.03 in chips) 
Seat 4: KrystalAA ($12.50 in chips) 
Seat 5: simonzez ($55.19 in chips) 
Seat 6: Vahe50 ($25.24 in chips) 
Seat 7: el pore 5 ($18.17 in chips) 
Seat 8: Roglus ($10.32 in chips) 
Seat 9: WARIBANA7777 ($14.09 in chips) 
1Karina1: posts small blind $0.10
hirozo: posts big blind $0.25
*** HOLE CARDS ***
Dealt to chiyuki [3c Ac]
KrystalAA: folds 
simonzez: raises $0.25 to $0.50
Vahe50: folds 
el pore 5: calls $0.50
Roglus: folds 
WARIBANA7777: folds 
chiyuki: folds 
1Karina1: folds 
hirozo: folds 
*** FLOP *** [4s Jd 5h]
simonzez: bets $0.50
el pore 5: calls $0.50
*** TURN *** [4s Jd 5h] [Ad]
simonzez: bets $0.50
el pore 5: calls $0.50
*** RIVER *** [4s Jd 5h Ad] [9d]
simonzez: bets $1.25
el pore 5: calls $1.25
*** SHOW DOWN ***
simonzez: shows [Ts Qs] (high card Ace)
el pore 5: shows [Ah Ks] (a pair of Aces)
el pore 5 collected $5.59 from pot
*** SUMMARY ***
Total pot $5.85 | Rake $0.26 
Board [4s Jd 5h Ad 9d]
Seat 1: chiyuki (button) folded before Flop (didn't bet)
Seat 2: 1Karina1 (small blind) folded before Flop
Seat 3: hirozo (big blind) folded before Flop
Seat 4: KrystalAA folded before Flop (didn't bet)
Seat 5: simonzez showed [Ts Qs] and lost with high card Ace
Seat 6: Vahe50 folded before Flop (didn't bet)
Seat 7: el pore 5 showed [Ah Ks] and won ($5.59) with a pair of Aces
Seat 8: Roglus folded before Flop (didn't bet)
Seat 9: WARIBANA7777 folded before Flop (didn't bet)



PokerStars Zoom Hand #84299590750:  Hold'em No Limit ($0.10/$0.25) - 2012/08/05 14:29:46 JST [2012/08/05 1:29:46 ET]
Table 'Whirlpool' 9-max Seat #1 is the button
Seat 1: Ladyteazer ($25.54 in chips) 
Seat 2: hirozo ($38.78 in chips) 
Seat 3: chiyuki ($40.64 in chips) 
Seat 4: Faraz ($18.79 in chips) 
Seat 5: mariuka1 ($11.10 in chips) 
Seat 6: PetitAlejo ($40.99 in chips) 
Seat 7: kamikkaze ($18.03 in chips) 
Seat 8: WARIBANA7777 ($14.09 in chips) 
Seat 9: Lasutchik ($70.26 in chips) 
hirozo: posts small blind $0.10
chiyuki: posts big blind $0.25
*** HOLE CARDS ***
Dealt to chiyuki [5s 8d]
Faraz: folds 
mariuka1: folds 
PetitAlejo: folds 
kamikkaze: folds 
WARIBANA7777: folds 
Lasutchik: folds 
Ladyteazer: folds 
hirozo: raises $0.25 to $0.50
chiyuki: calls $0.25
*** FLOP *** [Jd Js 6s]
hirozo: checks 
chiyuki: bets $0.50
hirozo: folds 
Uncalled bet ($0.50) returned to chiyuki
chiyuki collected $0.96 from pot
chiyuki: doesn't show hand 
*** SUMMARY ***
Total pot $1 | Rake $0.04 
Board [Jd Js 6s]
Seat 1: Ladyteazer (button) folded before Flop (didn't bet)
Seat 2: hirozo (small blind) folded on the Flop
Seat 3: chiyuki (big blind) collected ($0.96)
Seat 4: Faraz folded before Flop (didn't bet)
Seat 5: mariuka1 folded before Flop (didn't bet)
Seat 6: PetitAlejo folded before Flop (didn't bet)
Seat 7: kamikkaze folded before Flop (didn't bet)
Seat 8: WARIBANA7777 folded before Flop (didn't bet)
Seat 9: Lasutchik folded before Flop (didn't bet)



PokerStars Zoom Hand #84299589994:  Hold'em No Limit ($0.10/$0.25) - 2012/08/05 14:29:43 JST [2012/08/05 1:29:43 ET]
Table 'Whirlpool' 9-max Seat #1 is the button
Seat 1: 1Karina1 ($25 in chips) 
Seat 2: bonethugs699 ($30.99 in chips) 
Seat 3: BlOnDhOlIc ($35.61 in chips) 
Seat 4: KeLevro0 ($9.43 in chips) 
Seat 5: Roglus ($10.32 in chips) 
Seat 6: Loholov ($15 in chips) 
Seat 7: chiyuki ($40.64 in chips) 
Seat 8: Jene4kaBest ($12.62 in chips) 
Seat 9: pef1331 ($29.29 in chips) 
bonethugs699: posts small blind $0.10
BlOnDhOlIc: posts big blind $0.25
*** HOLE CARDS ***
Dealt to chiyuki [5s 2s]
KeLevro0: folds 
Roglus: raises $0.50 to $0.75
Loholov: calls $0.75
chiyuki: folds 
Jene4kaBest: folds 
pef1331: calls $0.75
1Karina1: folds 
bonethugs699: folds 
BlOnDhOlIc: folds 
*** FLOP *** [2h Jh 6d]
Roglus: bets $1.50
Loholov: calls $1.50
pef1331: folds 
*** TURN *** [2h Jh 6d] [6c]
Roglus: bets $3
Loholov: calls $3
*** RIVER *** [2h Jh 6d 6c] [Kc]
Roglus: bets $3.87
Loholov: calls $3.87
*** SHOW DOWN ***
Roglus: shows [Qh Th] (a pair of Sixes)
Loholov: shows [9c Jc] (two pair, Jacks and Sixes)
Loholov collected $18.47 from pot
*** SUMMARY ***
Total pot $19.34 | Rake $0.87 
Board [2h Jh 6d 6c Kc]
Seat 1: 1Karina1 (button) folded before Flop (didn't bet)
Seat 2: bonethugs699 (small blind) folded before Flop
Seat 3: BlOnDhOlIc (big blind) folded before Flop
Seat 4: KeLevro0 folded before Flop (didn't bet)
Seat 5: Roglus showed [Qh Th] and lost with a pair of Sixes
Seat 6: Loholov showed [9c Jc] and won ($18.47) with two pair, Jacks and Sixes
Seat 7: chiyuki folded before Flop (didn't bet)
Seat 8: Jene4kaBest folded before Flop (didn't bet)
Seat 9: pef1331 folded on the Flop



PokerStars Zoom Hand #84299602854:  Hold'em No Limit ($0.10/$0.25) - 2012/08/05 14:30:36 JST [2012/08/05 1:30:36 ET]
Table 'Whirlpool' 9-max Seat #1 is the button
Seat 1: Dejacob ($30.64 in chips) 
Seat 2: wtu1986 ($25.80 in chips) 
Seat 3: Perstenev ($13 in chips) 
Seat 4: Alvinpe85 ($50.36 in chips) 
Seat 5: ygoegoe ($25 in chips) 
Seat 6: KeLevro0 ($9.08 in chips) 
Seat 7: Th3Fog ($17.88 in chips) 
Seat 8: PetitAlejo ($31.41 in chips) 
Seat 9: chiyuki ($41 in chips) 
wtu1986: posts small blind $0.10
Perstenev: posts big blind $0.25
*** HOLE CARDS ***
Dealt to chiyuki [Ks 7s]
Alvinpe85: folds 
ygoegoe: folds 
KeLevro0: folds 
Th3Fog: folds 
PetitAlejo: raises $0.50 to $0.75
chiyuki: folds 
Dejacob: folds 
wtu1986: folds 
Perstenev: folds 
Uncalled bet ($0.50) returned to PetitAlejo
PetitAlejo collected $0.60 from pot
PetitAlejo: doesn't show hand 
*** SUMMARY ***
Total pot $0.60 | Rake $0 
Seat 1: Dejacob (button) folded before Flop (didn't bet)
Seat 2: wtu1986 (small blind) folded before Flop
Seat 3: Perstenev (big blind) folded before Flop
Seat 4: Alvinpe85 folded before Flop (didn't bet)
Seat 5: ygoegoe folded before Flop (didn't bet)
Seat 6: KeLevro0 folded before Flop (didn't bet)
Seat 7: Th3Fog folded before Flop (didn't bet)
Seat 8: PetitAlejo collected ($0.60)
Seat 9: chiyuki folded before Flop (didn't bet)



PokerStars Zoom Hand #84299599685:  Hold'em No Limit ($0.10/$0.25) - 2012/08/05 14:30:23 JST [2012/08/05 1:30:23 ET]
Table 'Whirlpool' 9-max Seat #1 is the button
Seat 1: PetitAlejo ($52.51 in chips) 
Seat 2: chiyuki ($41.10 in chips) 
Seat 3: Roglus ($1.20 in chips) 
Seat 4: seula i ($35.61 in chips) 
Seat 5: 1Karina1 ($25 in chips) 
Seat 6: el pore 5 ($21.01 in chips) 
Seat 7: Lasutchik ($70.61 in chips) 
Seat 8: Perstenev ($13 in chips) 
Seat 9: Dejacob ($48.87 in chips) 
chiyuki: posts small blind $0.10
Roglus: posts big blind $0.25
*** HOLE CARDS ***
Dealt to chiyuki [2c Jc]
seula i: folds 
1Karina1: folds 
el pore 5: folds 
Lasutchik: folds 
Perstenev: folds 
Dejacob: folds 
PetitAlejo: folds 
chiyuki: folds 
Uncalled bet ($0.15) returned to Roglus
Roglus collected $0.20 from pot
Roglus: doesn't show hand 
*** SUMMARY ***
Total pot $0.20 | Rake $0 
Seat 1: PetitAlejo (button) folded before Flop (didn't bet)
Seat 2: chiyuki (small blind) folded before Flop
Seat 3: Roglus (big blind) collected ($0.20)
Seat 4: seula i folded before Flop (didn't bet)
Seat 5: 1Karina1 folded before Flop (didn't bet)
Seat 6: el pore 5 folded before Flop (didn't bet)
Seat 7: Lasutchik folded before Flop (didn't bet)
Seat 8: Perstenev folded before Flop (didn't bet)
Seat 9: Dejacob folded before Flop (didn't bet)



PokerStars Zoom Hand #84299598665:  Hold'em No Limit ($0.10/$0.25) - 2012/08/05 14:30:18 JST [2012/08/05 1:30:18 ET]
Table 'Whirlpool' 9-max Seat #1 is the button
Seat 1: KrystalAA ($12.15 in chips) 
Seat 2: softdesign ($68.48 in chips) 
Seat 3: DanielWhyte ($38.86 in chips) 
Seat 4: Lasutchik ($70.61 in chips) 
Seat 5: el pore 5 ($21.01 in chips) 
Seat 6: chiyuki ($41.10 in chips) 
Seat 7: deadmoneykid ($22.04 in chips) 
Seat 8: BlOnDhOlIc ($86.78 in chips) 
Seat 9: hirozo ($38.38 in chips) 
softdesign: posts small blind $0.10
DanielWhyte: posts big blind $0.25
*** HOLE CARDS ***
Dealt to chiyuki [4d 8s]
Lasutchik: folds 
el pore 5: folds 
chiyuki: folds 
deadmoneykid: folds 
BlOnDhOlIc: folds 
hirozo: raises $0.50 to $0.75
KrystalAA: folds 
softdesign: calls $0.65
DanielWhyte: folds 
*** FLOP *** [Jc 7h 7c]
softdesign: bets $1.75
hirozo: raises $2.59 to $4.34
softdesign: calls $2.59
*** TURN *** [Jc 7h 7c] [Kc]
softdesign: bets $7.25
hirozo: folds 
Uncalled bet ($7.25) returned to softdesign
softdesign collected $9.96 from pot
softdesign: doesn't show hand 
*** SUMMARY ***
Total pot $10.43 | Rake $0.47 
Board [Jc 7h 7c Kc]
Seat 1: KrystalAA (button) folded before Flop (didn't bet)
Seat 2: softdesign (small blind) collected ($9.96)
Seat 3: DanielWhyte (big blind) folded before Flop
Seat 4: Lasutchik folded before Flop (didn't bet)
Seat 5: el pore 5 folded before Flop (didn't bet)
Seat 6: chiyuki folded before Flop (didn't bet)
Seat 7: deadmoneykid folded before Flop (didn't bet)
Seat 8: BlOnDhOlIc folded before Flop (didn't bet)
Seat 9: hirozo folded on the Turn



PokerStars Zoom Hand #84299608522:  Hold'em No Limit ($0.10/$0.25) - 2012/08/05 14:30:59 JST [2012/08/05 1:30:59 ET]
Table 'Whirlpool' 9-max Seat #1 is the button
Seat 1: chiyuki ($41 in chips) 
Seat 2: Perstenev ($12.75 in chips) 
Seat 3: KeLevro0 ($9.08 in chips) 
Seat 4: KrystalAA ($12 in chips) 
Seat 5: DanielWhyte ($38.51 in chips) 
Seat 6: hirozo ($25.25 in chips) 
Seat 7: wtu1986 ($25.25 in chips) 
Seat 8: pef1331 ($28.19 in chips) 
Seat 9: Feros 99 ($22.70 in chips) 
Perstenev: posts small blind $0.10
KeLevro0: posts big blind $0.25
*** HOLE CARDS ***
Dealt to chiyuki [2h Ks]
KrystalAA: raises $0.46 to $0.71
DanielWhyte: folds 
hirozo: folds 
wtu1986: folds 
pef1331: folds 
Feros 99: folds 
chiyuki: folds 
Perstenev: folds 
KeLevro0: folds 
Uncalled bet ($0.46) returned to KrystalAA
KrystalAA collected $0.60 from pot
KrystalAA: doesn't show hand 
*** SUMMARY ***
Total pot $0.60 | Rake $0 
Seat 1: chiyuki (button) folded before Flop (didn't bet)
Seat 2: Perstenev (small blind) folded before Flop
Seat 3: KeLevro0 (big blind) folded before Flop
Seat 4: KrystalAA collected ($0.60)
Seat 5: DanielWhyte folded before Flop (didn't bet)
Seat 6: hirozo folded before Flop (didn't bet)
Seat 7: wtu1986 folded before Flop (didn't bet)
Seat 8: pef1331 folded before Flop (didn't bet)
Seat 9: Feros 99 folded before Flop (didn't bet)



PokerStars Zoom Hand #84299609311:  Hold'em No Limit ($0.10/$0.25) - 2012/08/05 14:31:02 JST [2012/08/05 1:31:02 ET]
Table 'Whirlpool' 9-max Seat #1 is the button
Seat 1: Loholov ($22.77 in chips) 
Seat 2: Ellen1947 ($26.77 in chips) 
Seat 3: 1Karina1 ($26.78 in chips) 
Seat 4: Perstenev ($12.65 in chips) 
Seat 5: ZhukOFFskI ($24.30 in chips) 
Seat 6: slapshot2011 ($33.63 in chips) 
Seat 7: chiyuki ($41 in chips) 
Seat 8: Dejacob ($48.52 in chips) 
Seat 9: XeriaX ($18.39 in chips) 
Ellen1947: posts small blind $0.10
1Karina1: posts big blind $0.25
*** HOLE CARDS ***
Dealt to chiyuki [Jh 5d]
Perstenev: folds 
ZhukOFFskI: folds 
slapshot2011: folds 
chiyuki: folds 
Dejacob: folds 
XeriaX: folds 
Loholov: folds 
Ellen1947: folds 
Uncalled bet ($0.15) returned to 1Karina1
1Karina1 collected $0.20 from pot
1Karina1: doesn't show hand 
*** SUMMARY ***
Total pot $0.20 | Rake $0 
Seat 1: Loholov (button) folded before Flop (didn't bet)
Seat 2: Ellen1947 (small blind) folded before Flop
Seat 3: 1Karina1 (big blind) collected ($0.20)
Seat 4: Perstenev folded before Flop (didn't bet)
Seat 5: ZhukOFFskI folded before Flop (didn't bet)
Seat 6: slapshot2011 folded before Flop (didn't bet)
Seat 7: chiyuki folded before Flop (didn't bet)
Seat 8: Dejacob folded before Flop (didn't bet)
Seat 9: XeriaX folded before Flop (didn't bet)



PokerStars Zoom Hand #84299605572:  Hold'em No Limit ($0.10/$0.25) - 2012/08/05 14:30:47 JST [2012/08/05 1:30:47 ET]
Table 'Whirlpool' 9-max Seat #1 is the button
Seat 1: ll_LaMeR_ll ($70.19 in chips) 
Seat 2: Loholov ($15 in chips) 
Seat 3: phate-1up ($33.52 in chips) 
Seat 4: Lasutchik ($12.15 in chips) 
Seat 5: chiyuki ($41 in chips) 
Seat 6: Perstenev ($12.75 in chips) 
Seat 7: flyinprits ($12.42 in chips) 
Seat 8: Suhoff76 ($28.05 in chips) 
Seat 9: BlOnDhOlIc ($86.68 in chips) 
Loholov: posts small blind $0.10
phate-1up: posts big blind $0.25
*** HOLE CARDS ***
Dealt to chiyuki [Jh Tc]
Lasutchik: calls $0.25
chiyuki: folds 
Perstenev: folds 
flyinprits: folds 
Suhoff76: folds 
BlOnDhOlIc: folds 
ll_LaMeR_ll: folds 
Loholov: folds 
phate-1up: checks 
*** FLOP *** [8s 3s As]
phate-1up: checks 
Lasutchik: bets $0.25
phate-1up: raises $1.25 to $1.50
Lasutchik: folds 
Uncalled bet ($1.25) returned to phate-1up
phate-1up collected $1.05 from pot
phate-1up: doesn't show hand 
*** SUMMARY ***
Total pot $1.10 | Rake $0.05 
Board [8s 3s As]
Seat 1: ll_LaMeR_ll (button) folded before Flop (didn't bet)
Seat 2: Loholov (small blind) folded before Flop
Seat 3: phate-1up (big blind) collected ($1.05)
Seat 4: Lasutchik folded on the Flop
Seat 5: chiyuki folded before Flop (didn't bet)
Seat 6: Perstenev folded before Flop (didn't bet)
Seat 7: flyinprits folded before Flop (didn't bet)
Seat 8: Suhoff76 folded before Flop (didn't bet)
Seat 9: BlOnDhOlIc folded before Flop (didn't bet)



PokerStars Zoom Hand #84299607282:  Hold'em No Limit ($0.10/$0.25) - 2012/08/05 14:30:54 JST [2012/08/05 1:30:54 ET]
Table 'Whirlpool' 9-max Seat #1 is the button
Seat 1: pef1331 ($28.19 in chips) 
Seat 2: Alvinpe85 ($50.36 in chips) 
Seat 3: stalkerec ($12.50 in chips) 
Seat 4: yane73 ($21.33 in chips) 
Seat 5: Spartacus675 ($34.86 in chips) 
Seat 6: Ellen1947 ($26.77 in chips) 
Seat 7: Suhoff76 ($25.40 in chips) 
Seat 8: chiyuki ($41 in chips) 
Seat 9: 4ydo yogurt ($11.66 in chips) 
Alvinpe85: posts small blind $0.10
stalkerec: posts big blind $0.25
*** HOLE CARDS ***
Dealt to chiyuki [Tc 4d]
yane73: raises $0.25 to $0.50
Spartacus675: folds 
Ellen1947: folds 
Suhoff76: folds 
chiyuki: folds 
4ydo yogurt: folds 
pef1331: folds 
Alvinpe85: folds 
stalkerec: calls $0.25
*** FLOP *** [Qc 5s 6s]
stalkerec: checks 
yane73: bets $0.75
stalkerec: folds 
Uncalled bet ($0.75) returned to yane73
yane73 collected $1.05 from pot
yane73: doesn't show hand 
*** SUMMARY ***
Total pot $1.10 | Rake $0.05 
Board [Qc 5s 6s]
Seat 1: pef1331 (button) folded before Flop (didn't bet)
Seat 2: Alvinpe85 (small blind) folded before Flop
Seat 3: stalkerec (big blind) folded on the Flop
Seat 4: yane73 collected ($1.05)
Seat 5: Spartacus675 folded before Flop (didn't bet)
Seat 6: Ellen1947 folded before Flop (didn't bet)
Seat 7: Suhoff76 folded before Flop (didn't bet)
Seat 8: chiyuki folded before Flop (didn't bet)
Seat 9: 4ydo yogurt folded before Flop (didn't bet)



PokerStars Zoom Hand #84299612747:  Hold'em No Limit ($0.10/$0.25) - 2012/08/05 14:31:16 JST [2012/08/05 1:31:16 ET]
Table 'Whirlpool' 9-max Seat #1 is the button
Seat 1: kamikkaze ($17.28 in chips) 
Seat 2: DanielWhyte ($38.26 in chips) 
Seat 3: Dan Royal ($31.86 in chips) 
Seat 4: wtu1986 ($25.70 in chips) 
Seat 5: Wilcox76607 ($13.49 in chips) 
Seat 6: Perstenev ($21.20 in chips) 
Seat 7: silvno31 ($27.69 in chips) 
Seat 8: RikkStroken ($81.04 in chips) 
Seat 9: chiyuki ($41 in chips) 
DanielWhyte: posts small blind $0.10
Dan Royal: posts big blind $0.25
*** HOLE CARDS ***
Dealt to chiyuki [5s Th]
wtu1986: folds 
Wilcox76607: folds 
Perstenev: folds 
silvno31: folds 
RikkStroken: folds 
chiyuki: folds 
kamikkaze: raises $17.03 to $17.28 and is all-in
DanielWhyte: calls $17.18
Dan Royal: folds 
*** FLOP *** [7h 8c Jh]
*** TURN *** [7h 8c Jh] [6d]
*** RIVER *** [7h 8c Jh 6d] [9d]
*** SHOW DOWN ***
DanielWhyte: shows [Jc Js] (three of a kind, Jacks)
kamikkaze: mucks hand 
DanielWhyte collected $33.24 from pot
*** SUMMARY ***
Total pot $34.81 | Rake $1.57 
Board [7h 8c Jh 6d 9d]
Seat 1: kamikkaze (button) mucked [Qc Qd]
Seat 2: DanielWhyte (small blind) showed [Jc Js] and won ($33.24) with three of a kind, Jacks
Seat 3: Dan Royal (big blind) folded before Flop
Seat 4: wtu1986 folded before Flop (didn't bet)
Seat 5: Wilcox76607 folded before Flop (didn't bet)
Seat 6: Perstenev folded before Flop (didn't bet)
Seat 7: silvno31 folded before Flop (didn't bet)
Seat 8: RikkStroken folded before Flop (didn't bet)
Seat 9: chiyuki folded before Flop (didn't bet)



PokerStars Zoom Hand #84299613696:  Hold'em No Limit ($0.10/$0.25) - 2012/08/05 14:31:20 JST [2012/08/05 1:31:20 ET]
Table 'Whirlpool' 9-max Seat #1 is the button
Seat 1: Th3Fog ($17.78 in chips) 
Seat 2: Spartacus675 ($34.61 in chips) 
Seat 3: chiyuki ($41 in chips) 
Seat 4: silvno31 ($27.69 in chips) 
Seat 5: Roglus ($78.45 in chips) 
Seat 6: KrystalAA ($12.50 in chips) 
Seat 7: BlOnDhOlIc ($86.68 in chips) 
Seat 8: Loholov ($18.54 in chips) 
Seat 9: phate-1up ($27.47 in chips) 
Spartacus675: posts small blind $0.10
chiyuki: posts big blind $0.25
*** HOLE CARDS ***
Dealt to chiyuki [Jd Ac]
silvno31: raises $0.75 to $1
Roglus: folds 
KrystalAA: folds 
BlOnDhOlIc: folds 
Loholov: folds 
phate-1up: folds 
Th3Fog: folds 
Spartacus675: folds 
chiyuki: folds 
Uncalled bet ($0.75) returned to silvno31
silvno31 collected $0.60 from pot
silvno31: doesn't show hand 
*** SUMMARY ***
Total pot $0.60 | Rake $0 
Seat 1: Th3Fog (button) folded before Flop (didn't bet)
Seat 2: Spartacus675 (small blind) folded before Flop
Seat 3: chiyuki (big blind) folded before Flop
Seat 4: silvno31 collected ($0.60)
Seat 5: Roglus folded before Flop (didn't bet)
Seat 6: KrystalAA folded before Flop (didn't bet)
Seat 7: BlOnDhOlIc folded before Flop (didn't bet)
Seat 8: Loholov folded before Flop (didn't bet)
Seat 9: phate-1up folded before Flop (didn't bet)



PokerStars Zoom Hand #84299618633:  Hold'em No Limit ($0.10/$0.25) - 2012/08/05 14:31:41 JST [2012/08/05 1:31:41 ET]
Table 'Whirlpool' 9-max Seat #1 is the button
Seat 1: RikkStroken ($81.04 in chips) 
Seat 2: chiyuki ($40.75 in chips) 
Seat 3: ChrisCDee ($64.86 in chips) 
Seat 4: KeLevro0 ($12.07 in chips) 
Seat 5: wtu1986 ($31.27 in chips) 
Seat 6: XeriaX ($24.75 in chips) 
Seat 7: Spartacus675 ($34.51 in chips) 
Seat 8: phate-1up ($26.81 in chips) 
Seat 9: Dan Royal ($31.61 in chips) 
chiyuki: posts small blind $0.10
ChrisCDee: posts big blind $0.25
*** HOLE CARDS ***
Dealt to chiyuki [7h 2d]
KeLevro0: folds 
wtu1986: raises $0.50 to $0.75
XeriaX: folds 
Spartacus675: folds 
phate-1up: folds 
Dan Royal: folds 
RikkStroken: folds 
chiyuki: folds 
ChrisCDee: folds 
Uncalled bet ($0.50) returned to wtu1986
wtu1986 collected $0.60 from pot
wtu1986: doesn't show hand 
*** SUMMARY ***
Total pot $0.60 | Rake $0 
Seat 1: RikkStroken (button) folded before Flop (didn't bet)
Seat 2: chiyuki (small blind) folded before Flop
Seat 3: ChrisCDee (big blind) folded before Flop
Seat 4: KeLevro0 folded before Flop (didn't bet)
Seat 5: wtu1986 collected ($0.60)
Seat 6: XeriaX folded before Flop (didn't bet)
Seat 7: Spartacus675 folded before Flop (didn't bet)
Seat 8: phate-1up folded before Flop (didn't bet)
Seat 9: Dan Royal folded before Flop (didn't bet)



PokerStars Zoom Hand #84299610793:  Hold'em No Limit ($0.10/$0.25) - 2012/08/05 14:31:08 JST [2012/08/05 1:31:08 ET]
Table 'Whirlpool' 9-max Seat #1 is the button
Seat 1: KrystalAA ($12.50 in chips) 
Seat 2: KeLevro0 ($8.83 in chips) 
Seat 3: Suhoff76 ($32.41 in chips) 
Seat 4: hirozo ($25.25 in chips) 
Seat 5: pef1331 ($28.19 in chips) 
Seat 6: chiyuki ($41 in chips) 
Seat 7: dushvan ($28.99 in chips) 
Seat 8: ChrisCDee ($64.86 in chips) 
Seat 9: ZhukOFFskI ($24.30 in chips) 
KeLevro0: posts small blind $0.10
Suhoff76: posts big blind $0.25
*** HOLE CARDS ***
Dealt to chiyuki [6d 3h]
hirozo: folds 
pef1331: raises $0.25 to $0.50
chiyuki: folds 
dushvan: raises $1.25 to $1.75
ChrisCDee: folds 
ZhukOFFskI: folds 
KrystalAA: folds 
KeLevro0: folds 
Suhoff76: folds 
pef1331: calls $1.25
*** FLOP *** [4d Ac Ad]
pef1331: checks 
dushvan: bets $2.25
pef1331: calls $2.25
*** TURN *** [4d Ac Ad] [9c]
pef1331: checks 
dushvan: bets $5.97
pef1331: calls $5.97
*** RIVER *** [4d Ac Ad 9c] [2d]
pef1331: checks 
dushvan: bets $9.69
pef1331: calls $9.69
*** SHOW DOWN ***
dushvan: shows [Kd Ah] (three of a kind, Aces)
pef1331: mucks hand 
dushvan collected $37.88 from pot
*** SUMMARY ***
Total pot $39.67 | Rake $1.79 
Board [4d Ac Ad 9c 2d]
Seat 1: KrystalAA (button) folded before Flop (didn't bet)
Seat 2: KeLevro0 (small blind) folded before Flop
Seat 3: Suhoff76 (big blind) folded before Flop
Seat 4: hirozo folded before Flop (didn't bet)
Seat 5: pef1331 mucked [As Js]
Seat 6: chiyuki folded before Flop (didn't bet)
Seat 7: dushvan showed [Kd Ah] and won ($37.88) with three of a kind, Aces
Seat 8: ChrisCDee folded before Flop (didn't bet)
Seat 9: ZhukOFFskI folded before Flop (didn't bet)



PokerStars Zoom Hand #84299620099:  Hold'em No Limit ($0.10/$0.25) - 2012/08/05 14:31:47 JST [2012/08/05 1:31:47 ET]
Table 'Whirlpool' 9-max Seat #1 is the button
Seat 1: silvno31 ($28.04 in chips) 
Seat 2: peng2astic ($25.50 in chips) 
Seat 3: KeLevro0 ($10.49 in chips) 
Seat 4: Vahe50 ($26.71 in chips) 
Seat 5: chiyuki ($40.65 in chips) 
Seat 6: 4ydo yogurt ($10.36 in chips) 
Seat 7: Alvinpe85 ($49.51 in chips) 
Seat 8: fuguangps ($25.60 in chips) 
Seat 9: Lasutchik ($11.75 in chips) 
peng2astic: posts small blind $0.10
KeLevro0: posts big blind $0.25
*** HOLE CARDS ***
Dealt to chiyuki [2c Jh]
Vahe50: folds 
chiyuki: folds 
4ydo yogurt: folds 
Alvinpe85: folds 
fuguangps: folds 
Lasutchik: folds 
silvno31: raises $0.50 to $0.75
peng2astic: calls $0.65
KeLevro0: calls $0.50
*** FLOP *** [4c 6d Qc]
peng2astic: checks 
KeLevro0: checks 
silvno31: bets $2
peng2astic: folds 
KeLevro0: folds 
Uncalled bet ($2) returned to silvno31
silvno31 collected $2.15 from pot
silvno31: doesn't show hand 
*** SUMMARY ***
Total pot $2.25 | Rake $0.10 
Board [4c 6d Qc]
Seat 1: silvno31 (button) collected ($2.15)
Seat 2: peng2astic (small blind) folded on the Flop
Seat 3: KeLevro0 (big blind) folded on the Flop
Seat 4: Vahe50 folded before Flop (didn't bet)
Seat 5: chiyuki folded before Flop (didn't bet)
Seat 6: 4ydo yogurt folded before Flop (didn't bet)
Seat 7: Alvinpe85 folded before Flop (didn't bet)
Seat 8: fuguangps folded before Flop (didn't bet)
Seat 9: Lasutchik folded before Flop (didn't bet)



PokerStars Zoom Hand #84299617679:  Hold'em No Limit ($0.10/$0.25) - 2012/08/05 14:31:37 JST [2012/08/05 1:31:37 ET]
Table 'Whirlpool' 9-max Seat #1 is the button
Seat 1: Dan Royal ($31.61 in chips) 
Seat 2: Perstenev ($21.20 in chips) 
Seat 3: Th3Fog ($66.89 in chips) 
Seat 4: wtu1986 ($31.27 in chips) 
Seat 5: chiyuki ($40.75 in chips) 
Seat 6: Dejacob ($30.48 in chips) 
Seat 7: KCDOGG10 ($25 in chips) 
Seat 8: 1Karina1 ($25 in chips) 
Seat 9: Vahe50 ($20.96 in chips) 
Perstenev: posts small blind $0.10
Th3Fog: posts big blind $0.25
*** HOLE CARDS ***
Dealt to chiyuki [2s 7s]
wtu1986: folds 
chiyuki: folds 
Dejacob: folds 
KCDOGG10: folds 
1Karina1: folds 
Vahe50: raises $0.25 to $0.50
Dan Royal: folds 
Perstenev: calls $0.40
Th3Fog: folds 
*** FLOP *** [3d 7c 9s]
Perstenev: checks 
Vahe50: bets $0.75
Perstenev: folds 
Uncalled bet ($0.75) returned to Vahe50
Vahe50 collected $1.19 from pot
Vahe50: doesn't show hand 
*** SUMMARY ***
Total pot $1.25 | Rake $0.06 
Board [3d 7c 9s]
Seat 1: Dan Royal (button) folded before Flop (didn't bet)
Seat 2: Perstenev (small blind) folded on the Flop
Seat 3: Th3Fog (big blind) folded before Flop
Seat 4: wtu1986 folded before Flop (didn't bet)
Seat 5: chiyuki folded before Flop (didn't bet)
Seat 6: Dejacob folded before Flop (didn't bet)
Seat 7: KCDOGG10 folded before Flop (didn't bet)
Seat 8: 1Karina1 folded before Flop (didn't bet)
Seat 9: Vahe50 collected ($1.19)



PokerStars Zoom Hand #84299621570:  Hold'em No Limit ($0.10/$0.25) - 2012/08/05 14:31:53 JST [2012/08/05 1:31:53 ET]
Table 'Whirlpool' 9-max Seat #1 is the button
Seat 1: Th3Fog ($50.33 in chips) 
Seat 2: KeLevro0 ($12.50 in chips) 
Seat 3: Wilcox76607 ($15.33 in chips) 
Seat 4: taksist889 ($20.81 in chips) 
Seat 5: KrystalAA ($11.05 in chips) 
Seat 6: troms20 ($20.33 in chips) 
Seat 7: caro196661cv ($28.83 in chips) 
Seat 8: chiyuki ($40.65 in chips) 
Seat 9: Suhoff76 ($25 in chips) 
KeLevro0: posts small blind $0.10
Wilcox76607: posts big blind $0.25
*** HOLE CARDS ***
Dealt to chiyuki [Qc Tc]
taksist889: folds 
KrystalAA: folds 
troms20: folds 
caro196661cv: folds 
chiyuki: raises $0.50 to $0.75
Suhoff76: folds 
Th3Fog: folds 
KeLevro0: folds 
Wilcox76607: calls $0.50
*** FLOP *** [9c Js 8c]
Wilcox76607: checks 
chiyuki: bets $1
Wilcox76607: folds 
Uncalled bet ($1) returned to chiyuki
chiyuki collected $1.53 from pot
chiyuki: doesn't show hand 
*** SUMMARY ***
Total pot $1.60 | Rake $0.07 
Board [9c Js 8c]
Seat 1: Th3Fog (button) folded before Flop (didn't bet)
Seat 2: KeLevro0 (small blind) folded before Flop
Seat 3: Wilcox76607 (big blind) folded on the Flop
Seat 4: taksist889 folded before Flop (didn't bet)
Seat 5: KrystalAA folded before Flop (didn't bet)
Seat 6: troms20 folded before Flop (didn't bet)
Seat 7: caro196661cv folded before Flop (didn't bet)
Seat 8: chiyuki collected ($1.53)
Seat 9: Suhoff76 folded before Flop (didn't bet)



PokerStars Zoom Hand #84299630574:  Hold'em No Limit ($0.10/$0.25) - 2012/08/05 14:32:29 JST [2012/08/05 1:32:29 ET]
Table 'Whirlpool' 9-max Seat #1 is the button
Seat 1: chiyuki ($41.43 in chips) 
Seat 2: stalkerec ($11.25 in chips) 
Seat 3: wtu1986 ($30.07 in chips) 
Seat 4: 4ydo yogurt ($10.46 in chips) 
Seat 5: ygoegoe ($25.56 in chips) 
Seat 6: Perstenev ($11.65 in chips) 
Seat 7: ChrisCDee ($25 in chips) 
Seat 8: Ladyteazer ($24.54 in chips) 
Seat 9: seula i ($28.88 in chips) 
stalkerec: posts small blind $0.10
wtu1986: posts big blind $0.25
*** HOLE CARDS ***
Dealt to chiyuki [2c 2h]
4ydo yogurt: folds 
ygoegoe: folds 
Perstenev: folds 
ChrisCDee: folds 
Ladyteazer: folds 
seula i: folds 
chiyuki: raises $0.50 to $0.75
stalkerec: folds 
wtu1986: folds 
Uncalled bet ($0.50) returned to chiyuki
chiyuki collected $0.60 from pot
chiyuki: doesn't show hand 
*** SUMMARY ***
Total pot $0.60 | Rake $0 
Seat 1: chiyuki (button) collected ($0.60)
Seat 2: stalkerec (small blind) folded before Flop
Seat 3: wtu1986 (big blind) folded before Flop
Seat 4: 4ydo yogurt folded before Flop (didn't bet)
Seat 5: ygoegoe folded before Flop (didn't bet)
Seat 6: Perstenev folded before Flop (didn't bet)
Seat 7: ChrisCDee folded before Flop (didn't bet)
Seat 8: Ladyteazer folded before Flop (didn't bet)
Seat 9: seula i folded before Flop (didn't bet)



PokerStars Zoom Hand #84299637447:  Hold'em No Limit ($0.10/$0.25) - 2012/08/05 14:32:58 JST [2012/08/05 1:32:58 ET]
Table 'Whirlpool' 9-max Seat #1 is the button
Seat 1: seula i ($34.91 in chips) 
Seat 2: Dejacob ($30.73 in chips) 
Seat 3: stalkerec ($11.15 in chips) 
Seat 4: troms20 ($25 in chips) 
Seat 5: roksmokndonk ($22.31 in chips) 
Seat 6: chiyuki ($41.78 in chips) 
Seat 7: Perstenev ($11.05 in chips) 
Seat 8: hl77777 ($12.15 in chips) 
Seat 9: KAKamiro ($20.69 in chips) 
Dejacob: posts small blind $0.10
stalkerec: posts big blind $0.25
*** HOLE CARDS ***
Dealt to chiyuki [Qs 4s]
troms20: folds 
roksmokndonk: folds 
chiyuki: folds 
Perstenev: folds 
hl77777: folds 
KAKamiro: folds 
seula i: folds 
Dejacob: folds 
Uncalled bet ($0.15) returned to stalkerec
stalkerec collected $0.20 from pot
stalkerec: doesn't show hand 
*** SUMMARY ***
Total pot $0.20 | Rake $0 
Seat 1: seula i (button) folded before Flop (didn't bet)
Seat 2: Dejacob (small blind) folded before Flop
Seat 3: stalkerec (big blind) collected ($0.20)
Seat 4: troms20 folded before Flop (didn't bet)
Seat 5: roksmokndonk folded before Flop (didn't bet)
Seat 6: chiyuki folded before Flop (didn't bet)
Seat 7: Perstenev folded before Flop (didn't bet)
Seat 8: hl77777 folded before Flop (didn't bet)
Seat 9: KAKamiro folded before Flop (didn't bet)



PokerStars Zoom Hand #84299650051:  Hold'em No Limit ($0.10/$0.25) - 2012/08/05 14:33:49 JST [2012/08/05 1:33:49 ET]
Table 'Whirlpool' 9-max Seat #1 is the button
Seat 1: Suhoff76 ($25 in chips) 
Seat 2: GovGus ($25 in chips) 
Seat 3: KeLevro0 ($10.15 in chips) 
Seat 4: XeriaX ($34.87 in chips) 
Seat 5: Noviekid ($87 in chips) 
Seat 6: phate-1up ($37.47 in chips) 
Seat 7: Ladyteazer ($25.91 in chips) 
Seat 8: caro196661cv ($32.74 in chips) 
Seat 9: chiyuki ($41.43 in chips) 
GovGus: posts small blind $0.10
KeLevro0: posts big blind $0.25
*** HOLE CARDS ***
Dealt to chiyuki [6s 8d]
XeriaX: folds 
Noviekid: folds 
phate-1up: folds 
Ladyteazer: folds 
caro196661cv: folds 
chiyuki: folds 
Suhoff76: raises $0.32 to $0.57
GovGus: folds 
KeLevro0: folds 
Uncalled bet ($0.32) returned to Suhoff76
Suhoff76 collected $0.60 from pot
Suhoff76: doesn't show hand 
*** SUMMARY ***
Total pot $0.60 | Rake $0 
Seat 1: Suhoff76 (button) collected ($0.60)
Seat 2: GovGus (small blind) folded before Flop
Seat 3: KeLevro0 (big blind) folded before Flop
Seat 4: XeriaX folded before Flop (didn't bet)
Seat 5: Noviekid folded before Flop (didn't bet)
Seat 6: phate-1up folded before Flop (didn't bet)
Seat 7: Ladyteazer folded before Flop (didn't bet)
Seat 8: caro196661cv folded before Flop (didn't bet)
Seat 9: chiyuki folded before Flop (didn't bet)



PokerStars Zoom Hand #84299649084:  Hold'em No Limit ($0.10/$0.25) - 2012/08/05 14:33:45 JST [2012/08/05 1:33:45 ET]
Table 'Whirlpool' 9-max Seat #1 is the button
Seat 1: laurentzu84 ($25.35 in chips) 
Seat 2: chiyuki ($41.53 in chips) 
Seat 3: peng2astic ($13.50 in chips) 
Seat 4: XeriaX ($34.87 in chips) 
Seat 5: BlOnDhOlIc ($82.09 in chips) 
Seat 6: Nerkit ($11.59 in chips) 
Seat 7: Th3Fog ($66.89 in chips) 
Seat 8: 1Karina1 ($25.35 in chips) 
Seat 9: znake77 ($4.80 in chips) 
chiyuki: posts small blind $0.10
peng2astic: posts big blind $0.25
*** HOLE CARDS ***
Dealt to chiyuki [Kc 3c]
XeriaX: folds 
BlOnDhOlIc: folds 
Nerkit: folds 
Th3Fog: folds 
1Karina1: folds 
znake77: raises $0.50 to $0.75
laurentzu84: folds 
chiyuki: folds 
peng2astic: folds 
Uncalled bet ($0.50) returned to znake77
znake77 collected $0.60 from pot
znake77: doesn't show hand 
*** SUMMARY ***
Total pot $0.60 | Rake $0 
Seat 1: laurentzu84 (button) folded before Flop (didn't bet)
Seat 2: chiyuki (small blind) folded before Flop
Seat 3: peng2astic (big blind) folded before Flop
Seat 4: XeriaX folded before Flop (didn't bet)
Seat 5: BlOnDhOlIc folded before Flop (didn't bet)
Seat 6: Nerkit folded before Flop (didn't bet)
Seat 7: Th3Fog folded before Flop (didn't bet)
Seat 8: 1Karina1 folded before Flop (didn't bet)
Seat 9: znake77 collected ($0.60)



PokerStars Zoom Hand #84299646864:  Hold'em No Limit ($0.10/$0.25) - 2012/08/05 14:33:36 JST [2012/08/05 1:33:36 ET]
Table 'Whirlpool' 9-max Seat #1 is the button
Seat 1: ChrisCDee ($38.52 in chips) 
Seat 2: stalkerec ($8.90 in chips) 
Seat 3: Dafleche ($19.31 in chips) 
Seat 4: ygoegoe ($25.52 in chips) 
Seat 5: BlOnDhOlIc ($84.70 in chips) 
Seat 6: KeLevro0 ($9.75 in chips) 
Seat 7: chiyuki ($41.53 in chips) 
Seat 8: johnbaco1209 ($30.96 in chips) 
Seat 9: troms20 ($48.80 in chips) 
stalkerec: posts small blind $0.10
Dafleche: posts big blind $0.25
*** HOLE CARDS ***
Dealt to chiyuki [7h 8h]
ygoegoe: folds 
BlOnDhOlIc: folds 
KeLevro0: folds 
chiyuki: folds 
johnbaco1209: folds 
troms20: raises $0.50 to $0.75
ChrisCDee: calls $0.75
stalkerec: calls $0.65
Dafleche: folds 
*** FLOP *** [2h Jh Js]
stalkerec: checks 
troms20: checks 
ChrisCDee: bets $1.43
stalkerec: folds 
troms20: folds 
Uncalled bet ($1.43) returned to ChrisCDee
ChrisCDee collected $2.39 from pot
ChrisCDee: doesn't show hand 
*** SUMMARY ***
Total pot $2.50 | Rake $0.11 
Board [2h Jh Js]
Seat 1: ChrisCDee (button) collected ($2.39)
Seat 2: stalkerec (small blind) folded on the Flop
Seat 3: Dafleche (big blind) folded before Flop
Seat 4: ygoegoe folded before Flop (didn't bet)
Seat 5: BlOnDhOlIc folded before Flop (didn't bet)
Seat 6: KeLevro0 folded before Flop (didn't bet)
Seat 7: chiyuki folded before Flop (didn't bet)
Seat 8: johnbaco1209 folded before Flop (didn't bet)
Seat 9: troms20 folded on the Flop



PokerStars Zoom Hand #84299645882:  Hold'em No Limit ($0.10/$0.25) - 2012/08/05 14:33:32 JST [2012/08/05 1:33:32 ET]
Table 'Whirlpool' 9-max Seat #1 is the button
Seat 1: Lasutchik ($66.44 in chips) 
Seat 2: Alvinpe85 ($49.26 in chips) 
Seat 3: Dejacob ($29.32 in chips) 
Seat 4: chiyuki ($41.53 in chips) 
Seat 5: seula i ($32.29 in chips) 
Seat 6: JLajoie ($25.90 in chips) 
Seat 7: KeLevro0 ($10.15 in chips) 
Seat 8: troms20 ($24.90 in chips) 
Seat 9: Walturrr ($24.65 in chips) 
Alvinpe85: posts small blind $0.10
Dejacob: posts big blind $0.25
*** HOLE CARDS ***
Dealt to chiyuki [6d Tc]
chiyuki: folds 
seula i: folds 
JLajoie: calls $0.25
KeLevro0: folds 
troms20: folds 
Walturrr: folds 
Lasutchik: folds 
Alvinpe85: folds 
Dejacob: checks 
*** FLOP *** [Js Qc Ts]
Dejacob: bets $0.50
JLajoie: raises $0.50 to $1
Dejacob: folds 
Uncalled bet ($0.50) returned to JLajoie
JLajoie collected $1.53 from pot
JLajoie: doesn't show hand 
*** SUMMARY ***
Total pot $1.60 | Rake $0.07 
Board [Js Qc Ts]
Seat 1: Lasutchik (button) folded before Flop (didn't bet)
Seat 2: Alvinpe85 (small blind) folded before Flop
Seat 3: Dejacob (big blind) folded on the Flop
Seat 4: chiyuki folded before Flop (didn't bet)
Seat 5: seula i folded before Flop (didn't bet)
Seat 6: JLajoie collected ($1.53)
Seat 7: KeLevro0 folded before Flop (didn't bet)
Seat 8: troms20 folded before Flop (didn't bet)
Seat 9: Walturrr folded before Flop (didn't bet)



PokerStars Zoom Hand #84299654543:  Hold'em No Limit ($0.10/$0.25) - 2012/08/05 14:34:08 JST [2012/08/05 1:34:08 ET]
Table 'Whirlpool' 9-max Seat #1 is the button
Seat 1: Suhoff76 ($28.62 in chips) 
Seat 2: Loholov ($15 in chips) 
Seat 3: roksmokndonk ($21.06 in chips) 
Seat 4: KeLevro0 ($9.90 in chips) 
Seat 5: mariuka1 ($7.38 in chips) 
Seat 6: chiyuki ($41.43 in chips) 
Seat 7: Noviekid ($87.10 in chips) 
Seat 8: Perstenev ($12.65 in chips) 
Seat 9: caro196661cv ($32.64 in chips) 
Loholov: posts small blind $0.10
roksmokndonk: posts big blind $0.25
*** HOLE CARDS ***
Dealt to chiyuki [8c Jc]
KeLevro0: folds 
mariuka1: folds 
chiyuki: folds 
Noviekid: folds 
Perstenev: folds 
caro196661cv: folds 
Suhoff76: folds 
Loholov: folds 
Uncalled bet ($0.15) returned to roksmokndonk
roksmokndonk collected $0.20 from pot
roksmokndonk: doesn't show hand 
*** SUMMARY ***
Total pot $0.20 | Rake $0 
Seat 1: Suhoff76 (button) folded before Flop (didn't bet)
Seat 2: Loholov (small blind) folded before Flop
Seat 3: roksmokndonk (big blind) collected ($0.20)
Seat 4: KeLevro0 folded before Flop (didn't bet)
Seat 5: mariuka1 folded before Flop (didn't bet)
Seat 6: chiyuki folded before Flop (didn't bet)
Seat 7: Noviekid folded before Flop (didn't bet)
Seat 8: Perstenev folded before Flop (didn't bet)
Seat 9: caro196661cv folded before Flop (didn't bet)



PokerStars Zoom Hand #84299638955:  Hold'em No Limit ($0.10/$0.25) - 2012/08/05 14:33:04 JST [2012/08/05 1:33:04 ET]
Table 'Whirlpool' 9-max Seat #1 is the button
Seat 1: KeLevro0 ($9.85 in chips) 
Seat 2: wtu1986 ($29.82 in chips) 
Seat 3: chiyuki ($41.78 in chips) 
Seat 4: Landybob ($41.56 in chips) 
Seat 5: softdesign ($76.18 in chips) 
Seat 6: Alvinpe85 ($64.88 in chips) 
Seat 7: fuguangps ($25.67 in chips) 
Seat 8: Paranoix1990 ($10.25 in chips) 
Seat 9: Perstenev ($11.05 in chips) 
wtu1986: posts small blind $0.10
chiyuki: posts big blind $0.25
*** HOLE CARDS ***
Dealt to chiyuki [4h 8s]
Landybob: folds 
softdesign: calls $0.25
Alvinpe85: folds 
fuguangps: folds 
Paranoix1990: folds 
Perstenev: folds 
KeLevro0: folds 
wtu1986: raises $0.75 to $1
chiyuki: folds 
softdesign: calls $0.75
*** FLOP *** [Th 2c 4d]
wtu1986: checks 
softdesign: checks 
*** TURN *** [Th 2c 4d] [Jc]
wtu1986: checks 
softdesign: checks 
*** RIVER *** [Th 2c 4d Jc] [5s]
wtu1986: checks 
softdesign: bets $2.25
wtu1986: folds 
Uncalled bet ($2.25) returned to softdesign
softdesign collected $2.15 from pot
softdesign: doesn't show hand 
*** SUMMARY ***
Total pot $2.25 | Rake $0.10 
Board [Th 2c 4d Jc 5s]
Seat 1: KeLevro0 (button) folded before Flop (didn't bet)
Seat 2: wtu1986 (small blind) folded on the River
Seat 3: chiyuki (big blind) folded before Flop
Seat 4: Landybob folded before Flop (didn't bet)
Seat 5: softdesign collected ($2.15)
Seat 6: Alvinpe85 folded before Flop (didn't bet)
Seat 7: fuguangps folded before Flop (didn't bet)
Seat 8: Paranoix1990 folded before Flop (didn't bet)
Seat 9: Perstenev folded before Flop (didn't bet)



PokerStars Zoom Hand #84299648354:  Hold'em No Limit ($0.10/$0.25) - 2012/08/05 14:33:42 JST [2012/08/05 1:33:42 ET]
Table 'Whirlpool' 9-max Seat #1 is the button
Seat 1: seula i ($32.29 in chips) 
Seat 2: Loholov ($19.98 in chips) 
Seat 3: Spartacus675 ($33.76 in chips) 
Seat 4: WARIBANA7777 ($16.88 in chips) 
Seat 5: RikkStroken ($28.51 in chips) 
Seat 6: 4ydo yogurt ($10.81 in chips) 
Seat 7: phate-1up ($37.47 in chips) 
Seat 8: chiyuki ($41.53 in chips) 
Seat 9: johnbaco1209 ($30.96 in chips) 
Loholov: posts small blind $0.10
Spartacus675: posts big blind $0.25
*** HOLE CARDS ***
Dealt to chiyuki [Th 9s]
WARIBANA7777: folds 
RikkStroken: folds 
4ydo yogurt: folds 
phate-1up: folds 
chiyuki: folds 
johnbaco1209: raises $0.25 to $0.50
seula i: folds 
Loholov: raises $1.25 to $1.75
Spartacus675: folds 
johnbaco1209: calls $1.25
*** FLOP *** [7d 3d 3c]
Loholov: bets $1.75
johnbaco1209: calls $1.75
*** TURN *** [7d 3d 3c] [5d]
Loholov: bets $4
johnbaco1209: raises $4 to $8
Loholov: calls $4
*** RIVER *** [7d 3d 3c 5d] [Ah]
Loholov: bets $8.48 and is all-in
johnbaco1209: calls $8.48
*** SHOW DOWN ***
Loholov: shows [7h Ac] (two pair, Aces and Sevens)
johnbaco1209: mucks hand 
Loholov collected $38.40 from pot
*** SUMMARY ***
Total pot $40.21 | Rake $1.81 
Board [7d 3d 3c 5d Ah]
Seat 1: seula i (button) folded before Flop (didn't bet)
Seat 2: Loholov (small blind) showed [7h Ac] and won ($38.40) with two pair, Aces and Sevens
Seat 3: Spartacus675 (big blind) folded before Flop
Seat 4: WARIBANA7777 folded before Flop (didn't bet)
Seat 5: RikkStroken folded before Flop (didn't bet)
Seat 6: 4ydo yogurt folded before Flop (didn't bet)
Seat 7: phate-1up folded before Flop (didn't bet)
Seat 8: chiyuki folded before Flop (didn't bet)
Seat 9: johnbaco1209 mucked [7c 5c]



PokerStars Zoom Hand #84299655509:  Hold'em No Limit ($0.10/$0.25) - 2012/08/05 14:34:12 JST [2012/08/05 1:34:12 ET]
Table 'Whirlpool' 9-max Seat #1 is the button
Seat 1: chiyuki ($41.43 in chips) 
Seat 2: Nerkit ($12.25 in chips) 
Seat 3: ll_LaMeR_ll ($81.05 in chips) 
Seat 4: Alvinpe85 ($49.16 in chips) 
Seat 5: KAKamiro ($22.30 in chips) 
Seat 6: Dejacob ($35.10 in chips) 
Seat 7: troms20 ($48.05 in chips) 
Seat 8: znake77 ($13.79 in chips) 
Seat 9: GovGus ($25 in chips) 
Nerkit: posts small blind $0.10
ll_LaMeR_ll: posts big blind $0.25
*** HOLE CARDS ***
Dealt to chiyuki [4d Js]
Alvinpe85: folds 
KAKamiro: folds 
Dejacob: folds 
troms20: folds 
znake77: folds 
GovGus: raises $0.75 to $1
chiyuki: folds 
Nerkit: folds 
ll_LaMeR_ll: folds 
Uncalled bet ($0.75) returned to GovGus
GovGus collected $0.60 from pot
GovGus: doesn't show hand 
*** SUMMARY ***
Total pot $0.60 | Rake $0 
Seat 1: chiyuki (button) folded before Flop (didn't bet)
Seat 2: Nerkit (small blind) folded before Flop
Seat 3: ll_LaMeR_ll (big blind) folded before Flop
Seat 4: Alvinpe85 folded before Flop (didn't bet)
Seat 5: KAKamiro folded before Flop (didn't bet)
Seat 6: Dejacob folded before Flop (didn't bet)
Seat 7: troms20 folded before Flop (didn't bet)
Seat 8: znake77 folded before Flop (didn't bet)
Seat 9: GovGus collected ($0.60)



PokerStars Zoom Hand #84299653553:  Hold'em No Limit ($0.10/$0.25) - 2012/08/05 14:34:04 JST [2012/08/05 1:34:04 ET]
Table 'Whirlpool' 9-max Seat #1 is the button
Seat 1: ll_LaMeR_ll ($81.05 in chips) 
Seat 2: hl77777 ($12.50 in chips) 
Seat 3: laurentzu84 ($25.35 in chips) 
Seat 4: chiyuki ($41.43 in chips) 
Seat 5: deadmoneykid ($25 in chips) 
Seat 6: RikkStroken ($36.38 in chips) 
Seat 7: fuguangps ($25 in chips) 
Seat 8: Loholov ($15 in chips) 
Seat 9: silvno31 ($27.79 in chips) 
hl77777: posts small blind $0.10
laurentzu84: posts big blind $0.25
*** HOLE CARDS ***
Dealt to chiyuki [4h 7h]
chiyuki: folds 
deadmoneykid: folds 
RikkStroken: folds 
fuguangps: folds 
Loholov: raises $0.50 to $0.75
silvno31: folds 
ll_LaMeR_ll: folds 
hl77777: folds 
laurentzu84: raises $1.25 to $2
Loholov: folds 
Uncalled bet ($1.25) returned to laurentzu84
laurentzu84 collected $1.60 from pot
laurentzu84: doesn't show hand 
*** SUMMARY ***
Total pot $1.60 | Rake $0 
Seat 1: ll_LaMeR_ll (button) folded before Flop (didn't bet)
Seat 2: hl77777 (small blind) folded before Flop
Seat 3: laurentzu84 (big blind) collected ($1.60)
Seat 4: chiyuki folded before Flop (didn't bet)
Seat 5: deadmoneykid folded before Flop (didn't bet)
Seat 6: RikkStroken folded before Flop (didn't bet)
Seat 7: fuguangps folded before Flop (didn't bet)
Seat 8: Loholov folded before Flop
Seat 9: silvno31 folded before Flop (didn't bet)



PokerStars Zoom Hand #84299652517:  Hold'em No Limit ($0.10/$0.25) - 2012/08/05 14:34:00 JST [2012/08/05 1:34:00 ET]
Table 'Whirlpool' 9-max Seat #1 is the button
Seat 1: Dafleche ($18.96 in chips) 
Seat 2: loca-loca888 ($47.18 in chips) 
Seat 3: Ladyteazer ($25.91 in chips) 
Seat 4: craden500 ($11.75 in chips) 
Seat 5: roksmokndonk ($21.06 in chips) 
Seat 6: KeLevro0 ($9.90 in chips) 
Seat 7: chiyuki ($41.43 in chips) 
Seat 8: puffy5533 ($24.94 in chips) 
Seat 9: Perstenev ($12.65 in chips) 
loca-loca888: posts small blind $0.10
Ladyteazer: posts big blind $0.25
*** HOLE CARDS ***
Dealt to chiyuki [Kd 6d]
craden500: calls $0.25
roksmokndonk: folds 
KeLevro0: folds 
chiyuki: folds 
puffy5533: folds 
Perstenev: folds 
Dafleche: raises $0.25 to $0.50
loca-loca888: folds 
Ladyteazer: folds 
craden500: calls $0.25
*** FLOP *** [7s 4s 8d]
craden500: checks 
Dafleche: bets $0.50
craden500: calls $0.50
*** TURN *** [7s 4s 8d] [Ac]
craden500: checks 
Dafleche: bets $1
craden500: folds 
Uncalled bet ($1) returned to Dafleche
Dafleche collected $2.24 from pot
Dafleche: doesn't show hand 
*** SUMMARY ***
Total pot $2.35 | Rake $0.11 
Board [7s 4s 8d Ac]
Seat 1: Dafleche (button) collected ($2.24)
Seat 2: loca-loca888 (small blind) folded before Flop
Seat 3: Ladyteazer (big blind) folded before Flop
Seat 4: craden500 folded on the Turn
Seat 5: roksmokndonk folded before Flop (didn't bet)
Seat 6: KeLevro0 folded before Flop (didn't bet)
Seat 7: chiyuki folded before Flop (didn't bet)
Seat 8: puffy5533 folded before Flop (didn't bet)
Seat 9: Perstenev folded before Flop (didn't bet)



PokerStars Zoom Hand #84299659006:  Hold'em No Limit ($0.10/$0.25) - 2012/08/05 14:34:26 JST [2012/08/05 1:34:26 ET]
Table 'Whirlpool' 9-max Seat #1 is the button
Seat 1: Landybob ($41.56 in chips) 
Seat 2: BlOnDhOlIc ($37.62 in chips) 
Seat 3: chiyuki ($41.43 in chips) 
Seat 4: 4thepeople ($26.42 in chips) 
Seat 5: wtu1986 ($25 in chips) 
Seat 6: Wilcox76607 ($13.16 in chips) 
Seat 7: seula i ($28.53 in chips) 
Seat 8: KeLevro0 ($10.10 in chips) 
Seat 9: DanielWhyte ($50.74 in chips) 
BlOnDhOlIc: posts small blind $0.10
chiyuki: posts big blind $0.25
*** HOLE CARDS ***
Dealt to chiyuki [8d Kc]
4thepeople: folds 
wtu1986: folds 
Wilcox76607: folds 
seula i: folds 
KeLevro0: folds 
DanielWhyte: folds 
Landybob: folds 
BlOnDhOlIc: raises $0.25 to $0.50
chiyuki: folds 
Uncalled bet ($0.25) returned to BlOnDhOlIc
BlOnDhOlIc collected $0.50 from pot
BlOnDhOlIc: doesn't show hand 
*** SUMMARY ***
Total pot $0.50 | Rake $0 
Seat 1: Landybob (button) folded before Flop (didn't bet)
Seat 2: BlOnDhOlIc (small blind) collected ($0.50)
Seat 3: chiyuki (big blind) folded before Flop
Seat 4: 4thepeople folded before Flop (didn't bet)
Seat 5: wtu1986 folded before Flop (didn't bet)
Seat 6: Wilcox76607 folded before Flop (didn't bet)
Seat 7: seula i folded before Flop (didn't bet)
Seat 8: KeLevro0 folded before Flop (didn't bet)
Seat 9: DanielWhyte folded before Flop (didn't bet)



PokerStars Zoom Hand #84299657751:  Hold'em No Limit ($0.10/$0.25) - 2012/08/05 14:34:21 JST [2012/08/05 1:34:21 ET]
Table 'Whirlpool' 9-max Seat #1 is the button
Seat 1: Nerkit ($12.15 in chips) 
Seat 2: RikkStroken ($15.31 in chips) 
Seat 3: fuguangps ($25 in chips) 
Seat 4: Suhoff76 ($25.35 in chips) 
Seat 5: chiyuki ($41.43 in chips) 
Seat 6: DanielWhyte ($50.74 in chips) 
Seat 7: BlOnDhOlIc ($84.45 in chips) 
Seat 8: Vahe50 ($26.91 in chips) 
Seat 9: phate-1up ($25 in chips) 
RikkStroken: posts small blind $0.10
fuguangps: posts big blind $0.25
*** HOLE CARDS ***
Dealt to chiyuki [2d Ks]
Suhoff76: folds 
chiyuki: folds 
DanielWhyte: folds 
BlOnDhOlIc: folds 
Vahe50: folds 
phate-1up: folds 
Nerkit: raises $0.37 to $0.62
RikkStroken: raises $1.63 to $2.25
fuguangps: folds 
Nerkit: folds 
Uncalled bet ($1.63) returned to RikkStroken
RikkStroken collected $1.49 from pot
RikkStroken: doesn't show hand 
*** SUMMARY ***
Total pot $1.49 | Rake $0 
Seat 1: Nerkit (button) folded before Flop
Seat 2: RikkStroken (small blind) collected ($1.49)
Seat 3: fuguangps (big blind) folded before Flop
Seat 4: Suhoff76 folded before Flop (didn't bet)
Seat 5: chiyuki folded before Flop (didn't bet)
Seat 6: DanielWhyte folded before Flop (didn't bet)
Seat 7: BlOnDhOlIc folded before Flop (didn't bet)
Seat 8: Vahe50 folded before Flop (didn't bet)
Seat 9: phate-1up folded before Flop (didn't bet)



PokerStars Zoom Hand #84299664223:  Hold'em No Limit ($0.10/$0.25) - 2012/08/05 14:34:47 JST [2012/08/05 1:34:47 ET]
Table 'Whirlpool' 9-max Seat #1 is the button
Seat 1: taksist889 ($17.64 in chips) 
Seat 2: igor*gemert ($24.75 in chips) 
Seat 3: Jene4kaBest ($13.70 in chips) 
Seat 4: chiyuki ($41.18 in chips) 
Seat 5: JLajoie ($26.33 in chips) 
Seat 6: ygoegoe ($25.02 in chips) 
Seat 7: KAKamiro ($22.20 in chips) 
Seat 8: Alvinpe85 ($63.12 in chips) 
Seat 9: Vahe50 ($26.81 in chips) 
igor*gemert: posts small blind $0.10
Jene4kaBest: posts big blind $0.25
*** HOLE CARDS ***
Dealt to chiyuki [7h 7s]
chiyuki: raises $0.50 to $0.75
JLajoie: folds 
ygoegoe: folds 
KAKamiro: folds 
Alvinpe85: folds 
Vahe50: folds 
taksist889: raises $1.25 to $2
igor*gemert: folds 
Jene4kaBest: folds 
chiyuki: folds 
Uncalled bet ($1.25) returned to taksist889
taksist889 collected $1.85 from pot
taksist889: doesn't show hand 
*** SUMMARY ***
Total pot $1.85 | Rake $0 
Seat 1: taksist889 (button) collected ($1.85)
Seat 2: igor*gemert (small blind) folded before Flop
Seat 3: Jene4kaBest (big blind) folded before Flop
Seat 4: chiyuki folded before Flop
Seat 5: JLajoie folded before Flop (didn't bet)
Seat 6: ygoegoe folded before Flop (didn't bet)
Seat 7: KAKamiro folded before Flop (didn't bet)
Seat 8: Alvinpe85 folded before Flop (didn't bet)
Seat 9: Vahe50 folded before Flop (didn't bet)



PokerStars Zoom Hand #84299671418:  Hold'em No Limit ($0.10/$0.25) - 2012/08/05 14:35:17 JST [2012/08/05 1:35:17 ET]
Table 'Whirlpool' 9-max Seat #1 is the button
Seat 1: troms20 ($47.80 in chips) 
Seat 2: chiyuki ($40.43 in chips) 
Seat 3: ll_LaMeR_ll ($81.05 in chips) 
Seat 4: Ellen1947 ($31.87 in chips) 
Seat 5: Suhoff76 ($30.75 in chips) 
Seat 6: Loholov ($15 in chips) 
Seat 7: hl77777 ($12.15 in chips) 
Seat 8: Dejacob ($29.39 in chips) 
Seat 9: Perstenev ($12.55 in chips) 
chiyuki: posts small blind $0.10
ll_LaMeR_ll: posts big blind $0.25
*** HOLE CARDS ***
Dealt to chiyuki [4c 4h]
Ellen1947: folds 
Suhoff76: folds 
Loholov: raises $0.50 to $0.75
hl77777: folds 
Dejacob: folds 
Perstenev: calls $0.75
troms20: folds 
chiyuki: calls $0.65
ll_LaMeR_ll said, "Tbl He JloXoJloB"
ll_LaMeR_ll said, "))"
ll_LaMeR_ll said, "Tbl CaJloX ))"
ll_LaMeR_ll: folds 
*** FLOP *** [4s As Qc]
chiyuki: checks 
Loholov: checks 
Perstenev: checks 
*** TURN *** [4s As Qc] [Kd]
chiyuki: bets $1.75
Loholov: folds 
Perstenev: folds 
Uncalled bet ($1.75) returned to chiyuki
chiyuki collected $2.39 from pot
chiyuki: doesn't show hand 
*** SUMMARY ***
Total pot $2.50 | Rake $0.11 
Board [4s As Qc Kd]
Seat 1: troms20 (button) folded before Flop (didn't bet)
Seat 2: chiyuki (small blind) collected ($2.39)
Seat 3: ll_LaMeR_ll (big blind) folded before Flop
Seat 4: Ellen1947 folded before Flop (didn't bet)
Seat 5: Suhoff76 folded before Flop (didn't bet)
Seat 6: Loholov folded on the Turn
Seat 7: hl77777 folded before Flop (didn't bet)
Seat 8: Dejacob folded before Flop (didn't bet)
Seat 9: Perstenev folded on the Turn



PokerStars Zoom Hand #84299689319:  Hold'em No Limit ($0.10/$0.25) - 2012/08/05 14:36:31 JST [2012/08/05 1:36:31 ET]
Table 'Whirlpool' 9-max Seat #1 is the button
Seat 1: bonethugs699 ($8.95 in chips) 
Seat 2: Ellen1947 ($31.62 in chips) 
Seat 3: Wilcox76607 ($14.30 in chips) 
Seat 4: ZhukOFFskI ($21.10 in chips) 
Seat 5: hl77777 ($17.05 in chips) 
Seat 6: KeLevro0 ($7.94 in chips) 
Seat 7: chiyuki ($42.07 in chips) 
Seat 8: fuguangps ($25.35 in chips) 
Seat 9: jacquelinewu ($25 in chips) 
Ellen1947: posts small blind $0.10
Wilcox76607: posts big blind $0.25
*** HOLE CARDS ***
Dealt to chiyuki [8s 5c]
ZhukOFFskI: folds 
hl77777: folds 
KeLevro0: folds 
chiyuki: folds 
fuguangps: folds 
jacquelinewu: folds 
bonethugs699: folds 
Ellen1947: folds 
Uncalled bet ($0.15) returned to Wilcox76607
Wilcox76607 collected $0.20 from pot
Wilcox76607: doesn't show hand 
*** SUMMARY ***
Total pot $0.20 | Rake $0 
Seat 1: bonethugs699 (button) folded before Flop (didn't bet)
Seat 2: Ellen1947 (small blind) folded before Flop
Seat 3: Wilcox76607 (big blind) collected ($0.20)
Seat 4: ZhukOFFskI folded before Flop (didn't bet)
Seat 5: hl77777 folded before Flop (didn't bet)
Seat 6: KeLevro0 folded before Flop (didn't bet)
Seat 7: chiyuki folded before Flop (didn't bet)
Seat 8: fuguangps folded before Flop (didn't bet)
Seat 9: jacquelinewu folded before Flop (didn't bet)



PokerStars Zoom Hand #84299692278:  Hold'em No Limit ($0.10/$0.25) - 2012/08/05 14:36:43 JST [2012/08/05 1:36:43 ET]
Table 'Whirlpool' 9-max Seat #1 is the button
Seat 1: chiyuki ($42.07 in chips) 
Seat 2: seula i ($33.81 in chips) 
Seat 3: Vahe50 ($15 in chips) 
Seat 4: znake77 ($7.02 in chips) 
Seat 5: troms20 ($26.55 in chips) 
Seat 6: ZhukOFFskI ($32.46 in chips) 
Seat 7: cr0lox ($25.12 in chips) 
Seat 8: mariuka1 ($7.03 in chips) 
Seat 9: hl77777 ($12.15 in chips) 
seula i: posts small blind $0.10
Vahe50: posts big blind $0.25
*** HOLE CARDS ***
Dealt to chiyuki [7d Qh]
znake77: folds 
troms20: folds 
ZhukOFFskI: raises $0.50 to $0.75
cr0lox: folds 
mariuka1: folds 
hl77777: folds 
chiyuki: folds 
seula i: folds 
Vahe50: folds 
Uncalled bet ($0.50) returned to ZhukOFFskI
ZhukOFFskI collected $0.60 from pot
ZhukOFFskI: doesn't show hand 
*** SUMMARY ***
Total pot $0.60 | Rake $0 
Seat 1: chiyuki (button) folded before Flop (didn't bet)
Seat 2: seula i (small blind) folded before Flop
Seat 3: Vahe50 (big blind) folded before Flop
Seat 4: znake77 folded before Flop (didn't bet)
Seat 5: troms20 folded before Flop (didn't bet)
Seat 6: ZhukOFFskI collected ($0.60)
Seat 7: cr0lox folded before Flop (didn't bet)
Seat 8: mariuka1 folded before Flop (didn't bet)
Seat 9: hl77777 folded before Flop (didn't bet)



PokerStars Zoom Hand #84299690839:  Hold'em No Limit ($0.10/$0.25) - 2012/08/05 14:36:37 JST [2012/08/05 1:36:37 ET]
Table 'Whirlpool' 9-max Seat #1 is the button
Seat 1: Ellen1947 ($31.52 in chips) 
Seat 2: Dan Royal ($43.08 in chips) 
Seat 3: DanielWhyte ($49.14 in chips) 
Seat 4: Loholov ($15 in chips) 
Seat 5: KeLevro0 ($9.08 in chips) 
Seat 6: Paranoix1990 ($13.24 in chips) 
Seat 7: Perstenev ($8.28 in chips) 
Seat 8: Dejacob ($34.38 in chips) 
Seat 9: chiyuki ($42.07 in chips) 
Dan Royal: posts small blind $0.10
DanielWhyte: posts big blind $0.25
*** HOLE CARDS ***
Dealt to chiyuki [Tc 6c]
Loholov: folds 
KeLevro0: folds 
Paranoix1990: calls $0.25
Perstenev: folds 
Dejacob: folds 
chiyuki: folds 
Ellen1947: folds 
Dan Royal: folds 
DanielWhyte: checks 
*** FLOP *** [Ad 4c 7s]
DanielWhyte: checks 
Paranoix1990: checks 
*** TURN *** [Ad 4c 7s] [8d]
DanielWhyte: checks 
Paranoix1990: bets $0.50
DanielWhyte: calls $0.50
*** RIVER *** [Ad 4c 7s 8d] [Jc]
DanielWhyte: checks 
Paranoix1990: checks 
*** SHOW DOWN ***
DanielWhyte: shows [2d 8h] (a pair of Eights)
Paranoix1990: mucks hand 
DanielWhyte collected $1.53 from pot
*** SUMMARY ***
Total pot $1.60 | Rake $0.07 
Board [Ad 4c 7s 8d Jc]
Seat 1: Ellen1947 (button) folded before Flop (didn't bet)
Seat 2: Dan Royal (small blind) folded before Flop
Seat 3: DanielWhyte (big blind) showed [2d 8h] and won ($1.53) with a pair of Eights
Seat 4: Loholov folded before Flop (didn't bet)
Seat 5: KeLevro0 folded before Flop (didn't bet)
Seat 6: Paranoix1990 mucked [Ks 9s]
Seat 7: Perstenev folded before Flop (didn't bet)
Seat 8: Dejacob folded before Flop (didn't bet)
Seat 9: chiyuki folded before Flop (didn't bet)



PokerStars Zoom Hand #84299694488:  Hold'em No Limit ($0.10/$0.25) - 2012/08/05 14:36:52 JST [2012/08/05 1:36:52 ET]
Table 'Whirlpool' 9-max Seat #1 is the button
Seat 1: peng2astic ($13.90 in chips) 
Seat 2: deadmoneykid ($29.04 in chips) 
Seat 3: Dan Royal ($42.98 in chips) 
Seat 4: Perstenev ($11.70 in chips) 
Seat 5: Walturrr ($25.57 in chips) 
Seat 6: phate-1up ($26.59 in chips) 
Seat 7: KrystalAA ($26.47 in chips) 
Seat 8: chiyuki ($42.07 in chips) 
Seat 9: KeLevro0 ($7.84 in chips) 
deadmoneykid: posts small blind $0.10
Dan Royal: posts big blind $0.25
*** HOLE CARDS ***
Dealt to chiyuki [6s 4h]
Perstenev: folds 
Walturrr: folds 
phate-1up: folds 
KrystalAA: folds 
chiyuki: folds 
KeLevro0: folds 
peng2astic: folds 
deadmoneykid: raises $0.50 to $0.75
Dan Royal: calls $0.50
*** FLOP *** [7s 5h 4s]
deadmoneykid: checks 
Dan Royal: bets $1
deadmoneykid: folds 
Uncalled bet ($1) returned to Dan Royal
Dan Royal collected $1.43 from pot
Dan Royal: doesn't show hand 
*** SUMMARY ***
Total pot $1.50 | Rake $0.07 
Board [7s 5h 4s]
Seat 1: peng2astic (button) folded before Flop (didn't bet)
Seat 2: deadmoneykid (small blind) folded on the Flop
Seat 3: Dan Royal (big blind) collected ($1.43)
Seat 4: Perstenev folded before Flop (didn't bet)
Seat 5: Walturrr folded before Flop (didn't bet)
Seat 6: phate-1up folded before Flop (didn't bet)
Seat 7: KrystalAA folded before Flop (didn't bet)
Seat 8: chiyuki folded before Flop (didn't bet)
Seat 9: KeLevro0 folded before Flop (didn't bet)



PokerStars Zoom Hand #84299696016:  Hold'em No Limit ($0.10/$0.25) - 2012/08/05 14:36:58 JST [2012/08/05 1:36:58 ET]
Table 'Whirlpool' 9-max Seat #1 is the button
Seat 1: wildy29 ($10.71 in chips) 
Seat 2: Nerkit ($11.52 in chips) 
Seat 3: chiyuki ($42.07 in chips) 
Seat 4: mariuka1 ($7.03 in chips) 
Seat 5: Perstenev ($10.37 in chips) 
Seat 6: el pore 5 ($17.52 in chips) 
Seat 7: hl77777 ($12.15 in chips) 
Seat 8: phate-1up ($36.51 in chips) 
Seat 9: Dejacob ($36.62 in chips) 
Nerkit: posts small blind $0.10
chiyuki: posts big blind $0.25
*** HOLE CARDS ***
Dealt to chiyuki [2s Js]
mariuka1: folds 
Perstenev: folds 
el pore 5: folds 
hl77777: folds 
phate-1up: folds 
Dejacob: raises $0.50 to $0.75
wildy29: folds 
Nerkit: folds 
chiyuki: folds 
Uncalled bet ($0.50) returned to Dejacob
Dejacob collected $0.60 from pot
Dejacob: doesn't show hand 
*** SUMMARY ***
Total pot $0.60 | Rake $0 
Seat 1: wildy29 (button) folded before Flop (didn't bet)
Seat 2: Nerkit (small blind) folded before Flop
Seat 3: chiyuki (big blind) folded before Flop
Seat 4: mariuka1 folded before Flop (didn't bet)
Seat 5: Perstenev folded before Flop (didn't bet)
Seat 6: el pore 5 folded before Flop (didn't bet)
Seat 7: hl77777 folded before Flop (didn't bet)
Seat 8: phate-1up folded before Flop (didn't bet)
Seat 9: Dejacob collected ($0.60)



PokerStars Zoom Hand #84299702967:  Hold'em No Limit ($0.10/$0.25) - 2012/08/05 14:37:26 JST [2012/08/05 1:37:26 ET]
Table 'Whirlpool' 9-max Seat #1 is the button
Seat 1: Suhoff76 ($28.05 in chips) 
Seat 2: led52 ($23.97 in chips) 
Seat 3: igor*gemert ($24.62 in chips) 
Seat 4: BlOnDhOlIc ($39.36 in chips) 
Seat 5: Yogi707 ($16.72 in chips) 
Seat 6: chiyuki ($41.82 in chips) 
Seat 7: GovGus ($26.48 in chips) 
Seat 8: Jene4kaBest ($13 in chips) 
Seat 9: Perstenev ($11.80 in chips) 
led52: posts small blind $0.10
igor*gemert: posts big blind $0.25
*** HOLE CARDS ***
Dealt to chiyuki [Js 2s]
BlOnDhOlIc: folds 
Yogi707: folds 
chiyuki: folds 
GovGus: folds 
Jene4kaBest: folds 
Perstenev: raises $0.50 to $0.75
Suhoff76: folds 
led52: folds 
igor*gemert: folds 
Uncalled bet ($0.50) returned to Perstenev
Perstenev collected $0.60 from pot
Perstenev: doesn't show hand 
*** SUMMARY ***
Total pot $0.60 | Rake $0 
Seat 1: Suhoff76 (button) folded before Flop (didn't bet)
Seat 2: led52 (small blind) folded before Flop
Seat 3: igor*gemert (big blind) folded before Flop
Seat 4: BlOnDhOlIc folded before Flop (didn't bet)
Seat 5: Yogi707 folded before Flop (didn't bet)
Seat 6: chiyuki folded before Flop (didn't bet)
Seat 7: GovGus folded before Flop (didn't bet)
Seat 8: Jene4kaBest folded before Flop (didn't bet)
Seat 9: Perstenev collected ($0.60)



PokerStars Zoom Hand #84299708636:  Hold'em No Limit ($0.10/$0.25) - 2012/08/05 14:37:50 JST [2012/08/05 1:37:50 ET]
Table 'Whirlpool' 9-max Seat #1 is the button
Seat 1: 1Karina1 ($25 in chips) 
Seat 2: Perstenev ($17.31 in chips) 
Seat 3: KrystalAA ($15.26 in chips) 
Seat 4: GovGus ($25 in chips) 
Seat 5: chiyuki ($41.82 in chips) 
Seat 6: Nerkit ($16.13 in chips) 
Seat 7: 4thepeople ($26.61 in chips) 
Seat 8: Landybob ($40.21 in chips) 
Seat 9: troms20 ($27.39 in chips) 
Perstenev: posts small blind $0.10
KrystalAA: posts big blind $0.25
*** HOLE CARDS ***
Dealt to chiyuki [Ah 5c]
GovGus: folds 
chiyuki: folds 
Nerkit: raises $0.50 to $0.75
4thepeople: folds 
Landybob: folds 
troms20: folds 
1Karina1: folds 
Perstenev: folds 
KrystalAA: folds 
Uncalled bet ($0.50) returned to Nerkit
Nerkit collected $0.60 from pot
Nerkit: doesn't show hand 
*** SUMMARY ***
Total pot $0.60 | Rake $0 
Seat 1: 1Karina1 (button) folded before Flop (didn't bet)
Seat 2: Perstenev (small blind) folded before Flop
Seat 3: KrystalAA (big blind) folded before Flop
Seat 4: GovGus folded before Flop (didn't bet)
Seat 5: chiyuki folded before Flop (didn't bet)
Seat 6: Nerkit collected ($0.60)
Seat 7: 4thepeople folded before Flop (didn't bet)
Seat 8: Landybob folded before Flop (didn't bet)
Seat 9: troms20 folded before Flop (didn't bet)



PokerStars Zoom Hand #84299709670:  Hold'em No Limit ($0.10/$0.25) - 2012/08/05 14:37:54 JST [2012/08/05 1:37:54 ET]
Table 'Whirlpool' 9-max Seat #1 is the button
Seat 1: Walturrr ($24.90 in chips) 
Seat 2: fuguangps ($25.10 in chips) 
Seat 3: ChrisCDee ($26.85 in chips) 
Seat 4: chiyuki ($41.82 in chips) 
Seat 5: Dejacob ($37.45 in chips) 
Seat 6: Ellen1947 ($31.27 in chips) 
Seat 7: KeLevro0 ($7.65 in chips) 
Seat 8: RikkStroken ($30.78 in chips) 
Seat 9: Suhoff76 ($26.76 in chips) 
fuguangps: posts small blind $0.10
ChrisCDee: posts big blind $0.25
*** HOLE CARDS ***
Dealt to chiyuki [8h 2c]
chiyuki: folds 
Dejacob: folds 
Ellen1947: folds 
KeLevro0: folds 
RikkStroken: raises $0.25 to $0.50
Suhoff76: folds 
Walturrr: calls $0.50
fuguangps: folds 
ChrisCDee: folds 
*** FLOP *** [Kd Js 2s]
RikkStroken: checks 
Walturrr: bets $0.75
RikkStroken: folds 
Uncalled bet ($0.75) returned to Walturrr
Walturrr collected $1.29 from pot
Walturrr: doesn't show hand 
*** SUMMARY ***
Total pot $1.35 | Rake $0.06 
Board [Kd Js 2s]
Seat 1: Walturrr (button) collected ($1.29)
Seat 2: fuguangps (small blind) folded before Flop
Seat 3: ChrisCDee (big blind) folded before Flop
Seat 4: chiyuki folded before Flop (didn't bet)
Seat 5: Dejacob folded before Flop (didn't bet)
Seat 6: Ellen1947 folded before Flop (didn't bet)
Seat 7: KeLevro0 folded before Flop (didn't bet)
Seat 8: RikkStroken folded on the Flop
Seat 9: Suhoff76 folded before Flop (didn't bet)



PokerStars Zoom Hand #84299710430:  Hold'em No Limit ($0.10/$0.25) - 2012/08/05 14:37:59 JST [2012/08/05 1:37:59 ET]
Table 'Whirlpool' 9-max Seat #1 is the button
Seat 1: BlOnDhOlIc ($39.36 in chips) 
Seat 2: 1Karina1 ($25 in chips) 
Seat 3: dushvan ($44.79 in chips) 
Seat 4: GovGus ($26.83 in chips) 
Seat 5: roksmokndonk ($23.54 in chips) 
Seat 6: troms20 ($63.46 in chips) 
Seat 7: led52 ($12.15 in chips) 
Seat 8: Perstenev ($12.15 in chips) 
Seat 9: chiyuki ($41.82 in chips) 
1Karina1: posts small blind $0.10
dushvan: posts big blind $0.25
*** HOLE CARDS ***
Dealt to chiyuki [Ah Kc]
GovGus: raises $0.50 to $0.75
roksmokndonk: folds 
troms20: folds 
led52: folds 
Perstenev: folds 
chiyuki: raises $1.50 to $2.25
BlOnDhOlIc: folds 
1Karina1: folds 
dushvan: folds 
GovGus: calls $1.50
*** FLOP *** [2d 4c 7c]
GovGus: checks 
chiyuki: bets $2.50
GovGus: calls $2.50
*** TURN *** [2d 4c 7c] [Qs]
GovGus: checks 
chiyuki: bets $4.70
GovGus: calls $4.70
*** RIVER *** [2d 4c 7c Qs] [5d]
GovGus: checks 
chiyuki: checks 
*** SHOW DOWN ***
GovGus: shows [8d 8s] (a pair of Eights)
chiyuki: mucks hand 
GovGus collected $18.38 from pot
*** SUMMARY ***
Total pot $19.25 | Rake $0.87 
Board [2d 4c 7c Qs 5d]
Seat 1: BlOnDhOlIc (button) folded before Flop (didn't bet)
Seat 2: 1Karina1 (small blind) folded before Flop
Seat 3: dushvan (big blind) folded before Flop
Seat 4: GovGus showed [8d 8s] and won ($18.38) with a pair of Eights
Seat 5: roksmokndonk folded before Flop (didn't bet)
Seat 6: troms20 folded before Flop (didn't bet)
Seat 7: led52 folded before Flop (didn't bet)
Seat 8: Perstenev folded before Flop (didn't bet)
Seat 9: chiyuki mucked [Ah Kc]



PokerStars Zoom Hand #84299726448:  Hold'em No Limit ($0.10/$0.25) - 2012/08/05 14:39:03 JST [2012/08/05 1:39:03 ET]
Table 'Whirlpool' 9-max Seat #1 is the button
Seat 1: troms20 ($26.42 in chips) 
Seat 2: chiyuki ($32.37 in chips) 
Seat 3: KeLevro0 ($9.16 in chips) 
Seat 4: phate-1up ($40.46 in chips) 
Seat 5: loca-loca888 ($49.11 in chips) 
Seat 6: igor*gemert ($23.52 in chips) 
Seat 7: fuguangps ($26.68 in chips) 
Seat 8: Suhoff76 ($26.41 in chips) 
Seat 9: WARIBANA7777 ($24.22 in chips) 
chiyuki: posts small blind $0.10
KeLevro0: posts big blind $0.25
*** HOLE CARDS ***
Dealt to chiyuki [6c Jd]
phate-1up: folds 
loca-loca888: calls $0.25
igor*gemert: folds 
fuguangps: folds 
Suhoff76: folds 
WARIBANA7777: folds 
troms20: raises $0.75 to $1
chiyuki: folds 
KeLevro0: folds 
loca-loca888: folds 
Uncalled bet ($0.75) returned to troms20
troms20 collected $0.85 from pot
troms20: doesn't show hand 
*** SUMMARY ***
Total pot $0.85 | Rake $0 
Seat 1: troms20 (button) collected ($0.85)
Seat 2: chiyuki (small blind) folded before Flop
Seat 3: KeLevro0 (big blind) folded before Flop
Seat 4: phate-1up folded before Flop (didn't bet)
Seat 5: loca-loca888 folded before Flop
Seat 6: igor*gemert folded before Flop (didn't bet)
Seat 7: fuguangps folded before Flop (didn't bet)
Seat 8: Suhoff76 folded before Flop (didn't bet)
Seat 9: WARIBANA7777 folded before Flop (didn't bet)



PokerStars Zoom Hand #84299727866:  Hold'em No Limit ($0.10/$0.25) - 2012/08/05 14:39:09 JST [2012/08/05 1:39:09 ET]
Table 'Whirlpool' 9-max Seat #1 is the button
Seat 1: Dejacob ($33.28 in chips) 
Seat 2: snejokCoxx ($18.45 in chips) 
Seat 3: Suhoff76 ($26.41 in chips) 
Seat 4: softdesign ($78.69 in chips) 
Seat 5: Paranoix1990 ($8.21 in chips) 
Seat 6: WARIBANA7777 ($24.22 in chips) 
Seat 7: chiyuki ($32.27 in chips) 
Seat 8: Alvinpe85 ($64.14 in chips) 
Seat 9: jacquelinewu ($25 in chips) 
snejokCoxx: posts small blind $0.10
Suhoff76: posts big blind $0.25
*** HOLE CARDS ***
Dealt to chiyuki [Ks 9h]
softdesign: folds 
Paranoix1990: raises $0.25 to $0.50
WARIBANA7777: folds 
chiyuki: folds 
Alvinpe85: folds 
jacquelinewu: folds 
Dejacob: folds 
snejokCoxx: folds 
Suhoff76: folds 
Uncalled bet ($0.25) returned to Paranoix1990
Paranoix1990 collected $0.60 from pot
Paranoix1990: doesn't show hand 
*** SUMMARY ***
Total pot $0.60 | Rake $0 
Seat 1: Dejacob (button) folded before Flop (didn't bet)
Seat 2: snejokCoxx (small blind) folded before Flop
Seat 3: Suhoff76 (big blind) folded before Flop
Seat 4: softdesign folded before Flop (didn't bet)
Seat 5: Paranoix1990 collected ($0.60)
Seat 6: WARIBANA7777 folded before Flop (didn't bet)
Seat 7: chiyuki folded before Flop (didn't bet)
Seat 8: Alvinpe85 folded before Flop (didn't bet)
Seat 9: jacquelinewu folded before Flop (didn't bet)



PokerStars Zoom Hand #84299730079:  Hold'em No Limit ($0.10/$0.25) - 2012/08/05 14:39:18 JST [2012/08/05 1:39:18 ET]
Table 'Whirlpool' 9-max Seat #1 is the button
Seat 1: ZhukOFFskI ($29.63 in chips) 
Seat 2: Dejacob ($33.28 in chips) 
Seat 3: Jene4kaBest ($11.90 in chips) 
Seat 4: cofla tito ($10.12 in chips) 
Seat 5: ll_LaMeR_ll ($77.81 in chips) 
Seat 6: Cyanidoff ($25 in chips) 
Seat 7: gunbowler ($140.20 in chips) 
Seat 8: chiyuki ($32.27 in chips) 
Seat 9: peng2astic ($9.20 in chips) 
Dejacob: posts small blind $0.10
Jene4kaBest: posts big blind $0.25
*** HOLE CARDS ***
Dealt to chiyuki [2d 9d]
cofla tito: folds 
ll_LaMeR_ll: folds 
Cyanidoff: folds 
gunbowler: folds 
chiyuki: folds 
peng2astic: folds 
ZhukOFFskI: folds 
Dejacob: folds 
Uncalled bet ($0.15) returned to Jene4kaBest
Jene4kaBest collected $0.20 from pot
Jene4kaBest: doesn't show hand 
*** SUMMARY ***
Total pot $0.20 | Rake $0 
Seat 1: ZhukOFFskI (button) folded before Flop (didn't bet)
Seat 2: Dejacob (small blind) folded before Flop
Seat 3: Jene4kaBest (big blind) collected ($0.20)
Seat 4: cofla tito folded before Flop (didn't bet)
Seat 5: ll_LaMeR_ll folded before Flop (didn't bet)
Seat 6: Cyanidoff folded before Flop (didn't bet)
Seat 7: gunbowler folded before Flop (didn't bet)
Seat 8: chiyuki folded before Flop (didn't bet)
Seat 9: peng2astic folded before Flop (didn't bet)



PokerStars Zoom Hand #84299731514:  Hold'em No Limit ($0.10/$0.25) - 2012/08/05 14:39:24 JST [2012/08/05 1:39:24 ET]
Table 'Whirlpool' 9-max Seat #1 is the button
Seat 1: jacquelinewu ($25.79 in chips) 
Seat 2: 4thepeople ($28.26 in chips) 
Seat 3: deepakmbh ($25 in chips) 
Seat 4: troms20 ($27.02 in chips) 
Seat 5: Vahe50 ($15 in chips) 
Seat 6: chiyuki ($32.27 in chips) 
Seat 7: phate-1up ($56.69 in chips) 
Seat 8: snejokCoxx ($12.15 in chips) 
Seat 9: Dan Royal ($48.15 in chips) 
4thepeople: posts small blind $0.10
deepakmbh: posts big blind $0.25
*** HOLE CARDS ***
Dealt to chiyuki [4h Jd]
troms20: folds 
Vahe50: folds 
chiyuki: folds 
phate-1up: raises $0.50 to $0.75
snejokCoxx: folds 
Dan Royal: folds 
jacquelinewu: folds 
4thepeople: folds 
deepakmbh: folds 
Uncalled bet ($0.50) returned to phate-1up
phate-1up collected $0.60 from pot
phate-1up: doesn't show hand 
*** SUMMARY ***
Total pot $0.60 | Rake $0 
Seat 1: jacquelinewu (button) folded before Flop (didn't bet)
Seat 2: 4thepeople (small blind) folded before Flop
Seat 3: deepakmbh (big blind) folded before Flop
Seat 4: troms20 folded before Flop (didn't bet)
Seat 5: Vahe50 folded before Flop (didn't bet)
Seat 6: chiyuki folded before Flop (didn't bet)
Seat 7: phate-1up collected ($0.60)
Seat 8: snejokCoxx folded before Flop (didn't bet)
Seat 9: Dan Royal folded before Flop (didn't bet)



PokerStars Zoom Hand #84299733769:  Hold'em No Limit ($0.10/$0.25) - 2012/08/05 14:39:33 JST [2012/08/05 1:39:33 ET]
Table 'Whirlpool' 9-max Seat #1 is the button
Seat 1: chiyuki ($32.27 in chips) 
Seat 2: Cyanidoff ($25 in chips) 
Seat 3: laurentzu84 ($25 in chips) 
Seat 4: dushvan ($44.04 in chips) 
Seat 5: a_tasmanian ($24.13 in chips) 
Seat 6: 4ydo yogurt ($20.77 in chips) 
Seat 7: Jene4kaBest ($12 in chips) 
Seat 8: snejokCoxx ($18.35 in chips) 
Seat 9: hirozo ($30.42 in chips) 
Cyanidoff: posts small blind $0.10
laurentzu84: posts big blind $0.25
*** HOLE CARDS ***
Dealt to chiyuki [9s 7d]
dushvan: raises $0.50 to $0.75
a_tasmanian: folds 
4ydo yogurt: folds 
Jene4kaBest: folds 
snejokCoxx: folds 
hirozo: folds 
chiyuki: folds 
Cyanidoff: folds 
laurentzu84: calls $0.50
*** FLOP *** [Ts 8d 8c]
laurentzu84: checks 
dushvan: bets $1
laurentzu84: calls $1
*** TURN *** [Ts 8d 8c] [6s]
laurentzu84: bets $2.25
dushvan: folds 
Uncalled bet ($2.25) returned to laurentzu84
laurentzu84 collected $3.44 from pot
laurentzu84: doesn't show hand 
*** SUMMARY ***
Total pot $3.60 | Rake $0.16 
Board [Ts 8d 8c 6s]
Seat 1: chiyuki (button) folded before Flop (didn't bet)
Seat 2: Cyanidoff (small blind) folded before Flop
Seat 3: laurentzu84 (big blind) collected ($3.44)
Seat 4: dushvan folded on the Turn
Seat 5: a_tasmanian folded before Flop (didn't bet)
Seat 6: 4ydo yogurt folded before Flop (didn't bet)
Seat 7: Jene4kaBest folded before Flop (didn't bet)
Seat 8: snejokCoxx folded before Flop (didn't bet)
Seat 9: hirozo folded before Flop (didn't bet)



PokerStars Zoom Hand #84299735004:  Hold'em No Limit ($0.10/$0.25) - 2012/08/05 14:39:38 JST [2012/08/05 1:39:38 ET]
Table 'Whirlpool' 9-max Seat #1 is the button
Seat 1: DanielWhyte ($48.77 in chips) 
Seat 2: Jene4kaBest ($12 in chips) 
Seat 3: chiyuki ($32.27 in chips) 
Seat 4: Walturrr ($28.26 in chips) 
Seat 5: snejokCoxx ($11.65 in chips) 
Seat 6: a_tasmanian ($24.13 in chips) 
Seat 7: ZhukOFFskI ($34.09 in chips) 
Seat 8: debstar27 ($24.15 in chips) 
Seat 9: Dejacob ($36.70 in chips) 
Jene4kaBest: posts small blind $0.10
chiyuki: posts big blind $0.25
*** HOLE CARDS ***
Dealt to chiyuki [6h Ks]
Walturrr: folds 
snejokCoxx: raises $0.50 to $0.75
a_tasmanian: folds 
ZhukOFFskI: folds 
debstar27: folds 
Dejacob: folds 
DanielWhyte: calls $0.75
Jene4kaBest: folds 
chiyuki: folds 
*** FLOP *** [6d As 5c]
snejokCoxx: bets $0.95
DanielWhyte: folds 
Uncalled bet ($0.95) returned to snejokCoxx
snejokCoxx collected $1.77 from pot
snejokCoxx: doesn't show hand 
*** SUMMARY ***
Total pot $1.85 | Rake $0.08 
Board [6d As 5c]
Seat 1: DanielWhyte (button) folded on the Flop
Seat 2: Jene4kaBest (small blind) folded before Flop
Seat 3: chiyuki (big blind) folded before Flop
Seat 4: Walturrr folded before Flop (didn't bet)
Seat 5: snejokCoxx collected ($1.77)
Seat 6: a_tasmanian folded before Flop (didn't bet)
Seat 7: ZhukOFFskI folded before Flop (didn't bet)
Seat 8: debstar27 folded before Flop (didn't bet)
Seat 9: Dejacob folded before Flop (didn't bet)



PokerStars Zoom Hand #84299732291:  Hold'em No Limit ($0.10/$0.25) - 2012/08/05 14:39:27 JST [2012/08/05 1:39:27 ET]
Table 'Whirlpool' 9-max Seat #1 is the button
Seat 1: Alvinpe85 ($64.14 in chips) 
Seat 2: led52 ($11.90 in chips) 
Seat 3: loca-loca888 ($48.86 in chips) 
Seat 4: chiyuki ($32.27 in chips) 
Seat 5: ChrisCDee ($73.72 in chips) 
Seat 6: 1Karina1 ($29.13 in chips) 
Seat 7: KeLevro0 ($7.20 in chips) 
Seat 8: Dejacob ($27.18 in chips) 
Seat 9: Walturrr ($26.47 in chips) 
led52: posts small blind $0.10
loca-loca888: posts big blind $0.25
*** HOLE CARDS ***
Dealt to chiyuki [6s 4c]
chiyuki: folds 
ChrisCDee: folds 
1Karina1: folds 
KeLevro0: folds 
Dejacob: folds 
Walturrr: raises $0.47 to $0.72
Alvinpe85: folds 
led52: folds 
loca-loca888: calls $0.47
*** FLOP *** [5s 2c Qh]
loca-loca888: bets $1
Walturrr: folds 
Uncalled bet ($1) returned to loca-loca888
loca-loca888 collected $1.47 from pot
loca-loca888: doesn't show hand 
*** SUMMARY ***
Total pot $1.54 | Rake $0.07 
Board [5s 2c Qh]
Seat 1: Alvinpe85 (button) folded before Flop (didn't bet)
Seat 2: led52 (small blind) folded before Flop
Seat 3: loca-loca888 (big blind) collected ($1.47)
Seat 4: chiyuki folded before Flop (didn't bet)
Seat 5: ChrisCDee folded before Flop (didn't bet)
Seat 6: 1Karina1 folded before Flop (didn't bet)
Seat 7: KeLevro0 folded before Flop (didn't bet)
Seat 8: Dejacob folded before Flop (didn't bet)
Seat 9: Walturrr folded on the Flop



PokerStars Zoom Hand #84299745100:  Hold'em No Limit ($0.10/$0.25) - 2012/08/05 14:40:20 JST [2012/08/05 1:40:20 ET]
Table 'Whirlpool' 9-max Seat #1 is the button
Seat 1: ZhukOFFskI ($34.09 in chips) 
Seat 2: troms20 ($26.77 in chips) 
Seat 3: mid22 ($16.13 in chips) 
Seat 4: chiyuki ($32.02 in chips) 
Seat 5: 1Karina1 ($25.10 in chips) 
Seat 6: BlOnDhOlIc ($37.80 in chips) 
Seat 7: Dafleche ($16.57 in chips) 
Seat 8: Lars111 ($14.65 in chips) 
Seat 9: Vahe50 ($15.25 in chips) 
troms20: posts small blind $0.10
mid22: posts big blind $0.25
*** HOLE CARDS ***
Dealt to chiyuki [7c 5c]
chiyuki: folds 
1Karina1: folds 
BlOnDhOlIc: folds 
Dafleche: folds 
Lars111: raises $1 to $1.25
Vahe50: folds 
ZhukOFFskI: folds 
troms20: folds 
mid22: folds 
Uncalled bet ($1) returned to Lars111
Lars111 collected $0.60 from pot
Lars111: doesn't show hand 
*** SUMMARY ***
Total pot $0.60 | Rake $0 
Seat 1: ZhukOFFskI (button) folded before Flop (didn't bet)
Seat 2: troms20 (small blind) folded before Flop
Seat 3: mid22 (big blind) folded before Flop
Seat 4: chiyuki folded before Flop (didn't bet)
Seat 5: 1Karina1 folded before Flop (didn't bet)
Seat 6: BlOnDhOlIc folded before Flop (didn't bet)
Seat 7: Dafleche folded before Flop (didn't bet)
Seat 8: Lars111 collected ($0.60)
Seat 9: Vahe50 folded before Flop (didn't bet)



PokerStars Zoom Hand #84299747336:  Hold'em No Limit ($0.10/$0.25) - 2012/08/05 14:40:29 JST [2012/08/05 1:40:29 ET]
Table 'Whirlpool' 9-max Seat #1 is the button
Seat 1: Walturrr ($27.91 in chips) 
Seat 2: Dan Royal ($48.75 in chips) 
Seat 3: silvno31 ($31.07 in chips) 
Seat 4: ZhukOFFskI ($29.98 in chips) 
Seat 5: GovGus ($26.36 in chips) 
Seat 6: Wilcox76607 ($15.03 in chips) 
Seat 7: jacquelinewu ($25.70 in chips) 
Seat 8: fuguangps ($25.78 in chips) 
Seat 9: chiyuki ($32.02 in chips) 
Dan Royal: posts small blind $0.10
silvno31: posts big blind $0.25
*** HOLE CARDS ***
Dealt to chiyuki [3h 3d]
ZhukOFFskI: folds 
GovGus: folds 
Wilcox76607: raises $0.50 to $0.75
jacquelinewu: folds 
fuguangps: folds 
chiyuki: calls $0.75
Walturrr: folds 
Dan Royal: folds 
silvno31: folds 
*** FLOP *** [Td Jc 7s]
Wilcox76607: checks 
chiyuki: checks 
*** TURN *** [Td Jc 7s] [Kd]
Wilcox76607: checks 
chiyuki: checks 
*** RIVER *** [Td Jc 7s Kd] [4h]
Wilcox76607: bets $1
chiyuki: folds 
Uncalled bet ($1) returned to Wilcox76607
Wilcox76607 collected $1.77 from pot
Wilcox76607: doesn't show hand 
*** SUMMARY ***
Total pot $1.85 | Rake $0.08 
Board [Td Jc 7s Kd 4h]
Seat 1: Walturrr (button) folded before Flop (didn't bet)
Seat 2: Dan Royal (small blind) folded before Flop
Seat 3: silvno31 (big blind) folded before Flop
Seat 4: ZhukOFFskI folded before Flop (didn't bet)
Seat 5: GovGus folded before Flop (didn't bet)
Seat 6: Wilcox76607 collected ($1.77)
Seat 7: jacquelinewu folded before Flop (didn't bet)
Seat 8: fuguangps folded before Flop (didn't bet)
Seat 9: chiyuki folded on the River



PokerStars Zoom Hand #84299759586:  Hold'em No Limit ($0.10/$0.25) - 2012/08/05 14:41:20 JST [2012/08/05 1:41:20 ET]
Table 'Whirlpool' 9-max Seat #1 is the button
Seat 1: chiyuki ($31.17 in chips) 
Seat 2: fuguangps ($26.70 in chips) 
Seat 3: deepakmbh ($16.67 in chips) 
Seat 4: cofla tito ($14.12 in chips) 
Seat 5: snejokCoxx ($11.80 in chips) 
Seat 6: PillZ86 ($15.44 in chips) 
Seat 7: phate-1up ($34.26 in chips) 
Seat 8: led52 ($12.66 in chips) 
Seat 9: BlOnDhOlIc ($78.81 in chips) 
fuguangps: posts small blind $0.10
deepakmbh: posts big blind $0.25
*** HOLE CARDS ***
Dealt to chiyuki [6d 9d]
cofla tito: folds 
snejokCoxx: folds 
PillZ86: folds 
phate-1up: folds 
led52: folds 
BlOnDhOlIc: folds 
chiyuki: folds 
fuguangps: raises $0.50 to $0.75
deepakmbh: folds 
Uncalled bet ($0.50) returned to fuguangps
fuguangps collected $0.50 from pot
fuguangps: doesn't show hand 
*** SUMMARY ***
Total pot $0.50 | Rake $0 
Seat 1: chiyuki (button) folded before Flop (didn't bet)
Seat 2: fuguangps (small blind) collected ($0.50)
Seat 3: deepakmbh (big blind) folded before Flop
Seat 4: cofla tito folded before Flop (didn't bet)
Seat 5: snejokCoxx folded before Flop (didn't bet)
Seat 6: PillZ86 folded before Flop (didn't bet)
Seat 7: phate-1up folded before Flop (didn't bet)
Seat 8: led52 folded before Flop (didn't bet)
Seat 9: BlOnDhOlIc folded before Flop (didn't bet)



PokerStars Zoom Hand #84299761802:  Hold'em No Limit ($0.10/$0.25) - 2012/08/05 14:41:29 JST [2012/08/05 1:41:29 ET]
Table 'Whirlpool' 9-max Seat #1 is the button
Seat 1: hl77777 ($13.35 in chips) 
Seat 2: phate-1up ($34.26 in chips) 
Seat 3: chiyuki ($31.17 in chips) 
Seat 4: Landybob ($39.51 in chips) 
Seat 5: Phaedrus...3 ($25 in chips) 
Seat 6: Alvinpe85 ($62.79 in chips) 
Seat 7: Loholov ($27.10 in chips) 
Seat 8: 4thepeople ($27.14 in chips) 
Seat 9: Nerkit ($9.97 in chips) 
phate-1up: posts small blind $0.10
chiyuki: posts big blind $0.25
*** HOLE CARDS ***
Dealt to chiyuki [Tc Qh]
Landybob: folds 
Phaedrus...3: folds 
Alvinpe85: folds 
Loholov: folds 
4thepeople: folds 
Nerkit: folds 
hl77777: folds 
phate-1up: folds 
Uncalled bet ($0.15) returned to chiyuki
chiyuki collected $0.20 from pot
chiyuki: doesn't show hand 
*** SUMMARY ***
Total pot $0.20 | Rake $0 
Seat 1: hl77777 (button) folded before Flop (didn't bet)
Seat 2: phate-1up (small blind) folded before Flop
Seat 3: chiyuki (big blind) collected ($0.20)
Seat 4: Landybob folded before Flop (didn't bet)
Seat 5: Phaedrus...3 folded before Flop (didn't bet)
Seat 6: Alvinpe85 folded before Flop (didn't bet)
Seat 7: Loholov folded before Flop (didn't bet)
Seat 8: 4thepeople folded before Flop (didn't bet)
Seat 9: Nerkit folded before Flop (didn't bet)



PokerStars Zoom Hand #84299757399:  Hold'em No Limit ($0.10/$0.25) - 2012/08/05 14:41:11 JST [2012/08/05 1:41:11 ET]
Table 'Whirlpool' 9-max Seat #1 is the button
Seat 1: BlOnDhOlIc ($78.81 in chips) 
Seat 2: chiyuki ($31.27 in chips) 
Seat 3: Dejacob ($33.88 in chips) 
Seat 4: snejokCoxx ($16.65 in chips) 
Seat 5: 4ydo yogurt ($21.72 in chips) 
Seat 6: 1Karina1 ($28.78 in chips) 
Seat 7: KAKamiro ($23.60 in chips) 
Seat 8: Ladyteazer ($27.67 in chips) 
Seat 9: hirozo ($25 in chips) 
chiyuki: posts small blind $0.10
Dejacob: posts big blind $0.25
*** HOLE CARDS ***
Dealt to chiyuki [Js 2d]
snejokCoxx: folds 
4ydo yogurt: folds 
1Karina1: folds 
KAKamiro: calls $0.25
Ladyteazer: folds 
hirozo: folds 
BlOnDhOlIc: folds 
chiyuki: folds 
Dejacob: checks 
*** FLOP *** [6h Kd Jc]
Dejacob: checks 
KAKamiro: checks 
*** TURN *** [6h Kd Jc] [9s]
Dejacob: checks 
KAKamiro: bets $0.75
Dejacob: folds 
Uncalled bet ($0.75) returned to KAKamiro
KAKamiro collected $0.57 from pot
KAKamiro: doesn't show hand 
*** SUMMARY ***
Total pot $0.60 | Rake $0.03 
Board [6h Kd Jc 9s]
Seat 1: BlOnDhOlIc (button) folded before Flop (didn't bet)
Seat 2: chiyuki (small blind) folded before Flop
Seat 3: Dejacob (big blind) folded on the Turn
Seat 4: snejokCoxx folded before Flop (didn't bet)
Seat 5: 4ydo yogurt folded before Flop (didn't bet)
Seat 6: 1Karina1 folded before Flop (didn't bet)
Seat 7: KAKamiro collected ($0.57)
Seat 8: Ladyteazer folded before Flop (didn't bet)
Seat 9: hirozo folded before Flop (didn't bet)



PokerStars Zoom Hand #84299758639:  Hold'em No Limit ($0.10/$0.25) - 2012/08/05 14:41:16 JST [2012/08/05 1:41:16 ET]
Table 'Whirlpool' 9-max Seat #1 is the button
Seat 1: Nerkit ($13.49 in chips) 
Seat 2: hirozo ($25 in chips) 
Seat 3: 4ydo yogurt ($21.72 in chips) 
Seat 4: phate-1up ($34.26 in chips) 
Seat 5: deepakmbh ($16.67 in chips) 
Seat 6: Loholov ($15.85 in chips) 
Seat 7: Dan Royal ($48.75 in chips) 
Seat 8: chiyuki ($31.17 in chips) 
Seat 9: 4thepeople ($27.14 in chips) 
hirozo: posts small blind $0.10
4ydo yogurt: posts big blind $0.25
*** HOLE CARDS ***
Dealt to chiyuki [As 5s]
phate-1up: folds 
deepakmbh: folds 
Loholov: folds 
Dan Royal: calls $0.25
chiyuki: folds 
4thepeople: folds 
Nerkit: raises $0.75 to $1
hirozo: folds 
4ydo yogurt: folds 
Dan Royal: calls $0.75
*** FLOP *** [Ts 2c 9d]
Dan Royal: checks 
Nerkit: checks 
*** TURN *** [Ts 2c 9d] [3s]
Dan Royal: bets $1.50
Nerkit: calls $1.50
*** RIVER *** [Ts 2c 9d 3s] [Ah]
Dan Royal: checks 
Nerkit: checks 
*** SHOW DOWN ***
Dan Royal: shows [4s 4h] (a pair of Fours)
Nerkit: shows [Jd Jc] (a pair of Jacks)
Nerkit collected $5.11 from pot
*** SUMMARY ***
Total pot $5.35 | Rake $0.24 
Board [Ts 2c 9d 3s Ah]
Seat 1: Nerkit (button) showed [Jd Jc] and won ($5.11) with a pair of Jacks
Seat 2: hirozo (small blind) folded before Flop
Seat 3: 4ydo yogurt (big blind) folded before Flop
Seat 4: phate-1up folded before Flop (didn't bet)
Seat 5: deepakmbh folded before Flop (didn't bet)
Seat 6: Loholov folded before Flop (didn't bet)
Seat 7: Dan Royal showed [4s 4h] and lost with a pair of Fours
Seat 8: chiyuki folded before Flop (didn't bet)
Seat 9: 4thepeople folded before Flop (didn't bet)



PokerStars Zoom Hand #84299760820:  Hold'em No Limit ($0.10/$0.25) - 2012/08/05 14:41:25 JST [2012/08/05 1:41:25 ET]
Table 'Whirlpool' 9-max Seat #1 is the button
Seat 1: cofla tito ($14.12 in chips) 
Seat 2: hl77777 ($13.45 in chips) 
Seat 3: Lars111 ($16.23 in chips) 
Seat 4: Landybob ($39.51 in chips) 
Seat 5: a_tasmanian ($23.43 in chips) 
Seat 6: jacquelinewu ($27.67 in chips) 
Seat 7: chiyuki ($31.17 in chips) 
Seat 8: ChrisCDee ($28.70 in chips) 
Seat 9: silvno31 ($31.07 in chips) 
hl77777: posts small blind $0.10
Lars111: posts big blind $0.25
*** HOLE CARDS ***
Dealt to chiyuki [6c Jc]
Landybob: folds 
a_tasmanian: folds 
jacquelinewu: folds 
chiyuki: folds 
ChrisCDee: raises $0.50 to $0.75
silvno31: folds 
cofla tito: folds 
hl77777: folds 
Lars111: calls $0.50
*** FLOP *** [Kc 4d Ks]
Lars111: checks 
ChrisCDee: bets $0.91
Lars111: folds 
Uncalled bet ($0.91) returned to ChrisCDee
ChrisCDee collected $1.53 from pot
ChrisCDee: doesn't show hand 
*** SUMMARY ***
Total pot $1.60 | Rake $0.07 
Board [Kc 4d Ks]
Seat 1: cofla tito (button) folded before Flop (didn't bet)
Seat 2: hl77777 (small blind) folded before Flop
Seat 3: Lars111 (big blind) folded on the Flop
Seat 4: Landybob folded before Flop (didn't bet)
Seat 5: a_tasmanian folded before Flop (didn't bet)
Seat 6: jacquelinewu folded before Flop (didn't bet)
Seat 7: chiyuki folded before Flop (didn't bet)
Seat 8: ChrisCDee collected ($1.53)
Seat 9: silvno31 folded before Flop (didn't bet)



PokerStars Zoom Hand #84299743106:  Hold'em No Limit ($0.10/$0.25) - 2012/08/05 14:40:12 JST [2012/08/05 1:40:12 ET]
Table 'Whirlpool' 9-max Seat #1 is the button
Seat 1: Nerkit ($10.32 in chips) 
Seat 2: laurentzu84 ($26.69 in chips) 
Seat 3: WARIBANA7777 ($24.22 in chips) 
Seat 4: hirozo ($39.38 in chips) 
Seat 5: chiyuki ($32.02 in chips) 
Seat 6: KrystalAA ($2.89 in chips) 
Seat 7: Ellen1947 ($26 in chips) 
Seat 8: Landybob ($39.86 in chips) 
Seat 9: Alvinpe85 ($49.18 in chips) 
laurentzu84: posts small blind $0.10
WARIBANA7777: posts big blind $0.25
*** HOLE CARDS ***
Dealt to chiyuki [Th 6d]
hirozo: folds 
chiyuki: folds 
KrystalAA: folds 
Ellen1947: folds 
Landybob: folds 
Alvinpe85: raises $0.37 to $0.62
Nerkit: folds 
laurentzu84: calls $0.52
WARIBANA7777: folds 
*** FLOP *** [Jh 4c 4d]
laurentzu84: checks 
Alvinpe85: bets $0.85
laurentzu84: raises $1.15 to $2
Alvinpe85: calls $1.15
*** TURN *** [Jh 4c 4d] [3c]
laurentzu84: bets $3
Alvinpe85: calls $3
*** RIVER *** [Jh 4c 4d 3c] [2s]
laurentzu84: bets $7.25
Alvinpe85: folds 
Uncalled bet ($7.25) returned to laurentzu84
laurentzu84 collected $10.97 from pot
laurentzu84: doesn't show hand 
*** SUMMARY ***
Total pot $11.49 | Rake $0.52 
Board [Jh 4c 4d 3c 2s]
Seat 1: Nerkit (button) folded before Flop (didn't bet)
Seat 2: laurentzu84 (small blind) collected ($10.97)
Seat 3: WARIBANA7777 (big blind) folded before Flop
Seat 4: hirozo folded before Flop (didn't bet)
Seat 5: chiyuki folded before Flop (didn't bet)
Seat 6: KrystalAA folded before Flop (didn't bet)
Seat 7: Ellen1947 folded before Flop (didn't bet)
Seat 8: Landybob folded before Flop (didn't bet)
Seat 9: Alvinpe85 folded on the River



PokerStars Zoom Hand #84299766510:  Hold'em No Limit ($0.10/$0.25) - 2012/08/05 14:41:48 JST [2012/08/05 1:41:48 ET]
Table 'Whirlpool' 9-max Seat #1 is the button
Seat 1: Gichboy ($12.24 in chips) 
Seat 2: Dejacob ($33.63 in chips) 
Seat 3: seula i ($33.71 in chips) 
Seat 4: ll_LaMeR_ll ($78.83 in chips) 
Seat 5: KimPa39 ($23.94 in chips) 
Seat 6: chiyuki ($31.27 in chips) 
Seat 7: DanielWhyte ($47.17 in chips) 
Seat 8: Perstenev ($12.51 in chips) 
Seat 9: BlOnDhOlIc ($87.29 in chips) 
Dejacob: posts small blind $0.10
seula i: posts big blind $0.25
*** HOLE CARDS ***
Dealt to chiyuki [4c Ad]
ll_LaMeR_ll: folds 
KimPa39: folds 
chiyuki: folds 
DanielWhyte: folds 
Perstenev: folds 
BlOnDhOlIc: folds 
Gichboy has timed out
Gichboy: folds 
Dejacob: raises $0.50 to $0.75
seula i: folds 
Uncalled bet ($0.50) returned to Dejacob
Dejacob collected $0.50 from pot
Dejacob: doesn't show hand 
*** SUMMARY ***
Total pot $0.50 | Rake $0 
Seat 1: Gichboy (button) folded before Flop (didn't bet)
Seat 2: Dejacob (small blind) collected ($0.50)
Seat 3: seula i (big blind) folded before Flop
Seat 4: ll_LaMeR_ll folded before Flop (didn't bet)
Seat 5: KimPa39 folded before Flop (didn't bet)
Seat 6: chiyuki folded before Flop (didn't bet)
Seat 7: DanielWhyte folded before Flop (didn't bet)
Seat 8: Perstenev folded before Flop (didn't bet)
Seat 9: BlOnDhOlIc folded before Flop (didn't bet)



PokerStars Zoom Hand #84299767784:  Hold'em No Limit ($0.10/$0.25) - 2012/08/05 14:41:53 JST [2012/08/05 1:41:53 ET]
Table 'Whirlpool' 9-max Seat #1 is the button
Seat 1: DanielWhyte ($47.17 in chips) 
Seat 2: Dejacob ($25 in chips) 
Seat 3: jacquelinewu ($25 in chips) 
Seat 4: Perstenev ($13.71 in chips) 
Seat 5: KeLevro0 ($12.59 in chips) 
Seat 6: WARIBANA7777 ($23.12 in chips) 
Seat 7: Yogi707 ($13.29 in chips) 
Seat 8: KimPa39 ($23.94 in chips) 
Seat 9: chiyuki ($31.27 in chips) 
Dejacob: posts small blind $0.10
jacquelinewu: posts big blind $0.25
*** HOLE CARDS ***
Dealt to chiyuki [Th Td]
Perstenev: folds 
KeLevro0: raises $0.42 to $0.67
WARIBANA7777: folds 
Yogi707: folds 
KimPa39: folds 
chiyuki: calls $0.67
DanielWhyte: calls $0.67
Dejacob: folds 
jacquelinewu: folds 
*** FLOP *** [Kd 5d 6d]
KeLevro0: checks 
chiyuki: checks 
DanielWhyte: checks 
*** TURN *** [Kd 5d 6d] [Ad]
KeLevro0: checks 
chiyuki: bets $1.25
DanielWhyte: calls $1.25
KeLevro0: folds 
*** RIVER *** [Kd 5d 6d Ad] [4s]
chiyuki: checks 
DanielWhyte: bets $6.75
chiyuki: folds 
Uncalled bet ($6.75) returned to DanielWhyte
DanielWhyte collected $4.64 from pot
DanielWhyte: doesn't show hand 
*** SUMMARY ***
Total pot $4.86 | Rake $0.22 
Board [Kd 5d 6d Ad 4s]
Seat 1: DanielWhyte (button) collected ($4.64)
Seat 2: Dejacob (small blind) folded before Flop
Seat 3: jacquelinewu (big blind) folded before Flop
Seat 4: Perstenev folded before Flop (didn't bet)
Seat 5: KeLevro0 folded on the Turn
Seat 6: WARIBANA7777 folded before Flop (didn't bet)
Seat 7: Yogi707 folded before Flop (didn't bet)
Seat 8: KimPa39 folded before Flop (didn't bet)
Seat 9: chiyuki folded on the River



PokerStars Zoom Hand #84299786404:  Hold'em No Limit ($0.10/$0.25) - 2012/08/05 14:43:10 JST [2012/08/05 1:43:10 ET]
Table 'Whirlpool' 9-max Seat #1 is the button
Seat 1: BlOnDhOlIc ($78.31 in chips) 
Seat 2: Sal y Limon1 ($24.75 in chips) 
Seat 3: Cyanidoff ($25 in chips) 
Seat 4: jacquelinewu ($27.32 in chips) 
Seat 5: Walturrr ($24.68 in chips) 
Seat 6: chiyuki ($29.35 in chips) 
Seat 7: ZhukOFFskI ($33.84 in chips) 
Seat 8: igor*gemert ($25.95 in chips) 
Seat 9: led52 ($12.42 in chips) 
Sal y Limon1: posts small blind $0.10
Cyanidoff: posts big blind $0.25
*** HOLE CARDS ***
Dealt to chiyuki [Qd 2c]
jacquelinewu: folds 
Walturrr: folds 
chiyuki: folds 
ZhukOFFskI: folds 
igor*gemert: folds 
led52: raises $0.50 to $0.75
BlOnDhOlIc: folds 
Sal y Limon1: raises $1.75 to $2.50
Cyanidoff: folds 
led52: folds 
Uncalled bet ($1.75) returned to Sal y Limon1
Sal y Limon1 collected $1.75 from pot
Sal y Limon1: doesn't show hand 
*** SUMMARY ***
Total pot $1.75 | Rake $0 
Seat 1: BlOnDhOlIc (button) folded before Flop (didn't bet)
Seat 2: Sal y Limon1 (small blind) collected ($1.75)
Seat 3: Cyanidoff (big blind) folded before Flop
Seat 4: jacquelinewu folded before Flop (didn't bet)
Seat 5: Walturrr folded before Flop (didn't bet)
Seat 6: chiyuki folded before Flop (didn't bet)
Seat 7: ZhukOFFskI folded before Flop (didn't bet)
Seat 8: igor*gemert folded before Flop (didn't bet)
Seat 9: led52 folded before Flop



PokerStars Zoom Hand #84299791118:  Hold'em No Limit ($0.10/$0.25) - 2012/08/05 14:43:29 JST [2012/08/05 1:43:29 ET]
Table 'Whirlpool' 9-max Seat #1 is the button
Seat 1: seula i ($25.53 in chips) 
Seat 2: Cyanidoff ($25 in chips) 
Seat 3: DanielWhyte ($49.89 in chips) 
Seat 4: Alvinpe85 ($63.24 in chips) 
Seat 5: 1Karina1 ($25 in chips) 
Seat 6: 4thepeople ($21.87 in chips) 
Seat 7: chiyuki ($29.25 in chips) 
Seat 8: fuguangps ($51.04 in chips) 
Seat 9: KeLevro0 ($12.35 in chips) 
Cyanidoff: posts small blind $0.10
DanielWhyte: posts big blind $0.25
*** HOLE CARDS ***
Dealt to chiyuki [Qd 5c]
Alvinpe85: folds 
1Karina1: folds 
4thepeople: folds 
chiyuki: folds 
fuguangps: folds 
KeLevro0: raises $0.42 to $0.67
seula i: folds 
Cyanidoff: folds 
DanielWhyte: folds 
Uncalled bet ($0.42) returned to KeLevro0
KeLevro0 collected $0.60 from pot
KeLevro0: doesn't show hand 
*** SUMMARY ***
Total pot $0.60 | Rake $0 
Seat 1: seula i (button) folded before Flop (didn't bet)
Seat 2: Cyanidoff (small blind) folded before Flop
Seat 3: DanielWhyte (big blind) folded before Flop
Seat 4: Alvinpe85 folded before Flop (didn't bet)
Seat 5: 1Karina1 folded before Flop (didn't bet)
Seat 6: 4thepeople folded before Flop (didn't bet)
Seat 7: chiyuki folded before Flop (didn't bet)
Seat 8: fuguangps folded before Flop (didn't bet)
Seat 9: KeLevro0 collected ($0.60)



PokerStars Zoom Hand #84299789869:  Hold'em No Limit ($0.10/$0.25) - 2012/08/05 14:43:24 JST [2012/08/05 1:43:24 ET]
Table 'Whirlpool' 9-max Seat #1 is the button
Seat 1: Cyanidoff ($25 in chips) 
Seat 2: Nerkit ($11.75 in chips) 
Seat 3: BlOnDhOlIc ($78.31 in chips) 
Seat 4: ZhukOFFskI ($34.41 in chips) 
Seat 5: fuguangps ($51.04 in chips) 
Seat 6: jacquelinewu ($25 in chips) 
Seat 7: hirozo ($40.57 in chips) 
Seat 8: chiyuki ($29.25 in chips) 
Seat 9: DanielWhyte ($49.89 in chips) 
Nerkit: posts small blind $0.10
BlOnDhOlIc: posts big blind $0.25
*** HOLE CARDS ***
Dealt to chiyuki [3s Qs]
ZhukOFFskI: folds 
fuguangps: folds 
jacquelinewu: folds 
hirozo: folds 
chiyuki: folds 
DanielWhyte: folds 
Cyanidoff: folds 
Nerkit: folds 
Uncalled bet ($0.15) returned to BlOnDhOlIc
BlOnDhOlIc collected $0.20 from pot
BlOnDhOlIc: doesn't show hand 
*** SUMMARY ***
Total pot $0.20 | Rake $0 
Seat 1: Cyanidoff (button) folded before Flop (didn't bet)
Seat 2: Nerkit (small blind) folded before Flop
Seat 3: BlOnDhOlIc (big blind) collected ($0.20)
Seat 4: ZhukOFFskI folded before Flop (didn't bet)
Seat 5: fuguangps folded before Flop (didn't bet)
Seat 6: jacquelinewu folded before Flop (didn't bet)
Seat 7: hirozo folded before Flop (didn't bet)
Seat 8: chiyuki folded before Flop (didn't bet)
Seat 9: DanielWhyte folded before Flop (didn't bet)



PokerStars Zoom Hand #84299787898:  Hold'em No Limit ($0.10/$0.25) - 2012/08/05 14:43:16 JST [2012/08/05 1:43:16 ET]
Table 'Whirlpool' 9-max Seat #1 is the button
Seat 1: Perstenev ($11.16 in chips) 
Seat 2: chiyuki ($29.35 in chips) 
Seat 3: Nerkit ($12.91 in chips) 
Seat 4: Nagus3x ($19.45 in chips) 
Seat 5: wildy29 ($13.21 in chips) 
Seat 6: Dafleche ($12.57 in chips) 
Seat 7: KAKamiro ($28.35 in chips) 
Seat 8: Jene4kaBest ($10.45 in chips) 
Seat 9: seula i ($25.53 in chips) 
chiyuki: posts small blind $0.10
Nerkit: posts big blind $0.25
*** HOLE CARDS ***
Dealt to chiyuki [Js 6c]
Nagus3x: raises $0.55 to $0.80
wildy29: folds 
Dafleche: folds 
KAKamiro: folds 
Jene4kaBest: calls $0.80
seula i: folds 
Perstenev: folds 
chiyuki: folds 
Nerkit: folds 
*** FLOP *** [2c 9c Kc]
Nagus3x: bets $1
Jene4kaBest: raises $1 to $2
Nagus3x: raises $7.40 to $9.40
Jene4kaBest: folds 
Uncalled bet ($7.40) returned to Nagus3x
Nagus3x collected $5.68 from pot
Nagus3x: doesn't show hand 
*** SUMMARY ***
Total pot $5.95 | Rake $0.27 
Board [2c 9c Kc]
Seat 1: Perstenev (button) folded before Flop (didn't bet)
Seat 2: chiyuki (small blind) folded before Flop
Seat 3: Nerkit (big blind) folded before Flop
Seat 4: Nagus3x collected ($5.68)
Seat 5: wildy29 folded before Flop (didn't bet)
Seat 6: Dafleche folded before Flop (didn't bet)
Seat 7: KAKamiro folded before Flop (didn't bet)
Seat 8: Jene4kaBest folded on the Flop
Seat 9: seula i folded before Flop (didn't bet)



PokerStars Zoom Hand #84299784940:  Hold'em No Limit ($0.10/$0.25) - 2012/08/05 14:43:04 JST [2012/08/05 1:43:04 ET]
Table 'Whirlpool' 9-max Seat #1 is the button
Seat 1: igor*gemert ($24.97 in chips) 
Seat 2: Walturrr ($27.46 in chips) 
Seat 3: bigred1102 ($21.59 in chips) 
Seat 4: fuguangps ($51.29 in chips) 
Seat 5: chiyuki ($29.35 in chips) 
Seat 6: silvno31 ($29.97 in chips) 
Seat 7: 1Karina1 ($25 in chips) 
Seat 8: hirozo ($34.33 in chips) 
Seat 9: tribunpdm ($27.63 in chips) 
Walturrr: posts small blind $0.10
bigred1102: posts big blind $0.25
*** HOLE CARDS ***
Dealt to chiyuki [Kh 5s]
fuguangps: folds 
chiyuki: folds 
silvno31: raises $0.50 to $0.75
1Karina1: folds 
hirozo: folds 
tribunpdm: folds 
igor*gemert: calls $0.75
Walturrr: calls $0.65
bigred1102: calls $0.50
*** FLOP *** [4c 4s 4h]
Walturrr: checks 
bigred1102: checks 
silvno31: bets $1
igor*gemert: calls $1
Walturrr: folds 
bigred1102: folds 
*** TURN *** [4c 4s 4h] [Kc]
silvno31: bets $3.75
igor*gemert: folds 
Uncalled bet ($3.75) returned to silvno31
silvno31 collected $4.78 from pot
silvno31: doesn't show hand 
*** SUMMARY ***
Total pot $5 | Rake $0.22 
Board [4c 4s 4h Kc]
Seat 1: igor*gemert (button) folded on the Turn
Seat 2: Walturrr (small blind) folded on the Flop
Seat 3: bigred1102 (big blind) folded on the Flop
Seat 4: fuguangps folded before Flop (didn't bet)
Seat 5: chiyuki folded before Flop (didn't bet)
Seat 6: silvno31 collected ($4.78)
Seat 7: 1Karina1 folded before Flop (didn't bet)
Seat 8: hirozo folded before Flop (didn't bet)
Seat 9: tribunpdm folded before Flop (didn't bet)



PokerStars Zoom Hand #84299792846:  Hold'em No Limit ($0.10/$0.25) - 2012/08/05 14:43:37 JST [2012/08/05 1:43:37 ET]
Table 'Whirlpool' 9-max Seat #1 is the button
Seat 1: fuguangps ($51.04 in chips) 
Seat 2: loca-loca888 ($51.21 in chips) 
Seat 3: 4thepeople ($21.87 in chips) 
Seat 4: Ellen1947 ($31.89 in chips) 
Seat 5: chiyuki ($29.25 in chips) 
Seat 6: KrystalAA ($23.74 in chips) 
Seat 7: phate-1up ($57.04 in chips) 
Seat 8: Cyanidoff ($25 in chips) 
Seat 9: 1Karina1 ($29.66 in chips) 
loca-loca888: posts small blind $0.10
4thepeople: posts big blind $0.25
*** HOLE CARDS ***
Dealt to chiyuki [Ah Jh]
Ellen1947: folds 
chiyuki: raises $0.50 to $0.75
KrystalAA: folds 
phate-1up: folds 
Cyanidoff: folds 
1Karina1: folds 
fuguangps: folds 
loca-loca888: calls $0.65
4thepeople: calls $0.50
*** FLOP *** [8s Qs 4d]
loca-loca888: checks 
4thepeople: bets $0.25
chiyuki: calls $0.25
loca-loca888: calls $0.25
*** TURN *** [8s Qs 4d] [Th]
loca-loca888: bets $1.51
4thepeople: folds 
chiyuki: calls $1.51
*** RIVER *** [8s Qs 4d Th] [8h]
loca-loca888: bets $3.50
chiyuki: folds 
Uncalled bet ($3.50) returned to loca-loca888
loca-loca888 collected $5.75 from pot
loca-loca888: doesn't show hand 
*** SUMMARY ***
Total pot $6.02 | Rake $0.27 
Board [8s Qs 4d Th 8h]
Seat 1: fuguangps (button) folded before Flop (didn't bet)
Seat 2: loca-loca888 (small blind) collected ($5.75)
Seat 3: 4thepeople (big blind) folded on the Turn
Seat 4: Ellen1947 folded before Flop (didn't bet)
Seat 5: chiyuki folded on the River
Seat 6: KrystalAA folded before Flop (didn't bet)
Seat 7: phate-1up folded before Flop (didn't bet)
Seat 8: Cyanidoff folded before Flop (didn't bet)
Seat 9: 1Karina1 folded before Flop (didn't bet)



PokerStars Zoom Hand #84299812130:  Hold'em No Limit ($0.10/$0.25) - 2012/08/05 14:44:57 JST [2012/08/05 1:44:57 ET]
Table 'Whirlpool' 9-max Seat #1 is the button
Seat 1: chiyuki ($26.74 in chips) 
Seat 2: Tom1999 ($13.25 in chips) 
Seat 3: fuguangps ($31.05 in chips) 
Seat 4: el pore 5 ($31.21 in chips) 
Seat 5: canammark ($27.44 in chips) 
Seat 6: mjmichi ($25 in chips) 
Seat 7: Alvinpe85 ($47.27 in chips) 
Seat 8: KrystalAA ($24.16 in chips) 
Seat 9: caro196661cv ($23.01 in chips) 
Tom1999: posts small blind $0.10
fuguangps: posts big blind $0.25
*** HOLE CARDS ***
Dealt to chiyuki [Qd Kd]
el pore 5: folds 
canammark: raises $0.25 to $0.50
mjmichi: folds 
Alvinpe85: folds 
KrystalAA: folds 
caro196661cv: folds 
chiyuki: calls $0.50
Tom1999: folds 
fuguangps: folds 
*** FLOP *** [2d 7h 4c]
canammark: checks 
chiyuki: checks 
*** TURN *** [2d 7h 4c] [Kc]
canammark: checks 
chiyuki: bets $0.75
canammark: folds 
Uncalled bet ($0.75) returned to chiyuki
chiyuki collected $1.29 from pot
chiyuki: doesn't show hand 
*** SUMMARY ***
Total pot $1.35 | Rake $0.06 
Board [2d 7h 4c Kc]
Seat 1: chiyuki (button) collected ($1.29)
Seat 2: Tom1999 (small blind) folded before Flop
Seat 3: fuguangps (big blind) folded before Flop
Seat 4: el pore 5 folded before Flop (didn't bet)
Seat 5: canammark folded on the Turn
Seat 6: mjmichi folded before Flop (didn't bet)
Seat 7: Alvinpe85 folded before Flop (didn't bet)
Seat 8: KrystalAA folded before Flop (didn't bet)
Seat 9: caro196661cv folded before Flop (didn't bet)



PokerStars Zoom Hand #84299822142:  Hold'em No Limit ($0.10/$0.25) - 2012/08/05 14:45:38 JST [2012/08/05 1:45:38 ET]
Table 'Whirlpool' 9-max Seat #1 is the button
Seat 1: snejokCoxx ($12.96 in chips) 
Seat 2: phate-1up ($57.81 in chips) 
Seat 3: chiyuki ($27.53 in chips) 
Seat 4: 4ydo yogurt ($12 in chips) 
Seat 5: Ellen1947 ($28.56 in chips) 
Seat 6: Cyanidoff ($27.24 in chips) 
Seat 7: Landybob ($36.76 in chips) 
Seat 8: Nerkit ($11.56 in chips) 
Seat 9: simonzez ($28.56 in chips) 
phate-1up: posts small blind $0.10
chiyuki: posts big blind $0.25
*** HOLE CARDS ***
Dealt to chiyuki [Kc 5h]
4ydo yogurt: folds 
Ellen1947: folds 
Cyanidoff: folds 
Landybob: folds 
Nerkit: folds 
simonzez: folds 
snejokCoxx: folds 
phate-1up: folds 
Uncalled bet ($0.15) returned to chiyuki
chiyuki collected $0.20 from pot
chiyuki: doesn't show hand 
*** SUMMARY ***
Total pot $0.20 | Rake $0 
Seat 1: snejokCoxx (button) folded before Flop (didn't bet)
Seat 2: phate-1up (small blind) folded before Flop
Seat 3: chiyuki (big blind) collected ($0.20)
Seat 4: 4ydo yogurt folded before Flop (didn't bet)
Seat 5: Ellen1947 folded before Flop (didn't bet)
Seat 6: Cyanidoff folded before Flop (didn't bet)
Seat 7: Landybob folded before Flop (didn't bet)
Seat 8: Nerkit folded before Flop (didn't bet)
Seat 9: simonzez folded before Flop (didn't bet)



PokerStars Zoom Hand #84299820177:  Hold'em No Limit ($0.10/$0.25) - 2012/08/05 14:45:30 JST [2012/08/05 1:45:30 ET]
Table 'Whirlpool' 9-max Seat #1 is the button
Seat 1: troublesomm ($25 in chips) 
Seat 2: silvno31 ($32.40 in chips) 
Seat 3: 1Karina1 ($25.67 in chips) 
Seat 4: chiyuki ($27.53 in chips) 
Seat 5: caro196661cv ($23.01 in chips) 
Seat 6: canammark ($26.94 in chips) 
Seat 7: hirozo ($38.28 in chips) 
Seat 8: hl77777 ($9.70 in chips) 
Seat 9: snejokCoxx ($12.96 in chips) 
silvno31: posts small blind $0.10
1Karina1: posts big blind $0.25
*** HOLE CARDS ***
Dealt to chiyuki [9c 4s]
chiyuki: folds 
caro196661cv: folds 
canammark: raises $0.25 to $0.50
hirozo: calls $0.50
hl77777: folds 
snejokCoxx: folds 
troublesomm: calls $0.50
silvno31: folds 
1Karina1: folds 
*** FLOP *** [3c 4c 7h]
canammark: checks 
hirozo: bets $1.18
troublesomm: folds 
canammark: folds 
Uncalled bet ($1.18) returned to hirozo
hirozo collected $1.77 from pot
hirozo: doesn't show hand 
*** SUMMARY ***
Total pot $1.85 | Rake $0.08 
Board [3c 4c 7h]
Seat 1: troublesomm (button) folded on the Flop
Seat 2: silvno31 (small blind) folded before Flop
Seat 3: 1Karina1 (big blind) folded before Flop
Seat 4: chiyuki folded before Flop (didn't bet)
Seat 5: caro196661cv folded before Flop (didn't bet)
Seat 6: canammark folded on the Flop
Seat 7: hirozo collected ($1.77)
Seat 8: hl77777 folded before Flop (didn't bet)
Seat 9: snejokCoxx folded before Flop (didn't bet)



PokerStars Zoom Hand #84299826625:  Hold'em No Limit ($0.10/$0.25) - 2012/08/05 14:45:56 JST [2012/08/05 1:45:56 ET]
Table 'Whirlpool' 9-max Seat #1 is the button
Seat 1: KeLevro0 ($11.80 in chips) 
Seat 2: 1Karina1 ($45.74 in chips) 
Seat 3: BlOnDhOlIc ($35.60 in chips) 
Seat 4: Cyanidoff ($25 in chips) 
Seat 5: chiyuki ($27.63 in chips) 
Seat 6: Ellen1947 ($30.34 in chips) 
Seat 7: GovGus ($30.06 in chips) 
Seat 8: Paranoix1990 ($22.63 in chips) 
Seat 9: led52 ($10.02 in chips) 
1Karina1: posts small blind $0.10
BlOnDhOlIc: posts big blind $0.25
*** HOLE CARDS ***
Dealt to chiyuki [8s 4h]
Cyanidoff: folds 
chiyuki: folds 
Ellen1947: folds 
GovGus: raises $0.50 to $0.75
Paranoix1990: folds 
led52: folds 
KeLevro0: folds 
1Karina1: folds 
BlOnDhOlIc: folds 
Uncalled bet ($0.50) returned to GovGus
GovGus collected $0.60 from pot
GovGus: doesn't show hand 
*** SUMMARY ***
Total pot $0.60 | Rake $0 
Seat 1: KeLevro0 (button) folded before Flop (didn't bet)
Seat 2: 1Karina1 (small blind) folded before Flop
Seat 3: BlOnDhOlIc (big blind) folded before Flop
Seat 4: Cyanidoff folded before Flop (didn't bet)
Seat 5: chiyuki folded before Flop (didn't bet)
Seat 6: Ellen1947 folded before Flop (didn't bet)
Seat 7: GovGus collected ($0.60)
Seat 8: Paranoix1990 folded before Flop (didn't bet)
Seat 9: led52 folded before Flop (didn't bet)



PokerStars Zoom Hand #84299828763:  Hold'em No Limit ($0.10/$0.25) - 2012/08/05 14:46:06 JST [2012/08/05 1:46:06 ET]
Table 'Whirlpool' 9-max Seat #1 is the button
Seat 1: Wilcox76607 ($17.23 in chips) 
Seat 2: 4ydo yogurt ($11.75 in chips) 
Seat 3: canammark ($26.44 in chips) 
Seat 4: Ellen1947 ($28.31 in chips) 
Seat 5: dushvan ($41.59 in chips) 
Seat 6: Cyanidoff ($25 in chips) 
Seat 7: Dafleche ($15 in chips) 
Seat 8: laurentzu84 ($30.53 in chips) 
Seat 9: chiyuki ($27.63 in chips) 
4ydo yogurt: posts small blind $0.10
canammark: posts big blind $0.25
*** HOLE CARDS ***
Dealt to chiyuki [Td 9c]
Ellen1947: folds 
dushvan: folds 
Cyanidoff: folds 
Dafleche: folds 
laurentzu84: folds 
chiyuki: folds 
Wilcox76607: folds 
4ydo yogurt: raises $0.25 to $0.50
canammark: folds 
Uncalled bet ($0.25) returned to 4ydo yogurt
4ydo yogurt collected $0.50 from pot
4ydo yogurt: doesn't show hand 
*** SUMMARY ***
Total pot $0.50 | Rake $0 
Seat 1: Wilcox76607 (button) folded before Flop (didn't bet)
Seat 2: 4ydo yogurt (small blind) collected ($0.50)
Seat 3: canammark (big blind) folded before Flop
Seat 4: Ellen1947 folded before Flop (didn't bet)
Seat 5: dushvan folded before Flop (didn't bet)
Seat 6: Cyanidoff folded before Flop (didn't bet)
Seat 7: Dafleche folded before Flop (didn't bet)
Seat 8: laurentzu84 folded before Flop (didn't bet)
Seat 9: chiyuki folded before Flop (didn't bet)



PokerStars Zoom Hand #84299831421:  Hold'em No Limit ($0.10/$0.25) - 2012/08/05 14:46:17 JST [2012/08/05 1:46:17 ET]
Table 'Whirlpool' 9-max Seat #1 is the button
Seat 1: chiyuki ($27.53 in chips) 
Seat 2: KAKamiro ($25.58 in chips) 
Seat 3: seula i ($116.96 in chips) 
Seat 4: Ladyteazer ($30.09 in chips) 
Seat 5: Walturrr ($26.46 in chips) 
Seat 6: troublesomm ($25 in chips) 
Seat 7: 1Karina1 ($25 in chips) 
Seat 8: Dejacob ($25 in chips) 
Seat 9: Nagibator441 ($13.99 in chips) 
KAKamiro: posts small blind $0.10
seula i: posts big blind $0.25
*** HOLE CARDS ***
Dealt to chiyuki [9d 2h]
Ladyteazer: folds 
Walturrr: folds 
troublesomm: folds 
1Karina1: folds 
Dejacob: folds 
Nagibator441: folds 
chiyuki: folds 
KAKamiro: folds 
Uncalled bet ($0.15) returned to seula i
seula i collected $0.20 from pot
seula i: doesn't show hand 
*** SUMMARY ***
Total pot $0.20 | Rake $0 
Seat 1: chiyuki (button) folded before Flop (didn't bet)
Seat 2: KAKamiro (small blind) folded before Flop
Seat 3: seula i (big blind) collected ($0.20)
Seat 4: Ladyteazer folded before Flop (didn't bet)
Seat 5: Walturrr folded before Flop (didn't bet)
Seat 6: troublesomm folded before Flop (didn't bet)
Seat 7: 1Karina1 folded before Flop (didn't bet)
Seat 8: Dejacob folded before Flop (didn't bet)
Seat 9: Nagibator441 folded before Flop (didn't bet)



PokerStars Zoom Hand #84299830450:  Hold'em No Limit ($0.10/$0.25) - 2012/08/05 14:46:13 JST [2012/08/05 1:46:13 ET]
Table 'Whirlpool' 9-max Seat #1 is the button
Seat 1: Nerkit ($12.15 in chips) 
Seat 2: chiyuki ($27.63 in chips) 
Seat 3: tkd_joker ($24.30 in chips) 
Seat 4: DanielWhyte ($49.54 in chips) 
Seat 5: Ladyteazer ($30.09 in chips) 
Seat 6: fuguangps ($30.99 in chips) 
Seat 7: jacquelinewu ($36.91 in chips) 
Seat 8: Vahe50 ($16.54 in chips) 
Seat 9: led52 ($11.06 in chips) 
chiyuki: posts small blind $0.10
tkd_joker: posts big blind $0.25
*** HOLE CARDS ***
Dealt to chiyuki [3s 4h]
DanielWhyte: folds 
Ladyteazer: folds 
fuguangps: folds 
jacquelinewu: folds 
Vahe50: folds 
led52: folds 
Nerkit: folds 
chiyuki: folds 
Uncalled bet ($0.15) returned to tkd_joker
tkd_joker collected $0.20 from pot
tkd_joker: doesn't show hand 
*** SUMMARY ***
Total pot $0.20 | Rake $0 
Seat 1: Nerkit (button) folded before Flop (didn't bet)
Seat 2: chiyuki (small blind) folded before Flop
Seat 3: tkd_joker (big blind) collected ($0.20)
Seat 4: DanielWhyte folded before Flop (didn't bet)
Seat 5: Ladyteazer folded before Flop (didn't bet)
Seat 6: fuguangps folded before Flop (didn't bet)
Seat 7: jacquelinewu folded before Flop (didn't bet)
Seat 8: Vahe50 folded before Flop (didn't bet)
Seat 9: led52 folded before Flop (didn't bet)



PokerStars Zoom Hand #84299827832:  Hold'em No Limit ($0.10/$0.25) - 2012/08/05 14:46:01 JST [2012/08/05 1:46:01 ET]
Table 'Whirlpool' 9-max Seat #1 is the button
Seat 1: igor*gemert ($19.37 in chips) 
Seat 2: Nagibator441 ($14.11 in chips) 
Seat 3: el pore 5 ($29.96 in chips) 
Seat 4: ZhukOFFskI ($31.74 in chips) 
Seat 5: canammark ($26.44 in chips) 
Seat 6: Alvinpe85 ($43.02 in chips) 
Seat 7: fuguangps ($31.05 in chips) 
Seat 8: chiyuki ($27.63 in chips) 
Seat 9: Wilcox76607 ($17.23 in chips) 
Nagibator441: posts small blind $0.10
el pore 5: posts big blind $0.25
*** HOLE CARDS ***
Dealt to chiyuki [Qh 2d]
ZhukOFFskI: calls $0.25
canammark: folds 
Alvinpe85: folds 
fuguangps: folds 
chiyuki: folds 
Wilcox76607: folds 
igor*gemert: folds 
Nagibator441: raises $0.75 to $1
el pore 5: calls $0.75
ZhukOFFskI: calls $0.75
*** FLOP *** [6h Jc Qd]
Nagibator441: bets $2.25
el pore 5: folds 
ZhukOFFskI: folds 
Uncalled bet ($2.25) returned to Nagibator441
Nagibator441 collected $2.86 from pot
Nagibator441: doesn't show hand 
*** SUMMARY ***
Total pot $3 | Rake $0.14 
Board [6h Jc Qd]
Seat 1: igor*gemert (button) folded before Flop (didn't bet)
Seat 2: Nagibator441 (small blind) collected ($2.86)
Seat 3: el pore 5 (big blind) folded on the Flop
Seat 4: ZhukOFFskI folded on the Flop
Seat 5: canammark folded before Flop (didn't bet)
Seat 6: Alvinpe85 folded before Flop (didn't bet)
Seat 7: fuguangps folded before Flop (didn't bet)
Seat 8: chiyuki folded before Flop (didn't bet)
Seat 9: Wilcox76607 folded before Flop (didn't bet)



PokerStars Zoom Hand #84299832423:  Hold'em No Limit ($0.10/$0.25) - 2012/08/05 14:46:21 JST [2012/08/05 1:46:21 ET]
Table 'Whirlpool' 9-max Seat #1 is the button
Seat 1: KrystalAA ($23.81 in chips) 
Seat 2: stalkerec ($5.70 in chips) 
Seat 3: Ladyteazer ($30.09 in chips) 
Seat 4: simonzez ($26.96 in chips) 
Seat 5: deadmoneykid ($25.10 in chips) 
Seat 6: fuguangps ($31.05 in chips) 
Seat 7: chiyuki ($27.53 in chips) 
Seat 8: phate-1up ($40.74 in chips) 
Seat 9: hirozo ($40.22 in chips) 
stalkerec: posts small blind $0.10
Ladyteazer: posts big blind $0.25
*** HOLE CARDS ***
Dealt to chiyuki [2d Kd]
simonzez: folds 
deadmoneykid: folds 
fuguangps: folds 
chiyuki: folds 
phate-1up: folds 
hirozo: folds 
KrystalAA: folds 
stalkerec: folds 
Uncalled bet ($0.15) returned to Ladyteazer
Ladyteazer collected $0.20 from pot
Ladyteazer: doesn't show hand 
*** SUMMARY ***
Total pot $0.20 | Rake $0 
Seat 1: KrystalAA (button) folded before Flop (didn't bet)
Seat 2: stalkerec (small blind) folded before Flop
Seat 3: Ladyteazer (big blind) collected ($0.20)
Seat 4: simonzez folded before Flop (didn't bet)
Seat 5: deadmoneykid folded before Flop (didn't bet)
Seat 6: fuguangps folded before Flop (didn't bet)
Seat 7: chiyuki folded before Flop (didn't bet)
Seat 8: phate-1up folded before Flop (didn't bet)
Seat 9: hirozo folded before Flop (didn't bet)



PokerStars Zoom Hand #84299833684:  Hold'em No Limit ($0.10/$0.25) - 2012/08/05 14:46:26 JST [2012/08/05 1:46:26 ET]
Table 'Whirlpool' 9-max Seat #1 is the button
Seat 1: Tom1999 ($19.77 in chips) 
Seat 2: el pore 5 ($28.96 in chips) 
Seat 3: fuguangps ($31.05 in chips) 
Seat 4: chiyuki ($27.53 in chips) 
Seat 5: gunbowler ($145.49 in chips) 
Seat 6: igor*gemert ($19.27 in chips) 
Seat 7: JokerJudge ($24.75 in chips) 
Seat 8: jacquelinewu ($25.92 in chips) 
Seat 9: Perstenev ($11.18 in chips) 
el pore 5: posts small blind $0.10
fuguangps: posts big blind $0.25
*** HOLE CARDS ***
Dealt to chiyuki [6h 9s]
chiyuki: folds 
gunbowler: folds 
igor*gemert: folds 
JokerJudge: folds 
jacquelinewu: raises $0.50 to $0.75
Perstenev: calls $0.75
Tom1999: folds 
el pore 5: calls $0.65
fuguangps: folds 
*** FLOP *** [7d 9d 8s]
el pore 5: checks 
jacquelinewu: bets $1.67
Perstenev: calls $1.67
el pore 5: folds 
*** TURN *** [7d 9d 8s] [Kc]
jacquelinewu: checks 
Perstenev: bets $2.79
jacquelinewu: calls $2.79
*** RIVER *** [7d 9d 8s Kc] [6d]
jacquelinewu: checks 
Perstenev: bets $5.97 and is all-in
jacquelinewu: folds 
Uncalled bet ($5.97) returned to Perstenev
Perstenev collected $10.91 from pot
Perstenev: doesn't show hand 
*** SUMMARY ***
Total pot $11.42 | Rake $0.51 
Board [7d 9d 8s Kc 6d]
Seat 1: Tom1999 (button) folded before Flop (didn't bet)
Seat 2: el pore 5 (small blind) folded on the Flop
Seat 3: fuguangps (big blind) folded before Flop
Seat 4: chiyuki folded before Flop (didn't bet)
Seat 5: gunbowler folded before Flop (didn't bet)
Seat 6: igor*gemert folded before Flop (didn't bet)
Seat 7: JokerJudge folded before Flop (didn't bet)
Seat 8: jacquelinewu folded on the River
Seat 9: Perstenev collected ($10.91)



PokerStars Zoom Hand #84299835159:  Hold'em No Limit ($0.10/$0.25) - 2012/08/05 14:46:32 JST [2012/08/05 1:46:32 ET]
Table 'Whirlpool' 9-max Seat #1 is the button
Seat 1: Dafleche ($14.75 in chips) 
Seat 2: tkd_joker ($24.40 in chips) 
Seat 3: chiyuki ($27.53 in chips) 
Seat 4: Walturrr ($29.68 in chips) 
Seat 5: fuguangps ($30.99 in chips) 
Seat 6: GovGus ($30.41 in chips) 
Seat 7: mrvalet841 ($21.68 in chips) 
Seat 8: seula i ($117.06 in chips) 
Seat 9: Nagibator441 ($12.94 in chips) 
tkd_joker: posts small blind $0.10
chiyuki: posts big blind $0.25
*** HOLE CARDS ***
Dealt to chiyuki [3h 3d]
Walturrr: folds 
fuguangps: folds 
GovGus: folds 
mrvalet841: raises $0.50 to $0.75
seula i: folds 
Nagibator441: folds 
Dafleche: folds 
tkd_joker: folds 
chiyuki: calls $0.50
*** FLOP *** [5s 9c 9d]
chiyuki: checks 
mrvalet841: bets $0.75
chiyuki: folds 
Uncalled bet ($0.75) returned to mrvalet841
mrvalet841 collected $1.53 from pot
mrvalet841: doesn't show hand 
*** SUMMARY ***
Total pot $1.60 | Rake $0.07 
Board [5s 9c 9d]
Seat 1: Dafleche (button) folded before Flop (didn't bet)
Seat 2: tkd_joker (small blind) folded before Flop
Seat 3: chiyuki (big blind) folded on the Flop
Seat 4: Walturrr folded before Flop (didn't bet)
Seat 5: fuguangps folded before Flop (didn't bet)
Seat 6: GovGus folded before Flop (didn't bet)
Seat 7: mrvalet841 collected ($1.53)
Seat 8: seula i folded before Flop (didn't bet)
Seat 9: Nagibator441 folded before Flop (didn't bet)



PokerStars Zoom Hand #84299846706:  Hold'em No Limit ($0.10/$0.25) - 2012/08/05 14:47:20 JST [2012/08/05 1:47:20 ET]
Table 'Whirlpool' 9-max Seat #1 is the button
Seat 1: ChrisCDee ($35.68 in chips) 
Seat 2: mrvalet841 ($22.46 in chips) 
Seat 3: seula i ($39.99 in chips) 
Seat 4: Phaedrus...3 ($25.19 in chips) 
Seat 5: KrystalAA ($14.86 in chips) 
Seat 6: Nerkit ($12.50 in chips) 
Seat 7: cofla tito ($12.02 in chips) 
Seat 8: troublesomm ($26.10 in chips) 
Seat 9: chiyuki ($26.78 in chips) 
mrvalet841: posts small blind $0.10
seula i: posts big blind $0.25
*** HOLE CARDS ***
Dealt to chiyuki [Ad Jh]
Phaedrus...3: folds 
KrystalAA: folds 
Nerkit: folds 
cofla tito: folds 
troublesomm: folds 
chiyuki: raises $0.50 to $0.75
ChrisCDee: folds 
mrvalet841: folds 
seula i: calls $0.50
*** FLOP *** [Qs Qh Qc]
seula i: checks 
chiyuki: bets $0.76
seula i: folds 
Uncalled bet ($0.76) returned to chiyuki
chiyuki collected $1.53 from pot
chiyuki: doesn't show hand 
*** SUMMARY ***
Total pot $1.60 | Rake $0.07 
Board [Qs Qh Qc]
Seat 1: ChrisCDee (button) folded before Flop (didn't bet)
Seat 2: mrvalet841 (small blind) folded before Flop
Seat 3: seula i (big blind) folded on the Flop
Seat 4: Phaedrus...3 folded before Flop (didn't bet)
Seat 5: KrystalAA folded before Flop (didn't bet)
Seat 6: Nerkit folded before Flop (didn't bet)
Seat 7: cofla tito folded before Flop (didn't bet)
Seat 8: troublesomm folded before Flop (didn't bet)
Seat 9: chiyuki collected ($1.53)



PokerStars Zoom Hand #84299856685:  Hold'em No Limit ($0.10/$0.25) - 2012/08/05 14:48:01 JST [2012/08/05 1:48:01 ET]
Table 'Whirlpool' 9-max Seat #1 is the button
Seat 1: seula i ($29.11 in chips) 
Seat 2: Jene4kaBest ($7.15 in chips) 
Seat 3: Vahe50 ($16.43 in chips) 
Seat 4: Nerkit ($9.95 in chips) 
Seat 5: chiyuki ($27.56 in chips) 
Seat 6: snejokCoxx ($11.15 in chips) 
Seat 7: tkd_joker ($23.45 in chips) 
Seat 8: jacquelinewu ($36.56 in chips) 
Seat 9: fuguangps ($31.74 in chips) 
Jene4kaBest: posts small blind $0.10
Vahe50: posts big blind $0.25
*** HOLE CARDS ***
Dealt to chiyuki [8h Qd]
Nerkit: folds 
chiyuki: folds 
snejokCoxx: folds 
tkd_joker: folds 
jacquelinewu: folds 
fuguangps: raises $0.50 to $0.75
seula i: folds 
Jene4kaBest: folds 
Vahe50: folds 
Uncalled bet ($0.50) returned to fuguangps
fuguangps collected $0.60 from pot
fuguangps: doesn't show hand 
*** SUMMARY ***
Total pot $0.60 | Rake $0 
Seat 1: seula i (button) folded before Flop (didn't bet)
Seat 2: Jene4kaBest (small blind) folded before Flop
Seat 3: Vahe50 (big blind) folded before Flop
Seat 4: Nerkit folded before Flop (didn't bet)
Seat 5: chiyuki folded before Flop (didn't bet)
Seat 6: snejokCoxx folded before Flop (didn't bet)
Seat 7: tkd_joker folded before Flop (didn't bet)
Seat 8: jacquelinewu folded before Flop (didn't bet)
Seat 9: fuguangps collected ($0.60)



PokerStars Zoom Hand #84299861561:  Hold'em No Limit ($0.10/$0.25) - 2012/08/05 14:48:21 JST [2012/08/05 1:48:21 ET]
Table 'Whirlpool' 9-max Seat #1 is the button
Seat 1: Walturrr ($30.35 in chips) 
Seat 2: DonSimonUsa ($25.58 in chips) 
Seat 3: kamikkaze ($15.68 in chips) 
Seat 4: chiyuki ($27.56 in chips) 
Seat 5: snejokCoxx ($11.15 in chips) 
Seat 6: Jene4kaBest ($7.05 in chips) 
Seat 7: 1Karina1 ($25 in chips) 
Seat 8: Dejacob ($30.37 in chips) 
Seat 9: cofla tito ($9.84 in chips) 
DonSimonUsa: posts small blind $0.10
kamikkaze: posts big blind $0.25
*** HOLE CARDS ***
Dealt to chiyuki [7h 8c]
chiyuki: folds 
snejokCoxx: folds 
Jene4kaBest: folds 
1Karina1: folds 
Dejacob: folds 
cofla tito: folds 
Walturrr: raises $0.47 to $0.72
DonSimonUsa: folds 
kamikkaze: folds 
Uncalled bet ($0.47) returned to Walturrr
Walturrr collected $0.60 from pot
Walturrr: doesn't show hand 
*** SUMMARY ***
Total pot $0.60 | Rake $0 
Seat 1: Walturrr (button) collected ($0.60)
Seat 2: DonSimonUsa (small blind) folded before Flop
Seat 3: kamikkaze (big blind) folded before Flop
Seat 4: chiyuki folded before Flop (didn't bet)
Seat 5: snejokCoxx folded before Flop (didn't bet)
Seat 6: Jene4kaBest folded before Flop (didn't bet)
Seat 7: 1Karina1 folded before Flop (didn't bet)
Seat 8: Dejacob folded before Flop (didn't bet)
Seat 9: cofla tito folded before Flop (didn't bet)



PokerStars Zoom Hand #84299857927:  Hold'em No Limit ($0.10/$0.25) - 2012/08/05 14:48:06 JST [2012/08/05 1:48:06 ET]
Table 'Whirlpool' 9-max Seat #1 is the button
Seat 1: Perstenev ($13.27 in chips) 
Seat 2: GovGus ($32.08 in chips) 
Seat 3: deadmoneykid ($24.67 in chips) 
Seat 4: seula i ($116.96 in chips) 
Seat 5: hirozo ($39.90 in chips) 
Seat 6: chiyuki ($27.56 in chips) 
Seat 7: Nerkit ($9.95 in chips) 
Seat 8: ChrisCDee ($35.58 in chips) 
Seat 9: yane73 ($43.41 in chips) 
GovGus: posts small blind $0.10
deadmoneykid: posts big blind $0.25
*** HOLE CARDS ***
Dealt to chiyuki [Ac 9d]
seula i: folds 
hirozo: folds 
chiyuki: folds 
Nerkit: folds 
ChrisCDee: folds 
yane73: folds 
Perstenev: folds 
GovGus: raises $0.50 to $0.75
deadmoneykid: folds 
Uncalled bet ($0.50) returned to GovGus
GovGus collected $0.50 from pot
GovGus: doesn't show hand 
*** SUMMARY ***
Total pot $0.50 | Rake $0 
Seat 1: Perstenev (button) folded before Flop (didn't bet)
Seat 2: GovGus (small blind) collected ($0.50)
Seat 3: deadmoneykid (big blind) folded before Flop
Seat 4: seula i folded before Flop (didn't bet)
Seat 5: hirozo folded before Flop (didn't bet)
Seat 6: chiyuki folded before Flop (didn't bet)
Seat 7: Nerkit folded before Flop (didn't bet)
Seat 8: ChrisCDee folded before Flop (didn't bet)
Seat 9: yane73 folded before Flop (didn't bet)



PokerStars Zoom Hand #84299863568:  Hold'em No Limit ($0.10/$0.25) - 2012/08/05 14:48:30 JST [2012/08/05 1:48:30 ET]
Table 'Whirlpool' 9-max Seat #1 is the button
Seat 1: Dejacob ($25.78 in chips) 
Seat 2: chiyuki ($27.56 in chips) 
Seat 3: ll_LaMeR_ll ($83.89 in chips) 
Seat 4: seula i ($29.11 in chips) 
Seat 5: fuguangps ($64.94 in chips) 
Seat 6: Paranoix1990 ($27.17 in chips) 
Seat 7: led52 ($10.71 in chips) 
Seat 8: ZhukOFFskI ($35.90 in chips) 
Seat 9: hirozo ($50.25 in chips) 
chiyuki: posts small blind $0.10
ll_LaMeR_ll: posts big blind $0.25
*** HOLE CARDS ***
Dealt to chiyuki [7c Qc]
seula i: folds 
fuguangps: folds 
Paranoix1990: folds 
led52: folds 
ZhukOFFskI: folds 
hirozo: folds 
Dejacob: raises $0.50 to $0.75
chiyuki: folds 
ll_LaMeR_ll: raises $1.25 to $2
Dejacob: folds 
Uncalled bet ($1.25) returned to ll_LaMeR_ll
ll_LaMeR_ll collected $1.60 from pot
ll_LaMeR_ll: doesn't show hand 
*** SUMMARY ***
Total pot $1.60 | Rake $0 
Seat 1: Dejacob (button) folded before Flop
Seat 2: chiyuki (small blind) folded before Flop
Seat 3: ll_LaMeR_ll (big blind) collected ($1.60)
Seat 4: seula i folded before Flop (didn't bet)
Seat 5: fuguangps folded before Flop (didn't bet)
Seat 6: Paranoix1990 folded before Flop (didn't bet)
Seat 7: led52 folded before Flop (didn't bet)
Seat 8: ZhukOFFskI folded before Flop (didn't bet)
Seat 9: hirozo folded before Flop (didn't bet)



PokerStars Zoom Hand #84299869417:  Hold'em No Limit ($0.10/$0.25) - 2012/08/05 14:48:54 JST [2012/08/05 1:48:54 ET]
Table 'Whirlpool' 9-max Seat #1 is the button
Seat 1: BlOnDhOlIc ($34 in chips) 
Seat 2: fuguangps ($25 in chips) 
Seat 3: Phaedrus...3 ($25.16 in chips) 
Seat 4: snejokCoxx ($13.21 in chips) 
Seat 5: mrvalet841 ($25.42 in chips) 
Seat 6: simonzez ($26.54 in chips) 
Seat 7: hl77777 ($14.50 in chips) 
Seat 8: chiyuki ($27.46 in chips) 
Seat 9: GovGus ($30.49 in chips) 
fuguangps: posts small blind $0.10
Phaedrus...3: posts big blind $0.25
*** HOLE CARDS ***
Dealt to chiyuki [7c 4h]
snejokCoxx: folds 
mrvalet841: folds 
simonzez: folds 
hl77777: folds 
chiyuki: folds 
GovGus: folds 
BlOnDhOlIc: folds 
fuguangps: raises $0.50 to $0.75
Phaedrus...3: folds 
Uncalled bet ($0.50) returned to fuguangps
fuguangps collected $0.50 from pot
fuguangps: doesn't show hand 
*** SUMMARY ***
Total pot $0.50 | Rake $0 
Seat 1: BlOnDhOlIc (button) folded before Flop (didn't bet)
Seat 2: fuguangps (small blind) collected ($0.50)
Seat 3: Phaedrus...3 (big blind) folded before Flop
Seat 4: snejokCoxx folded before Flop (didn't bet)
Seat 5: mrvalet841 folded before Flop (didn't bet)
Seat 6: simonzez folded before Flop (didn't bet)
Seat 7: hl77777 folded before Flop (didn't bet)
Seat 8: chiyuki folded before Flop (didn't bet)
Seat 9: GovGus folded before Flop (didn't bet)



PokerStars Zoom Hand #84299870338:  Hold'em No Limit ($0.10/$0.25) - 2012/08/05 14:48:58 JST [2012/08/05 1:48:58 ET]
Table 'Whirlpool' 9-max Seat #1 is the button
Seat 1: simonzez ($26.54 in chips) 
Seat 2: Nerkit ($9.70 in chips) 
Seat 3: dushvan ($41.32 in chips) 
Seat 4: ChrisCDee ($30.98 in chips) 
Seat 5: snejokCoxx ($13.21 in chips) 
Seat 6: deadmoneykid ($22.05 in chips) 
Seat 7: chiyuki ($27.46 in chips) 
Seat 8: troublesomm ($25 in chips) 
Seat 9: 1Karina1 ($25 in chips) 
Nerkit: posts small blind $0.10
dushvan: posts big blind $0.25
*** HOLE CARDS ***
Dealt to chiyuki [2d 3h]
ChrisCDee: folds 
snejokCoxx: folds 
deadmoneykid: folds 
chiyuki: folds 
troublesomm: folds 
1Karina1: folds 
simonzez: calls $0.25
Nerkit: folds 
dushvan: checks 
*** FLOP *** [Qh 7s 2s]
dushvan: checks 
simonzez: bets $0.50
dushvan: folds 
Uncalled bet ($0.50) returned to simonzez
simonzez collected $0.57 from pot
simonzez: doesn't show hand 
*** SUMMARY ***
Total pot $0.60 | Rake $0.03 
Board [Qh 7s 2s]
Seat 1: simonzez (button) collected ($0.57)
Seat 2: Nerkit (small blind) folded before Flop
Seat 3: dushvan (big blind) folded on the Flop
Seat 4: ChrisCDee folded before Flop (didn't bet)
Seat 5: snejokCoxx folded before Flop (didn't bet)
Seat 6: deadmoneykid folded before Flop (didn't bet)
Seat 7: chiyuki folded before Flop (didn't bet)
Seat 8: troublesomm folded before Flop (didn't bet)
Seat 9: 1Karina1 folded before Flop (didn't bet)



PokerStars Zoom Hand #84299872064:  Hold'em No Limit ($0.10/$0.25) - 2012/08/05 14:49:05 JST [2012/08/05 1:49:05 ET]
Table 'Whirlpool' 9-max Seat #1 is the button
Seat 1: phate-1up ($25 in chips) 
Seat 2: Lars111 ($24.66 in chips) 
Seat 3: chiyuki ($27.46 in chips) 
Seat 4: Nerkit ($9.60 in chips) 
Seat 5: hl77777 ($14.50 in chips) 
Seat 6: KrystalAA ($17.41 in chips) 
Seat 7: seula i ($29.86 in chips) 
Seat 8: 1Karina1 ($28.92 in chips) 
Seat 9: Landybob ($35.11 in chips) 
Lars111: posts small blind $0.10
chiyuki: posts big blind $0.25
*** HOLE CARDS ***
Dealt to chiyuki [7c Kh]
Nerkit: folds 
hl77777: folds 
KrystalAA: folds 
seula i: folds 
1Karina1: folds 
Landybob: folds 
phate-1up: raises $0.50 to $0.75
Lars111: calls $0.65
chiyuki: folds 
*** FLOP *** [5d 8s 9c]
Lars111: bets $0.83
phate-1up: folds 
Uncalled bet ($0.83) returned to Lars111
Lars111 collected $1.67 from pot
Lars111: doesn't show hand 
*** SUMMARY ***
Total pot $1.75 | Rake $0.08 
Board [5d 8s 9c]
Seat 1: phate-1up (button) folded on the Flop
Seat 2: Lars111 (small blind) collected ($1.67)
Seat 3: chiyuki (big blind) folded before Flop
Seat 4: Nerkit folded before Flop (didn't bet)
Seat 5: hl77777 folded before Flop (didn't bet)
Seat 6: KrystalAA folded before Flop (didn't bet)
Seat 7: seula i folded before Flop (didn't bet)
Seat 8: 1Karina1 folded before Flop (didn't bet)
Seat 9: Landybob folded before Flop (didn't bet)



PokerStars Zoom Hand #84299876024:  Hold'em No Limit ($0.10/$0.25) - 2012/08/05 14:49:21 JST [2012/08/05 1:49:21 ET]
Table 'Whirlpool' 9-max Seat #1 is the button
Seat 1: led52 ($15.85 in chips) 
Seat 2: snejokCoxx ($12.25 in chips) 
Seat 3: phate-1up ($46.34 in chips) 
Seat 4: Phaedrus...3 ($25 in chips) 
Seat 5: BlOnDhOlIc ($90.11 in chips) 
Seat 6: Sal y Limon1 ($25.08 in chips) 
Seat 7: 4plankton ($26.83 in chips) 
Seat 8: tkd_joker ($23.42 in chips) 
Seat 9: chiyuki ($27.21 in chips) 
snejokCoxx: posts small blind $0.10
phate-1up: posts big blind $0.25
*** HOLE CARDS ***
Dealt to chiyuki [7s 7h]
Phaedrus...3: folds 
BlOnDhOlIc: folds 
Sal y Limon1: folds 
4plankton: folds 
tkd_joker: folds 
chiyuki: raises $0.50 to $0.75
led52: folds 
snejokCoxx: folds 
phate-1up: folds 
Uncalled bet ($0.50) returned to chiyuki
chiyuki collected $0.60 from pot
chiyuki: doesn't show hand 
*** SUMMARY ***
Total pot $0.60 | Rake $0 
Seat 1: led52 (button) folded before Flop (didn't bet)
Seat 2: snejokCoxx (small blind) folded before Flop
Seat 3: phate-1up (big blind) folded before Flop
Seat 4: Phaedrus...3 folded before Flop (didn't bet)
Seat 5: BlOnDhOlIc folded before Flop (didn't bet)
Seat 6: Sal y Limon1 folded before Flop (didn't bet)
Seat 7: 4plankton folded before Flop (didn't bet)
Seat 8: tkd_joker folded before Flop (didn't bet)
Seat 9: chiyuki collected ($0.60)



PokerStars Zoom Hand #84299881802:  Hold'em No Limit ($0.10/$0.25) - 2012/08/05 14:49:46 JST [2012/08/05 1:49:46 ET]
Table 'Whirlpool' 9-max Seat #1 is the button
Seat 1: chiyuki ($27.56 in chips) 
Seat 2: seula i ($38.89 in chips) 
Seat 3: KeLevro0 ($11.80 in chips) 
Seat 4: hirozo ($39.97 in chips) 
Seat 5: jacquelinewu ($42.56 in chips) 
Seat 6: GovGus ($34.29 in chips) 
Seat 7: 1Karina1 ($25 in chips) 
Seat 8: ChrisCDee ($70.84 in chips) 
Seat 9: phate-1up ($46.09 in chips) 
seula i: posts small blind $0.10
KeLevro0: posts big blind $0.25
*** HOLE CARDS ***
Dealt to chiyuki [2d 7d]
hirozo: folds 
jacquelinewu: folds 
GovGus: folds 
1Karina1: folds 
ChrisCDee: folds 
phate-1up: folds 
chiyuki: folds 
seula i: folds 
Uncalled bet ($0.15) returned to KeLevro0
KeLevro0 collected $0.20 from pot
KeLevro0: doesn't show hand 
*** SUMMARY ***
Total pot $0.20 | Rake $0 
Seat 1: chiyuki (button) folded before Flop (didn't bet)
Seat 2: seula i (small blind) folded before Flop
Seat 3: KeLevro0 (big blind) collected ($0.20)
Seat 4: hirozo folded before Flop (didn't bet)
Seat 5: jacquelinewu folded before Flop (didn't bet)
Seat 6: GovGus folded before Flop (didn't bet)
Seat 7: 1Karina1 folded before Flop (didn't bet)
Seat 8: ChrisCDee folded before Flop (didn't bet)
Seat 9: phate-1up folded before Flop (didn't bet)



PokerStars Zoom Hand #84299882767:  Hold'em No Limit ($0.10/$0.25) - 2012/08/05 14:49:50 JST [2012/08/05 1:49:50 ET]
Table 'Whirlpool' 9-max Seat #1 is the button
Seat 1: mjmichi ($41.95 in chips) 
Seat 2: DonSimonUsa ($27.44 in chips) 
Seat 3: kamikkaze ($17.58 in chips) 
Seat 4: ZhukOFFskI ($28.13 in chips) 
Seat 5: seula i ($38.79 in chips) 
Seat 6: chiyuki ($27.56 in chips) 
Seat 7: Dejacob ($32.23 in chips) 
Seat 8: 1Karina1 ($25 in chips) 
Seat 9: troublesomm ($25 in chips) 
DonSimonUsa: posts small blind $0.10
kamikkaze: posts big blind $0.25
*** HOLE CARDS ***
Dealt to chiyuki [8s Ah]
ZhukOFFskI: raises $0.50 to $0.75
seula i: folds 
chiyuki: folds 
Dejacob: folds 
1Karina1: folds 
troublesomm: folds 
mjmichi: folds 
DonSimonUsa: folds 
kamikkaze: calls $0.50
*** FLOP *** [4d 7h 9c]
kamikkaze: checks 
ZhukOFFskI: bets $0.91
kamikkaze: folds 
Uncalled bet ($0.91) returned to ZhukOFFskI
ZhukOFFskI collected $1.53 from pot
ZhukOFFskI: doesn't show hand 
*** SUMMARY ***
Total pot $1.60 | Rake $0.07 
Board [4d 7h 9c]
Seat 1: mjmichi (button) folded before Flop (didn't bet)
Seat 2: DonSimonUsa (small blind) folded before Flop
Seat 3: kamikkaze (big blind) folded on the Flop
Seat 4: ZhukOFFskI collected ($1.53)
Seat 5: seula i folded before Flop (didn't bet)
Seat 6: chiyuki folded before Flop (didn't bet)
Seat 7: Dejacob folded before Flop (didn't bet)
Seat 8: 1Karina1 folded before Flop (didn't bet)
Seat 9: troublesomm folded before Flop (didn't bet)



PokerStars Zoom Hand #84299885246:  Hold'em No Limit ($0.10/$0.25) - 2012/08/05 14:50:00 JST [2012/08/05 1:50:00 ET]
Table 'Whirlpool' 9-max Seat #1 is the button
Seat 1: peng2astic ($17.47 in chips) 
Seat 2: chiyuki ($27.56 in chips) 
Seat 3: mjmichi ($25.35 in chips) 
Seat 4: softdesign ($62.30 in chips) 
Seat 5: jacquelinewu ($46.58 in chips) 
Seat 6: Dejacob ($29.62 in chips) 
Seat 7: silvno31 ($24.70 in chips) 
Seat 8: snejokCoxx ($12.15 in chips) 
Seat 9: hirozo ($40.15 in chips) 
chiyuki: posts small blind $0.10
mjmichi: posts big blind $0.25
*** HOLE CARDS ***
Dealt to chiyuki [Tc 4s]
softdesign: folds 
jacquelinewu: folds 
Dejacob: folds 
silvno31: folds 
snejokCoxx: raises $0.40 to $0.65
hirozo: folds 
peng2astic: folds 
chiyuki: folds 
mjmichi: folds 
Uncalled bet ($0.40) returned to snejokCoxx
snejokCoxx collected $0.60 from pot
snejokCoxx: doesn't show hand 
*** SUMMARY ***
Total pot $0.60 | Rake $0 
Seat 1: peng2astic (button) folded before Flop (didn't bet)
Seat 2: chiyuki (small blind) folded before Flop
Seat 3: mjmichi (big blind) folded before Flop
Seat 4: softdesign folded before Flop (didn't bet)
Seat 5: jacquelinewu folded before Flop (didn't bet)
Seat 6: Dejacob folded before Flop (didn't bet)
Seat 7: silvno31 folded before Flop (didn't bet)
Seat 8: snejokCoxx collected ($0.60)
Seat 9: hirozo folded before Flop (didn't bet)



PokerStars Zoom Hand #84299889168:  Hold'em No Limit ($0.10/$0.25) - 2012/08/05 14:50:15 JST [2012/08/05 1:50:15 ET]
Table 'Whirlpool' 9-max Seat #1 is the button
Seat 1: PillZ86 ($15.83 in chips) 
Seat 2: Walturrr ($29.70 in chips) 
Seat 3: sparky5224 ($34.03 in chips) 
Seat 4: Dejacob ($32.33 in chips) 
Seat 5: Alvinpe85 ($57.44 in chips) 
Seat 6: chiyuki ($27.46 in chips) 
Seat 7: Jene4kaBest ($13.48 in chips) 
Seat 8: el pore 5 ($26.93 in chips) 
Seat 9: hl77777 ($14.72 in chips) 
Walturrr: posts small blind $0.10
sparky5224: posts big blind $0.25
*** HOLE CARDS ***
Dealt to chiyuki [7d Tc]
Dejacob: folds 
Alvinpe85: folds 
chiyuki: folds 
Jene4kaBest: folds 
el pore 5: folds 
hl77777: folds 
PillZ86: folds 
Walturrr: folds 
Uncalled bet ($0.15) returned to sparky5224
sparky5224 collected $0.20 from pot
sparky5224: doesn't show hand 
*** SUMMARY ***
Total pot $0.20 | Rake $0 
Seat 1: PillZ86 (button) folded before Flop (didn't bet)
Seat 2: Walturrr (small blind) folded before Flop
Seat 3: sparky5224 (big blind) collected ($0.20)
Seat 4: Dejacob folded before Flop (didn't bet)
Seat 5: Alvinpe85 folded before Flop (didn't bet)
Seat 6: chiyuki folded before Flop (didn't bet)
Seat 7: Jene4kaBest folded before Flop (didn't bet)
Seat 8: el pore 5 folded before Flop (didn't bet)
Seat 9: hl77777 folded before Flop (didn't bet)



PokerStars Zoom Hand #84299892110:  Hold'em No Limit ($0.10/$0.25) - 2012/08/05 14:50:27 JST [2012/08/05 1:50:27 ET]
Table 'Whirlpool' 9-max Seat #1 is the button
Seat 1: ZhukOFFskI ($27.81 in chips) 
Seat 2: Jene4kaBest ($13.48 in chips) 
Seat 3: DanielWhyte ($46.62 in chips) 
Seat 4: Nerkit ($10.73 in chips) 
Seat 5: chiyuki ($27.46 in chips) 
Seat 6: Perstenev ($13.81 in chips) 
Seat 7: snejokCoxx ($12.50 in chips) 
Seat 8: troublesomm ($25 in chips) 
Seat 9: Vahe50 ($14.04 in chips) 
Jene4kaBest: posts small blind $0.10
DanielWhyte: posts big blind $0.25
*** HOLE CARDS ***
Dealt to chiyuki [Jh Kh]
Nerkit: folds 
chiyuki: folds 
Perstenev: folds 
snejokCoxx: folds 
troublesomm: folds 
Vahe50: folds 
ZhukOFFskI: folds 
Jene4kaBest: folds 
Uncalled bet ($0.15) returned to DanielWhyte
DanielWhyte collected $0.20 from pot
DanielWhyte: doesn't show hand 
*** SUMMARY ***
Total pot $0.20 | Rake $0 
Seat 1: ZhukOFFskI (button) folded before Flop (didn't bet)
Seat 2: Jene4kaBest (small blind) folded before Flop
Seat 3: DanielWhyte (big blind) collected ($0.20)
Seat 4: Nerkit folded before Flop (didn't bet)
Seat 5: chiyuki folded before Flop (didn't bet)
Seat 6: Perstenev folded before Flop (didn't bet)
Seat 7: snejokCoxx folded before Flop (didn't bet)
Seat 8: troublesomm folded before Flop (didn't bet)
Seat 9: Vahe50 folded before Flop (didn't bet)



PokerStars Zoom Hand #84299895593:  Hold'em No Limit ($0.10/$0.25) - 2012/08/05 14:50:41 JST [2012/08/05 1:50:41 ET]
Table 'Whirlpool' 9-max Seat #1 is the button
Seat 1: chiyuki ($27.46 in chips) 
Seat 2: Tom1999 ($21.54 in chips) 
Seat 3: Perstenev ($13.81 in chips) 
Seat 4: Nerkit ($11 in chips) 
Seat 5: troublesomm ($31.25 in chips) 
Seat 6: Nagibator441 ($10.99 in chips) 
Seat 7: Ladyteazer ($29.84 in chips) 
Seat 8: DanielWhyte ($46.72 in chips) 
Seat 9: ttjppy ($15.11 in chips) 
Tom1999: posts small blind $0.10
Perstenev: posts big blind $0.25
*** HOLE CARDS ***
Dealt to chiyuki [8d Ks]
Nerkit: folds 
troublesomm: folds 
Nagibator441: folds 
Ladyteazer: folds 
DanielWhyte: folds 
ttjppy: folds 
chiyuki: raises $0.50 to $0.75
Tom1999: folds 
Perstenev: folds 
Uncalled bet ($0.50) returned to chiyuki
chiyuki collected $0.60 from pot
chiyuki: doesn't show hand 
*** SUMMARY ***
Total pot $0.60 | Rake $0 
Seat 1: chiyuki (button) collected ($0.60)
Seat 2: Tom1999 (small blind) folded before Flop
Seat 3: Perstenev (big blind) folded before Flop
Seat 4: Nerkit folded before Flop (didn't bet)
Seat 5: troublesomm folded before Flop (didn't bet)
Seat 6: Nagibator441 folded before Flop (didn't bet)
Seat 7: Ladyteazer folded before Flop (didn't bet)
Seat 8: DanielWhyte folded before Flop (didn't bet)
Seat 9: ttjppy folded before Flop (didn't bet)



PokerStars Zoom Hand #84299890882:  Hold'em No Limit ($0.10/$0.25) - 2012/08/05 14:50:22 JST [2012/08/05 1:50:22 ET]
Table 'Whirlpool' 9-max Seat #1 is the button
Seat 1: Lars111 ($29.24 in chips) 
Seat 2: colorado2108 ($15.20 in chips) 
Seat 3: BlOnDhOlIc ($87.46 in chips) 
Seat 4: kamikkaze ($16.73 in chips) 
Seat 5: GovGus ($34.04 in chips) 
Seat 6: Alvinpe85 ($50.64 in chips) 
Seat 7: chiyuki ($27.46 in chips) 
Seat 8: Sal y Limon1 ($25.08 in chips) 
Seat 9: troublesomm ($31.35 in chips) 
colorado2108: posts small blind $0.10
BlOnDhOlIc: posts big blind $0.25
*** HOLE CARDS ***
Dealt to chiyuki [5d 8s]
kamikkaze: folds 
GovGus: raises $0.50 to $0.75
Alvinpe85: folds 
chiyuki: folds 
Sal y Limon1: folds 
troublesomm: folds 
Lars111: folds 
colorado2108: folds 
BlOnDhOlIc: calls $0.50
*** FLOP *** [7d 7s Jh]
BlOnDhOlIc: checks 
GovGus: checks 
*** TURN *** [7d 7s Jh] [Th]
BlOnDhOlIc: bets $0.75
GovGus: calls $0.75
*** RIVER *** [7d 7s Jh Th] [Kd]
BlOnDhOlIc: checks 
GovGus: bets $1.75
BlOnDhOlIc: folds 
Uncalled bet ($1.75) returned to GovGus
GovGus collected $2.96 from pot
GovGus: doesn't show hand 
*** SUMMARY ***
Total pot $3.10 | Rake $0.14 
Board [7d 7s Jh Th Kd]
Seat 1: Lars111 (button) folded before Flop (didn't bet)
Seat 2: colorado2108 (small blind) folded before Flop
Seat 3: BlOnDhOlIc (big blind) folded on the River
Seat 4: kamikkaze folded before Flop (didn't bet)
Seat 5: GovGus collected ($2.96)
Seat 6: Alvinpe85 folded before Flop (didn't bet)
Seat 7: chiyuki folded before Flop (didn't bet)
Seat 8: Sal y Limon1 folded before Flop (didn't bet)
Seat 9: troublesomm folded before Flop (didn't bet)



PokerStars Zoom Hand #84299894331:  Hold'em No Limit ($0.10/$0.25) - 2012/08/05 14:50:36 JST [2012/08/05 1:50:36 ET]
Table 'Whirlpool' 9-max Seat #1 is the button
Seat 1: BlOnDhOlIc ($34.49 in chips) 
Seat 2: KAKamiro ($26.25 in chips) 
Seat 3: led52 ($12.50 in chips) 
Seat 4: Perstenev ($11.67 in chips) 
Seat 5: KrystalAA ($29.39 in chips) 
Seat 6: snejokCoxx ($12.50 in chips) 
Seat 7: cofla tito ($9.24 in chips) 
Seat 8: chiyuki ($27.46 in chips) 
Seat 9: hirozo ($51.25 in chips) 
KAKamiro: posts small blind $0.10
led52: posts big blind $0.25
*** HOLE CARDS ***
Dealt to chiyuki [Jd Th]
Perstenev: folds 
KrystalAA: folds 
snejokCoxx: raises $0.40 to $0.65
cofla tito: folds 
chiyuki: folds 
hirozo: folds 
BlOnDhOlIc: raises $1.60 to $2.25
KAKamiro: folds 
led52: folds 
snejokCoxx: folds 
Uncalled bet ($1.60) returned to BlOnDhOlIc
BlOnDhOlIc collected $1.65 from pot
BlOnDhOlIc: doesn't show hand 
*** SUMMARY ***
Total pot $1.65 | Rake $0 
Seat 1: BlOnDhOlIc (button) collected ($1.65)
Seat 2: KAKamiro (small blind) folded before Flop
Seat 3: led52 (big blind) folded before Flop
Seat 4: Perstenev folded before Flop (didn't bet)
Seat 5: KrystalAA folded before Flop (didn't bet)
Seat 6: snejokCoxx folded before Flop
Seat 7: cofla tito folded before Flop (didn't bet)
Seat 8: chiyuki folded before Flop (didn't bet)
Seat 9: hirozo folded before Flop (didn't bet)



PokerStars Zoom Hand #84299900790:  Hold'em No Limit ($0.10/$0.25) - 2012/08/05 14:51:03 JST [2012/08/05 1:51:03 ET]
Table 'Whirlpool' 9-max Seat #1 is the button
Seat 1: Sal y Limon1 ($30.20 in chips) 
Seat 2: Cyanidoff ($25.78 in chips) 
Seat 3: KeLevro0 ($12.50 in chips) 
Seat 4: chiyuki ($27.81 in chips) 
Seat 5: deadmoneykid ($29.50 in chips) 
Seat 6: hirozo ($25.35 in chips) 
Seat 7: Perstenev ($13.56 in chips) 
Seat 8: Jene4kaBest ($13.73 in chips) 
Seat 9: Alvinpe85 ($57.54 in chips) 
Cyanidoff: posts small blind $0.10
KeLevro0: posts big blind $0.25
*** HOLE CARDS ***
Dealt to chiyuki [Qs 9c]
chiyuki: folds 
deadmoneykid: folds 
hirozo: folds 
Perstenev: folds 
Jene4kaBest: folds 
Alvinpe85: folds 
Sal y Limon1: folds 
Cyanidoff: folds 
Uncalled bet ($0.15) returned to KeLevro0
KeLevro0 collected $0.20 from pot
KeLevro0: doesn't show hand 
*** SUMMARY ***
Total pot $0.20 | Rake $0 
Seat 1: Sal y Limon1 (button) folded before Flop (didn't bet)
Seat 2: Cyanidoff (small blind) folded before Flop
Seat 3: KeLevro0 (big blind) collected ($0.20)
Seat 4: chiyuki folded before Flop (didn't bet)
Seat 5: deadmoneykid folded before Flop (didn't bet)
Seat 6: hirozo folded before Flop (didn't bet)
Seat 7: Perstenev folded before Flop (didn't bet)
Seat 8: Jene4kaBest folded before Flop (didn't bet)
Seat 9: Alvinpe85 folded before Flop (didn't bet)



PokerStars Zoom Hand #84299903494:  Hold'em No Limit ($0.10/$0.25) - 2012/08/05 14:51:14 JST [2012/08/05 1:51:14 ET]
Table 'Whirlpool' 9-max Seat #1 is the button
Seat 1: Dejacob ($26.12 in chips) 
Seat 2: GovGus ($35.50 in chips) 
Seat 3: chiyuki ($27.81 in chips) 
Seat 4: ZhukOFFskI ($28.56 in chips) 
Seat 5: snejokCoxx ($11.85 in chips) 
Seat 6: hirozo ($51 in chips) 
Seat 7: phate-1up ($25 in chips) 
Seat 8: led52 ($13.96 in chips) 
Seat 9: BlOnDhOlIc ($35.49 in chips) 
GovGus: posts small blind $0.10
chiyuki: posts big blind $0.25
*** HOLE CARDS ***
Dealt to chiyuki [5d 4s]
ZhukOFFskI: folds 
snejokCoxx: raises $0.40 to $0.65
hirozo: folds 
phate-1up: folds 
led52: folds 
BlOnDhOlIc: folds 
Dejacob: folds 
GovGus: folds 
chiyuki: folds 
Uncalled bet ($0.40) returned to snejokCoxx
snejokCoxx collected $0.60 from pot
snejokCoxx: doesn't show hand 
*** SUMMARY ***
Total pot $0.60 | Rake $0 
Seat 1: Dejacob (button) folded before Flop (didn't bet)
Seat 2: GovGus (small blind) folded before Flop
Seat 3: chiyuki (big blind) folded before Flop
Seat 4: ZhukOFFskI folded before Flop (didn't bet)
Seat 5: snejokCoxx collected ($0.60)
Seat 6: hirozo folded before Flop (didn't bet)
Seat 7: phate-1up folded before Flop (didn't bet)
Seat 8: led52 folded before Flop (didn't bet)
Seat 9: BlOnDhOlIc folded before Flop (didn't bet)



PokerStars Zoom Hand #84299910081:  Hold'em No Limit ($0.10/$0.25) - 2012/08/05 14:51:40 JST [2012/08/05 1:51:40 ET]
Table 'Whirlpool' 9-max Seat #1 is the button
Seat 1: Nerkit ($9.75 in chips) 
Seat 2: Phaedrus...3 ($25 in chips) 
Seat 3: Lars111 ($30.69 in chips) 
Seat 4: snejokCoxx ($12.20 in chips) 
Seat 5: a_tasmanian ($47.39 in chips) 
Seat 6: chiyuki ($27.56 in chips) 
Seat 7: HighDuka ($27.24 in chips) 
Seat 8: ChrisCDee ($31.16 in chips) 
Seat 9: deadmoneykid ($29.25 in chips) 
Phaedrus...3: posts small blind $0.10
Lars111: posts big blind $0.25
*** HOLE CARDS ***
Dealt to chiyuki [2h Qd]
snejokCoxx: folds 
a_tasmanian: folds 
chiyuki: folds 
HighDuka: raises $0.50 to $0.75
ChrisCDee: folds 
deadmoneykid: folds 
Nerkit: folds 
Phaedrus...3: folds 
Lars111: folds 
Uncalled bet ($0.50) returned to HighDuka
HighDuka collected $0.60 from pot
HighDuka: doesn't show hand 
*** SUMMARY ***
Total pot $0.60 | Rake $0 
Seat 1: Nerkit (button) folded before Flop (didn't bet)
Seat 2: Phaedrus...3 (small blind) folded before Flop
Seat 3: Lars111 (big blind) folded before Flop
Seat 4: snejokCoxx folded before Flop (didn't bet)
Seat 5: a_tasmanian folded before Flop (didn't bet)
Seat 6: chiyuki folded before Flop (didn't bet)
Seat 7: HighDuka collected ($0.60)
Seat 8: ChrisCDee folded before Flop (didn't bet)
Seat 9: deadmoneykid folded before Flop (didn't bet)



PokerStars Zoom Hand #84299902282:  Hold'em No Limit ($0.10/$0.25) - 2012/08/05 14:51:09 JST [2012/08/05 1:51:09 ET]
Table 'Whirlpool' 9-max Seat #1 is the button
Seat 1: deepakmbh ($42.59 in chips) 
Seat 2: el pore 5 ($26.18 in chips) 
Seat 3: KrystalAA ($29.29 in chips) 
Seat 4: Alvinpe85 ($57.54 in chips) 
Seat 5: phate-1up ($25 in chips) 
Seat 6: Walturrr ($26.80 in chips) 
Seat 7: Wilcox76607 ($38.31 in chips) 
Seat 8: troublesomm ($31 in chips) 
Seat 9: chiyuki ($27.81 in chips) 
el pore 5: posts small blind $0.10
KrystalAA: posts big blind $0.25
*** HOLE CARDS ***
Dealt to chiyuki [7d 2d]
Alvinpe85: folds 
phate-1up: folds 
Walturrr: folds 
Wilcox76607: folds 
troublesomm: folds 
chiyuki: folds 
deepakmbh: folds 
el pore 5: calls $0.15
KrystalAA: checks 
*** FLOP *** [6h Kc 3h]
el pore 5: checks 
KrystalAA: bets $0.36
el pore 5: calls $0.36
*** TURN *** [6h Kc 3h] [Js]
el pore 5: checks 
KrystalAA: bets $0.90
el pore 5: calls $0.90
*** RIVER *** [6h Kc 3h Js] [6c]
el pore 5: checks 
KrystalAA: checks 
*** SHOW DOWN ***
el pore 5: shows [Ah 2h] (a pair of Sixes)
KrystalAA: mucks hand 
el pore 5 collected $2.88 from pot
*** SUMMARY ***
Total pot $3.02 | Rake $0.14 
Board [6h Kc 3h Js 6c]
Seat 1: deepakmbh (button) folded before Flop (didn't bet)
Seat 2: el pore 5 (small blind) showed [Ah 2h] and won ($2.88) with a pair of Sixes
Seat 3: KrystalAA (big blind) mucked [4h 5h]
Seat 4: Alvinpe85 folded before Flop (didn't bet)
Seat 5: phate-1up folded before Flop (didn't bet)
Seat 6: Walturrr folded before Flop (didn't bet)
Seat 7: Wilcox76607 folded before Flop (didn't bet)
Seat 8: troublesomm folded before Flop (didn't bet)
Seat 9: chiyuki folded before Flop (didn't bet)



PokerStars Zoom Hand #84299912520:  Hold'em No Limit ($0.10/$0.25) - 2012/08/05 14:51:50 JST [2012/08/05 1:51:50 ET]
Table 'Whirlpool' 9-max Seat #1 is the button
Seat 1: sparky5224 ($38.33 in chips) 
Seat 2: chiyuki ($27.56 in chips) 
Seat 3: 1Karina1 ($29.44 in chips) 
Seat 4: KeLevro0 ($11.93 in chips) 
Seat 5: BlOnDhOlIc ($35.39 in chips) 
Seat 6: deadmoneykid ($22.05 in chips) 
Seat 7: 4plankton ($29.64 in chips) 
Seat 8: ZhukOFFskI ($28.06 in chips) 
Seat 9: kamikkaze ($15 in chips) 
chiyuki: posts small blind $0.10
1Karina1: posts big blind $0.25
*** HOLE CARDS ***
Dealt to chiyuki [4c Qc]
KeLevro0: folds 
BlOnDhOlIc: folds 
deadmoneykid: folds 
4plankton: folds 
ZhukOFFskI: folds 
kamikkaze: folds 
sparky5224: folds 
chiyuki: raises $0.50 to $0.75
1Karina1: folds 
Uncalled bet ($0.50) returned to chiyuki
chiyuki collected $0.50 from pot
chiyuki: doesn't show hand 
*** SUMMARY ***
Total pot $0.50 | Rake $0 
Seat 1: sparky5224 (button) folded before Flop (didn't bet)
Seat 2: chiyuki (small blind) collected ($0.50)
Seat 3: 1Karina1 (big blind) folded before Flop
Seat 4: KeLevro0 folded before Flop (didn't bet)
Seat 5: BlOnDhOlIc folded before Flop (didn't bet)
Seat 6: deadmoneykid folded before Flop (didn't bet)
Seat 7: 4plankton folded before Flop (didn't bet)
Seat 8: ZhukOFFskI folded before Flop (didn't bet)
Seat 9: kamikkaze folded before Flop (didn't bet)



PokerStars Zoom Hand #84299909034:  Hold'em No Limit ($0.10/$0.25) - 2012/08/05 14:51:36 JST [2012/08/05 1:51:36 ET]
Table 'Whirlpool' 9-max Seat #1 is the button
Seat 1: deadmoneykid ($22.05 in chips) 
Seat 2: Wilcox76607 ($37.81 in chips) 
Seat 3: Perstenev ($13.27 in chips) 
Seat 4: chiyuki ($27.56 in chips) 
Seat 5: edilson_ita ($30.20 in chips) 
Seat 6: Alvinpe85 ($58.71 in chips) 
Seat 7: KAKamiro ($25.90 in chips) 
Seat 8: 1Karina1 ($25 in chips) 
Seat 9: KeLevro0 ($12.15 in chips) 
Wilcox76607: posts small blind $0.10
Perstenev: posts big blind $0.25
*** HOLE CARDS ***
Dealt to chiyuki [Td Qc]
chiyuki: folds 
edilson_ita: raises $0.50 to $0.75
Alvinpe85: folds 
KAKamiro: folds 
1Karina1: calls $0.75
KeLevro0: folds 
deadmoneykid: folds 
Wilcox76607: folds 
Perstenev: folds 
*** FLOP *** [5s 9s 7h]
edilson_ita: checks 
1Karina1: checks 
*** TURN *** [5s 9s 7h] [4d]
edilson_ita: checks 
1Karina1: checks 
*** RIVER *** [5s 9s 7h 4d] [Ah]
edilson_ita: bets $0.75
1Karina1: folds 
Uncalled bet ($0.75) returned to edilson_ita
edilson_ita collected $1.77 from pot
edilson_ita: doesn't show hand 
*** SUMMARY ***
Total pot $1.85 | Rake $0.08 
Board [5s 9s 7h 4d Ah]
Seat 1: deadmoneykid (button) folded before Flop (didn't bet)
Seat 2: Wilcox76607 (small blind) folded before Flop
Seat 3: Perstenev (big blind) folded before Flop
Seat 4: chiyuki folded before Flop (didn't bet)
Seat 5: edilson_ita collected ($1.77)
Seat 6: Alvinpe85 folded before Flop (didn't bet)
Seat 7: KAKamiro folded before Flop (didn't bet)
Seat 8: 1Karina1 folded on the River
Seat 9: KeLevro0 folded before Flop (didn't bet)



PokerStars Zoom Hand #84299918989:  Hold'em No Limit ($0.10/$0.25) - 2012/08/05 14:52:17 JST [2012/08/05 1:52:17 ET]
Table 'Whirlpool' 9-max Seat #1 is the button
Seat 1: Gichboy ($12.64 in chips) 
Seat 2: hl77777 ($12.25 in chips) 
Seat 3: led52 ($11.05 in chips) 
Seat 4: snejokCoxx ($11.90 in chips) 
Seat 5: el pore 5 ($27.30 in chips) 
Seat 6: deepakmbh ($21.58 in chips) 
Seat 7: chiyuki ($27.81 in chips) 
Seat 8: a_tasmanian ($46.89 in chips) 
Seat 9: seula i ($26.66 in chips) 
hl77777: posts small blind $0.10
led52: posts big blind $0.25
*** HOLE CARDS ***
Dealt to chiyuki [Ah 8c]
snejokCoxx: folds 
el pore 5: calls $0.25
deepakmbh: folds 
chiyuki: folds 
a_tasmanian: folds 
seula i: folds 
Gichboy: raises $0.50 to $0.75
hl77777: folds 
led52: folds 
el pore 5: calls $0.50
*** FLOP *** [3c 4d 6d]
el pore 5: checks 
Gichboy: bets $1
el pore 5: folds 
Uncalled bet ($1) returned to Gichboy
Gichboy collected $1.77 from pot
Gichboy: doesn't show hand 
*** SUMMARY ***
Total pot $1.85 | Rake $0.08 
Board [3c 4d 6d]
Seat 1: Gichboy (button) collected ($1.77)
Seat 2: hl77777 (small blind) folded before Flop
Seat 3: led52 (big blind) folded before Flop
Seat 4: snejokCoxx folded before Flop (didn't bet)
Seat 5: el pore 5 folded on the Flop
Seat 6: deepakmbh folded before Flop (didn't bet)
Seat 7: chiyuki folded before Flop (didn't bet)
Seat 8: a_tasmanian folded before Flop (didn't bet)
Seat 9: seula i folded before Flop (didn't bet)



PokerStars Zoom Hand #84299924475:  Hold'em No Limit ($0.10/$0.25) - 2012/08/05 14:52:39 JST [2012/08/05 1:52:39 ET]
Table 'Whirlpool' 9-max Seat #1 is the button
Seat 1: seula i ($26.66 in chips) 
Seat 2: ZhukOFFskI ($49.45 in chips) 
Seat 3: GovGus ($28.49 in chips) 
Seat 4: hirozo ($25 in chips) 
Seat 5: chiyuki ($27.81 in chips) 
Seat 6: KrystalAA ($15.11 in chips) 
Seat 7: ChrisCDee ($70.39 in chips) 
Seat 8: led52 ($13.61 in chips) 
Seat 9: hl77777 ($12.15 in chips) 
ZhukOFFskI: posts small blind $0.10
GovGus: posts big blind $0.25
*** HOLE CARDS ***
Dealt to chiyuki [9s 3c]
hirozo: folds 
chiyuki: folds 
KrystalAA: folds 
ChrisCDee: folds 
led52: folds 
hl77777: folds 
seula i: folds 
ZhukOFFskI: folds 
Uncalled bet ($0.15) returned to GovGus
GovGus collected $0.20 from pot
GovGus: doesn't show hand 
*** SUMMARY ***
Total pot $0.20 | Rake $0 
Seat 1: seula i (button) folded before Flop (didn't bet)
Seat 2: ZhukOFFskI (small blind) folded before Flop
Seat 3: GovGus (big blind) collected ($0.20)
Seat 4: hirozo folded before Flop (didn't bet)
Seat 5: chiyuki folded before Flop (didn't bet)
Seat 6: KrystalAA folded before Flop (didn't bet)
Seat 7: ChrisCDee folded before Flop (didn't bet)
Seat 8: led52 folded before Flop (didn't bet)
Seat 9: hl77777 folded before Flop (didn't bet)



PokerStars Zoom Hand #84299921207:  Hold'em No Limit ($0.10/$0.25) - 2012/08/05 14:52:26 JST [2012/08/05 1:52:26 ET]
Table 'Whirlpool' 9-max Seat #1 is the button
Seat 1: chiyuki ($27.81 in chips) 
Seat 2: Alvinpe85 ($58.46 in chips) 
Seat 3: Walturrr ($27.45 in chips) 
Seat 4: Perstenev ($11.92 in chips) 
Seat 5: mjmichi ($25 in chips) 
Seat 6: 1Karina1 ($25 in chips) 
Seat 7: hobby56 ($16.06 in chips) 
Seat 8: peng2astic ($14.97 in chips) 
Seat 9: BlOnDhOlIc ($35.14 in chips) 
Alvinpe85: posts small blind $0.10
Walturrr: posts big blind $0.25
*** HOLE CARDS ***
Dealt to chiyuki [5s Ah]
Perstenev: folds 
mjmichi: folds 
1Karina1: folds 
hobby56: raises $0.25 to $0.50
peng2astic: folds 
BlOnDhOlIc: folds 
chiyuki: folds 
Alvinpe85: calls $0.40
Walturrr: calls $0.25
*** FLOP *** [As 8h 9c]
Alvinpe85: checks 
Walturrr: checks 
hobby56: checks 
*** TURN *** [As 8h 9c] [5d]
Alvinpe85: bets $0.85
Walturrr: folds 
hobby56: folds 
Uncalled bet ($0.85) returned to Alvinpe85
Alvinpe85 collected $1.43 from pot
Alvinpe85: doesn't show hand 
*** SUMMARY ***
Total pot $1.50 | Rake $0.07 
Board [As 8h 9c 5d]
Seat 1: chiyuki (button) folded before Flop (didn't bet)
Seat 2: Alvinpe85 (small blind) collected ($1.43)
Seat 3: Walturrr (big blind) folded on the Turn
Seat 4: Perstenev folded before Flop (didn't bet)
Seat 5: mjmichi folded before Flop (didn't bet)
Seat 6: 1Karina1 folded before Flop (didn't bet)
Seat 7: hobby56 folded on the Turn
Seat 8: peng2astic folded before Flop (didn't bet)
Seat 9: BlOnDhOlIc folded before Flop (didn't bet)



PokerStars Zoom Hand #84299916254:  Hold'em No Limit ($0.10/$0.25) - 2012/08/05 14:52:06 JST [2012/08/05 1:52:06 ET]
Table 'Whirlpool' 9-max Seat #1 is the button
Seat 1: jacquelinewu ($46.58 in chips) 
Seat 2: simonzez ($26.25 in chips) 
Seat 3: phate-1up ($45.74 in chips) 
Seat 4: snejokCoxx ($12.30 in chips) 
Seat 5: oktan60 ($12.31 in chips) 
Seat 6: GovGus ($27.93 in chips) 
Seat 7: Perstenev ($13.52 in chips) 
Seat 8: chiyuki ($27.81 in chips) 
Seat 9: Tom1999 ($21.44 in chips) 
simonzez: posts small blind $0.10
phate-1up: posts big blind $0.25
*** HOLE CARDS ***
Dealt to chiyuki [Qd Ks]
snejokCoxx: raises $0.40 to $0.65
oktan60: folds 
GovGus: folds 
Perstenev: folds 
chiyuki: folds 
Tom1999: calls $0.65
jacquelinewu: folds 
simonzez: calls $0.55
phate-1up: folds 
*** FLOP *** [9d Js 9c]
simonzez: bets $1
snejokCoxx: folds 
Tom1999: calls $1
*** TURN *** [9d Js 9c] [Ts]
simonzez: bets $2
Tom1999: calls $2
*** RIVER *** [9d Js 9c Ts] [7c]
simonzez: bets $3.25
Tom1999: calls $3.25
*** SHOW DOWN ***
simonzez: shows [5d 4h] (a pair of Nines)
Tom1999: shows [Qh Jd] (two pair, Jacks and Nines)
Tom1999 collected $14.04 from pot
*** SUMMARY ***
Total pot $14.70 | Rake $0.66 
Board [9d Js 9c Ts 7c]
Seat 1: jacquelinewu (button) folded before Flop (didn't bet)
Seat 2: simonzez (small blind) showed [5d 4h] and lost with a pair of Nines
Seat 3: phate-1up (big blind) folded before Flop
Seat 4: snejokCoxx folded on the Flop
Seat 5: oktan60 folded before Flop (didn't bet)
Seat 6: GovGus folded before Flop (didn't bet)
Seat 7: Perstenev folded before Flop (didn't bet)
Seat 8: chiyuki folded before Flop (didn't bet)
Seat 9: Tom1999 showed [Qh Jd] and won ($14.04) with two pair, Jacks and Nines



PokerStars Zoom Hand #84299929764:  Hold'em No Limit ($0.10/$0.25) - 2012/08/05 14:53:00 JST [2012/08/05 1:53:00 ET]
Table 'Whirlpool' 9-max Seat #1 is the button
Seat 1: troublesomm ($25 in chips) 
Seat 2: chiyuki ($27.56 in chips) 
Seat 3: seula i ($40.31 in chips) 
Seat 4: deadmoneykid ($29.30 in chips) 
Seat 5: cofla tito ($8.28 in chips) 
Seat 6: phate-1up ($45.39 in chips) 
Seat 7: canammark ($23.90 in chips) 
Seat 8: hl77777 ($12.15 in chips) 
Seat 9: Perstenev ($15.98 in chips) 
chiyuki: posts small blind $0.10
seula i: posts big blind $0.25
*** HOLE CARDS ***
Dealt to chiyuki [8c 4s]
deadmoneykid: folds 
cofla tito: folds 
phate-1up: folds 
canammark: folds 
hl77777: folds 
Perstenev: folds 
troublesomm: folds 
chiyuki: folds 
Uncalled bet ($0.15) returned to seula i
seula i collected $0.20 from pot
seula i: doesn't show hand 
*** SUMMARY ***
Total pot $0.20 | Rake $0 
Seat 1: troublesomm (button) folded before Flop (didn't bet)
Seat 2: chiyuki (small blind) folded before Flop
Seat 3: seula i (big blind) collected ($0.20)
Seat 4: deadmoneykid folded before Flop (didn't bet)
Seat 5: cofla tito folded before Flop (didn't bet)
Seat 6: phate-1up folded before Flop (didn't bet)
Seat 7: canammark folded before Flop (didn't bet)
Seat 8: hl77777 folded before Flop (didn't bet)
Seat 9: Perstenev folded before Flop (didn't bet)



PokerStars Zoom Hand #84299925489:  Hold'em No Limit ($0.10/$0.25) - 2012/08/05 14:52:43 JST [2012/08/05 1:52:43 ET]
Table 'Whirlpool' 9-max Seat #1 is the button
Seat 1: azizmimi ($12.71 in chips) 
Seat 2: KeLevro0 ($11.75 in chips) 
Seat 3: chiyuki ($27.81 in chips) 
Seat 4: KAKamiro ($25.22 in chips) 
Seat 5: BlOnDhOlIc ($82.96 in chips) 
Seat 6: ll_LaMeR_ll ($77.67 in chips) 
Seat 7: 1Karina1 ($29.09 in chips) 
Seat 8: seula i ($26.66 in chips) 
Seat 9: Sal y Limon1 ($24.75 in chips) 
KeLevro0: posts small blind $0.10
chiyuki: posts big blind $0.25
*** HOLE CARDS ***
Dealt to chiyuki [8c Qc]
KAKamiro: folds 
BlOnDhOlIc: folds 
ll_LaMeR_ll: raises $0.50 to $0.75
1Karina1: folds 
seula i: folds 
Sal y Limon1: folds 
azizmimi: calls $0.75
KeLevro0: folds 
chiyuki: folds 
*** FLOP *** [Kc Jc 6c]
ll_LaMeR_ll: bets $1
azizmimi: calls $1
*** TURN *** [Kc Jc 6c] [5d]
ll_LaMeR_ll: bets $2
azizmimi: calls $2
*** RIVER *** [Kc Jc 6c 5d] [4c]
ll_LaMeR_ll: bets $3.75
azizmimi: raises $5.21 to $8.96 and is all-in
ll_LaMeR_ll: folds 
Uncalled bet ($5.21) returned to azizmimi
azizmimi collected $14.66 from pot
azizmimi: doesn't show hand 
*** SUMMARY ***
Total pot $15.35 | Rake $0.69 
Board [Kc Jc 6c 5d 4c]
Seat 1: azizmimi (button) collected ($14.66)
Seat 2: KeLevro0 (small blind) folded before Flop
Seat 3: chiyuki (big blind) folded before Flop
Seat 4: KAKamiro folded before Flop (didn't bet)
Seat 5: BlOnDhOlIc folded before Flop (didn't bet)
Seat 6: ll_LaMeR_ll folded on the River
Seat 7: 1Karina1 folded before Flop (didn't bet)
Seat 8: seula i folded before Flop (didn't bet)
Seat 9: Sal y Limon1 folded before Flop (didn't bet)



PokerStars Zoom Hand #84299933543:  Hold'em No Limit ($0.10/$0.25) - 2012/08/05 14:53:15 JST [2012/08/05 1:53:15 ET]
Table 'Whirlpool' 9-max Seat #1 is the button
Seat 1: Tom1999 ($19.51 in chips) 
Seat 2: hl77777 ($12.15 in chips) 
Seat 3: kesstukas25 ($15 in chips) 
Seat 4: sparky5224 ($37.51 in chips) 
Seat 5: GovGus ($35.40 in chips) 
Seat 6: Walturrr ($26.95 in chips) 
Seat 7: Dan Royal ($44.51 in chips) 
Seat 8: Perstenev ($13.07 in chips) 
Seat 9: chiyuki ($27.46 in chips) 
hl77777: posts small blind $0.10
kesstukas25: posts big blind $0.25
*** HOLE CARDS ***
Dealt to chiyuki [6c 8d]
sparky5224: folds 
GovGus: folds 
Walturrr: folds 
Dan Royal: folds 
Perstenev: folds 
chiyuki: folds 
Tom1999: raises $0.50 to $0.75
hl77777: folds 
kesstukas25: folds 
Uncalled bet ($0.50) returned to Tom1999
Tom1999 collected $0.60 from pot
Tom1999: doesn't show hand 
*** SUMMARY ***
Total pot $0.60 | Rake $0 
Seat 1: Tom1999 (button) collected ($0.60)
Seat 2: hl77777 (small blind) folded before Flop
Seat 3: kesstukas25 (big blind) folded before Flop
Seat 4: sparky5224 folded before Flop (didn't bet)
Seat 5: GovGus folded before Flop (didn't bet)
Seat 6: Walturrr folded before Flop (didn't bet)
Seat 7: Dan Royal folded before Flop (didn't bet)
Seat 8: Perstenev folded before Flop (didn't bet)
Seat 9: chiyuki folded before Flop (didn't bet)



PokerStars Zoom Hand #84299937068:  Hold'em No Limit ($0.10/$0.25) - 2012/08/05 14:53:30 JST [2012/08/05 1:53:30 ET]
Table 'Whirlpool' 9-max Seat #1 is the button
Seat 1: cofla tito ($8.38 in chips) 
Seat 2: kesstukas25 ($14.75 in chips) 
Seat 3: Perstenev ($15.98 in chips) 
Seat 4: Dan Royal ($44.41 in chips) 
Seat 5: phate-1up ($45.39 in chips) 
Seat 6: laurentzu84 ($37.20 in chips) 
Seat 7: chiyuki ($27.46 in chips) 
Seat 8: Landybob ($38.89 in chips) 
Seat 9: 1Karina1 ($28.84 in chips) 
kesstukas25: posts small blind $0.10
Perstenev: posts big blind $0.25
*** HOLE CARDS ***
Dealt to chiyuki [2c Td]
Dan Royal: folds 
phate-1up: folds 
laurentzu84: folds 
chiyuki: folds 
Landybob: folds 
1Karina1: folds 
cofla tito: folds 
kesstukas25: folds 
Uncalled bet ($0.15) returned to Perstenev
Perstenev collected $0.20 from pot
Perstenev: doesn't show hand 
*** SUMMARY ***
Total pot $0.20 | Rake $0 
Seat 1: cofla tito (button) folded before Flop (didn't bet)
Seat 2: kesstukas25 (small blind) folded before Flop
Seat 3: Perstenev (big blind) collected ($0.20)
Seat 4: Dan Royal folded before Flop (didn't bet)
Seat 5: phate-1up folded before Flop (didn't bet)
Seat 6: laurentzu84 folded before Flop (didn't bet)
Seat 7: chiyuki folded before Flop (didn't bet)
Seat 8: Landybob folded before Flop (didn't bet)
Seat 9: 1Karina1 folded before Flop (didn't bet)



PokerStars Zoom Hand #84299935054:  Hold'em No Limit ($0.10/$0.25) - 2012/08/05 14:53:22 JST [2012/08/05 1:53:22 ET]
Table 'Whirlpool' 9-max Seat #1 is the button
Seat 1: chiyuki ($27.46 in chips) 
Seat 2: sparky5224 ($37.51 in chips) 
Seat 3: deadmoneykid ($24.37 in chips) 
Seat 4: ZhukOFFskI ($49.35 in chips) 
Seat 5: bigred1102 ($39.32 in chips) 
Seat 6: Landybob ($38.89 in chips) 
Seat 7: peng2astic ($15.53 in chips) 
Seat 8: PillZ86 ($16.15 in chips) 
Seat 9: DonSimonUsa ($20.57 in chips) 
sparky5224: posts small blind $0.10
deadmoneykid: posts big blind $0.25
*** HOLE CARDS ***
Dealt to chiyuki [2h 9c]
ZhukOFFskI: folds 
bigred1102: raises $0.25 to $0.50
Landybob: folds 
peng2astic: folds 
PillZ86: folds 
DonSimonUsa: folds 
chiyuki: folds 
sparky5224: calls $0.40
deadmoneykid: folds 
*** FLOP *** [5c 4c Kc]
sparky5224: checks 
bigred1102: bets $0.50
sparky5224: folds 
Uncalled bet ($0.50) returned to bigred1102
bigred1102 collected $1.19 from pot
bigred1102: doesn't show hand 
*** SUMMARY ***
Total pot $1.25 | Rake $0.06 
Board [5c 4c Kc]
Seat 1: chiyuki (button) folded before Flop (didn't bet)
Seat 2: sparky5224 (small blind) folded on the Flop
Seat 3: deadmoneykid (big blind) folded before Flop
Seat 4: ZhukOFFskI folded before Flop (didn't bet)
Seat 5: bigred1102 collected ($1.19)
Seat 6: Landybob folded before Flop (didn't bet)
Seat 7: peng2astic folded before Flop (didn't bet)
Seat 8: PillZ86 folded before Flop (didn't bet)
Seat 9: DonSimonUsa folded before Flop (didn't bet)



PokerStars Zoom Hand #84299938481:  Hold'em No Limit ($0.10/$0.25) - 2012/08/05 14:53:36 JST [2012/08/05 1:53:36 ET]
Table 'Whirlpool' 9-max Seat #1 is the button
Seat 1: phate-1up ($45.39 in chips) 
Seat 2: kesstukas25 ($14.75 in chips) 
Seat 3: Tom1999 ($19.86 in chips) 
Seat 4: Sal y Limon1 ($24.75 in chips) 
Seat 5: Jene4kaBest ($17.89 in chips) 
Seat 6: chiyuki ($27.46 in chips) 
Seat 7: snejokCoxx ($11.55 in chips) 
Seat 8: mjmichi ($25.44 in chips) 
Seat 9: hirozo ($53.51 in chips) 
kesstukas25: posts small blind $0.10
Tom1999: posts big blind $0.25
*** HOLE CARDS ***
Dealt to chiyuki [3c As]
Sal y Limon1: folds 
Jene4kaBest: raises $0.50 to $0.75
chiyuki: folds 
snejokCoxx: folds 
mjmichi: folds 
hirozo: folds 
phate-1up: folds 
kesstukas25: folds 
Tom1999: calls $0.50
*** FLOP *** [Th 7h Ts]
Tom1999: checks 
Jene4kaBest: bets $0.50
Tom1999: folds 
Uncalled bet ($0.50) returned to Jene4kaBest
Jene4kaBest collected $1.53 from pot
Jene4kaBest: doesn't show hand 
*** SUMMARY ***
Total pot $1.60 | Rake $0.07 
Board [Th 7h Ts]
Seat 1: phate-1up (button) folded before Flop (didn't bet)
Seat 2: kesstukas25 (small blind) folded before Flop
Seat 3: Tom1999 (big blind) folded on the Flop
Seat 4: Sal y Limon1 folded before Flop (didn't bet)
Seat 5: Jene4kaBest collected ($1.53)
Seat 6: chiyuki folded before Flop (didn't bet)
Seat 7: snejokCoxx folded before Flop (didn't bet)
Seat 8: mjmichi folded before Flop (didn't bet)
Seat 9: hirozo folded before Flop (didn't bet)



PokerStars Zoom Hand #84299932053:  Hold'em No Limit ($0.10/$0.25) - 2012/08/05 14:53:09 JST [2012/08/05 1:53:09 ET]
Table 'Whirlpool' 9-max Seat #1 is the button
Seat 1: simonzez ($19.35 in chips) 
Seat 2: deadmoneykid ($24.47 in chips) 
Seat 3: KrystalAA ($33.59 in chips) 
Seat 4: chiyuki ($27.46 in chips) 
Seat 5: hl77777 ($12.15 in chips) 
Seat 6: Tom1999 ($28.58 in chips) 
Seat 7: Nerkit ($9.75 in chips) 
Seat 8: hirozo ($40.50 in chips) 
Seat 9: snejokCoxx ($11.55 in chips) 
deadmoneykid: posts small blind $0.10
KrystalAA: posts big blind $0.25
*** HOLE CARDS ***
Dealt to chiyuki [Ac 3c]
chiyuki: folds 
hl77777: folds 
Tom1999: folds 
Nerkit: folds 
hirozo: folds 
snejokCoxx: folds 
simonzez: calls $0.25
deadmoneykid: folds 
KrystalAA: checks 
*** FLOP *** [7s 9c Ah]
KrystalAA: checks 
simonzez: checks 
*** TURN *** [7s 9c Ah] [5h]
KrystalAA: checks 
simonzez: checks 
*** RIVER *** [7s 9c Ah 5h] [5s]
KrystalAA: checks 
simonzez: bets $0.50
KrystalAA: folds 
Uncalled bet ($0.50) returned to simonzez
simonzez collected $0.57 from pot
simonzez: doesn't show hand 
*** SUMMARY ***
Total pot $0.60 | Rake $0.03 
Board [7s 9c Ah 5h 5s]
Seat 1: simonzez (button) collected ($0.57)
Seat 2: deadmoneykid (small blind) folded before Flop
Seat 3: KrystalAA (big blind) folded on the River
Seat 4: chiyuki folded before Flop (didn't bet)
Seat 5: hl77777 folded before Flop (didn't bet)
Seat 6: Tom1999 folded before Flop (didn't bet)
Seat 7: Nerkit folded before Flop (didn't bet)
Seat 8: hirozo folded before Flop (didn't bet)
Seat 9: snejokCoxx folded before Flop (didn't bet)



PokerStars Zoom Hand #84299936060:  Hold'em No Limit ($0.10/$0.25) - 2012/08/05 14:53:26 JST [2012/08/05 1:53:26 ET]
Table 'Whirlpool' 9-max Seat #1 is the button
Seat 1: Dejacob ($25 in chips) 
Seat 2: Dan Royal ($44.51 in chips) 
Seat 3: KrystalAA ($28.13 in chips) 
Seat 4: peng2astic ($15.53 in chips) 
Seat 5: Perstenev ($15.98 in chips) 
Seat 6: azizmimi ($19.87 in chips) 
Seat 7: DonSimonUsa ($20.57 in chips) 
Seat 8: chiyuki ($27.46 in chips) 
Seat 9: GovGus ($35.40 in chips) 
Dan Royal: posts small blind $0.10
KrystalAA: posts big blind $0.25
*** HOLE CARDS ***
Dealt to chiyuki [Kh 6c]
peng2astic: folds 
Perstenev: folds 
azizmimi: folds 
DonSimonUsa: raises $0.30 to $0.55
chiyuki: folds 
GovGus: calls $0.55
Dejacob: calls $0.55
Dan Royal: folds 
KrystalAA: calls $0.30
*** FLOP *** [6h 7c Js]
KrystalAA: bets $1.16
DonSimonUsa: folds 
GovGus: folds 
Dejacob: calls $1.16
*** TURN *** [6h 7c Js] [3h]
KrystalAA: bets $3.39
Dejacob: calls $3.39
*** RIVER *** [6h 7c Js 3h] [3d]
KrystalAA: checks 
Dejacob: checks 
*** SHOW DOWN ***
KrystalAA: shows [Jh Kc] (two pair, Jacks and Threes)
Dejacob: mucks hand 
KrystalAA collected $10.89 from pot
*** SUMMARY ***
Total pot $11.40 | Rake $0.51 
Board [6h 7c Js 3h 3d]
Seat 1: Dejacob (button) mucked [7h 9h]
Seat 2: Dan Royal (small blind) folded before Flop
Seat 3: KrystalAA (big blind) showed [Jh Kc] and won ($10.89) with two pair, Jacks and Threes
Seat 4: peng2astic folded before Flop (didn't bet)
Seat 5: Perstenev folded before Flop (didn't bet)
Seat 6: azizmimi folded before Flop (didn't bet)
Seat 7: DonSimonUsa folded on the Flop
Seat 8: chiyuki folded before Flop (didn't bet)
Seat 9: GovGus folded on the Flop



PokerStars Zoom Hand #84299940418:  Hold'em No Limit ($0.10/$0.25) - 2012/08/05 14:53:44 JST [2012/08/05 1:53:44 ET]
Table 'Whirlpool' 9-max Seat #1 is the button
Seat 1: Perstenev ($13.28 in chips) 
Seat 2: BlOnDhOlIc ($82.44 in chips) 
Seat 3: chiyuki ($27.46 in chips) 
Seat 4: slapshot2011 ($52.83 in chips) 
Seat 5: Walturrr ($26.71 in chips) 
Seat 6: deadmoneykid ($24.12 in chips) 
Seat 7: gunbowler ($146.49 in chips) 
Seat 8: phate-1up ($71.68 in chips) 
Seat 9: GovGus ($28.49 in chips) 
BlOnDhOlIc: posts small blind $0.10
chiyuki: posts big blind $0.25
*** HOLE CARDS ***
Dealt to chiyuki [As Qc]
slapshot2011: folds 
Walturrr: folds 
deadmoneykid: folds 
gunbowler: raises $0.50 to $0.75
phate-1up: folds 
GovGus: calls $0.75
Perstenev: folds 
BlOnDhOlIc: folds 
chiyuki: raises $2 to $2.75
gunbowler: calls $2
GovGus: calls $2
*** FLOP *** [4c Jc 4h]
chiyuki: bets $5
gunbowler: calls $5
GovGus: calls $5
*** TURN *** [4c Jc 4h] [Ts]
chiyuki: checks 
gunbowler: checks 
GovGus: checks 
*** RIVER *** [4c Jc 4h Ts] [2d]
chiyuki: checks 
gunbowler: checks 
GovGus: checks 
*** SHOW DOWN ***
chiyuki: shows [As Qc] (a pair of Fours)
gunbowler: shows [Tc Ac] (two pair, Tens and Fours)
GovGus: mucks hand 
gunbowler collected $22.30 from pot
*** SUMMARY ***
Total pot $23.35 | Rake $1.05 
Board [4c Jc 4h Ts 2d]
Seat 1: Perstenev (button) folded before Flop (didn't bet)
Seat 2: BlOnDhOlIc (small blind) folded before Flop
Seat 3: chiyuki (big blind) showed [As Qc] and lost with a pair of Fours
Seat 4: slapshot2011 folded before Flop (didn't bet)
Seat 5: Walturrr folded before Flop (didn't bet)
Seat 6: deadmoneykid folded before Flop (didn't bet)
Seat 7: gunbowler showed [Tc Ac] and won ($22.30) with two pair, Tens and Fours
Seat 8: phate-1up folded before Flop (didn't bet)
Seat 9: GovGus mucked [8c 5c]



PokerStars Zoom Hand #84299960412:  Hold'em No Limit ($0.10/$0.25) - 2012/08/05 14:55:06 JST [2012/08/05 1:55:06 ET]
Table 'Whirlpool' 9-max Seat #1 is the button
Seat 1: gunbowler ($161.04 in chips) 
Seat 2: KrystalAA ($34.27 in chips) 
Seat 3: ChrisCDee ($43.32 in chips) 
Seat 4: DanielWhyte ($51.35 in chips) 
Seat 5: DutchShultzs ($25 in chips) 
Seat 6: GovGus ($25 in chips) 
Seat 7: 4ydo yogurt ($24.94 in chips) 
Seat 8: silvno31 ($23.52 in chips) 
Seat 9: chiyuki ($25 in chips) 
KrystalAA: posts small blind $0.10
ChrisCDee: posts big blind $0.25
*** HOLE CARDS ***
Dealt to chiyuki [Ac Ad]
DanielWhyte: folds 
DutchShultzs: folds 
GovGus: folds 
4ydo yogurt: raises $0.25 to $0.50
silvno31: folds 
chiyuki: raises $1.25 to $1.75
gunbowler: folds 
KrystalAA: folds 
ChrisCDee: folds 
4ydo yogurt: folds 
Uncalled bet ($1.25) returned to chiyuki
chiyuki collected $1.35 from pot
chiyuki: doesn't show hand 
*** SUMMARY ***
Total pot $1.35 | Rake $0 
Seat 1: gunbowler (button) folded before Flop (didn't bet)
Seat 2: KrystalAA (small blind) folded before Flop
Seat 3: ChrisCDee (big blind) folded before Flop
Seat 4: DanielWhyte folded before Flop (didn't bet)
Seat 5: DutchShultzs folded before Flop (didn't bet)
Seat 6: GovGus folded before Flop (didn't bet)
Seat 7: 4ydo yogurt folded before Flop
Seat 8: silvno31 folded before Flop (didn't bet)
Seat 9: chiyuki collected ($1.35)



PokerStars Zoom Hand #84299964736:  Hold'em No Limit ($0.10/$0.25) - 2012/08/05 14:55:25 JST [2012/08/05 1:55:25 ET]
Table 'Whirlpool' 9-max Seat #1 is the button
Seat 1: azizmimi ($18.87 in chips) 
Seat 2: 1Karina1 ($25 in chips) 
Seat 3: deadmoneykid ($28.62 in chips) 
Seat 4: ZhukOFFskI ($28.78 in chips) 
Seat 5: chiyuki ($25.85 in chips) 
Seat 6: canammark ($39.29 in chips) 
Seat 7: ChrisCDee ($30.76 in chips) 
Seat 8: Perstenev ($12.93 in chips) 
Seat 9: led52 ($13.42 in chips) 
1Karina1: posts small blind $0.10
deadmoneykid: posts big blind $0.25
*** HOLE CARDS ***
Dealt to chiyuki [9c Qh]
ZhukOFFskI: folds 
chiyuki: folds 
canammark: folds 
ChrisCDee: folds 
Perstenev: folds 
led52: folds 
azizmimi: folds 
1Karina1: raises $0.50 to $0.75
deadmoneykid: folds 
Uncalled bet ($0.50) returned to 1Karina1
1Karina1 collected $0.50 from pot
1Karina1: doesn't show hand 
*** SUMMARY ***
Total pot $0.50 | Rake $0 
Seat 1: azizmimi (button) folded before Flop (didn't bet)
Seat 2: 1Karina1 (small blind) collected ($0.50)
Seat 3: deadmoneykid (big blind) folded before Flop
Seat 4: ZhukOFFskI folded before Flop (didn't bet)
Seat 5: chiyuki folded before Flop (didn't bet)
Seat 6: canammark folded before Flop (didn't bet)
Seat 7: ChrisCDee folded before Flop (didn't bet)
Seat 8: Perstenev folded before Flop (didn't bet)
Seat 9: led52 folded before Flop (didn't bet)



PokerStars Zoom Hand #84299967525:  Hold'em No Limit ($0.10/$0.25) - 2012/08/05 14:55:39 JST [2012/08/05 1:55:39 ET]
Table 'Whirlpool' 9-max Seat #1 is the button
Seat 1: 1Karina1 ($25.35 in chips) 
Seat 2: chiyuki ($25.85 in chips) 
Seat 3: Jene4kaBest ($16.92 in chips) 
Seat 4: Nerkit ($14.98 in chips) 
Seat 5: phate-1up ($69.78 in chips) 
Seat 6: DutchShultzs ($25 in chips) 
Seat 7: hl77777 ($12.50 in chips) 
Seat 8: Dejacob ($25 in chips) 
Seat 9: azizmimi ($18.87 in chips) 
chiyuki: posts small blind $0.10
Jene4kaBest: posts big blind $0.25
*** HOLE CARDS ***
Dealt to chiyuki [Jh 2s]
Nerkit: folds 
phate-1up: folds 
DutchShultzs: folds 
hl77777: folds 
Dejacob: folds 
azizmimi: folds 
1Karina1: folds 
chiyuki: folds 
Uncalled bet ($0.15) returned to Jene4kaBest
Jene4kaBest collected $0.20 from pot
Jene4kaBest: doesn't show hand 
*** SUMMARY ***
Total pot $0.20 | Rake $0 
Seat 1: 1Karina1 (button) folded before Flop (didn't bet)
Seat 2: chiyuki (small blind) folded before Flop
Seat 3: Jene4kaBest (big blind) collected ($0.20)
Seat 4: Nerkit folded before Flop (didn't bet)
Seat 5: phate-1up folded before Flop (didn't bet)
Seat 6: DutchShultzs folded before Flop (didn't bet)
Seat 7: hl77777 folded before Flop (didn't bet)
Seat 8: Dejacob folded before Flop (didn't bet)
Seat 9: azizmimi folded before Flop (didn't bet)



PokerStars Zoom Hand #84299970548:  Hold'em No Limit ($0.10/$0.25) - 2012/08/05 14:55:55 JST [2012/08/05 1:55:55 ET]
Table 'Whirlpool' 9-max Seat #1 is the button
Seat 1: laurentzu84 ($34.85 in chips) 
Seat 2: Cyanidoff ($26.24 in chips) 
Seat 3: DutchShultzs ($28.31 in chips) 
Seat 4: Dafleche ($20.46 in chips) 
Seat 5: Landybob ($40.82 in chips) 
Seat 6: Dejacob ($35.96 in chips) 
Seat 7: troublesomm ($32.84 in chips) 
Seat 8: chiyuki ($25.75 in chips) 
Seat 9: KrystalAA ($14.51 in chips) 
Cyanidoff: posts small blind $0.10
DutchShultzs: posts big blind $0.25
*** HOLE CARDS ***
Dealt to chiyuki [4d Js]
Dafleche: folds 
Landybob: folds 
Dejacob: folds 
troublesomm: folds 
chiyuki: folds 
KrystalAA: folds 
laurentzu84: folds 
Cyanidoff: folds 
Uncalled bet ($0.15) returned to DutchShultzs
DutchShultzs collected $0.20 from pot
DutchShultzs: doesn't show hand 
*** SUMMARY ***
Total pot $0.20 | Rake $0 
Seat 1: laurentzu84 (button) folded before Flop (didn't bet)
Seat 2: Cyanidoff (small blind) folded before Flop
Seat 3: DutchShultzs (big blind) collected ($0.20)
Seat 4: Dafleche folded before Flop (didn't bet)
Seat 5: Landybob folded before Flop (didn't bet)
Seat 6: Dejacob folded before Flop (didn't bet)
Seat 7: troublesomm folded before Flop (didn't bet)
Seat 8: chiyuki folded before Flop (didn't bet)
Seat 9: KrystalAA folded before Flop (didn't bet)



PokerStars Zoom Hand #84299968539:  Hold'em No Limit ($0.10/$0.25) - 2012/08/05 14:55:45 JST [2012/08/05 1:55:45 ET]
Table 'Whirlpool' 9-max Seat #1 is the button
Seat 1: miramax89 ($20.62 in chips) 
Seat 2: jacquelinewu ($47 in chips) 
Seat 3: Nerkit ($12.50 in chips) 
Seat 4: chiyuki ($25.75 in chips) 
Seat 5: 1Karina1 ($25 in chips) 
Seat 6: phate-1up ($30.62 in chips) 
Seat 7: ChrisCDee ($69.04 in chips) 
Seat 8: hl77777 ($12.50 in chips) 
Seat 9: Sal y Limon1 ($24.75 in chips) 
jacquelinewu: posts small blind $0.10
Nerkit: posts big blind $0.25
*** HOLE CARDS ***
Dealt to chiyuki [4c 4h]
chiyuki: folds 
1Karina1: folds 
phate-1up: folds 
ChrisCDee: folds 
hl77777: folds 
Sal y Limon1: folds 
miramax89: folds 
jacquelinewu: raises $0.50 to $0.75
Nerkit: folds 
Uncalled bet ($0.50) returned to jacquelinewu
jacquelinewu collected $0.50 from pot
jacquelinewu: doesn't show hand 
*** SUMMARY ***
Total pot $0.50 | Rake $0 
Seat 1: miramax89 (button) folded before Flop (didn't bet)
Seat 2: jacquelinewu (small blind) collected ($0.50)
Seat 3: Nerkit (big blind) folded before Flop
Seat 4: chiyuki folded before Flop (didn't bet)
Seat 5: 1Karina1 folded before Flop (didn't bet)
Seat 6: phate-1up folded before Flop (didn't bet)
Seat 7: ChrisCDee folded before Flop (didn't bet)
Seat 8: hl77777 folded before Flop (didn't bet)
Seat 9: Sal y Limon1 folded before Flop (didn't bet)



PokerStars Zoom Hand #84299969593:  Hold'em No Limit ($0.10/$0.25) - 2012/08/05 14:55:50 JST [2012/08/05 1:55:50 ET]
Table 'Whirlpool' 9-max Seat #1 is the button
Seat 1: Nerkit ($14.98 in chips) 
Seat 2: snejokCoxx ($12.35 in chips) 
Seat 3: Nagibator441 ($10.64 in chips) 
Seat 4: kesstukas25 ($15.84 in chips) 
Seat 5: jacquelinewu ($28.32 in chips) 
Seat 6: azizmimi ($18.87 in chips) 
Seat 7: chiyuki ($25.75 in chips) 
Seat 8: troublesomm ($32.84 in chips) 
Seat 9: ChrisCDee ($42.97 in chips) 
snejokCoxx: posts small blind $0.10
Nagibator441: posts big blind $0.25
*** HOLE CARDS ***
Dealt to chiyuki [6s Jh]
kesstukas25: folds 
jacquelinewu: raises $0.50 to $0.75
azizmimi: folds 
chiyuki: folds 
troublesomm: folds 
ChrisCDee: folds 
Nerkit: calls $0.75
snejokCoxx: folds 
Nagibator441: folds 
*** FLOP *** [8s 2c 5d]
jacquelinewu: bets $1.25
Nerkit: folds 
Uncalled bet ($1.25) returned to jacquelinewu
jacquelinewu collected $1.77 from pot
jacquelinewu: doesn't show hand 
*** SUMMARY ***
Total pot $1.85 | Rake $0.08 
Board [8s 2c 5d]
Seat 1: Nerkit (button) folded on the Flop
Seat 2: snejokCoxx (small blind) folded before Flop
Seat 3: Nagibator441 (big blind) folded before Flop
Seat 4: kesstukas25 folded before Flop (didn't bet)
Seat 5: jacquelinewu collected ($1.77)
Seat 6: azizmimi folded before Flop (didn't bet)
Seat 7: chiyuki folded before Flop (didn't bet)
Seat 8: troublesomm folded before Flop (didn't bet)
Seat 9: ChrisCDee folded before Flop (didn't bet)



PokerStars Zoom Hand #84299972220:  Hold'em No Limit ($0.10/$0.25) - 2012/08/05 14:56:04 JST [2012/08/05 1:56:04 ET]
Table 'Whirlpool' 9-max Seat #1 is the button
Seat 1: KeLevro0 ($11.33 in chips) 
Seat 2: 4ydo yogurt ($23.69 in chips) 
Seat 3: slapshot2011 ($49.98 in chips) 
Seat 4: troublesomm ($32.84 in chips) 
Seat 5: chiyuki ($25.75 in chips) 
Seat 6: ZhukOFFskI ($48.50 in chips) 
Seat 7: deadmoneykid ($25.68 in chips) 
Seat 8: Alvinpe85 ($50.02 in chips) 
Seat 9: hirozo ($65.88 in chips) 
4ydo yogurt: posts small blind $0.10
slapshot2011: posts big blind $0.25
*** HOLE CARDS ***
Dealt to chiyuki [Jc Ah]
troublesomm: folds 
chiyuki: raises $0.50 to $0.75
ZhukOFFskI: folds 
deadmoneykid: folds 
Alvinpe85: calls $0.75
hirozo: calls $0.75
KeLevro0: folds 
4ydo yogurt: calls $0.65
slapshot2011: folds 
*** FLOP *** [4c As 2h]
4ydo yogurt: checks 
chiyuki: bets $1.75
Alvinpe85: folds 
hirozo: calls $1.75
4ydo yogurt: calls $1.75
*** TURN *** [4c As 2h] [5d]
4ydo yogurt: checks 
chiyuki: checks 
hirozo: checks 
*** RIVER *** [4c As 2h 5d] [3c]
4ydo yogurt: checks 
chiyuki: checks 
hirozo: bets $5.42
4ydo yogurt: folds 
chiyuki: folds 
Uncalled bet ($5.42) returned to hirozo
hirozo collected $8.12 from pot
hirozo: doesn't show hand 
*** SUMMARY ***
Total pot $8.50 | Rake $0.38 
Board [4c As 2h 5d 3c]
Seat 1: KeLevro0 (button) folded before Flop (didn't bet)
Seat 2: 4ydo yogurt (small blind) folded on the River
Seat 3: slapshot2011 (big blind) folded before Flop
Seat 4: troublesomm folded before Flop (didn't bet)
Seat 5: chiyuki folded on the River
Seat 6: ZhukOFFskI folded before Flop (didn't bet)
Seat 7: deadmoneykid folded before Flop (didn't bet)
Seat 8: Alvinpe85 folded on the Flop
Seat 9: hirozo collected ($8.12)



PokerStars Zoom Hand #84299989972:  Hold'em No Limit ($0.10/$0.25) - 2012/08/05 14:57:34 JST [2012/08/05 1:57:34 ET]
Table 'Whirlpool' 9-max Seat #1 is the button
Seat 1: chiyuki ($23.25 in chips) 
Seat 2: kamikkaze ($15.10 in chips) 
Seat 3: Cyanidoff ($26.31 in chips) 
Seat 4: 1Karina1 ($25.10 in chips) 
Seat 5: DutchShultzs ($34.55 in chips) 
Seat 6: troublesomm ($25.77 in chips) 
Seat 7: Wilcox76607 ($36.06 in chips) 
Seat 8: deepakmbh ($54.72 in chips) 
Seat 9: hobby56 ($14.11 in chips) 
kamikkaze: posts small blind $0.10
Cyanidoff: posts big blind $0.25
*** HOLE CARDS ***
Dealt to chiyuki [Ad 8c]
1Karina1: folds 
DutchShultzs: folds 
troublesomm: folds 
Wilcox76607: folds 
deepakmbh: folds 
hobby56: raises $0.25 to $0.50
chiyuki: folds 
kamikkaze: folds 
Cyanidoff: folds 
Uncalled bet ($0.25) returned to hobby56
hobby56 collected $0.60 from pot
hobby56: doesn't show hand 
*** SUMMARY ***
Total pot $0.60 | Rake $0 
Seat 1: chiyuki (button) folded before Flop (didn't bet)
Seat 2: kamikkaze (small blind) folded before Flop
Seat 3: Cyanidoff (big blind) folded before Flop
Seat 4: 1Karina1 folded before Flop (didn't bet)
Seat 5: DutchShultzs folded before Flop (didn't bet)
Seat 6: troublesomm folded before Flop (didn't bet)
Seat 7: Wilcox76607 folded before Flop (didn't bet)
Seat 8: deepakmbh folded before Flop (didn't bet)
Seat 9: hobby56 collected ($0.60)



PokerStars Zoom Hand #84299988803:  Hold'em No Limit ($0.10/$0.25) - 2012/08/05 14:57:28 JST [2012/08/05 1:57:28 ET]
Table 'Whirlpool' 9-max Seat #1 is the button
Seat 1: Perstenev ($13 in chips) 
Seat 2: hirozo ($74.86 in chips) 
Seat 3: turbotom122 ($13.85 in chips) 
Seat 4: 4plankton ($27.33 in chips) 
Seat 5: snejokCoxx ($10.35 in chips) 
Seat 6: chiyuki ($23.25 in chips) 
Seat 7: 1Karina1 ($25 in chips) 
Seat 8: seula i ($42.54 in chips) 
Seat 9: KrystalAA ($33.94 in chips) 
hirozo: posts small blind $0.10
turbotom122: posts big blind $0.25
*** HOLE CARDS ***
Dealt to chiyuki [5s Ad]
4plankton: folds 
snejokCoxx: folds 
chiyuki: folds 
1Karina1: folds 
seula i: folds 
KrystalAA: folds 
Perstenev: folds 
hirozo: raises $0.25 to $0.50
turbotom122: raises $1.50 to $2
hirozo: folds 
Uncalled bet ($1.50) returned to turbotom122
turbotom122 collected $1 from pot
turbotom122: doesn't show hand 
*** SUMMARY ***
Total pot $1 | Rake $0 
Seat 1: Perstenev (button) folded before Flop (didn't bet)
Seat 2: hirozo (small blind) folded before Flop
Seat 3: turbotom122 (big blind) collected ($1)
Seat 4: 4plankton folded before Flop (didn't bet)
Seat 5: snejokCoxx folded before Flop (didn't bet)
Seat 6: chiyuki folded before Flop (didn't bet)
Seat 7: 1Karina1 folded before Flop (didn't bet)
Seat 8: seula i folded before Flop (didn't bet)
Seat 9: KrystalAA folded before Flop (didn't bet)



PokerStars Zoom Hand #84300000873:  Hold'em No Limit ($0.10/$0.25) - 2012/08/05 14:58:29 JST [2012/08/05 1:58:29 ET]
Table 'Whirlpool' 9-max Seat #1 is the button
Seat 1: azizmimi ($21.55 in chips) 
Seat 2: chiyuki ($23 in chips) 
Seat 3: GovGus ($36.29 in chips) 
Seat 4: Jene4kaBest ($15.77 in chips) 
Seat 5: snejokCoxx ($10 in chips) 
Seat 6: Vahe50 ($9.79 in chips) 
Seat 7: DutchShultzs ($25 in chips) 
Seat 8: hirozo ($74.36 in chips) 
Seat 9: seula i ($107.71 in chips) 
chiyuki: posts small blind $0.10
GovGus: posts big blind $0.25
*** HOLE CARDS ***
Dealt to chiyuki [5h Ts]
Jene4kaBest: folds 
snejokCoxx: folds 
Vahe50: folds 
DutchShultzs: folds 
hirozo: folds 
seula i: folds 
azizmimi: folds 
chiyuki: folds 
Uncalled bet ($0.15) returned to GovGus
GovGus collected $0.20 from pot
GovGus: doesn't show hand 
*** SUMMARY ***
Total pot $0.20 | Rake $0 
Seat 1: azizmimi (button) folded before Flop (didn't bet)
Seat 2: chiyuki (small blind) folded before Flop
Seat 3: GovGus (big blind) collected ($0.20)
Seat 4: Jene4kaBest folded before Flop (didn't bet)
Seat 5: snejokCoxx folded before Flop (didn't bet)
Seat 6: Vahe50 folded before Flop (didn't bet)
Seat 7: DutchShultzs folded before Flop (didn't bet)
Seat 8: hirozo folded before Flop (didn't bet)
Seat 9: seula i folded before Flop (didn't bet)



PokerStars Zoom Hand #84299994221:  Hold'em No Limit ($0.10/$0.25) - 2012/08/05 14:57:55 JST [2012/08/05 1:57:55 ET]
Table 'Whirlpool' 9-max Seat #1 is the button
Seat 1: 1Karina1 ($25 in chips) 
Seat 2: Perstenev ($15.65 in chips) 
Seat 3: chiyuki ($23.25 in chips) 
Seat 4: deadmoneykid ($28.95 in chips) 
Seat 5: DutchShultzs ($29.21 in chips) 
Seat 6: seula i ($25.13 in chips) 
Seat 7: jacquelinewu ($48.44 in chips) 
Seat 8: empfang ($22.56 in chips) 
Seat 9: KrystalAA ($15.09 in chips) 
Perstenev: posts small blind $0.10
chiyuki: posts big blind $0.25
*** HOLE CARDS ***
Dealt to chiyuki [8s 5d]
deadmoneykid: folds 
DutchShultzs: folds 
seula i: folds 
jacquelinewu: folds 
empfang: calls $0.25
KrystalAA: calls $0.25
1Karina1: folds 
Perstenev: raises $1.25 to $1.50
chiyuki: folds 
empfang: calls $1.25
KrystalAA: calls $1.25
*** FLOP *** [9c Td 2d]
Perstenev: bets $3.40
empfang: folds 
KrystalAA: calls $3.40
*** TURN *** [9c Td 2d] [Th]
Perstenev: bets $10.75 and is all-in
KrystalAA: calls $10.19 and is all-in
Uncalled bet ($0.56) returned to Perstenev
*** RIVER *** [9c Td 2d Th] [Kh]
*** SHOW DOWN ***
Perstenev: shows [Ac Ad] (two pair, Aces and Tens)
KrystalAA: shows [9d 9h] (a full house, Nines full of Tens)
KrystalAA collected $30.49 from pot
*** SUMMARY ***
Total pot $31.93 | Rake $1.44 
Board [9c Td 2d Th Kh]
Seat 1: 1Karina1 (button) folded before Flop (didn't bet)
Seat 2: Perstenev (small blind) showed [Ac Ad] and lost with two pair, Aces and Tens
Seat 3: chiyuki (big blind) folded before Flop
Seat 4: deadmoneykid folded before Flop (didn't bet)
Seat 5: DutchShultzs folded before Flop (didn't bet)
Seat 6: seula i folded before Flop (didn't bet)
Seat 7: jacquelinewu folded before Flop (didn't bet)
Seat 8: empfang folded on the Flop
Seat 9: KrystalAA showed [9d 9h] and won ($30.49) with a full house, Nines full of Tens



PokerStars Zoom Hand #84299997493:  Hold'em No Limit ($0.10/$0.25) - 2012/08/05 14:58:12 JST [2012/08/05 1:58:12 ET]
Table 'Whirlpool' 9-max Seat #1 is the button
Seat 1: 1Karina1 ($25.10 in chips) 
Seat 2: deadmoneykid ($27.64 in chips) 
Seat 3: jacquelinewu ($48.44 in chips) 
Seat 4: Tom1999 ($22.47 in chips) 
Seat 5: Paranoix1990 ($22.88 in chips) 
Seat 6: kamikkaze ($15 in chips) 
Seat 7: hobby56 ($14.46 in chips) 
Seat 8: DutchShultzs ($25 in chips) 
Seat 9: chiyuki ($23 in chips) 
deadmoneykid: posts small blind $0.10
jacquelinewu: posts big blind $0.25
*** HOLE CARDS ***
Dealt to chiyuki [7c 4h]
Tom1999: folds 
Paranoix1990: folds 
kamikkaze: folds 
hobby56: folds 
DutchShultzs: folds 
chiyuki: folds 
1Karina1: folds 
deadmoneykid: calls $0.15
jacquelinewu: checks 
*** FLOP *** [Td Ad Ts]
deadmoneykid: bets $0.25
jacquelinewu: folds 
Uncalled bet ($0.25) returned to deadmoneykid
deadmoneykid collected $0.48 from pot
deadmoneykid: doesn't show hand 
*** SUMMARY ***
Total pot $0.50 | Rake $0.02 
Board [Td Ad Ts]
Seat 1: 1Karina1 (button) folded before Flop (didn't bet)
Seat 2: deadmoneykid (small blind) collected ($0.48)
Seat 3: jacquelinewu (big blind) folded on the Flop
Seat 4: Tom1999 folded before Flop (didn't bet)
Seat 5: Paranoix1990 folded before Flop (didn't bet)
Seat 6: kamikkaze folded before Flop (didn't bet)
Seat 7: hobby56 folded before Flop (didn't bet)
Seat 8: DutchShultzs folded before Flop (didn't bet)
Seat 9: chiyuki folded before Flop (didn't bet)



PokerStars Zoom Hand #84299999682:  Hold'em No Limit ($0.10/$0.25) - 2012/08/05 14:58:23 JST [2012/08/05 1:58:23 ET]
Table 'Whirlpool' 9-max Seat #1 is the button
Seat 1: troublesomm ($26.54 in chips) 
Seat 2: Alvinpe85 ($49.02 in chips) 
Seat 3: Nerkit ($14.25 in chips) 
Seat 4: DutchShultzs ($25 in chips) 
Seat 5: chiyuki ($23 in chips) 
Seat 6: pativyko ($7.97 in chips) 
Seat 7: Perstenev ($13.45 in chips) 
Seat 8: Phaedrus...3 ($23.18 in chips) 
Seat 9: hirozo ($71.40 in chips) 
Alvinpe85: posts small blind $0.10
Nerkit: posts big blind $0.25
*** HOLE CARDS ***
Dealt to chiyuki [5c Jc]
DutchShultzs: folds 
chiyuki: folds 
pativyko: folds 
Perstenev: folds 
Phaedrus...3: folds 
hirozo: raises $0.50 to $0.75
troublesomm: folds 
Alvinpe85: folds 
Nerkit: calls $0.50
*** FLOP *** [Jh 2s 8h]
Nerkit: checks 
hirozo: bets $1.02
Nerkit: folds 
Uncalled bet ($1.02) returned to hirozo
hirozo collected $1.53 from pot
hirozo: doesn't show hand 
*** SUMMARY ***
Total pot $1.60 | Rake $0.07 
Board [Jh 2s 8h]
Seat 1: troublesomm (button) folded before Flop (didn't bet)
Seat 2: Alvinpe85 (small blind) folded before Flop
Seat 3: Nerkit (big blind) folded on the Flop
Seat 4: DutchShultzs folded before Flop (didn't bet)
Seat 5: chiyuki folded before Flop (didn't bet)
Seat 6: pativyko folded before Flop (didn't bet)
Seat 7: Perstenev folded before Flop (didn't bet)
Seat 8: Phaedrus...3 folded before Flop (didn't bet)
Seat 9: hirozo collected ($1.53)



PokerStars Zoom Hand #84299998685:  Hold'em No Limit ($0.10/$0.25) - 2012/08/05 14:58:18 JST [2012/08/05 1:58:18 ET]
Table 'Whirlpool' 9-max Seat #1 is the button
Seat 1: Phaedrus...3 ($23.18 in chips) 
Seat 2: 1Karina1 ($25.10 in chips) 
Seat 3: Tom1999 ($22.47 in chips) 
Seat 4: Alvinpe85 ($49.02 in chips) 
Seat 5: GovGus ($25.43 in chips) 
Seat 6: troublesomm ($26.54 in chips) 
Seat 7: kamikkaze ($15 in chips) 
Seat 8: chiyuki ($23 in chips) 
Seat 9: Dejacob ($47.26 in chips) 
1Karina1: posts small blind $0.10
Tom1999: posts big blind $0.25
*** HOLE CARDS ***
Dealt to chiyuki [Th 6h]
Alvinpe85: folds 
GovGus: raises $0.50 to $0.75
troublesomm: folds 
kamikkaze: calls $0.75
chiyuki: folds 
Dejacob: folds 
Phaedrus...3: folds 
1Karina1: folds 
Tom1999: folds 
*** FLOP *** [9s 9d 8s]
GovGus: bets $1.15
kamikkaze: folds 
Uncalled bet ($1.15) returned to GovGus
GovGus collected $1.77 from pot
GovGus: doesn't show hand 
*** SUMMARY ***
Total pot $1.85 | Rake $0.08 
Board [9s 9d 8s]
Seat 1: Phaedrus...3 (button) folded before Flop (didn't bet)
Seat 2: 1Karina1 (small blind) folded before Flop
Seat 3: Tom1999 (big blind) folded before Flop
Seat 4: Alvinpe85 folded before Flop (didn't bet)
Seat 5: GovGus collected ($1.77)
Seat 6: troublesomm folded before Flop (didn't bet)
Seat 7: kamikkaze folded on the Flop
Seat 8: chiyuki folded before Flop (didn't bet)
Seat 9: Dejacob folded before Flop (didn't bet)



PokerStars Zoom Hand #84300002464:  Hold'em No Limit ($0.10/$0.25) - 2012/08/05 14:58:37 JST [2012/08/05 1:58:37 ET]
Table 'Whirlpool' 9-max Seat #1 is the button
Seat 1: kamikkaze ($28.78 in chips) 
Seat 2: DutchShultzs ($25 in chips) 
Seat 3: Vahe50 ($9.79 in chips) 
Seat 4: chiyuki ($22.90 in chips) 
Seat 5: Cyanidoff ($25.31 in chips) 
Seat 6: KeLevro0 ($12.15 in chips) 
Seat 7: hirozo ($74.36 in chips) 
Seat 8: deepakmbh ($25 in chips) 
Seat 9: phate-1up ($34.74 in chips) 
DutchShultzs: posts small blind $0.10
Vahe50: posts big blind $0.25
*** HOLE CARDS ***
Dealt to chiyuki [3d Th]
chiyuki: folds 
Cyanidoff: folds 
KeLevro0: folds 
hirozo: folds 
deepakmbh: raises $0.45 to $0.70
phate-1up: folds 
kamikkaze: folds 
DutchShultzs: folds 
Vahe50: raises $1.80 to $2.50
deepakmbh: folds 
Uncalled bet ($1.80) returned to Vahe50
Vahe50 collected $1.50 from pot
Vahe50: doesn't show hand 
*** SUMMARY ***
Total pot $1.50 | Rake $0 
Seat 1: kamikkaze (button) folded before Flop (didn't bet)
Seat 2: DutchShultzs (small blind) folded before Flop
Seat 3: Vahe50 (big blind) collected ($1.50)
Seat 4: chiyuki folded before Flop (didn't bet)
Seat 5: Cyanidoff folded before Flop (didn't bet)
Seat 6: KeLevro0 folded before Flop (didn't bet)
Seat 7: hirozo folded before Flop (didn't bet)
Seat 8: deepakmbh folded before Flop
Seat 9: phate-1up folded before Flop (didn't bet)



PokerStars Zoom Hand #84300003268:  Hold'em No Limit ($0.10/$0.25) - 2012/08/05 14:58:41 JST [2012/08/05 1:58:41 ET]
Table 'Whirlpool' 9-max Seat #1 is the button
Seat 1: Perstenev ($0.56 in chips) 
Seat 2: jacquelinewu ($33.93 in chips) 
Seat 3: 1Karina1 ($25 in chips) 
Seat 4: deadmoneykid ($27.27 in chips) 
Seat 5: phate-1up ($69.33 in chips) 
Seat 6: GovGus ($36.39 in chips) 
Seat 7: chiyuki ($22.90 in chips) 
Seat 8: KrystalAA ($30.49 in chips) 
Seat 9: snejokCoxx ($10 in chips) 
jacquelinewu: posts small blind $0.10
1Karina1: posts big blind $0.25
*** HOLE CARDS ***
Dealt to chiyuki [Kd 3h]
deadmoneykid: folds 
phate-1up: raises $0.50 to $0.75
GovGus: folds 
chiyuki: folds 
KrystalAA: folds 
snejokCoxx: folds 
Perstenev: folds 
jacquelinewu: folds 
1Karina1: folds 
Uncalled bet ($0.50) returned to phate-1up
phate-1up collected $0.60 from pot
phate-1up: doesn't show hand 
*** SUMMARY ***
Total pot $0.60 | Rake $0 
Seat 1: Perstenev (button) folded before Flop (didn't bet)
Seat 2: jacquelinewu (small blind) folded before Flop
Seat 3: 1Karina1 (big blind) folded before Flop
Seat 4: deadmoneykid folded before Flop (didn't bet)
Seat 5: phate-1up collected ($0.60)
Seat 6: GovGus folded before Flop (didn't bet)
Seat 7: chiyuki folded before Flop (didn't bet)
Seat 8: KrystalAA folded before Flop (didn't bet)
Seat 9: snejokCoxx folded before Flop (didn't bet)



PokerStars Zoom Hand #84300005628:  Hold'em No Limit ($0.10/$0.25) - 2012/08/05 14:58:53 JST [2012/08/05 1:58:53 ET]
Table 'Whirlpool' 9-max Seat #1 is the button
Seat 1: chiyuki ($22.90 in chips) 
Seat 2: Dejacob ($25.94 in chips) 
Seat 3: Perstenev ($9.29 in chips) 
Seat 4: GovGus ($26.45 in chips) 
Seat 5: snejokCoxx ($11.53 in chips) 
Seat 6: DutchShultzs ($25 in chips) 
Seat 7: hirozo ($74.36 in chips) 
Seat 8: Jene4kaBest ($15.67 in chips) 
Seat 9: PillZ86 ($13.05 in chips) 
Dejacob: posts small blind $0.10
Perstenev: posts big blind $0.25
*** HOLE CARDS ***
Dealt to chiyuki [8h Qd]
GovGus: folds 
snejokCoxx: raises $0.40 to $0.65
DutchShultzs: raises $1.05 to $1.70
hirozo: folds 
Jene4kaBest: folds 
PillZ86: folds 
chiyuki: folds 
Dejacob: folds 
Perstenev: folds 
snejokCoxx: folds 
Uncalled bet ($1.05) returned to DutchShultzs
DutchShultzs collected $1.65 from pot
DutchShultzs: doesn't show hand 
*** SUMMARY ***
Total pot $1.65 | Rake $0 
Seat 1: chiyuki (button) folded before Flop (didn't bet)
Seat 2: Dejacob (small blind) folded before Flop
Seat 3: Perstenev (big blind) folded before Flop
Seat 4: GovGus folded before Flop (didn't bet)
Seat 5: snejokCoxx folded before Flop
Seat 6: DutchShultzs collected ($1.65)
Seat 7: hirozo folded before Flop (didn't bet)
Seat 8: Jene4kaBest folded before Flop (didn't bet)
Seat 9: PillZ86 folded before Flop (didn't bet)



PokerStars Zoom Hand #84300008175:  Hold'em No Limit ($0.10/$0.25) - 2012/08/05 14:59:06 JST [2012/08/05 1:59:06 ET]
Table 'Whirlpool' 9-max Seat #1 is the button
Seat 1: ZhukOFFskI ($28.30 in chips) 
Seat 2: Streikel ($20.39 in chips) 
Seat 3: chiyuki ($22.90 in chips) 
Seat 4: jacquelinewu ($48.09 in chips) 
Seat 5: Vahe50 ($10.59 in chips) 
Seat 6: kaplya2010 ($15.14 in chips) 
Seat 7: Tom1999 ($22.12 in chips) 
Seat 8: KeLevro0 ($10.08 in chips) 
Seat 9: turbotom122 ($13.20 in chips) 
Streikel: posts small blind $0.10
chiyuki: posts big blind $0.25
*** HOLE CARDS ***
Dealt to chiyuki [Kd Kh]
jacquelinewu: folds 
Vahe50: folds 
kaplya2010: folds 
Tom1999: raises $0.50 to $0.75
KeLevro0: folds 
turbotom122: folds 
ZhukOFFskI: folds 
Streikel: calls $0.65
chiyuki: raises $2 to $2.75
Tom1999: calls $2
Streikel: calls $2
*** FLOP *** [Qc Ac Qs]
Streikel: checks 
chiyuki: checks 
Tom1999: checks 
*** TURN *** [Qc Ac Qs] [4c]
Streikel: checks 
chiyuki: checks 
Tom1999: bets $0.50
Streikel: calls $0.50
chiyuki: calls $0.50
*** RIVER *** [Qc Ac Qs 4c] [5s]
Streikel: checks 
chiyuki: checks 
Tom1999: bets $4.25
Streikel: folds 
chiyuki: folds 
Uncalled bet ($4.25) returned to Tom1999
Tom1999 collected $9.31 from pot
Tom1999: doesn't show hand 
*** SUMMARY ***
Total pot $9.75 | Rake $0.44 
Board [Qc Ac Qs 4c 5s]
Seat 1: ZhukOFFskI (button) folded before Flop (didn't bet)
Seat 2: Streikel (small blind) folded on the River
Seat 3: chiyuki (big blind) folded on the River
Seat 4: jacquelinewu folded before Flop (didn't bet)
Seat 5: Vahe50 folded before Flop (didn't bet)
Seat 6: kaplya2010 folded before Flop (didn't bet)
Seat 7: Tom1999 collected ($9.31)
Seat 8: KeLevro0 folded before Flop (didn't bet)
Seat 9: turbotom122 folded before Flop (didn't bet)



PokerStars Zoom Hand #84300026685:  Hold'em No Limit ($0.10/$0.25) - 2012/08/05 15:00:40 JST [2012/08/05 2:00:40 ET]
Table 'Whirlpool' 9-max Seat #1 is the button
Seat 1: Nerkit ($14.07 in chips) 
Seat 2: phate-1up ($25 in chips) 
Seat 3: KeLevro0 ($12.15 in chips) 
Seat 4: Alvinpe85 ($58.47 in chips) 
Seat 5: mjmichi ($25 in chips) 
Seat 6: chiyuki ($25 in chips) 
Seat 7: bigred1102 ($44.84 in chips) 
Seat 8: KAKamiro ($24.91 in chips) 
Seat 9: azizmimi ($24.37 in chips) 
phate-1up: posts small blind $0.10
KeLevro0: posts big blind $0.25
*** HOLE CARDS ***
Dealt to chiyuki [4s 4c]
Alvinpe85: folds 
mjmichi: folds 
chiyuki: raises $0.50 to $0.75
bigred1102: calls $0.75
KAKamiro: folds 
azizmimi: folds 
Nerkit: folds 
phate-1up: folds 
KeLevro0: folds 
*** FLOP *** [8s 4d 3s]
chiyuki: bets $1
bigred1102: calls $1
*** TURN *** [8s 4d 3s] [Ks]
chiyuki: bets $3
bigred1102: calls $3
*** RIVER *** [8s 4d 3s Ks] [Ac]
chiyuki: bets $6
bigred1102: calls $6
*** SHOW DOWN ***
chiyuki: shows [4s 4c] (three of a kind, Fours)
bigred1102: mucks hand 
chiyuki collected $20.87 from pot
*** SUMMARY ***
Total pot $21.85 | Rake $0.98 
Board [8s 4d 3s Ks Ac]
Seat 1: Nerkit (button) folded before Flop (didn't bet)
Seat 2: phate-1up (small blind) folded before Flop
Seat 3: KeLevro0 (big blind) folded before Flop
Seat 4: Alvinpe85 folded before Flop (didn't bet)
Seat 5: mjmichi folded before Flop (didn't bet)
Seat 6: chiyuki showed [4s 4c] and won ($20.87) with three of a kind, Fours
Seat 7: bigred1102 mucked [9h As]
Seat 8: KAKamiro folded before Flop (didn't bet)
Seat 9: azizmimi folded before Flop (didn't bet)



PokerStars Zoom Hand #84300038799:  Hold'em No Limit ($0.10/$0.25) - 2012/08/05 15:01:35 JST [2012/08/05 2:01:35 ET]
Table 'Whirlpool' 9-max Seat #1 is the button
Seat 1: DutchShultzs ($29.46 in chips) 
Seat 2: empfang ($21.14 in chips) 
Seat 3: Dejacob ($25 in chips) 
Seat 4: ll_LaMeR_ll ($99.14 in chips) 
Seat 5: ChrisCDee ($69.39 in chips) 
Seat 6: DanielWhyte ($52.76 in chips) 
Seat 7: rorfo23 ($21.09 in chips) 
Seat 8: chiyuki ($35.12 in chips) 
Seat 9: Ellen1947 ($31.79 in chips) 
empfang: posts small blind $0.10
Dejacob: posts big blind $0.25
*** HOLE CARDS ***
Dealt to chiyuki [5h Js]
ll_LaMeR_ll: folds 
ChrisCDee: folds 
DanielWhyte: folds 
rorfo23: folds 
chiyuki: folds 
Ellen1947: raises $0.50 to $0.75
DutchShultzs: folds 
empfang: folds 
Dejacob: folds 
Uncalled bet ($0.50) returned to Ellen1947
Ellen1947 collected $0.60 from pot
Ellen1947: doesn't show hand 
*** SUMMARY ***
Total pot $0.60 | Rake $0 
Seat 1: DutchShultzs (button) folded before Flop (didn't bet)
Seat 2: empfang (small blind) folded before Flop
Seat 3: Dejacob (big blind) folded before Flop
Seat 4: ll_LaMeR_ll folded before Flop (didn't bet)
Seat 5: ChrisCDee folded before Flop (didn't bet)
Seat 6: DanielWhyte folded before Flop (didn't bet)
Seat 7: rorfo23 folded before Flop (didn't bet)
Seat 8: chiyuki folded before Flop (didn't bet)
Seat 9: Ellen1947 collected ($0.60)



PokerStars Zoom Hand #84300039700:  Hold'em No Limit ($0.10/$0.25) - 2012/08/05 15:01:38 JST [2012/08/05 2:01:38 ET]
Table 'Whirlpool' 9-max Seat #1 is the button
Seat 1: rorfo23 ($21.09 in chips) 
Seat 2: KimPa39 ($31.72 in chips) 
Seat 3: Nerkit ($12.15 in chips) 
Seat 4: deadmoneykid ($25.62 in chips) 
Seat 5: hirozo ($29.30 in chips) 
Seat 6: snejokCoxx ($12.63 in chips) 
Seat 7: ll_LaMeR_ll ($99.14 in chips) 
Seat 8: seula i ($107.21 in chips) 
Seat 9: chiyuki ($35.12 in chips) 
KimPa39: posts small blind $0.10
Nerkit: posts big blind $0.25
*** HOLE CARDS ***
Dealt to chiyuki [Qc 5c]
deadmoneykid: folds 
hirozo: folds 
snejokCoxx: folds 
ll_LaMeR_ll: folds 
seula i: folds 
chiyuki: folds 
rorfo23: folds 
KimPa39: folds 
Uncalled bet ($0.15) returned to Nerkit
Nerkit collected $0.20 from pot
Nerkit: doesn't show hand 
*** SUMMARY ***
Total pot $0.20 | Rake $0 
Seat 1: rorfo23 (button) folded before Flop (didn't bet)
Seat 2: KimPa39 (small blind) folded before Flop
Seat 3: Nerkit (big blind) collected ($0.20)
Seat 4: deadmoneykid folded before Flop (didn't bet)
Seat 5: hirozo folded before Flop (didn't bet)
Seat 6: snejokCoxx folded before Flop (didn't bet)
Seat 7: ll_LaMeR_ll folded before Flop (didn't bet)
Seat 8: seula i folded before Flop (didn't bet)
Seat 9: chiyuki folded before Flop (didn't bet)



PokerStars Zoom Hand #84300041838:  Hold'em No Limit ($0.10/$0.25) - 2012/08/05 15:01:48 JST [2012/08/05 2:01:48 ET]
Table 'Whirlpool' 9-max Seat #1 is the button
Seat 1: KeLevro0 ($12.75 in chips) 
Seat 2: rorfo23 ($21.09 in chips) 
Seat 3: seula i ($107.21 in chips) 
Seat 4: DanielWhyte ($52.76 in chips) 
Seat 5: Gichboy ($6.10 in chips) 
Seat 6: chiyuki ($35.12 in chips) 
Seat 7: womble32 ($28.72 in chips) 
Seat 8: DutchShultzs ($29.46 in chips) 
Seat 9: deadmoneykid ($25.62 in chips) 
rorfo23: posts small blind $0.10
seula i: posts big blind $0.25
*** HOLE CARDS ***
Dealt to chiyuki [9c Qd]
DanielWhyte: folds 
Gichboy: folds 
chiyuki: folds 
womble32: folds 
DutchShultzs: raises $0.50 to $0.75
deadmoneykid: folds 
KeLevro0: calls $0.75
rorfo23: folds 
seula i: folds 
*** FLOP *** [6d Jc Th]
DutchShultzs: checks 
KeLevro0: bets $0.99
DutchShultzs: folds 
Uncalled bet ($0.99) returned to KeLevro0
KeLevro0 collected $1.77 from pot
KeLevro0: doesn't show hand 
*** SUMMARY ***
Total pot $1.85 | Rake $0.08 
Board [6d Jc Th]
Seat 1: KeLevro0 (button) collected ($1.77)
Seat 2: rorfo23 (small blind) folded before Flop
Seat 3: seula i (big blind) folded before Flop
Seat 4: DanielWhyte folded before Flop (didn't bet)
Seat 5: Gichboy folded before Flop (didn't bet)
Seat 6: chiyuki folded before Flop (didn't bet)
Seat 7: womble32 folded before Flop (didn't bet)
Seat 8: DutchShultzs folded on the Flop
Seat 9: deadmoneykid folded before Flop (didn't bet)



PokerStars Zoom Hand #84300044795:  Hold'em No Limit ($0.10/$0.25) - 2012/08/05 15:02:00 JST [2012/08/05 2:02:00 ET]
Table 'Whirlpool' 9-max Seat #1 is the button
Seat 1: ChrisCDee ($69.39 in chips) 
Seat 2: Nerkit ($12.25 in chips) 
Seat 3: seula i ($26.01 in chips) 
Seat 4: Dejacob ($26.73 in chips) 
Seat 5: DanielWhyte ($52.76 in chips) 
Seat 6: 4plankton ($16.23 in chips) 
Seat 7: chiyuki ($35.12 in chips) 
Seat 8: silvno31 ($16.09 in chips) 
Seat 9: snejokCoxx ($12.63 in chips) 
Nerkit: posts small blind $0.10
seula i: posts big blind $0.25
*** HOLE CARDS ***
Dealt to chiyuki [7h Ts]
Dejacob: folds 
DanielWhyte: folds 
4plankton: folds 
chiyuki: folds 
silvno31: folds 
snejokCoxx: raises $0.40 to $0.65
ChrisCDee: folds 
Nerkit: folds 
seula i: folds 
Uncalled bet ($0.40) returned to snejokCoxx
snejokCoxx collected $0.60 from pot
snejokCoxx: doesn't show hand 
*** SUMMARY ***
Total pot $0.60 | Rake $0 
Seat 1: ChrisCDee (button) folded before Flop (didn't bet)
Seat 2: Nerkit (small blind) folded before Flop
Seat 3: seula i (big blind) folded before Flop
Seat 4: Dejacob folded before Flop (didn't bet)
Seat 5: DanielWhyte folded before Flop (didn't bet)
Seat 6: 4plankton folded before Flop (didn't bet)
Seat 7: chiyuki folded before Flop (didn't bet)
Seat 8: silvno31 folded before Flop (didn't bet)
Seat 9: snejokCoxx collected ($0.60)



PokerStars Zoom Hand #84300046835:  Hold'em No Limit ($0.10/$0.25) - 2012/08/05 15:02:07 JST [2012/08/05 2:02:07 ET]
Table 'Whirlpool' 9-max Seat #1 is the button
Seat 1: INSP!RON ($25.44 in chips) 
Seat 2: chiyuki ($35.12 in chips) 
Seat 3: deadmoneykid ($27.77 in chips) 
Seat 4: silvno31 ($16.09 in chips) 
Seat 5: kamikkaze ($14.90 in chips) 
Seat 6: GovGus ($26.35 in chips) 
Seat 7: rorfo23 ($20.99 in chips) 
Seat 8: KrystalAA ($33.14 in chips) 
Seat 9: cofla tito ($10.10 in chips) 
chiyuki: posts small blind $0.10
deadmoneykid: posts big blind $0.25
*** HOLE CARDS ***
Dealt to chiyuki [5s Qh]
silvno31: folds 
kamikkaze: folds 
GovGus: folds 
rorfo23: folds 
KrystalAA: raises $0.46 to $0.71
cofla tito: folds 
INSP!RON: folds 
chiyuki: folds 
deadmoneykid: folds 
Uncalled bet ($0.46) returned to KrystalAA
KrystalAA collected $0.60 from pot
KrystalAA: doesn't show hand 
*** SUMMARY ***
Total pot $0.60 | Rake $0 
Seat 1: INSP!RON (button) folded before Flop (didn't bet)
Seat 2: chiyuki (small blind) folded before Flop
Seat 3: deadmoneykid (big blind) folded before Flop
Seat 4: silvno31 folded before Flop (didn't bet)
Seat 5: kamikkaze folded before Flop (didn't bet)
Seat 6: GovGus folded before Flop (didn't bet)
Seat 7: rorfo23 folded before Flop (didn't bet)
Seat 8: KrystalAA collected ($0.60)
Seat 9: cofla tito folded before Flop (didn't bet)



PokerStars Zoom Hand #84300048305:  Hold'em No Limit ($0.10/$0.25) - 2012/08/05 15:02:13 JST [2012/08/05 2:02:13 ET]
Table 'Whirlpool' 9-max Seat #1 is the button
Seat 1: Perstenev ($11 in chips) 
Seat 2: DutchShultzs ($25.03 in chips) 
Seat 3: chiyuki ($35.02 in chips) 
Seat 4: bigred1102 ($33.84 in chips) 
Seat 5: jacquelinewu ($25 in chips) 
Seat 6: Dejacob ($45.86 in chips) 
Seat 7: mjmichi ($25 in chips) 
Seat 8: 1Karina1 ($25.65 in chips) 
Seat 9: Tom1999 ($27.07 in chips) 
DutchShultzs: posts small blind $0.10
chiyuki: posts big blind $0.25
*** HOLE CARDS ***
Dealt to chiyuki [2c Tc]
bigred1102: calls $0.25
jacquelinewu: folds 
Dejacob: folds 
mjmichi: folds 
1Karina1: folds 
Tom1999: folds 
Perstenev: folds 
DutchShultzs: folds 
chiyuki: checks 
*** FLOP *** [3d Kd Qh]
chiyuki: checks 
bigred1102: bets $0.50
chiyuki: folds 
Uncalled bet ($0.50) returned to bigred1102
bigred1102 collected $0.57 from pot
bigred1102: doesn't show hand 
*** SUMMARY ***
Total pot $0.60 | Rake $0.03 
Board [3d Kd Qh]
Seat 1: Perstenev (button) folded before Flop (didn't bet)
Seat 2: DutchShultzs (small blind) folded before Flop
Seat 3: chiyuki (big blind) folded on the Flop
Seat 4: bigred1102 collected ($0.57)
Seat 5: jacquelinewu folded before Flop (didn't bet)
Seat 6: Dejacob folded before Flop (didn't bet)
Seat 7: mjmichi folded before Flop (didn't bet)
Seat 8: 1Karina1 folded before Flop (didn't bet)
Seat 9: Tom1999 folded before Flop (didn't bet)



PokerStars Zoom Hand #84300057248:  Hold'em No Limit ($0.10/$0.25) - 2012/08/05 15:02:51 JST [2012/08/05 2:02:51 ET]
Table 'Whirlpool' 9-max Seat #1 is the button
Seat 1: kaplya2010 ($17.62 in chips) 
Seat 2: phate-1up ($69.53 in chips) 
Seat 3: Andrei 23rus ($25 in chips) 
Seat 4: jacquelinewu ($28.52 in chips) 
Seat 5: chiyuki ($34.77 in chips) 
Seat 6: Perstenev ($16.40 in chips) 
Seat 7: deepakmbh ($68.25 in chips) 
Seat 8: Wilcox76607 ($32.19 in chips) 
Seat 9: Faantomace ($11.53 in chips) 
phate-1up: posts small blind $0.10
Andrei 23rus: posts big blind $0.25
*** HOLE CARDS ***
Dealt to chiyuki [6d 9s]
jacquelinewu: folds 
chiyuki: folds 
Perstenev: folds 
deepakmbh: raises $0.50 to $0.75
Wilcox76607: calls $0.75
Faantomace: folds 
kaplya2010: folds 
phate-1up: folds 
Andrei 23rus: calls $0.50
*** FLOP *** [Qd 6c As]
Andrei 23rus: checks 
deepakmbh: checks 
Wilcox76607: bets $1.25
Andrei 23rus: folds 
deepakmbh: folds 
Uncalled bet ($1.25) returned to Wilcox76607
Wilcox76607 collected $2.24 from pot
Wilcox76607: doesn't show hand 
*** SUMMARY ***
Total pot $2.35 | Rake $0.11 
Board [Qd 6c As]
Seat 1: kaplya2010 (button) folded before Flop (didn't bet)
Seat 2: phate-1up (small blind) folded before Flop
Seat 3: Andrei 23rus (big blind) folded on the Flop
Seat 4: jacquelinewu folded before Flop (didn't bet)
Seat 5: chiyuki folded before Flop (didn't bet)
Seat 6: Perstenev folded before Flop (didn't bet)
Seat 7: deepakmbh folded on the Flop
Seat 8: Wilcox76607 collected ($2.24)
Seat 9: Faantomace folded before Flop (didn't bet)



PokerStars Zoom Hand #84300060369:  Hold'em No Limit ($0.10/$0.25) - 2012/08/05 15:03:05 JST [2012/08/05 2:03:05 ET]
Table 'Whirlpool' 9-max Seat #1 is the button
Seat 1: chiyuki ($34.77 in chips) 
Seat 2: ChrisCDee ($45.75 in chips) 
Seat 3: ygoegoe ($25 in chips) 
Seat 4: PAMBOS.L ($17.52 in chips) 
Seat 5: Dejacob ($25.35 in chips) 
Seat 6: drunk_bender ($23.95 in chips) 
Seat 7: Perstenev ($10.75 in chips) 
Seat 8: hirozo ($29.20 in chips) 
Seat 9: Paranoix1990 ($17.08 in chips) 
ChrisCDee: posts small blind $0.10
ygoegoe: posts big blind $0.25
*** HOLE CARDS ***
Dealt to chiyuki [7d 7s]
PAMBOS.L: raises $0.35 to $0.60
Dejacob: folds 
drunk_bender: folds 
Perstenev: folds 
hirozo: folds 
Paranoix1990: calls $0.60
chiyuki: calls $0.60
ChrisCDee: folds 
ygoegoe: folds 
*** FLOP *** [8c Tc 5s]
PAMBOS.L: checks 
Paranoix1990: checks 
chiyuki: checks 
*** TURN *** [8c Tc 5s] [Qc]
PAMBOS.L: checks 
Paranoix1990: bets $0.50
chiyuki: folds 
PAMBOS.L: calls $0.50
*** RIVER *** [8c Tc 5s Qc] [5h]
PAMBOS.L: checks 
Paranoix1990: checks 
*** SHOW DOWN ***
PAMBOS.L: shows [Jd Ad] (a pair of Fives)
Paranoix1990: shows [Jh As] (a pair of Fives)
PAMBOS.L collected $1.51 from pot
Paranoix1990 collected $1.50 from pot
*** SUMMARY ***
Total pot $3.15 | Rake $0.14 
Board [8c Tc 5s Qc 5h]
Seat 1: chiyuki (button) folded on the Turn
Seat 2: ChrisCDee (small blind) folded before Flop
Seat 3: ygoegoe (big blind) folded before Flop
Seat 4: PAMBOS.L showed [Jd Ad] and won ($1.51) with a pair of Fives
Seat 5: Dejacob folded before Flop (didn't bet)
Seat 6: drunk_bender folded before Flop (didn't bet)
Seat 7: Perstenev folded before Flop (didn't bet)
Seat 8: hirozo folded before Flop (didn't bet)
Seat 9: Paranoix1990 showed [Jh As] and won ($1.50) with a pair of Fives



PokerStars Zoom Hand #84300068496:  Hold'em No Limit ($0.10/$0.25) - 2012/08/05 15:03:36 JST [2012/08/05 2:03:36 ET]
Table 'Whirlpool' 9-max Seat #1 is the button
Seat 1: Dejacob ($45.51 in chips) 
Seat 2: Streikel ($17.37 in chips) 
Seat 3: INSP!RON ($25.44 in chips) 
Seat 4: ChrisCDee ($45.65 in chips) 
Seat 5: snejokCoxx ($13.55 in chips) 
Seat 6: Alvinpe85 ($48.08 in chips) 
Seat 7: chiyuki ($34.17 in chips) 
Seat 8: silvno31 ($25.35 in chips) 
Seat 9: jacquelinewu ($41.81 in chips) 
Streikel: posts small blind $0.10
INSP!RON: posts big blind $0.25
*** HOLE CARDS ***
Dealt to chiyuki [6h Tc]
ChrisCDee: folds 
snejokCoxx: folds 
Alvinpe85: folds 
chiyuki: folds 
silvno31: folds 
jacquelinewu: folds 
Dejacob: folds 
Streikel: folds 
Uncalled bet ($0.15) returned to INSP!RON
INSP!RON collected $0.20 from pot
INSP!RON: doesn't show hand 
*** SUMMARY ***
Total pot $0.20 | Rake $0 
Seat 1: Dejacob (button) folded before Flop (didn't bet)
Seat 2: Streikel (small blind) folded before Flop
Seat 3: INSP!RON (big blind) collected ($0.20)
Seat 4: ChrisCDee folded before Flop (didn't bet)
Seat 5: snejokCoxx folded before Flop (didn't bet)
Seat 6: Alvinpe85 folded before Flop (didn't bet)
Seat 7: chiyuki folded before Flop (didn't bet)
Seat 8: silvno31 folded before Flop (didn't bet)
Seat 9: jacquelinewu folded before Flop (didn't bet)



PokerStars Zoom Hand #84300058257:  Hold'em No Limit ($0.10/$0.25) - 2012/08/05 15:02:56 JST [2012/08/05 2:02:56 ET]
Table 'Whirlpool' 9-max Seat #1 is the button
Seat 1: snejokCoxx ($8.65 in chips) 
Seat 2: mjmichi ($25 in chips) 
Seat 3: Littlea029 ($24.73 in chips) 
Seat 4: chiyuki ($34.77 in chips) 
Seat 5: troublesomm ($28.40 in chips) 
Seat 6: INSP!RON ($25.09 in chips) 
Seat 7: Nerkit ($11.12 in chips) 
Seat 8: KAKamiro ($20.81 in chips) 
Seat 9: ChrisCDee ($69.29 in chips) 
mjmichi: posts small blind $0.10
Littlea029: posts big blind $0.25
*** HOLE CARDS ***
Dealt to chiyuki [3c 7d]
chiyuki: folds 
troublesomm: folds 
INSP!RON: folds 
Nerkit: folds 
KAKamiro: folds 
ChrisCDee: raises $0.50 to $0.75
snejokCoxx: folds 
mjmichi: folds 
Littlea029: raises $0.75 to $1.50
ChrisCDee: calls $0.75
*** FLOP *** [4h 2d 5c]
Littlea029: bets $1.25
ChrisCDee: raises $1.50 to $2.75
Littlea029: calls $1.50
*** TURN *** [4h 2d 5c] [Ah]
Littlea029: checks 
ChrisCDee: checks 
*** RIVER *** [4h 2d 5c Ah] [Qc]
Littlea029: bets $1.50
ChrisCDee: calls $1.50
*** SHOW DOWN ***
Littlea029: shows [Kc Ks] (a pair of Kings)
ChrisCDee: mucks hand 
Littlea029 collected $11.08 from pot
*** SUMMARY ***
Total pot $11.60 | Rake $0.52 
Board [4h 2d 5c Ah Qc]
Seat 1: snejokCoxx (button) folded before Flop (didn't bet)
Seat 2: mjmichi (small blind) folded before Flop
Seat 3: Littlea029 (big blind) showed [Kc Ks] and won ($11.08) with a pair of Kings
Seat 4: chiyuki folded before Flop (didn't bet)
Seat 5: troublesomm folded before Flop (didn't bet)
Seat 6: INSP!RON folded before Flop (didn't bet)
Seat 7: Nerkit folded before Flop (didn't bet)
Seat 8: KAKamiro folded before Flop (didn't bet)
Seat 9: ChrisCDee mucked [5s 7c]



PokerStars Zoom Hand #84300069833:  Hold'em No Limit ($0.10/$0.25) - 2012/08/05 15:03:41 JST [2012/08/05 2:03:41 ET]
Table 'Whirlpool' 9-max Seat #1 is the button
Seat 1: deadmoneykid ($26.90 in chips) 
Seat 2: KrystalAA ($28.76 in chips) 
Seat 3: GovGus ($34.99 in chips) 
Seat 4: Nerkit ($22.70 in chips) 
Seat 5: ZhukOFFskI ($40.81 in chips) 
Seat 6: Silveystryk ($24.40 in chips) 
Seat 7: hirozo ($50.27 in chips) 
Seat 8: 4plankton ($18.53 in chips) 
Seat 9: chiyuki ($34.17 in chips) 
KrystalAA: posts small blind $0.10
GovGus: posts big blind $0.25
*** HOLE CARDS ***
Dealt to chiyuki [9s Ts]
Nerkit: raises $0.37 to $0.62
ZhukOFFskI: folds 
Silveystryk: folds 
hirozo: folds 
4plankton: folds 
chiyuki: folds 
deadmoneykid: folds 
KrystalAA: folds 
GovGus: folds 
Uncalled bet ($0.37) returned to Nerkit
Nerkit collected $0.60 from pot
Nerkit: doesn't show hand 
*** SUMMARY ***
Total pot $0.60 | Rake $0 
Seat 1: deadmoneykid (button) folded before Flop (didn't bet)
Seat 2: KrystalAA (small blind) folded before Flop
Seat 3: GovGus (big blind) folded before Flop
Seat 4: Nerkit collected ($0.60)
Seat 5: ZhukOFFskI folded before Flop (didn't bet)
Seat 6: Silveystryk folded before Flop (didn't bet)
Seat 7: hirozo folded before Flop (didn't bet)
Seat 8: 4plankton folded before Flop (didn't bet)
Seat 9: chiyuki folded before Flop (didn't bet)



PokerStars Zoom Hand #84300078454:  Hold'em No Limit ($0.10/$0.25) - 2012/08/05 15:04:17 JST [2012/08/05 2:04:17 ET]
Table 'Whirlpool' 9-max Seat #1 is the button
Seat 1: troublesomm ($25 in chips) 
Seat 2: NuMetal88 ($25 in chips) 
Seat 3: 1Karina1 ($25 in chips) 
Seat 4: chiyuki ($34.07 in chips) 
Seat 5: MOReilly000 ($30.63 in chips) 
Seat 6: deadmoneykid ($30.36 in chips) 
Seat 7: yane73 ($75.44 in chips) 
Seat 8: Perstenev ($11.75 in chips) 
Seat 9: ZhukOFFskI ($29.58 in chips) 
NuMetal88: posts small blind $0.10
1Karina1: posts big blind $0.25
*** HOLE CARDS ***
Dealt to chiyuki [8c 3c]
chiyuki: folds 
MOReilly000: raises $0.75 to $1
deadmoneykid: folds 
yane73: folds 
Perstenev: folds 
ZhukOFFskI: folds 
troublesomm: folds 
NuMetal88: folds 
1Karina1: folds 
Uncalled bet ($0.75) returned to MOReilly000
MOReilly000 collected $0.60 from pot
MOReilly000: doesn't show hand 
*** SUMMARY ***
Total pot $0.60 | Rake $0 
Seat 1: troublesomm (button) folded before Flop (didn't bet)
Seat 2: NuMetal88 (small blind) folded before Flop
Seat 3: 1Karina1 (big blind) folded before Flop
Seat 4: chiyuki folded before Flop (didn't bet)
Seat 5: MOReilly000 collected ($0.60)
Seat 6: deadmoneykid folded before Flop (didn't bet)
Seat 7: yane73 folded before Flop (didn't bet)
Seat 8: Perstenev folded before Flop (didn't bet)
Seat 9: ZhukOFFskI folded before Flop (didn't bet)



PokerStars Zoom Hand #84300072094:  Hold'em No Limit ($0.10/$0.25) - 2012/08/05 15:03:50 JST [2012/08/05 2:03:50 ET]
Table 'Whirlpool' 9-max Seat #1 is the button
Seat 1: Faantomace ($1.18 in chips) 
Seat 2: phate-1up ($26.64 in chips) 
Seat 3: hirozo ($29.55 in chips) 
Seat 4: kesstukas25 ($12.50 in chips) 
Seat 5: chiyuki ($34.17 in chips) 
Seat 6: DutchShultzs ($32.40 in chips) 
Seat 7: mjmichi ($25 in chips) 
Seat 8: deadmoneykid ($30.36 in chips) 
Seat 9: troublesomm ($28.40 in chips) 
phate-1up: posts small blind $0.10
hirozo: posts big blind $0.25
*** HOLE CARDS ***
Dealt to chiyuki [Ad 3d]
kesstukas25: folds 
chiyuki: folds 
DutchShultzs: folds 
mjmichi: folds 
deadmoneykid: folds 
troublesomm: folds 
Faantomace: raises $0.93 to $1.18 and is all-in
phate-1up: calls $1.08
hirozo: folds 
*** FLOP *** [4d 8c 3h]
*** TURN *** [4d 8c 3h] [2h]
*** RIVER *** [4d 8c 3h 2h] [3c]
*** SHOW DOWN ***
phate-1up: shows [As 9s] (a pair of Threes)
Faantomace: shows [6d 5s] (a straight, Deuce to Six)
Faantomace collected $2.49 from pot
*** SUMMARY ***
Total pot $2.61 | Rake $0.12 
Board [4d 8c 3h 2h 3c]
Seat 1: Faantomace (button) showed [6d 5s] and won ($2.49) with a straight, Deuce to Six
Seat 2: phate-1up (small blind) showed [As 9s] and lost with a pair of Threes
Seat 3: hirozo (big blind) folded before Flop
Seat 4: kesstukas25 folded before Flop (didn't bet)
Seat 5: chiyuki folded before Flop (didn't bet)
Seat 6: DutchShultzs folded before Flop (didn't bet)
Seat 7: mjmichi folded before Flop (didn't bet)
Seat 8: deadmoneykid folded before Flop (didn't bet)
Seat 9: troublesomm folded before Flop (didn't bet)



PokerStars Zoom Hand #84300074796:  Hold'em No Limit ($0.10/$0.25) - 2012/08/05 15:04:01 JST [2012/08/05 2:04:01 ET]
Table 'Whirlpool' 9-max Seat #1 is the button
Seat 1: jeades ($14.65 in chips) 
Seat 2: snejokCoxx ($10.28 in chips) 
Seat 3: cofla tito ($9.89 in chips) 
Seat 4: troublesomm ($36.78 in chips) 
Seat 5: hirozo ($50.27 in chips) 
Seat 6: phate-1up ($49.75 in chips) 
Seat 7: PillZ86 ($22.25 in chips) 
Seat 8: chiyuki ($34.07 in chips) 
Seat 9: starreset ($25 in chips) 
snejokCoxx: posts small blind $0.10
cofla tito: posts big blind $0.25
*** HOLE CARDS ***
Dealt to chiyuki [6d 8c]
troublesomm: folds 
hirozo: raises $0.50 to $0.75
phate-1up: folds 
PillZ86: folds 
chiyuki: folds 
starreset: folds 
jeades: folds 
snejokCoxx: folds 
cofla tito: folds 
Uncalled bet ($0.50) returned to hirozo
hirozo collected $0.60 from pot
hirozo: doesn't show hand 
*** SUMMARY ***
Total pot $0.60 | Rake $0 
Seat 1: jeades (button) folded before Flop (didn't bet)
Seat 2: snejokCoxx (small blind) folded before Flop
Seat 3: cofla tito (big blind) folded before Flop
Seat 4: troublesomm folded before Flop (didn't bet)
Seat 5: hirozo collected ($0.60)
Seat 6: phate-1up folded before Flop (didn't bet)
Seat 7: PillZ86 folded before Flop (didn't bet)
Seat 8: chiyuki folded before Flop (didn't bet)
Seat 9: starreset folded before Flop (didn't bet)



PokerStars Zoom Hand #84300076280:  Hold'em No Limit ($0.10/$0.25) - 2012/08/05 15:04:08 JST [2012/08/05 2:04:08 ET]
Table 'Whirlpool' 9-max Seat #1 is the button
Seat 1: DutchShultzs ($32.40 in chips) 
Seat 2: softdesign ($84.01 in chips) 
Seat 3: 1Karina1 ($25.32 in chips) 
Seat 4: snejokCoxx ($12.33 in chips) 
Seat 5: Perstenev ($11.75 in chips) 
Seat 6: chiyuki ($34.07 in chips) 
Seat 7: ygoegoe ($25 in chips) 
Seat 8: Ellen1947 ($31.14 in chips) 
Seat 9: mid22 ($18.67 in chips) 
softdesign: posts small blind $0.10
1Karina1: posts big blind $0.25
*** HOLE CARDS ***
Dealt to chiyuki [2c Ad]
snejokCoxx: folds 
Perstenev: folds 
chiyuki: folds 
ygoegoe: folds 
Ellen1947: folds 
mid22: folds 
DutchShultzs: raises $0.35 to $0.60
softdesign: calls $0.50
1Karina1: calls $0.35
*** FLOP *** [9h Jc 5s]
softdesign: bets $1.75
1Karina1: calls $1.75
DutchShultzs: folds 
*** TURN *** [9h Jc 5s] [Kd]
softdesign: bets $3.25
1Karina1: calls $3.25
*** RIVER *** [9h Jc 5s Kd] [Ts]
softdesign: checks 
1Karina1: checks 
*** SHOW DOWN ***
softdesign: shows [Jd 4d] (a pair of Jacks)
1Karina1: shows [Tc Js] (two pair, Jacks and Tens)
1Karina1 collected $11.27 from pot
*** SUMMARY ***
Total pot $11.80 | Rake $0.53 
Board [9h Jc 5s Kd Ts]
Seat 1: DutchShultzs (button) folded on the Flop
Seat 2: softdesign (small blind) showed [Jd 4d] and lost with a pair of Jacks
Seat 3: 1Karina1 (big blind) showed [Tc Js] and won ($11.27) with two pair, Jacks and Tens
Seat 4: snejokCoxx folded before Flop (didn't bet)
Seat 5: Perstenev folded before Flop (didn't bet)
Seat 6: chiyuki folded before Flop (didn't bet)
Seat 7: ygoegoe folded before Flop (didn't bet)
Seat 8: Ellen1947 folded before Flop (didn't bet)
Seat 9: mid22 folded before Flop (didn't bet)



PokerStars Zoom Hand #84300074075:  Hold'em No Limit ($0.10/$0.25) - 2012/08/05 15:03:58 JST [2012/08/05 2:03:58 ET]
Table 'Whirlpool' 9-max Seat #1 is the button
Seat 1: laurentzu84 ($26.36 in chips) 
Seat 2: chiyuki ($34.17 in chips) 
Seat 3: 4plankton ($18.53 in chips) 
Seat 4: Vahe50 ($10.29 in chips) 
Seat 5: turbotom122 ($11.66 in chips) 
Seat 6: bigred1102 ($31.76 in chips) 
Seat 7: seula i ($25 in chips) 
Seat 8: Roglus ($13.93 in chips) 
Seat 9: DutchShultzs ($32.40 in chips) 
chiyuki: posts small blind $0.10
4plankton: posts big blind $0.25
*** HOLE CARDS ***
Dealt to chiyuki [2s 3d]
Vahe50: folds 
turbotom122: calls $0.25
bigred1102: raises $0.25 to $0.50
seula i: folds 
Roglus: calls $0.50
DutchShultzs: folds 
laurentzu84: folds 
chiyuki: folds 
4plankton: calls $0.25
turbotom122: calls $0.25
*** FLOP *** [4c As Ac]
4plankton: checks 
turbotom122: checks 
bigred1102: bets $0.75
Roglus: calls $0.75
4plankton: calls $0.75
turbotom122: calls $0.75
*** TURN *** [4c As Ac] [Ks]
4plankton: checks 
turbotom122: checks 
bigred1102: folds 
Roglus: checks 
*** RIVER *** [4c As Ac Ks] [7s]
4plankton: checks 
turbotom122: checks 
Roglus: checks 
*** SHOW DOWN ***
4plankton: shows [Js Ah] (three of a kind, Aces)
turbotom122: mucks hand 
Roglus: mucks hand 
4plankton collected $4.87 from pot
*** SUMMARY ***
Total pot $5.10 | Rake $0.23 
Board [4c As Ac Ks 7s]
Seat 1: laurentzu84 (button) folded before Flop (didn't bet)
Seat 2: chiyuki (small blind) folded before Flop
Seat 3: 4plankton (big blind) showed [Js Ah] and won ($4.87) with three of a kind, Aces
Seat 4: Vahe50 folded before Flop (didn't bet)
Seat 5: turbotom122 mucked [8c Kc]
Seat 6: bigred1102 folded on the Turn
Seat 7: seula i folded before Flop (didn't bet)
Seat 8: Roglus mucked [5d 4d]
Seat 9: DutchShultzs folded before Flop (didn't bet)



PokerStars Zoom Hand #84300079224:  Hold'em No Limit ($0.10/$0.25) - 2012/08/05 15:04:20 JST [2012/08/05 2:04:20 ET]
Table 'Whirlpool' 9-max Seat #1 is the button
Seat 1: KeLevro0 ($12.40 in chips) 
Seat 2: deadmoneykid ($26.65 in chips) 
Seat 3: chiyuki ($34.07 in chips) 
Seat 4: kesstukas25 ($13.62 in chips) 
Seat 5: risekuku468 ($40.01 in chips) 
Seat 6: kamikkaze ($12.95 in chips) 
Seat 7: ygoegoe ($25.66 in chips) 
Seat 8: troublesomm ($28.40 in chips) 
Seat 9: jacquelinewu ($26.52 in chips) 
deadmoneykid: posts small blind $0.10
chiyuki: posts big blind $0.25
*** HOLE CARDS ***
Dealt to chiyuki [4c Ks]
kesstukas25: folds 
risekuku468: folds 
kamikkaze: folds 
ygoegoe: folds 
troublesomm: folds 
jacquelinewu: folds 
KeLevro0: raises $0.42 to $0.67
deadmoneykid: calls $0.57
chiyuki: folds 
*** FLOP *** [5d Tc Ah]
deadmoneykid: bets $0.75
KeLevro0: raises $1.75 to $2.50
deadmoneykid: folds 
Uncalled bet ($1.75) returned to KeLevro0
KeLevro0 collected $2.95 from pot
KeLevro0: doesn't show hand 
*** SUMMARY ***
Total pot $3.09 | Rake $0.14 
Board [5d Tc Ah]
Seat 1: KeLevro0 (button) collected ($2.95)
Seat 2: deadmoneykid (small blind) folded on the Flop
Seat 3: chiyuki (big blind) folded before Flop
Seat 4: kesstukas25 folded before Flop (didn't bet)
Seat 5: risekuku468 folded before Flop (didn't bet)
Seat 6: kamikkaze folded before Flop (didn't bet)
Seat 7: ygoegoe folded before Flop (didn't bet)
Seat 8: troublesomm folded before Flop (didn't bet)
Seat 9: jacquelinewu folded before Flop (didn't bet)



PokerStars Zoom Hand #84300087968:  Hold'em No Limit ($0.10/$0.25) - 2012/08/05 15:04:54 JST [2012/08/05 2:04:54 ET]
Table 'Whirlpool' 9-max Seat #1 is the button
Seat 1: gunbowler ($195.19 in chips) 
Seat 2: Perstenev ($11.75 in chips) 
Seat 3: DutchShultzs ($30.06 in chips) 
Seat 4: chiyuki ($33.82 in chips) 
Seat 5: Alvinpe85 ($51.51 in chips) 
Seat 6: Faantomace ($2.84 in chips) 
Seat 7: 1Karina1 ($30.99 in chips) 
Seat 8: KrystalAA ($33.26 in chips) 
Seat 9: INSP!RON ($25 in chips) 
Perstenev: posts small blind $0.10
DutchShultzs: posts big blind $0.25
*** HOLE CARDS ***
Dealt to chiyuki [Jd Qd]
chiyuki: folds 
Alvinpe85: folds 
Faantomace: folds 
1Karina1: folds 
KrystalAA: folds 
INSP!RON: raises $0.50 to $0.75
gunbowler: folds 
Perstenev: calls $0.65
DutchShultzs: calls $0.50
*** FLOP *** [9h As 8c]
Perstenev: checks 
DutchShultzs: checks 
INSP!RON: bets $1.50
Perstenev: folds 
DutchShultzs: folds 
Uncalled bet ($1.50) returned to INSP!RON
INSP!RON collected $2.15 from pot
INSP!RON: doesn't show hand 
*** SUMMARY ***
Total pot $2.25 | Rake $0.10 
Board [9h As 8c]
Seat 1: gunbowler (button) folded before Flop (didn't bet)
Seat 2: Perstenev (small blind) folded on the Flop
Seat 3: DutchShultzs (big blind) folded on the Flop
Seat 4: chiyuki folded before Flop (didn't bet)
Seat 5: Alvinpe85 folded before Flop (didn't bet)
Seat 6: Faantomace folded before Flop (didn't bet)
Seat 7: 1Karina1 folded before Flop (didn't bet)
Seat 8: KrystalAA folded before Flop (didn't bet)
Seat 9: INSP!RON collected ($2.15)



PokerStars Zoom Hand #84300088819:  Hold'em No Limit ($0.10/$0.25) - 2012/08/05 15:04:57 JST [2012/08/05 2:04:57 ET]
Table 'Whirlpool' 9-max Seat #1 is the button
Seat 1: 4plankton ($22.15 in chips) 
Seat 2: Andrei 23rus ($20.40 in chips) 
Seat 3: Nerkit ($12.50 in chips) 
Seat 4: dushvan ($44.73 in chips) 
Seat 5: turbotom122 ($10.41 in chips) 
Seat 6: chiyuki ($33.82 in chips) 
Seat 7: troublesomm ($40.86 in chips) 
Seat 8: rorfo23 ($20.24 in chips) 
Seat 9: GovGus ($34.24 in chips) 
Andrei 23rus: posts small blind $0.10
Nerkit: posts big blind $0.25
*** HOLE CARDS ***
Dealt to chiyuki [4c 2s]
dushvan: raises $0.50 to $0.75
turbotom122: folds 
chiyuki: folds 
troublesomm: folds 
rorfo23: calls $0.75
GovGus: folds 
4plankton: folds 
Andrei 23rus: folds 
Nerkit: folds 
*** FLOP *** [Jc Qc 7c]
dushvan: checks 
rorfo23: bets $1
dushvan: folds 
Uncalled bet ($1) returned to rorfo23
rorfo23 collected $1.77 from pot
rorfo23: doesn't show hand 
*** SUMMARY ***
Total pot $1.85 | Rake $0.08 
Board [Jc Qc 7c]
Seat 1: 4plankton (button) folded before Flop (didn't bet)
Seat 2: Andrei 23rus (small blind) folded before Flop
Seat 3: Nerkit (big blind) folded before Flop
Seat 4: dushvan folded on the Flop
Seat 5: turbotom122 folded before Flop (didn't bet)
Seat 6: chiyuki folded before Flop (didn't bet)
Seat 7: troublesomm folded before Flop (didn't bet)
Seat 8: rorfo23 collected ($1.77)
Seat 9: GovGus folded before Flop (didn't bet)



PokerStars Zoom Hand #84300090037:  Hold'em No Limit ($0.10/$0.25) - 2012/08/05 15:05:02 JST [2012/08/05 2:05:02 ET]
Table 'Whirlpool' 9-max Seat #1 is the button
Seat 1: kamikkaze ($12.95 in chips) 
Seat 2: WARIBANA7777 ($15.63 in chips) 
Seat 3: Andrei 23rus ($20.30 in chips) 
Seat 4: turbotom122 ($10.41 in chips) 
Seat 5: KimPa39 ($29.01 in chips) 
Seat 6: River_GmbH ($13.15 in chips) 
Seat 7: 1Karina1 ($25 in chips) 
Seat 8: chiyuki ($33.82 in chips) 
Seat 9: hobby56 ($13.66 in chips) 
WARIBANA7777: posts small blind $0.10
Andrei 23rus: posts big blind $0.25
*** HOLE CARDS ***
Dealt to chiyuki [7h 7c]
turbotom122: folds 
KimPa39: folds 
River_GmbH: folds 
1Karina1: folds 
chiyuki: raises $0.50 to $0.75
hobby56: folds 
kamikkaze: folds 
WARIBANA7777: folds 
Andrei 23rus: folds 
Uncalled bet ($0.50) returned to chiyuki
chiyuki collected $0.60 from pot
chiyuki: doesn't show hand 
*** SUMMARY ***
Total pot $0.60 | Rake $0 
Seat 1: kamikkaze (button) folded before Flop (didn't bet)
Seat 2: WARIBANA7777 (small blind) folded before Flop
Seat 3: Andrei 23rus (big blind) folded before Flop
Seat 4: turbotom122 folded before Flop (didn't bet)
Seat 5: KimPa39 folded before Flop (didn't bet)
Seat 6: River_GmbH folded before Flop (didn't bet)
Seat 7: 1Karina1 folded before Flop (didn't bet)
Seat 8: chiyuki collected ($0.60)
Seat 9: hobby56 folded before Flop (didn't bet)



PokerStars Zoom Hand #84300086994:  Hold'em No Limit ($0.10/$0.25) - 2012/08/05 15:04:50 JST [2012/08/05 2:04:50 ET]
Table 'Whirlpool' 9-max Seat #1 is the button
Seat 1: chiyuki ($33.82 in chips) 
Seat 2: Rilko1975 ($25.10 in chips) 
Seat 3: deadmoneykid ($30.26 in chips) 
Seat 4: ygoegoe ($25.66 in chips) 
Seat 5: snejokCoxx ($11.75 in chips) 
Seat 6: jacquelinewu ($47.42 in chips) 
Seat 7: dushvan ($44.73 in chips) 
Seat 8: seula i ($106.11 in chips) 
Seat 9: DutchShultzs ($30.06 in chips) 
Rilko1975: posts small blind $0.10
deadmoneykid: posts big blind $0.25
*** HOLE CARDS ***
Dealt to chiyuki [6c Jh]
ygoegoe: folds 
snejokCoxx: folds 
jacquelinewu: raises $0.50 to $0.75
dushvan: folds 
seula i: raises $1.75 to $2.50
DutchShultzs: folds 
chiyuki: folds 
Rilko1975: calls $2.40
deadmoneykid: folds 
jacquelinewu: calls $1.75
*** FLOP *** [Ac Qd 4h]
Rilko1975: bets $2.50
jacquelinewu: folds 
seula i: calls $2.50
*** TURN *** [Ac Qd 4h] [5d]
Rilko1975: bets $4
seula i: calls $4
*** RIVER *** [Ac Qd 4h 5d] [4c]
Rilko1975: bets $5
seula i: calls $5
*** SHOW DOWN ***
Rilko1975: shows [As Ks] (two pair, Aces and Fours)
seula i: shows [Ad Kd] (two pair, Aces and Fours)
Rilko1975 collected $14.69 from pot
seula i collected $14.68 from pot
*** SUMMARY ***
Total pot $30.75 | Rake $1.38 
Board [Ac Qd 4h 5d 4c]
Seat 1: chiyuki (button) folded before Flop (didn't bet)
Seat 2: Rilko1975 (small blind) showed [As Ks] and won ($14.69) with two pair, Aces and Fours
Seat 3: deadmoneykid (big blind) folded before Flop
Seat 4: ygoegoe folded before Flop (didn't bet)
Seat 5: snejokCoxx folded before Flop (didn't bet)
Seat 6: jacquelinewu folded on the Flop
Seat 7: dushvan folded before Flop (didn't bet)
Seat 8: seula i showed [Ad Kd] and won ($14.68) with two pair, Aces and Fours
Seat 9: DutchShultzs folded before Flop (didn't bet)



PokerStars Zoom Hand #84300099812:  Hold'em No Limit ($0.10/$0.25) - 2012/08/05 15:05:41 JST [2012/08/05 2:05:41 ET]
Table 'Whirlpool' 9-max Seat #1 is the button
Seat 1: mid22 ($17.67 in chips) 
Seat 2: Nerkit ($12.25 in chips) 
Seat 3: moku36 ($17.43 in chips) 
Seat 4: GovGus ($26 in chips) 
Seat 5: 1Karina1 ($30.89 in chips) 
Seat 6: hirozo ($71.43 in chips) 
Seat 7: DutchShultzs ($33.52 in chips) 
Seat 8: pandaaaaaa ($12.15 in chips) 
Seat 9: chiyuki ($34.17 in chips) 
Nerkit: posts small blind $0.10
moku36: posts big blind $0.25
*** HOLE CARDS ***
Dealt to chiyuki [Tc 7d]
GovGus: folds 
1Karina1: calls $0.25
hirozo: raises $0.75 to $1
DutchShultzs: folds 
pandaaaaaa: folds 
chiyuki: folds 
mid22: folds 
Nerkit: folds 
moku36: folds 
1Karina1: folds 
Uncalled bet ($0.75) returned to hirozo
hirozo collected $0.85 from pot
hirozo: doesn't show hand 
*** SUMMARY ***
Total pot $0.85 | Rake $0 
Seat 1: mid22 (button) folded before Flop (didn't bet)
Seat 2: Nerkit (small blind) folded before Flop
Seat 3: moku36 (big blind) folded before Flop
Seat 4: GovGus folded before Flop (didn't bet)
Seat 5: 1Karina1 folded before Flop
Seat 6: hirozo collected ($0.85)
Seat 7: DutchShultzs folded before Flop (didn't bet)
Seat 8: pandaaaaaa folded before Flop (didn't bet)
Seat 9: chiyuki folded before Flop (didn't bet)



PokerStars Zoom Hand #84300103895:  Hold'em No Limit ($0.10/$0.25) - 2012/08/05 15:05:57 JST [2012/08/05 2:05:57 ET]
Table 'Whirlpool' 9-max Seat #1 is the button
Seat 1: Wilcox76607 ($33.10 in chips) 
Seat 2: womble32 ($28.12 in chips) 
Seat 3: 1Karina1 ($28.21 in chips) 
Seat 4: ZhukOFFskI ($47.84 in chips) 
Seat 5: deadmoneykid ($25.23 in chips) 
Seat 6: pandaaaaaa ($12.15 in chips) 
Seat 7: chiyuki ($34.07 in chips) 
Seat 8: Vahe50 ($13.94 in chips) 
Seat 9: Nerkit ($12.15 in chips) 
womble32: posts small blind $0.10
1Karina1: posts big blind $0.25
*** HOLE CARDS ***
Dealt to chiyuki [Ah 3s]
ZhukOFFskI: folds 
deadmoneykid: folds 
pandaaaaaa: raises $0.50 to $0.75
chiyuki: folds 
Vahe50: folds 
Nerkit: folds 
Wilcox76607: folds 
womble32: folds 
1Karina1: folds 
Uncalled bet ($0.50) returned to pandaaaaaa
pandaaaaaa collected $0.60 from pot
pandaaaaaa: doesn't show hand 
*** SUMMARY ***
Total pot $0.60 | Rake $0 
Seat 1: Wilcox76607 (button) folded before Flop (didn't bet)
Seat 2: womble32 (small blind) folded before Flop
Seat 3: 1Karina1 (big blind) folded before Flop
Seat 4: ZhukOFFskI folded before Flop (didn't bet)
Seat 5: deadmoneykid folded before Flop (didn't bet)
Seat 6: pandaaaaaa collected ($0.60)
Seat 7: chiyuki folded before Flop (didn't bet)
Seat 8: Vahe50 folded before Flop (didn't bet)
Seat 9: Nerkit folded before Flop (didn't bet)



PokerStars Zoom Hand #84300104948:  Hold'em No Limit ($0.10/$0.25) - 2012/08/05 15:06:01 JST [2012/08/05 2:06:01 ET]
Table 'Whirlpool' 9-max Seat #1 is the button
Seat 1: troublesomm ($25.67 in chips) 
Seat 2: Gichboy ($4.99 in chips) 
Seat 3: chiyuki ($34.07 in chips) 
Seat 4: Roglus ($12.33 in chips) 
Seat 5: colorado2108 ($53.85 in chips) 
Seat 6: INSP!RON ($25.65 in chips) 
Seat 7: Nerkit ($12.15 in chips) 
Seat 8: hirozo ($80.30 in chips) 
Seat 9: deadmoneykid ($25.23 in chips) 
Gichboy: posts small blind $0.10
chiyuki: posts big blind $0.25
*** HOLE CARDS ***
Dealt to chiyuki [Td 9s]
Roglus: folds 
colorado2108: folds 
INSP!RON: folds 
Nerkit: folds 
hirozo: raises $0.50 to $0.75
deadmoneykid: folds 
troublesomm: folds 
Gichboy: folds 
chiyuki: folds 
Uncalled bet ($0.50) returned to hirozo
hirozo collected $0.60 from pot
hirozo: doesn't show hand 
*** SUMMARY ***
Total pot $0.60 | Rake $0 
Seat 1: troublesomm (button) folded before Flop (didn't bet)
Seat 2: Gichboy (small blind) folded before Flop
Seat 3: chiyuki (big blind) folded before Flop
Seat 4: Roglus folded before Flop (didn't bet)
Seat 5: colorado2108 folded before Flop (didn't bet)
Seat 6: INSP!RON folded before Flop (didn't bet)
Seat 7: Nerkit folded before Flop (didn't bet)
Seat 8: hirozo collected ($0.60)
Seat 9: deadmoneykid folded before Flop (didn't bet)



PokerStars Zoom Hand #84300107728:  Hold'em No Limit ($0.10/$0.25) - 2012/08/05 15:06:12 JST [2012/08/05 2:06:12 ET]
Table 'Whirlpool' 9-max Seat #1 is the button
Seat 1: hirozo ($30.41 in chips) 
Seat 2: GovGus ($34.24 in chips) 
Seat 3: ygoegoe ($25.50 in chips) 
Seat 4: seula i ($25 in chips) 
Seat 5: Perstenev ($10.75 in chips) 
Seat 6: Littlea029 ($30.38 in chips) 
Seat 7: phate-1up ($25 in chips) 
Seat 8: chiyuki ($33.82 in chips) 
Seat 9: INSP!RON ($25 in chips) 
GovGus: posts small blind $0.10
ygoegoe: posts big blind $0.25
*** HOLE CARDS ***
Dealt to chiyuki [Ks Qh]
seula i: folds 
Perstenev: folds 
Littlea029: raises $0.25 to $0.50
phate-1up: folds 
chiyuki: folds 
INSP!RON: folds 
hirozo: folds 
GovGus: folds 
ygoegoe: folds 
Uncalled bet ($0.25) returned to Littlea029
Littlea029 collected $0.60 from pot
Littlea029: doesn't show hand 
*** SUMMARY ***
Total pot $0.60 | Rake $0 
Seat 1: hirozo (button) folded before Flop (didn't bet)
Seat 2: GovGus (small blind) folded before Flop
Seat 3: ygoegoe (big blind) folded before Flop
Seat 4: seula i folded before Flop (didn't bet)
Seat 5: Perstenev folded before Flop (didn't bet)
Seat 6: Littlea029 collected ($0.60)
Seat 7: phate-1up folded before Flop (didn't bet)
Seat 8: chiyuki folded before Flop (didn't bet)
Seat 9: INSP!RON folded before Flop (didn't bet)



PokerStars Zoom Hand #84300101832:  Hold'em No Limit ($0.10/$0.25) - 2012/08/05 15:05:49 JST [2012/08/05 2:05:49 ET]
Table 'Whirlpool' 9-max Seat #1 is the button
Seat 1: wildy29 ($21 in chips) 
Seat 2: chiyuki ($34.17 in chips) 
Seat 3: Silveystryk ($28.94 in chips) 
Seat 4: jeades ($13.15 in chips) 
Seat 5: womble32 ($28.12 in chips) 
Seat 6: DutchShultzs ($33.52 in chips) 
Seat 7: Roglus ($12.33 in chips) 
Seat 8: phate-1up ($54.66 in chips) 
Seat 9: KeLevro0 ($9.95 in chips) 
chiyuki: posts small blind $0.10
Silveystryk: posts big blind $0.25
*** HOLE CARDS ***
Dealt to chiyuki [4h Ac]
jeades: folds 
womble32: folds 
DutchShultzs: raises $0.50 to $0.75
Roglus: folds 
phate-1up: folds 
KeLevro0: calls $0.75
wildy29: calls $0.75
chiyuki: folds 
Silveystryk: folds 
*** FLOP *** [4s 8h Ad]
DutchShultzs: bets $1.40
KeLevro0: folds 
wildy29: calls $1.40
*** TURN *** [4s 8h Ad] [3c]
DutchShultzs: bets $3.40
wildy29: folds 
Uncalled bet ($3.40) returned to DutchShultzs
DutchShultzs collected $5.16 from pot
DutchShultzs: doesn't show hand 
*** SUMMARY ***
Total pot $5.40 | Rake $0.24 
Board [4s 8h Ad 3c]
Seat 1: wildy29 (button) folded on the Turn
Seat 2: chiyuki (small blind) folded before Flop
Seat 3: Silveystryk (big blind) folded before Flop
Seat 4: jeades folded before Flop (didn't bet)
Seat 5: womble32 folded before Flop (didn't bet)
Seat 6: DutchShultzs collected ($5.16)
Seat 7: Roglus folded before Flop (didn't bet)
Seat 8: phate-1up folded before Flop (didn't bet)
Seat 9: KeLevro0 folded on the Flop



PokerStars Zoom Hand #84300114254:  Hold'em No Limit ($0.10/$0.25) - 2012/08/05 15:06:38 JST [2012/08/05 2:06:38 ET]
Table 'Whirlpool' 9-max Seat #1 is the button
Seat 1: chiyuki ($33.82 in chips) 
Seat 2: phate-1up ($54.41 in chips) 
Seat 3: edilson_ita ($39.71 in chips) 
Seat 4: KrystalAA ($28.31 in chips) 
Seat 5: hirozo ($71.78 in chips) 
Seat 6: Gichboy ($4.89 in chips) 
Seat 7: DutchShultzs ($26.11 in chips) 
Seat 8: laurentzu84 ($27.44 in chips) 
Seat 9: snejokCoxx ($9.18 in chips) 
phate-1up: posts small blind $0.10
edilson_ita: posts big blind $0.25
*** HOLE CARDS ***
Dealt to chiyuki [Qs Kd]
KrystalAA: folds 
hirozo: raises $0.50 to $0.75
Gichboy: folds 
DutchShultzs: folds 
laurentzu84: folds 
snejokCoxx: folds 
chiyuki: folds 
phate-1up: folds 
edilson_ita: folds 
Uncalled bet ($0.50) returned to hirozo
hirozo collected $0.60 from pot
hirozo: doesn't show hand 
*** SUMMARY ***
Total pot $0.60 | Rake $0 
Seat 1: chiyuki (button) folded before Flop (didn't bet)
Seat 2: phate-1up (small blind) folded before Flop
Seat 3: edilson_ita (big blind) folded before Flop
Seat 4: KrystalAA folded before Flop (didn't bet)
Seat 5: hirozo collected ($0.60)
Seat 6: Gichboy folded before Flop (didn't bet)
Seat 7: DutchShultzs folded before Flop (didn't bet)
Seat 8: laurentzu84 folded before Flop (didn't bet)
Seat 9: snejokCoxx folded before Flop (didn't bet)



PokerStars Zoom Hand #84300120136:  Hold'em No Limit ($0.10/$0.25) - 2012/08/05 15:07:01 JST [2012/08/05 2:07:01 ET]
Table 'Whirlpool' 9-max Seat #1 is the button
Seat 1: Dan Royal ($16.27 in chips) 
Seat 2: chiyuki ($33.82 in chips) 
Seat 3: hirozo ($30.41 in chips) 
Seat 4: hobby56 ($13.31 in chips) 
Seat 5: KeLevro0 ($14.62 in chips) 
Seat 6: Dejacob ($25 in chips) 
Seat 7: risekuku468 ($39.47 in chips) 
Seat 8: womble32 ($29.04 in chips) 
Seat 9: simonzez ($24.08 in chips) 
chiyuki: posts small blind $0.10
hirozo: posts big blind $0.25
*** HOLE CARDS ***
Dealt to chiyuki [7h Ts]
hobby56: folds 
KeLevro0: folds 
Dejacob: folds 
risekuku468: folds 
womble32: folds 
simonzez: folds 
Dan Royal: raises $0.50 to $0.75
chiyuki: folds 
hirozo: folds 
Uncalled bet ($0.50) returned to Dan Royal
Dan Royal collected $0.60 from pot
Dan Royal: doesn't show hand 
*** SUMMARY ***
Total pot $0.60 | Rake $0 
Seat 1: Dan Royal (button) collected ($0.60)
Seat 2: chiyuki (small blind) folded before Flop
Seat 3: hirozo (big blind) folded before Flop
Seat 4: hobby56 folded before Flop (didn't bet)
Seat 5: KeLevro0 folded before Flop (didn't bet)
Seat 6: Dejacob folded before Flop (didn't bet)
Seat 7: risekuku468 folded before Flop (didn't bet)
Seat 8: womble32 folded before Flop (didn't bet)
Seat 9: simonzez folded before Flop (didn't bet)



PokerStars Zoom Hand #84300112398:  Hold'em No Limit ($0.10/$0.25) - 2012/08/05 15:06:31 JST [2012/08/05 2:06:31 ET]
Table 'Whirlpool' 9-max Seat #1 is the button
Seat 1: 1Karina1 ($25 in chips) 
Seat 2: Jene4kaBest ($10.07 in chips) 
Seat 3: Rilko1975 ($24 in chips) 
Seat 4: phate-1up ($25 in chips) 
Seat 5: chiyuki ($33.82 in chips) 
Seat 6: Roglus ($16.22 in chips) 
Seat 7: deepakmbh ($34.44 in chips) 
Seat 8: Gichboy ($4.89 in chips) 
Seat 9: Andrei 23rus ($20.40 in chips) 
Jene4kaBest: posts small blind $0.10
Rilko1975: posts big blind $0.25
*** HOLE CARDS ***
Dealt to chiyuki [5s 3s]
phate-1up: folds 
chiyuki: folds 
Roglus: folds 
deepakmbh: folds 
Gichboy: folds 
Andrei 23rus: folds 
1Karina1: raises $0.50 to $0.75
Jene4kaBest: folds 
Rilko1975: raises $0.75 to $1.50
1Karina1: calls $0.75
*** FLOP *** [Kh 3c As]
Rilko1975: bets $1
1Karina1: calls $1
*** TURN *** [Kh 3c As] [2d]
Rilko1975: checks 
1Karina1: checks 
*** RIVER *** [Kh 3c As 2d] [5d]
Rilko1975: bets $3
1Karina1: calls $3
*** SHOW DOWN ***
Rilko1975: shows [Kc Ac] (two pair, Aces and Kings)
1Karina1: mucks hand 
Rilko1975 collected $10.60 from pot
*** SUMMARY ***
Total pot $11.10 | Rake $0.50 
Board [Kh 3c As 2d 5d]
Seat 1: 1Karina1 (button) mucked [Jc Ad]
Seat 2: Jene4kaBest (small blind) folded before Flop
Seat 3: Rilko1975 (big blind) showed [Kc Ac] and won ($10.60) with two pair, Aces and Kings
Seat 4: phate-1up folded before Flop (didn't bet)
Seat 5: chiyuki folded before Flop (didn't bet)
Seat 6: Roglus folded before Flop (didn't bet)
Seat 7: deepakmbh folded before Flop (didn't bet)
Seat 8: Gichboy folded before Flop (didn't bet)
Seat 9: Andrei 23rus folded before Flop (didn't bet)



PokerStars Zoom Hand #84300118590:  Hold'em No Limit ($0.10/$0.25) - 2012/08/05 15:06:55 JST [2012/08/05 2:06:55 ET]
Table 'Whirlpool' 9-max Seat #1 is the button
Seat 1: GovGus ($34.14 in chips) 
Seat 2: starreset ($31.37 in chips) 
Seat 3: jacquelinewu ($43.27 in chips) 
Seat 4: snejokCoxx ($13.82 in chips) 
Seat 5: INSP!RON ($25 in chips) 
Seat 6: Silveystryk ($24.53 in chips) 
Seat 7: womble32 ($29.04 in chips) 
Seat 8: Dan Royal ($16.27 in chips) 
Seat 9: chiyuki ($33.82 in chips) 
starreset: posts small blind $0.10
jacquelinewu: posts big blind $0.25
*** HOLE CARDS ***
Dealt to chiyuki [Kd 4s]
snejokCoxx: folds 
INSP!RON: folds 
Silveystryk: calls $0.25
womble32: folds 
Dan Royal: folds 
chiyuki: folds 
GovGus: folds 
starreset: folds 
jacquelinewu: checks 
*** FLOP *** [6h 9h Ts]
jacquelinewu: checks 
Silveystryk: bets $0.25
jacquelinewu: calls $0.25
*** TURN *** [6h 9h Ts] [Td]
jacquelinewu: checks 
Silveystryk: checks 
*** RIVER *** [6h 9h Ts Td] [Js]
jacquelinewu: checks 
Silveystryk: checks 
*** SHOW DOWN ***
jacquelinewu: shows [Ks 9s] (two pair, Tens and Nines)
Silveystryk: mucks hand 
jacquelinewu collected $1.05 from pot
*** SUMMARY ***
Total pot $1.10 | Rake $0.05 
Board [6h 9h Ts Td Js]
Seat 1: GovGus (button) folded before Flop (didn't bet)
Seat 2: starreset (small blind) folded before Flop
Seat 3: jacquelinewu (big blind) showed [Ks 9s] and won ($1.05) with two pair, Tens and Nines
Seat 4: snejokCoxx folded before Flop (didn't bet)
Seat 5: INSP!RON folded before Flop (didn't bet)
Seat 6: Silveystryk mucked [As 5s]
Seat 7: womble32 folded before Flop (didn't bet)
Seat 8: Dan Royal folded before Flop (didn't bet)
Seat 9: chiyuki folded before Flop (didn't bet)



PokerStars Zoom Hand #84300117790:  Hold'em No Limit ($0.10/$0.25) - 2012/08/05 15:06:52 JST [2012/08/05 2:06:52 ET]
Table 'Whirlpool' 9-max Seat #1 is the button
Seat 1: hirozo ($80.65 in chips) 
Seat 2: moku36 ($17.18 in chips) 
Seat 3: seula i ($42.77 in chips) 
Seat 4: chiyuki ($33.82 in chips) 
Seat 5: Nerkit ($12.15 in chips) 
Seat 6: turbotom122 ($19.63 in chips) 
Seat 7: DanielWhyte ($56.84 in chips) 
Seat 8: deepakmbh ($62.36 in chips) 
Seat 9: Gichboy ($4.89 in chips) 
moku36: posts small blind $0.10
seula i: posts big blind $0.25
*** HOLE CARDS ***
Dealt to chiyuki [Ts 5s]
chiyuki: folds 
Nerkit: folds 
turbotom122: folds 
DanielWhyte: folds 
deepakmbh: raises $0.50 to $0.75
Gichboy: calls $0.75
hirozo: folds 
moku36: folds 
seula i: folds 
*** FLOP *** [9d 2d 3d]
deepakmbh: checks 
Gichboy: checks 
*** TURN *** [9d 2d 3d] [Ah]
deepakmbh: bets $1
Gichboy: folds 
Uncalled bet ($1) returned to deepakmbh
deepakmbh collected $1.77 from pot
deepakmbh: doesn't show hand 
*** SUMMARY ***
Total pot $1.85 | Rake $0.08 
Board [9d 2d 3d Ah]
Seat 1: hirozo (button) folded before Flop (didn't bet)
Seat 2: moku36 (small blind) folded before Flop
Seat 3: seula i (big blind) folded before Flop
Seat 4: chiyuki folded before Flop (didn't bet)
Seat 5: Nerkit folded before Flop (didn't bet)
Seat 6: turbotom122 folded before Flop (didn't bet)
Seat 7: DanielWhyte folded before Flop (didn't bet)
Seat 8: deepakmbh collected ($1.77)
Seat 9: Gichboy folded on the Turn



PokerStars Zoom Hand #84300133977:  Hold'em No Limit ($0.10/$0.25) - 2012/08/05 15:07:56 JST [2012/08/05 2:07:56 ET]
Table 'Whirlpool' 9-max Seat #1 is the button
Seat 1: Streikel ($8.86 in chips) 
Seat 2: KeLevro0 ($9.52 in chips) 
Seat 3: Perstenev ($13 in chips) 
Seat 4: troublesomm ($25 in chips) 
Seat 5: chiyuki ($33.47 in chips) 
Seat 6: Nerkit ($8.75 in chips) 
Seat 7: kesstukas25 ($14.43 in chips) 
Seat 8: INSP!RON ($25 in chips) 
Seat 9: hirozo ($72.03 in chips) 
KeLevro0: posts small blind $0.10
Perstenev: posts big blind $0.25
*** HOLE CARDS ***
Dealt to chiyuki [Ad 5d]
troublesomm: folds 
chiyuki: folds 
Nerkit: folds 
kesstukas25: raises $0.50 to $0.75
INSP!RON: folds 
hirozo: folds 
Streikel: folds 
KeLevro0: folds 
Perstenev: folds 
Uncalled bet ($0.50) returned to kesstukas25
kesstukas25 collected $0.60 from pot
kesstukas25: doesn't show hand 
*** SUMMARY ***
Total pot $0.60 | Rake $0 
Seat 1: Streikel (button) folded before Flop (didn't bet)
Seat 2: KeLevro0 (small blind) folded before Flop
Seat 3: Perstenev (big blind) folded before Flop
Seat 4: troublesomm folded before Flop (didn't bet)
Seat 5: chiyuki folded before Flop (didn't bet)
Seat 6: Nerkit folded before Flop (didn't bet)
Seat 7: kesstukas25 collected ($0.60)
Seat 8: INSP!RON folded before Flop (didn't bet)
Seat 9: hirozo folded before Flop (didn't bet)



PokerStars Zoom Hand #84300132686:  Hold'em No Limit ($0.10/$0.25) - 2012/08/05 15:07:51 JST [2012/08/05 2:07:51 ET]
Table 'Whirlpool' 9-max Seat #1 is the button
Seat 1: DutchShultzs ($35.53 in chips) 
Seat 2: Rilko1975 ($30.12 in chips) 
Seat 3: Silveystryk ($22.20 in chips) 
Seat 4: edilson_ita ($39.36 in chips) 
Seat 5: rorfo23 ($15.66 in chips) 
Seat 6: DanielWhyte ($56.84 in chips) 
Seat 7: chiyuki ($33.47 in chips) 
Seat 8: moku36 ($16.83 in chips) 
Seat 9: 4ydo yogurt ($22.74 in chips) 
Rilko1975: posts small blind $0.10
Silveystryk: posts big blind $0.25
*** HOLE CARDS ***
Dealt to chiyuki [5d 2d]
edilson_ita: folds 
rorfo23: folds 
DanielWhyte: folds 
chiyuki: folds 
moku36: folds 
4ydo yogurt: raises $0.50 to $0.75
DutchShultzs: folds 
Rilko1975: folds 
Silveystryk: folds 
Uncalled bet ($0.50) returned to 4ydo yogurt
4ydo yogurt collected $0.60 from pot
4ydo yogurt: doesn't show hand 
*** SUMMARY ***
Total pot $0.60 | Rake $0 
Seat 1: DutchShultzs (button) folded before Flop (didn't bet)
Seat 2: Rilko1975 (small blind) folded before Flop
Seat 3: Silveystryk (big blind) folded before Flop
Seat 4: edilson_ita folded before Flop (didn't bet)
Seat 5: rorfo23 folded before Flop (didn't bet)
Seat 6: DanielWhyte folded before Flop (didn't bet)
Seat 7: chiyuki folded before Flop (didn't bet)
Seat 8: moku36 folded before Flop (didn't bet)
Seat 9: 4ydo yogurt collected ($0.60)



PokerStars Zoom Hand #84300123739:  Hold'em No Limit ($0.10/$0.25) - 2012/08/05 15:07:15 JST [2012/08/05 2:07:15 ET]
Table 'Whirlpool' 9-max Seat #1 is the button
Seat 1: deadmoneykid ($24.88 in chips) 
Seat 2: deepakmbh ($34.54 in chips) 
Seat 3: chiyuki ($33.72 in chips) 
Seat 4: el pore 5 ($18.32 in chips) 
Seat 5: hirozo ($50.97 in chips) 
Seat 6: ygoegoe ($29.31 in chips) 
Seat 7: PillZ86 ($23.14 in chips) 
Seat 8: wildy29 ($18.75 in chips) 
Seat 9: kamikkaze ($15.27 in chips) 
deepakmbh: posts small blind $0.10
chiyuki: posts big blind $0.25
*** HOLE CARDS ***
Dealt to chiyuki [Ac Jh]
el pore 5: folds 
hirozo: folds 
ygoegoe: raises $0.50 to $0.75
PillZ86: folds 
wildy29: calls $0.75
kamikkaze: folds 
deadmoneykid: folds 
deepakmbh: calls $0.65
chiyuki: folds 
*** FLOP *** [Qs Tc Ts]
deepakmbh: checks 
ygoegoe: bets $1.31
wildy29: folds 
deepakmbh: calls $1.31
*** TURN *** [Qs Tc Ts] [Js]
deepakmbh: bets $3
ygoegoe: calls $3
*** RIVER *** [Qs Tc Ts Js] [8h]
deepakmbh: bets $6
ygoegoe: folds 
Uncalled bet ($6) returned to deepakmbh
deepakmbh collected $10.62 from pot
deepakmbh: doesn't show hand 
*** SUMMARY ***
Total pot $11.12 | Rake $0.50 
Board [Qs Tc Ts Js 8h]
Seat 1: deadmoneykid (button) folded before Flop (didn't bet)
Seat 2: deepakmbh (small blind) collected ($10.62)
Seat 3: chiyuki (big blind) folded before Flop
Seat 4: el pore 5 folded before Flop (didn't bet)
Seat 5: hirozo folded before Flop (didn't bet)
Seat 6: ygoegoe folded on the River
Seat 7: PillZ86 folded before Flop (didn't bet)
Seat 8: wildy29 folded on the Flop
Seat 9: kamikkaze folded before Flop (didn't bet)



PokerStars Zoom Hand #84300135681:  Hold'em No Limit ($0.10/$0.25) - 2012/08/05 15:08:03 JST [2012/08/05 2:08:03 ET]
Table 'Whirlpool' 9-max Seat #1 is the button
Seat 1: chiyuki ($33.47 in chips) 
Seat 2: ChrisCDee ($25.34 in chips) 
Seat 3: AAAKK777 ($25 in chips) 
Seat 4: DutchShultzs ($27.31 in chips) 
Seat 5: phate-1up ($70.33 in chips) 
Seat 6: hirozo ($72.03 in chips) 
Seat 7: snejokCoxx ($12.50 in chips) 
Seat 8: silvno31 ($24.65 in chips) 
Seat 9: Nerkit ($8.75 in chips) 
ChrisCDee: posts small blind $0.10
AAAKK777: posts big blind $0.25
*** HOLE CARDS ***
Dealt to chiyuki [Ad 7h]
DutchShultzs: folds 
phate-1up: folds 
hirozo: folds 
snejokCoxx: folds 
silvno31: folds 
Nerkit: folds 
chiyuki: raises $0.50 to $0.75
ChrisCDee: folds 
AAAKK777: raises $0.50 to $1.25
chiyuki: calls $0.50
*** FLOP *** [Td Jc 5d]
AAAKK777: bets $1.25
chiyuki: folds 
Uncalled bet ($1.25) returned to AAAKK777
AAAKK777 collected $2.48 from pot
AAAKK777: doesn't show hand 
*** SUMMARY ***
Total pot $2.60 | Rake $0.12 
Board [Td Jc 5d]
Seat 1: chiyuki (button) folded on the Flop
Seat 2: ChrisCDee (small blind) folded before Flop
Seat 3: AAAKK777 (big blind) collected ($2.48)
Seat 4: DutchShultzs folded before Flop (didn't bet)
Seat 5: phate-1up folded before Flop (didn't bet)
Seat 6: hirozo folded before Flop (didn't bet)
Seat 7: snejokCoxx folded before Flop (didn't bet)
Seat 8: silvno31 folded before Flop (didn't bet)
Seat 9: Nerkit folded before Flop (didn't bet)



PokerStars Zoom Hand #84300149814:  Hold'em No Limit ($0.10/$0.25) - 2012/08/05 15:08:59 JST [2012/08/05 2:08:59 ET]
Table 'Whirlpool' 9-max Seat #1 is the button
Seat 1: starreset ($30.34 in chips) 
Seat 2: hobby56 ($2.83 in chips) 
Seat 3: ygoegoe ($27.30 in chips) 
Seat 4: chiyuki ($32.22 in chips) 
Seat 5: laurentzu84 ($33.01 in chips) 
Seat 6: Saruotiss ($21.68 in chips) 
Seat 7: MOReilly000 ($33.70 in chips) 
Seat 8: Yoshimac ($14.18 in chips) 
Seat 9: Jene4kaBest ($6.84 in chips) 
hobby56: posts small blind $0.10
ygoegoe: posts big blind $0.25
*** HOLE CARDS ***
Dealt to chiyuki [4c 8c]
chiyuki: folds 
laurentzu84: folds 
Saruotiss: folds 
MOReilly000: raises $1 to $1.25
Yoshimac: folds 
Jene4kaBest: folds 
starreset: folds 
hobby56: folds 
ygoegoe: folds 
Uncalled bet ($1) returned to MOReilly000
MOReilly000 collected $0.60 from pot
MOReilly000: doesn't show hand 
*** SUMMARY ***
Total pot $0.60 | Rake $0 
Seat 1: starreset (button) folded before Flop (didn't bet)
Seat 2: hobby56 (small blind) folded before Flop
Seat 3: ygoegoe (big blind) folded before Flop
Seat 4: chiyuki folded before Flop (didn't bet)
Seat 5: laurentzu84 folded before Flop (didn't bet)
Seat 6: Saruotiss folded before Flop (didn't bet)
Seat 7: MOReilly000 collected ($0.60)
Seat 8: Yoshimac folded before Flop (didn't bet)
Seat 9: Jene4kaBest folded before Flop (didn't bet)



PokerStars Zoom Hand #84300147003:  Hold'em No Limit ($0.10/$0.25) - 2012/08/05 15:08:47 JST [2012/08/05 2:08:47 ET]
Table 'Whirlpool' 9-max Seat #1 is the button
Seat 1: Perstenev ($12.50 in chips) 
Seat 2: turbotom122 ($26.44 in chips) 
Seat 3: kaplya2010 ($24.65 in chips) 
Seat 4: seula i ($105.19 in chips) 
Seat 5: JhonnyP1979 ($3.44 in chips) 
Seat 6: ChrisCDee ($63.60 in chips) 
Seat 7: Rilko1975 ($28.39 in chips) 
Seat 8: starreset ($30.44 in chips) 
Seat 9: chiyuki ($32.22 in chips) 
turbotom122: posts small blind $0.10
kaplya2010: posts big blind $0.25
*** HOLE CARDS ***
Dealt to chiyuki [7h Ad]
seula i: raises $0.25 to $0.50
JhonnyP1979: raises $1 to $1.50
ChrisCDee: folds 
Rilko1975: folds 
starreset: folds 
chiyuki: folds 
Perstenev: folds 
turbotom122: folds 
kaplya2010: folds 
seula i: raises $2.75 to $4.25
JhonnyP1979: calls $1.94 and is all-in
Uncalled bet ($0.81) returned to seula i
*** FLOP *** [8s Qc Ac]
*** TURN *** [8s Qc Ac] [3h]
*** RIVER *** [8s Qc Ac 3h] [Th]
*** SHOW DOWN ***
seula i: shows [3d 3s] (three of a kind, Threes)
JhonnyP1979: shows [Qh Qs] (three of a kind, Queens)
JhonnyP1979 collected $6.90 from pot
*** SUMMARY ***
Total pot $7.23 | Rake $0.33 
Board [8s Qc Ac 3h Th]
Seat 1: Perstenev (button) folded before Flop (didn't bet)
Seat 2: turbotom122 (small blind) folded before Flop
Seat 3: kaplya2010 (big blind) folded before Flop
Seat 4: seula i showed [3d 3s] and lost with three of a kind, Threes
Seat 5: JhonnyP1979 showed [Qh Qs] and won ($6.90) with three of a kind, Queens
Seat 6: ChrisCDee folded before Flop (didn't bet)
Seat 7: Rilko1975 folded before Flop (didn't bet)
Seat 8: starreset folded before Flop (didn't bet)
Seat 9: chiyuki folded before Flop (didn't bet)



PokerStars Zoom Hand #84300146245:  Hold'em No Limit ($0.10/$0.25) - 2012/08/05 15:08:44 JST [2012/08/05 2:08:44 ET]
Table 'Whirlpool' 9-max Seat #1 is the button
Seat 1: phate-1up ($53.46 in chips) 
Seat 2: moku36 ($16.58 in chips) 
Seat 3: pandaaaaaa ($12.05 in chips) 
Seat 4: 1Karina1 ($25 in chips) 
Seat 5: Silveystryk ($27.59 in chips) 
Seat 6: chiyuki ($32.22 in chips) 
Seat 7: mid22 ($16.58 in chips) 
Seat 8: laurentzu84 ($33.01 in chips) 
Seat 9: yane73 ($66.58 in chips) 
moku36: posts small blind $0.10
pandaaaaaa: posts big blind $0.25
*** HOLE CARDS ***
Dealt to chiyuki [5s Kh]
1Karina1: folds 
Silveystryk: folds 
chiyuki: folds 
mid22: calls $0.25
laurentzu84: folds 
yane73: calls $0.25
phate-1up: folds 
moku36: calls $0.15
pandaaaaaa: checks 
*** FLOP *** [As 4h Th]
moku36: bets $1
pandaaaaaa: folds 
mid22: calls $1
yane73: folds 
*** TURN *** [As 4h Th] [Ac]
moku36: bets $1.25
mid22: calls $1.25
*** RIVER *** [As 4h Th Ac] [2s]
moku36: bets $1.25
mid22: calls $1.25
*** SHOW DOWN ***
moku36: shows [7c Ah] (three of a kind, Aces)
mid22: mucks hand 
moku36 collected $7.64 from pot
*** SUMMARY ***
Total pot $8 | Rake $0.36 
Board [As 4h Th Ac 2s]
Seat 1: phate-1up (button) folded before Flop (didn't bet)
Seat 2: moku36 (small blind) showed [7c Ah] and won ($7.64) with three of a kind, Aces
Seat 3: pandaaaaaa (big blind) folded on the Flop
Seat 4: 1Karina1 folded before Flop (didn't bet)
Seat 5: Silveystryk folded before Flop (didn't bet)
Seat 6: chiyuki folded before Flop (didn't bet)
Seat 7: mid22 mucked [Jc Jh]
Seat 8: laurentzu84 folded before Flop (didn't bet)
Seat 9: yane73 folded on the Flop



PokerStars Zoom Hand #84300150564:  Hold'em No Limit ($0.10/$0.25) - 2012/08/05 15:09:02 JST [2012/08/05 2:09:02 ET]
Table 'Whirlpool' 9-max Seat #1 is the button
Seat 1: troublesomm ($26.02 in chips) 
Seat 2: chiyuki ($32.22 in chips) 
Seat 3: deepakmbh ($40.10 in chips) 
Seat 4: DanielWhyte ($56.84 in chips) 
Seat 5: jacquelinewu ($38.56 in chips) 
Seat 6: Perstenev ($13 in chips) 
Seat 7: Nerkit ($11.40 in chips) 
Seat 8: PillZ86 ($14.39 in chips) 
Seat 9: Vahe50 ($14.51 in chips) 
chiyuki: posts small blind $0.10
deepakmbh: posts big blind $0.25
*** HOLE CARDS ***
Dealt to chiyuki [Ah 4c]
DanielWhyte: folds 
jacquelinewu: raises $0.50 to $0.75
Perstenev: folds 
Nerkit: folds 
PillZ86: folds 
Vahe50: folds 
troublesomm: folds 
chiyuki: folds 
deepakmbh: calls $0.50
*** FLOP *** [Kd Ad 9h]
deepakmbh: checks 
jacquelinewu: bets $1.07
deepakmbh: raises $2.73 to $3.80
jacquelinewu: folds 
Uncalled bet ($2.73) returned to deepakmbh
deepakmbh collected $3.57 from pot
deepakmbh: doesn't show hand 
*** SUMMARY ***
Total pot $3.74 | Rake $0.17 
Board [Kd Ad 9h]
Seat 1: troublesomm (button) folded before Flop (didn't bet)
Seat 2: chiyuki (small blind) folded before Flop
Seat 3: deepakmbh (big blind) collected ($3.57)
Seat 4: DanielWhyte folded before Flop (didn't bet)
Seat 5: jacquelinewu folded on the Flop
Seat 6: Perstenev folded before Flop (didn't bet)
Seat 7: Nerkit folded before Flop (didn't bet)
Seat 8: PillZ86 folded before Flop (didn't bet)
Seat 9: Vahe50 folded before Flop (didn't bet)



PokerStars Zoom Hand #84300155046:  Hold'em No Limit ($0.10/$0.25) - 2012/08/05 15:09:19 JST [2012/08/05 2:09:19 ET]
Table 'Whirlpool' 9-max Seat #1 is the button
Seat 1: Lasutchik ($75.58 in chips) 
Seat 2: DutchShultzs ($26.54 in chips) 
Seat 3: River_GmbH ($19.24 in chips) 
Seat 4: Roglus ($11.48 in chips) 
Seat 5: 4ydo yogurt ($32.73 in chips) 
Seat 6: rorfo23 ($14.01 in chips) 
Seat 7: snejokCoxx ($11.38 in chips) 
Seat 8: chiyuki ($32.12 in chips) 
Seat 9: edilson_ita ($23.39 in chips) 
DutchShultzs: posts small blind $0.10
River_GmbH: posts big blind $0.25
*** HOLE CARDS ***
Dealt to chiyuki [2d 3h]
Roglus: folds 
4ydo yogurt: raises $0.25 to $0.50
rorfo23: folds 
snejokCoxx: folds 
chiyuki: folds 
edilson_ita: folds 
Lasutchik: folds 
DutchShultzs: folds 
River_GmbH: folds 
Uncalled bet ($0.25) returned to 4ydo yogurt
4ydo yogurt collected $0.60 from pot
4ydo yogurt: doesn't show hand 
*** SUMMARY ***
Total pot $0.60 | Rake $0 
Seat 1: Lasutchik (button) folded before Flop (didn't bet)
Seat 2: DutchShultzs (small blind) folded before Flop
Seat 3: River_GmbH (big blind) folded before Flop
Seat 4: Roglus folded before Flop (didn't bet)
Seat 5: 4ydo yogurt collected ($0.60)
Seat 6: rorfo23 folded before Flop (didn't bet)
Seat 7: snejokCoxx folded before Flop (didn't bet)
Seat 8: chiyuki folded before Flop (didn't bet)
Seat 9: edilson_ita folded before Flop (didn't bet)



PokerStars Zoom Hand #84300156259:  Hold'em No Limit ($0.10/$0.25) - 2012/08/05 15:09:24 JST [2012/08/05 2:09:24 ET]
Table 'Whirlpool' 9-max Seat #1 is the button
Seat 1: chiyuki ($32.12 in chips) 
Seat 2: Roglus ($8.58 in chips) 
Seat 3: bigred1102 ($24.73 in chips) 
Seat 4: rorfo23 ($14.01 in chips) 
Seat 5: Rafioso ($12.50 in chips) 
Seat 6: pandaaaaaa ($11.55 in chips) 
Seat 7: 1Karina1 ($29.79 in chips) 
Seat 8: Alvinpe85 ($44.21 in chips) 
Seat 9: Streikel ($10.02 in chips) 
Roglus: posts small blind $0.10
bigred1102: posts big blind $0.25
*** HOLE CARDS ***
Dealt to chiyuki [6s Ts]
rorfo23: raises $0.50 to $0.75
Rafioso: folds 
pandaaaaaa: folds 
1Karina1: folds 
Alvinpe85: folds 
Streikel: calls $0.75
chiyuki: folds 
Roglus: folds 
bigred1102: calls $0.50
*** FLOP *** [Th Ah 7c]
bigred1102: checks 
rorfo23: bets $1
Streikel: folds 
bigred1102: folds 
Uncalled bet ($1) returned to rorfo23
rorfo23 collected $2.24 from pot
rorfo23: doesn't show hand 
*** SUMMARY ***
Total pot $2.35 | Rake $0.11 
Board [Th Ah 7c]
Seat 1: chiyuki (button) folded before Flop (didn't bet)
Seat 2: Roglus (small blind) folded before Flop
Seat 3: bigred1102 (big blind) folded on the Flop
Seat 4: rorfo23 collected ($2.24)
Seat 5: Rafioso folded before Flop (didn't bet)
Seat 6: pandaaaaaa folded before Flop (didn't bet)
Seat 7: 1Karina1 folded before Flop (didn't bet)
Seat 8: Alvinpe85 folded before Flop (didn't bet)
Seat 9: Streikel folded on the Flop



PokerStars Zoom Hand #84300164770:  Hold'em No Limit ($0.10/$0.25) - 2012/08/05 15:09:57 JST [2012/08/05 2:09:57 ET]
Table 'Whirlpool' 9-max Seat #1 is the button
Seat 1: 1Karina1 ($29.75 in chips) 
Seat 2: kamikkaze ($15.43 in chips) 
Seat 3: risekuku468 ($37.12 in chips) 
Seat 4: luyifei ($19.53 in chips) 
Seat 5: masterkoolb ($13.62 in chips) 
Seat 6: chiyuki ($31.87 in chips) 
Seat 7: KrystalAA ($31.82 in chips) 
Seat 8: Perstenev ($12.65 in chips) 
Seat 9: dushvan ($44.73 in chips) 
kamikkaze: posts small blind $0.10
risekuku468: posts big blind $0.25
*** HOLE CARDS ***
Dealt to chiyuki [6c 5s]
luyifei: folds 
masterkoolb: folds 
chiyuki: folds 
KrystalAA: raises $0.46 to $0.71
Perstenev: folds 
dushvan: folds 
1Karina1: folds 
kamikkaze: folds 
risekuku468: folds 
Uncalled bet ($0.46) returned to KrystalAA
KrystalAA collected $0.60 from pot
KrystalAA: doesn't show hand 
*** SUMMARY ***
Total pot $0.60 | Rake $0 
Seat 1: 1Karina1 (button) folded before Flop (didn't bet)
Seat 2: kamikkaze (small blind) folded before Flop
Seat 3: risekuku468 (big blind) folded before Flop
Seat 4: luyifei folded before Flop (didn't bet)
Seat 5: masterkoolb folded before Flop (didn't bet)
Seat 6: chiyuki folded before Flop (didn't bet)
Seat 7: KrystalAA collected ($0.60)
Seat 8: Perstenev folded before Flop (didn't bet)
Seat 9: dushvan folded before Flop (didn't bet)



PokerStars Zoom Hand #84300165580:  Hold'em No Limit ($0.10/$0.25) - 2012/08/05 15:10:00 JST [2012/08/05 2:10:00 ET]
Table 'Whirlpool' 9-max Seat #1 is the button
Seat 1: masterkoolb ($13.62 in chips) 
Seat 2: gunbowler ($225.15 in chips) 
Seat 3: Dan Royal ($20.55 in chips) 
Seat 4: DutchShultzs ($35.53 in chips) 
Seat 5: chiyuki ($31.87 in chips) 
Seat 6: jacquelinewu ($48.72 in chips) 
Seat 7: 1Karina1 ($29.75 in chips) 
Seat 8: 4plankton ($20.99 in chips) 
Seat 9: silvno31 ($27.40 in chips) 
gunbowler: posts small blind $0.10
Dan Royal: posts big blind $0.25
*** HOLE CARDS ***
Dealt to chiyuki [9d As]
DutchShultzs: folds 
chiyuki: folds 
jacquelinewu: raises $0.50 to $0.75
1Karina1: folds 
4plankton: folds 
silvno31: folds 
masterkoolb: folds 
gunbowler: folds 
Dan Royal: raises $1.50 to $2.25
jacquelinewu: folds 
Uncalled bet ($1.50) returned to Dan Royal
Dan Royal collected $1.60 from pot
Dan Royal: doesn't show hand 
*** SUMMARY ***
Total pot $1.60 | Rake $0 
Seat 1: masterkoolb (button) folded before Flop (didn't bet)
Seat 2: gunbowler (small blind) folded before Flop
Seat 3: Dan Royal (big blind) collected ($1.60)
Seat 4: DutchShultzs folded before Flop (didn't bet)
Seat 5: chiyuki folded before Flop (didn't bet)
Seat 6: jacquelinewu folded before Flop
Seat 7: 1Karina1 folded before Flop (didn't bet)
Seat 8: 4plankton folded before Flop (didn't bet)
Seat 9: silvno31 folded before Flop (didn't bet)



PokerStars Zoom Hand #84300161414:  Hold'em No Limit ($0.10/$0.25) - 2012/08/05 15:09:44 JST [2012/08/05 2:09:44 ET]
Table 'Whirlpool' 9-max Seat #1 is the button
Seat 1: Dan Royal ($20.55 in chips) 
Seat 2: dushvan ($44.83 in chips) 
Seat 3: chiyuki ($32.12 in chips) 
Seat 4: ZhukOFFskI ($31.68 in chips) 
Seat 5: Dejacob ($27.41 in chips) 
Seat 6: Alvinpe85 ($44.21 in chips) 
Seat 7: Rafioso ($12.50 in chips) 
Seat 8: kamikkaze ($14.75 in chips) 
Seat 9: Faantomace ($11.58 in chips) 
dushvan: posts small blind $0.10
chiyuki: posts big blind $0.25
*** HOLE CARDS ***
Dealt to chiyuki [6d 4c]
ZhukOFFskI: folds 
Dejacob: raises $0.50 to $0.75
Alvinpe85: folds 
Rafioso: folds 
kamikkaze: folds 
Faantomace: calls $0.75
Dan Royal: folds 
dushvan: folds 
chiyuki: folds 
*** FLOP *** [5d 8d 2c]
Dejacob: bets $1.25
Faantomace: raises $9.58 to $10.83 and is all-in
Dejacob: folds 
Uncalled bet ($9.58) returned to Faantomace
Faantomace collected $4.15 from pot
Faantomace: doesn't show hand 
*** SUMMARY ***
Total pot $4.35 | Rake $0.20 
Board [5d 8d 2c]
Seat 1: Dan Royal (button) folded before Flop (didn't bet)
Seat 2: dushvan (small blind) folded before Flop
Seat 3: chiyuki (big blind) folded before Flop
Seat 4: ZhukOFFskI folded before Flop (didn't bet)
Seat 5: Dejacob folded on the Flop
Seat 6: Alvinpe85 folded before Flop (didn't bet)
Seat 7: Rafioso folded before Flop (didn't bet)
Seat 8: kamikkaze folded before Flop (didn't bet)
Seat 9: Faantomace collected ($4.15)



PokerStars Zoom Hand #84300157807:  Hold'em No Limit ($0.10/$0.25) - 2012/08/05 15:09:30 JST [2012/08/05 2:09:30 ET]
Table 'Whirlpool' 9-max Seat #1 is the button
Seat 1: risekuku468 ($37.12 in chips) 
Seat 2: phate-1up ($25.10 in chips) 
Seat 3: JhonnyP1979 ($6.80 in chips) 
Seat 4: wildy29 ($32.73 in chips) 
Seat 5: colorado2108 ($42.98 in chips) 
Seat 6: Ellen1947 ($23.51 in chips) 
Seat 7: chiyuki ($32.12 in chips) 
Seat 8: jacquelinewu ($36.74 in chips) 
Seat 9: ChrisCDee ($63.50 in chips) 
phate-1up: posts small blind $0.10
JhonnyP1979: posts big blind $0.25
*** HOLE CARDS ***
Dealt to chiyuki [Td As]
wildy29: calls $0.25
colorado2108: folds 
Ellen1947: folds 
chiyuki: folds 
jacquelinewu: folds 
ChrisCDee: calls $0.25
risekuku468: folds 
phate-1up: folds 
JhonnyP1979: checks 
*** FLOP *** [Kc Ah 2c]
JhonnyP1979: checks 
wildy29: bets $0.25
ChrisCDee: folds 
JhonnyP1979: calls $0.25
*** TURN *** [Kc Ah 2c] [9c]
JhonnyP1979: checks 
wildy29: bets $0.25
JhonnyP1979: calls $0.25
*** RIVER *** [Kc Ah 2c 9c] [Ac]
JhonnyP1979: checks 
wildy29: bets $0.25
JhonnyP1979: folds 
Uncalled bet ($0.25) returned to wildy29
wildy29 collected $1.77 from pot
wildy29: doesn't show hand 
*** SUMMARY ***
Total pot $1.85 | Rake $0.08 
Board [Kc Ah 2c 9c Ac]
Seat 1: risekuku468 (button) folded before Flop (didn't bet)
Seat 2: phate-1up (small blind) folded before Flop
Seat 3: JhonnyP1979 (big blind) folded on the River
Seat 4: wildy29 collected ($1.77)
Seat 5: colorado2108 folded before Flop (didn't bet)
Seat 6: Ellen1947 folded before Flop (didn't bet)
Seat 7: chiyuki folded before Flop (didn't bet)
Seat 8: jacquelinewu folded before Flop (didn't bet)
Seat 9: ChrisCDee folded on the Flop



PokerStars Zoom Hand #84300167354:  Hold'em No Limit ($0.10/$0.25) - 2012/08/05 15:10:08 JST [2012/08/05 2:10:08 ET]
Table 'Whirlpool' 9-max Seat #1 is the button
Seat 1: Nerkit ($9.05 in chips) 
Seat 2: Sal y Limon1 ($24.75 in chips) 
Seat 3: INSP!RON ($25 in chips) 
Seat 4: Silveystryk ($23.99 in chips) 
Seat 5: risekuku468 ($36.87 in chips) 
Seat 6: Ellen1947 ($24.75 in chips) 
Seat 7: ChrisCDee ($63.25 in chips) 
Seat 8: kamikkaze ($15.33 in chips) 
Seat 9: chiyuki ($31.87 in chips) 
Sal y Limon1: posts small blind $0.10
INSP!RON: posts big blind $0.25
*** HOLE CARDS ***
Dealt to chiyuki [Jc Kh]
Silveystryk: folds 
risekuku468: folds 
Ellen1947: folds 
ChrisCDee: folds 
kamikkaze: folds 
chiyuki: raises $0.50 to $0.75
Nerkit: calls $0.75
Sal y Limon1: folds 
INSP!RON: folds 
*** FLOP *** [7h Td 6c]
chiyuki: bets $0.88
Nerkit: calls $0.88
*** TURN *** [7h Td 6c] [2d]
chiyuki: checks 
Nerkit: bets $1.75
chiyuki: folds 
Uncalled bet ($1.75) returned to Nerkit
Nerkit collected $3.45 from pot
Nerkit: doesn't show hand 
*** SUMMARY ***
Total pot $3.61 | Rake $0.16 
Board [7h Td 6c 2d]
Seat 1: Nerkit (button) collected ($3.45)
Seat 2: Sal y Limon1 (small blind) folded before Flop
Seat 3: INSP!RON (big blind) folded before Flop
Seat 4: Silveystryk folded before Flop (didn't bet)
Seat 5: risekuku468 folded before Flop (didn't bet)
Seat 6: Ellen1947 folded before Flop (didn't bet)
Seat 7: ChrisCDee folded before Flop (didn't bet)
Seat 8: kamikkaze folded before Flop (didn't bet)
Seat 9: chiyuki folded on the Turn



PokerStars Zoom Hand #84300180946:  Hold'em No Limit ($0.10/$0.25) - 2012/08/05 15:11:01 JST [2012/08/05 2:11:01 ET]
Table 'Whirlpool' 9-max Seat #1 is the button
Seat 1: WARIBANA7777 ($17.81 in chips) 
Seat 2: yane73 ($64.18 in chips) 
Seat 3: Littlea029 ($31.86 in chips) 
Seat 4: seula i ($36.56 in chips) 
Seat 5: pandaaaaaa ($10.05 in chips) 
Seat 6: starreset ($30.37 in chips) 
Seat 7: DutchShultzs ($34.39 in chips) 
Seat 8: chiyuki ($30.24 in chips) 
Seat 9: Nerkit ($11.75 in chips) 
yane73: posts small blind $0.10
Littlea029: posts big blind $0.25
*** HOLE CARDS ***
Dealt to chiyuki [Js 3c]
seula i: folds 
pandaaaaaa: folds 
starreset: folds 
DutchShultzs: folds 
chiyuki: folds 
Nerkit: folds 
WARIBANA7777: folds 
yane73: folds 
Uncalled bet ($0.15) returned to Littlea029
Littlea029 collected $0.20 from pot
Littlea029: doesn't show hand 
*** SUMMARY ***
Total pot $0.20 | Rake $0 
Seat 1: WARIBANA7777 (button) folded before Flop (didn't bet)
Seat 2: yane73 (small blind) folded before Flop
Seat 3: Littlea029 (big blind) collected ($0.20)
Seat 4: seula i folded before Flop (didn't bet)
Seat 5: pandaaaaaa folded before Flop (didn't bet)
Seat 6: starreset folded before Flop (didn't bet)
Seat 7: DutchShultzs folded before Flop (didn't bet)
Seat 8: chiyuki folded before Flop (didn't bet)
Seat 9: Nerkit folded before Flop (didn't bet)



PokerStars Zoom Hand #84300181948:  Hold'em No Limit ($0.10/$0.25) - 2012/08/05 15:11:05 JST [2012/08/05 2:11:05 ET]
Table 'Whirlpool' 9-max Seat #1 is the button
Seat 1: womble32 ($28.71 in chips) 
Seat 2: tribunpdm ($29.75 in chips) 
Seat 3: WARIBANA7777 ($17.81 in chips) 
Seat 4: DutchShultzs ($34.39 in chips) 
Seat 5: Dejacob ($25.91 in chips) 
Seat 6: kwkim73 ($25 in chips) 
Seat 7: chiyuki ($30.24 in chips) 
Seat 8: Nerkit ($10.87 in chips) 
Seat 9: Dan Royal ($21.30 in chips) 
tribunpdm: posts small blind $0.10
WARIBANA7777: posts big blind $0.25
*** HOLE CARDS ***
Dealt to chiyuki [As Ah]
DutchShultzs: folds 
Dejacob: folds 
kwkim73: folds 
chiyuki: raises $0.50 to $0.75
Nerkit: folds 
Dan Royal: folds 
womble32: calls $0.75
tribunpdm: folds 
WARIBANA7777: folds 
*** FLOP *** [Qh Ks Kd]
chiyuki: checks 
womble32: checks 
*** TURN *** [Qh Ks Kd] [5s]
chiyuki: bets $1
womble32: folds 
Uncalled bet ($1) returned to chiyuki
chiyuki collected $1.77 from pot
chiyuki: doesn't show hand 
*** SUMMARY ***
Total pot $1.85 | Rake $0.08 
Board [Qh Ks Kd 5s]
Seat 1: womble32 (button) folded on the Turn
Seat 2: tribunpdm (small blind) folded before Flop
Seat 3: WARIBANA7777 (big blind) folded before Flop
Seat 4: DutchShultzs folded before Flop (didn't bet)
Seat 5: Dejacob folded before Flop (didn't bet)
Seat 6: kwkim73 folded before Flop (didn't bet)
Seat 7: chiyuki collected ($1.77)
Seat 8: Nerkit folded before Flop (didn't bet)
Seat 9: Dan Royal folded before Flop (didn't bet)



PokerStars Zoom Hand #84300191953:  Hold'em No Limit ($0.10/$0.25) - 2012/08/05 15:11:45 JST [2012/08/05 2:11:45 ET]
Table 'Whirlpool' 9-max Seat #1 is the button
Seat 1: kwkim73 ($29.55 in chips) 
Seat 2: seula i ($29.71 in chips) 
Seat 3: troublesomm ($28 in chips) 
Seat 4: Perstenev ($18.28 in chips) 
Seat 5: chiyuki ($31.26 in chips) 
Seat 6: Dejacob ($25.66 in chips) 
Seat 7: snejokCoxx ($10.38 in chips) 
Seat 8: ZhukOFFskI ($31.08 in chips) 
Seat 9: hirozo ($47.22 in chips) 
seula i: posts small blind $0.10
troublesomm: posts big blind $0.25
*** HOLE CARDS ***
Dealt to chiyuki [4c 4d]
Perstenev: folds 
chiyuki: raises $0.50 to $0.75
Dejacob: calls $0.75
snejokCoxx: folds 
ZhukOFFskI: folds 
hirozo: folds 
kwkim73: folds 
seula i: folds 
troublesomm: folds 
*** FLOP *** [9s 9d 7c]
chiyuki: bets $1
Dejacob: calls $1
*** TURN *** [9s 9d 7c] [Th]
chiyuki: bets $2.50
Dejacob: calls $2.50
*** RIVER *** [9s 9d 7c Th] [Ks]
chiyuki: checks 
Dejacob: bets $5.25
chiyuki: folds 
Uncalled bet ($5.25) returned to Dejacob
Dejacob collected $8.45 from pot
Dejacob: doesn't show hand 
*** SUMMARY ***
Total pot $8.85 | Rake $0.40 
Board [9s 9d 7c Th Ks]
Seat 1: kwkim73 (button) folded before Flop (didn't bet)
Seat 2: seula i (small blind) folded before Flop
Seat 3: troublesomm (big blind) folded before Flop
Seat 4: Perstenev folded before Flop (didn't bet)
Seat 5: chiyuki folded on the River
Seat 6: Dejacob collected ($8.45)
Seat 7: snejokCoxx folded before Flop (didn't bet)
Seat 8: ZhukOFFskI folded before Flop (didn't bet)
Seat 9: hirozo folded before Flop (didn't bet)



PokerStars Zoom Hand #84300203117:  Hold'em No Limit ($0.10/$0.25) - 2012/08/05 15:12:29 JST [2012/08/05 2:12:29 ET]
Table 'Whirlpool' 9-max Seat #1 is the button
Seat 1: snejokCoxx ($11.80 in chips) 
Seat 2: seula i ($40.82 in chips) 
Seat 3: kamikkaze ($13.20 in chips) 
Seat 4: Perstenev ($10.40 in chips) 
Seat 5: starreset ($32.63 in chips) 
Seat 6: chiyuki ($27.01 in chips) 
Seat 7: pandaaaaaa ($9.45 in chips) 
Seat 8: Tom1999 ($23.12 in chips) 
Seat 9: Silveystryk ($19.98 in chips) 
seula i: posts small blind $0.10
kamikkaze: posts big blind $0.25
*** HOLE CARDS ***
Dealt to chiyuki [2h Ks]
Perstenev: folds 
starreset: folds 
chiyuki: folds 
pandaaaaaa: folds 
Tom1999: raises $0.50 to $0.75
Silveystryk: folds 
snejokCoxx: folds 
seula i: folds 
kamikkaze: folds 
Uncalled bet ($0.50) returned to Tom1999
Tom1999 collected $0.60 from pot
Tom1999: doesn't show hand 
*** SUMMARY ***
Total pot $0.60 | Rake $0 
Seat 1: snejokCoxx (button) folded before Flop (didn't bet)
Seat 2: seula i (small blind) folded before Flop
Seat 3: kamikkaze (big blind) folded before Flop
Seat 4: Perstenev folded before Flop (didn't bet)
Seat 5: starreset folded before Flop (didn't bet)
Seat 6: chiyuki folded before Flop (didn't bet)
Seat 7: pandaaaaaa folded before Flop (didn't bet)
Seat 8: Tom1999 collected ($0.60)
Seat 9: Silveystryk folded before Flop (didn't bet)



PokerStars Zoom Hand #84300205908:  Hold'em No Limit ($0.10/$0.25) - 2012/08/05 15:12:41 JST [2012/08/05 2:12:41 ET]
Table 'Whirlpool' 9-max Seat #1 is the button
Seat 1: kesstukas25 ($12.98 in chips) 
Seat 2: Nerkit ($23.02 in chips) 
Seat 3: hirozo ($33.20 in chips) 
Seat 4: womble32 ($27.21 in chips) 
Seat 5: pandaaaaaa ($9.45 in chips) 
Seat 6: seula i ($101.10 in chips) 
Seat 7: DPsemplic ($6.21 in chips) 
Seat 8: kamikkaze ($12.95 in chips) 
Seat 9: chiyuki ($26.91 in chips) 
Nerkit: posts small blind $0.10
hirozo: posts big blind $0.25
*** HOLE CARDS ***
Dealt to chiyuki [Jd Qc]
womble32: folds 
pandaaaaaa: folds 
seula i: folds 
DPsemplic: raises $0.25 to $0.50
kamikkaze: folds 
chiyuki: folds 
kesstukas25: folds 
Nerkit: folds 
hirozo: folds 
Uncalled bet ($0.25) returned to DPsemplic
DPsemplic collected $0.60 from pot
DPsemplic: doesn't show hand 
*** SUMMARY ***
Total pot $0.60 | Rake $0 
Seat 1: kesstukas25 (button) folded before Flop (didn't bet)
Seat 2: Nerkit (small blind) folded before Flop
Seat 3: hirozo (big blind) folded before Flop
Seat 4: womble32 folded before Flop (didn't bet)
Seat 5: pandaaaaaa folded before Flop (didn't bet)
Seat 6: seula i folded before Flop (didn't bet)
Seat 7: DPsemplic collected ($0.60)
Seat 8: kamikkaze folded before Flop (didn't bet)
Seat 9: chiyuki folded before Flop (didn't bet)



PokerStars Zoom Hand #84300204640:  Hold'em No Limit ($0.10/$0.25) - 2012/08/05 15:12:36 JST [2012/08/05 2:12:36 ET]
Table 'Whirlpool' 9-max Seat #1 is the button
Seat 1: Nerkit ($23.02 in chips) 
Seat 2: chiyuki ($27.01 in chips) 
Seat 3: Roglus ($8.25 in chips) 
Seat 4: KeLevro0 ($11.60 in chips) 
Seat 5: mjmichi ($32.30 in chips) 
Seat 6: pandaaaaaa ($9.45 in chips) 
Seat 7: 1Karina1 ($25 in chips) 
Seat 8: Silveystryk ($19.98 in chips) 
Seat 9: jacquelinewu ($38.10 in chips) 
chiyuki: posts small blind $0.10
Roglus: posts big blind $0.25
*** HOLE CARDS ***
Dealt to chiyuki [5c 6c]
KeLevro0: folds 
mjmichi: folds 
pandaaaaaa: folds 
1Karina1: folds 
Silveystryk: calls $0.25
jacquelinewu: folds 
Nerkit: folds 
chiyuki: folds 
Roglus: checks 
*** FLOP *** [Jh 2d 7h]
Roglus: checks 
Silveystryk: bets $0.25
Roglus: calls $0.25
*** TURN *** [Jh 2d 7h] [Jc]
Roglus: checks 
Silveystryk: checks 
*** RIVER *** [Jh 2d 7h Jc] [6d]
Roglus: checks 
Silveystryk: checks 
*** SHOW DOWN ***
Roglus: shows [6h 2c] (two pair, Jacks and Sixes)
Silveystryk: mucks hand 
Roglus collected $1.05 from pot
*** SUMMARY ***
Total pot $1.10 | Rake $0.05 
Board [Jh 2d 7h Jc 6d]
Seat 1: Nerkit (button) folded before Flop (didn't bet)
Seat 2: chiyuki (small blind) folded before Flop
Seat 3: Roglus (big blind) showed [6h 2c] and won ($1.05) with two pair, Jacks and Sixes
Seat 4: KeLevro0 folded before Flop (didn't bet)
Seat 5: mjmichi folded before Flop (didn't bet)
Seat 6: pandaaaaaa folded before Flop (didn't bet)
Seat 7: 1Karina1 folded before Flop (didn't bet)
Seat 8: Silveystryk mucked [3c 3d]
Seat 9: jacquelinewu folded before Flop (didn't bet)



PokerStars Zoom Hand #84300214478:  Hold'em No Limit ($0.10/$0.25) - 2012/08/05 15:13:15 JST [2012/08/05 2:13:15 ET]
Table 'Whirlpool' 9-max Seat #1 is the button
Seat 1: Lasutchik ($75.46 in chips) 
Seat 2: ygoegoe ($28.71 in chips) 
Seat 3: yane73 ($42.88 in chips) 
Seat 4: jacquelinewu ($26.21 in chips) 
Seat 5: deadmoneykid ($31.59 in chips) 
Seat 6: turbotom122 ($28.37 in chips) 
Seat 7: Rilko1975 ($31.16 in chips) 
Seat 8: chiyuki ($26.66 in chips) 
Seat 9: Dan Royal ($41.54 in chips) 
ygoegoe: posts small blind $0.10
yane73: posts big blind $0.25
*** HOLE CARDS ***
Dealt to chiyuki [3h 7c]
jacquelinewu: folds 
deadmoneykid: folds 
turbotom122: folds 
Rilko1975: raises $0.25 to $0.50
chiyuki: folds 
Dan Royal: folds 
Lasutchik: folds 
ygoegoe: folds 
yane73: folds 
Uncalled bet ($0.25) returned to Rilko1975
Rilko1975 collected $0.60 from pot
Rilko1975: doesn't show hand 
*** SUMMARY ***
Total pot $0.60 | Rake $0 
Seat 1: Lasutchik (button) folded before Flop (didn't bet)
Seat 2: ygoegoe (small blind) folded before Flop
Seat 3: yane73 (big blind) folded before Flop
Seat 4: jacquelinewu folded before Flop (didn't bet)
Seat 5: deadmoneykid folded before Flop (didn't bet)
Seat 6: turbotom122 folded before Flop (didn't bet)
Seat 7: Rilko1975 collected ($0.60)
Seat 8: chiyuki folded before Flop (didn't bet)
Seat 9: Dan Royal folded before Flop (didn't bet)



PokerStars Zoom Hand #84300211505:  Hold'em No Limit ($0.10/$0.25) - 2012/08/05 15:13:03 JST [2012/08/05 2:13:03 ET]
Table 'Whirlpool' 9-max Seat #1 is the button
Seat 1: chiyuki ($26.66 in chips) 
Seat 2: DutchShultzs ($35.18 in chips) 
Seat 3: seula i ($101 in chips) 
Seat 4: Alvinpe85 ($42.82 in chips) 
Seat 5: GovGus ($27.28 in chips) 
Seat 6: laurentzu84 ($25 in chips) 
Seat 7: Rilko1975 ($23.07 in chips) 
Seat 8: troublesomm ($39.79 in chips) 
Seat 9: INSP!RON ($26.37 in chips) 
DutchShultzs: posts small blind $0.10
seula i: posts big blind $0.25
*** HOLE CARDS ***
Dealt to chiyuki [9d 8d]
Alvinpe85: raises $0.50 to $0.75
GovGus: folds 
laurentzu84: folds 
Rilko1975: folds 
troublesomm: folds 
INSP!RON: folds 
chiyuki: folds 
DutchShultzs: folds 
seula i: raises $3.75 to $4.50
Alvinpe85: folds 
Uncalled bet ($3.75) returned to seula i
seula i collected $1.60 from pot
seula i: doesn't show hand 
*** SUMMARY ***
Total pot $1.60 | Rake $0 
Seat 1: chiyuki (button) folded before Flop (didn't bet)
Seat 2: DutchShultzs (small blind) folded before Flop
Seat 3: seula i (big blind) collected ($1.60)
Seat 4: Alvinpe85 folded before Flop
Seat 5: GovGus folded before Flop (didn't bet)
Seat 6: laurentzu84 folded before Flop (didn't bet)
Seat 7: Rilko1975 folded before Flop (didn't bet)
Seat 8: troublesomm folded before Flop (didn't bet)
Seat 9: INSP!RON folded before Flop (didn't bet)



PokerStars Zoom Hand #84300218798:  Hold'em No Limit ($0.10/$0.25) - 2012/08/05 15:13:32 JST [2012/08/05 2:13:32 ET]
Table 'Whirlpool' 9-max Seat #1 is the button
Seat 1: Rilko1975 ($22.82 in chips) 
Seat 2: starreset ($34.24 in chips) 
Seat 3: laurentzu84 ($25 in chips) 
Seat 4: snejokCoxx ($10.03 in chips) 
Seat 5: WARIBANA7777 ($17.11 in chips) 
Seat 6: chiyuki ($26.66 in chips) 
Seat 7: el pore 5 ($8.56 in chips) 
Seat 8: Sal y Limon1 ($24.75 in chips) 
Seat 9: phate-1up ($25.25 in chips) 
starreset: posts small blind $0.10
laurentzu84: posts big blind $0.25
*** HOLE CARDS ***
Dealt to chiyuki [3h 9d]
snejokCoxx: folds 
WARIBANA7777: folds 
chiyuki: folds 
el pore 5: folds 
Sal y Limon1: folds 
phate-1up: folds 
Rilko1975: folds 
starreset: folds 
Uncalled bet ($0.15) returned to laurentzu84
laurentzu84 collected $0.20 from pot
laurentzu84: doesn't show hand 
*** SUMMARY ***
Total pot $0.20 | Rake $0 
Seat 1: Rilko1975 (button) folded before Flop (didn't bet)
Seat 2: starreset (small blind) folded before Flop
Seat 3: laurentzu84 (big blind) collected ($0.20)
Seat 4: snejokCoxx folded before Flop (didn't bet)
Seat 5: WARIBANA7777 folded before Flop (didn't bet)
Seat 6: chiyuki folded before Flop (didn't bet)
Seat 7: el pore 5 folded before Flop (didn't bet)
Seat 8: Sal y Limon1 folded before Flop (didn't bet)
Seat 9: phate-1up folded before Flop (didn't bet)



PokerStars Zoom Hand #84300219552:  Hold'em No Limit ($0.10/$0.25) - 2012/08/05 15:13:35 JST [2012/08/05 2:13:35 ET]
Table 'Whirlpool' 9-max Seat #1 is the button
Seat 1: KeLevro0 ($11.85 in chips) 
Seat 2: Sal y Limon1 ($24.75 in chips) 
Seat 3: kamikkaze ($12.85 in chips) 
Seat 4: chiyuki ($26.66 in chips) 
Seat 5: yane73 ($42.63 in chips) 
Seat 6: masterkoolb ($12.50 in chips) 
Seat 7: GovGus ($28.20 in chips) 
Seat 8: starreset ($34.14 in chips) 
Seat 9: d8hetniet ($12.66 in chips) 
Sal y Limon1: posts small blind $0.10
kamikkaze: posts big blind $0.25
*** HOLE CARDS ***
Dealt to chiyuki [6s Qd]
chiyuki: folds 
yane73: raises $0.50 to $0.75
masterkoolb: folds 
GovGus: folds 
starreset: folds 
d8hetniet: folds 
KeLevro0: folds 
Sal y Limon1: folds 
kamikkaze: folds 
Uncalled bet ($0.50) returned to yane73
yane73 collected $0.60 from pot
yane73: doesn't show hand 
*** SUMMARY ***
Total pot $0.60 | Rake $0 
Seat 1: KeLevro0 (button) folded before Flop (didn't bet)
Seat 2: Sal y Limon1 (small blind) folded before Flop
Seat 3: kamikkaze (big blind) folded before Flop
Seat 4: chiyuki folded before Flop (didn't bet)
Seat 5: yane73 collected ($0.60)
Seat 6: masterkoolb folded before Flop (didn't bet)
Seat 7: GovGus folded before Flop (didn't bet)
Seat 8: starreset folded before Flop (didn't bet)
Seat 9: d8hetniet folded before Flop (didn't bet)



PokerStars Zoom Hand #84300224415:  Hold'em No Limit ($0.10/$0.25) - 2012/08/05 15:13:55 JST [2012/08/05 2:13:55 ET]
Table 'Whirlpool' 9-max Seat #1 is the button
Seat 1: phate-1up ($58.97 in chips) 
Seat 2: Tom1999 ($14.86 in chips) 
Seat 3: chiyuki ($26.56 in chips) 
Seat 4: Paranoix1990 ($10.09 in chips) 
Seat 5: MarginX ($24 in chips) 
Seat 6: therati ($18.48 in chips) 
Seat 7: Alvinpe85 ($45.40 in chips) 
Seat 8: jacquelinewu ($38 in chips) 
Seat 9: Dejacob ($32.87 in chips) 
Tom1999: posts small blind $0.10
chiyuki: posts big blind $0.25
*** HOLE CARDS ***
Dealt to chiyuki [Qh 7d]
Paranoix1990: folds 
MarginX: folds 
therati: folds 
Alvinpe85: folds 
jacquelinewu: folds 
Dejacob: folds 
phate-1up: raises $0.50 to $0.75
Tom1999: folds 
chiyuki: folds 
Uncalled bet ($0.50) returned to phate-1up
phate-1up collected $0.60 from pot
phate-1up: doesn't show hand 
*** SUMMARY ***
Total pot $0.60 | Rake $0 
Seat 1: phate-1up (button) collected ($0.60)
Seat 2: Tom1999 (small blind) folded before Flop
Seat 3: chiyuki (big blind) folded before Flop
Seat 4: Paranoix1990 folded before Flop (didn't bet)
Seat 5: MarginX folded before Flop (didn't bet)
Seat 6: therati folded before Flop (didn't bet)
Seat 7: Alvinpe85 folded before Flop (didn't bet)
Seat 8: jacquelinewu folded before Flop (didn't bet)
Seat 9: Dejacob folded before Flop (didn't bet)



PokerStars Zoom Hand #84300221339:  Hold'em No Limit ($0.10/$0.25) - 2012/08/05 15:13:42 JST [2012/08/05 2:13:42 ET]
Table 'Whirlpool' 9-max Seat #1 is the button
Seat 1: HighDuka ($40.57 in chips) 
Seat 2: deadmoneykid ($24.66 in chips) 
Seat 3: snejokCoxx ($10.03 in chips) 
Seat 4: chiyuki ($26.56 in chips) 
Seat 5: Saruotiss ($46.53 in chips) 
Seat 6: Nerkit ($14.90 in chips) 
Seat 7: Dan Royal ($41.29 in chips) 
Seat 8: INSP!RON ($31.10 in chips) 
Seat 9: Tom1999 ($20.72 in chips) 
deadmoneykid: posts small blind $0.10
snejokCoxx: posts big blind $0.25
*** HOLE CARDS ***
Dealt to chiyuki [Ad Jc]
chiyuki: folds 
Saruotiss: folds 
Nerkit: folds 
Dan Royal: folds 
INSP!RON: folds 
Tom1999: folds 
HighDuka: raises $0.50 to $0.75
deadmoneykid: folds 
snejokCoxx: folds 
Uncalled bet ($0.50) returned to HighDuka
HighDuka collected $0.60 from pot
HighDuka: doesn't show hand 
*** SUMMARY ***
Total pot $0.60 | Rake $0 
Seat 1: HighDuka (button) collected ($0.60)
Seat 2: deadmoneykid (small blind) folded before Flop
Seat 3: snejokCoxx (big blind) folded before Flop
Seat 4: chiyuki folded before Flop (didn't bet)
Seat 5: Saruotiss folded before Flop (didn't bet)
Seat 6: Nerkit folded before Flop (didn't bet)
Seat 7: Dan Royal folded before Flop (didn't bet)
Seat 8: INSP!RON folded before Flop (didn't bet)
Seat 9: Tom1999 folded before Flop (didn't bet)



PokerStars Zoom Hand #84300207740:  Hold'em No Limit ($0.10/$0.25) - 2012/08/05 15:12:48 JST [2012/08/05 2:12:48 ET]
Table 'Whirlpool' 9-max Seat #1 is the button
Seat 1: Dejacob ($25 in chips) 
Seat 2: karpexxx ($12.25 in chips) 
Seat 3: chiyuki ($26.91 in chips) 
Seat 4: Alvinpe85 ($45.75 in chips) 
Seat 5: mjmichi ($32.77 in chips) 
Seat 6: womble32 ($27.21 in chips) 
Seat 7: tribunpdm ($32.03 in chips) 
Seat 8: seula i ($40.72 in chips) 
Seat 9: puffy5533 ($24.75 in chips) 
karpexxx: posts small blind $0.10
chiyuki: posts big blind $0.25
*** HOLE CARDS ***
Dealt to chiyuki [4d 3s]
Alvinpe85: folds 
mjmichi: raises $0.50 to $0.75
womble32: calls $0.75
tribunpdm: folds 
seula i: folds 
puffy5533: folds 
Dejacob: calls $0.75
karpexxx: calls $0.65
chiyuki: folds 
*** FLOP *** [5s Ts 8h]
karpexxx: checks 
mjmichi: checks 
womble32: checks 
Dejacob: checks 
*** TURN *** [5s Ts 8h] [Th]
karpexxx: bets $2.25
mjmichi: folds 
womble32: folds 
Dejacob: folds 
Uncalled bet ($2.25) returned to karpexxx
karpexxx collected $3.10 from pot
karpexxx: doesn't show hand 
*** SUMMARY ***
Total pot $3.25 | Rake $0.15 
Board [5s Ts 8h Th]
Seat 1: Dejacob (button) folded on the Turn
Seat 2: karpexxx (small blind) collected ($3.10)
Seat 3: chiyuki (big blind) folded before Flop
Seat 4: Alvinpe85 folded before Flop (didn't bet)
Seat 5: mjmichi folded on the Turn
Seat 6: womble32 folded on the Turn
Seat 7: tribunpdm folded before Flop (didn't bet)
Seat 8: seula i folded before Flop (didn't bet)
Seat 9: puffy5533 folded before Flop (didn't bet)



PokerStars Zoom Hand #84300220564:  Hold'em No Limit ($0.10/$0.25) - 2012/08/05 15:13:39 JST [2012/08/05 2:13:39 ET]
Table 'Whirlpool' 9-max Seat #1 is the button
Seat 1: DutchShultzs ($32.64 in chips) 
Seat 2: chiyuki ($26.66 in chips) 
Seat 3: phate-1up ($59.22 in chips) 
Seat 4: Rilko1975 ($22.82 in chips) 
Seat 5: kaplya2010 ($26.09 in chips) 
Seat 6: GovGus ($28.20 in chips) 
Seat 7: hirozo ($74.36 in chips) 
Seat 8: troublesomm ($35.70 in chips) 
Seat 9: starreset ($34.14 in chips) 
chiyuki: posts small blind $0.10
phate-1up: posts big blind $0.25
*** HOLE CARDS ***
Dealt to chiyuki [6d Qc]
Rilko1975: folds 
kaplya2010: raises $0.25 to $0.50
GovGus: calls $0.50
hirozo: folds 
troublesomm: folds 
starreset: calls $0.50
DutchShultzs: folds 
chiyuki: folds 
phate-1up: folds 
*** FLOP *** [Ks 7h 2c]
kaplya2010: checks 
GovGus: bets $1.15
starreset: folds 
kaplya2010: folds 
Uncalled bet ($1.15) returned to GovGus
GovGus collected $1.77 from pot
GovGus: doesn't show hand 
*** SUMMARY ***
Total pot $1.85 | Rake $0.08 
Board [Ks 7h 2c]
Seat 1: DutchShultzs (button) folded before Flop (didn't bet)
Seat 2: chiyuki (small blind) folded before Flop
Seat 3: phate-1up (big blind) folded before Flop
Seat 4: Rilko1975 folded before Flop (didn't bet)
Seat 5: kaplya2010 folded on the Flop
Seat 6: GovGus collected ($1.77)
Seat 7: hirozo folded before Flop (didn't bet)
Seat 8: troublesomm folded before Flop (didn't bet)
Seat 9: starreset folded on the Flop



PokerStars Zoom Hand #84300228227:  Hold'em No Limit ($0.10/$0.25) - 2012/08/05 15:14:10 JST [2012/08/05 2:14:10 ET]
Table 'Whirlpool' 9-max Seat #1 is the button
Seat 1: NuMetal88 ($25.67 in chips) 
Seat 2: GravyWalrus ($11.81 in chips) 
Seat 3: Dejacob ($26.02 in chips) 
Seat 4: wildy29 ($37.18 in chips) 
Seat 5: chiyuki ($26.31 in chips) 
Seat 6: KrystalAA ($29.60 in chips) 
Seat 7: GovGus ($33.31 in chips) 
Seat 8: mjmichi ($32.02 in chips) 
Seat 9: AntoineHunt ($18.51 in chips) 
GravyWalrus: posts small blind $0.10
Dejacob: posts big blind $0.25
*** HOLE CARDS ***
Dealt to chiyuki [4s Qd]
wildy29: folds 
chiyuki: folds 
KrystalAA: folds 
GovGus: folds 
mjmichi: folds 
AntoineHunt: folds 
NuMetal88: raises $0.50 to $0.75
GravyWalrus: folds 
Dejacob: folds 
Uncalled bet ($0.50) returned to NuMetal88
NuMetal88 collected $0.60 from pot
NuMetal88: doesn't show hand 
*** SUMMARY ***
Total pot $0.60 | Rake $0 
Seat 1: NuMetal88 (button) collected ($0.60)
Seat 2: GravyWalrus (small blind) folded before Flop
Seat 3: Dejacob (big blind) folded before Flop
Seat 4: wildy29 folded before Flop (didn't bet)
Seat 5: chiyuki folded before Flop (didn't bet)
Seat 6: KrystalAA folded before Flop (didn't bet)
Seat 7: GovGus folded before Flop (didn't bet)
Seat 8: mjmichi folded before Flop (didn't bet)
Seat 9: AntoineHunt folded before Flop (didn't bet)



PokerStars Zoom Hand #84300223403:  Hold'em No Limit ($0.10/$0.25) - 2012/08/05 15:13:51 JST [2012/08/05 2:13:51 ET]
Table 'Whirlpool' 9-max Seat #1 is the button
Seat 1: chiyuki ($26.56 in chips) 
Seat 2: troublesomm ($35.70 in chips) 
Seat 3: ChrisCDee ($45.61 in chips) 
Seat 4: dushvan ($33.54 in chips) 
Seat 5: seula i ($28.86 in chips) 
Seat 6: deadmoneykid ($31.59 in chips) 
Seat 7: MarginX ($24 in chips) 
Seat 8: Dejacob ($32.87 in chips) 
Seat 9: 1Karina1 ($28.70 in chips) 
troublesomm: posts small blind $0.10
ChrisCDee: posts big blind $0.25
*** HOLE CARDS ***
Dealt to chiyuki [4h 8h]
dushvan: folds 
seula i: folds 
deadmoneykid: folds 
MarginX: folds 
Dejacob: folds 
1Karina1: raises $0.50 to $0.75
chiyuki: folds 
troublesomm: folds 
ChrisCDee: calls $0.50
*** FLOP *** [3s 4s Qc]
ChrisCDee: checks 
1Karina1: bets $1
ChrisCDee: folds 
Uncalled bet ($1) returned to 1Karina1
1Karina1 collected $1.53 from pot
1Karina1: doesn't show hand 
*** SUMMARY ***
Total pot $1.60 | Rake $0.07 
Board [3s 4s Qc]
Seat 1: chiyuki (button) folded before Flop (didn't bet)
Seat 2: troublesomm (small blind) folded before Flop
Seat 3: ChrisCDee (big blind) folded on the Flop
Seat 4: dushvan folded before Flop (didn't bet)
Seat 5: seula i folded before Flop (didn't bet)
Seat 6: deadmoneykid folded before Flop (didn't bet)
Seat 7: MarginX folded before Flop (didn't bet)
Seat 8: Dejacob folded before Flop (didn't bet)
Seat 9: 1Karina1 collected ($1.53)



PokerStars Zoom Hand #84300216437:  Hold'em No Limit ($0.10/$0.25) - 2012/08/05 15:13:23 JST [2012/08/05 2:13:23 ET]
Table 'Whirlpool' 9-max Seat #1 is the button
Seat 1: deadmoneykid ($25.46 in chips) 
Seat 2: DutchShultzs ($32.74 in chips) 
Seat 3: svg51 ($14.07 in chips) 
Seat 4: masterkoolb ($15.06 in chips) 
Seat 5: kwkim73 ($25 in chips) 
Seat 6: pandaaaaaa ($9.72 in chips) 
Seat 7: chiyuki ($26.66 in chips) 
Seat 8: KeLevro0 ($11.25 in chips) 
Seat 9: Sal y Limon1 ($24.75 in chips) 
DutchShultzs: posts small blind $0.10
svg51: posts big blind $0.25
*** HOLE CARDS ***
Dealt to chiyuki [Qh 8h]
masterkoolb: folds 
kwkim73: folds 
pandaaaaaa: folds 
chiyuki: folds 
KeLevro0: raises $0.42 to $0.67
Sal y Limon1: folds 
deadmoneykid: calls $0.67
DutchShultzs: folds 
svg51: folds 
*** FLOP *** [9c Kd 8d]
KeLevro0: bets $0.90
deadmoneykid: calls $0.90
*** TURN *** [9c Kd 8d] [Qs]
KeLevro0: checks 
deadmoneykid: checks 
*** RIVER *** [9c Kd 8d Qs] [Td]
KeLevro0: checks 
deadmoneykid: checks 
*** SHOW DOWN ***
KeLevro0: shows [4d 4h] (a pair of Fours)
deadmoneykid: shows [Ac Qc] (a pair of Queens)
deadmoneykid collected $3.33 from pot
*** SUMMARY ***
Total pot $3.49 | Rake $0.16 
Board [9c Kd 8d Qs Td]
Seat 1: deadmoneykid (button) showed [Ac Qc] and won ($3.33) with a pair of Queens
Seat 2: DutchShultzs (small blind) folded before Flop
Seat 3: svg51 (big blind) folded before Flop
Seat 4: masterkoolb folded before Flop (didn't bet)
Seat 5: kwkim73 folded before Flop (didn't bet)
Seat 6: pandaaaaaa folded before Flop (didn't bet)
Seat 7: chiyuki folded before Flop (didn't bet)
Seat 8: KeLevro0 showed [4d 4h] and lost with a pair of Fours
Seat 9: Sal y Limon1 folded before Flop (didn't bet)



PokerStars Zoom Hand #84300230506:  Hold'em No Limit ($0.10/$0.25) - 2012/08/05 15:14:19 JST [2012/08/05 2:14:19 ET]
Table 'Whirlpool' 9-max Seat #1 is the button
Seat 1: KeLevro0 ($11.75 in chips) 
Seat 2: DanielWhyte ($65.06 in chips) 
Seat 3: pandaaaaaa ($10.02 in chips) 
Seat 4: Lasutchik ($75.21 in chips) 
Seat 5: Sal y Limon1 ($24.75 in chips) 
Seat 6: Rilko1975 ($22.72 in chips) 
Seat 7: kwkim73 ($26.44 in chips) 
Seat 8: chiyuki ($26.31 in chips) 
Seat 9: PAMBOS.L ($20.50 in chips) 
DanielWhyte: posts small blind $0.10
pandaaaaaa: posts big blind $0.25
*** HOLE CARDS ***
Dealt to chiyuki [Kc 6c]
Lasutchik: folds 
Sal y Limon1: folds 
Rilko1975: folds 
kwkim73: folds 
chiyuki: folds 
PAMBOS.L: folds 
KeLevro0: folds 
DanielWhyte: folds 
Uncalled bet ($0.15) returned to pandaaaaaa
pandaaaaaa collected $0.20 from pot
pandaaaaaa: doesn't show hand 
*** SUMMARY ***
Total pot $0.20 | Rake $0 
Seat 1: KeLevro0 (button) folded before Flop (didn't bet)
Seat 2: DanielWhyte (small blind) folded before Flop
Seat 3: pandaaaaaa (big blind) collected ($0.20)
Seat 4: Lasutchik folded before Flop (didn't bet)
Seat 5: Sal y Limon1 folded before Flop (didn't bet)
Seat 6: Rilko1975 folded before Flop (didn't bet)
Seat 7: kwkim73 folded before Flop (didn't bet)
Seat 8: chiyuki folded before Flop (didn't bet)
Seat 9: PAMBOS.L folded before Flop (didn't bet)



PokerStars Zoom Hand #84300229479:  Hold'em No Limit ($0.10/$0.25) - 2012/08/05 15:14:15 JST [2012/08/05 2:14:15 ET]
Table 'Whirlpool' 9-max Seat #1 is the button
Seat 1: wildy29 ($37.18 in chips) 
Seat 2: troublesomm ($25 in chips) 
Seat 3: silvno31 ($28.37 in chips) 
Seat 4: jacquelinewu ($38 in chips) 
Seat 5: AAAKK777 ($29.64 in chips) 
Seat 6: PAMBOS.L ($20.50 in chips) 
Seat 7: masterkoolb ($15.31 in chips) 
Seat 8: Rilko1975 ($22.72 in chips) 
Seat 9: chiyuki ($26.31 in chips) 
troublesomm: posts small blind $0.10
silvno31: posts big blind $0.25
*** HOLE CARDS ***
Dealt to chiyuki [7h 6c]
jacquelinewu: folds 
AAAKK777: folds 
PAMBOS.L: folds 
masterkoolb: folds 
Rilko1975: folds 
chiyuki: folds 
wildy29: calls $0.25
troublesomm: folds 
silvno31: checks 
*** FLOP *** [5c Kd 7d]
silvno31: checks 
wildy29: checks 
*** TURN *** [5c Kd 7d] [Jd]
silvno31: checks 
wildy29: checks 
*** RIVER *** [5c Kd 7d Jd] [9c]
silvno31: checks 
wildy29: checks 
*** SHOW DOWN ***
silvno31: shows [6d 5s] (a pair of Fives)
wildy29: mucks hand 
silvno31 collected $0.57 from pot
*** SUMMARY ***
Total pot $0.60 | Rake $0.03 
Board [5c Kd 7d Jd 9c]
Seat 1: wildy29 (button) mucked [6s Ad]
Seat 2: troublesomm (small blind) folded before Flop
Seat 3: silvno31 (big blind) showed [6d 5s] and won ($0.57) with a pair of Fives
Seat 4: jacquelinewu folded before Flop (didn't bet)
Seat 5: AAAKK777 folded before Flop (didn't bet)
Seat 6: PAMBOS.L folded before Flop (didn't bet)
Seat 7: masterkoolb folded before Flop (didn't bet)
Seat 8: Rilko1975 folded before Flop (didn't bet)
Seat 9: chiyuki folded before Flop (didn't bet)



PokerStars Zoom Hand #84300227511:  Hold'em No Limit ($0.10/$0.25) - 2012/08/05 15:14:07 JST [2012/08/05 2:14:07 ET]
Table 'Whirlpool' 9-max Seat #1 is the button
Seat 1: bigred1102 ($10.73 in chips) 
Seat 2: deadmoneykid ($32.21 in chips) 
Seat 3: GovGus ($26.02 in chips) 
Seat 4: chiyuki ($26.31 in chips) 
Seat 5: seula i ($101.75 in chips) 
Seat 6: Ellen1947 ($25 in chips) 
Seat 7: kwkim73 ($29.15 in chips) 
Seat 8: el pore 5 ($8.81 in chips) 
Seat 9: silvno31 ($28.37 in chips) 
deadmoneykid: posts small blind $0.10
GovGus: posts big blind $0.25
*** HOLE CARDS ***
Dealt to chiyuki [Qs 2s]
chiyuki: folds 
seula i: raises $0.50 to $0.75
Ellen1947: folds 
kwkim73: folds 
el pore 5: folds 
silvno31: folds 
bigred1102: folds 
deadmoneykid: folds 
GovGus: folds 
Uncalled bet ($0.50) returned to seula i
seula i collected $0.60 from pot
seula i: doesn't show hand 
*** SUMMARY ***
Total pot $0.60 | Rake $0 
Seat 1: bigred1102 (button) folded before Flop (didn't bet)
Seat 2: deadmoneykid (small blind) folded before Flop
Seat 3: GovGus (big blind) folded before Flop
Seat 4: chiyuki folded before Flop (didn't bet)
Seat 5: seula i collected ($0.60)
Seat 6: Ellen1947 folded before Flop (didn't bet)
Seat 7: kwkim73 folded before Flop (didn't bet)
Seat 8: el pore 5 folded before Flop (didn't bet)
Seat 9: silvno31 folded before Flop (didn't bet)



PokerStars Zoom Hand #84300232014:  Hold'em No Limit ($0.10/$0.25) - 2012/08/05 15:14:25 JST [2012/08/05 2:14:25 ET]
Table 'Whirlpool' 9-max Seat #1 is the button
Seat 1: kaplya2010 ($25.49 in chips) 
Seat 2: WARIBANA7777 ($16.86 in chips) 
Seat 3: Nerkit ($10.55 in chips) 
Seat 4: ChrisCDee ($44.86 in chips) 
Seat 5: GovGus ($33.31 in chips) 
Seat 6: DutchShultzs ($34.08 in chips) 
Seat 7: chiyuki ($26.31 in chips) 
Seat 8: rey2040 ($11.95 in chips) 
Seat 9: Rilko1975 ($32.63 in chips) 
WARIBANA7777: posts small blind $0.10
Nerkit: posts big blind $0.25
*** HOLE CARDS ***
Dealt to chiyuki [Qs Ac]
ChrisCDee: folds 
GovGus: folds 
DutchShultzs: folds 
chiyuki: raises $0.50 to $0.75
rey2040: folds 
Rilko1975: folds 
kaplya2010: calls $0.75
WARIBANA7777: folds 
Nerkit: folds 
*** FLOP *** [Ad Qh 5d]
chiyuki: bets $1.25
kaplya2010: raises $1.25 to $2.50
chiyuki: raises $3 to $5.50
kaplya2010: calls $3
*** TURN *** [Ad Qh 5d] [6d]
chiyuki: bets $6
kaplya2010: folds 
Uncalled bet ($6) returned to chiyuki
chiyuki collected $12.27 from pot
chiyuki: doesn't show hand 
*** SUMMARY ***
Total pot $12.85 | Rake $0.58 
Board [Ad Qh 5d 6d]
Seat 1: kaplya2010 (button) folded on the Turn
Seat 2: WARIBANA7777 (small blind) folded before Flop
Seat 3: Nerkit (big blind) folded before Flop
Seat 4: ChrisCDee folded before Flop (didn't bet)
Seat 5: GovGus folded before Flop (didn't bet)
Seat 6: DutchShultzs folded before Flop (didn't bet)
Seat 7: chiyuki collected ($12.27)
Seat 8: rey2040 folded before Flop (didn't bet)
Seat 9: Rilko1975 folded before Flop (didn't bet)



PokerStars Zoom Hand #84300249414:  Hold'em No Limit ($0.10/$0.25) - 2012/08/05 15:15:34 JST [2012/08/05 2:15:34 ET]
Table 'Whirlpool' 9-max Seat #1 is the button
Seat 1: INSP!RON ($30.20 in chips) 
Seat 2: chiyuki ($32.33 in chips) 
Seat 3: Dan Royal ($40.69 in chips) 
Seat 4: snejokCoxx ($11.44 in chips) 
Seat 5: ygoegoe ($30.67 in chips) 
Seat 6: pandaaaaaa ($10.02 in chips) 
Seat 7: DanielWhyte ($67.11 in chips) 
Seat 8: nastya040 ($18.37 in chips) 
Seat 9: dushvan ($32.84 in chips) 
chiyuki: posts small blind $0.10
Dan Royal: posts big blind $0.25
*** HOLE CARDS ***
Dealt to chiyuki [6h 7s]
snejokCoxx: folds 
ygoegoe: folds 
pandaaaaaa: folds 
DanielWhyte: calls $0.25
nastya040: folds 
dushvan: folds 
INSP!RON: folds 
chiyuki: folds 
Dan Royal: checks 
*** FLOP *** [4d 7h 3d]
Dan Royal: checks 
DanielWhyte: checks 
*** TURN *** [4d 7h 3d] [9s]
Dan Royal: checks 
DanielWhyte: bets $0.25
Dan Royal: calls $0.25
*** RIVER *** [4d 7h 3d 9s] [Td]
Dan Royal: checks 
DanielWhyte: checks 
*** SHOW DOWN ***
Dan Royal: shows [4h Qs] (a pair of Fours)
DanielWhyte: shows [9h Qh] (a pair of Nines)
DanielWhyte collected $1.05 from pot
*** SUMMARY ***
Total pot $1.10 | Rake $0.05 
Board [4d 7h 3d 9s Td]
Seat 1: INSP!RON (button) folded before Flop (didn't bet)
Seat 2: chiyuki (small blind) folded before Flop
Seat 3: Dan Royal (big blind) showed [4h Qs] and lost with a pair of Fours
Seat 4: snejokCoxx folded before Flop (didn't bet)
Seat 5: ygoegoe folded before Flop (didn't bet)
Seat 6: pandaaaaaa folded before Flop (didn't bet)
Seat 7: DanielWhyte showed [9h Qh] and won ($1.05) with a pair of Nines
Seat 8: nastya040 folded before Flop (didn't bet)
Seat 9: dushvan folded before Flop (didn't bet)



PokerStars Zoom Hand #84300250175:  Hold'em No Limit ($0.10/$0.25) - 2012/08/05 15:15:37 JST [2012/08/05 2:15:37 ET]
Table 'Whirlpool' 9-max Seat #1 is the button
Seat 1: dergeb ($16.68 in chips) 
Seat 2: Jene4kaBest ($11.90 in chips) 
Seat 3: chiyuki ($32.23 in chips) 
Seat 4: Perstenev ($13.09 in chips) 
Seat 5: jacquelinewu ($25 in chips) 
Seat 6: Rilko1975 ($31.78 in chips) 
Seat 7: 1Karina1 ($31.17 in chips) 
Seat 8: KrystalAA ($20.56 in chips) 
Seat 9: MarginX ($23.90 in chips) 
Jene4kaBest: posts small blind $0.10
chiyuki: posts big blind $0.25
*** HOLE CARDS ***
Dealt to chiyuki [2h Kc]
Perstenev: folds 
jacquelinewu: folds 
Rilko1975: raises $0.50 to $0.75
1Karina1: folds 
KrystalAA: folds 
MarginX: calls $0.75
dergeb: folds 
Jene4kaBest: folds 
chiyuki: folds 
*** FLOP *** [Qc 8c 3h]
Rilko1975: bets $0.75
MarginX: raises $1.25 to $2
Rilko1975: calls $1.25
*** TURN *** [Qc 8c 3h] [7h]
Rilko1975: bets $1
MarginX: folds 
Uncalled bet ($1) returned to Rilko1975
Rilko1975 collected $5.59 from pot
Rilko1975: doesn't show hand 
*** SUMMARY ***
Total pot $5.85 | Rake $0.26 
Board [Qc 8c 3h 7h]
Seat 1: dergeb (button) folded before Flop (didn't bet)
Seat 2: Jene4kaBest (small blind) folded before Flop
Seat 3: chiyuki (big blind) folded before Flop
Seat 4: Perstenev folded before Flop (didn't bet)
Seat 5: jacquelinewu folded before Flop (didn't bet)
Seat 6: Rilko1975 collected ($5.59)
Seat 7: 1Karina1 folded before Flop (didn't bet)
Seat 8: KrystalAA folded before Flop (didn't bet)
Seat 9: MarginX folded on the Turn



PokerStars Zoom Hand #84300259235:  Hold'em No Limit ($0.10/$0.25) - 2012/08/05 15:16:14 JST [2012/08/05 2:16:14 ET]
Table 'Whirlpool' 9-max Seat #1 is the button
Seat 1: Dan Royal ($40.09 in chips) 
Seat 2: d8hetniet ($14.49 in chips) 
Seat 3: womble32 ($27.03 in chips) 
Seat 4: 1Karina1 ($37.45 in chips) 
Seat 5: rey2040 ($11.55 in chips) 
Seat 6: chiyuki ($31.98 in chips) 
Seat 7: Silveystryk ($26.98 in chips) 
Seat 8: grand maitre ($24.30 in chips) 
Seat 9: ChrisCDee ($72.77 in chips) 
d8hetniet: posts small blind $0.10
womble32: posts big blind $0.25
*** HOLE CARDS ***
Dealt to chiyuki [8s 8h]
1Karina1: folds 
rey2040: folds 
chiyuki: raises $0.50 to $0.75
Silveystryk: folds 
grand maitre: folds 
ChrisCDee: folds 
Dan Royal: folds 
d8hetniet: folds 
womble32: folds 
Uncalled bet ($0.50) returned to chiyuki
chiyuki collected $0.60 from pot
chiyuki: doesn't show hand 
*** SUMMARY ***
Total pot $0.60 | Rake $0 
Seat 1: Dan Royal (button) folded before Flop (didn't bet)
Seat 2: d8hetniet (small blind) folded before Flop
Seat 3: womble32 (big blind) folded before Flop
Seat 4: 1Karina1 folded before Flop (didn't bet)
Seat 5: rey2040 folded before Flop (didn't bet)
Seat 6: chiyuki collected ($0.60)
Seat 7: Silveystryk folded before Flop (didn't bet)
Seat 8: grand maitre folded before Flop (didn't bet)
Seat 9: ChrisCDee folded before Flop (didn't bet)



PokerStars Zoom Hand #84300263361:  Hold'em No Limit ($0.10/$0.25) - 2012/08/05 15:16:30 JST [2012/08/05 2:16:30 ET]
Table 'Whirlpool' 9-max Seat #1 is the button
Seat 1: seula i ($27.76 in chips) 
Seat 2: GovGus ($35.93 in chips) 
Seat 3: DanielWhyte ($67.56 in chips) 
Seat 4: MarginX ($21.15 in chips) 
Seat 5: Ellen1947 ($24.90 in chips) 
Seat 6: Silveystryk ($17.48 in chips) 
Seat 7: Paranoix1990 ($6.72 in chips) 
Seat 8: chiyuki ($32.33 in chips) 
Seat 9: INSP!RON ($25 in chips) 
GovGus: posts small blind $0.10
DanielWhyte: posts big blind $0.25
*** HOLE CARDS ***
Dealt to chiyuki [Td Kc]
MarginX: folds 
Ellen1947: folds 
Silveystryk: raises $0.50 to $0.75
Paranoix1990: folds 
chiyuki: folds 
INSP!RON: folds 
seula i: folds 
GovGus: folds 
DanielWhyte: folds 
Uncalled bet ($0.50) returned to Silveystryk
Silveystryk collected $0.60 from pot
Silveystryk: doesn't show hand 
*** SUMMARY ***
Total pot $0.60 | Rake $0 
Seat 1: seula i (button) folded before Flop (didn't bet)
Seat 2: GovGus (small blind) folded before Flop
Seat 3: DanielWhyte (big blind) folded before Flop
Seat 4: MarginX folded before Flop (didn't bet)
Seat 5: Ellen1947 folded before Flop (didn't bet)
Seat 6: Silveystryk collected ($0.60)
Seat 7: Paranoix1990 folded before Flop (didn't bet)
Seat 8: chiyuki folded before Flop (didn't bet)
Seat 9: INSP!RON folded before Flop (didn't bet)



PokerStars Zoom Hand #84300265635:  Hold'em No Limit ($0.10/$0.25) - 2012/08/05 15:16:39 JST [2012/08/05 2:16:39 ET]
Table 'Whirlpool' 9-max Seat #1 is the button
Seat 1: Perstenev ($13 in chips) 
Seat 2: seula i ($95.85 in chips) 
Seat 3: 1Karina1 ($31.07 in chips) 
Seat 4: KrystalAA ($20.46 in chips) 
Seat 5: chiyuki ($32.33 in chips) 
Seat 6: INSP!RON ($30.55 in chips) 
Seat 7: Dejacob ($25.35 in chips) 
Seat 8: PAMBOS.L ($17.65 in chips) 
Seat 9: fima00000007 ($12.50 in chips) 
seula i: posts small blind $0.10
1Karina1: posts big blind $0.25
*** HOLE CARDS ***
Dealt to chiyuki [Ad Ah]
KrystalAA: folds 
chiyuki: raises $0.50 to $0.75
INSP!RON: folds 
Dejacob: folds 
PAMBOS.L: folds 
fima00000007: folds 
Perstenev: folds 
seula i: folds 
1Karina1: folds 
Uncalled bet ($0.50) returned to chiyuki
chiyuki collected $0.60 from pot
chiyuki: doesn't show hand 
*** SUMMARY ***
Total pot $0.60 | Rake $0 
Seat 1: Perstenev (button) folded before Flop (didn't bet)
Seat 2: seula i (small blind) folded before Flop
Seat 3: 1Karina1 (big blind) folded before Flop
Seat 4: KrystalAA folded before Flop (didn't bet)
Seat 5: chiyuki collected ($0.60)
Seat 6: INSP!RON folded before Flop (didn't bet)
Seat 7: Dejacob folded before Flop (didn't bet)
Seat 8: PAMBOS.L folded before Flop (didn't bet)
Seat 9: fima00000007 folded before Flop (didn't bet)



PokerStars Zoom Hand #84300257995:  Hold'em No Limit ($0.10/$0.25) - 2012/08/05 15:16:09 JST [2012/08/05 2:16:09 ET]
Table 'Whirlpool' 9-max Seat #1 is the button
Seat 1: chiyuki ($31.98 in chips) 
Seat 2: KrystalAA ($26.85 in chips) 
Seat 3: hirozo ($74.36 in chips) 
Seat 4: panaam ($24.65 in chips) 
Seat 5: DutchShultzs ($33.07 in chips) 
Seat 6: Perstenev ($31.30 in chips) 
Seat 7: deadmoneykid ($34.11 in chips) 
Seat 8: jacquelinewu ($26.05 in chips) 
Seat 9: masterkoolb ($12.50 in chips) 
KrystalAA: posts small blind $0.10
hirozo: posts big blind $0.25
*** HOLE CARDS ***
Dealt to chiyuki [Qs 3c]
panaam: calls $0.25
DutchShultzs: folds 
Perstenev: folds 
deadmoneykid: folds 
jacquelinewu: folds 
masterkoolb: calls $0.25
chiyuki: folds 
KrystalAA: calls $0.15
hirozo: checks 
*** FLOP *** [5s Jc 6h]
KrystalAA: checks 
hirozo: checks 
panaam: bets $0.75
masterkoolb: folds 
KrystalAA: folds 
hirozo: raises $1.23 to $1.98
panaam: calls $1.23
*** TURN *** [5s Jc 6h] [2c]
hirozo: bets $3.16
panaam: folds 
Uncalled bet ($3.16) returned to hirozo
hirozo collected $4.74 from pot
hirozo: doesn't show hand 
*** SUMMARY ***
Total pot $4.96 | Rake $0.22 
Board [5s Jc 6h 2c]
Seat 1: chiyuki (button) folded before Flop (didn't bet)
Seat 2: KrystalAA (small blind) folded on the Flop
Seat 3: hirozo (big blind) collected ($4.74)
Seat 4: panaam folded on the Turn
Seat 5: DutchShultzs folded before Flop (didn't bet)
Seat 6: Perstenev folded before Flop (didn't bet)
Seat 7: deadmoneykid folded before Flop (didn't bet)
Seat 8: jacquelinewu folded before Flop (didn't bet)
Seat 9: masterkoolb folded on the Flop



PokerStars Zoom Hand #84300274572:  Hold'em No Limit ($0.10/$0.25) - 2012/08/05 15:17:14 JST [2012/08/05 2:17:14 ET]
Table 'Whirlpool' 9-max Seat #1 is the button
Seat 1: Perstenev ($12.39 in chips) 
Seat 2: DutchShultzs ($32.82 in chips) 
Seat 3: rey2040 ($11.15 in chips) 
Seat 4: AAAKK777 ($27.74 in chips) 
Seat 5: 1Karina1 ($30.82 in chips) 
Seat 6: chiyuki ($32.68 in chips) 
Seat 7: Silveystryk ($20.49 in chips) 
Seat 8: seula i ($44.81 in chips) 
Seat 9: ZhukOFFskI ($34.64 in chips) 
DutchShultzs: posts small blind $0.10
rey2040: posts big blind $0.25
*** HOLE CARDS ***
Dealt to chiyuki [2h Qh]
AAAKK777: raises $0.25 to $0.50
1Karina1: folds 
chiyuki: folds 
Silveystryk: folds 
seula i: folds 
ZhukOFFskI: folds 
Perstenev: folds 
DutchShultzs: folds 
rey2040: folds 
Uncalled bet ($0.25) returned to AAAKK777
AAAKK777 collected $0.60 from pot
AAAKK777: doesn't show hand 
*** SUMMARY ***
Total pot $0.60 | Rake $0 
Seat 1: Perstenev (button) folded before Flop (didn't bet)
Seat 2: DutchShultzs (small blind) folded before Flop
Seat 3: rey2040 (big blind) folded before Flop
Seat 4: AAAKK777 collected ($0.60)
Seat 5: 1Karina1 folded before Flop (didn't bet)
Seat 6: chiyuki folded before Flop (didn't bet)
Seat 7: Silveystryk folded before Flop (didn't bet)
Seat 8: seula i folded before Flop (didn't bet)
Seat 9: ZhukOFFskI folded before Flop (didn't bet)



PokerStars Zoom Hand #84300273568:  Hold'em No Limit ($0.10/$0.25) - 2012/08/05 15:17:10 JST [2012/08/05 2:17:10 ET]
Table 'Whirlpool' 9-max Seat #1 is the button
Seat 1: Silveystryk ($26.63 in chips) 
Seat 2: Perstenev ($12.49 in chips) 
Seat 3: Saruotiss ($46.51 in chips) 
Seat 4: Rilko1975 ($24.65 in chips) 
Seat 5: GovGus ($35.83 in chips) 
Seat 6: INSP!RON ($30.30 in chips) 
Seat 7: snejokCoxx ($12.40 in chips) 
Seat 8: rey2040 ($11.15 in chips) 
Seat 9: chiyuki ($32.68 in chips) 
Perstenev: posts small blind $0.10
Saruotiss: posts big blind $0.25
*** HOLE CARDS ***
Dealt to chiyuki [5c 7s]
Rilko1975: folds 
GovGus: raises $0.50 to $0.75
INSP!RON: folds 
snejokCoxx: folds 
rey2040: folds 
chiyuki: folds 
Silveystryk: folds 
Perstenev: folds 
Saruotiss: folds 
Uncalled bet ($0.50) returned to GovGus
GovGus collected $0.60 from pot
GovGus: doesn't show hand 
*** SUMMARY ***
Total pot $0.60 | Rake $0 
Seat 1: Silveystryk (button) folded before Flop (didn't bet)
Seat 2: Perstenev (small blind) folded before Flop
Seat 3: Saruotiss (big blind) folded before Flop
Seat 4: Rilko1975 folded before Flop (didn't bet)
Seat 5: GovGus collected ($0.60)
Seat 6: INSP!RON folded before Flop (didn't bet)
Seat 7: snejokCoxx folded before Flop (didn't bet)
Seat 8: rey2040 folded before Flop (didn't bet)
Seat 9: chiyuki folded before Flop (didn't bet)



PokerStars Zoom Hand #84300277441:  Hold'em No Limit ($0.10/$0.25) - 2012/08/05 15:17:26 JST [2012/08/05 2:17:26 ET]
Table 'Whirlpool' 9-max Seat #1 is the button
Seat 1: River_GmbH ($16.30 in chips) 
Seat 2: chiyuki ($32.68 in chips) 
Seat 3: KeLevro0 ($12.50 in chips) 
Seat 4: Jene4kaBest ($11.90 in chips) 
Seat 5: el pore 5 ($10.72 in chips) 
Seat 6: turbotom122 ($26.87 in chips) 
Seat 7: wildy29 ($33.64 in chips) 
Seat 8: Silveystryk ($17.83 in chips) 
Seat 9: Nerkit ($10.65 in chips) 
chiyuki: posts small blind $0.10
KeLevro0: posts big blind $0.25
*** HOLE CARDS ***
Dealt to chiyuki [6s 3d]
Jene4kaBest: folds 
el pore 5: raises $0.50 to $0.75
turbotom122: folds 
wildy29: folds 
Silveystryk: folds 
Nerkit: folds 
River_GmbH: folds 
chiyuki: folds 
KeLevro0: folds 
Uncalled bet ($0.50) returned to el pore 5
el pore 5 collected $0.60 from pot
el pore 5: doesn't show hand 
*** SUMMARY ***
Total pot $0.60 | Rake $0 
Seat 1: River_GmbH (button) folded before Flop (didn't bet)
Seat 2: chiyuki (small blind) folded before Flop
Seat 3: KeLevro0 (big blind) folded before Flop
Seat 4: Jene4kaBest folded before Flop (didn't bet)
Seat 5: el pore 5 collected ($0.60)
Seat 6: turbotom122 folded before Flop (didn't bet)
Seat 7: wildy29 folded before Flop (didn't bet)
Seat 8: Silveystryk folded before Flop (didn't bet)
Seat 9: Nerkit folded before Flop (didn't bet)



PokerStars Zoom Hand #84300275608:  Hold'em No Limit ($0.10/$0.25) - 2012/08/05 15:17:18 JST [2012/08/05 2:17:18 ET]
Table 'Whirlpool' 9-max Seat #1 is the button
Seat 1: Rilko1975 ($24.65 in chips) 
Seat 2: 1Karina1 ($30.82 in chips) 
Seat 3: PetitAlejo ($25 in chips) 
Seat 4: chiyuki ($32.68 in chips) 
Seat 5: Perstenev ($13.35 in chips) 
Seat 6: Silveystryk ($20.49 in chips) 
Seat 7: troublesomm ($35.35 in chips) 
Seat 8: dergeb ($15.11 in chips) 
Seat 9: Alvinpe85 ($49.85 in chips) 
1Karina1: posts small blind $0.10
PetitAlejo: posts big blind $0.25
*** HOLE CARDS ***
Dealt to chiyuki [8s Qd]
chiyuki: folds 
Perstenev: folds 
Silveystryk: raises $0.50 to $0.75
troublesomm: folds 
dergeb: calls $0.75
Alvinpe85: folds 
Rilko1975: folds 
1Karina1: folds 
PetitAlejo: folds 
*** FLOP *** [6d 7c 6c]
Silveystryk: bets $1
dergeb: folds 
Uncalled bet ($1) returned to Silveystryk
Silveystryk collected $1.77 from pot
Silveystryk: doesn't show hand 
*** SUMMARY ***
Total pot $1.85 | Rake $0.08 
Board [6d 7c 6c]
Seat 1: Rilko1975 (button) folded before Flop (didn't bet)
Seat 2: 1Karina1 (small blind) folded before Flop
Seat 3: PetitAlejo (big blind) folded before Flop
Seat 4: chiyuki folded before Flop (didn't bet)
Seat 5: Perstenev folded before Flop (didn't bet)
Seat 6: Silveystryk collected ($1.77)
Seat 7: troublesomm folded before Flop (didn't bet)
Seat 8: dergeb folded on the Flop
Seat 9: Alvinpe85 folded before Flop (didn't bet)



PokerStars Zoom Hand #84300271285:  Hold'em No Limit ($0.10/$0.25) - 2012/08/05 15:17:01 JST [2012/08/05 2:17:01 ET]
Table 'Whirlpool' 9-max Seat #1 is the button
Seat 1: MarginX ($25.35 in chips) 
Seat 2: Rilko1975 ($34.37 in chips) 
Seat 3: snejokCoxx ($9.03 in chips) 
Seat 4: 4ydo yogurt ($43.38 in chips) 
Seat 5: 1Karina1 ($29.91 in chips) 
Seat 6: svg51 ($11.22 in chips) 
Seat 7: chiyuki ($32.68 in chips) 
Seat 8: KrystalAA ($33.68 in chips) 
Seat 9: DutchShultzs ($40.68 in chips) 
Rilko1975: posts small blind $0.10
snejokCoxx: posts big blind $0.25
*** HOLE CARDS ***
Dealt to chiyuki [3c 6d]
4ydo yogurt: folds 
1Karina1: folds 
svg51: folds 
chiyuki: folds 
KrystalAA: folds 
DutchShultzs: folds 
MarginX: folds 
Rilko1975: calls $0.15
snejokCoxx: checks 
*** FLOP *** [4s Qd Tc]
Rilko1975: checks 
snejokCoxx: checks 
*** TURN *** [4s Qd Tc] [Jc]
Rilko1975: checks 
snejokCoxx: checks 
*** RIVER *** [4s Qd Tc Jc] [4h]
Rilko1975: checks 
snejokCoxx: checks 
*** SHOW DOWN ***
Rilko1975: shows [3s As] (a pair of Fours)
snejokCoxx: mucks hand 
Rilko1975 collected $0.48 from pot
*** SUMMARY ***
Total pot $0.50 | Rake $0.02 
Board [4s Qd Tc Jc 4h]
Seat 1: MarginX (button) folded before Flop (didn't bet)
Seat 2: Rilko1975 (small blind) showed [3s As] and won ($0.48) with a pair of Fours
Seat 3: snejokCoxx (big blind) mucked [2c 8h]
Seat 4: 4ydo yogurt folded before Flop (didn't bet)
Seat 5: 1Karina1 folded before Flop (didn't bet)
Seat 6: svg51 folded before Flop (didn't bet)
Seat 7: chiyuki folded before Flop (didn't bet)
Seat 8: KrystalAA folded before Flop (didn't bet)
Seat 9: DutchShultzs folded before Flop (didn't bet)



PokerStars Zoom Hand #84300283211:  Hold'em No Limit ($0.10/$0.25) - 2012/08/05 15:17:49 JST [2012/08/05 2:17:49 ET]
Table 'Whirlpool' 9-max Seat #1 is the button
Seat 1: chiyuki ($32.33 in chips) 
Seat 2: Tom1999 ($11.62 in chips) 
Seat 3: Rilko1975 ($25.10 in chips) 
Seat 4: Perstenev ($12.39 in chips) 
Seat 5: masterkoolb ($15.28 in chips) 
Seat 6: Alvinpe85 ($49.85 in chips) 
Seat 7: snejokCoxx ($8.30 in chips) 
Seat 8: Nerkit ($10.68 in chips) 
Seat 9: PetitAlejo ($25 in chips) 
Tom1999: posts small blind $0.10
Rilko1975: posts big blind $0.25
*** HOLE CARDS ***
Dealt to chiyuki [9h Kc]
Perstenev: folds 
masterkoolb: folds 
Alvinpe85: folds 
snejokCoxx: folds 
Nerkit: folds 
PetitAlejo: raises $0.50 to $0.75
chiyuki: folds 
Tom1999: folds 
Rilko1975: folds 
Uncalled bet ($0.50) returned to PetitAlejo
PetitAlejo collected $0.60 from pot
PetitAlejo: doesn't show hand 
*** SUMMARY ***
Total pot $0.60 | Rake $0 
Seat 1: chiyuki (button) folded before Flop (didn't bet)
Seat 2: Tom1999 (small blind) folded before Flop
Seat 3: Rilko1975 (big blind) folded before Flop
Seat 4: Perstenev folded before Flop (didn't bet)
Seat 5: masterkoolb folded before Flop (didn't bet)
Seat 6: Alvinpe85 folded before Flop (didn't bet)
Seat 7: snejokCoxx folded before Flop (didn't bet)
Seat 8: Nerkit folded before Flop (didn't bet)
Seat 9: PetitAlejo collected ($0.60)



PokerStars Zoom Hand #84300279955:  Hold'em No Limit ($0.10/$0.25) - 2012/08/05 15:17:36 JST [2012/08/05 2:17:36 ET]
Table 'Whirlpool' 9-max Seat #1 is the button
Seat 1: hirozo ($25 in chips) 
Seat 2: deadmoneykid ($31.34 in chips) 
Seat 3: River_GmbH ($16.30 in chips) 
Seat 4: wildy29 ($33.64 in chips) 
Seat 5: panaam ($22.42 in chips) 
Seat 6: troublesomm ($35.25 in chips) 
Seat 7: chiyuki ($32.58 in chips) 
Seat 8: seula i ($95.75 in chips) 
Seat 9: Yoshimac ($30.45 in chips) 
deadmoneykid: posts small blind $0.10
River_GmbH: posts big blind $0.25
*** HOLE CARDS ***
Dealt to chiyuki [5h Js]
wildy29: folds 
panaam: folds 
troublesomm: folds 
chiyuki: folds 
seula i: folds 
Yoshimac: calls $0.25
hirozo: folds 
deadmoneykid: calls $0.15
River_GmbH: checks 
*** FLOP *** [2d 5s Qs]
deadmoneykid: bets $0.54
River_GmbH: folds 
Yoshimac: folds 
Uncalled bet ($0.54) returned to deadmoneykid
deadmoneykid collected $0.72 from pot
deadmoneykid: doesn't show hand 
*** SUMMARY ***
Total pot $0.75 | Rake $0.03 
Board [2d 5s Qs]
Seat 1: hirozo (button) folded before Flop (didn't bet)
Seat 2: deadmoneykid (small blind) collected ($0.72)
Seat 3: River_GmbH (big blind) folded on the Flop
Seat 4: wildy29 folded before Flop (didn't bet)
Seat 5: panaam folded before Flop (didn't bet)
Seat 6: troublesomm folded before Flop (didn't bet)
Seat 7: chiyuki folded before Flop (didn't bet)
Seat 8: seula i folded before Flop (didn't bet)
Seat 9: Yoshimac folded on the Flop



PokerStars Zoom Hand #84300280949:  Hold'em No Limit ($0.10/$0.25) - 2012/08/05 15:17:40 JST [2012/08/05 2:17:40 ET]
Table 'Whirlpool' 9-max Seat #1 is the button
Seat 1: PetitAlejo ($25 in chips) 
Seat 2: dergeb ($14.36 in chips) 
Seat 3: chiyuki ($32.58 in chips) 
Seat 4: panaam ($22.42 in chips) 
Seat 5: KrystalAA ($20.21 in chips) 
Seat 6: snejokCoxx ($12.40 in chips) 
Seat 7: Silveystryk ($17.83 in chips) 
Seat 8: yane73 ($35.34 in chips) 
Seat 9: wildy29 ($33.64 in chips) 
dergeb: posts small blind $0.10
chiyuki: posts big blind $0.25
*** HOLE CARDS ***
Dealt to chiyuki [4h 3d]
panaam: folds 
KrystalAA: raises $0.46 to $0.71
snejokCoxx: folds 
Silveystryk: folds 
yane73: calls $0.71
wildy29: folds 
PetitAlejo: folds 
dergeb: calls $0.61
chiyuki: folds 
*** FLOP *** [8s 4d 5s]
dergeb: checks 
KrystalAA: checks 
yane73: bets $0.75
dergeb: raises $1.88 to $2.63
KrystalAA: folds 
yane73: calls $1.88
*** TURN *** [8s 4d 5s] [Qd]
dergeb: bets $5.47
yane73: folds 
Uncalled bet ($5.47) returned to dergeb
dergeb collected $7.30 from pot
dergeb: doesn't show hand 
*** SUMMARY ***
Total pot $7.64 | Rake $0.34 
Board [8s 4d 5s Qd]
Seat 1: PetitAlejo (button) folded before Flop (didn't bet)
Seat 2: dergeb (small blind) collected ($7.30)
Seat 3: chiyuki (big blind) folded before Flop
Seat 4: panaam folded before Flop (didn't bet)
Seat 5: KrystalAA folded on the Flop
Seat 6: snejokCoxx folded before Flop (didn't bet)
Seat 7: Silveystryk folded before Flop (didn't bet)
Seat 8: yane73 folded on the Turn
Seat 9: wildy29 folded before Flop (didn't bet)



PokerStars Zoom Hand #84300287520:  Hold'em No Limit ($0.10/$0.25) - 2012/08/05 15:18:06 JST [2012/08/05 2:18:06 ET]
Table 'Whirlpool' 9-max Seat #1 is the button
Seat 1: troublesomm ($38.76 in chips) 
Seat 2: KrystalAA ($33.43 in chips) 
Seat 3: seula i ($27.41 in chips) 
Seat 4: Alvinpe85 ($49.85 in chips) 
Seat 5: phate-1up ($50.89 in chips) 
Seat 6: deadmoneykid ($27.13 in chips) 
Seat 7: snejokCoxx ($8.68 in chips) 
Seat 8: Ellen1947 ($24.15 in chips) 
Seat 9: chiyuki ($32.33 in chips) 
KrystalAA: posts small blind $0.10
seula i: posts big blind $0.25
*** HOLE CARDS ***
Dealt to chiyuki [Th Qs]
Alvinpe85: folds 
phate-1up: folds 
deadmoneykid: folds 
snejokCoxx: folds 
Ellen1947: folds 
chiyuki: raises $0.50 to $0.75
troublesomm: calls $0.75
KrystalAA: folds 
seula i: folds 
*** FLOP *** [Jc 8s Tc]
chiyuki: bets $1
troublesomm: calls $1
*** TURN *** [Jc 8s Tc] [Qd]
chiyuki: checks 
troublesomm: checks 
*** RIVER *** [Jc 8s Tc Qd] [Js]
chiyuki: checks 
troublesomm: checks 
*** SHOW DOWN ***
chiyuki: shows [Th Qs] (two pair, Queens and Jacks)
troublesomm: mucks hand 
chiyuki collected $3.68 from pot
*** SUMMARY ***
Total pot $3.85 | Rake $0.17 
Board [Jc 8s Tc Qd Js]
Seat 1: troublesomm (button) mucked [8h 7h]
Seat 2: KrystalAA (small blind) folded before Flop
Seat 3: seula i (big blind) folded before Flop
Seat 4: Alvinpe85 folded before Flop (didn't bet)
Seat 5: phate-1up folded before Flop (didn't bet)
Seat 6: deadmoneykid folded before Flop (didn't bet)
Seat 7: snejokCoxx folded before Flop (didn't bet)
Seat 8: Ellen1947 folded before Flop (didn't bet)
Seat 9: chiyuki showed [Th Qs] and won ($3.68) with two pair, Queens and Jacks



PokerStars Zoom Hand #84300304567:  Hold'em No Limit ($0.10/$0.25) - 2012/08/05 15:19:14 JST [2012/08/05 2:19:14 ET]
Table 'Whirlpool' 9-max Seat #1 is the button
Seat 1: Perstenev ($13.75 in chips) 
Seat 2: KeLevro0 ($11.50 in chips) 
Seat 3: Silveystryk ($27.43 in chips) 
Seat 4: Alvinpe85 ($48.72 in chips) 
Seat 5: chiyuki ($34.26 in chips) 
Seat 6: ChrisCDee ($44.78 in chips) 
Seat 7: turbotom122 ($30.89 in chips) 
Seat 8: Wilcox76607 ($20.39 in chips) 
Seat 9: Sal y Limon1 ($24.75 in chips) 
KeLevro0: posts small blind $0.10
Silveystryk: posts big blind $0.25
*** HOLE CARDS ***
Dealt to chiyuki [5c Ac]
Alvinpe85: raises $0.50 to $0.75
chiyuki: folds 
ChrisCDee: calls $0.75
turbotom122: folds 
Wilcox76607: folds 
Sal y Limon1: folds 
Perstenev: folds 
KeLevro0: folds 
Silveystryk: folds 
*** FLOP *** [2s 7d 6c]
Alvinpe85: checks 
ChrisCDee: checks 
*** TURN *** [2s 7d 6c] [Kc]
Alvinpe85: bets $1.06
ChrisCDee: folds 
Uncalled bet ($1.06) returned to Alvinpe85
Alvinpe85 collected $1.77 from pot
Alvinpe85: doesn't show hand 
*** SUMMARY ***
Total pot $1.85 | Rake $0.08 
Board [2s 7d 6c Kc]
Seat 1: Perstenev (button) folded before Flop (didn't bet)
Seat 2: KeLevro0 (small blind) folded before Flop
Seat 3: Silveystryk (big blind) folded before Flop
Seat 4: Alvinpe85 collected ($1.77)
Seat 5: chiyuki folded before Flop (didn't bet)
Seat 6: ChrisCDee folded on the Turn
Seat 7: turbotom122 folded before Flop (didn't bet)
Seat 8: Wilcox76607 folded before Flop (didn't bet)
Seat 9: Sal y Limon1 folded before Flop (didn't bet)



PokerStars Zoom Hand #84300314058:  Hold'em No Limit ($0.10/$0.25) - 2012/08/05 15:19:52 JST [2012/08/05 2:19:52 ET]
Table 'Whirlpool' 9-max Seat #1 is the button
Seat 1: WARIBANA7777 ($16.49 in chips) 
Seat 2: Tom1999 ($12.35 in chips) 
Seat 3: GovGus ($36.53 in chips) 
Seat 4: chiyuki ($34.16 in chips) 
Seat 5: PetitAlejo ($25.10 in chips) 
Seat 6: snejokCoxx ($8.68 in chips) 
Seat 7: Wilcox76607 ($20.64 in chips) 
Seat 8: Sal y Limon1 ($24.75 in chips) 
Seat 9: 4plankton ($16.60 in chips) 
Tom1999: posts small blind $0.10
GovGus: posts big blind $0.25
*** HOLE CARDS ***
Dealt to chiyuki [7d 8h]
chiyuki: folds 
PetitAlejo: folds 
snejokCoxx: folds 
Wilcox76607: folds 
Sal y Limon1: folds 
4plankton: folds 
WARIBANA7777: folds 
Tom1999: folds 
Uncalled bet ($0.15) returned to GovGus
GovGus collected $0.20 from pot
GovGus: doesn't show hand 
*** SUMMARY ***
Total pot $0.20 | Rake $0 
Seat 1: WARIBANA7777 (button) folded before Flop (didn't bet)
Seat 2: Tom1999 (small blind) folded before Flop
Seat 3: GovGus (big blind) collected ($0.20)
Seat 4: chiyuki folded before Flop (didn't bet)
Seat 5: PetitAlejo folded before Flop (didn't bet)
Seat 6: snejokCoxx folded before Flop (didn't bet)
Seat 7: Wilcox76607 folded before Flop (didn't bet)
Seat 8: Sal y Limon1 folded before Flop (didn't bet)
Seat 9: 4plankton folded before Flop (didn't bet)



PokerStars Zoom Hand #84300306327:  Hold'em No Limit ($0.10/$0.25) - 2012/08/05 15:19:21 JST [2012/08/05 2:19:21 ET]
Table 'Whirlpool' 9-max Seat #1 is the button
Seat 1: KeLevro0 ($11.40 in chips) 
Seat 2: turbotom122 ($30.89 in chips) 
Seat 3: slapshot2011 ($19.44 in chips) 
Seat 4: INSP!RON ($30.47 in chips) 
Seat 5: Perstenev ($8.77 in chips) 
Seat 6: Roglus ($5.82 in chips) 
Seat 7: phate-1up ($49.27 in chips) 
Seat 8: chiyuki ($34.26 in chips) 
Seat 9: Gichboy ($7.35 in chips) 
turbotom122: posts small blind $0.10
slapshot2011: posts big blind $0.25
*** HOLE CARDS ***
Dealt to chiyuki [Tc 2h]
INSP!RON: raises $0.50 to $0.75
Perstenev: folds 
Roglus: folds 
phate-1up: folds 
chiyuki: folds 
Gichboy: folds 
KeLevro0: folds 
turbotom122: folds 
slapshot2011: calls $0.50
*** FLOP *** [5d Qc Kc]
slapshot2011: checks 
INSP!RON: bets $1.10
slapshot2011: calls $1.10
*** TURN *** [5d Qc Kc] [Ks]
slapshot2011: checks 
INSP!RON: checks 
*** RIVER *** [5d Qc Kc Ks] [Qs]
slapshot2011: bets $1.75
INSP!RON: folds 
Uncalled bet ($1.75) returned to slapshot2011
slapshot2011 collected $3.63 from pot
slapshot2011: doesn't show hand 
*** SUMMARY ***
Total pot $3.80 | Rake $0.17 
Board [5d Qc Kc Ks Qs]
Seat 1: KeLevro0 (button) folded before Flop (didn't bet)
Seat 2: turbotom122 (small blind) folded before Flop
Seat 3: slapshot2011 (big blind) collected ($3.63)
Seat 4: INSP!RON folded on the River
Seat 5: Perstenev folded before Flop (didn't bet)
Seat 6: Roglus folded before Flop (didn't bet)
Seat 7: phate-1up folded before Flop (didn't bet)
Seat 8: chiyuki folded before Flop (didn't bet)
Seat 9: Gichboy folded before Flop (didn't bet)



PokerStars Zoom Hand #84300309413:  Hold'em No Limit ($0.10/$0.25) - 2012/08/05 15:19:33 JST [2012/08/05 2:19:33 ET]
Table 'Whirlpool' 9-max Seat #1 is the button
Seat 1: masterkoolb ($12.50 in chips) 
Seat 2: nice.franki ($12.25 in chips) 
Seat 3: 4ydo yogurt ($47.94 in chips) 
Seat 4: colorado2108 ($45.65 in chips) 
Seat 5: HighDuka ($23.28 in chips) 
Seat 6: chiyuki ($34.26 in chips) 
Seat 7: hirozo ($44.87 in chips) 
Seat 8: pandaaaaaa ($8.92 in chips) 
Seat 9: DutchShultzs ($31.58 in chips) 
nice.franki: posts small blind $0.10
4ydo yogurt: posts big blind $0.25
*** HOLE CARDS ***
Dealt to chiyuki [2c 9h]
colorado2108: folds 
HighDuka: folds 
chiyuki: folds 
hirozo: folds 
pandaaaaaa: folds 
DutchShultzs: folds 
masterkoolb: folds 
nice.franki: raises $0.50 to $0.75
4ydo yogurt: calls $0.50
*** FLOP *** [Qc 4c 6c]
nice.franki: bets $1
4ydo yogurt: calls $1
*** TURN *** [Qc 4c 6c] [Qh]
nice.franki: bets $2.50
4ydo yogurt: calls $2.50
*** RIVER *** [Qc 4c 6c Qh] [As]
nice.franki: bets $8 and is all-in
4ydo yogurt: folds 
Uncalled bet ($8) returned to nice.franki
nice.franki collected $8.12 from pot
nice.franki: doesn't show hand 
*** SUMMARY ***
Total pot $8.50 | Rake $0.38 
Board [Qc 4c 6c Qh As]
Seat 1: masterkoolb (button) folded before Flop (didn't bet)
Seat 2: nice.franki (small blind) collected ($8.12)
Seat 3: 4ydo yogurt (big blind) folded on the River
Seat 4: colorado2108 folded before Flop (didn't bet)
Seat 5: HighDuka folded before Flop (didn't bet)
Seat 6: chiyuki folded before Flop (didn't bet)
Seat 7: hirozo folded before Flop (didn't bet)
Seat 8: pandaaaaaa folded before Flop (didn't bet)
Seat 9: DutchShultzs folded before Flop (didn't bet)



PokerStars Zoom Hand #84300310454:  Hold'em No Limit ($0.10/$0.25) - 2012/08/05 15:19:37 JST [2012/08/05 2:19:37 ET]
Table 'Whirlpool' 9-max Seat #1 is the button
Seat 1: AntoineHunt ($37.25 in chips) 
Seat 2: chiyuki ($34.26 in chips) 
Seat 3: 1Karina1 ($38.49 in chips) 
Seat 4: colorado2108 ($45.65 in chips) 
Seat 5: Perstenev ($13 in chips) 
Seat 6: fima00000007 ($23.97 in chips) 
Seat 7: troublesomm ($25.25 in chips) 
Seat 8: hirozo ($83.14 in chips) 
Seat 9: Sal y Limon1 ($26.63 in chips) 
chiyuki: posts small blind $0.10
1Karina1: posts big blind $0.25
*** HOLE CARDS ***
Dealt to chiyuki [Td 5c]
colorado2108: folds 
Perstenev: folds 
fima00000007 has timed out
fima00000007: folds 
troublesomm: folds 
hirozo: folds 
Sal y Limon1: folds 
AntoineHunt: raises $0.50 to $0.75
chiyuki: folds 
1Karina1: calls $0.50
*** FLOP *** [3c 5s As]
1Karina1: checks 
AntoineHunt: bets $0.50
1Karina1: calls $0.50
*** TURN *** [3c 5s As] [Jd]
1Karina1: bets $1.75
AntoineHunt: folds 
Uncalled bet ($1.75) returned to 1Karina1
1Karina1 collected $2.48 from pot
1Karina1: doesn't show hand 
*** SUMMARY ***
Total pot $2.60 | Rake $0.12 
Board [3c 5s As Jd]
Seat 1: AntoineHunt (button) folded on the Turn
Seat 2: chiyuki (small blind) folded before Flop
Seat 3: 1Karina1 (big blind) collected ($2.48)
Seat 4: colorado2108 folded before Flop (didn't bet)
Seat 5: Perstenev folded before Flop (didn't bet)
Seat 6: fima00000007 folded before Flop (didn't bet)
Seat 7: troublesomm folded before Flop (didn't bet)
Seat 8: hirozo folded before Flop (didn't bet)
Seat 9: Sal y Limon1 folded before Flop (didn't bet)



PokerStars Zoom Hand #84300317550:  Hold'em No Limit ($0.10/$0.25) - 2012/08/05 15:20:06 JST [2012/08/05 2:20:06 ET]
Table 'Whirlpool' 9-max Seat #1 is the button
Seat 1: Rilko1975 ($23.35 in chips) 
Seat 2: deadmoneykid ($31.56 in chips) 
Seat 3: deepakmbh ($25 in chips) 
Seat 4: phate-1up ($30.04 in chips) 
Seat 5: troublesomm ($25.15 in chips) 
Seat 6: risekuku468 ($36.31 in chips) 
Seat 7: chiyuki ($34.16 in chips) 
Seat 8: Gichboy ($29.03 in chips) 
Seat 9: Lasutchik ($74.46 in chips) 
deadmoneykid: posts small blind $0.10
deepakmbh: posts big blind $0.25
*** HOLE CARDS ***
Dealt to chiyuki [5d 6d]
phate-1up: folds 
troublesomm: folds 
risekuku468: folds 
chiyuki: folds 
Gichboy: folds 
Lasutchik: raises $0.50 to $0.75
Rilko1975: folds 
deadmoneykid: raises $1.75 to $2.50
deepakmbh: folds 
Lasutchik: folds 
Uncalled bet ($1.75) returned to deadmoneykid
deadmoneykid collected $1.75 from pot
deadmoneykid: doesn't show hand 
*** SUMMARY ***
Total pot $1.75 | Rake $0 
Seat 1: Rilko1975 (button) folded before Flop (didn't bet)
Seat 2: deadmoneykid (small blind) collected ($1.75)
Seat 3: deepakmbh (big blind) folded before Flop
Seat 4: phate-1up folded before Flop (didn't bet)
Seat 5: troublesomm folded before Flop (didn't bet)
Seat 6: risekuku468 folded before Flop (didn't bet)
Seat 7: chiyuki folded before Flop (didn't bet)
Seat 8: Gichboy folded before Flop (didn't bet)
Seat 9: Lasutchik folded before Flop



PokerStars Zoom Hand #84300319503:  Hold'em No Limit ($0.10/$0.25) - 2012/08/05 15:20:14 JST [2012/08/05 2:20:14 ET]
Table 'Whirlpool' 9-max Seat #1 is the button
Seat 1: phate-1up ($30.04 in chips) 
Seat 2: WARIBANA7777 ($16.49 in chips) 
Seat 3: chiyuki ($34.16 in chips) 
Seat 4: snejokCoxx ($12.05 in chips) 
Seat 5: panaam ($21.85 in chips) 
Seat 6: Vahe50 ($14.76 in chips) 
Seat 7: hirozo ($76.69 in chips) 
Seat 8: el pore 5 ($10.80 in chips) 
Seat 9: slapshot2011 ($21.22 in chips) 
WARIBANA7777: posts small blind $0.10
chiyuki: posts big blind $0.25
*** HOLE CARDS ***
Dealt to chiyuki [Jd 5d]
snejokCoxx: folds 
panaam: folds 
Vahe50: folds 
hirozo: folds 
el pore 5: folds 
slapshot2011: calls $0.25
phate-1up: folds 
WARIBANA7777: calls $0.15
chiyuki: checks 
*** FLOP *** [3d 8c 7c]
WARIBANA7777: bets $0.36
chiyuki: folds 
slapshot2011: calls $0.36
*** TURN *** [3d 8c 7c] [6d]
WARIBANA7777: bets $0.88
slapshot2011: calls $0.88
*** RIVER *** [3d 8c 7c 6d] [Th]
WARIBANA7777: bets $0.99
slapshot2011: calls $0.99
*** SHOW DOWN ***
WARIBANA7777: shows [7s 7d] (three of a kind, Sevens)
slapshot2011: shows [6c 9c] (a straight, Six to Ten)
slapshot2011 collected $4.98 from pot
*** SUMMARY ***
Total pot $5.21 | Rake $0.23 
Board [3d 8c 7c 6d Th]
Seat 1: phate-1up (button) folded before Flop (didn't bet)
Seat 2: WARIBANA7777 (small blind) showed [7s 7d] and lost with three of a kind, Sevens
Seat 3: chiyuki (big blind) folded on the Flop
Seat 4: snejokCoxx folded before Flop (didn't bet)
Seat 5: panaam folded before Flop (didn't bet)
Seat 6: Vahe50 folded before Flop (didn't bet)
Seat 7: hirozo folded before Flop (didn't bet)
Seat 8: el pore 5 folded before Flop (didn't bet)
Seat 9: slapshot2011 showed [6c 9c] and won ($4.98) with a straight, Six to Ten



PokerStars Zoom Hand #84300329494:  Hold'em No Limit ($0.10/$0.25) - 2012/08/05 15:20:53 JST [2012/08/05 2:20:53 ET]
Table 'Whirlpool' 9-max Seat #1 is the button
Seat 1: chiyuki ($33.91 in chips) 
Seat 2: Nerkit ($11.43 in chips) 
Seat 3: 1Karina1 ($26.62 in chips) 
Seat 4: 4ydo yogurt ($42.94 in chips) 
Seat 5: PetitAlejo ($25.68 in chips) 
Seat 6: troublesomm ($25 in chips) 
Seat 7: tribunpdm ($23.84 in chips) 
Seat 8: nice.franki ($16.12 in chips) 
Seat 9: Alvinpe85 ($49.74 in chips) 
Nerkit: posts small blind $0.10
1Karina1: posts big blind $0.25
*** HOLE CARDS ***
Dealt to chiyuki [Jd Qd]
4ydo yogurt: folds 
PetitAlejo: folds 
troublesomm: raises $0.50 to $0.75
tribunpdm: folds 
nice.franki: folds 
Alvinpe85: folds 
chiyuki: folds 
Nerkit: folds 
1Karina1: folds 
Uncalled bet ($0.50) returned to troublesomm
troublesomm collected $0.60 from pot
troublesomm: doesn't show hand 
*** SUMMARY ***
Total pot $0.60 | Rake $0 
Seat 1: chiyuki (button) folded before Flop (didn't bet)
Seat 2: Nerkit (small blind) folded before Flop
Seat 3: 1Karina1 (big blind) folded before Flop
Seat 4: 4ydo yogurt folded before Flop (didn't bet)
Seat 5: PetitAlejo folded before Flop (didn't bet)
Seat 6: troublesomm collected ($0.60)
Seat 7: tribunpdm folded before Flop (didn't bet)
Seat 8: nice.franki folded before Flop (didn't bet)
Seat 9: Alvinpe85 folded before Flop (didn't bet)



PokerStars Zoom Hand #84300315292:  Hold'em No Limit ($0.10/$0.25) - 2012/08/05 15:19:57 JST [2012/08/05 2:19:57 ET]
Table 'Whirlpool' 9-max Seat #1 is the button
Seat 1: PetitAlejo ($25.10 in chips) 
Seat 2: GovGus ($26.04 in chips) 
Seat 3: snejokCoxx ($8.68 in chips) 
Seat 4: DutchShultzs ($25 in chips) 
Seat 5: chiyuki ($34.16 in chips) 
Seat 6: Alvinpe85 ($49.49 in chips) 
Seat 7: xxx Spb xxx ($26.35 in chips) 
Seat 8: deadmoneykid ($26.78 in chips) 
Seat 9: Silveystryk ($26.35 in chips) 
GovGus: posts small blind $0.10
snejokCoxx: posts big blind $0.25
*** HOLE CARDS ***
Dealt to chiyuki [Qs 7h]
DutchShultzs: raises $0.50 to $0.75
chiyuki: folds 
Alvinpe85: folds 
xxx Spb xxx: calls $0.75
deadmoneykid: folds 
Silveystryk: folds 
PetitAlejo: folds 
GovGus: folds 
snejokCoxx: calls $0.50
*** FLOP *** [9d 3c Jh]
snejokCoxx: checks 
DutchShultzs: checks 
xxx Spb xxx: checks 
*** TURN *** [9d 3c Jh] [2c]
snejokCoxx: checks 
DutchShultzs: checks 
xxx Spb xxx: checks 
*** RIVER *** [9d 3c Jh 2c] [2d]
snejokCoxx: checks 
DutchShultzs: checks 
xxx Spb xxx: checks 
*** SHOW DOWN ***
snejokCoxx: shows [As Ts] (a pair of Deuces)
DutchShultzs: shows [Ac Qd] (a pair of Deuces - Ace+Queen kicker)
xxx Spb xxx: shows [5c 5h] (two pair, Fives and Deuces)
xxx Spb xxx collected $2.24 from pot
*** SUMMARY ***
Total pot $2.35 | Rake $0.11 
Board [9d 3c Jh 2c 2d]
Seat 1: PetitAlejo (button) folded before Flop (didn't bet)
Seat 2: GovGus (small blind) folded before Flop
Seat 3: snejokCoxx (big blind) showed [As Ts] and lost with a pair of Deuces
Seat 4: DutchShultzs showed [Ac Qd] and lost with a pair of Deuces
Seat 5: chiyuki folded before Flop (didn't bet)
Seat 6: Alvinpe85 folded before Flop (didn't bet)
Seat 7: xxx Spb xxx showed [5c 5h] and won ($2.24) with two pair, Fives and Deuces
Seat 8: deadmoneykid folded before Flop (didn't bet)
Seat 9: Silveystryk folded before Flop (didn't bet)



PokerStars Zoom Hand #84300340621:  Hold'em No Limit ($0.10/$0.25) - 2012/08/05 15:21:37 JST [2012/08/05 2:21:37 ET]
Table 'Whirlpool' 9-max Seat #1 is the button
Seat 1: Perstenev ($17.62 in chips) 
Seat 2: nice.franki ($12.60 in chips) 
Seat 3: Dan Royal ($23.37 in chips) 
Seat 4: troublesomm ($25.35 in chips) 
Seat 5: chiyuki ($33.91 in chips) 
Seat 6: slapshot2011 ($23.72 in chips) 
Seat 7: DanielWhyte ($61.81 in chips) 
Seat 8: PetitAlejo ($25.68 in chips) 
Seat 9: GravyWalrus ($9.15 in chips) 
nice.franki: posts small blind $0.10
Dan Royal: posts big blind $0.25
*** HOLE CARDS ***
Dealt to chiyuki [Jc Js]
troublesomm: folds 
chiyuki: raises $0.50 to $0.75
slapshot2011: folds 
DanielWhyte: folds 
PetitAlejo: folds 
GravyWalrus: folds 
Perstenev: folds 
nice.franki: folds 
Dan Royal: folds 
Uncalled bet ($0.50) returned to chiyuki
chiyuki collected $0.60 from pot
chiyuki: doesn't show hand 
*** SUMMARY ***
Total pot $0.60 | Rake $0 
Seat 1: Perstenev (button) folded before Flop (didn't bet)
Seat 2: nice.franki (small blind) folded before Flop
Seat 3: Dan Royal (big blind) folded before Flop
Seat 4: troublesomm folded before Flop (didn't bet)
Seat 5: chiyuki collected ($0.60)
Seat 6: slapshot2011 folded before Flop (didn't bet)
Seat 7: DanielWhyte folded before Flop (didn't bet)
Seat 8: PetitAlejo folded before Flop (didn't bet)
Seat 9: GravyWalrus folded before Flop (didn't bet)



PokerStars Zoom Hand #84300343666:  Hold'em No Limit ($0.10/$0.25) - 2012/08/05 15:21:49 JST [2012/08/05 2:21:49 ET]
Table 'Whirlpool' 9-max Seat #1 is the button
Seat 1: deadmoneykid ($26.18 in chips) 
Seat 2: 1Karina1 ($39.32 in chips) 
Seat 3: slapshot2011 ($23.72 in chips) 
Seat 4: Alvinpe85 ($51.58 in chips) 
Seat 5: phate-1up ($29.69 in chips) 
Seat 6: Rilko1975 ($38.61 in chips) 
Seat 7: dushvan ($55.43 in chips) 
Seat 8: pandaaaaaa ($8.22 in chips) 
Seat 9: chiyuki ($34.26 in chips) 
1Karina1: posts small blind $0.10
slapshot2011: posts big blind $0.25
*** HOLE CARDS ***
Dealt to chiyuki [Qd 6c]
Alvinpe85: raises $0.50 to $0.75
phate-1up: folds 
Rilko1975: calls $0.75
dushvan: folds 
pandaaaaaa: folds 
chiyuki: folds 
deadmoneykid: folds 
1Karina1: folds 
slapshot2011: folds 
*** FLOP *** [Kc Ac 8c]
Alvinpe85: bets $1.23
Rilko1975: folds 
Uncalled bet ($1.23) returned to Alvinpe85
Alvinpe85 collected $1.77 from pot
Alvinpe85: doesn't show hand 
*** SUMMARY ***
Total pot $1.85 | Rake $0.08 
Board [Kc Ac 8c]
Seat 1: deadmoneykid (button) folded before Flop (didn't bet)
Seat 2: 1Karina1 (small blind) folded before Flop
Seat 3: slapshot2011 (big blind) folded before Flop
Seat 4: Alvinpe85 collected ($1.77)
Seat 5: phate-1up folded before Flop (didn't bet)
Seat 6: Rilko1975 folded on the Flop
Seat 7: dushvan folded before Flop (didn't bet)
Seat 8: pandaaaaaa folded before Flop (didn't bet)
Seat 9: chiyuki folded before Flop (didn't bet)



PokerStars Zoom Hand #84300353045:  Hold'em No Limit ($0.10/$0.25) - 2012/08/05 15:22:27 JST [2012/08/05 2:22:27 ET]
Table 'Whirlpool' 9-max Seat #1 is the button
Seat 1: GovGus ($25.35 in chips) 
Seat 2: el pore 5 ($14.22 in chips) 
Seat 3: rey2040 ($9.47 in chips) 
Seat 4: chiyuki ($34.16 in chips) 
Seat 5: troublesomm ($25 in chips) 
Seat 6: masterkoolb ($15.54 in chips) 
Seat 7: snejokCoxx ($12.75 in chips) 
Seat 8: Alvinpe85 ($52.60 in chips) 
Seat 9: hirozo ($77.29 in chips) 
el pore 5: posts small blind $0.10
rey2040: posts big blind $0.25
*** HOLE CARDS ***
Dealt to chiyuki [Qs Kd]
chiyuki: folds 
troublesomm: folds 
masterkoolb: folds 
snejokCoxx: folds 
Alvinpe85: folds 
hirozo: folds 
GovGus: folds 
el pore 5: folds 
Uncalled bet ($0.15) returned to rey2040
rey2040 collected $0.20 from pot
rey2040: doesn't show hand 
*** SUMMARY ***
Total pot $0.20 | Rake $0 
Seat 1: GovGus (button) folded before Flop (didn't bet)
Seat 2: el pore 5 (small blind) folded before Flop
Seat 3: rey2040 (big blind) collected ($0.20)
Seat 4: chiyuki folded before Flop (didn't bet)
Seat 5: troublesomm folded before Flop (didn't bet)
Seat 6: masterkoolb folded before Flop (didn't bet)
Seat 7: snejokCoxx folded before Flop (didn't bet)
Seat 8: Alvinpe85 folded before Flop (didn't bet)
Seat 9: hirozo folded before Flop (didn't bet)



PokerStars Zoom Hand #84300353811:  Hold'em No Limit ($0.10/$0.25) - 2012/08/05 15:22:30 JST [2012/08/05 2:22:30 ET]
Table 'Whirlpool' 9-max Seat #1 is the button
Seat 1: Dan Royal ($23.52 in chips) 
Seat 2: kamikkaze ($12.25 in chips) 
Seat 3: snejokCoxx ($14.21 in chips) 
Seat 4: troublesomm ($25 in chips) 
Seat 5: chiyuki ($34.16 in chips) 
Seat 6: 4plankton ($17.40 in chips) 
Seat 7: panaam ($20.98 in chips) 
Seat 8: deadmoneykid ($41.31 in chips) 
Seat 9: ygoegoe ($25 in chips) 
kamikkaze: posts small blind $0.10
snejokCoxx: posts big blind $0.25
*** HOLE CARDS ***
Dealt to chiyuki [As 2h]
troublesomm: folds 
chiyuki: folds 
4plankton: folds 
panaam: folds 
deadmoneykid: folds 
ygoegoe: folds 
Dan Royal: folds 
kamikkaze: folds 
Uncalled bet ($0.15) returned to snejokCoxx
snejokCoxx collected $0.20 from pot
snejokCoxx: doesn't show hand 
*** SUMMARY ***
Total pot $0.20 | Rake $0 
Seat 1: Dan Royal (button) folded before Flop (didn't bet)
Seat 2: kamikkaze (small blind) folded before Flop
Seat 3: snejokCoxx (big blind) collected ($0.20)
Seat 4: troublesomm folded before Flop (didn't bet)
Seat 5: chiyuki folded before Flop (didn't bet)
Seat 6: 4plankton folded before Flop (didn't bet)
Seat 7: panaam folded before Flop (didn't bet)
Seat 8: deadmoneykid folded before Flop (didn't bet)
Seat 9: ygoegoe folded before Flop (didn't bet)



PokerStars Zoom Hand #84300352089:  Hold'em No Limit ($0.10/$0.25) - 2012/08/05 15:22:23 JST [2012/08/05 2:22:23 ET]
Table 'Whirlpool' 9-max Seat #1 is the button
Seat 1: WARIBANA7777 ($14.33 in chips) 
Seat 2: INSP!RON ($29.59 in chips) 
Seat 3: Grishukps ($12.50 in chips) 
Seat 4: dergeb ($20.50 in chips) 
Seat 5: troublesomm ($25 in chips) 
Seat 6: KrystalAA ($17.65 in chips) 
Seat 7: rey2040 ($9.47 in chips) 
Seat 8: chiyuki ($34.16 in chips) 
Seat 9: ChrisCDee ($46.96 in chips) 
INSP!RON: posts small blind $0.10
Grishukps: posts big blind $0.25
*** HOLE CARDS ***
Dealt to chiyuki [2h 5d]
dergeb: folds 
troublesomm: folds 
KrystalAA: folds 
rey2040: folds 
chiyuki: folds 
ChrisCDee: raises $0.50 to $0.75
WARIBANA7777: folds 
INSP!RON: folds 
Grishukps: folds 
Uncalled bet ($0.50) returned to ChrisCDee
ChrisCDee collected $0.60 from pot
ChrisCDee: doesn't show hand 
*** SUMMARY ***
Total pot $0.60 | Rake $0 
Seat 1: WARIBANA7777 (button) folded before Flop (didn't bet)
Seat 2: INSP!RON (small blind) folded before Flop
Seat 3: Grishukps (big blind) folded before Flop
Seat 4: dergeb folded before Flop (didn't bet)
Seat 5: troublesomm folded before Flop (didn't bet)
Seat 6: KrystalAA folded before Flop (didn't bet)
Seat 7: rey2040 folded before Flop (didn't bet)
Seat 8: chiyuki folded before Flop (didn't bet)
Seat 9: ChrisCDee collected ($0.60)



PokerStars Zoom Hand #84300355653:  Hold'em No Limit ($0.10/$0.25) - 2012/08/05 15:22:37 JST [2012/08/05 2:22:37 ET]
Table 'Whirlpool' 9-max Seat #1 is the button
Seat 1: Tom1999 ($4.95 in chips) 
Seat 2: Perstenev ($17.37 in chips) 
Seat 3: deadmoneykid ($41.31 in chips) 
Seat 4: snejokCoxx ($12.72 in chips) 
Seat 5: mjmichi ($48.98 in chips) 
Seat 6: chiyuki ($34.16 in chips) 
Seat 7: Roglus ($3.50 in chips) 
Seat 8: seula i ($25 in chips) 
Seat 9: KrystalAA ($17.65 in chips) 
Perstenev: posts small blind $0.10
deadmoneykid: posts big blind $0.25
*** HOLE CARDS ***
Dealt to chiyuki [Qh 2c]
snejokCoxx: folds 
mjmichi: raises $0.50 to $0.75
chiyuki: folds 
Roglus: folds 
seula i: folds 
KrystalAA: folds 
Tom1999: folds 
Perstenev: folds 
deadmoneykid: folds 
Uncalled bet ($0.50) returned to mjmichi
mjmichi collected $0.60 from pot
mjmichi: doesn't show hand 
*** SUMMARY ***
Total pot $0.60 | Rake $0 
Seat 1: Tom1999 (button) folded before Flop (didn't bet)
Seat 2: Perstenev (small blind) folded before Flop
Seat 3: deadmoneykid (big blind) folded before Flop
Seat 4: snejokCoxx folded before Flop (didn't bet)
Seat 5: mjmichi collected ($0.60)
Seat 6: chiyuki folded before Flop (didn't bet)
Seat 7: Roglus folded before Flop (didn't bet)
Seat 8: seula i folded before Flop (didn't bet)
Seat 9: KrystalAA folded before Flop (didn't bet)



PokerStars Zoom Hand #84300356457:  Hold'em No Limit ($0.10/$0.25) - 2012/08/05 15:22:40 JST [2012/08/05 2:22:40 ET]
Table 'Whirlpool' 9-max Seat #1 is the button
Seat 1: GravyWalrus ($9.15 in chips) 
Seat 2: ZhukOFFskI ($29.30 in chips) 
Seat 3: chiyuki ($34.16 in chips) 
Seat 4: DutchShultzs ($42.31 in chips) 
Seat 5: 1Karina1 ($25.80 in chips) 
Seat 6: KeLevro0 ($13.23 in chips) 
Seat 7: Nerkit ($11.33 in chips) 
Seat 8: Gichboy ($13.04 in chips) 
Seat 9: Perstenev ($17.27 in chips) 
ZhukOFFskI: posts small blind $0.10
chiyuki: posts big blind $0.25
*** HOLE CARDS ***
Dealt to chiyuki [4s Jd]
DutchShultzs: folds 
1Karina1: folds 
KeLevro0: folds 
Nerkit: folds 
Gichboy: folds 
Perstenev: folds 
GravyWalrus: folds 
ZhukOFFskI: raises $0.37 to $0.62
chiyuki: folds 
Uncalled bet ($0.37) returned to ZhukOFFskI
ZhukOFFskI collected $0.50 from pot
ZhukOFFskI: doesn't show hand 
*** SUMMARY ***
Total pot $0.50 | Rake $0 
Seat 1: GravyWalrus (button) folded before Flop (didn't bet)
Seat 2: ZhukOFFskI (small blind) collected ($0.50)
Seat 3: chiyuki (big blind) folded before Flop
Seat 4: DutchShultzs folded before Flop (didn't bet)
Seat 5: 1Karina1 folded before Flop (didn't bet)
Seat 6: KeLevro0 folded before Flop (didn't bet)
Seat 7: Nerkit folded before Flop (didn't bet)
Seat 8: Gichboy folded before Flop (didn't bet)
Seat 9: Perstenev folded before Flop (didn't bet)



PokerStars Zoom Hand #84300361605:  Hold'em No Limit ($0.10/$0.25) - 2012/08/05 15:23:00 JST [2012/08/05 2:23:00 ET]
Table 'Whirlpool' 9-max Seat #1 is the button
Seat 1: grand maitre ($20.91 in chips) 
Seat 2: Saruotiss ($56.07 in chips) 
Seat 3: masterkoolb ($15.54 in chips) 
Seat 4: DutchShultzs ($32.87 in chips) 
Seat 5: laurentzu84 ($31.14 in chips) 
Seat 6: GSDP ($24.15 in chips) 
Seat 7: INSP!RON ($29.49 in chips) 
Seat 8: 1Karina1 ($27.66 in chips) 
Seat 9: chiyuki ($33.91 in chips) 
Saruotiss: posts small blind $0.10
masterkoolb: posts big blind $0.25
*** HOLE CARDS ***
Dealt to chiyuki [5s 6c]
DutchShultzs: folds 
laurentzu84: folds 
GSDP: folds 
INSP!RON: folds 
1Karina1: folds 
chiyuki: folds 
grand maitre: folds 
Saruotiss: folds 
Uncalled bet ($0.15) returned to masterkoolb
masterkoolb collected $0.20 from pot
masterkoolb: doesn't show hand 
*** SUMMARY ***
Total pot $0.20 | Rake $0 
Seat 1: grand maitre (button) folded before Flop (didn't bet)
Seat 2: Saruotiss (small blind) folded before Flop
Seat 3: masterkoolb (big blind) collected ($0.20)
Seat 4: DutchShultzs folded before Flop (didn't bet)
Seat 5: laurentzu84 folded before Flop (didn't bet)
Seat 6: GSDP folded before Flop (didn't bet)
Seat 7: INSP!RON folded before Flop (didn't bet)
Seat 8: 1Karina1 folded before Flop (didn't bet)
Seat 9: chiyuki folded before Flop (didn't bet)



PokerStars Zoom Hand #84300344678:  Hold'em No Limit ($0.10/$0.25) - 2012/08/05 15:21:53 JST [2012/08/05 2:21:53 ET]
Table 'Whirlpool' 9-max Seat #1 is the button
Seat 1: phate-1up ($29.69 in chips) 
Seat 2: chiyuki ($34.26 in chips) 
Seat 3: DutchShultzs ($42.56 in chips) 
Seat 4: troublesomm ($37.26 in chips) 
Seat 5: moku36 ($17.40 in chips) 
Seat 6: KeLevro0 ($14.17 in chips) 
Seat 7: turbotom122 ($28.19 in chips) 
Seat 8: ChrisCDee ($25 in chips) 
Seat 9: ViTiV2010 ($11.16 in chips) 
chiyuki: posts small blind $0.10
DutchShultzs: posts big blind $0.25
*** HOLE CARDS ***
Dealt to chiyuki [3h 5h]
troublesomm: folds 
moku36: calls $0.25
KeLevro0 has timed out
KeLevro0: folds 
turbotom122: calls $0.25
ChrisCDee: folds 
ViTiV2010: raises $0.95 to $1.20
phate-1up: folds 
chiyuki: folds 
DutchShultzs: folds 
moku36: calls $0.95
turbotom122: calls $0.95
*** FLOP *** [Ah Ac Ts]
moku36: checks 
turbotom122: checks 
ViTiV2010: bets $2
moku36: raises $14.20 to $16.20 and is all-in
turbotom122: folds 
ViTiV2010: folds 
Uncalled bet ($14.20) returned to moku36
moku36 collected $7.59 from pot
moku36: doesn't show hand 
*** SUMMARY ***
Total pot $7.95 | Rake $0.36 
Board [Ah Ac Ts]
Seat 1: phate-1up (button) folded before Flop (didn't bet)
Seat 2: chiyuki (small blind) folded before Flop
Seat 3: DutchShultzs (big blind) folded before Flop
Seat 4: troublesomm folded before Flop (didn't bet)
Seat 5: moku36 collected ($7.59)
Seat 6: KeLevro0 folded before Flop (didn't bet)
Seat 7: turbotom122 folded on the Flop
Seat 8: ChrisCDee folded before Flop (didn't bet)
Seat 9: ViTiV2010 folded on the Flop



PokerStars Zoom Hand #84300362612:  Hold'em No Limit ($0.10/$0.25) - 2012/08/05 15:23:04 JST [2012/08/05 2:23:04 ET]
Table 'Whirlpool' 9-max Seat #1 is the button
Seat 1: Dejacob ($25 in chips) 
Seat 2: nice.franki ($12.25 in chips) 
Seat 3: hirozo ($35.98 in chips) 
Seat 4: Perstenev ($10.34 in chips) 
Seat 5: GovGus ($33.08 in chips) 
Seat 6: grand maitre ($20.91 in chips) 
Seat 7: chiyuki ($33.91 in chips) 
Seat 8: svg51 ($11.44 in chips) 
Seat 9: Saruotiss ($55.97 in chips) 
nice.franki: posts small blind $0.10
hirozo: posts big blind $0.25
*** HOLE CARDS ***
Dealt to chiyuki [Qc 2s]
Perstenev: folds 
GovGus: folds 
grand maitre: folds 
chiyuki: folds 
svg51: folds 
Saruotiss: folds 
Dejacob: raises $0.50 to $0.75
nice.franki: folds 
hirozo: folds 
Uncalled bet ($0.50) returned to Dejacob
Dejacob collected $0.60 from pot
Dejacob: doesn't show hand 
*** SUMMARY ***
Total pot $0.60 | Rake $0 
Seat 1: Dejacob (button) collected ($0.60)
Seat 2: nice.franki (small blind) folded before Flop
Seat 3: hirozo (big blind) folded before Flop
Seat 4: Perstenev folded before Flop (didn't bet)
Seat 5: GovGus folded before Flop (didn't bet)
Seat 6: grand maitre folded before Flop (didn't bet)
Seat 7: chiyuki folded before Flop (didn't bet)
Seat 8: svg51 folded before Flop (didn't bet)
Seat 9: Saruotiss folded before Flop (didn't bet)



PokerStars Zoom Hand #84300363677:  Hold'em No Limit ($0.10/$0.25) - 2012/08/05 15:23:08 JST [2012/08/05 2:23:08 ET]
Table 'Whirlpool' 9-max Seat #1 is the button
Seat 1: chiyuki ($33.91 in chips) 
Seat 2: KeLevro0 ($13.23 in chips) 
Seat 3: Robchie ($16.45 in chips) 
Seat 4: Perstenev ($17.27 in chips) 
Seat 5: ZhukOFFskI ($74.78 in chips) 
Seat 6: KrystalAA ($34.52 in chips) 
Seat 7: svg51 ($11.44 in chips) 
Seat 8: DutchShultzs ($25 in chips) 
Seat 9: kwkim73 ($26.60 in chips) 
KeLevro0: posts small blind $0.10
Robchie: posts big blind $0.25
*** HOLE CARDS ***
Dealt to chiyuki [As 9s]
Perstenev: folds 
ZhukOFFskI: folds 
KrystalAA: folds 
svg51: folds 
DutchShultzs: raises $0.50 to $0.75
kwkim73: folds 
chiyuki: folds 
KeLevro0: folds 
Robchie: calls $0.50
*** FLOP *** [6d 9h 8d]
Robchie: bets $0.75
DutchShultzs: folds 
Uncalled bet ($0.75) returned to Robchie
Robchie collected $1.53 from pot
Robchie: doesn't show hand 
*** SUMMARY ***
Total pot $1.60 | Rake $0.07 
Board [6d 9h 8d]
Seat 1: chiyuki (button) folded before Flop (didn't bet)
Seat 2: KeLevro0 (small blind) folded before Flop
Seat 3: Robchie (big blind) collected ($1.53)
Seat 4: Perstenev folded before Flop (didn't bet)
Seat 5: ZhukOFFskI folded before Flop (didn't bet)
Seat 6: KrystalAA folded before Flop (didn't bet)
Seat 7: svg51 folded before Flop (didn't bet)
Seat 8: DutchShultzs folded on the Flop
Seat 9: kwkim73 folded before Flop (didn't bet)



PokerStars Zoom Hand #84300369372:  Hold'em No Limit ($0.10/$0.25) - 2012/08/05 15:23:31 JST [2012/08/05 2:23:31 ET]
Table 'Whirlpool' 9-max Seat #1 is the button
Seat 1: ZhukOFFskI ($29.55 in chips) 
Seat 2: chiyuki ($33.91 in chips) 
Seat 3: nice.franki ($13.60 in chips) 
Seat 4: Rilko1975 ($37.36 in chips) 
Seat 5: ygoegoe ($25.68 in chips) 
Seat 6: turbotom122 ($26.89 in chips) 
Seat 7: DutchShultzs ($32.77 in chips) 
Seat 8: deadmoneykid ($26.12 in chips) 
Seat 9: 4plankton ($18.07 in chips) 
chiyuki: posts small blind $0.10
nice.franki: posts big blind $0.25
*** HOLE CARDS ***
Dealt to chiyuki [Qc As]
Rilko1975: raises $0.50 to $0.75
ygoegoe: folds 
turbotom122: folds 
DutchShultzs: folds 
deadmoneykid: folds 
4plankton: folds 
ZhukOFFskI: folds 
chiyuki: calls $0.65
nice.franki: folds 
*** FLOP *** [4h Qd 4s]
chiyuki: checks 
Rilko1975: bets $0.75
chiyuki: raises $1.25 to $2
Rilko1975: folds 
Uncalled bet ($1.25) returned to chiyuki
chiyuki collected $3.10 from pot
chiyuki: doesn't show hand 
*** SUMMARY ***
Total pot $3.25 | Rake $0.15 
Board [4h Qd 4s]
Seat 1: ZhukOFFskI (button) folded before Flop (didn't bet)
Seat 2: chiyuki (small blind) collected ($3.10)
Seat 3: nice.franki (big blind) folded before Flop
Seat 4: Rilko1975 folded on the Flop
Seat 5: ygoegoe folded before Flop (didn't bet)
Seat 6: turbotom122 folded before Flop (didn't bet)
Seat 7: DutchShultzs folded before Flop (didn't bet)
Seat 8: deadmoneykid folded before Flop (didn't bet)
Seat 9: 4plankton folded before Flop (didn't bet)



PokerStars Zoom Hand #84300377227:  Hold'em No Limit ($0.10/$0.25) - 2012/08/05 15:24:02 JST [2012/08/05 2:24:02 ET]
Table 'Whirlpool' 9-max Seat #1 is the button
Seat 1: Grishukps ($15.17 in chips) 
Seat 2: rey2040 ($4.77 in chips) 
Seat 3: 1Karina1 ($26.95 in chips) 
Seat 4: chiyuki ($35.51 in chips) 
Seat 5: Jene4kaBest ($20.13 in chips) 
Seat 6: troublesomm ($37.09 in chips) 
Seat 7: nice.franki ($12.50 in chips) 
Seat 8: DutchShultzs ($32.52 in chips) 
Seat 9: ygoegoe ($43.10 in chips) 
rey2040: posts small blind $0.10
1Karina1: posts big blind $0.25
*** HOLE CARDS ***
Dealt to chiyuki [Ks Th]
chiyuki: folds 
Jene4kaBest: folds 
troublesomm: raises $0.25 to $0.50
nice.franki: folds 
DutchShultzs: folds 
ygoegoe: folds 
Grishukps: folds 
rey2040: folds 
1Karina1: folds 
Uncalled bet ($0.25) returned to troublesomm
troublesomm collected $0.60 from pot
troublesomm: doesn't show hand 
*** SUMMARY ***
Total pot $0.60 | Rake $0 
Seat 1: Grishukps (button) folded before Flop (didn't bet)
Seat 2: rey2040 (small blind) folded before Flop
Seat 3: 1Karina1 (big blind) folded before Flop
Seat 4: chiyuki folded before Flop (didn't bet)
Seat 5: Jene4kaBest folded before Flop (didn't bet)
Seat 6: troublesomm collected ($0.60)
Seat 7: nice.franki folded before Flop (didn't bet)
Seat 8: DutchShultzs folded before Flop (didn't bet)
Seat 9: ygoegoe folded before Flop (didn't bet)



PokerStars Zoom Hand #84300380327:  Hold'em No Limit ($0.10/$0.25) - 2012/08/05 15:24:14 JST [2012/08/05 2:24:14 ET]
Table 'Whirlpool' 9-max Seat #1 is the button
Seat 1: GovGus ($29.35 in chips) 
Seat 2: DutchShultzs ($25 in chips) 
Seat 3: chiyuki ($35.51 in chips) 
Seat 4: kwkim73 ($25 in chips) 
Seat 5: Silveystryk ($25 in chips) 
Seat 6: nice.franki ($13.25 in chips) 
Seat 7: moku36 ($20.54 in chips) 
Seat 8: Perstenev ($14.17 in chips) 
Seat 9: Tom1999 ($15.96 in chips) 
DutchShultzs: posts small blind $0.10
chiyuki: posts big blind $0.25
*** HOLE CARDS ***
Dealt to chiyuki [9d 3s]
kwkim73: folds 
Silveystryk: folds 
nice.franki: folds 
moku36: folds 
Perstenev: raises $0.50 to $0.75
Tom1999: folds 
GovGus: folds 
DutchShultzs: folds 
chiyuki: folds 
Uncalled bet ($0.50) returned to Perstenev
Perstenev collected $0.60 from pot
Perstenev: doesn't show hand 
*** SUMMARY ***
Total pot $0.60 | Rake $0 
Seat 1: GovGus (button) folded before Flop (didn't bet)
Seat 2: DutchShultzs (small blind) folded before Flop
Seat 3: chiyuki (big blind) folded before Flop
Seat 4: kwkim73 folded before Flop (didn't bet)
Seat 5: Silveystryk folded before Flop (didn't bet)
Seat 6: nice.franki folded before Flop (didn't bet)
Seat 7: moku36 folded before Flop (didn't bet)
Seat 8: Perstenev collected ($0.60)
Seat 9: Tom1999 folded before Flop (didn't bet)



PokerStars Zoom Hand #84300368310:  Hold'em No Limit ($0.10/$0.25) - 2012/08/05 15:23:27 JST [2012/08/05 2:23:27 ET]
Table 'Whirlpool' 9-max Seat #1 is the button
Seat 1: mjmichi ($42.75 in chips) 
Seat 2: kwkim73 ($26.59 in chips) 
Seat 3: svg51 ($11.44 in chips) 
Seat 4: WARIBANA7777 ($13.73 in chips) 
Seat 5: GSDP ($24.15 in chips) 
Seat 6: snejokCoxx ($12.87 in chips) 
Seat 7: Nerkit ($11.08 in chips) 
Seat 8: chiyuki ($33.91 in chips) 
Seat 9: masterkoolb ($15.54 in chips) 
kwkim73: posts small blind $0.10
svg51: posts big blind $0.25
*** HOLE CARDS ***
Dealt to chiyuki [5s Qc]
WARIBANA7777: raises $0.49 to $0.74
GSDP: calls $0.74
snejokCoxx: folds 
Nerkit: folds 
chiyuki: folds 
masterkoolb: folds 
mjmichi: folds 
kwkim73: folds 
svg51: folds 
*** FLOP *** [6h 4d 8s]
WARIBANA7777: bets $0.42
GSDP: calls $0.42
*** TURN *** [6h 4d 8s] [Qd]
WARIBANA7777: checks 
GSDP: bets $1.50
WARIBANA7777: raises $2.07 to $3.57
GSDP: folds 
Uncalled bet ($2.07) returned to WARIBANA7777
WARIBANA7777 collected $5.41 from pot
WARIBANA7777: doesn't show hand 
*** SUMMARY ***
Total pot $5.67 | Rake $0.26 
Board [6h 4d 8s Qd]
Seat 1: mjmichi (button) folded before Flop (didn't bet)
Seat 2: kwkim73 (small blind) folded before Flop
Seat 3: svg51 (big blind) folded before Flop
Seat 4: WARIBANA7777 collected ($5.41)
Seat 5: GSDP folded on the Turn
Seat 6: snejokCoxx folded before Flop (didn't bet)
Seat 7: Nerkit folded before Flop (didn't bet)
Seat 8: chiyuki folded before Flop (didn't bet)
Seat 9: masterkoolb folded before Flop (didn't bet)



PokerStars Zoom Hand #84300384939:  Hold'em No Limit ($0.10/$0.25) - 2012/08/05 15:24:32 JST [2012/08/05 2:24:32 ET]
Table 'Whirlpool' 9-max Seat #1 is the button
Seat 1: Rilko1975 ($23.96 in chips) 
Seat 2: Grishukps ($12.50 in chips) 
Seat 3: troublesomm ($27.60 in chips) 
Seat 4: macmauret ($16.86 in chips) 
Seat 5: nice.franki ($13.25 in chips) 
Seat 6: chiyuki ($35.26 in chips) 
Seat 7: hirozo ($90.04 in chips) 
Seat 8: Ellen1947 ($23.95 in chips) 
Seat 9: Robchie ($21.72 in chips) 
Grishukps: posts small blind $0.10
troublesomm: posts big blind $0.25
*** HOLE CARDS ***
Dealt to chiyuki [9d Qh]
macmauret: folds 
nice.franki: folds 
chiyuki: folds 
hirozo: raises $0.50 to $0.75
Ellen1947: folds 
Robchie: folds 
Rilko1975: folds 
Grishukps: folds 
troublesomm: folds 
Uncalled bet ($0.50) returned to hirozo
hirozo collected $0.60 from pot
hirozo: doesn't show hand 
hirozo is disconnected 
*** SUMMARY ***
Total pot $0.60 | Rake $0 
Seat 1: Rilko1975 (button) folded before Flop (didn't bet)
Seat 2: Grishukps (small blind) folded before Flop
Seat 3: troublesomm (big blind) folded before Flop
Seat 4: macmauret folded before Flop (didn't bet)
Seat 5: nice.franki folded before Flop (didn't bet)
Seat 6: chiyuki folded before Flop (didn't bet)
Seat 7: hirozo collected ($0.60)
Seat 8: Ellen1947 folded before Flop (didn't bet)
Seat 9: Robchie folded before Flop (didn't bet)



PokerStars Zoom Hand #84300386439:  Hold'em No Limit ($0.10/$0.25) - 2012/08/05 15:24:39 JST [2012/08/05 2:24:39 ET]
Table 'Whirlpool' 9-max Seat #1 is the button
Seat 1: seula i ($28.16 in chips) 
Seat 2: DutchShultzs ($32.87 in chips) 
Seat 3: rey2040 ($4.67 in chips) 
Seat 4: panaam ($18.73 in chips) 
Seat 5: troublesomm ($37.44 in chips) 
Seat 6: Perstenev ($14.52 in chips) 
Seat 7: Spheroff ($25.35 in chips) 
Seat 8: snejokCoxx ($12.77 in chips) 
Seat 9: chiyuki ($35.26 in chips) 
DutchShultzs: posts small blind $0.10
rey2040: posts big blind $0.25
*** HOLE CARDS ***
Dealt to chiyuki [Ac 8s]
panaam: folds 
troublesomm: folds 
Perstenev: folds 
Spheroff: folds 
snejokCoxx: folds 
chiyuki: folds 
seula i: raises $0.50 to $0.75
DutchShultzs: folds 
rey2040: raises $3.92 to $4.67 and is all-in
seula i: calls $3.92
*** FLOP *** [5s 2d Tc]
*** TURN *** [5s 2d Tc] [7d]
*** RIVER *** [5s 2d Tc 7d] [Kh]
*** SHOW DOWN ***
rey2040: shows [Jc Jh] (a pair of Jacks)
seula i: shows [Td Ad] (a pair of Tens)
rey2040 collected $9.02 from pot
*** SUMMARY ***
Total pot $9.44 | Rake $0.42 
Board [5s 2d Tc 7d Kh]
Seat 1: seula i (button) showed [Td Ad] and lost with a pair of Tens
Seat 2: DutchShultzs (small blind) folded before Flop
Seat 3: rey2040 (big blind) showed [Jc Jh] and won ($9.02) with a pair of Jacks
Seat 4: panaam folded before Flop (didn't bet)
Seat 5: troublesomm folded before Flop (didn't bet)
Seat 6: Perstenev folded before Flop (didn't bet)
Seat 7: Spheroff folded before Flop (didn't bet)
Seat 8: snejokCoxx folded before Flop (didn't bet)
Seat 9: chiyuki folded before Flop (didn't bet)



PokerStars Zoom Hand #84300394000:  Hold'em No Limit ($0.10/$0.25) - 2012/08/05 15:25:08 JST [2012/08/05 2:25:08 ET]
Table 'Whirlpool' 9-max Seat #1 is the button
Seat 1: nice.franki ($12.15 in chips) 
Seat 2: Grishukps ($15.17 in chips) 
Seat 3: slapshot2011 ($22.78 in chips) 
Seat 4: phate-1up ($53.11 in chips) 
Seat 5: macmauret ($16.51 in chips) 
Seat 6: WARIBANA7777 ($16.38 in chips) 
Seat 7: chiyuki ($35.26 in chips) 
Seat 8: kwkim73 ($25 in chips) 
Seat 9: ChrisCDee ($34.88 in chips) 
Grishukps: posts small blind $0.10
slapshot2011: posts big blind $0.25
*** HOLE CARDS ***
Dealt to chiyuki [Ts Jd]
phate-1up: folds 
macmauret: folds 
WARIBANA7777: folds 
chiyuki: folds 
kwkim73: folds 
ChrisCDee: folds 
nice.franki: folds 
Grishukps: folds 
Uncalled bet ($0.15) returned to slapshot2011
slapshot2011 collected $0.20 from pot
slapshot2011: doesn't show hand 
*** SUMMARY ***
Total pot $0.20 | Rake $0 
Seat 1: nice.franki (button) folded before Flop (didn't bet)
Seat 2: Grishukps (small blind) folded before Flop
Seat 3: slapshot2011 (big blind) collected ($0.20)
Seat 4: phate-1up folded before Flop (didn't bet)
Seat 5: macmauret folded before Flop (didn't bet)
Seat 6: WARIBANA7777 folded before Flop (didn't bet)
Seat 7: chiyuki folded before Flop (didn't bet)
Seat 8: kwkim73 folded before Flop (didn't bet)
Seat 9: ChrisCDee folded before Flop (didn't bet)



PokerStars Zoom Hand #84300391606:  Hold'em No Limit ($0.10/$0.25) - 2012/08/05 15:24:59 JST [2012/08/05 2:24:59 ET]
Table 'Whirlpool' 9-max Seat #1 is the button
Seat 1: chiyuki ($35.26 in chips) 
Seat 2: kwkim73 ($25 in chips) 
Seat 3: Rilko1975 ($24.31 in chips) 
Seat 4: Dan Royal ($25.68 in chips) 
Seat 5: drunk_bender ($19.35 in chips) 
Seat 6: PAMBOS.L ($12.83 in chips) 
Seat 7: troublesomm ($25.35 in chips) 
Seat 8: yane73 ($8.14 in chips) 
Seat 9: Ellen1947 ($23.85 in chips) 
kwkim73: posts small blind $0.10
Rilko1975: posts big blind $0.25
*** HOLE CARDS ***
Dealt to chiyuki [Qs 5c]
Dan Royal: folds 
drunk_bender: folds 
PAMBOS.L: calls $0.25
troublesomm: folds 
yane73: folds 
Ellen1947: folds 
chiyuki: folds 
kwkim73: folds 
Rilko1975: checks 
*** FLOP *** [5s Ts 4d]
Rilko1975: bets $0.50
PAMBOS.L: calls $0.50
*** TURN *** [5s Ts 4d] [3s]
Rilko1975: bets $1
PAMBOS.L: calls $1
*** RIVER *** [5s Ts 4d 3s] [9s]
Rilko1975: checks 
PAMBOS.L: checks 
*** SHOW DOWN ***
Rilko1975: shows [4h 8d] (a pair of Fours)
PAMBOS.L: shows [Td Qd] (a pair of Tens)
PAMBOS.L collected $3.44 from pot
*** SUMMARY ***
Total pot $3.60 | Rake $0.16 
Board [5s Ts 4d 3s 9s]
Seat 1: chiyuki (button) folded before Flop (didn't bet)
Seat 2: kwkim73 (small blind) folded before Flop
Seat 3: Rilko1975 (big blind) showed [4h 8d] and lost with a pair of Fours
Seat 4: Dan Royal folded before Flop (didn't bet)
Seat 5: drunk_bender folded before Flop (didn't bet)
Seat 6: PAMBOS.L showed [Td Qd] and won ($3.44) with a pair of Tens
Seat 7: troublesomm folded before Flop (didn't bet)
Seat 8: yane73 folded before Flop (didn't bet)
Seat 9: Ellen1947 folded before Flop (didn't bet)



PokerStars Zoom Hand #84300395035:  Hold'em No Limit ($0.10/$0.25) - 2012/08/05 15:25:12 JST [2012/08/05 2:25:12 ET]
Table 'Whirlpool' 9-max Seat #1 is the button
Seat 1: masterkoolb ($13.45 in chips) 
Seat 2: seula i ($25.10 in chips) 
Seat 3: snejokCoxx ($12.77 in chips) 
Seat 4: 4plankton ($20.66 in chips) 
Seat 5: Nerkit ($12.79 in chips) 
Seat 6: chiyuki ($35.26 in chips) 
Seat 7: Faantomace ($19.47 in chips) 
Seat 8: Wilcox76607 ($25.11 in chips) 
Seat 9: nice.franki ($11.80 in chips) 
seula i: posts small blind $0.10
snejokCoxx: posts big blind $0.25
*** HOLE CARDS ***
Dealt to chiyuki [Ad Ac]
4plankton: folds 
Nerkit: folds 
chiyuki: raises $0.50 to $0.75
Faantomace: folds 
Wilcox76607: folds 
nice.franki: folds 
masterkoolb: folds 
seula i: folds 
snejokCoxx: calls $0.50
*** FLOP *** [Qh 7s 5s]
snejokCoxx: checks 
chiyuki: bets $1
snejokCoxx: folds 
Uncalled bet ($1) returned to chiyuki
chiyuki collected $1.53 from pot
chiyuki: doesn't show hand 
*** SUMMARY ***
Total pot $1.60 | Rake $0.07 
Board [Qh 7s 5s]
Seat 1: masterkoolb (button) folded before Flop (didn't bet)
Seat 2: seula i (small blind) folded before Flop
Seat 3: snejokCoxx (big blind) folded on the Flop
Seat 4: 4plankton folded before Flop (didn't bet)
Seat 5: Nerkit folded before Flop (didn't bet)
Seat 6: chiyuki collected ($1.53)
Seat 7: Faantomace folded before Flop (didn't bet)
Seat 8: Wilcox76607 folded before Flop (didn't bet)
Seat 9: nice.franki folded before Flop (didn't bet)



PokerStars Zoom Hand #84300392618:  Hold'em No Limit ($0.10/$0.25) - 2012/08/05 15:25:03 JST [2012/08/05 2:25:03 ET]
Table 'Whirlpool' 9-max Seat #1 is the button
Seat 1: WARIBANA7777 ($16.38 in chips) 
Seat 2: troublesomm ($27.35 in chips) 
Seat 3: Nerkit ($13.04 in chips) 
Seat 4: 4ydo yogurt ($27.30 in chips) 
Seat 5: Dan Royal ($25.68 in chips) 
Seat 6: phate-1up ($42.17 in chips) 
Seat 7: therati ($22.10 in chips) 
Seat 8: chiyuki ($35.26 in chips) 
Seat 9: macmauret ($16.51 in chips) 
troublesomm: posts small blind $0.10
Nerkit: posts big blind $0.25
*** HOLE CARDS ***
Dealt to chiyuki [Qh 4c]
4ydo yogurt: folds 
Dan Royal: raises $0.50 to $0.75
phate-1up: folds 
therati: folds 
chiyuki: folds 
macmauret: folds 
WARIBANA7777: folds 
troublesomm: calls $0.65
Nerkit: folds 
*** FLOP *** [2h 4h 2c]
troublesomm: checks 
Dan Royal: bets $0.75
troublesomm: raises $0.75 to $1.50
Dan Royal: calls $0.75
*** TURN *** [2h 4h 2c] [3c]
troublesomm: checks 
Dan Royal: bets $2.25
troublesomm: calls $2.25
*** RIVER *** [2h 4h 2c 3c] [9s]
troublesomm: checks 
Dan Royal: bets $7.25
troublesomm: folds 
Uncalled bet ($7.25) returned to Dan Royal
Dan Royal collected $8.83 from pot
Dan Royal: doesn't show hand 
*** SUMMARY ***
Total pot $9.25 | Rake $0.42 
Board [2h 4h 2c 3c 9s]
Seat 1: WARIBANA7777 (button) folded before Flop (didn't bet)
Seat 2: troublesomm (small blind) folded on the River
Seat 3: Nerkit (big blind) folded before Flop
Seat 4: 4ydo yogurt folded before Flop (didn't bet)
Seat 5: Dan Royal collected ($8.83)
Seat 6: phate-1up folded before Flop (didn't bet)
Seat 7: therati folded before Flop (didn't bet)
Seat 8: chiyuki folded before Flop (didn't bet)
Seat 9: macmauret folded before Flop (didn't bet)



PokerStars Zoom Hand #84300402905:  Hold'em No Limit ($0.10/$0.25) - 2012/08/05 15:25:44 JST [2012/08/05 2:25:44 ET]
Table 'Whirlpool' 9-max Seat #1 is the button
Seat 1: jacquelinewu ($74.97 in chips) 
Seat 2: chiyuki ($36.04 in chips) 
Seat 3: ChrisCDee ($68.74 in chips) 
Seat 4: nice.franki ($12.15 in chips) 
Seat 5: ZhukOFFskI ($36.33 in chips) 
Seat 6: deadmoneykid ($23.02 in chips) 
Seat 7: Nerkit ($12.40 in chips) 
Seat 8: silvno31 ($45.71 in chips) 
Seat 9: INSP!RON ($41.30 in chips) 
chiyuki: posts small blind $0.10
ChrisCDee: posts big blind $0.25
*** HOLE CARDS ***
Dealt to chiyuki [Kc Js]
nice.franki: folds 
ZhukOFFskI: folds 
deadmoneykid: folds 
Nerkit: folds 
silvno31: folds 
INSP!RON: raises $0.50 to $0.75
jacquelinewu: folds 
chiyuki: folds 
ChrisCDee: folds 
Uncalled bet ($0.50) returned to INSP!RON
INSP!RON collected $0.60 from pot
INSP!RON: doesn't show hand 
*** SUMMARY ***
Total pot $0.60 | Rake $0 
Seat 1: jacquelinewu (button) folded before Flop (didn't bet)
Seat 2: chiyuki (small blind) folded before Flop
Seat 3: ChrisCDee (big blind) folded before Flop
Seat 4: nice.franki folded before Flop (didn't bet)
Seat 5: ZhukOFFskI folded before Flop (didn't bet)
Seat 6: deadmoneykid folded before Flop (didn't bet)
Seat 7: Nerkit folded before Flop (didn't bet)
Seat 8: silvno31 folded before Flop (didn't bet)
Seat 9: INSP!RON collected ($0.60)



PokerStars Zoom Hand #84300405920:  Hold'em No Limit ($0.10/$0.25) - 2012/08/05 15:25:56 JST [2012/08/05 2:25:56 ET]
Table 'Whirlpool' 9-max Seat #1 is the button
Seat 1: WARIBANA7777 ($16.03 in chips) 
Seat 2: phate-1up ($52.86 in chips) 
Seat 3: nice.franki ($11.80 in chips) 
Seat 4: Tidder ($23.75 in chips) 
Seat 5: chiyuki ($35.94 in chips) 
Seat 6: jacquelinewu ($35.78 in chips) 
Seat 7: 4plankton ($20.41 in chips) 
Seat 8: troublesomm ($26.03 in chips) 
Seat 9: ZhukOFFskI ($74.88 in chips) 
phate-1up: posts small blind $0.10
nice.franki: posts big blind $0.25
*** HOLE CARDS ***
Dealt to chiyuki [3h 6c]
Tidder: folds 
chiyuki: folds 
jacquelinewu: folds 
4plankton: folds 
troublesomm: folds 
ZhukOFFskI: raises $0.50 to $0.75
WARIBANA7777: folds 
phate-1up: folds 
nice.franki: folds 
Uncalled bet ($0.50) returned to ZhukOFFskI
ZhukOFFskI collected $0.60 from pot
ZhukOFFskI: doesn't show hand 
*** SUMMARY ***
Total pot $0.60 | Rake $0 
Seat 1: WARIBANA7777 (button) folded before Flop (didn't bet)
Seat 2: phate-1up (small blind) folded before Flop
Seat 3: nice.franki (big blind) folded before Flop
Seat 4: Tidder folded before Flop (didn't bet)
Seat 5: chiyuki folded before Flop (didn't bet)
Seat 6: jacquelinewu folded before Flop (didn't bet)
Seat 7: 4plankton folded before Flop (didn't bet)
Seat 8: troublesomm folded before Flop (didn't bet)
Seat 9: ZhukOFFskI collected ($0.60)



PokerStars Zoom Hand #84300407212:  Hold'em No Limit ($0.10/$0.25) - 2012/08/05 15:26:01 JST [2012/08/05 2:26:01 ET]
Table 'Whirlpool' 9-max Seat #1 is the button
Seat 1: ygoegoe ($43.10 in chips) 
Seat 2: fima00000007 ($9.26 in chips) 
Seat 3: NuMetal88 ($26.38 in chips) 
Seat 4: Dan Royal ($30.01 in chips) 
Seat 5: INSP!RON ($41.65 in chips) 
Seat 6: phate-1up ($52.76 in chips) 
Seat 7: chiyuki ($35.94 in chips) 
Seat 8: ChrisCDee ($34.88 in chips) 
Seat 9: WARIBANA7777 ($16.03 in chips) 
fima00000007: posts small blind $0.10
NuMetal88: posts big blind $0.25
*** HOLE CARDS ***
Dealt to chiyuki [Ac 7h]
Dan Royal: folds 
INSP!RON: folds 
phate-1up: folds 
chiyuki: folds 
ChrisCDee: folds 
WARIBANA7777: folds 
ygoegoe: folds 
fima00000007: calls $0.15
NuMetal88: checks 
*** FLOP *** [Td 8c 4d]
fima00000007: bets $1.50
NuMetal88: folds 
Uncalled bet ($1.50) returned to fima00000007
fima00000007 collected $0.48 from pot
fima00000007: doesn't show hand 
*** SUMMARY ***
Total pot $0.50 | Rake $0.02 
Board [Td 8c 4d]
Seat 1: ygoegoe (button) folded before Flop (didn't bet)
Seat 2: fima00000007 (small blind) collected ($0.48)
Seat 3: NuMetal88 (big blind) folded on the Flop
Seat 4: Dan Royal folded before Flop (didn't bet)
Seat 5: INSP!RON folded before Flop (didn't bet)
Seat 6: phate-1up folded before Flop (didn't bet)
Seat 7: chiyuki folded before Flop (didn't bet)
Seat 8: ChrisCDee folded before Flop (didn't bet)
Seat 9: WARIBANA7777 folded before Flop (didn't bet)



PokerStars Zoom Hand #84300408687:  Hold'em No Limit ($0.10/$0.25) - 2012/08/05 15:26:07 JST [2012/08/05 2:26:07 ET]
Table 'Whirlpool' 9-max Seat #1 is the button
Seat 1: chiyuki ($35.94 in chips) 
Seat 2: snejokCoxx ($12.02 in chips) 
Seat 3: panaam ($19.56 in chips) 
Seat 4: ZhukOFFskI ($36.23 in chips) 
Seat 5: Grishukps ($12.50 in chips) 
Seat 6: seula i ($25 in chips) 
Seat 7: Silveystryk ($19.82 in chips) 
Seat 8: deepakmbh ($15.65 in chips) 
Seat 9: troublesomm ($28.01 in chips) 
snejokCoxx: posts small blind $0.10
panaam: posts big blind $0.25
*** HOLE CARDS ***
Dealt to chiyuki [Th Qh]
ZhukOFFskI: folds 
Grishukps: folds 
seula i: folds 
Silveystryk: calls $0.25
deepakmbh: folds 
troublesomm: folds 
chiyuki: folds 
snejokCoxx: folds 
panaam: checks 
*** FLOP *** [8d 9c 8c]
panaam: folds 
Silveystryk collected $0.57 from pot
Silveystryk: doesn't show hand 
*** SUMMARY ***
Total pot $0.60 | Rake $0.03 
Board [8d 9c 8c]
Seat 1: chiyuki (button) folded before Flop (didn't bet)
Seat 2: snejokCoxx (small blind) folded before Flop
Seat 3: panaam (big blind) folded on the Flop
Seat 4: ZhukOFFskI folded before Flop (didn't bet)
Seat 5: Grishukps folded before Flop (didn't bet)
Seat 6: seula i folded before Flop (didn't bet)
Seat 7: Silveystryk collected ($0.57)
Seat 8: deepakmbh folded before Flop (didn't bet)
Seat 9: troublesomm folded before Flop (didn't bet)



PokerStars Zoom Hand #84300412073:  Hold'em No Limit ($0.10/$0.25) - 2012/08/05 15:26:20 JST [2012/08/05 2:26:20 ET]
Table 'Whirlpool' 9-max Seat #1 is the button
Seat 1: troublesomm ($37.09 in chips) 
Seat 2: ChrisCDee ($25 in chips) 
Seat 3: chiyuki ($35.94 in chips) 
Seat 4: hirozo ($90.14 in chips) 
Seat 5: ZhukOFFskI ($75.23 in chips) 
Seat 6: jacquelinewu ($74.87 in chips) 
Seat 7: tribunpdm ($28.07 in chips) 
Seat 8: KeLevro0 ($12.05 in chips) 
Seat 9: drunk_bender ($18.25 in chips) 
ChrisCDee: posts small blind $0.10
chiyuki: posts big blind $0.25
*** HOLE CARDS ***
Dealt to chiyuki [Js 8h]
hirozo: folds 
ZhukOFFskI: raises $0.50 to $0.75
jacquelinewu: folds 
tribunpdm: folds 
KeLevro0: folds 
drunk_bender: folds 
troublesomm: folds 
ChrisCDee: folds 
chiyuki: folds 
Uncalled bet ($0.50) returned to ZhukOFFskI
ZhukOFFskI collected $0.60 from pot
ZhukOFFskI: doesn't show hand 
*** SUMMARY ***
Total pot $0.60 | Rake $0 
Seat 1: troublesomm (button) folded before Flop (didn't bet)
Seat 2: ChrisCDee (small blind) folded before Flop
Seat 3: chiyuki (big blind) folded before Flop
Seat 4: hirozo folded before Flop (didn't bet)
Seat 5: ZhukOFFskI collected ($0.60)
Seat 6: jacquelinewu folded before Flop (didn't bet)
Seat 7: tribunpdm folded before Flop (didn't bet)
Seat 8: KeLevro0 folded before Flop (didn't bet)
Seat 9: drunk_bender folded before Flop (didn't bet)



PokerStars Zoom Hand #84300416895:  Hold'em No Limit ($0.10/$0.25) - 2012/08/05 15:26:39 JST [2012/08/05 2:26:39 ET]
Table 'Whirlpool' 9-max Seat #1 is the button
Seat 1: kwkim73 ($26.25 in chips) 
Seat 2: masterkoolb ($14.16 in chips) 
Seat 3: Perstenev ($10.60 in chips) 
Seat 4: GovGus ($38.51 in chips) 
Seat 5: Silveystryk ($20.14 in chips) 
Seat 6: turbotom122 ($23.76 in chips) 
Seat 7: JhonnyP1979 ($2.12 in chips) 
Seat 8: Faantomace ($15.97 in chips) 
Seat 9: chiyuki ($35.69 in chips) 
masterkoolb: posts small blind $0.10
Perstenev: posts big blind $0.25
*** HOLE CARDS ***
Dealt to chiyuki [3c 2s]
GovGus: folds 
Silveystryk: folds 
turbotom122: folds 
JhonnyP1979: raises $0.37 to $0.62
Faantomace: folds 
chiyuki: folds 
kwkim73: folds 
masterkoolb: folds 
Perstenev: folds 
Uncalled bet ($0.37) returned to JhonnyP1979
JhonnyP1979 collected $0.60 from pot
JhonnyP1979: doesn't show hand 
*** SUMMARY ***
Total pot $0.60 | Rake $0 
Seat 1: kwkim73 (button) folded before Flop (didn't bet)
Seat 2: masterkoolb (small blind) folded before Flop
Seat 3: Perstenev (big blind) folded before Flop
Seat 4: GovGus folded before Flop (didn't bet)
Seat 5: Silveystryk folded before Flop (didn't bet)
Seat 6: turbotom122 folded before Flop (didn't bet)
Seat 7: JhonnyP1979 collected ($0.60)
Seat 8: Faantomace folded before Flop (didn't bet)
Seat 9: chiyuki folded before Flop (didn't bet)



PokerStars Zoom Hand #84300421096:  Hold'em No Limit ($0.10/$0.25) - 2012/08/05 15:26:56 JST [2012/08/05 2:26:56 ET]
Table 'Whirlpool' 9-max Seat #1 is the button
Seat 1: INSP!RON ($30.61 in chips) 
Seat 2: Alvinpe85 ($55.29 in chips) 
Seat 3: snejokCoxx ($11.62 in chips) 
Seat 4: Roglus ($5.63 in chips) 
Seat 5: kamikkaze ($14.39 in chips) 
Seat 6: svg51 ($8.98 in chips) 
Seat 7: troublesomm ($26.03 in chips) 
Seat 8: chiyuki ($35.59 in chips) 
Seat 9: Rilko1975 ($26.27 in chips) 
Alvinpe85: posts small blind $0.10
snejokCoxx: posts big blind $0.25
*** HOLE CARDS ***
Dealt to chiyuki [Qc 6d]
Roglus: folds 
kamikkaze: folds 
svg51: raises $0.50 to $0.75
troublesomm: folds 
chiyuki: folds 
Rilko1975: folds 
INSP!RON: folds 
Alvinpe85: folds 
snejokCoxx: folds 
Uncalled bet ($0.50) returned to svg51
svg51 collected $0.60 from pot
svg51: doesn't show hand 
*** SUMMARY ***
Total pot $0.60 | Rake $0 
Seat 1: INSP!RON (button) folded before Flop (didn't bet)
Seat 2: Alvinpe85 (small blind) folded before Flop
Seat 3: snejokCoxx (big blind) folded before Flop
Seat 4: Roglus folded before Flop (didn't bet)
Seat 5: kamikkaze folded before Flop (didn't bet)
Seat 6: svg51 collected ($0.60)
Seat 7: troublesomm folded before Flop (didn't bet)
Seat 8: chiyuki folded before Flop (didn't bet)
Seat 9: Rilko1975 folded before Flop (didn't bet)



PokerStars Zoom Hand #84300422105:  Hold'em No Limit ($0.10/$0.25) - 2012/08/05 15:27:01 JST [2012/08/05 2:27:01 ET]
Table 'Whirlpool' 9-max Seat #1 is the button
Seat 1: xxx Spb xxx ($26.23 in chips) 
Seat 2: pandaaaaaa ($7.61 in chips) 
Seat 3: yane73 ($7.24 in chips) 
Seat 4: kamikkaze ($14.39 in chips) 
Seat 5: troublesomm ($36.74 in chips) 
Seat 6: chiyuki ($35.59 in chips) 
Seat 7: Jene4kaBest ($20.18 in chips) 
Seat 8: Roglus ($5.63 in chips) 
Seat 9: DutchShultzs ($25.68 in chips) 
pandaaaaaa: posts small blind $0.10
yane73: posts big blind $0.25
*** HOLE CARDS ***
Dealt to chiyuki [5c Ad]
kamikkaze: folds 
troublesomm: folds 
chiyuki: folds 
Jene4kaBest: folds 
Roglus: folds 
DutchShultzs: raises $0.50 to $0.75
xxx Spb xxx: folds 
pandaaaaaa: folds 
yane73: folds 
Uncalled bet ($0.50) returned to DutchShultzs
DutchShultzs collected $0.60 from pot
DutchShultzs: doesn't show hand 
*** SUMMARY ***
Total pot $0.60 | Rake $0 
Seat 1: xxx Spb xxx (button) folded before Flop (didn't bet)
Seat 2: pandaaaaaa (small blind) folded before Flop
Seat 3: yane73 (big blind) folded before Flop
Seat 4: kamikkaze folded before Flop (didn't bet)
Seat 5: troublesomm folded before Flop (didn't bet)
Seat 6: chiyuki folded before Flop (didn't bet)
Seat 7: Jene4kaBest folded before Flop (didn't bet)
Seat 8: Roglus folded before Flop (didn't bet)
Seat 9: DutchShultzs collected ($0.60)



PokerStars Zoom Hand #84300425948:  Hold'em No Limit ($0.10/$0.25) - 2012/08/05 15:27:16 JST [2012/08/05 2:27:16 ET]
Table 'Whirlpool' 9-max Seat #1 is the button
Seat 1: Alvinpe85 ($52.76 in chips) 
Seat 2: Faraz ($14.75 in chips) 
Seat 3: rey2040 ($8.92 in chips) 
Seat 4: NuMetal88 ($25.35 in chips) 
Seat 5: chiyuki ($35.59 in chips) 
Seat 6: drunk_bender ($17.50 in chips) 
Seat 7: HighDuka ($40.98 in chips) 
Seat 8: 1Karina1 ($39.55 in chips) 
Seat 9: deadmoneykid ($26.37 in chips) 
Faraz: posts small blind $0.10
rey2040: posts big blind $0.25
*** HOLE CARDS ***
Dealt to chiyuki [Ah Th]
NuMetal88: folds 
chiyuki: folds 
drunk_bender: folds 
HighDuka: folds 
1Karina1: folds 
deadmoneykid: folds 
Alvinpe85: raises $0.37 to $0.62
Faraz: folds 
rey2040: folds 
Uncalled bet ($0.37) returned to Alvinpe85
Alvinpe85 collected $0.60 from pot
Alvinpe85: doesn't show hand 
*** SUMMARY ***
Total pot $0.60 | Rake $0 
Seat 1: Alvinpe85 (button) collected ($0.60)
Seat 2: Faraz (small blind) folded before Flop
Seat 3: rey2040 (big blind) folded before Flop
Seat 4: NuMetal88 folded before Flop (didn't bet)
Seat 5: chiyuki folded before Flop (didn't bet)
Seat 6: drunk_bender folded before Flop (didn't bet)
Seat 7: HighDuka folded before Flop (didn't bet)
Seat 8: 1Karina1 folded before Flop (didn't bet)
Seat 9: deadmoneykid folded before Flop (didn't bet)



PokerStars Zoom Hand #84300418353:  Hold'em No Limit ($0.10/$0.25) - 2012/08/05 15:26:45 JST [2012/08/05 2:26:45 ET]
Table 'Whirlpool' 9-max Seat #1 is the button
Seat 1: nice.franki ($11.45 in chips) 
Seat 2: chiyuki ($35.69 in chips) 
Seat 3: jacquelinewu ($35.39 in chips) 
Seat 4: phate-1up ($28.54 in chips) 
Seat 5: Faantomace ($15.97 in chips) 
Seat 6: KeLevro0 ($12.05 in chips) 
Seat 7: Grishukps ($12.85 in chips) 
Seat 8: 4plankton ($20.16 in chips) 
Seat 9: Spheroff ($25.13 in chips) 
chiyuki: posts small blind $0.10
jacquelinewu: posts big blind $0.25
*** HOLE CARDS ***
Dealt to chiyuki [4d 7s]
phate-1up: raises $0.50 to $0.75
Faantomace: calls $0.75
KeLevro0: folds 
Grishukps: folds 
4plankton: folds 
Spheroff: folds 
nice.franki: folds 
chiyuki: folds 
jacquelinewu: folds 
*** FLOP *** [5s Qh 4c]
phate-1up: bets $1
Faantomace: raises $3.50 to $4.50
phate-1up: raises $11.50 to $16
Faantomace: folds 
Uncalled bet ($11.50) returned to phate-1up
phate-1up collected $10.36 from pot
phate-1up: doesn't show hand 
*** SUMMARY ***
Total pot $10.85 | Rake $0.49 
Board [5s Qh 4c]
Seat 1: nice.franki (button) folded before Flop (didn't bet)
Seat 2: chiyuki (small blind) folded before Flop
Seat 3: jacquelinewu (big blind) folded before Flop
Seat 4: phate-1up collected ($10.36)
Seat 5: Faantomace folded on the Flop
Seat 6: KeLevro0 folded before Flop (didn't bet)
Seat 7: Grishukps folded before Flop (didn't bet)
Seat 8: 4plankton folded before Flop (didn't bet)
Seat 9: Spheroff folded before Flop (didn't bet)



PokerStars Zoom Hand #84300423172:  Hold'em No Limit ($0.10/$0.25) - 2012/08/05 15:27:05 JST [2012/08/05 2:27:05 ET]
Table 'Whirlpool' 9-max Seat #1 is the button
Seat 1: jacquelinewu ($35.14 in chips) 
Seat 2: phate-1up ($52.76 in chips) 
Seat 3: ygoegoe ($25 in chips) 
Seat 4: troublesomm ($36.74 in chips) 
Seat 5: chiyuki ($35.59 in chips) 
Seat 6: GSDP ($21.95 in chips) 
Seat 7: Roglus ($5.63 in chips) 
Seat 8: Lasutchik ($69.64 in chips) 
Seat 9: deepakmbh ($16 in chips) 
phate-1up: posts small blind $0.10
ygoegoe: posts big blind $0.25
*** HOLE CARDS ***
Dealt to chiyuki [7d Qh]
troublesomm: folds 
chiyuki: folds 
GSDP: folds 
Roglus: folds 
Lasutchik: folds 
deepakmbh: raises $0.55 to $0.80
jacquelinewu: folds 
phate-1up: folds 
ygoegoe: raises $1.95 to $2.75
deepakmbh: calls $1.95
*** FLOP *** [5c 5d 9c]
ygoegoe: bets $4
deepakmbh: calls $4
*** TURN *** [5c 5d 9c] [Ks]
ygoegoe: checks 
deepakmbh: bets $9.25 and is all-in
ygoegoe: calls $9.25
*** RIVER *** [5c 5d 9c Ks] [6h]
*** SHOW DOWN ***
ygoegoe: shows [Qd Qc] (two pair, Queens and Fives)
deepakmbh: mucks hand 
ygoegoe collected $30.66 from pot
*** SUMMARY ***
Total pot $32.10 | Rake $1.44 
Board [5c 5d 9c Ks 6h]
Seat 1: jacquelinewu (button) folded before Flop (didn't bet)
Seat 2: phate-1up (small blind) folded before Flop
Seat 3: ygoegoe (big blind) showed [Qd Qc] and won ($30.66) with two pair, Queens and Fives
Seat 4: troublesomm folded before Flop (didn't bet)
Seat 5: chiyuki folded before Flop (didn't bet)
Seat 6: GSDP folded before Flop (didn't bet)
Seat 7: Roglus folded before Flop (didn't bet)
Seat 8: Lasutchik folded before Flop (didn't bet)
Seat 9: deepakmbh mucked [Ah Qs]



PokerStars Zoom Hand #84300426698:  Hold'em No Limit ($0.10/$0.25) - 2012/08/05 15:27:19 JST [2012/08/05 2:27:19 ET]
Table 'Whirlpool' 9-max Seat #1 is the button
Seat 1: DutchShultzs ($44.68 in chips) 
Seat 2: silvno31 ($44.61 in chips) 
Seat 3: River_GmbH ($16.10 in chips) 
Seat 4: chiyuki ($35.59 in chips) 
Seat 5: AntoineHunt ($41.19 in chips) 
Seat 6: Jene4kaBest ($20.18 in chips) 
Seat 7: phate-1up ($79.99 in chips) 
Seat 8: KrystalAA ($12.87 in chips) 
Seat 9: Perstenev ($13.45 in chips) 
silvno31: posts small blind $0.10
River_GmbH: posts big blind $0.25
*** HOLE CARDS ***
Dealt to chiyuki [4c 5h]
chiyuki: folds 
AntoineHunt: folds 
Jene4kaBest: folds 
phate-1up: folds 
KrystalAA: folds 
Perstenev: raises $0.50 to $0.75
DutchShultzs: folds 
silvno31: folds 
River_GmbH: folds 
Uncalled bet ($0.50) returned to Perstenev
Perstenev collected $0.60 from pot
Perstenev: doesn't show hand 
*** SUMMARY ***
Total pot $0.60 | Rake $0 
Seat 1: DutchShultzs (button) folded before Flop (didn't bet)
Seat 2: silvno31 (small blind) folded before Flop
Seat 3: River_GmbH (big blind) folded before Flop
Seat 4: chiyuki folded before Flop (didn't bet)
Seat 5: AntoineHunt folded before Flop (didn't bet)
Seat 6: Jene4kaBest folded before Flop (didn't bet)
Seat 7: phate-1up folded before Flop (didn't bet)
Seat 8: KrystalAA folded before Flop (didn't bet)
Seat 9: Perstenev collected ($0.60)



PokerStars Zoom Hand #84300424680:  Hold'em No Limit ($0.10/$0.25) - 2012/08/05 15:27:11 JST [2012/08/05 2:27:11 ET]
Table 'Whirlpool' 9-max Seat #1 is the button
Seat 1: pandaaaaaa ($7.51 in chips) 
Seat 2: snejokCoxx ($11.37 in chips) 
Seat 3: slapshot2011 ($21.13 in chips) 
Seat 4: chiyuki ($35.59 in chips) 
Seat 5: troublesomm ($28.01 in chips) 
Seat 6: 1Karina1 ($39.55 in chips) 
Seat 7: nice.franki ($11.45 in chips) 
Seat 8: WARIBANA7777 ($15.68 in chips) 
Seat 9: Dejacob ($26.10 in chips) 
snejokCoxx: posts small blind $0.10
slapshot2011: posts big blind $0.25
*** HOLE CARDS ***
Dealt to chiyuki [Ts Qs]
chiyuki: folds 
troublesomm: folds 
1Karina1: folds 
nice.franki: folds 
WARIBANA7777: folds 
Dejacob: raises $0.50 to $0.75
pandaaaaaa: folds 
snejokCoxx: raises $1.25 to $2
slapshot2011: folds 
Dejacob: raises $24.10 to $26.10 and is all-in
snejokCoxx: folds 
Uncalled bet ($24.10) returned to Dejacob
Dejacob collected $4.25 from pot
Dejacob: doesn't show hand 
*** SUMMARY ***
Total pot $4.25 | Rake $0 
Seat 1: pandaaaaaa (button) folded before Flop (didn't bet)
Seat 2: snejokCoxx (small blind) folded before Flop
Seat 3: slapshot2011 (big blind) folded before Flop
Seat 4: chiyuki folded before Flop (didn't bet)
Seat 5: troublesomm folded before Flop (didn't bet)
Seat 6: 1Karina1 folded before Flop (didn't bet)
Seat 7: nice.franki folded before Flop (didn't bet)
Seat 8: WARIBANA7777 folded before Flop (didn't bet)
Seat 9: Dejacob collected ($4.25)



PokerStars Zoom Hand #84300435095:  Hold'em No Limit ($0.10/$0.25) - 2012/08/05 15:27:52 JST [2012/08/05 2:27:52 ET]
Table 'Whirlpool' 9-max Seat #1 is the button
Seat 1: chiyuki ($35.34 in chips) 
Seat 2: Tom1999 ($18.58 in chips) 
Seat 3: ZhukOFFskI ($80.95 in chips) 
Seat 4: INSP!RON ($42 in chips) 
Seat 5: kamikkaze ($14.04 in chips) 
Seat 6: DutchShultzs ($25.93 in chips) 
Seat 7: Nagus3x ($24.75 in chips) 
Seat 8: jacquelinewu ($74.52 in chips) 
Seat 9: KrystalAA ($30.32 in chips) 
Tom1999: posts small blind $0.10
ZhukOFFskI: posts big blind $0.25
*** HOLE CARDS ***
Dealt to chiyuki [5s Jh]
INSP!RON: folds 
kamikkaze: folds 
DutchShultzs: raises $0.50 to $0.75
Nagus3x: folds 
jacquelinewu: folds 
KrystalAA: folds 
chiyuki: folds 
Tom1999: folds 
ZhukOFFskI: folds 
Uncalled bet ($0.50) returned to DutchShultzs
DutchShultzs collected $0.60 from pot
DutchShultzs: doesn't show hand 
*** SUMMARY ***
Total pot $0.60 | Rake $0 
Seat 1: chiyuki (button) folded before Flop (didn't bet)
Seat 2: Tom1999 (small blind) folded before Flop
Seat 3: ZhukOFFskI (big blind) folded before Flop
Seat 4: INSP!RON folded before Flop (didn't bet)
Seat 5: kamikkaze folded before Flop (didn't bet)
Seat 6: DutchShultzs collected ($0.60)
Seat 7: Nagus3x folded before Flop (didn't bet)
Seat 8: jacquelinewu folded before Flop (didn't bet)
Seat 9: KrystalAA folded before Flop (didn't bet)



PokerStars Zoom Hand #84300427667:  Hold'em No Limit ($0.10/$0.25) - 2012/08/05 15:27:23 JST [2012/08/05 2:27:23 ET]
Table 'Whirlpool' 9-max Seat #1 is the button
Seat 1: hirozo ($84.43 in chips) 
Seat 2: seula i ($26.60 in chips) 
Seat 3: chiyuki ($35.59 in chips) 
Seat 4: NuMetal88 ($25.35 in chips) 
Seat 5: nice.franki ($11.45 in chips) 
Seat 6: fima00000007 ($9.84 in chips) 
Seat 7: AAAKK777 ($31.10 in chips) 
Seat 8: Wilcox76607 ($20.15 in chips) 
Seat 9: Grishukps ($12.60 in chips) 
seula i: posts small blind $0.10
chiyuki: posts big blind $0.25
*** HOLE CARDS ***
Dealt to chiyuki [6h Ts]
NuMetal88: folds 
nice.franki: folds 
fima00000007: raises $0.75 to $1
AAAKK777: folds 
Wilcox76607: folds 
Grishukps: folds 
hirozo: calls $1
seula i: folds 
chiyuki: folds 
*** FLOP *** [9c Tc 5c]
fima00000007: bets $2
hirozo: calls $2
*** TURN *** [9c Tc 5c] [Ad]
fima00000007: bets $1.50
hirozo: folds 
Uncalled bet ($1.50) returned to fima00000007
fima00000007 collected $6.06 from pot
fima00000007: doesn't show hand 
*** SUMMARY ***
Total pot $6.35 | Rake $0.29 
Board [9c Tc 5c Ad]
Seat 1: hirozo (button) folded on the Turn
Seat 2: seula i (small blind) folded before Flop
Seat 3: chiyuki (big blind) folded before Flop
Seat 4: NuMetal88 folded before Flop (didn't bet)
Seat 5: nice.franki folded before Flop (didn't bet)
Seat 6: fima00000007 collected ($6.06)
Seat 7: AAAKK777 folded before Flop (didn't bet)
Seat 8: Wilcox76607 folded before Flop (didn't bet)
Seat 9: Grishukps folded before Flop (didn't bet)



PokerStars Zoom Hand #84300441176:  Hold'em No Limit ($0.10/$0.25) - 2012/08/05 15:28:17 JST [2012/08/05 2:28:17 ET]
Table 'Whirlpool' 9-max Seat #1 is the button
Seat 1: ygoegoe ($39.66 in chips) 
Seat 2: slapshot2011 ($18.63 in chips) 
Seat 3: ViTiV2010 ($12.70 in chips) 
Seat 4: chiyuki ($35.34 in chips) 
Seat 5: Lasutchik ($69.54 in chips) 
Seat 6: Ellen1947 ($29.24 in chips) 
Seat 7: hirozo ($35.23 in chips) 
Seat 8: Nerkit ($14.49 in chips) 
Seat 9: jacquelinewu ($74.52 in chips) 
slapshot2011: posts small blind $0.10
ViTiV2010: posts big blind $0.25
*** HOLE CARDS ***
Dealt to chiyuki [5c 7d]
chiyuki: folds 
Lasutchik: folds 
Ellen1947: folds 
hirozo: folds 
Nerkit: folds 
jacquelinewu: folds 
ygoegoe: folds 
slapshot2011: folds 
Uncalled bet ($0.15) returned to ViTiV2010
ViTiV2010 collected $0.20 from pot
ViTiV2010: doesn't show hand 
*** SUMMARY ***
Total pot $0.20 | Rake $0 
Seat 1: ygoegoe (button) folded before Flop (didn't bet)
Seat 2: slapshot2011 (small blind) folded before Flop
Seat 3: ViTiV2010 (big blind) collected ($0.20)
Seat 4: chiyuki folded before Flop (didn't bet)
Seat 5: Lasutchik folded before Flop (didn't bet)
Seat 6: Ellen1947 folded before Flop (didn't bet)
Seat 7: hirozo folded before Flop (didn't bet)
Seat 8: Nerkit folded before Flop (didn't bet)
Seat 9: jacquelinewu folded before Flop (didn't bet)



PokerStars Zoom Hand #84300438869:  Hold'em No Limit ($0.10/$0.25) - 2012/08/05 15:28:07 JST [2012/08/05 2:28:07 ET]
Table 'Whirlpool' 9-max Seat #1 is the button
Seat 1: drunk_bender ($17.15 in chips) 
Seat 2: ChrisCDee ($34.04 in chips) 
Seat 3: nastya040 ($16.15 in chips) 
Seat 4: snejokCoxx ($9.37 in chips) 
Seat 5: ZhukOFFskI ($35.88 in chips) 
Seat 6: phate-1up ($79.74 in chips) 
Seat 7: chiyuki ($35.34 in chips) 
Seat 8: xxx Spb xxx ($45.68 in chips) 
Seat 9: DutchShultzs ($43.93 in chips) 
ChrisCDee: posts small blind $0.10
nastya040: posts big blind $0.25
*** HOLE CARDS ***
Dealt to chiyuki [9h 9s]
snejokCoxx: raises $0.40 to $0.65
ZhukOFFskI: folds 
phate-1up: folds 
chiyuki: folds 
xxx Spb xxx: calls $0.65
DutchShultzs: folds 
drunk_bender: folds 
ChrisCDee: folds 
nastya040: folds 
*** FLOP *** [Jh Tc 3s]
snejokCoxx: bets $0.99
xxx Spb xxx: folds 
Uncalled bet ($0.99) returned to snejokCoxx
snejokCoxx collected $1.58 from pot
snejokCoxx: doesn't show hand 
*** SUMMARY ***
Total pot $1.65 | Rake $0.07 
Board [Jh Tc 3s]
Seat 1: drunk_bender (button) folded before Flop (didn't bet)
Seat 2: ChrisCDee (small blind) folded before Flop
Seat 3: nastya040 (big blind) folded before Flop
Seat 4: snejokCoxx collected ($1.58)
Seat 5: ZhukOFFskI folded before Flop (didn't bet)
Seat 6: phate-1up folded before Flop (didn't bet)
Seat 7: chiyuki folded before Flop (didn't bet)
Seat 8: xxx Spb xxx folded on the Flop
Seat 9: DutchShultzs folded before Flop (didn't bet)



PokerStars Zoom Hand #84300437853:  Hold'em No Limit ($0.10/$0.25) - 2012/08/05 15:28:03 JST [2012/08/05 2:28:03 ET]
Table 'Whirlpool' 9-max Seat #1 is the button
Seat 1: yane73 ($7.22 in chips) 
Seat 2: Perstenev ($15.30 in chips) 
Seat 3: INSP!RON ($42 in chips) 
Seat 4: Rilko1975 ($33.86 in chips) 
Seat 5: ygoegoe ($39.66 in chips) 
Seat 6: KeLevro0 ($11.70 in chips) 
Seat 7: 4ydo yogurt ($31.80 in chips) 
Seat 8: Ellen1947 ($29.24 in chips) 
Seat 9: chiyuki ($35.34 in chips) 
Perstenev: posts small blind $0.10
INSP!RON: posts big blind $0.25
*** HOLE CARDS ***
Dealt to chiyuki [4d 3d]
Rilko1975: folds 
ygoegoe: folds 
KeLevro0: raises $0.42 to $0.67
4ydo yogurt: calls $0.67
Ellen1947: folds 
chiyuki: folds 
yane73: folds 
Perstenev: calls $0.57
INSP!RON: folds 
*** FLOP *** [5c 7d Qd]
Perstenev: checks 
KeLevro0: checks 
4ydo yogurt: checks 
*** TURN *** [5c 7d Qd] [4s]
Perstenev: checks 
KeLevro0: checks 
4ydo yogurt: checks 
*** RIVER *** [5c 7d Qd 4s] [Td]
Perstenev: bets $1.62
KeLevro0: folds 
4ydo yogurt: calls $1.62
*** SHOW DOWN ***
Perstenev: shows [9d Ad] (a flush, Ace high)
4ydo yogurt: mucks hand 
Perstenev collected $5.25 from pot
*** SUMMARY ***
Total pot $5.50 | Rake $0.25 
Board [5c 7d Qd 4s Td]
Seat 1: yane73 (button) folded before Flop (didn't bet)
Seat 2: Perstenev (small blind) showed [9d Ad] and won ($5.25) with a flush, Ace high
Seat 3: INSP!RON (big blind) folded before Flop
Seat 4: Rilko1975 folded before Flop (didn't bet)
Seat 5: ygoegoe folded before Flop (didn't bet)
Seat 6: KeLevro0 folded on the River
Seat 7: 4ydo yogurt mucked [Tc Kc]
Seat 8: Ellen1947 folded before Flop (didn't bet)
Seat 9: chiyuki folded before Flop (didn't bet)



PokerStars Zoom Hand #84300442686:  Hold'em No Limit ($0.10/$0.25) - 2012/08/05 15:28:23 JST [2012/08/05 2:28:23 ET]
Table 'Whirlpool' 9-max Seat #1 is the button
Seat 1: God)Squall ($33.20 in chips) 
Seat 2: chiyuki ($35.34 in chips) 
Seat 3: ChrisCDee ($27.15 in chips) 
Seat 4: Grishukps ($12.50 in chips) 
Seat 5: AAAKK777 ($31.10 in chips) 
Seat 6: 1Karina1 ($25.94 in chips) 
Seat 7: DutchShultzs ($43.93 in chips) 
Seat 8: wildy29 ($41.94 in chips) 
Seat 9: Jene4kaBest ($17.69 in chips) 
chiyuki: posts small blind $0.10
ChrisCDee: posts big blind $0.25
*** HOLE CARDS ***
Dealt to chiyuki [Qd Qh]
Grishukps: folds 
AAAKK777: raises $0.25 to $0.50
1Karina1: folds 
DutchShultzs: folds 
wildy29: calls $0.50
Jene4kaBest: folds 
God)Squall: calls $0.50
chiyuki: raises $1.75 to $2.25
ChrisCDee: folds 
AAAKK777: folds 
wildy29: calls $1.75
God)Squall: folds 
*** FLOP *** [9s 7h 2h]
chiyuki: bets $3.25
wildy29: folds 
Uncalled bet ($3.25) returned to chiyuki
chiyuki collected $5.49 from pot
chiyuki: doesn't show hand 
*** SUMMARY ***
Total pot $5.75 | Rake $0.26 
Board [9s 7h 2h]
Seat 1: God)Squall (button) folded before Flop
Seat 2: chiyuki (small blind) collected ($5.49)
Seat 3: ChrisCDee (big blind) folded before Flop
Seat 4: Grishukps folded before Flop (didn't bet)
Seat 5: AAAKK777 folded before Flop
Seat 6: 1Karina1 folded before Flop (didn't bet)
Seat 7: DutchShultzs folded before Flop (didn't bet)
Seat 8: wildy29 folded on the Flop
Seat 9: Jene4kaBest folded before Flop (didn't bet)



PokerStars Zoom Hand #84300440382:  Hold'em No Limit ($0.10/$0.25) - 2012/08/05 15:28:14 JST [2012/08/05 2:28:14 ET]
Table 'Whirlpool' 9-max Seat #1 is the button
Seat 1: nice.franki ($11.46 in chips) 
Seat 2: Dejacob ($25 in chips) 
Seat 3: KrystalAA ($12.77 in chips) 
Seat 4: hirozo ($35.23 in chips) 
Seat 5: fima00000007 ($12.90 in chips) 
Seat 6: ChrisCDee ($33.94 in chips) 
Seat 7: troublesomm ($25 in chips) 
Seat 8: chiyuki ($35.34 in chips) 
Seat 9: Roglus ($7.35 in chips) 
Dejacob: posts small blind $0.10
KrystalAA: posts big blind $0.25
*** HOLE CARDS ***
Dealt to chiyuki [8c Qh]
hirozo: folds 
fima00000007: calls $0.25
ChrisCDee: folds 
troublesomm: raises $0.75 to $1
chiyuki: folds 
Roglus: calls $1
nice.franki: folds 
Dejacob: folds 
KrystalAA: folds 
fima00000007: calls $0.75
*** FLOP *** [Ks Js Ad]
fima00000007: checks 
troublesomm: checks 
Roglus: bets $1.75
fima00000007: calls $1.75
troublesomm: folds 
*** TURN *** [Ks Js Ad] [6c]
fima00000007: checks 
Roglus: bets $2.28
fima00000007: folds 
Uncalled bet ($2.28) returned to Roglus
Roglus collected $6.54 from pot
Roglus: doesn't show hand 
*** SUMMARY ***
Total pot $6.85 | Rake $0.31 
Board [Ks Js Ad 6c]
Seat 1: nice.franki (button) folded before Flop (didn't bet)
Seat 2: Dejacob (small blind) folded before Flop
Seat 3: KrystalAA (big blind) folded before Flop
Seat 4: hirozo folded before Flop (didn't bet)
Seat 5: fima00000007 folded on the Turn
Seat 6: ChrisCDee folded before Flop (didn't bet)
Seat 7: troublesomm folded on the Flop
Seat 8: chiyuki folded before Flop (didn't bet)
Seat 9: Roglus collected ($6.54)



PokerStars Zoom Hand #84300458002:  Hold'em No Limit ($0.10/$0.25) - 2012/08/05 15:29:25 JST [2012/08/05 2:29:25 ET]
Table 'Whirlpool' 9-max Seat #1 is the button
Seat 1: kamikkaze ($13.69 in chips) 
Seat 2: phate-1up ($46.30 in chips) 
Seat 3: snejokCoxx ($10.65 in chips) 
Seat 4: Faraz ($14.25 in chips) 
Seat 5: KrystalAA ($12.52 in chips) 
Seat 6: chiyuki ($38.58 in chips) 
Seat 7: laurentzu84 ($27.89 in chips) 
Seat 8: tribunpdm ($29.10 in chips) 
Seat 9: seula i ($25.27 in chips) 
phate-1up: posts small blind $0.10
snejokCoxx: posts big blind $0.25
*** HOLE CARDS ***
Dealt to chiyuki [As Kc]
Faraz: folds 
KrystalAA: folds 
chiyuki: raises $0.50 to $0.75
laurentzu84: calls $0.75
tribunpdm: folds 
seula i: calls $0.75
kamikkaze: folds 
phate-1up: folds 
snejokCoxx: folds 
*** FLOP *** [6d 2d 9h]
chiyuki: checks 
laurentzu84: bets $2
seula i: folds 
chiyuki: folds 
Uncalled bet ($2) returned to laurentzu84
laurentzu84 collected $2.48 from pot
laurentzu84: doesn't show hand 
*** SUMMARY ***
Total pot $2.60 | Rake $0.12 
Board [6d 2d 9h]
Seat 1: kamikkaze (button) folded before Flop (didn't bet)
Seat 2: phate-1up (small blind) folded before Flop
Seat 3: snejokCoxx (big blind) folded before Flop
Seat 4: Faraz folded before Flop (didn't bet)
Seat 5: KrystalAA folded before Flop (didn't bet)
Seat 6: chiyuki folded on the Flop
Seat 7: laurentzu84 collected ($2.48)
Seat 8: tribunpdm folded before Flop (didn't bet)
Seat 9: seula i folded on the Flop



PokerStars Zoom Hand #84300470091:  Hold'em No Limit ($0.10/$0.25) - 2012/08/05 15:30:12 JST [2012/08/05 2:30:12 ET]
Table 'Whirlpool' 9-max Seat #1 is the button
Seat 1: 1Karina1 ($25.59 in chips) 
Seat 2: Grishukps ($12.60 in chips) 
Seat 3: DutchShultzs ($25.92 in chips) 
Seat 4: Perstenev ($9.75 in chips) 
Seat 5: chiyuki ($37.83 in chips) 
Seat 6: Rilko1975 ($35.21 in chips) 
Seat 7: Dejacob ($25.78 in chips) 
Seat 8: Robchie ($17.58 in chips) 
Seat 9: phate-1up ($50.33 in chips) 
Grishukps: posts small blind $0.10
DutchShultzs: posts big blind $0.25
*** HOLE CARDS ***
Dealt to chiyuki [7s 7h]
Perstenev: folds 
chiyuki: raises $0.50 to $0.75
Rilko1975: folds 
Dejacob: folds 
Robchie: folds 
phate-1up: folds 
1Karina1: folds 
Grishukps: folds 
DutchShultzs: folds 
Uncalled bet ($0.50) returned to chiyuki
chiyuki collected $0.60 from pot
chiyuki: doesn't show hand 
*** SUMMARY ***
Total pot $0.60 | Rake $0 
Seat 1: 1Karina1 (button) folded before Flop (didn't bet)
Seat 2: Grishukps (small blind) folded before Flop
Seat 3: DutchShultzs (big blind) folded before Flop
Seat 4: Perstenev folded before Flop (didn't bet)
Seat 5: chiyuki collected ($0.60)
Seat 6: Rilko1975 folded before Flop (didn't bet)
Seat 7: Dejacob folded before Flop (didn't bet)
Seat 8: Robchie folded before Flop (didn't bet)
Seat 9: phate-1up folded before Flop (didn't bet)



PokerStars Zoom Hand #84300474069:  Hold'em No Limit ($0.10/$0.25) - 2012/08/05 15:30:28 JST [2012/08/05 2:30:28 ET]
Table 'Whirlpool' 9-max Seat #1 is the button
Seat 1: Nagus3x ($23.79 in chips) 
Seat 2: snejokCoxx ($10.75 in chips) 
Seat 3: AVerdonk ($30.75 in chips) 
Seat 4: chiyuki ($38.18 in chips) 
Seat 5: KrystalAA ($20.43 in chips) 
Seat 6: GSDP ($12.86 in chips) 
Seat 7: Grishukps ($12.50 in chips) 
Seat 8: 1Karina1 ($25.49 in chips) 
Seat 9: DutchShultzs ($25.67 in chips) 
snejokCoxx: posts small blind $0.10
AVerdonk: posts big blind $0.25
*** HOLE CARDS ***
Dealt to chiyuki [Ah 4c]
chiyuki: folds 
KrystalAA: folds 
GSDP: folds 
Grishukps: folds 
1Karina1: folds 
DutchShultzs: folds 
Nagus3x: folds 
snejokCoxx: folds 
Uncalled bet ($0.15) returned to AVerdonk
AVerdonk collected $0.20 from pot
AVerdonk: doesn't show hand 
*** SUMMARY ***
Total pot $0.20 | Rake $0 
Seat 1: Nagus3x (button) folded before Flop (didn't bet)
Seat 2: snejokCoxx (small blind) folded before Flop
Seat 3: AVerdonk (big blind) collected ($0.20)
Seat 4: chiyuki folded before Flop (didn't bet)
Seat 5: KrystalAA folded before Flop (didn't bet)
Seat 6: GSDP folded before Flop (didn't bet)
Seat 7: Grishukps folded before Flop (didn't bet)
Seat 8: 1Karina1 folded before Flop (didn't bet)
Seat 9: DutchShultzs folded before Flop (didn't bet)



PokerStars Zoom Hand #84300476259:  Hold'em No Limit ($0.10/$0.25) - 2012/08/05 15:30:38 JST [2012/08/05 2:30:38 ET]
Table 'Whirlpool' 9-max Seat #1 is the button
Seat 1: Dejacob ($36.29 in chips) 
Seat 2: DutchShultzs ($37.16 in chips) 
Seat 3: chiyuki ($38.18 in chips) 
Seat 4: Grishukps ($13.10 in chips) 
Seat 5: deadmoneykid ($39.13 in chips) 
Seat 6: nice.franki ($23.40 in chips) 
Seat 7: 4plankton ($21.72 in chips) 
Seat 8: pandaaaaaa ($9.88 in chips) 
Seat 9: snejokCoxx ($10.65 in chips) 
DutchShultzs: posts small blind $0.10
chiyuki: posts big blind $0.25
*** HOLE CARDS ***
Dealt to chiyuki [5c 6h]
Grishukps: folds 
deadmoneykid: folds 
nice.franki: folds 
4plankton: folds 
pandaaaaaa: folds 
snejokCoxx: raises $0.40 to $0.65
Dejacob: folds 
DutchShultzs: folds 
chiyuki: folds 
Uncalled bet ($0.40) returned to snejokCoxx
snejokCoxx collected $0.60 from pot
snejokCoxx: doesn't show hand 
*** SUMMARY ***
Total pot $0.60 | Rake $0 
Seat 1: Dejacob (button) folded before Flop (didn't bet)
Seat 2: DutchShultzs (small blind) folded before Flop
Seat 3: chiyuki (big blind) folded before Flop
Seat 4: Grishukps folded before Flop (didn't bet)
Seat 5: deadmoneykid folded before Flop (didn't bet)
Seat 6: nice.franki folded before Flop (didn't bet)
Seat 7: 4plankton folded before Flop (didn't bet)
Seat 8: pandaaaaaa folded before Flop (didn't bet)
Seat 9: snejokCoxx collected ($0.60)



PokerStars Zoom Hand #84300481870:  Hold'em No Limit ($0.10/$0.25) - 2012/08/05 15:31:00 JST [2012/08/05 2:31:00 ET]
Table 'Whirlpool' 9-max Seat #1 is the button
Seat 1: chiyuki ($37.93 in chips) 
Seat 2: seula i ($25 in chips) 
Seat 3: kamikkaze ($15.15 in chips) 
Seat 4: DutchShultzs ($25.15 in chips) 
Seat 5: snejokCoxx ($13.10 in chips) 
Seat 6: JhonnyP1979 ($3.14 in chips) 
Seat 7: kwkim73 ($40.37 in chips) 
Seat 8: Grishukps ($12.50 in chips) 
Seat 9: River_GmbH ($15.25 in chips) 
seula i: posts small blind $0.10
kamikkaze: posts big blind $0.25
*** HOLE CARDS ***
Dealt to chiyuki [5h 6c]
DutchShultzs: folds 
snejokCoxx: folds 
JhonnyP1979: folds 
kwkim73: folds 
Grishukps: folds 
River_GmbH: folds 
chiyuki: folds 
seula i: folds 
Uncalled bet ($0.15) returned to kamikkaze
kamikkaze collected $0.20 from pot
kamikkaze: doesn't show hand 
*** SUMMARY ***
Total pot $0.20 | Rake $0 
Seat 1: chiyuki (button) folded before Flop (didn't bet)
Seat 2: seula i (small blind) folded before Flop
Seat 3: kamikkaze (big blind) collected ($0.20)
Seat 4: DutchShultzs folded before Flop (didn't bet)
Seat 5: snejokCoxx folded before Flop (didn't bet)
Seat 6: JhonnyP1979 folded before Flop (didn't bet)
Seat 7: kwkim73 folded before Flop (didn't bet)
Seat 8: Grishukps folded before Flop (didn't bet)
Seat 9: River_GmbH folded before Flop (didn't bet)



PokerStars Zoom Hand #84300485208:  Hold'em No Limit ($0.10/$0.25) - 2012/08/05 15:31:13 JST [2012/08/05 2:31:13 ET]
Table 'Whirlpool' 9-max Seat #1 is the button
Seat 1: panaam ($20.85 in chips) 
Seat 2: nice.franki ($23.40 in chips) 
Seat 3: yvasilik ($25 in chips) 
Seat 4: INSP!RON ($39.47 in chips) 
Seat 5: phate-1up ($49.98 in chips) 
Seat 6: ZhukOFFskI ($81.05 in chips) 
Seat 7: JhonnyP1979 ($3.14 in chips) 
Seat 8: kamikkaze ($15.25 in chips) 
Seat 9: chiyuki ($37.93 in chips) 
nice.franki: posts small blind $0.10
yvasilik: posts big blind $0.25
*** HOLE CARDS ***
Dealt to chiyuki [3h 3c]
INSP!RON: folds 
phate-1up: folds 
ZhukOFFskI: folds 
JhonnyP1979: raises $0.50 to $0.75
kamikkaze: folds 
chiyuki: folds 
panaam: folds 
nice.franki: folds 
yvasilik: calls $0.50
*** FLOP *** [5c 2c Jc]
yvasilik: checks 
JhonnyP1979: bets $2.39 and is all-in
yvasilik: calls $2.39
*** TURN *** [5c 2c Jc] [3s]
*** RIVER *** [5c 2c Jc 3s] [Th]
*** SHOW DOWN ***
yvasilik: shows [9h Jh] (a pair of Jacks)
JhonnyP1979: shows [Qs Kc] (high card King)
yvasilik collected $6.09 from pot
*** SUMMARY ***
Total pot $6.38 | Rake $0.29 
Board [5c 2c Jc 3s Th]
Seat 1: panaam (button) folded before Flop (didn't bet)
Seat 2: nice.franki (small blind) folded before Flop
Seat 3: yvasilik (big blind) showed [9h Jh] and won ($6.09) with a pair of Jacks
Seat 4: INSP!RON folded before Flop (didn't bet)
Seat 5: phate-1up folded before Flop (didn't bet)
Seat 6: ZhukOFFskI folded before Flop (didn't bet)
Seat 7: JhonnyP1979 showed [Qs Kc] and lost with high card King
Seat 8: kamikkaze folded before Flop (didn't bet)
Seat 9: chiyuki folded before Flop (didn't bet)



PokerStars Zoom Hand #84300488550:  Hold'em No Limit ($0.10/$0.25) - 2012/08/05 15:31:26 JST [2012/08/05 2:31:26 ET]
Table 'Whirlpool' 9-max Seat #1 is the button
Seat 1: chiyuki ($37.83 in chips) 
Seat 2: ZhukOFFskI ($81.05 in chips) 
Seat 3: KimPa39 ($26.73 in chips) 
Seat 4: Perstenev ($7.30 in chips) 
Seat 5: Wilcox76607 ($12.67 in chips) 
Seat 6: INSP!RON ($40.58 in chips) 
Seat 7: nice.franki ($10.75 in chips) 
Seat 8: Dejacob ($36.19 in chips) 
Seat 9: svg51 ($6.27 in chips) 
ZhukOFFskI: posts small blind $0.10
KimPa39: posts big blind $0.25
*** HOLE CARDS ***
Dealt to chiyuki [8s 5d]
Perstenev: calls $0.25
Wilcox76607: folds 
INSP!RON: folds 
nice.franki: folds 
Dejacob: folds 
svg51: folds 
chiyuki: folds 
ZhukOFFskI: folds 
KimPa39: raises $0.75 to $1
Perstenev: folds 
Uncalled bet ($0.75) returned to KimPa39
KimPa39 collected $0.60 from pot
KimPa39: doesn't show hand 
*** SUMMARY ***
Total pot $0.60 | Rake $0 
Seat 1: chiyuki (button) folded before Flop (didn't bet)
Seat 2: ZhukOFFskI (small blind) folded before Flop
Seat 3: KimPa39 (big blind) collected ($0.60)
Seat 4: Perstenev folded before Flop
Seat 5: Wilcox76607 folded before Flop (didn't bet)
Seat 6: INSP!RON folded before Flop (didn't bet)
Seat 7: nice.franki folded before Flop (didn't bet)
Seat 8: Dejacob folded before Flop (didn't bet)
Seat 9: svg51 folded before Flop (didn't bet)



PokerStars Zoom Hand #84300486975:  Hold'em No Limit ($0.10/$0.25) - 2012/08/05 15:31:20 JST [2012/08/05 2:31:20 ET]
Table 'Whirlpool' 9-max Seat #1 is the button
Seat 1: phate-1up ($44.44 in chips) 
Seat 2: chiyuki ($37.93 in chips) 
Seat 3: kwkim73 ($30.11 in chips) 
Seat 4: Dejacob ($25.10 in chips) 
Seat 5: deadmoneykid ($24.88 in chips) 
Seat 6: DutchShultzs ($37.06 in chips) 
Seat 7: tribunpdm ($28.20 in chips) 
Seat 8: herkko11 ($10.22 in chips) 
Seat 9: dergeb ($17.27 in chips) 
chiyuki: posts small blind $0.10
kwkim73: posts big blind $0.25
*** HOLE CARDS ***
Dealt to chiyuki [Tc 5s]
Dejacob: folds 
deadmoneykid: folds 
DutchShultzs: folds 
tribunpdm: raises $0.50 to $0.75
herkko11: folds 
dergeb: raises $0.50 to $1.25
phate-1up: folds 
chiyuki: folds 
kwkim73: folds 
tribunpdm: calls $0.50
*** FLOP *** [2s 4h 8h]
tribunpdm: checks 
dergeb: bets $1.36
tribunpdm: calls $1.36
*** TURN *** [2s 4h 8h] [Ac]
tribunpdm: checks 
dergeb: bets $2.66
tribunpdm: calls $2.66
*** RIVER *** [2s 4h 8h Ac] [8s]
tribunpdm: checks 
dergeb: checks 
*** SHOW DOWN ***
tribunpdm: shows [9s 8c] (three of a kind, Eights)
dergeb: mucks hand 
tribunpdm collected $10.40 from pot
*** SUMMARY ***
Total pot $10.89 | Rake $0.49 
Board [2s 4h 8h Ac 8s]
Seat 1: phate-1up (button) folded before Flop (didn't bet)
Seat 2: chiyuki (small blind) folded before Flop
Seat 3: kwkim73 (big blind) folded before Flop
Seat 4: Dejacob folded before Flop (didn't bet)
Seat 5: deadmoneykid folded before Flop (didn't bet)
Seat 6: DutchShultzs folded before Flop (didn't bet)
Seat 7: tribunpdm showed [9s 8c] and won ($10.40) with three of a kind, Eights
Seat 8: herkko11 folded before Flop (didn't bet)
Seat 9: dergeb mucked [Kd Ah]



PokerStars Zoom Hand #84300490868:  Hold'em No Limit ($0.10/$0.25) - 2012/08/05 15:31:35 JST [2012/08/05 2:31:35 ET]
Table 'Whirlpool' 9-max Seat #1 is the button
Seat 1: kwkim73 ($28.84 in chips) 
Seat 2: Alvinpe85 ($54.54 in chips) 
Seat 3: GSDP ($42.58 in chips) 
Seat 4: mjmichi ($47.19 in chips) 
Seat 5: turbotom122 ($15.59 in chips) 
Seat 6: Grishukps ($12.75 in chips) 
Seat 7: chiyuki ($37.83 in chips) 
Seat 8: Rilko1975 ($24.42 in chips) 
Seat 9: God)Squall ($29.80 in chips) 
Alvinpe85: posts small blind $0.10
GSDP: posts big blind $0.25
*** HOLE CARDS ***
Dealt to chiyuki [2c 5c]
mjmichi: folds 
turbotom122: calls $0.25
Grishukps: folds 
chiyuki: folds 
Rilko1975: folds 
God)Squall: folds 
kwkim73: folds 
Alvinpe85: folds 
GSDP: checks 
*** FLOP *** [8h 6c 5d]
GSDP: bets $0.25
turbotom122: calls $0.25
*** TURN *** [8h 6c 5d] [2h]
GSDP: bets $0.50
turbotom122: raises $1.75 to $2.25
GSDP: folds 
Uncalled bet ($1.75) returned to turbotom122
turbotom122 collected $2.01 from pot
turbotom122: doesn't show hand 
*** SUMMARY ***
Total pot $2.10 | Rake $0.09 
Board [8h 6c 5d 2h]
Seat 1: kwkim73 (button) folded before Flop (didn't bet)
Seat 2: Alvinpe85 (small blind) folded before Flop
Seat 3: GSDP (big blind) folded on the Turn
Seat 4: mjmichi folded before Flop (didn't bet)
Seat 5: turbotom122 collected ($2.01)
Seat 6: Grishukps folded before Flop (didn't bet)
Seat 7: chiyuki folded before Flop (didn't bet)
Seat 8: Rilko1975 folded before Flop (didn't bet)
Seat 9: God)Squall folded before Flop (didn't bet)



PokerStars Zoom Hand #84300492426:  Hold'em No Limit ($0.10/$0.25) - 2012/08/05 15:31:41 JST [2012/08/05 2:31:41 ET]
Table 'Whirlpool' 9-max Seat #1 is the button
Seat 1: ZhukOFFskI ($80.95 in chips) 
Seat 2: fima00000007 ($11.54 in chips) 
Seat 3: aSasha280 ($13.83 in chips) 
Seat 4: Roglus ($11.04 in chips) 
Seat 5: Rilko1975 ($34.11 in chips) 
Seat 6: kwkim73 ($25 in chips) 
Seat 7: seula i ($25.64 in chips) 
Seat 8: Ellen1947 ($26.04 in chips) 
Seat 9: chiyuki ($37.83 in chips) 
fima00000007: posts small blind $0.10
aSasha280: posts big blind $0.25
*** HOLE CARDS ***
Dealt to chiyuki [7s Kd]
Roglus: folds 
Rilko1975: folds 
kwkim73: raises $0.50 to $0.75
seula i: folds 
Ellen1947: folds 
chiyuki: folds 
ZhukOFFskI: folds 
fima00000007: calls $0.65
aSasha280: calls $0.50
*** FLOP *** [Jc 4s Jh]
fima00000007: checks 
aSasha280: bets $1
kwkim73: folds 
fima00000007: folds 
Uncalled bet ($1) returned to aSasha280
aSasha280 collected $2.15 from pot
aSasha280: doesn't show hand 
*** SUMMARY ***
Total pot $2.25 | Rake $0.10 
Board [Jc 4s Jh]
Seat 1: ZhukOFFskI (button) folded before Flop (didn't bet)
Seat 2: fima00000007 (small blind) folded on the Flop
Seat 3: aSasha280 (big blind) collected ($2.15)
Seat 4: Roglus folded before Flop (didn't bet)
Seat 5: Rilko1975 folded before Flop (didn't bet)
Seat 6: kwkim73 folded on the Flop
Seat 7: seula i folded before Flop (didn't bet)
Seat 8: Ellen1947 folded before Flop (didn't bet)
Seat 9: chiyuki folded before Flop (didn't bet)



PokerStars Zoom Hand #84300491669:  Hold'em No Limit ($0.10/$0.25) - 2012/08/05 15:31:38 JST [2012/08/05 2:31:38 ET]
Table 'Whirlpool' 9-max Seat #1 is the button
Seat 1: KeLevro0 ($10.14 in chips) 
Seat 2: GovGus ($44.45 in chips) 
Seat 3: Faraz ($14.63 in chips) 
Seat 4: wildy29 ($40.69 in chips) 
Seat 5: DutchShultzs ($43.58 in chips) 
Seat 6: chiyuki ($37.83 in chips) 
Seat 7: fil740 ($8.48 in chips) 
Seat 8: Wilcox76607 ($12.67 in chips) 
Seat 9: masterkoolb ($14.06 in chips) 
GovGus: posts small blind $0.10
Faraz: posts big blind $0.25
*** HOLE CARDS ***
Dealt to chiyuki [2d As]
wildy29: calls $0.25
DutchShultzs: folds 
chiyuki: folds 
fil740: folds 
Wilcox76607: raises $0.50 to $0.75
masterkoolb: folds 
KeLevro0: folds 
GovGus: folds 
Faraz: folds 
wildy29: calls $0.50
*** FLOP *** [2s 4s Jd]
wildy29: checks 
Wilcox76607: bets $1
wildy29: folds 
Uncalled bet ($1) returned to Wilcox76607
Wilcox76607 collected $1.77 from pot
Wilcox76607: doesn't show hand 
*** SUMMARY ***
Total pot $1.85 | Rake $0.08 
Board [2s 4s Jd]
Seat 1: KeLevro0 (button) folded before Flop (didn't bet)
Seat 2: GovGus (small blind) folded before Flop
Seat 3: Faraz (big blind) folded before Flop
Seat 4: wildy29 folded on the Flop
Seat 5: DutchShultzs folded before Flop (didn't bet)
Seat 6: chiyuki folded before Flop (didn't bet)
Seat 7: fil740 folded before Flop (didn't bet)
Seat 8: Wilcox76607 collected ($1.77)
Seat 9: masterkoolb folded before Flop (didn't bet)



PokerStars Zoom Hand #84300489880:  Hold'em No Limit ($0.10/$0.25) - 2012/08/05 15:31:31 JST [2012/08/05 2:31:31 ET]
Table 'Whirlpool' 9-max Seat #1 is the button
Seat 1: Silveystryk ($36.87 in chips) 
Seat 2: Dejacob ($25.10 in chips) 
Seat 3: 1Karina1 ($25 in chips) 
Seat 4: masterkoolb ($14.06 in chips) 
Seat 5: svg51 ($6.27 in chips) 
Seat 6: Ellen1947 ($26.04 in chips) 
Seat 7: Grishukps ($12.50 in chips) 
Seat 8: chiyuki ($37.83 in chips) 
Seat 9: cofla tito ($11.56 in chips) 
Dejacob: posts small blind $0.10
1Karina1: posts big blind $0.25
*** HOLE CARDS ***
Dealt to chiyuki [9d Jc]
masterkoolb: folds 
svg51: folds 
Ellen1947: folds 
Grishukps: folds 
chiyuki: folds 
cofla tito: calls $0.25
Silveystryk: calls $0.25
Dejacob: folds 
1Karina1: checks 
*** FLOP *** [3h 9s 4d]
1Karina1: checks 
cofla tito: checks 
Silveystryk: bets $0.50
1Karina1: folds 
cofla tito: folds 
Uncalled bet ($0.50) returned to Silveystryk
Silveystryk collected $0.81 from pot
Silveystryk: doesn't show hand 
*** SUMMARY ***
Total pot $0.85 | Rake $0.04 
Board [3h 9s 4d]
Seat 1: Silveystryk (button) collected ($0.81)
Seat 2: Dejacob (small blind) folded before Flop
Seat 3: 1Karina1 (big blind) folded on the Flop
Seat 4: masterkoolb folded before Flop (didn't bet)
Seat 5: svg51 folded before Flop (didn't bet)
Seat 6: Ellen1947 folded before Flop (didn't bet)
Seat 7: Grishukps folded before Flop (didn't bet)
Seat 8: chiyuki folded before Flop (didn't bet)
Seat 9: cofla tito folded on the Flop



PokerStars Zoom Hand #84300499376:  Hold'em No Limit ($0.10/$0.25) - 2012/08/05 15:32:09 JST [2012/08/05 2:32:09 ET]
Table 'Whirlpool' 9-max Seat #1 is the button
Seat 1: aSasha280 ($15.23 in chips) 
Seat 2: kamikkaze ($14.90 in chips) 
Seat 3: chiyuki ($37.83 in chips) 
Seat 4: hirozo ($89.16 in chips) 
Seat 5: Serge Claws ($25 in chips) 
Seat 6: hldtom ($26.10 in chips) 
Seat 7: masterkoolb ($14.06 in chips) 
Seat 8: laurentzu84 ($31.16 in chips) 
Seat 9: phate-1up ($44.79 in chips) 
kamikkaze: posts small blind $0.10
chiyuki: posts big blind $0.25
*** HOLE CARDS ***
Dealt to chiyuki [3c 2c]
hirozo: folds 
Serge Claws: folds 
hldtom: raises $0.50 to $0.75
masterkoolb: folds 
laurentzu84: folds 
phate-1up: folds 
aSasha280: folds 
kamikkaze: folds 
chiyuki: folds 
Uncalled bet ($0.50) returned to hldtom
hldtom collected $0.60 from pot
hldtom: doesn't show hand 
*** SUMMARY ***
Total pot $0.60 | Rake $0 
Seat 1: aSasha280 (button) folded before Flop (didn't bet)
Seat 2: kamikkaze (small blind) folded before Flop
Seat 3: chiyuki (big blind) folded before Flop
Seat 4: hirozo folded before Flop (didn't bet)
Seat 5: Serge Claws folded before Flop (didn't bet)
Seat 6: hldtom collected ($0.60)
Seat 7: masterkoolb folded before Flop (didn't bet)
Seat 8: laurentzu84 folded before Flop (didn't bet)
Seat 9: phate-1up folded before Flop (didn't bet)



PokerStars Zoom Hand #84300504991:  Hold'em No Limit ($0.10/$0.25) - 2012/08/05 15:32:31 JST [2012/08/05 2:32:31 ET]
Table 'Whirlpool' 9-max Seat #1 is the button
Seat 1: 4plankton ($21.47 in chips) 
Seat 2: turbotom122 ($16.35 in chips) 
Seat 3: masterkoolb ($14.06 in chips) 
Seat 4: Faantomace ($37.31 in chips) 
Seat 5: kamikkaze ($14.80 in chips) 
Seat 6: God)Squall ($28.80 in chips) 
Seat 7: panaam ($28.24 in chips) 
Seat 8: chiyuki ($37.58 in chips) 
Seat 9: ZhukOFFskI ($80.36 in chips) 
turbotom122: posts small blind $0.10
masterkoolb: posts big blind $0.25
*** HOLE CARDS ***
Dealt to chiyuki [Jc Ah]
Faantomace: raises $0.75 to $1
kamikkaze: folds 
God)Squall: folds 
panaam: folds 
chiyuki: folds 
ZhukOFFskI has timed out
ZhukOFFskI: folds 
4plankton: folds 
turbotom122: folds 
masterkoolb: folds 
Uncalled bet ($0.75) returned to Faantomace
Faantomace collected $0.60 from pot
Faantomace: doesn't show hand 
*** SUMMARY ***
Total pot $0.60 | Rake $0 
Seat 1: 4plankton (button) folded before Flop (didn't bet)
Seat 2: turbotom122 (small blind) folded before Flop
Seat 3: masterkoolb (big blind) folded before Flop
Seat 4: Faantomace collected ($0.60)
Seat 5: kamikkaze folded before Flop (didn't bet)
Seat 6: God)Squall folded before Flop (didn't bet)
Seat 7: panaam folded before Flop (didn't bet)
Seat 8: chiyuki folded before Flop (didn't bet)
Seat 9: ZhukOFFskI folded before Flop (didn't bet)



PokerStars Zoom Hand #84300509049:  Hold'em No Limit ($0.10/$0.25) - 2012/08/05 15:32:47 JST [2012/08/05 2:32:47 ET]
Table 'Whirlpool' 9-max Seat #1 is the button
Seat 1: ZhukOFFskI ($21.45 in chips) 
Seat 2: kamikkaze ($14.80 in chips) 
Seat 3: leo2095 ($20 in chips) 
Seat 4: aSasha280 ($15.23 in chips) 
Seat 5: Jene4kaBest ($14.98 in chips) 
Seat 6: chiyuki ($37.58 in chips) 
Seat 7: seula i ($25 in chips) 
Seat 8: 1Karina1 ($36.30 in chips) 
Seat 9: AAAKK777 ($25.51 in chips) 
kamikkaze: posts small blind $0.10
leo2095: posts big blind $0.25
*** HOLE CARDS ***
Dealt to chiyuki [9s Qs]
aSasha280: folds 
Jene4kaBest: folds 
chiyuki: folds 
seula i: raises $0.75 to $1
1Karina1: folds 
AAAKK777: folds 
ZhukOFFskI: folds 
kamikkaze: folds 
leo2095: folds 
Uncalled bet ($0.75) returned to seula i
seula i collected $0.60 from pot
seula i: doesn't show hand 
*** SUMMARY ***
Total pot $0.60 | Rake $0 
Seat 1: ZhukOFFskI (button) folded before Flop (didn't bet)
Seat 2: kamikkaze (small blind) folded before Flop
Seat 3: leo2095 (big blind) folded before Flop
Seat 4: aSasha280 folded before Flop (didn't bet)
Seat 5: Jene4kaBest folded before Flop (didn't bet)
Seat 6: chiyuki folded before Flop (didn't bet)
Seat 7: seula i collected ($0.60)
Seat 8: 1Karina1 folded before Flop (didn't bet)
Seat 9: AAAKK777 folded before Flop (didn't bet)



PokerStars Zoom Hand #84300511781:  Hold'em No Limit ($0.10/$0.25) - 2012/08/05 15:32:58 JST [2012/08/05 2:32:58 ET]
Table 'Whirlpool' 9-max Seat #1 is the button
Seat 1: GovGus ($26.10 in chips) 
Seat 2: chiyuki ($37.58 in chips) 
Seat 3: yane73 ($13.64 in chips) 
Seat 4: INSP!RON ($41.03 in chips) 
Seat 5: Jene4kaBest ($14.98 in chips) 
Seat 6: nice.franki ($13.25 in chips) 
Seat 7: DutchShultzs ($25 in chips) 
Seat 8: GSDP ($41.48 in chips) 
Seat 9: snejokCoxx ($13.75 in chips) 
chiyuki: posts small blind $0.10
yane73: posts big blind $0.25
*** HOLE CARDS ***
Dealt to chiyuki [7c 6d]
INSP!RON: folds 
Jene4kaBest: raises $0.50 to $0.75
nice.franki: folds 
DutchShultzs: folds 
GSDP: folds 
snejokCoxx: folds 
GovGus: folds 
chiyuki: folds 
yane73: calls $0.50
*** FLOP *** [5s Kc 8h]
yane73: checks 
Jene4kaBest: bets $1.07
yane73: folds 
Uncalled bet ($1.07) returned to Jene4kaBest
Jene4kaBest collected $1.53 from pot
Jene4kaBest: doesn't show hand 
*** SUMMARY ***
Total pot $1.60 | Rake $0.07 
Board [5s Kc 8h]
Seat 1: GovGus (button) folded before Flop (didn't bet)
Seat 2: chiyuki (small blind) folded before Flop
Seat 3: yane73 (big blind) folded on the Flop
Seat 4: INSP!RON folded before Flop (didn't bet)
Seat 5: Jene4kaBest collected ($1.53)
Seat 6: nice.franki folded before Flop (didn't bet)
Seat 7: DutchShultzs folded before Flop (didn't bet)
Seat 8: GSDP folded before Flop (didn't bet)
Seat 9: snejokCoxx folded before Flop (didn't bet)



PokerStars Zoom Hand #84300512801:  Hold'em No Limit ($0.10/$0.25) - 2012/08/05 15:33:03 JST [2012/08/05 2:33:03 ET]
Table 'Whirlpool' 9-max Seat #1 is the button
Seat 1: DutchShultzs ($25 in chips) 
Seat 2: INSP!RON ($41.03 in chips) 
Seat 3: Serge Claws ($26.10 in chips) 
Seat 4: dergeb ($10.50 in chips) 
Seat 5: chiyuki ($37.48 in chips) 
Seat 6: 1Karina1 ($25 in chips) 
Seat 7: aSasha280 ($15.13 in chips) 
Seat 8: moku36 ($39.65 in chips) 
Seat 9: River_GmbH ($14.90 in chips) 
INSP!RON: posts small blind $0.10
Serge Claws: posts big blind $0.25
*** HOLE CARDS ***
Dealt to chiyuki [As Ks]
dergeb: raises $0.50 to $0.75
chiyuki: raises $1.50 to $2.25
1Karina1: folds 
aSasha280: folds 
moku36: folds 
River_GmbH: folds 
DutchShultzs: folds 
INSP!RON: folds 
Serge Claws: folds 
dergeb: folds 
Uncalled bet ($1.50) returned to chiyuki
chiyuki collected $1.85 from pot
chiyuki: doesn't show hand 
*** SUMMARY ***
Total pot $1.85 | Rake $0 
Seat 1: DutchShultzs (button) folded before Flop (didn't bet)
Seat 2: INSP!RON (small blind) folded before Flop
Seat 3: Serge Claws (big blind) folded before Flop
Seat 4: dergeb folded before Flop
Seat 5: chiyuki collected ($1.85)
Seat 6: 1Karina1 folded before Flop (didn't bet)
Seat 7: aSasha280 folded before Flop (didn't bet)
Seat 8: moku36 folded before Flop (didn't bet)
Seat 9: River_GmbH folded before Flop (didn't bet)



PokerStars Zoom Hand #84300509808:  Hold'em No Limit ($0.10/$0.25) - 2012/08/05 15:32:50 JST [2012/08/05 2:32:50 ET]
Table 'Whirlpool' 9-max Seat #1 is the button
Seat 1: masterkoolb ($13.71 in chips) 
Seat 2: silvno31 ($44.17 in chips) 
Seat 3: phate-1up ($31.05 in chips) 
Seat 4: laurentzu84 ($30.91 in chips) 
Seat 5: chiyuki ($37.58 in chips) 
Seat 6: hldtom ($26.37 in chips) 
Seat 7: mjmichi ($54.12 in chips) 
Seat 8: KimPa39 ($26.73 in chips) 
Seat 9: Wilcox76607 ($13.19 in chips) 
silvno31: posts small blind $0.10
phate-1up: posts big blind $0.25
*** HOLE CARDS ***
Dealt to chiyuki [Ks Ts]
laurentzu84: folds 
chiyuki: folds 
hldtom: folds 
mjmichi: folds 
KimPa39: folds 
Wilcox76607: folds 
masterkoolb: raises $0.60 to $0.85
silvno31: calls $0.75
phate-1up: raises $2.40 to $3.25
masterkoolb: raises $7.35 to $10.60
silvno31: folds 
phate-1up: raises $7.35 to $17.95
masterkoolb: calls $3.11 and is all-in
Uncalled bet ($4.24) returned to phate-1up
*** FLOP *** [2h Jh 6c]
*** TURN *** [2h Jh 6c] [3d]
*** RIVER *** [2h Jh 6c 3d] [3c]
*** SHOW DOWN ***
phate-1up: shows [As Ah] (two pair, Aces and Threes)
masterkoolb: mucks hand 
phate-1up collected $27 from pot
*** SUMMARY ***
Total pot $28.27 | Rake $1.27 
Board [2h Jh 6c 3d 3c]
Seat 1: masterkoolb (button) mucked [Ac Kc]
Seat 2: silvno31 (small blind) folded before Flop
Seat 3: phate-1up (big blind) showed [As Ah] and won ($27) with two pair, Aces and Threes
Seat 4: laurentzu84 folded before Flop (didn't bet)
Seat 5: chiyuki folded before Flop (didn't bet)
Seat 6: hldtom folded before Flop (didn't bet)
Seat 7: mjmichi folded before Flop (didn't bet)
Seat 8: KimPa39 folded before Flop (didn't bet)
Seat 9: Wilcox76607 folded before Flop (didn't bet)



PokerStars Zoom Hand #84300510534:  Hold'em No Limit ($0.10/$0.25) - 2012/08/05 15:32:53 JST [2012/08/05 2:32:53 ET]
Table 'Whirlpool' 9-max Seat #1 is the button
Seat 1: deadmoneykid ($30.07 in chips) 
Seat 2: mr. joker-kz ($24.75 in chips) 
Seat 3: tribunpdm ($37.34 in chips) 
Seat 4: Gichboy ($14.53 in chips) 
Seat 5: Perstenev ($7.37 in chips) 
Seat 6: yane73 ($13.64 in chips) 
Seat 7: chiyuki ($37.58 in chips) 
Seat 8: seula i ($25.29 in chips) 
Seat 9: jacquelinewu ($25 in chips) 
mr. joker-kz: posts small blind $0.10
tribunpdm: posts big blind $0.25
*** HOLE CARDS ***
Dealt to chiyuki [Qd 2h]
Gichboy: folds 
Perstenev: folds 
yane73: folds 
chiyuki: folds 
seula i: folds 
jacquelinewu: raises $0.50 to $0.75
deadmoneykid: folds 
mr. joker-kz: folds 
tribunpdm: calls $0.50
*** FLOP *** [3c 4s Td]
tribunpdm: checks 
jacquelinewu: bets $1.07
tribunpdm: calls $1.07
*** TURN *** [3c 4s Td] [3s]
tribunpdm: checks 
jacquelinewu: checks 
*** RIVER *** [3c 4s Td 3s] [9d]
tribunpdm: bets $3
jacquelinewu: folds 
Uncalled bet ($3) returned to tribunpdm
tribunpdm collected $3.57 from pot
tribunpdm: doesn't show hand 
*** SUMMARY ***
Total pot $3.74 | Rake $0.17 
Board [3c 4s Td 3s 9d]
Seat 1: deadmoneykid (button) folded before Flop (didn't bet)
Seat 2: mr. joker-kz (small blind) folded before Flop
Seat 3: tribunpdm (big blind) collected ($3.57)
Seat 4: Gichboy folded before Flop (didn't bet)
Seat 5: Perstenev folded before Flop (didn't bet)
Seat 6: yane73 folded before Flop (didn't bet)
Seat 7: chiyuki folded before Flop (didn't bet)
Seat 8: seula i folded before Flop (didn't bet)
Seat 9: jacquelinewu folded on the River



PokerStars Zoom Hand #84300521103:  Hold'em No Limit ($0.10/$0.25) - 2012/08/05 15:33:35 JST [2012/08/05 2:33:35 ET]
Table 'Whirlpool' 9-max Seat #1 is the button
Seat 1: Serge Claws ($25.75 in chips) 
Seat 2: NuMetal88 ($30.25 in chips) 
Seat 3: jacquelinewu ($25 in chips) 
Seat 4: Perstenev ($12.34 in chips) 
Seat 5: chiyuki ($38.58 in chips) 
Seat 6: turbotom122 ($15.99 in chips) 
Seat 7: Nerkit ($13.66 in chips) 
Seat 8: yvasilik ($27.49 in chips) 
Seat 9: nice.franki ($11.10 in chips) 
NuMetal88: posts small blind $0.10
jacquelinewu: posts big blind $0.25
*** HOLE CARDS ***
Dealt to chiyuki [3c 7s]
Perstenev: folds 
chiyuki: folds 
turbotom122: folds 
Nerkit: folds 
yvasilik: folds 
nice.franki: folds 
Serge Claws: folds 
NuMetal88: folds 
Uncalled bet ($0.15) returned to jacquelinewu
jacquelinewu collected $0.20 from pot
jacquelinewu: doesn't show hand 
*** SUMMARY ***
Total pot $0.20 | Rake $0 
Seat 1: Serge Claws (button) folded before Flop (didn't bet)
Seat 2: NuMetal88 (small blind) folded before Flop
Seat 3: jacquelinewu (big blind) collected ($0.20)
Seat 4: Perstenev folded before Flop (didn't bet)
Seat 5: chiyuki folded before Flop (didn't bet)
Seat 6: turbotom122 folded before Flop (didn't bet)
Seat 7: Nerkit folded before Flop (didn't bet)
Seat 8: yvasilik folded before Flop (didn't bet)
Seat 9: nice.franki folded before Flop (didn't bet)



PokerStars Zoom Hand #84300518475:  Hold'em No Limit ($0.10/$0.25) - 2012/08/05 15:33:25 JST [2012/08/05 2:33:25 ET]
Table 'Whirlpool' 9-max Seat #1 is the button
Seat 1: chiyuki ($38.58 in chips) 
Seat 2: Dejacob ($25.85 in chips) 
Seat 3: Fructionar ($25 in chips) 
Seat 4: fima00000007 ($8.54 in chips) 
Seat 5: God)Squall ($29.38 in chips) 
Seat 6: nice.franki ($13.25 in chips) 
Seat 7: mr. joker-kz ($24.65 in chips) 
Seat 8: deadmoneykid ($40.95 in chips) 
Seat 9: dodgersfan17 ($25 in chips) 
Dejacob: posts small blind $0.10
Fructionar: posts big blind $0.25
*** HOLE CARDS ***
Dealt to chiyuki [9s 5s]
fima00000007: folds 
God)Squall: folds 
nice.franki: folds 
mr. joker-kz: folds 
deadmoneykid: folds 
dodgersfan17: calls $0.25
chiyuki: folds 
Dejacob: folds 
Fructionar: checks 
*** FLOP *** [Jc Kc 2c]
Fructionar: bets $0.25
dodgersfan17: calls $0.25
*** TURN *** [Jc Kc 2c] [Kd]
Fructionar: bets $0.78
dodgersfan17: folds 
Uncalled bet ($0.78) returned to Fructionar
Fructionar collected $1.05 from pot
Fructionar: doesn't show hand 
*** SUMMARY ***
Total pot $1.10 | Rake $0.05 
Board [Jc Kc 2c Kd]
Seat 1: chiyuki (button) folded before Flop (didn't bet)
Seat 2: Dejacob (small blind) folded before Flop
Seat 3: Fructionar (big blind) collected ($1.05)
Seat 4: fima00000007 folded before Flop (didn't bet)
Seat 5: God)Squall folded before Flop (didn't bet)
Seat 6: nice.franki folded before Flop (didn't bet)
Seat 7: mr. joker-kz folded before Flop (didn't bet)
Seat 8: deadmoneykid folded before Flop (didn't bet)
Seat 9: dodgersfan17 folded on the Turn



PokerStars Zoom Hand #84300523161:  Hold'em No Limit ($0.10/$0.25) - 2012/08/05 15:33:43 JST [2012/08/05 2:33:43 ET]
Table 'Whirlpool' 9-max Seat #1 is the button
Seat 1: Grishukps ($12.50 in chips) 
Seat 2: Tom1999 ($20.91 in chips) 
Seat 3: chiyuki ($38.58 in chips) 
Seat 4: turbotom122 ($15.99 in chips) 
Seat 5: opie62 ($29.40 in chips) 
Seat 6: tribunpdm ($39.09 in chips) 
Seat 7: nice.franki ($11.10 in chips) 
Seat 8: kwkim73 ($25.44 in chips) 
Seat 9: nastya040 ($17.31 in chips) 
Tom1999: posts small blind $0.10
chiyuki: posts big blind $0.25
*** HOLE CARDS ***
Dealt to chiyuki [3s 4d]
turbotom122: folds 
opie62: folds 
tribunpdm: folds 
nice.franki: folds 
kwkim73: raises $0.50 to $0.75
nastya040: folds 
Grishukps: folds 
Tom1999: folds 
chiyuki: folds 
Uncalled bet ($0.50) returned to kwkim73
kwkim73 collected $0.60 from pot
kwkim73: doesn't show hand 
*** SUMMARY ***
Total pot $0.60 | Rake $0 
Seat 1: Grishukps (button) folded before Flop (didn't bet)
Seat 2: Tom1999 (small blind) folded before Flop
Seat 3: chiyuki (big blind) folded before Flop
Seat 4: turbotom122 folded before Flop (didn't bet)
Seat 5: opie62 folded before Flop (didn't bet)
Seat 6: tribunpdm folded before Flop (didn't bet)
Seat 7: nice.franki folded before Flop (didn't bet)
Seat 8: kwkim73 collected ($0.60)
Seat 9: nastya040 folded before Flop (didn't bet)



PokerStars Zoom Hand #84300522405:  Hold'em No Limit ($0.10/$0.25) - 2012/08/05 15:33:40 JST [2012/08/05 2:33:40 ET]
Table 'Whirlpool' 9-max Seat #1 is the button
Seat 1: ZhukOFFskI ($35.18 in chips) 
Seat 2: Perstenev ($12.34 in chips) 
Seat 3: NuMetal88 ($30.15 in chips) 
Seat 4: God)Squall ($29.38 in chips) 
Seat 5: 1Karina1 ($36.30 in chips) 
Seat 6: hirozo ($88.91 in chips) 
Seat 7: WARIBANA7777 ($16.23 in chips) 
Seat 8: banderas761 ($22.19 in chips) 
Seat 9: chiyuki ($38.58 in chips) 
Perstenev: posts small blind $0.10
NuMetal88: posts big blind $0.25
*** HOLE CARDS ***
Dealt to chiyuki [3h Ts]
God)Squall: folds 
1Karina1: folds 
hirozo: raises $0.50 to $0.75
WARIBANA7777: folds 
banderas761: folds 
chiyuki: folds 
ZhukOFFskI: folds 
Perstenev: calls $0.65
NuMetal88: folds 
*** FLOP *** [Qc Ad 8d]
Perstenev: checks 
hirozo: bets $1.11
Perstenev: folds 
Uncalled bet ($1.11) returned to hirozo
hirozo collected $1.67 from pot
hirozo: doesn't show hand 
*** SUMMARY ***
Total pot $1.75 | Rake $0.08 
Board [Qc Ad 8d]
Seat 1: ZhukOFFskI (button) folded before Flop (didn't bet)
Seat 2: Perstenev (small blind) folded on the Flop
Seat 3: NuMetal88 (big blind) folded before Flop
Seat 4: God)Squall folded before Flop (didn't bet)
Seat 5: 1Karina1 folded before Flop (didn't bet)
Seat 6: hirozo collected ($1.67)
Seat 7: WARIBANA7777 folded before Flop (didn't bet)
Seat 8: banderas761 folded before Flop (didn't bet)
Seat 9: chiyuki folded before Flop (didn't bet)



PokerStars Zoom Hand #84300529513:  Hold'em No Limit ($0.10/$0.25) - 2012/08/05 15:34:08 JST [2012/08/05 2:34:08 ET]
Table 'Whirlpool' 9-max Seat #1 is the button
Seat 1: HighDuka ($39.93 in chips) 
Seat 2: kwkim73 ($43.99 in chips) 
Seat 3: hirozo ($43.33 in chips) 
Seat 4: DutchShultzs ($26.38 in chips) 
Seat 5: KeLevro0 ($11.47 in chips) 
Seat 6: mjmichi ($41.34 in chips) 
Seat 7: Grishukps ($12.50 in chips) 
Seat 8: chiyuki ($38.33 in chips) 
Seat 9: ViTiV2010 ($12.15 in chips) 
kwkim73: posts small blind $0.10
hirozo: posts big blind $0.25
*** HOLE CARDS ***
Dealt to chiyuki [8s 5s]
DutchShultzs: folds 
KeLevro0: raises $0.42 to $0.67
mjmichi: folds 
Grishukps: folds 
chiyuki: folds 
ViTiV2010: folds 
HighDuka: folds 
kwkim73: folds 
hirozo: folds 
Uncalled bet ($0.42) returned to KeLevro0
KeLevro0 collected $0.60 from pot
KeLevro0: doesn't show hand 
*** SUMMARY ***
Total pot $0.60 | Rake $0 
Seat 1: HighDuka (button) folded before Flop (didn't bet)
Seat 2: kwkim73 (small blind) folded before Flop
Seat 3: hirozo (big blind) folded before Flop
Seat 4: DutchShultzs folded before Flop (didn't bet)
Seat 5: KeLevro0 collected ($0.60)
Seat 6: mjmichi folded before Flop (didn't bet)
Seat 7: Grishukps folded before Flop (didn't bet)
Seat 8: chiyuki folded before Flop (didn't bet)
Seat 9: ViTiV2010 folded before Flop (didn't bet)



PokerStars Zoom Hand #84300537143:  Hold'em No Limit ($0.10/$0.25) - 2012/08/05 15:34:39 JST [2012/08/05 2:34:39 ET]
Table 'Whirlpool' 9-max Seat #1 is the button
Seat 1: chiyuki ($38.23 in chips) 
Seat 2: GovGus ($39.30 in chips) 
Seat 3: Silveystryk ($20.72 in chips) 
Seat 4: masterkoolb ($13.52 in chips) 
Seat 5: svg51 ($4.32 in chips) 
Seat 6: kamikkaze ($16.15 in chips) 
Seat 7: panaam ($28.09 in chips) 
Seat 8: hldtom ($25 in chips) 
Seat 9: NuMetal88 ($25 in chips) 
GovGus: posts small blind $0.10
Silveystryk: posts big blind $0.25
*** HOLE CARDS ***
Dealt to chiyuki [Kh Kd]
masterkoolb: folds 
svg51: folds 
kamikkaze: folds 
panaam: folds 
hldtom: folds 
NuMetal88: folds 
chiyuki: raises $0.50 to $0.75
GovGus: folds 
Silveystryk: folds 
Uncalled bet ($0.50) returned to chiyuki
chiyuki collected $0.60 from pot
chiyuki: doesn't show hand 
*** SUMMARY ***
Total pot $0.60 | Rake $0 
Seat 1: chiyuki (button) collected ($0.60)
Seat 2: GovGus (small blind) folded before Flop
Seat 3: Silveystryk (big blind) folded before Flop
Seat 4: masterkoolb folded before Flop (didn't bet)
Seat 5: svg51 folded before Flop (didn't bet)
Seat 6: kamikkaze folded before Flop (didn't bet)
Seat 7: panaam folded before Flop (didn't bet)
Seat 8: hldtom folded before Flop (didn't bet)
Seat 9: NuMetal88 folded before Flop (didn't bet)



PokerStars Zoom Hand #84300532775:  Hold'em No Limit ($0.10/$0.25) - 2012/08/05 15:34:22 JST [2012/08/05 2:34:22 ET]
Table 'Whirlpool' 9-max Seat #1 is the button
Seat 1: PPP7SSS ($25.27 in chips) 
Seat 2: chiyuki ($38.33 in chips) 
Seat 3: NuMetal88 ($25.35 in chips) 
Seat 4: jacquelinewu ($71.27 in chips) 
Seat 5: kamikkaze ($12.51 in chips) 
Seat 6: KrystalAA ($22.18 in chips) 
Seat 7: Spheroff ($24.12 in chips) 
Seat 8: HighDuka ($39.93 in chips) 
Seat 9: snejokCoxx ($13.40 in chips) 
chiyuki: posts small blind $0.10
NuMetal88: posts big blind $0.25
*** HOLE CARDS ***
Dealt to chiyuki [6s Kc]
jacquelinewu: raises $0.50 to $0.75
kamikkaze: folds 
KrystalAA: folds 
Spheroff: folds 
HighDuka: folds 
snejokCoxx: folds 
PPP7SSS: calls $0.75
chiyuki: folds 
NuMetal88: folds 
*** FLOP *** [2d 7s Js]
jacquelinewu: checks 
PPP7SSS: bets $0.50
jacquelinewu: calls $0.50
*** TURN *** [2d 7s Js] [Qh]
jacquelinewu: checks 
PPP7SSS: checks 
*** RIVER *** [2d 7s Js Qh] [Jh]
jacquelinewu: checks 
PPP7SSS: checks 
*** SHOW DOWN ***
jacquelinewu: shows [Td Ts] (two pair, Jacks and Tens)
PPP7SSS: mucks hand 
jacquelinewu collected $2.72 from pot
*** SUMMARY ***
Total pot $2.85 | Rake $0.13 
Board [2d 7s Js Qh Jh]
Seat 1: PPP7SSS (button) mucked [Ah Tc]
Seat 2: chiyuki (small blind) folded before Flop
Seat 3: NuMetal88 (big blind) folded before Flop
Seat 4: jacquelinewu showed [Td Ts] and won ($2.72) with two pair, Jacks and Tens
Seat 5: kamikkaze folded before Flop (didn't bet)
Seat 6: KrystalAA folded before Flop (didn't bet)
Seat 7: Spheroff folded before Flop (didn't bet)
Seat 8: HighDuka folded before Flop (didn't bet)
Seat 9: snejokCoxx folded before Flop (didn't bet)



PokerStars Zoom Hand #84300530994:  Hold'em No Limit ($0.10/$0.25) - 2012/08/05 15:34:15 JST [2012/08/05 2:34:15 ET]
Table 'Whirlpool' 9-max Seat #1 is the button
Seat 1: ShaninPeter ($14.75 in chips) 
Seat 2: dodgersfan17 ($24.60 in chips) 
Seat 3: Jene4kaBest ($17 in chips) 
Seat 4: turbotom122 ($16.31 in chips) 
Seat 5: snejokCoxx ($10.30 in chips) 
Seat 6: chiyuki ($38.33 in chips) 
Seat 7: Gichboy ($25.29 in chips) 
Seat 8: aivvo ($14.47 in chips) 
Seat 9: NuMetal88 ($29.90 in chips) 
dodgersfan17: posts small blind $0.10
Jene4kaBest: posts big blind $0.25
*** HOLE CARDS ***
Dealt to chiyuki [Jd 3d]
turbotom122: folds 
snejokCoxx: folds 
chiyuki: folds 
Gichboy: raises $0.25 to $0.50
aivvo: folds 
NuMetal88: folds 
ShaninPeter: folds 
dodgersfan17: calls $0.40
Jene4kaBest: calls $0.25
*** FLOP *** [6s 5c 2c]
dodgersfan17: checks 
Jene4kaBest: checks 
Gichboy: checks 
*** TURN *** [6s 5c 2c] [8s]
dodgersfan17: checks 
Jene4kaBest: bets $0.50
Gichboy: calls $0.50
dodgersfan17: folds 
*** RIVER *** [6s 5c 2c 8s] [Js]
Jene4kaBest: bets $1.67
Gichboy: raises $2.58 to $4.25
Jene4kaBest: calls $2.58
*** SHOW DOWN ***
Gichboy: shows [Ks Ts] (a flush, King high)
Jene4kaBest: mucks hand 
Gichboy collected $10.50 from pot
*** SUMMARY ***
Total pot $11 | Rake $0.50 
Board [6s 5c 2c 8s Js]
Seat 1: ShaninPeter (button) folded before Flop (didn't bet)
Seat 2: dodgersfan17 (small blind) folded on the Turn
Seat 3: Jene4kaBest (big blind) mucked [2s 3s]
Seat 4: turbotom122 folded before Flop (didn't bet)
Seat 5: snejokCoxx folded before Flop (didn't bet)
Seat 6: chiyuki folded before Flop (didn't bet)
Seat 7: Gichboy showed [Ks Ts] and won ($10.50) with a flush, King high
Seat 8: aivvo folded before Flop (didn't bet)
Seat 9: NuMetal88 folded before Flop (didn't bet)



PokerStars Zoom Hand #84300542835:  Hold'em No Limit ($0.10/$0.25) - 2012/08/05 15:35:02 JST [2012/08/05 2:35:02 ET]
Table 'Whirlpool' 9-max Seat #1 is the button
Seat 1: fima00000007 ($8.54 in chips) 
Seat 2: INSP!RON ($49.46 in chips) 
Seat 3: chiyuki ($38.58 in chips) 
Seat 4: Perstenev ($11.34 in chips) 
Seat 5: Ellen1947 ($22.68 in chips) 
Seat 6: River_GmbH ($14.55 in chips) 
Seat 7: KrystalAA ($35.83 in chips) 
Seat 8: Rilko1975 ($33.11 in chips) 
Seat 9: PPP7SSS ($24.02 in chips) 
INSP!RON: posts small blind $0.10
chiyuki: posts big blind $0.25
*** HOLE CARDS ***
Dealt to chiyuki [8c As]
Perstenev: folds 
Ellen1947: folds 
River_GmbH: folds 
KrystalAA: folds 
Rilko1975: folds 
PPP7SSS: folds 
fima00000007: folds 
INSP!RON: raises $0.50 to $0.75
chiyuki: folds 
Uncalled bet ($0.50) returned to INSP!RON
INSP!RON collected $0.50 from pot
INSP!RON: doesn't show hand 
*** SUMMARY ***
Total pot $0.50 | Rake $0 
Seat 1: fima00000007 (button) folded before Flop (didn't bet)
Seat 2: INSP!RON (small blind) collected ($0.50)
Seat 3: chiyuki (big blind) folded before Flop
Seat 4: Perstenev folded before Flop (didn't bet)
Seat 5: Ellen1947 folded before Flop (didn't bet)
Seat 6: River_GmbH folded before Flop (didn't bet)
Seat 7: KrystalAA folded before Flop (didn't bet)
Seat 8: Rilko1975 folded before Flop (didn't bet)
Seat 9: PPP7SSS folded before Flop (didn't bet)



PokerStars Zoom Hand #84300546937:  Hold'em No Limit ($0.10/$0.25) - 2012/08/05 15:35:18 JST [2012/08/05 2:35:18 ET]
Table 'Whirlpool' 9-max Seat #1 is the button
Seat 1: Jene4kaBest ($11.65 in chips) 
Seat 2: 1Karina1 ($26.69 in chips) 
Seat 3: kamikkaze ($11.53 in chips) 
Seat 4: chiyuki ($38.33 in chips) 
Seat 5: phate-1up ($47.98 in chips) 
Seat 6: Roglus ($12.64 in chips) 
Seat 7: svg51 ($3.97 in chips) 
Seat 8: Nerkit ($13.66 in chips) 
Seat 9: KeLevro0 ($9.99 in chips) 
1Karina1: posts small blind $0.10
kamikkaze: posts big blind $0.25
*** HOLE CARDS ***
Dealt to chiyuki [Jd As]
chiyuki: folds 
phate-1up: folds 
Roglus: folds 
svg51: folds 
Nerkit: folds 
KeLevro0: folds 
Jene4kaBest: folds 
1Karina1: folds 
Uncalled bet ($0.15) returned to kamikkaze
kamikkaze collected $0.20 from pot
kamikkaze: doesn't show hand 
*** SUMMARY ***
Total pot $0.20 | Rake $0 
Seat 1: Jene4kaBest (button) folded before Flop (didn't bet)
Seat 2: 1Karina1 (small blind) folded before Flop
Seat 3: kamikkaze (big blind) collected ($0.20)
Seat 4: chiyuki folded before Flop (didn't bet)
Seat 5: phate-1up folded before Flop (didn't bet)
Seat 6: Roglus folded before Flop (didn't bet)
Seat 7: svg51 folded before Flop (didn't bet)
Seat 8: Nerkit folded before Flop (didn't bet)
Seat 9: KeLevro0 folded before Flop (didn't bet)



PokerStars Zoom Hand #84300531767:  Hold'em No Limit ($0.10/$0.25) - 2012/08/05 15:34:18 JST [2012/08/05 2:34:18 ET]
Table 'Whirlpool' 9-max Seat #1 is the button
Seat 1: phate-1up ($73.96 in chips) 
Seat 2: INSP!RON ($42.27 in chips) 
Seat 3: DutchShultzs ($25 in chips) 
Seat 4: mjmichi ($41.34 in chips) 
Seat 5: Serge Claws ($25.40 in chips) 
Seat 6: kamikkaze ($12.51 in chips) 
Seat 7: chiyuki ($38.33 in chips) 
Seat 8: Grishukps ($12.50 in chips) 
Seat 9: hirozo ($43.08 in chips) 
INSP!RON: posts small blind $0.10
DutchShultzs: posts big blind $0.25
*** HOLE CARDS ***
Dealt to chiyuki [6d Ks]
mjmichi: folds 
Serge Claws: folds 
kamikkaze: folds 
chiyuki: folds 
Grishukps: raises $0.50 to $0.75
hirozo: folds 
phate-1up: folds 
INSP!RON: folds 
DutchShultzs: calls $0.50
*** FLOP *** [4d 2h 3d]
DutchShultzs: checks 
Grishukps: bets $1
DutchShultzs: folds 
Uncalled bet ($1) returned to Grishukps
Grishukps collected $1.53 from pot
Grishukps: doesn't show hand 
*** SUMMARY ***
Total pot $1.60 | Rake $0.07 
Board [4d 2h 3d]
Seat 1: phate-1up (button) folded before Flop (didn't bet)
Seat 2: INSP!RON (small blind) folded before Flop
Seat 3: DutchShultzs (big blind) folded on the Flop
Seat 4: mjmichi folded before Flop (didn't bet)
Seat 5: Serge Claws folded before Flop (didn't bet)
Seat 6: kamikkaze folded before Flop (didn't bet)
Seat 7: chiyuki folded before Flop (didn't bet)
Seat 8: Grishukps collected ($1.53)
Seat 9: hirozo folded before Flop (didn't bet)



PokerStars Zoom Hand #84300541781:  Hold'em No Limit ($0.10/$0.25) - 2012/08/05 15:34:58 JST [2012/08/05 2:34:58 ET]
Table 'Whirlpool' 9-max Seat #1 is the button
Seat 1: snejokCoxx ($11.65 in chips) 
Seat 2: phate-1up ($60.98 in chips) 
Seat 3: masterkoolb ($13.52 in chips) 
Seat 4: NuMetal88 ($29.55 in chips) 
Seat 5: 1Karina1 ($26.69 in chips) 
Seat 6: chiyuki ($38.58 in chips) 
Seat 7: Rilko1975 ($33.11 in chips) 
Seat 8: ZhukOFFskI ($35.28 in chips) 
Seat 9: Serge Claws ($26.10 in chips) 
phate-1up: posts small blind $0.10
masterkoolb: posts big blind $0.25
*** HOLE CARDS ***
Dealt to chiyuki [6c 4h]
NuMetal88: folds 
1Karina1: folds 
chiyuki: folds 
Rilko1975: folds 
ZhukOFFskI: folds 
Serge Claws: folds 
snejokCoxx: raises $0.40 to $0.65
phate-1up: folds 
masterkoolb: calls $0.40
*** FLOP *** [Ts 2d 8h]
masterkoolb: checks 
snejokCoxx: bets $0.82
masterkoolb: folds 
Uncalled bet ($0.82) returned to snejokCoxx
snejokCoxx collected $1.34 from pot
snejokCoxx: doesn't show hand 
*** SUMMARY ***
Total pot $1.40 | Rake $0.06 
Board [Ts 2d 8h]
Seat 1: snejokCoxx (button) collected ($1.34)
Seat 2: phate-1up (small blind) folded before Flop
Seat 3: masterkoolb (big blind) folded on the Flop
Seat 4: NuMetal88 folded before Flop (didn't bet)
Seat 5: 1Karina1 folded before Flop (didn't bet)
Seat 6: chiyuki folded before Flop (didn't bet)
Seat 7: Rilko1975 folded before Flop (didn't bet)
Seat 8: ZhukOFFskI folded before Flop (didn't bet)
Seat 9: Serge Claws folded before Flop (didn't bet)



PokerStars Zoom Hand #84300536144:  Hold'em No Limit ($0.10/$0.25) - 2012/08/05 15:34:35 JST [2012/08/05 2:34:35 ET]
Table 'Whirlpool' 9-max Seat #1 is the button
Seat 1: seula i ($25 in chips) 
Seat 2: snejokCoxx ($10.30 in chips) 
Seat 3: HighDuka ($39.93 in chips) 
Seat 4: GovGus ($39.30 in chips) 
Seat 5: Silveystryk ($20.72 in chips) 
Seat 6: phate-1up ($60.98 in chips) 
Seat 7: River_GmbH ($14.55 in chips) 
Seat 8: panaam ($28.09 in chips) 
Seat 9: chiyuki ($38.23 in chips) 
snejokCoxx: posts small blind $0.10
HighDuka: posts big blind $0.25
*** HOLE CARDS ***
Dealt to chiyuki [9c 2d]
GovGus: folds 
Silveystryk: folds 
phate-1up: folds 
River_GmbH: folds 
panaam: folds 
chiyuki: folds 
seula i: folds 
snejokCoxx: raises $0.45 to $0.70
HighDuka: calls $0.45
*** FLOP *** [Ks 7c Qd]
snejokCoxx: checks 
HighDuka: checks 
*** TURN *** [Ks 7c Qd] [Kd]
snejokCoxx: checks 
HighDuka: bets $0.25
snejokCoxx: calls $0.25
*** RIVER *** [Ks 7c Qd Kd] [Jc]
snejokCoxx: bets $1.14
HighDuka: folds 
Uncalled bet ($1.14) returned to snejokCoxx
snejokCoxx collected $1.81 from pot
snejokCoxx: doesn't show hand 
*** SUMMARY ***
Total pot $1.90 | Rake $0.09 
Board [Ks 7c Qd Kd Jc]
Seat 1: seula i (button) folded before Flop (didn't bet)
Seat 2: snejokCoxx (small blind) collected ($1.81)
Seat 3: HighDuka (big blind) folded on the River
Seat 4: GovGus folded before Flop (didn't bet)
Seat 5: Silveystryk folded before Flop (didn't bet)
Seat 6: phate-1up folded before Flop (didn't bet)
Seat 7: River_GmbH folded before Flop (didn't bet)
Seat 8: panaam folded before Flop (didn't bet)
Seat 9: chiyuki folded before Flop (didn't bet)



PokerStars Zoom Hand #84300553020:  Hold'em No Limit ($0.10/$0.25) - 2012/08/05 15:35:43 JST [2012/08/05 2:35:43 ET]
Table 'Whirlpool' 9-max Seat #1 is the button
Seat 1: NuMetal88 ($25 in chips) 
Seat 2: chiyuki ($38.33 in chips) 
Seat 3: 1Karina1 ($35.95 in chips) 
Seat 4: Serge Claws ($41.26 in chips) 
Seat 5: Vahe50 ($14.22 in chips) 
Seat 6: ziggzagg77 ($28.18 in chips) 
Seat 7: ZhukOFFskI ($20.72 in chips) 
Seat 8: Grishukps ($12.50 in chips) 
Seat 9: mjmichi ($57.47 in chips) 
chiyuki: posts small blind $0.10
1Karina1: posts big blind $0.25
*** HOLE CARDS ***
Dealt to chiyuki [Td Jc]
Serge Claws: raises $0.50 to $0.75
Vahe50: folds 
ziggzagg77: folds 
ZhukOFFskI: folds 
Grishukps: folds 
mjmichi has timed out
mjmichi: folds 
NuMetal88: folds 
chiyuki: folds 
1Karina1: folds 
Uncalled bet ($0.50) returned to Serge Claws
Serge Claws collected $0.60 from pot
Serge Claws: doesn't show hand 
*** SUMMARY ***
Total pot $0.60 | Rake $0 
Seat 1: NuMetal88 (button) folded before Flop (didn't bet)
Seat 2: chiyuki (small blind) folded before Flop
Seat 3: 1Karina1 (big blind) folded before Flop
Seat 4: Serge Claws collected ($0.60)
Seat 5: Vahe50 folded before Flop (didn't bet)
Seat 6: ziggzagg77 folded before Flop (didn't bet)
Seat 7: ZhukOFFskI folded before Flop (didn't bet)
Seat 8: Grishukps folded before Flop (didn't bet)
Seat 9: mjmichi folded before Flop (didn't bet)



PokerStars Zoom Hand #84300548708:  Hold'em No Limit ($0.10/$0.25) - 2012/08/05 15:35:25 JST [2012/08/05 2:35:25 ET]
Table 'Whirlpool' 9-max Seat #1 is the button
Seat 1: phate-1up ($45.78 in chips) 
Seat 2: Roglus ($12.64 in chips) 
Seat 3: aivvo ($14.12 in chips) 
Seat 4: jacquelinewu ($35.28 in chips) 
Seat 5: svg51 ($3.97 in chips) 
Seat 6: nice.franki ($11.45 in chips) 
Seat 7: AntoineHunt ($38.13 in chips) 
Seat 8: chiyuki ($38.33 in chips) 
Seat 9: NENE54 ($12.30 in chips) 
Roglus: posts small blind $0.10
aivvo: posts big blind $0.25
*** HOLE CARDS ***
Dealt to chiyuki [6c 3h]
jacquelinewu: folds 
svg51: folds 
nice.franki: folds 
AntoineHunt: raises $0.25 to $0.50
chiyuki: folds 
NENE54: folds 
phate-1up: folds 
Roglus: calls $0.40
aivvo: calls $0.25
*** FLOP *** [4c 7s Qs]
Roglus: checks 
aivvo: bets $0.50
AntoineHunt: raises $0.75 to $1.25
Roglus: calls $1.25
aivvo: calls $0.75
*** TURN *** [4c 7s Qs] [5c]
Roglus: checks 
aivvo: bets $0.25
AntoineHunt: raises $0.75 to $1
Roglus: calls $1
aivvo: calls $0.75
*** RIVER *** [4c 7s Qs 5c] [Td]
Roglus: checks 
aivvo: checks 
AntoineHunt: bets $1.25
Roglus: calls $1.25
aivvo: calls $1.25
*** SHOW DOWN ***
AntoineHunt: shows [Kh Qc] (a pair of Queens)
Roglus: shows [Tc Qd] (two pair, Queens and Tens)
aivvo: mucks hand 
Roglus collected $11.46 from pot
*** SUMMARY ***
Total pot $12 | Rake $0.54 
Board [4c 7s Qs 5c Td]
Seat 1: phate-1up (button) folded before Flop (didn't bet)
Seat 2: Roglus (small blind) showed [Tc Qd] and won ($11.46) with two pair, Queens and Tens
Seat 3: aivvo (big blind) mucked [Qh Kd]
Seat 4: jacquelinewu folded before Flop (didn't bet)
Seat 5: svg51 folded before Flop (didn't bet)
Seat 6: nice.franki folded before Flop (didn't bet)
Seat 7: AntoineHunt showed [Kh Qc] and lost with a pair of Queens
Seat 8: chiyuki folded before Flop (didn't bet)
Seat 9: NENE54 folded before Flop (didn't bet)



PokerStars Zoom Hand #84300549978:  Hold'em No Limit ($0.10/$0.25) - 2012/08/05 15:35:31 JST [2012/08/05 2:35:31 ET]
Table 'Whirlpool' 9-max Seat #1 is the button
Seat 1: 1Karina1 ($26.59 in chips) 
Seat 2: phate-1up ($47.98 in chips) 
Seat 3: xxx Spb xxx ($25 in chips) 
Seat 4: kwkim73 ($27.53 in chips) 
Seat 5: chiyuki ($38.33 in chips) 
Seat 6: 4plankton ($27.26 in chips) 
Seat 7: Perstenev ($11.34 in chips) 
Seat 8: Lasutchik ($13.94 in chips) 
Seat 9: GovGus ($46.42 in chips) 
phate-1up: posts small blind $0.10
xxx Spb xxx: posts big blind $0.25
*** HOLE CARDS ***
Dealt to chiyuki [Kh Jd]
kwkim73: folds 
chiyuki: folds 
4plankton: folds 
Perstenev: calls $0.25
Lasutchik: calls $0.25
GovGus: folds 
1Karina1: folds 
phate-1up: folds 
xxx Spb xxx: checks 
*** FLOP *** [4h 7h 4c]
xxx Spb xxx: checks 
Perstenev: bets $0.25
Lasutchik: folds 
xxx Spb xxx: calls $0.25
*** TURN *** [4h 7h 4c] [4s]
xxx Spb xxx: checks 
Perstenev: checks 
*** RIVER *** [4h 7h 4c 4s] [8h]
xxx Spb xxx: bets $1
Perstenev: calls $1
*** SHOW DOWN ***
xxx Spb xxx: shows [Qh 7s] (a full house, Fours full of Sevens)
Perstenev: mucks hand 
xxx Spb xxx collected $3.20 from pot
*** SUMMARY ***
Total pot $3.35 | Rake $0.15 
Board [4h 7h 4c 4s 8h]
Seat 1: 1Karina1 (button) folded before Flop (didn't bet)
Seat 2: phate-1up (small blind) folded before Flop
Seat 3: xxx Spb xxx (big blind) showed [Qh 7s] and won ($3.20) with a full house, Fours full of Sevens
Seat 4: kwkim73 folded before Flop (didn't bet)
Seat 5: chiyuki folded before Flop (didn't bet)
Seat 6: 4plankton folded before Flop (didn't bet)
Seat 7: Perstenev mucked [9h 6h]
Seat 8: Lasutchik folded on the Flop
Seat 9: GovGus folded before Flop (didn't bet)



PokerStars Zoom Hand #84300561157:  Hold'em No Limit ($0.10/$0.25) - 2012/08/05 15:36:15 JST [2012/08/05 2:36:15 ET]
Table 'Whirlpool' 9-max Seat #1 is the button
Seat 1: chiyuki ($38.23 in chips) 
Seat 2: KeLevro0 ($10.34 in chips) 
Seat 3: genamator ($19.18 in chips) 
Seat 4: hldtom ($25 in chips) 
Seat 5: Silveystryk ($19.15 in chips) 
Seat 6: Rici47 ($26.95 in chips) 
Seat 7: GovGus ($38.95 in chips) 
Seat 8: seula i ($25 in chips) 
Seat 9: nice.franki ($13.31 in chips) 
KeLevro0: posts small blind $0.10
genamator: posts big blind $0.25
*** HOLE CARDS ***
Dealt to chiyuki [7h 3c]
hldtom: raises $0.50 to $0.75
Silveystryk: folds 
Rici47: folds 
GovGus: calls $0.75
seula i: folds 
nice.franki: folds 
chiyuki: folds 
KeLevro0: folds 
genamator: folds 
*** FLOP *** [5d As 5h]
hldtom: bets $1.34
GovGus: folds 
Uncalled bet ($1.34) returned to hldtom
hldtom collected $1.77 from pot
hldtom: doesn't show hand 
*** SUMMARY ***
Total pot $1.85 | Rake $0.08 
Board [5d As 5h]
Seat 1: chiyuki (button) folded before Flop (didn't bet)
Seat 2: KeLevro0 (small blind) folded before Flop
Seat 3: genamator (big blind) folded before Flop
Seat 4: hldtom collected ($1.77)
Seat 5: Silveystryk folded before Flop (didn't bet)
Seat 6: Rici47 folded before Flop (didn't bet)
Seat 7: GovGus folded on the Flop
Seat 8: seula i folded before Flop (didn't bet)
Seat 9: nice.franki folded before Flop (didn't bet)



PokerStars Zoom Hand #84300567991:  Hold'em No Limit ($0.10/$0.25) - 2012/08/05 15:36:43 JST [2012/08/05 2:36:43 ET]
Table 'Whirlpool' 9-max Seat #1 is the button
Seat 1: NuMetal88 ($28.85 in chips) 
Seat 2: DutchShultzs ($42.49 in chips) 
Seat 3: 4plankton ($27.26 in chips) 
Seat 4: KeLevro0 ($13.30 in chips) 
Seat 5: yvasilik ($21.10 in chips) 
Seat 6: GovGus ($45.67 in chips) 
Seat 7: kwkim73 ($56.45 in chips) 
Seat 8: chiyuki ($38.23 in chips) 
Seat 9: kesstukas25 ($13.55 in chips) 
DutchShultzs: posts small blind $0.10
4plankton: posts big blind $0.25
*** HOLE CARDS ***
Dealt to chiyuki [7d Kd]
KeLevro0: folds 
yvasilik: folds 
GovGus: folds 
kwkim73: folds 
chiyuki: folds 
kesstukas25: folds 
NuMetal88: folds 
DutchShultzs: folds 
Uncalled bet ($0.15) returned to 4plankton
4plankton collected $0.20 from pot
4plankton: doesn't show hand 
*** SUMMARY ***
Total pot $0.20 | Rake $0 
Seat 1: NuMetal88 (button) folded before Flop (didn't bet)
Seat 2: DutchShultzs (small blind) folded before Flop
Seat 3: 4plankton (big blind) collected ($0.20)
Seat 4: KeLevro0 folded before Flop (didn't bet)
Seat 5: yvasilik folded before Flop (didn't bet)
Seat 6: GovGus folded before Flop (didn't bet)
Seat 7: kwkim73 folded before Flop (didn't bet)
Seat 8: chiyuki folded before Flop (didn't bet)
Seat 9: kesstukas25 folded before Flop (didn't bet)



PokerStars Zoom Hand #84300552286:  Hold'em No Limit ($0.10/$0.25) - 2012/08/05 15:35:40 JST [2012/08/05 2:35:40 ET]
Table 'Whirlpool' 9-max Seat #1 is the button
Seat 1: drunk_bender ($19.03 in chips) 
Seat 2: Nerkit ($13.49 in chips) 
Seat 3: phate-1up ($60.88 in chips) 
Seat 4: snejokCoxx ($13.75 in chips) 
Seat 5: God)Squall ($28.88 in chips) 
Seat 6: 4ydo yogurt ($18.51 in chips) 
Seat 7: chiyuki ($38.33 in chips) 
Seat 8: masterkoolb ($12.77 in chips) 
Seat 9: seula i ($28.09 in chips) 
Nerkit: posts small blind $0.10
phate-1up: posts big blind $0.25
*** HOLE CARDS ***
Dealt to chiyuki [7s Td]
snejokCoxx: raises $0.40 to $0.65
God)Squall: folds 
4ydo yogurt: folds 
chiyuki: folds 
masterkoolb: calls $0.65
seula i: folds 
drunk_bender: calls $0.65
Nerkit: folds 
phate-1up: calls $0.40
*** FLOP *** [Tc 8d 2c]
phate-1up: checks 
snejokCoxx: checks 
masterkoolb: checks 
drunk_bender: checks 
*** TURN *** [Tc 8d 2c] [6d]
phate-1up: checks 
snejokCoxx: checks 
masterkoolb: bets $1.50
drunk_bender: calls $1.50
phate-1up: folds 
snejokCoxx: folds 
*** RIVER *** [Tc 8d 2c 6d] [6s]
masterkoolb: bets $4.08
drunk_bender: folds 
Uncalled bet ($4.08) returned to masterkoolb
masterkoolb collected $5.44 from pot
masterkoolb: doesn't show hand 
*** SUMMARY ***
Total pot $5.70 | Rake $0.26 
Board [Tc 8d 2c 6d 6s]
Seat 1: drunk_bender (button) folded on the River
Seat 2: Nerkit (small blind) folded before Flop
Seat 3: phate-1up (big blind) folded on the Turn
Seat 4: snejokCoxx folded on the Turn
Seat 5: God)Squall folded before Flop (didn't bet)
Seat 6: 4ydo yogurt folded before Flop (didn't bet)
Seat 7: chiyuki folded before Flop (didn't bet)
Seat 8: masterkoolb collected ($5.44)
Seat 9: seula i folded before Flop (didn't bet)



PokerStars Zoom Hand #84300569027:  Hold'em No Limit ($0.10/$0.25) - 2012/08/05 15:36:47 JST [2012/08/05 2:36:47 ET]
Table 'Whirlpool' 9-max Seat #1 is the button
Seat 1: GSDP ($45.53 in chips) 
Seat 2: AntoineHunt ($33.88 in chips) 
Seat 3: KeLevro0 ($13.30 in chips) 
Seat 4: chiyuki ($38.23 in chips) 
Seat 5: ZhukOFFskI ($34.93 in chips) 
Seat 6: seula i ($25 in chips) 
Seat 7: Grishukps ($12.50 in chips) 
Seat 8: Faantomace ($31.69 in chips) 
Seat 9: Limoilou ($25 in chips) 
AntoineHunt: posts small blind $0.10
KeLevro0: posts big blind $0.25
*** HOLE CARDS ***
Dealt to chiyuki [Ah 8s]
chiyuki: folds 
ZhukOFFskI: folds 
seula i: folds 
Grishukps: folds 
Faantomace: folds 
Limoilou: folds 
GSDP: raises $0.50 to $0.75
AntoineHunt: folds 
KeLevro0: folds 
Uncalled bet ($0.50) returned to GSDP
GSDP collected $0.60 from pot
GSDP: doesn't show hand 
*** SUMMARY ***
Total pot $0.60 | Rake $0 
Seat 1: GSDP (button) collected ($0.60)
Seat 2: AntoineHunt (small blind) folded before Flop
Seat 3: KeLevro0 (big blind) folded before Flop
Seat 4: chiyuki folded before Flop (didn't bet)
Seat 5: ZhukOFFskI folded before Flop (didn't bet)
Seat 6: seula i folded before Flop (didn't bet)
Seat 7: Grishukps folded before Flop (didn't bet)
Seat 8: Faantomace folded before Flop (didn't bet)
Seat 9: Limoilou folded before Flop (didn't bet)



PokerStars Zoom Hand #84300563197:  Hold'em No Limit ($0.10/$0.25) - 2012/08/05 15:36:23 JST [2012/08/05 2:36:23 ET]
Table 'Whirlpool' 9-max Seat #1 is the button
Seat 1: Serge Claws ($25.35 in chips) 
Seat 2: KrystalAA ($37.82 in chips) 
Seat 3: ZhukOFFskI ($20.72 in chips) 
Seat 4: 1Karina1 ($26.59 in chips) 
Seat 5: phate-1up ($73.61 in chips) 
Seat 6: chiyuki ($38.23 in chips) 
Seat 7: ChrisCDee ($39.17 in chips) 
Seat 8: nastya040 ($10.26 in chips) 
Seat 9: Roglus ($20.10 in chips) 
KrystalAA: posts small blind $0.10
ZhukOFFskI: posts big blind $0.25
*** HOLE CARDS ***
Dealt to chiyuki [7d Tc]
1Karina1: folds 
phate-1up: folds 
chiyuki: folds 
ChrisCDee: folds 
nastya040: raises $0.25 to $0.50
Roglus: folds 
Serge Claws: raises $1.25 to $1.75
KrystalAA: folds 
ZhukOFFskI: folds 
nastya040: calls $1.25
*** FLOP *** [Kd 6c 7c]
nastya040: bets $0.50
Serge Claws: raises $2 to $2.50
nastya040: calls $2
*** TURN *** [Kd 6c 7c] [Qc]
nastya040: checks 
Serge Claws: checks 
*** RIVER *** [Kd 6c 7c Qc] [9h]
nastya040: bets $2
Serge Claws: folds 
Uncalled bet ($2) returned to nastya040
nastya040 collected $8.45 from pot
nastya040: doesn't show hand 
*** SUMMARY ***
Total pot $8.85 | Rake $0.40 
Board [Kd 6c 7c Qc 9h]
Seat 1: Serge Claws (button) folded on the River
Seat 2: KrystalAA (small blind) folded before Flop
Seat 3: ZhukOFFskI (big blind) folded before Flop
Seat 4: 1Karina1 folded before Flop (didn't bet)
Seat 5: phate-1up folded before Flop (didn't bet)
Seat 6: chiyuki folded before Flop (didn't bet)
Seat 7: ChrisCDee folded before Flop (didn't bet)
Seat 8: nastya040 collected ($8.45)
Seat 9: Roglus folded before Flop (didn't bet)



PokerStars Zoom Hand #84300569807:  Hold'em No Limit ($0.10/$0.25) - 2012/08/05 15:36:50 JST [2012/08/05 2:36:50 ET]
Table 'Whirlpool' 9-max Seat #1 is the button
Seat 1: KrystalAA ($22.79 in chips) 
Seat 2: hldtom ($26.02 in chips) 
Seat 3: chiyuki ($38.23 in chips) 
Seat 4: 1Karina1 ($35.60 in chips) 
Seat 5: nice.franki ($13.31 in chips) 
Seat 6: ChrisCDee ($63.27 in chips) 
Seat 7: panaam ($26.49 in chips) 
Seat 8: Perstenev ($9.22 in chips) 
Seat 9: DutchShultzs ($28.91 in chips) 
hldtom: posts small blind $0.10
chiyuki: posts big blind $0.25
*** HOLE CARDS ***
Dealt to chiyuki [Kc Ks]
1Karina1: folds 
nice.franki: folds 
ChrisCDee: folds 
panaam: folds 
Perstenev: folds 
DutchShultzs: raises $0.50 to $0.75
KrystalAA: calls $0.75
hldtom: folds 
chiyuki: raises $2 to $2.75
DutchShultzs: folds 
KrystalAA: calls $2
*** FLOP *** [Jh Tc 6d]
chiyuki: bets $3.50
KrystalAA: folds 
Uncalled bet ($3.50) returned to chiyuki
chiyuki collected $6.06 from pot
chiyuki: doesn't show hand 
*** SUMMARY ***
Total pot $6.35 | Rake $0.29 
Board [Jh Tc 6d]
Seat 1: KrystalAA (button) folded on the Flop
Seat 2: hldtom (small blind) folded before Flop
Seat 3: chiyuki (big blind) collected ($6.06)
Seat 4: 1Karina1 folded before Flop (didn't bet)
Seat 5: nice.franki folded before Flop (didn't bet)
Seat 6: ChrisCDee folded before Flop (didn't bet)
Seat 7: panaam folded before Flop (didn't bet)
Seat 8: Perstenev folded before Flop (didn't bet)
Seat 9: DutchShultzs folded before Flop



PokerStars Zoom Hand #84300585091:  Hold'em No Limit ($0.10/$0.25) - 2012/08/05 15:37:51 JST [2012/08/05 2:37:51 ET]
Table 'Whirlpool' 9-max Seat #1 is the button
Seat 1: NuMetal88 ($38.79 in chips) 
Seat 2: Grishukps ($12.50 in chips) 
Seat 3: Perstenev ($11.40 in chips) 
Seat 4: 1Karina1 ($26.24 in chips) 
Seat 5: svg51 ($3.54 in chips) 
Seat 6: seula i ($29.21 in chips) 
Seat 7: KrystalAA ($37.47 in chips) 
Seat 8: KeLevro0 ($12.95 in chips) 
Seat 9: chiyuki ($41.54 in chips) 
Grishukps: posts small blind $0.10
Perstenev: posts big blind $0.25
*** HOLE CARDS ***
Dealt to chiyuki [4h Jd]
1Karina1: folds 
svg51: folds 
seula i: folds 
KrystalAA: raises $0.46 to $0.71
KeLevro0: folds 
chiyuki: folds 
NuMetal88: folds 
Grishukps: folds 
Perstenev: calls $0.46
*** FLOP *** [4d 5s 7d]
Perstenev: checks 
KrystalAA: bets $1.55
Perstenev: folds 
Uncalled bet ($1.55) returned to KrystalAA
KrystalAA collected $1.45 from pot
KrystalAA: doesn't show hand 
*** SUMMARY ***
Total pot $1.52 | Rake $0.07 
Board [4d 5s 7d]
Seat 1: NuMetal88 (button) folded before Flop (didn't bet)
Seat 2: Grishukps (small blind) folded before Flop
Seat 3: Perstenev (big blind) folded on the Flop
Seat 4: 1Karina1 folded before Flop (didn't bet)
Seat 5: svg51 folded before Flop (didn't bet)
Seat 6: seula i folded before Flop (didn't bet)
Seat 7: KrystalAA collected ($1.45)
Seat 8: KeLevro0 folded before Flop (didn't bet)
Seat 9: chiyuki folded before Flop (didn't bet)



PokerStars Zoom Hand #84300589958:  Hold'em No Limit ($0.10/$0.25) - 2012/08/05 15:38:10 JST [2012/08/05 2:38:10 ET]
Table 'Whirlpool' 9-max Seat #1 is the button
Seat 1: INSP!RON ($41.60 in chips) 
Seat 2: seula i ($25.10 in chips) 
Seat 3: masterkoolb ($13.86 in chips) 
Seat 4: chiyuki ($41.44 in chips) 
Seat 5: KeLevro0 ($12.95 in chips) 
Seat 6: ChrisCDee ($40.19 in chips) 
Seat 7: God)Squall ($32.29 in chips) 
Seat 8: fil740 ($23.65 in chips) 
Seat 9: nastya040 ($14.11 in chips) 
seula i: posts small blind $0.10
masterkoolb: posts big blind $0.25
*** HOLE CARDS ***
Dealt to chiyuki [2s Jh]
chiyuki: folds 
KeLevro0: folds 
ChrisCDee: folds 
God)Squall: folds 
fil740: folds 
nastya040: folds 
INSP!RON: raises $0.35 to $0.60
seula i: folds 
masterkoolb: folds 
Uncalled bet ($0.35) returned to INSP!RON
INSP!RON collected $0.60 from pot
INSP!RON: doesn't show hand 
*** SUMMARY ***
Total pot $0.60 | Rake $0 
Seat 1: INSP!RON (button) collected ($0.60)
Seat 2: seula i (small blind) folded before Flop
Seat 3: masterkoolb (big blind) folded before Flop
Seat 4: chiyuki folded before Flop (didn't bet)
Seat 5: KeLevro0 folded before Flop (didn't bet)
Seat 6: ChrisCDee folded before Flop (didn't bet)
Seat 7: God)Squall folded before Flop (didn't bet)
Seat 8: fil740 folded before Flop (didn't bet)
Seat 9: nastya040 folded before Flop (didn't bet)



PokerStars Zoom Hand #84300586372:  Hold'em No Limit ($0.10/$0.25) - 2012/08/05 15:37:56 JST [2012/08/05 2:37:56 ET]
Table 'Whirlpool' 9-max Seat #1 is the button
Seat 1: svg51 ($3.54 in chips) 
Seat 2: chiyuki ($41.54 in chips) 
Seat 3: kkbruins0408 ($12.85 in chips) 
Seat 4: kwkim73 ($56.10 in chips) 
Seat 5: Robchie ($20.52 in chips) 
Seat 6: GSDP ($45.78 in chips) 
Seat 7: GovGus ($45.80 in chips) 
Seat 8: Spheroff ($24.97 in chips) 
Seat 9: phate-1up ($49.85 in chips) 
chiyuki: posts small blind $0.10
kkbruins0408: posts big blind $0.25
*** HOLE CARDS ***
Dealt to chiyuki [3c Td]
kwkim73: folds 
Robchie: calls $0.25
GSDP: folds 
GovGus: folds 
Spheroff: folds 
phate-1up: folds 
svg51: folds 
chiyuki: folds 
kkbruins0408: checks 
*** FLOP *** [Kh 6c 3s]
kkbruins0408: checks 
Robchie: checks 
*** TURN *** [Kh 6c 3s] [9c]
kkbruins0408: checks 
Robchie: checks 
*** RIVER *** [Kh 6c 3s 9c] [9d]
kkbruins0408: bets $0.50
Robchie: calls $0.50
*** SHOW DOWN ***
kkbruins0408: shows [2d 3h] (two pair, Nines and Threes)
Robchie: mucks hand 
kkbruins0408 collected $1.53 from pot
*** SUMMARY ***
Total pot $1.60 | Rake $0.07 
Board [Kh 6c 3s 9c 9d]
Seat 1: svg51 (button) folded before Flop (didn't bet)
Seat 2: chiyuki (small blind) folded before Flop
Seat 3: kkbruins0408 (big blind) showed [2d 3h] and won ($1.53) with two pair, Nines and Threes
Seat 4: kwkim73 folded before Flop (didn't bet)
Seat 5: Robchie mucked [Ad 2s]
Seat 6: GSDP folded before Flop (didn't bet)
Seat 7: GovGus folded before Flop (didn't bet)
Seat 8: Spheroff folded before Flop (didn't bet)
Seat 9: phate-1up folded before Flop (didn't bet)



PokerStars Zoom Hand #84300590942:  Hold'em No Limit ($0.10/$0.25) - 2012/08/05 15:38:14 JST [2012/08/05 2:38:14 ET]
Table 'Whirlpool' 9-max Seat #1 is the button
Seat 1: chiyuki ($41.44 in chips) 
Seat 2: DutchShultzs ($25 in chips) 
Seat 3: kwkim73 ($56.10 in chips) 
Seat 4: Jene4kaBest ($10.90 in chips) 
Seat 5: Faraz ($12.88 in chips) 
Seat 6: turbotom122 ($25 in chips) 
Seat 7: soul_5577 ($33.76 in chips) 
Seat 8: nice.franki ($13.31 in chips) 
Seat 9: JhonnyP1979 ($15.83 in chips) 
DutchShultzs: posts small blind $0.10
kwkim73: posts big blind $0.25
*** HOLE CARDS ***
Dealt to chiyuki [Qd Qh]
Jene4kaBest: folds 
Faraz: folds 
turbotom122: folds 
soul_5577: folds 
nice.franki: folds 
JhonnyP1979: folds 
chiyuki: raises $0.50 to $0.75
DutchShultzs: folds 
kwkim73: folds 
Uncalled bet ($0.50) returned to chiyuki
chiyuki collected $0.60 from pot
chiyuki: doesn't show hand 
*** SUMMARY ***
Total pot $0.60 | Rake $0 
Seat 1: chiyuki (button) collected ($0.60)
Seat 2: DutchShultzs (small blind) folded before Flop
Seat 3: kwkim73 (big blind) folded before Flop
Seat 4: Jene4kaBest folded before Flop (didn't bet)
Seat 5: Faraz folded before Flop (didn't bet)
Seat 6: turbotom122 folded before Flop (didn't bet)
Seat 7: soul_5577 folded before Flop (didn't bet)
Seat 8: nice.franki folded before Flop (didn't bet)
Seat 9: JhonnyP1979 folded before Flop (didn't bet)



PokerStars Zoom Hand #84300599564:  Hold'em No Limit ($0.10/$0.25) - 2012/08/05 15:38:48 JST [2012/08/05 2:38:48 ET]
Table 'Whirlpool' 9-max Seat #1 is the button
Seat 1: kesstukas25 ($23.19 in chips) 
Seat 2: KeLevro0 ($11.05 in chips) 
Seat 3: panaam ($26.24 in chips) 
Seat 4: kwkim73 ($26.95 in chips) 
Seat 5: Faraz ($12.80 in chips) 
Seat 6: chiyuki ($41.79 in chips) 
Seat 7: KrystalAA ($24.98 in chips) 
Seat 8: slapshot2011 ($9.93 in chips) 
Seat 9: DutchShultzs ($27.91 in chips) 
KeLevro0: posts small blind $0.10
panaam: posts big blind $0.25
*** HOLE CARDS ***
Dealt to chiyuki [6h 4d]
kwkim73: folds 
Faraz: folds 
chiyuki: folds 
KrystalAA: raises $0.46 to $0.71
slapshot2011: calls $0.71
DutchShultzs: raises $2.59 to $3.30
kesstukas25: folds 
KeLevro0: folds 
panaam: folds 
KrystalAA: folds 
slapshot2011: folds 
Uncalled bet ($2.59) returned to DutchShultzs
DutchShultzs collected $2.48 from pot
DutchShultzs: doesn't show hand 
*** SUMMARY ***
Total pot $2.48 | Rake $0 
Seat 1: kesstukas25 (button) folded before Flop (didn't bet)
Seat 2: KeLevro0 (small blind) folded before Flop
Seat 3: panaam (big blind) folded before Flop
Seat 4: kwkim73 folded before Flop (didn't bet)
Seat 5: Faraz folded before Flop (didn't bet)
Seat 6: chiyuki folded before Flop (didn't bet)
Seat 7: KrystalAA folded before Flop
Seat 8: slapshot2011 folded before Flop
Seat 9: DutchShultzs collected ($2.48)



PokerStars Zoom Hand #84300596506:  Hold'em No Limit ($0.10/$0.25) - 2012/08/05 15:38:36 JST [2012/08/05 2:38:36 ET]
Table 'Whirlpool' 9-max Seat #1 is the button
Seat 1: DutchShultzs ($25 in chips) 
Seat 2: kamikkaze ($14.20 in chips) 
Seat 3: Serge Claws ($25 in chips) 
Seat 4: Lasutchik ($12.15 in chips) 
Seat 5: Jene4kaBest ($10.80 in chips) 
Seat 6: PPP7SSS ($14.21 in chips) 
Seat 7: chiyuki ($41.79 in chips) 
Seat 8: 4plankton ($26.85 in chips) 
Seat 9: Saruotiss ($63.56 in chips) 
kamikkaze: posts small blind $0.10
Serge Claws: posts big blind $0.25
*** HOLE CARDS ***
Dealt to chiyuki [9d 7d]
Lasutchik: folds 
Jene4kaBest: folds 
PPP7SSS: raises $0.50 to $0.75
chiyuki: folds 
4plankton: folds 
Saruotiss: calls $0.75
DutchShultzs: folds 
kamikkaze: folds 
Serge Claws: folds 
*** FLOP *** [Ad 3h Kh]
PPP7SSS: bets $1
Saruotiss: folds 
Uncalled bet ($1) returned to PPP7SSS
PPP7SSS collected $1.77 from pot
PPP7SSS: doesn't show hand 
*** SUMMARY ***
Total pot $1.85 | Rake $0.08 
Board [Ad 3h Kh]
Seat 1: DutchShultzs (button) folded before Flop (didn't bet)
Seat 2: kamikkaze (small blind) folded before Flop
Seat 3: Serge Claws (big blind) folded before Flop
Seat 4: Lasutchik folded before Flop (didn't bet)
Seat 5: Jene4kaBest folded before Flop (didn't bet)
Seat 6: PPP7SSS collected ($1.77)
Seat 7: chiyuki folded before Flop (didn't bet)
Seat 8: 4plankton folded before Flop (didn't bet)
Seat 9: Saruotiss folded on the Flop



PokerStars Zoom Hand #84300602916:  Hold'em No Limit ($0.10/$0.25) - 2012/08/05 15:39:01 JST [2012/08/05 2:39:01 ET]
Table 'Whirlpool' 9-max Seat #1 is the button
Seat 1: KeLevro0 ($10.70 in chips) 
Seat 2: mjmichi ($43.14 in chips) 
Seat 3: chiyuki ($41.79 in chips) 
Seat 4: Limoilou ($33.37 in chips) 
Seat 5: panaam ($25.99 in chips) 
Seat 6: Rilko1975 ($21.50 in chips) 
Seat 7: Serge Claws ($25 in chips) 
Seat 8: AntoineHunt ($36.87 in chips) 
Seat 9: seula i ($28.96 in chips) 
mjmichi: posts small blind $0.10
chiyuki: posts big blind $0.25
*** HOLE CARDS ***
Dealt to chiyuki [4c 7d]
Limoilou: raises $0.50 to $0.75
panaam: folds 
Rilko1975: folds 
Serge Claws: folds 
AntoineHunt: folds 
seula i: folds 
KeLevro0: folds 
mjmichi: folds 
chiyuki: folds 
Uncalled bet ($0.50) returned to Limoilou
Limoilou collected $0.60 from pot
Limoilou: doesn't show hand 
*** SUMMARY ***
Total pot $0.60 | Rake $0 
Seat 1: KeLevro0 (button) folded before Flop (didn't bet)
Seat 2: mjmichi (small blind) folded before Flop
Seat 3: chiyuki (big blind) folded before Flop
Seat 4: Limoilou collected ($0.60)
Seat 5: panaam folded before Flop (didn't bet)
Seat 6: Rilko1975 folded before Flop (didn't bet)
Seat 7: Serge Claws folded before Flop (didn't bet)
Seat 8: AntoineHunt folded before Flop (didn't bet)
Seat 9: seula i folded before Flop (didn't bet)



PokerStars Zoom Hand #84300597527:  Hold'em No Limit ($0.10/$0.25) - 2012/08/05 15:38:40 JST [2012/08/05 2:38:40 ET]
Table 'Whirlpool' 9-max Seat #1 is the button
Seat 1: jacquelinewu ($29.93 in chips) 
Seat 2: hldtom ($25 in chips) 
Seat 3: silvno31 ($70.79 in chips) 
Seat 4: 4plankton ($26.85 in chips) 
Seat 5: fil740 ($24 in chips) 
Seat 6: Perstenev ($12.65 in chips) 
Seat 7: nice.franki ($13.06 in chips) 
Seat 8: Jene4kaBest ($10.80 in chips) 
Seat 9: chiyuki ($41.79 in chips) 
hldtom: posts small blind $0.10
silvno31: posts big blind $0.25
*** HOLE CARDS ***
Dealt to chiyuki [Jh 5h]
4plankton: folds 
fil740: folds 
Perstenev: folds 
nice.franki: folds 
Jene4kaBest: folds 
chiyuki: folds 
jacquelinewu: raises $0.50 to $0.75
hldtom: raises $1.75 to $2.50
silvno31: folds 
jacquelinewu: folds 
Uncalled bet ($1.75) returned to hldtom
hldtom collected $1.75 from pot
hldtom: doesn't show hand 
*** SUMMARY ***
Total pot $1.75 | Rake $0 
Seat 1: jacquelinewu (button) folded before Flop
Seat 2: hldtom (small blind) collected ($1.75)
Seat 3: silvno31 (big blind) folded before Flop
Seat 4: 4plankton folded before Flop (didn't bet)
Seat 5: fil740 folded before Flop (didn't bet)
Seat 6: Perstenev folded before Flop (didn't bet)
Seat 7: nice.franki folded before Flop (didn't bet)
Seat 8: Jene4kaBest folded before Flop (didn't bet)
Seat 9: chiyuki folded before Flop (didn't bet)



PokerStars Zoom Hand #84300601822:  Hold'em No Limit ($0.10/$0.25) - 2012/08/05 15:38:57 JST [2012/08/05 2:38:57 ET]
Table 'Whirlpool' 9-max Seat #1 is the button
Seat 1: kesstukas25 ($14.80 in chips) 
Seat 2: nice.franki ($13.06 in chips) 
Seat 3: westhavenbc ($20 in chips) 
Seat 4: KrystalAA ($38.21 in chips) 
Seat 5: chiyuki ($41.79 in chips) 
Seat 6: Gichboy ($16.75 in chips) 
Seat 7: snejokCoxx ($11.75 in chips) 
Seat 8: Ellen1947 ($22.85 in chips) 
Seat 9: Serge Claws ($25 in chips) 
nice.franki: posts small blind $0.10
westhavenbc: posts big blind $0.25
*** HOLE CARDS ***
Dealt to chiyuki [5h 4c]
KrystalAA: folds 
chiyuki: folds 
Gichboy: folds 
snejokCoxx: raises $0.40 to $0.65
Ellen1947: folds 
Serge Claws: folds 
kesstukas25: folds 
nice.franki: folds 
westhavenbc: folds 
Uncalled bet ($0.40) returned to snejokCoxx
snejokCoxx collected $0.60 from pot
snejokCoxx: doesn't show hand 
*** SUMMARY ***
Total pot $0.60 | Rake $0 
Seat 1: kesstukas25 (button) folded before Flop (didn't bet)
Seat 2: nice.franki (small blind) folded before Flop
Seat 3: westhavenbc (big blind) folded before Flop
Seat 4: KrystalAA folded before Flop (didn't bet)
Seat 5: chiyuki folded before Flop (didn't bet)
Seat 6: Gichboy folded before Flop (didn't bet)
Seat 7: snejokCoxx collected ($0.60)
Seat 8: Ellen1947 folded before Flop (didn't bet)
Seat 9: Serge Claws folded before Flop (didn't bet)



PokerStars Zoom Hand #84300600321:  Hold'em No Limit ($0.10/$0.25) - 2012/08/05 15:38:51 JST [2012/08/05 2:38:51 ET]
Table 'Whirlpool' 9-max Seat #1 is the button
Seat 1: INSP!RON ($46.86 in chips) 
Seat 2: phate-1up ($62.73 in chips) 
Seat 3: Nerkit ($13.49 in chips) 
Seat 4: Perstenev ($10.59 in chips) 
Seat 5: ZhukOFFskI ($75.11 in chips) 
Seat 6: GSDP ($26.29 in chips) 
Seat 7: chiyuki ($41.79 in chips) 
Seat 8: 1Karina1 ($36.72 in chips) 
Seat 9: hirozo ($25 in chips) 
phate-1up: posts small blind $0.10
Nerkit: posts big blind $0.25
*** HOLE CARDS ***
Dealt to chiyuki [5d Ad]
Perstenev: calls $0.25
ZhukOFFskI: folds 
GSDP: folds 
chiyuki: folds 
1Karina1: folds 
hirozo: raises $0.75 to $1
INSP!RON: folds 
phate-1up: folds 
Nerkit: folds 
Perstenev: calls $0.75
*** FLOP *** [7d Qs Js]
Perstenev: checks 
hirozo: bets $1.49
Perstenev: calls $1.49
*** TURN *** [7d Qs Js] [9h]
Perstenev: checks 
hirozo: bets $3.40
Perstenev: folds 
Uncalled bet ($3.40) returned to hirozo
hirozo collected $5.09 from pot
hirozo: doesn't show hand 
*** SUMMARY ***
Total pot $5.33 | Rake $0.24 
Board [7d Qs Js 9h]
Seat 1: INSP!RON (button) folded before Flop (didn't bet)
Seat 2: phate-1up (small blind) folded before Flop
Seat 3: Nerkit (big blind) folded before Flop
Seat 4: Perstenev folded on the Turn
Seat 5: ZhukOFFskI folded before Flop (didn't bet)
Seat 6: GSDP folded before Flop (didn't bet)
Seat 7: chiyuki folded before Flop (didn't bet)
Seat 8: 1Karina1 folded before Flop (didn't bet)
Seat 9: hirozo collected ($5.09)



PokerStars Zoom Hand #84300606680:  Hold'em No Limit ($0.10/$0.25) - 2012/08/05 15:39:17 JST [2012/08/05 2:39:17 ET]
Table 'Whirlpool' 9-max Seat #1 is the button
Seat 1: NuMetal88 ($28.50 in chips) 
Seat 2: nice.franki ($9.10 in chips) 
Seat 3: kesstukas25 ($14.80 in chips) 
Seat 4: ZhukOFFskI ($75.01 in chips) 
Seat 5: 1Karina1 ($36.72 in chips) 
Seat 6: phate-1up ($35.33 in chips) 
Seat 7: Vahe50 ($19.19 in chips) 
Seat 8: chiyuki ($41.54 in chips) 
Seat 9: 4plankton ($26.60 in chips) 
nice.franki: posts small blind $0.10
kesstukas25: posts big blind $0.25
*** HOLE CARDS ***
Dealt to chiyuki [Kh Jd]
ZhukOFFskI: raises $0.37 to $0.62
1Karina1: folds 
phate-1up: calls $0.62
Vahe50: folds 
chiyuki: folds 
4plankton: folds 
NuMetal88: folds 
nice.franki: folds 
kesstukas25: folds 
*** FLOP *** [7s Kc 2c]
ZhukOFFskI: bets $0.91
phate-1up: calls $0.91
*** TURN *** [7s Kc 2c] [Tc]
ZhukOFFskI: bets $2
phate-1up: raises $3.25 to $5.25
ZhukOFFskI: folds 
Uncalled bet ($3.25) returned to phate-1up
phate-1up collected $7.08 from pot
phate-1up: doesn't show hand 
*** SUMMARY ***
Total pot $7.41 | Rake $0.33 
Board [7s Kc 2c Tc]
Seat 1: NuMetal88 (button) folded before Flop (didn't bet)
Seat 2: nice.franki (small blind) folded before Flop
Seat 3: kesstukas25 (big blind) folded before Flop
Seat 4: ZhukOFFskI folded on the Turn
Seat 5: 1Karina1 folded before Flop (didn't bet)
Seat 6: phate-1up collected ($7.08)
Seat 7: Vahe50 folded before Flop (didn't bet)
Seat 8: chiyuki folded before Flop (didn't bet)
Seat 9: 4plankton folded before Flop (didn't bet)



PokerStars Zoom Hand #84300619201:  Hold'em No Limit ($0.10/$0.25) - 2012/08/05 15:40:06 JST [2012/08/05 2:40:06 ET]
Table 'Whirlpool' 9-max Seat #1 is the button
Seat 1: slapshot2011 ($7.47 in chips) 
Seat 2: HighDuka ($34.91 in chips) 
Seat 3: ZhukOFFskI ($71.48 in chips) 
Seat 4: jvds114 ($27.45 in chips) 
Seat 5: chiyuki ($41.44 in chips) 
Seat 6: kesstukas25 ($22.09 in chips) 
Seat 7: Rilko1975 ($25 in chips) 
Seat 8: kwkim73 ($28.80 in chips) 
Seat 9: Jene4kaBest ($11.90 in chips) 
HighDuka: posts small blind $0.10
ZhukOFFskI: posts big blind $0.25
*** HOLE CARDS ***
Dealt to chiyuki [2c Tc]
jvds114: folds 
chiyuki: folds 
kesstukas25: raises $0.50 to $0.75
Rilko1975: folds 
kwkim73: folds 
Jene4kaBest: folds 
slapshot2011: folds 
HighDuka: folds 
ZhukOFFskI: folds 
Uncalled bet ($0.50) returned to kesstukas25
kesstukas25 collected $0.60 from pot
kesstukas25: doesn't show hand 
*** SUMMARY ***
Total pot $0.60 | Rake $0 
Seat 1: slapshot2011 (button) folded before Flop (didn't bet)
Seat 2: HighDuka (small blind) folded before Flop
Seat 3: ZhukOFFskI (big blind) folded before Flop
Seat 4: jvds114 folded before Flop (didn't bet)
Seat 5: chiyuki folded before Flop (didn't bet)
Seat 6: kesstukas25 collected ($0.60)
Seat 7: Rilko1975 folded before Flop (didn't bet)
Seat 8: kwkim73 folded before Flop (didn't bet)
Seat 9: Jene4kaBest folded before Flop (didn't bet)



PokerStars Zoom Hand #84300620994:  Hold'em No Limit ($0.10/$0.25) - 2012/08/05 15:40:13 JST [2012/08/05 2:40:13 ET]
Table 'Whirlpool' 9-max Seat #1 is the button
Seat 1: DutchShultzs ($29.33 in chips) 
Seat 2: 4plankton ($26.25 in chips) 
Seat 3: silvno31 ($70.04 in chips) 
Seat 4: INSP!RON ($40.34 in chips) 
Seat 5: Limoilou ($33.37 in chips) 
Seat 6: soul_5577 ($40.10 in chips) 
Seat 7: Gichboy ($30.68 in chips) 
Seat 8: chiyuki ($41.44 in chips) 
Seat 9: KeLevro0 ($9.38 in chips) 
4plankton: posts small blind $0.10
silvno31: posts big blind $0.25
*** HOLE CARDS ***
Dealt to chiyuki [9h Th]
INSP!RON: folds 
Limoilou: folds 
soul_5577: folds 
Gichboy: raises $0.50 to $0.75
chiyuki: folds 
KeLevro0: folds 
DutchShultzs: folds 
4plankton: folds 
silvno31: folds 
Uncalled bet ($0.50) returned to Gichboy
Gichboy collected $0.60 from pot
Gichboy: doesn't show hand 
*** SUMMARY ***
Total pot $0.60 | Rake $0 
Seat 1: DutchShultzs (button) folded before Flop (didn't bet)
Seat 2: 4plankton (small blind) folded before Flop
Seat 3: silvno31 (big blind) folded before Flop
Seat 4: INSP!RON folded before Flop (didn't bet)
Seat 5: Limoilou folded before Flop (didn't bet)
Seat 6: soul_5577 folded before Flop (didn't bet)
Seat 7: Gichboy collected ($0.60)
Seat 8: chiyuki folded before Flop (didn't bet)
Seat 9: KeLevro0 folded before Flop (didn't bet)



PokerStars Zoom Hand #84300622041:  Hold'em No Limit ($0.10/$0.25) - 2012/08/05 15:40:18 JST [2012/08/05 2:40:18 ET]
Table 'Whirlpool' 9-max Seat #1 is the button
Seat 1: Rilko1975 ($25 in chips) 
Seat 2: KrystalAA ($24.02 in chips) 
Seat 3: chiyuki ($41.44 in chips) 
Seat 4: Serge Claws ($36.69 in chips) 
Seat 5: masterkoolb ($13.26 in chips) 
Seat 6: nice.franki ($12.71 in chips) 
Seat 7: INSP!RON ($40.34 in chips) 
Seat 8: Dan Royal ($36.04 in chips) 
Seat 9: herkko11 ($2.97 in chips) 
KrystalAA: posts small blind $0.10
chiyuki: posts big blind $0.25
*** HOLE CARDS ***
Dealt to chiyuki [4c 9s]
Serge Claws: folds 
masterkoolb: folds 
nice.franki: folds 
INSP!RON: folds 
Dan Royal: folds 
herkko11: folds 
Rilko1975: folds 
KrystalAA: raises $0.38 to $0.63
chiyuki: folds 
Uncalled bet ($0.38) returned to KrystalAA
KrystalAA collected $0.50 from pot
KrystalAA: doesn't show hand 
*** SUMMARY ***
Total pot $0.50 | Rake $0 
Seat 1: Rilko1975 (button) folded before Flop (didn't bet)
Seat 2: KrystalAA (small blind) collected ($0.50)
Seat 3: chiyuki (big blind) folded before Flop
Seat 4: Serge Claws folded before Flop (didn't bet)
Seat 5: masterkoolb folded before Flop (didn't bet)
Seat 6: nice.franki folded before Flop (didn't bet)
Seat 7: INSP!RON folded before Flop (didn't bet)
Seat 8: Dan Royal folded before Flop (didn't bet)
Seat 9: herkko11 folded before Flop (didn't bet)



PokerStars Zoom Hand #84300615377:  Hold'em No Limit ($0.10/$0.25) - 2012/08/05 15:39:51 JST [2012/08/05 2:39:51 ET]
Table 'Whirlpool' 9-max Seat #1 is the button
Seat 1: aivvo ($9.73 in chips) 
Seat 2: chiyuki ($41.54 in chips) 
Seat 3: pandaaaaaa ($10.77 in chips) 
Seat 4: GSDP ($25.79 in chips) 
Seat 5: jvds114 ($27.45 in chips) 
Seat 6: Gichboy ($30.68 in chips) 
Seat 7: Roglus ($18.70 in chips) 
Seat 8: Perstenev ($8.10 in chips) 
Seat 9: Faraz ($12.45 in chips) 
chiyuki: posts small blind $0.10
pandaaaaaa: posts big blind $0.25
*** HOLE CARDS ***
Dealt to chiyuki [Jc 4c]
GSDP: folds 
jvds114: folds 
Gichboy: folds 
Roglus: folds 
Perstenev has timed out while being disconnected
Perstenev: folds 
Faraz: raises $0.25 to $0.50
aivvo: folds 
chiyuki: folds 
pandaaaaaa: folds 
Uncalled bet ($0.25) returned to Faraz
Faraz collected $0.60 from pot
Faraz: doesn't show hand 
*** SUMMARY ***
Total pot $0.60 | Rake $0 
Seat 1: aivvo (button) folded before Flop (didn't bet)
Seat 2: chiyuki (small blind) folded before Flop
Seat 3: pandaaaaaa (big blind) folded before Flop
Seat 4: GSDP folded before Flop (didn't bet)
Seat 5: jvds114 folded before Flop (didn't bet)
Seat 6: Gichboy folded before Flop (didn't bet)
Seat 7: Roglus folded before Flop (didn't bet)
Seat 8: Perstenev folded before Flop (didn't bet)
Seat 9: Faraz collected ($0.60)



PokerStars Zoom Hand #84300624904:  Hold'em No Limit ($0.10/$0.25) - 2012/08/05 15:40:29 JST [2012/08/05 2:40:29 ET]
Table 'Whirlpool' 9-max Seat #1 is the button
Seat 1: kamikkaze ($13.25 in chips) 
Seat 2: nice.franki ($12.71 in chips) 
Seat 3: yvasilik ($20.50 in chips) 
Seat 4: masterkoolb ($13.16 in chips) 
Seat 5: WARIBANA7777 ($14.83 in chips) 
Seat 6: 1Karina1 ($36.72 in chips) 
Seat 7: ViTiV2010 ($12.13 in chips) 
Seat 8: GSDP ($49.10 in chips) 
Seat 9: chiyuki ($41.19 in chips) 
nice.franki: posts small blind $0.10
yvasilik: posts big blind $0.25
*** HOLE CARDS ***
Dealt to chiyuki [5d 2d]
masterkoolb: folds 
WARIBANA7777: folds 
1Karina1: folds 
ViTiV2010: folds 
GSDP: raises $0.75 to $1
chiyuki: folds 
kamikkaze: folds 
nice.franki: folds 
yvasilik: folds 
Uncalled bet ($0.75) returned to GSDP
GSDP collected $0.60 from pot
GSDP: doesn't show hand 
*** SUMMARY ***
Total pot $0.60 | Rake $0 
Seat 1: kamikkaze (button) folded before Flop (didn't bet)
Seat 2: nice.franki (small blind) folded before Flop
Seat 3: yvasilik (big blind) folded before Flop
Seat 4: masterkoolb folded before Flop (didn't bet)
Seat 5: WARIBANA7777 folded before Flop (didn't bet)
Seat 6: 1Karina1 folded before Flop (didn't bet)
Seat 7: ViTiV2010 folded before Flop (didn't bet)
Seat 8: GSDP collected ($0.60)
Seat 9: chiyuki folded before Flop (didn't bet)



PokerStars Zoom Hand #84300609546:  Hold'em No Limit ($0.10/$0.25) - 2012/08/05 15:39:28 JST [2012/08/05 2:39:28 ET]
Table 'Whirlpool' 9-max Seat #1 is the button
Seat 1: chiyuki ($41.54 in chips) 
Seat 2: westhavenbc ($19.75 in chips) 
Seat 3: Faraz ($12.78 in chips) 
Seat 4: Nerkit ($13.24 in chips) 
Seat 5: Grishukps ($12.50 in chips) 
Seat 6: jacquelinewu ($31.91 in chips) 
Seat 7: God)Squall ($32.29 in chips) 
Seat 8: Serge Claws ($28.35 in chips) 
Seat 9: AAAKK777 ($9.36 in chips) 
westhavenbc: posts small blind $0.10
Faraz: posts big blind $0.25
*** HOLE CARDS ***
Dealt to chiyuki [6c 6s]
Nerkit: folds 
Grishukps: raises $0.50 to $0.75
jacquelinewu: folds 
God)Squall: folds 
Serge Claws: folds 
AAAKK777: calls $0.75
chiyuki: folds 
westhavenbc: folds 
Faraz: calls $0.50
*** FLOP *** [Kc Jd 9h]
Faraz: checks 
Grishukps: bets $1.30
AAAKK777: calls $1.30
Faraz: folds 
*** TURN *** [Kc Jd 9h] [3h]
Grishukps: bets $3.30
AAAKK777: calls $3.30
*** RIVER *** [Kc Jd 9h 3h] [Ts]
Grishukps: bets $4
AAAKK777: raises $0.01 to $4.01 and is all-in
Grishukps: calls $0.01
*** SHOW DOWN ***
AAAKK777: shows [Qc 7c] (a straight, Nine to King)
Grishukps: shows [Ks Ad] (a pair of Kings)
AAAKK777 collected $18.69 from pot
*** SUMMARY ***
Total pot $19.57 | Rake $0.88 
Board [Kc Jd 9h 3h Ts]
Seat 1: chiyuki (button) folded before Flop (didn't bet)
Seat 2: westhavenbc (small blind) folded before Flop
Seat 3: Faraz (big blind) folded on the Flop
Seat 4: Nerkit folded before Flop (didn't bet)
Seat 5: Grishukps showed [Ks Ad] and lost with a pair of Kings
Seat 6: jacquelinewu folded before Flop (didn't bet)
Seat 7: God)Squall folded before Flop (didn't bet)
Seat 8: Serge Claws folded before Flop (didn't bet)
Seat 9: AAAKK777 showed [Qc 7c] and won ($18.69) with a straight, Nine to King



PokerStars Zoom Hand #84300619967:  Hold'em No Limit ($0.10/$0.25) - 2012/08/05 15:40:09 JST [2012/08/05 2:40:09 ET]
Table 'Whirlpool' 9-max Seat #1 is the button
Seat 1: 4plankton ($26.25 in chips) 
Seat 2: Ellen1947 ($22.60 in chips) 
Seat 3: jvds114 ($27.45 in chips) 
Seat 4: ZhukOFFskI ($35.78 in chips) 
Seat 5: drunk_bender ($15.88 in chips) 
Seat 6: genamator ($19.61 in chips) 
Seat 7: 4ydo yogurt ($21.46 in chips) 
Seat 8: WARIBANA7777 ($15.08 in chips) 
Seat 9: chiyuki ($41.44 in chips) 
Ellen1947: posts small blind $0.10
jvds114: posts big blind $0.25
*** HOLE CARDS ***
Dealt to chiyuki [7s 8c]
ZhukOFFskI: folds 
drunk_bender: raises $0.50 to $0.75
genamator: calls $0.75
4ydo yogurt: folds 
WARIBANA7777: folds 
chiyuki: folds 
4plankton: folds 
Ellen1947: folds 
jvds114: calls $0.50
*** FLOP *** [Qs Ts Jh]
jvds114: checks 
drunk_bender: checks 
genamator: bets $0.75
jvds114: calls $0.75
drunk_bender: calls $0.75
*** TURN *** [Qs Ts Jh] [Jc]
jvds114: checks 
drunk_bender: checks 
genamator: bets $1.75
jvds114: calls $1.75
drunk_bender: folds 
*** RIVER *** [Qs Ts Jh Jc] [6s]
jvds114: bets $1.75
genamator: raises $4 to $5.75
jvds114: folds 
Uncalled bet ($4) returned to genamator
genamator collected $11.08 from pot
genamator: doesn't show hand 
*** SUMMARY ***
Total pot $11.60 | Rake $0.52 
Board [Qs Ts Jh Jc 6s]
Seat 1: 4plankton (button) folded before Flop (didn't bet)
Seat 2: Ellen1947 (small blind) folded before Flop
Seat 3: jvds114 (big blind) folded on the River
Seat 4: ZhukOFFskI folded before Flop (didn't bet)
Seat 5: drunk_bender folded on the Turn
Seat 6: genamator collected ($11.08)
Seat 7: 4ydo yogurt folded before Flop (didn't bet)
Seat 8: WARIBANA7777 folded before Flop (didn't bet)
Seat 9: chiyuki folded before Flop (didn't bet)



PokerStars Zoom Hand #84300617923:  Hold'em No Limit ($0.10/$0.25) - 2012/08/05 15:40:01 JST [2012/08/05 2:40:01 ET]
Table 'Whirlpool' 9-max Seat #1 is the button
Seat 1: 1Karina1 ($31.96 in chips) 
Seat 2: GovGus ($36.35 in chips) 
Seat 3: tribunpdm ($47.15 in chips) 
Seat 4: soul_5577 ($40.10 in chips) 
Seat 5: aivvo ($9.73 in chips) 
Seat 6: chiyuki ($41.44 in chips) 
Seat 7: Nerkit ($15.72 in chips) 
Seat 8: ViTiV2010 ($12.13 in chips) 
Seat 9: kwkim73 ($28.80 in chips) 
GovGus: posts small blind $0.10
tribunpdm: posts big blind $0.25
*** HOLE CARDS ***
Dealt to chiyuki [Qs Kc]
soul_5577: folds 
aivvo: folds 
chiyuki: folds 
Nerkit: folds 
ViTiV2010: folds 
kwkim73: folds 
1Karina1: folds 
GovGus: raises $0.50 to $0.75
tribunpdm: calls $0.50
*** FLOP *** [Ts 3s 3c]
GovGus: bets $1
tribunpdm: calls $1
*** TURN *** [Ts 3s 3c] [Ad]
GovGus: bets $2
tribunpdm: calls $2
*** RIVER *** [Ts 3s 3c Ad] [Ac]
GovGus: checks 
tribunpdm: bets $3
GovGus: calls $3
*** SHOW DOWN ***
tribunpdm: shows [3d Qh] (a full house, Threes full of Aces)
GovGus: mucks hand 
tribunpdm collected $12.89 from pot
*** SUMMARY ***
Total pot $13.50 | Rake $0.61 
Board [Ts 3s 3c Ad Ac]
Seat 1: 1Karina1 (button) folded before Flop (didn't bet)
Seat 2: GovGus (small blind) mucked [6s Th]
Seat 3: tribunpdm (big blind) showed [3d Qh] and won ($12.89) with a full house, Threes full of Aces
Seat 4: soul_5577 folded before Flop (didn't bet)
Seat 5: aivvo folded before Flop (didn't bet)
Seat 6: chiyuki folded before Flop (didn't bet)
Seat 7: Nerkit folded before Flop (didn't bet)
Seat 8: ViTiV2010 folded before Flop (didn't bet)
Seat 9: kwkim73 folded before Flop (didn't bet)



PokerStars Zoom Hand #84300626437:  Hold'em No Limit ($0.10/$0.25) - 2012/08/05 15:40:35 JST [2012/08/05 2:40:35 ET]
Table 'Whirlpool' 9-max Seat #1 is the button
Seat 1: WARIBANA7777 ($14.83 in chips) 
Seat 2: herkko11 ($2.97 in chips) 
Seat 3: ZhukOFFskI ($35.78 in chips) 
Seat 4: slapshot2011 ($7.37 in chips) 
Seat 5: chiyuki ($41.19 in chips) 
Seat 6: phate-1up ($38.63 in chips) 
Seat 7: Serge Claws ($42.40 in chips) 
Seat 8: kamikkaze ($19.73 in chips) 
Seat 9: risekuku468 ($29.14 in chips) 
herkko11: posts small blind $0.10
ZhukOFFskI: posts big blind $0.25
*** HOLE CARDS ***
Dealt to chiyuki [Ac As]
slapshot2011: folds 
chiyuki: raises $0.50 to $0.75
phate-1up: folds 
Serge Claws: folds 
kamikkaze: folds 
risekuku468: folds 
WARIBANA7777: folds 
herkko11: folds 
ZhukOFFskI: folds 
Uncalled bet ($0.50) returned to chiyuki
chiyuki collected $0.60 from pot
chiyuki: doesn't show hand 
*** SUMMARY ***
Total pot $0.60 | Rake $0 
Seat 1: WARIBANA7777 (button) folded before Flop (didn't bet)
Seat 2: herkko11 (small blind) folded before Flop
Seat 3: ZhukOFFskI (big blind) folded before Flop
Seat 4: slapshot2011 folded before Flop (didn't bet)
Seat 5: chiyuki collected ($0.60)
Seat 6: phate-1up folded before Flop (didn't bet)
Seat 7: Serge Claws folded before Flop (didn't bet)
Seat 8: kamikkaze folded before Flop (didn't bet)
Seat 9: risekuku468 folded before Flop (didn't bet)



PokerStars Zoom Hand #84300636215:  Hold'em No Limit ($0.10/$0.25) - 2012/08/05 15:41:13 JST [2012/08/05 2:41:13 ET]
Table 'Whirlpool' 9-max Seat #1 is the button
Seat 1: jacquelinewu ($73.86 in chips) 
Seat 2: seula i ($28.61 in chips) 
Seat 3: INSP!RON ($39.59 in chips) 
Seat 4: KeLevro0 ($9.48 in chips) 
Seat 5: KrystalAA ($21.80 in chips) 
Seat 6: Roglus ($13.20 in chips) 
Seat 7: chiyuki ($41.54 in chips) 
Seat 8: kesstukas25 ($14.10 in chips) 
Seat 9: DutchShultzs ($25 in chips) 
seula i: posts small blind $0.10
INSP!RON: posts big blind $0.25
*** HOLE CARDS ***
Dealt to chiyuki [2s Qh]
KeLevro0: folds 
KrystalAA: folds 
Roglus: raises $0.62 to $0.87
chiyuki: folds 
kesstukas25: folds 
DutchShultzs: folds 
jacquelinewu: folds 
seula i: folds 
INSP!RON: folds 
Uncalled bet ($0.62) returned to Roglus
Roglus collected $0.60 from pot
Roglus: doesn't show hand 
*** SUMMARY ***
Total pot $0.60 | Rake $0 
Seat 1: jacquelinewu (button) folded before Flop (didn't bet)
Seat 2: seula i (small blind) folded before Flop
Seat 3: INSP!RON (big blind) folded before Flop
Seat 4: KeLevro0 folded before Flop (didn't bet)
Seat 5: KrystalAA folded before Flop (didn't bet)
Seat 6: Roglus collected ($0.60)
Seat 7: chiyuki folded before Flop (didn't bet)
Seat 8: kesstukas25 folded before Flop (didn't bet)
Seat 9: DutchShultzs folded before Flop (didn't bet)



PokerStars Zoom Hand #84300639430:  Hold'em No Limit ($0.10/$0.25) - 2012/08/05 15:41:26 JST [2012/08/05 2:41:26 ET]
Table 'Whirlpool' 9-max Seat #1 is the button
Seat 1: chiyuki ($41.44 in chips) 
Seat 2: Trip_Krowns ($24.75 in chips) 
Seat 3: nice.franki ($8.65 in chips) 
Seat 4: pawn909 ($14.40 in chips) 
Seat 5: snejokCoxx ($20.29 in chips) 
Seat 6: 1Karina1 ($32.03 in chips) 
Seat 7: Saruotiss ($62.21 in chips) 
Seat 8: GovGus ($29.60 in chips) 
Seat 9: Dan Royal ($35.69 in chips) 
Trip_Krowns: posts small blind $0.10
nice.franki: posts big blind $0.25
*** HOLE CARDS ***
Dealt to chiyuki [2h 9d]
pawn909: folds 
snejokCoxx: raises $0.45 to $0.70
1Karina1: folds 
Saruotiss: folds 
GovGus: folds 
Dan Royal: folds 
chiyuki: folds 
Trip_Krowns: folds 
nice.franki: folds 
Uncalled bet ($0.45) returned to snejokCoxx
snejokCoxx collected $0.60 from pot
snejokCoxx: doesn't show hand 
*** SUMMARY ***
Total pot $0.60 | Rake $0 
Seat 1: chiyuki (button) folded before Flop (didn't bet)
Seat 2: Trip_Krowns (small blind) folded before Flop
Seat 3: nice.franki (big blind) folded before Flop
Seat 4: pawn909 folded before Flop (didn't bet)
Seat 5: snejokCoxx collected ($0.60)
Seat 6: 1Karina1 folded before Flop (didn't bet)
Seat 7: Saruotiss folded before Flop (didn't bet)
Seat 8: GovGus folded before Flop (didn't bet)
Seat 9: Dan Royal folded before Flop (didn't bet)



PokerStars Zoom Hand #84300637200:  Hold'em No Limit ($0.10/$0.25) - 2012/08/05 15:41:17 JST [2012/08/05 2:41:17 ET]
Table 'Whirlpool' 9-max Seat #1 is the button
Seat 1: romanian c4 ($20.35 in chips) 
Seat 2: KeLevro0 ($9.48 in chips) 
Seat 3: kesstukas25 ($14.10 in chips) 
Seat 4: chiyuki ($41.54 in chips) 
Seat 5: Faraz ($19.22 in chips) 
Seat 6: DutchShultzs ($25 in chips) 
Seat 7: masterkoolb ($13.16 in chips) 
Seat 8: hldtom ($25.98 in chips) 
Seat 9: Saruotiss ($62.21 in chips) 
KeLevro0: posts small blind $0.10
kesstukas25: posts big blind $0.25
*** HOLE CARDS ***
Dealt to chiyuki [9d 6d]
chiyuki: folds 
Faraz: folds 
DutchShultzs: folds 
masterkoolb: folds 
hldtom: folds 
Saruotiss: folds 
romanian c4: folds 
KeLevro0: raises $0.42 to $0.67
kesstukas25: folds 
Uncalled bet ($0.42) returned to KeLevro0
KeLevro0 collected $0.50 from pot
KeLevro0: doesn't show hand 
*** SUMMARY ***
Total pot $0.50 | Rake $0 
Seat 1: romanian c4 (button) folded before Flop (didn't bet)
Seat 2: KeLevro0 (small blind) collected ($0.50)
Seat 3: kesstukas25 (big blind) folded before Flop
Seat 4: chiyuki folded before Flop (didn't bet)
Seat 5: Faraz folded before Flop (didn't bet)
Seat 6: DutchShultzs folded before Flop (didn't bet)
Seat 7: masterkoolb folded before Flop (didn't bet)
Seat 8: hldtom folded before Flop (didn't bet)
Seat 9: Saruotiss folded before Flop (didn't bet)



PokerStars Zoom Hand #84300637979:  Hold'em No Limit ($0.10/$0.25) - 2012/08/05 15:41:20 JST [2012/08/05 2:41:20 ET]
Table 'Whirlpool' 9-max Seat #1 is the button
Seat 1: yvasilik ($20.50 in chips) 
Seat 2: chiyuki ($41.54 in chips) 
Seat 3: aivvo ($9.70 in chips) 
Seat 4: KrystalAA ($10.71 in chips) 
Seat 5: KeLevro0 ($9.51 in chips) 
Seat 6: nastya040 ($9.43 in chips) 
Seat 7: kamikkaze ($12.90 in chips) 
Seat 8: westhavenbc ($19.60 in chips) 
Seat 9: phate-1up ($38.28 in chips) 
chiyuki: posts small blind $0.10
aivvo: posts big blind $0.25
*** HOLE CARDS ***
Dealt to chiyuki [9s 7d]
KrystalAA: folds 
KeLevro0: folds 
nastya040: folds 
kamikkaze: folds 
westhavenbc: raises $0.25 to $0.50
phate-1up: raises $1 to $1.50
yvasilik: folds 
chiyuki: folds 
aivvo: folds 
westhavenbc: calls $1
*** FLOP *** [8s 9h Tc]
westhavenbc: checks 
phate-1up: bets $2
westhavenbc: folds 
Uncalled bet ($2) returned to phate-1up
phate-1up collected $3.20 from pot
phate-1up: doesn't show hand 
*** SUMMARY ***
Total pot $3.35 | Rake $0.15 
Board [8s 9h Tc]
Seat 1: yvasilik (button) folded before Flop (didn't bet)
Seat 2: chiyuki (small blind) folded before Flop
Seat 3: aivvo (big blind) folded before Flop
Seat 4: KrystalAA folded before Flop (didn't bet)
Seat 5: KeLevro0 folded before Flop (didn't bet)
Seat 6: nastya040 folded before Flop (didn't bet)
Seat 7: kamikkaze folded before Flop (didn't bet)
Seat 8: westhavenbc folded on the Flop
Seat 9: phate-1up collected ($3.20)



PokerStars Zoom Hand #84300605924:  Hold'em No Limit ($0.10/$0.25) - 2012/08/05 15:39:14 JST [2012/08/05 2:39:14 ET]
Table 'Whirlpool' 9-max Seat #1 is the button
Seat 1: Perstenev ($8.49 in chips) 
Seat 2: westhavenbc ($20.10 in chips) 
Seat 3: phate-1up ($51.12 in chips) 
Seat 4: chiyuki ($41.54 in chips) 
Seat 5: macmauret ($13.75 in chips) 
Seat 6: God)Squall ($32.29 in chips) 
Seat 7: DutchShultzs ($46.96 in chips) 
Seat 8: genamator ($19.96 in chips) 
Seat 9: NENE54 ($19.45 in chips) 
westhavenbc: posts small blind $0.10
phate-1up: posts big blind $0.25
*** HOLE CARDS ***
Dealt to chiyuki [9s 3d]
chiyuki: folds 
macmauret: folds 
God)Squall: folds 
DutchShultzs: folds 
genamator: folds 
NENE54: calls $0.25
Perstenev: calls $0.25
westhavenbc: calls $0.15
phate-1up: checks 
*** FLOP *** [2c Jd 6h]
westhavenbc: checks 
phate-1up: checks 
NENE54: bets $0.25
Perstenev: calls $0.25
westhavenbc: calls $0.25
phate-1up: folds 
*** TURN *** [2c Jd 6h] [Tc]
westhavenbc: checks 
NENE54: checks 
Perstenev: checks 
*** RIVER *** [2c Jd 6h Tc] [Ad]
westhavenbc: checks 
NENE54: bets $1.25
Perstenev is disconnected 
Perstenev is connected 
Perstenev: folds 
westhavenbc: folds 
Uncalled bet ($1.25) returned to NENE54
NENE54 collected $1.67 from pot
NENE54: doesn't show hand 
*** SUMMARY ***
Total pot $1.75 | Rake $0.08 
Board [2c Jd 6h Tc Ad]
Seat 1: Perstenev (button) folded on the River
Seat 2: westhavenbc (small blind) folded on the River
Seat 3: phate-1up (big blind) folded on the Flop
Seat 4: chiyuki folded before Flop (didn't bet)
Seat 5: macmauret folded before Flop (didn't bet)
Seat 6: God)Squall folded before Flop (didn't bet)
Seat 7: DutchShultzs folded before Flop (didn't bet)
Seat 8: genamator folded before Flop (didn't bet)
Seat 9: NENE54 collected ($1.67)



PokerStars Zoom Hand #84300640688:  Hold'em No Limit ($0.10/$0.25) - 2012/08/05 15:41:32 JST [2012/08/05 2:41:32 ET]
Table 'Whirlpool' 9-max Seat #1 is the button
Seat 1: risekuku468 ($28.29 in chips) 
Seat 2: jvds114 ($25 in chips) 
Seat 3: NuMetal88 ($38.79 in chips) 
Seat 4: aivvo ($9.45 in chips) 
Seat 5: Ellen1947 ($29.83 in chips) 
Seat 6: seula i ($25.40 in chips) 
Seat 7: chiyuki ($41.44 in chips) 
Seat 8: hldtom ($12.50 in chips) 
Seat 9: ViTiV2010 ($11.88 in chips) 
jvds114: posts small blind $0.10
NuMetal88: posts big blind $0.25
*** HOLE CARDS ***
Dealt to chiyuki [Ts Kd]
aivvo: folds 
Ellen1947: folds 
seula i: folds 
chiyuki: folds 
hldtom: raises $0.50 to $0.75
ViTiV2010: folds 
risekuku468: folds 
jvds114: folds 
NuMetal88: folds 
Uncalled bet ($0.50) returned to hldtom
hldtom collected $0.60 from pot
hldtom: doesn't show hand 
*** SUMMARY ***
Total pot $0.60 | Rake $0 
Seat 1: risekuku468 (button) folded before Flop (didn't bet)
Seat 2: jvds114 (small blind) folded before Flop
Seat 3: NuMetal88 (big blind) folded before Flop
Seat 4: aivvo folded before Flop (didn't bet)
Seat 5: Ellen1947 folded before Flop (didn't bet)
Seat 6: seula i folded before Flop (didn't bet)
Seat 7: chiyuki folded before Flop (didn't bet)
Seat 8: hldtom collected ($0.60)
Seat 9: ViTiV2010 folded before Flop (didn't bet)



PokerStars Zoom Hand #84300649534:  Hold'em No Limit ($0.10/$0.25) - 2012/08/05 15:42:06 JST [2012/08/05 2:42:06 ET]
Table 'Whirlpool' 9-max Seat #1 is the button
Seat 1: banderas761 ($22.20 in chips) 
Seat 2: kwkim73 ($25.37 in chips) 
Seat 3: jvds114 ($25 in chips) 
Seat 4: 4ydo yogurt ($26.81 in chips) 
Seat 5: DutchShultzs ($46.61 in chips) 
Seat 6: chiyuki ($41.19 in chips) 
Seat 7: Ellen1947 ($22.50 in chips) 
Seat 8: GovGus ($43.25 in chips) 
Seat 9: svg51 ($6.37 in chips) 
kwkim73: posts small blind $0.10
jvds114: posts big blind $0.25
*** HOLE CARDS ***
Dealt to chiyuki [Td 2d]
4ydo yogurt: folds 
DutchShultzs: folds 
chiyuki: folds 
Ellen1947: folds 
GovGus: raises $0.75 to $1
svg51: folds 
banderas761: folds 
kwkim73: folds 
jvds114: folds 
Uncalled bet ($0.75) returned to GovGus
GovGus collected $0.60 from pot
GovGus: doesn't show hand 
*** SUMMARY ***
Total pot $0.60 | Rake $0 
Seat 1: banderas761 (button) folded before Flop (didn't bet)
Seat 2: kwkim73 (small blind) folded before Flop
Seat 3: jvds114 (big blind) folded before Flop
Seat 4: 4ydo yogurt folded before Flop (didn't bet)
Seat 5: DutchShultzs folded before Flop (didn't bet)
Seat 6: chiyuki folded before Flop (didn't bet)
Seat 7: Ellen1947 folded before Flop (didn't bet)
Seat 8: GovGus collected ($0.60)
Seat 9: svg51 folded before Flop (didn't bet)



PokerStars Zoom Hand #84300651046:  Hold'em No Limit ($0.10/$0.25) - 2012/08/05 15:42:12 JST [2012/08/05 2:42:12 ET]
Table 'Whirlpool' 9-max Seat #1 is the button
Seat 1: opie62 ($18.57 in chips) 
Seat 2: kwkim73 ($25.10 in chips) 
Seat 3: ChrisCDee ($37.44 in chips) 
Seat 4: chiyuki ($41.19 in chips) 
Seat 5: Grishukps ($12.50 in chips) 
Seat 6: Vahe50 ($22.83 in chips) 
Seat 7: 1Karina1 ($36.42 in chips) 
Seat 8: Rilko1975 ($29.22 in chips) 
Seat 9: phate-1up ($57.70 in chips) 
kwkim73: posts small blind $0.10
ChrisCDee: posts big blind $0.25
*** HOLE CARDS ***
Dealt to chiyuki [3h 4h]
chiyuki: folds 
Grishukps: raises $0.50 to $0.75
Vahe50: folds 
1Karina1: folds 
Rilko1975: folds 
phate-1up: folds 
opie62: folds 
kwkim73: folds 
ChrisCDee: folds 
Uncalled bet ($0.50) returned to Grishukps
Grishukps collected $0.60 from pot
Grishukps: doesn't show hand 
*** SUMMARY ***
Total pot $0.60 | Rake $0 
Seat 1: opie62 (button) folded before Flop (didn't bet)
Seat 2: kwkim73 (small blind) folded before Flop
Seat 3: ChrisCDee (big blind) folded before Flop
Seat 4: chiyuki folded before Flop (didn't bet)
Seat 5: Grishukps collected ($0.60)
Seat 6: Vahe50 folded before Flop (didn't bet)
Seat 7: 1Karina1 folded before Flop (didn't bet)
Seat 8: Rilko1975 folded before Flop (didn't bet)
Seat 9: phate-1up folded before Flop (didn't bet)



PokerStars Zoom Hand #84300641959:  Hold'em No Limit ($0.10/$0.25) - 2012/08/05 15:41:37 JST [2012/08/05 2:41:37 ET]
Table 'Whirlpool' 9-max Seat #1 is the button
Seat 1: Grishukps ($12.50 in chips) 
Seat 2: aivvo ($9.45 in chips) 
Seat 3: chiyuki ($41.44 in chips) 
Seat 4: Ellen1947 ($29.83 in chips) 
Seat 5: jacquelinewu ($73.86 in chips) 
Seat 6: River_GmbH ($13.35 in chips) 
Seat 7: 1Karina1 ($36.66 in chips) 
Seat 8: Saruotiss ($62.21 in chips) 
Seat 9: Faantomace ($28.04 in chips) 
aivvo: posts small blind $0.10
chiyuki: posts big blind $0.25
*** HOLE CARDS ***
Dealt to chiyuki [Ah Js]
Ellen1947: folds 
jacquelinewu: raises $0.50 to $0.75
River_GmbH: folds 
1Karina1: folds 
Saruotiss: folds 
Faantomace: calls $0.75
Grishukps: folds 
aivvo: folds 
chiyuki: folds 
*** FLOP *** [Qd 6c As]
jacquelinewu: bets $1.23
Faantomace: calls $1.23
*** TURN *** [Qd 6c As] [Kd]
jacquelinewu: bets $0.25
Faantomace: calls $0.25
*** RIVER *** [Qd 6c As Kd] [Qs]
jacquelinewu: checks 
Faantomace: bets $3.50
jacquelinewu: folds 
Uncalled bet ($3.50) returned to Faantomace
Faantomace collected $4.59 from pot
Faantomace: doesn't show hand 
*** SUMMARY ***
Total pot $4.81 | Rake $0.22 
Board [Qd 6c As Kd Qs]
Seat 1: Grishukps (button) folded before Flop (didn't bet)
Seat 2: aivvo (small blind) folded before Flop
Seat 3: chiyuki (big blind) folded before Flop
Seat 4: Ellen1947 folded before Flop (didn't bet)
Seat 5: jacquelinewu folded on the River
Seat 6: River_GmbH folded before Flop (didn't bet)
Seat 7: 1Karina1 folded before Flop (didn't bet)
Seat 8: Saruotiss folded before Flop (didn't bet)
Seat 9: Faantomace collected ($4.59)



PokerStars Zoom Hand #84300647764:  Hold'em No Limit ($0.10/$0.25) - 2012/08/05 15:42:00 JST [2012/08/05 2:42:00 ET]
Table 'Whirlpool' 9-max Seat #1 is the button
Seat 1: NENE54 ($20.62 in chips) 
Seat 2: Limoilou ($34.07 in chips) 
Seat 3: 1Karina1 ($36.66 in chips) 
Seat 4: kamikkaze ($13.25 in chips) 
Seat 5: GovGus ($43.25 in chips) 
Seat 6: hldtom ($12.85 in chips) 
Seat 7: masterkoolb ($14.96 in chips) 
Seat 8: chiyuki ($41.19 in chips) 
Seat 9: nice.franki ($11.75 in chips) 
Limoilou: posts small blind $0.10
1Karina1: posts big blind $0.25
*** HOLE CARDS ***
Dealt to chiyuki [5d 3c]
kamikkaze: folds 
GovGus: folds 
hldtom: raises $0.50 to $0.75
masterkoolb: folds 
chiyuki: folds 
nice.franki has timed out
nice.franki: folds 
NENE54: folds 
Limoilou: folds 
1Karina1: calls $0.50
*** FLOP *** [8c Tc Ad]
1Karina1: checks 
hldtom: bets $1.16
1Karina1: folds 
Uncalled bet ($1.16) returned to hldtom
hldtom collected $1.53 from pot
hldtom: doesn't show hand 
*** SUMMARY ***
Total pot $1.60 | Rake $0.07 
Board [8c Tc Ad]
Seat 1: NENE54 (button) folded before Flop (didn't bet)
Seat 2: Limoilou (small blind) folded before Flop
Seat 3: 1Karina1 (big blind) folded on the Flop
Seat 4: kamikkaze folded before Flop (didn't bet)
Seat 5: GovGus folded before Flop (didn't bet)
Seat 6: hldtom collected ($1.53)
Seat 7: masterkoolb folded before Flop (didn't bet)
Seat 8: chiyuki folded before Flop (didn't bet)
Seat 9: nice.franki folded before Flop (didn't bet)



PokerStars Zoom Hand #84300653755:  Hold'em No Limit ($0.10/$0.25) - 2012/08/05 15:42:23 JST [2012/08/05 2:42:23 ET]
Table 'Whirlpool' 9-max Seat #1 is the button
Seat 1: Alvinpe85 ($44.89 in chips) 
Seat 2: kamikkaze ($13 in chips) 
Seat 3: KeLevro0 ($9.73 in chips) 
Seat 4: Perstenev ($7.85 in chips) 
Seat 5: Gichboy ($31.53 in chips) 
Seat 6: phate-1up ($69.10 in chips) 
Seat 7: INSP!RON ($37.70 in chips) 
Seat 8: silvno31 ($67.04 in chips) 
Seat 9: chiyuki ($41.09 in chips) 
kamikkaze: posts small blind $0.10
KeLevro0: posts big blind $0.25
*** HOLE CARDS ***
Dealt to chiyuki [3h 4c]
Perstenev: folds 
Gichboy: folds 
phate-1up: folds 
INSP!RON: folds 
silvno31: folds 
chiyuki: folds 
Alvinpe85: raises $0.37 to $0.62
kamikkaze: calls $0.52
KeLevro0: folds 
*** FLOP *** [Kd 2h Ah]
kamikkaze: checks 
Alvinpe85: bets $1
kamikkaze: folds 
Uncalled bet ($1) returned to Alvinpe85
Alvinpe85 collected $1.42 from pot
Alvinpe85: doesn't show hand 
*** SUMMARY ***
Total pot $1.49 | Rake $0.07 
Board [Kd 2h Ah]
Seat 1: Alvinpe85 (button) collected ($1.42)
Seat 2: kamikkaze (small blind) folded on the Flop
Seat 3: KeLevro0 (big blind) folded before Flop
Seat 4: Perstenev folded before Flop (didn't bet)
Seat 5: Gichboy folded before Flop (didn't bet)
Seat 6: phate-1up folded before Flop (didn't bet)
Seat 7: INSP!RON folded before Flop (didn't bet)
Seat 8: silvno31 folded before Flop (didn't bet)
Seat 9: chiyuki folded before Flop (didn't bet)



PokerStars Zoom Hand #84300658850:  Hold'em No Limit ($0.10/$0.25) - 2012/08/05 15:42:44 JST [2012/08/05 2:42:44 ET]
Table 'Whirlpool' 9-max Seat #1 is the button
Seat 1: KeLevro0 ($8.98 in chips) 
Seat 2: Nerkit ($16.14 in chips) 
Seat 3: ZhukOFFskI ($64.40 in chips) 
Seat 4: GSDP ($48.75 in chips) 
Seat 5: DutchShultzs ($25 in chips) 
Seat 6: chiyuki ($41.09 in chips) 
Seat 7: Alvinpe85 ($56.74 in chips) 
Seat 8: Fructionar ($32.76 in chips) 
Seat 9: banderas761 ($22.10 in chips) 
Nerkit: posts small blind $0.10
ZhukOFFskI: posts big blind $0.25
*** HOLE CARDS ***
Dealt to chiyuki [Qs 3s]
GSDP: folds 
DutchShultzs: folds 
chiyuki: folds 
Alvinpe85: folds 
Fructionar: folds 
banderas761: folds 
KeLevro0: folds 
Nerkit: folds 
Uncalled bet ($0.15) returned to ZhukOFFskI
ZhukOFFskI collected $0.20 from pot
ZhukOFFskI: doesn't show hand 
*** SUMMARY ***
Total pot $0.20 | Rake $0 
Seat 1: KeLevro0 (button) folded before Flop (didn't bet)
Seat 2: Nerkit (small blind) folded before Flop
Seat 3: ZhukOFFskI (big blind) collected ($0.20)
Seat 4: GSDP folded before Flop (didn't bet)
Seat 5: DutchShultzs folded before Flop (didn't bet)
Seat 6: chiyuki folded before Flop (didn't bet)
Seat 7: Alvinpe85 folded before Flop (didn't bet)
Seat 8: Fructionar folded before Flop (didn't bet)
Seat 9: banderas761 folded before Flop (didn't bet)



PokerStars Zoom Hand #84300654797:  Hold'em No Limit ($0.10/$0.25) - 2012/08/05 15:42:27 JST [2012/08/05 2:42:27 ET]
Table 'Whirlpool' 9-max Seat #1 is the button
Seat 1: 1Karina1 ($26.10 in chips) 
Seat 2: GovGus ($27.35 in chips) 
Seat 3: Dejacob ($25 in chips) 
Seat 4: INSP!RON ($37.70 in chips) 
Seat 5: svg51 ($6.37 in chips) 
Seat 6: GSDP ($24.69 in chips) 
Seat 7: Silveystryk ($20.82 in chips) 
Seat 8: chiyuki ($41.09 in chips) 
Seat 9: kesstukas25 ($13.85 in chips) 
GovGus: posts small blind $0.10
Dejacob: posts big blind $0.25
*** HOLE CARDS ***
Dealt to chiyuki [4s 5s]
INSP!RON: folds 
svg51: folds 
GSDP: folds 
Silveystryk: folds 
chiyuki: folds 
kesstukas25: raises $0.50 to $0.75
1Karina1: folds 
GovGus: folds 
Dejacob: raises $1.75 to $2.50
kesstukas25: raises $3 to $5.50
Dejacob: folds 
Uncalled bet ($3) returned to kesstukas25
kesstukas25 collected $5.10 from pot
kesstukas25: doesn't show hand 
*** SUMMARY ***
Total pot $5.10 | Rake $0 
Seat 1: 1Karina1 (button) folded before Flop (didn't bet)
Seat 2: GovGus (small blind) folded before Flop
Seat 3: Dejacob (big blind) folded before Flop
Seat 4: INSP!RON folded before Flop (didn't bet)
Seat 5: svg51 folded before Flop (didn't bet)
Seat 6: GSDP folded before Flop (didn't bet)
Seat 7: Silveystryk folded before Flop (didn't bet)
Seat 8: chiyuki folded before Flop (didn't bet)
Seat 9: kesstukas25 collected ($5.10)



PokerStars Zoom Hand #84300652024:  Hold'em No Limit ($0.10/$0.25) - 2012/08/05 15:42:16 JST [2012/08/05 2:42:16 ET]
Table 'Whirlpool' 9-max Seat #1 is the button
Seat 1: KrystalAA ($10.36 in chips) 
Seat 2: chiyuki ($41.19 in chips) 
Seat 3: jacquelinewu ($28.98 in chips) 
Seat 4: God)Squall ($36.26 in chips) 
Seat 5: GSDP ($48.85 in chips) 
Seat 6: ZhukOFFskI ($64.40 in chips) 
Seat 7: TorTrade ($28.14 in chips) 
Seat 8: seula i ($28.51 in chips) 
Seat 9: kkbruins0408 ($18.69 in chips) 
chiyuki: posts small blind $0.10
jacquelinewu: posts big blind $0.25
*** HOLE CARDS ***
Dealt to chiyuki [3d 8c]
God)Squall: folds 
GSDP: folds 
ZhukOFFskI: folds 
TorTrade: folds 
seula i: folds 
kkbruins0408: calls $0.25
KrystalAA: folds 
chiyuki: folds 
jacquelinewu: raises $0.75 to $1
kkbruins0408: calls $0.75
*** FLOP *** [As 9h 5h]
jacquelinewu: checks 
kkbruins0408: bets $2.25
jacquelinewu: calls $2.25
*** TURN *** [As 9h 5h] [8d]
jacquelinewu: checks 
kkbruins0408: checks 
*** RIVER *** [As 9h 5h 8d] [5d]
jacquelinewu: checks 
kkbruins0408: bets $2.25
jacquelinewu: folds 
Uncalled bet ($2.25) returned to kkbruins0408
kkbruins0408 collected $6.30 from pot
kkbruins0408: doesn't show hand 
*** SUMMARY ***
Total pot $6.60 | Rake $0.30 
Board [As 9h 5h 8d 5d]
Seat 1: KrystalAA (button) folded before Flop (didn't bet)
Seat 2: chiyuki (small blind) folded before Flop
Seat 3: jacquelinewu (big blind) folded on the River
Seat 4: God)Squall folded before Flop (didn't bet)
Seat 5: GSDP folded before Flop (didn't bet)
Seat 6: ZhukOFFskI folded before Flop (didn't bet)
Seat 7: TorTrade folded before Flop (didn't bet)
Seat 8: seula i folded before Flop (didn't bet)
Seat 9: kkbruins0408 collected ($6.30)



PokerStars Zoom Hand #84300659603:  Hold'em No Limit ($0.10/$0.25) - 2012/08/05 15:42:47 JST [2012/08/05 2:42:47 ET]
Table 'Whirlpool' 9-max Seat #1 is the button
Seat 1: ChrisCDee ($64.53 in chips) 
Seat 2: Grishukps ($12.50 in chips) 
Seat 3: chiyuki ($41.09 in chips) 
Seat 4: kamikkaze ($18.85 in chips) 
Seat 5: nice.franki ($14.43 in chips) 
Seat 6: masterkoolb ($14.61 in chips) 
Seat 7: nastya040 ($8.08 in chips) 
Seat 8: Dejacob ($25 in chips) 
Seat 9: Roglus ($19.01 in chips) 
Grishukps: posts small blind $0.10
chiyuki: posts big blind $0.25
*** HOLE CARDS ***
Dealt to chiyuki [Qd Kh]
kamikkaze: folds 
nice.franki: folds 
masterkoolb: folds 
nastya040: folds 
Dejacob: raises $0.50 to $0.75
Roglus: folds 
ChrisCDee: calls $0.75
Grishukps: folds 
chiyuki: folds 
*** FLOP *** [Kc 9c 7h]
Dejacob: checks 
ChrisCDee: bets $1.25
Dejacob: folds 
Uncalled bet ($1.25) returned to ChrisCDee
ChrisCDee collected $1.77 from pot
ChrisCDee: doesn't show hand 
*** SUMMARY ***
Total pot $1.85 | Rake $0.08 
Board [Kc 9c 7h]
Seat 1: ChrisCDee (button) collected ($1.77)
Seat 2: Grishukps (small blind) folded before Flop
Seat 3: chiyuki (big blind) folded before Flop
Seat 4: kamikkaze folded before Flop (didn't bet)
Seat 5: nice.franki folded before Flop (didn't bet)
Seat 6: masterkoolb folded before Flop (didn't bet)
Seat 7: nastya040 folded before Flop (didn't bet)
Seat 8: Dejacob folded on the Flop
Seat 9: Roglus folded before Flop (didn't bet)



PokerStars Zoom Hand #84300657638:  Hold'em No Limit ($0.10/$0.25) - 2012/08/05 15:42:38 JST [2012/08/05 2:42:38 ET]
Table 'Whirlpool' 9-max Seat #1 is the button
Seat 1: chiyuki ($41.09 in chips) 
Seat 2: Silveystryk ($37.45 in chips) 
Seat 3: 1Karina1 ($36.42 in chips) 
Seat 4: God)Squall ($36.16 in chips) 
Seat 5: ZhukOFFskI ($64.40 in chips) 
Seat 6: laurentzu84 ($25.35 in chips) 
Seat 7: masterkoolb ($14.71 in chips) 
Seat 8: seula i ($25.30 in chips) 
Seat 9: slapshot2011 ($9.59 in chips) 
Silveystryk: posts small blind $0.10
1Karina1: posts big blind $0.25
*** HOLE CARDS ***
Dealt to chiyuki [Ah 4d]
God)Squall: raises $0.50 to $0.75
ZhukOFFskI: folds 
laurentzu84: folds 
masterkoolb: folds 
seula i: calls $0.75
slapshot2011: folds 
chiyuki: folds 
Silveystryk: folds 
1Karina1: folds 
*** FLOP *** [Ks Kd 3s]
God)Squall: checks 
seula i: bets $1.75
God)Squall: calls $1.75
*** TURN *** [Ks Kd 3s] [8h]
God)Squall: checks 
seula i: bets $3.50
God)Squall: folds 
Uncalled bet ($3.50) returned to seula i
seula i collected $5.11 from pot
seula i: doesn't show hand 
*** SUMMARY ***
Total pot $5.35 | Rake $0.24 
Board [Ks Kd 3s 8h]
Seat 1: chiyuki (button) folded before Flop (didn't bet)
Seat 2: Silveystryk (small blind) folded before Flop
Seat 3: 1Karina1 (big blind) folded before Flop
Seat 4: God)Squall folded on the Turn
Seat 5: ZhukOFFskI folded before Flop (didn't bet)
Seat 6: laurentzu84 folded before Flop (didn't bet)
Seat 7: masterkoolb folded before Flop (didn't bet)
Seat 8: seula i collected ($5.11)
Seat 9: slapshot2011 folded before Flop (didn't bet)



PokerStars Zoom Hand #84300665912:  Hold'em No Limit ($0.10/$0.25) - 2012/08/05 15:43:12 JST [2012/08/05 2:43:12 ET]
Table 'Whirlpool' 9-max Seat #1 is the button
Seat 1: herkko11 ($5.85 in chips) 
Seat 2: Grishukps ($13.27 in chips) 
Seat 3: nice.franki ($11.65 in chips) 
Seat 4: ZhukOFFskI ($64.40 in chips) 
Seat 5: AntoineHunt ($41.59 in chips) 
Seat 6: kamikkaze ($18.75 in chips) 
Seat 7: chiyuki ($40.84 in chips) 
Seat 8: mjmichi ($37.19 in chips) 
Seat 9: masterkoolb ($13.86 in chips) 
Grishukps: posts small blind $0.10
nice.franki: posts big blind $0.25
*** HOLE CARDS ***
Dealt to chiyuki [6s Qs]
ZhukOFFskI: folds 
AntoineHunt: folds 
kamikkaze: folds 
chiyuki: folds 
mjmichi: raises $0.50 to $0.75
masterkoolb: folds 
herkko11: folds 
Grishukps: folds 
nice.franki: folds 
Uncalled bet ($0.50) returned to mjmichi
mjmichi collected $0.60 from pot
mjmichi: doesn't show hand 
*** SUMMARY ***
Total pot $0.60 | Rake $0 
Seat 1: herkko11 (button) folded before Flop (didn't bet)
Seat 2: Grishukps (small blind) folded before Flop
Seat 3: nice.franki (big blind) folded before Flop
Seat 4: ZhukOFFskI folded before Flop (didn't bet)
Seat 5: AntoineHunt folded before Flop (didn't bet)
Seat 6: kamikkaze folded before Flop (didn't bet)
Seat 7: chiyuki folded before Flop (didn't bet)
Seat 8: mjmichi collected ($0.60)
Seat 9: masterkoolb folded before Flop (didn't bet)



PokerStars Zoom Hand #84300670857:  Hold'em No Limit ($0.10/$0.25) - 2012/08/05 15:43:31 JST [2012/08/05 2:43:31 ET]
Table 'Whirlpool' 9-max Seat #1 is the button
Seat 1: Rici47 ($29.54 in chips) 
Seat 2: ShaninPeter ($11.50 in chips) 
Seat 3: Kasperlmusik ($25 in chips) 
Seat 4: Perstenev ($9.13 in chips) 
Seat 5: seula i ($27.91 in chips) 
Seat 6: chiyuki ($40.84 in chips) 
Seat 7: phate-1up ($69.10 in chips) 
Seat 8: GovGus ($43.60 in chips) 
Seat 9: GSDP ($49.10 in chips) 
ShaninPeter: posts small blind $0.10
Kasperlmusik: posts big blind $0.25
*** HOLE CARDS ***
Dealt to chiyuki [Ts 4s]
Perstenev: folds 
seula i: folds 
chiyuki: folds 
phate-1up: folds 
GovGus: folds 
GSDP: folds 
Rici47: folds 
ShaninPeter: raises $0.50 to $0.75
Kasperlmusik: folds 
Uncalled bet ($0.50) returned to ShaninPeter
ShaninPeter collected $0.50 from pot
ShaninPeter: doesn't show hand 
*** SUMMARY ***
Total pot $0.50 | Rake $0 
Seat 1: Rici47 (button) folded before Flop (didn't bet)
Seat 2: ShaninPeter (small blind) collected ($0.50)
Seat 3: Kasperlmusik (big blind) folded before Flop
Seat 4: Perstenev folded before Flop (didn't bet)
Seat 5: seula i folded before Flop (didn't bet)
Seat 6: chiyuki folded before Flop (didn't bet)
Seat 7: phate-1up folded before Flop (didn't bet)
Seat 8: GovGus folded before Flop (didn't bet)
Seat 9: GSDP folded before Flop (didn't bet)



PokerStars Zoom Hand #84300678232:  Hold'em No Limit ($0.10/$0.25) - 2012/08/05 15:44:01 JST [2012/08/05 2:44:01 ET]
Table 'Whirlpool' 9-max Seat #1 is the button
Seat 1: INSP!RON ($38.56 in chips) 
Seat 2: DutchShultzs ($46.36 in chips) 
Seat 3: jacquelinewu ($25.79 in chips) 
Seat 4: 1Karina1 ($33.44 in chips) 
Seat 5: chiyuki ($40.74 in chips) 
Seat 6: Serge Claws ($40.55 in chips) 
Seat 7: 0 operator 0 ($32.67 in chips) 
Seat 8: snejokCoxx ($11.90 in chips) 
Seat 9: ZhukOFFskI ($39.06 in chips) 
DutchShultzs: posts small blind $0.10
jacquelinewu: posts big blind $0.25
*** HOLE CARDS ***
Dealt to chiyuki [Kh As]
1Karina1: folds 
chiyuki: raises $0.50 to $0.75
Serge Claws: folds 
0 operator 0: folds 
snejokCoxx: folds 
ZhukOFFskI: folds 
INSP!RON: folds 
DutchShultzs: folds 
jacquelinewu: folds 
Uncalled bet ($0.50) returned to chiyuki
chiyuki collected $0.60 from pot
chiyuki: doesn't show hand 
*** SUMMARY ***
Total pot $0.60 | Rake $0 
Seat 1: INSP!RON (button) folded before Flop (didn't bet)
Seat 2: DutchShultzs (small blind) folded before Flop
Seat 3: jacquelinewu (big blind) folded before Flop
Seat 4: 1Karina1 folded before Flop (didn't bet)
Seat 5: chiyuki collected ($0.60)
Seat 6: Serge Claws folded before Flop (didn't bet)
Seat 7: 0 operator 0 folded before Flop (didn't bet)
Seat 8: snejokCoxx folded before Flop (didn't bet)
Seat 9: ZhukOFFskI folded before Flop (didn't bet)



PokerStars Zoom Hand #84300667443:  Hold'em No Limit ($0.10/$0.25) - 2012/08/05 15:43:18 JST [2012/08/05 2:43:18 ET]
Table 'Whirlpool' 9-max Seat #1 is the button
Seat 1: soul_5577 ($38.15 in chips) 
Seat 2: Trip_Krowns ($24.45 in chips) 
Seat 3: leo2095 ($25.57 in chips) 
Seat 4: masterkoolb ($13.86 in chips) 
Seat 5: chiyuki ($40.84 in chips) 
Seat 6: Perstenev ($9.13 in chips) 
Seat 7: kwkim73 ($55.48 in chips) 
Seat 8: Silveystryk ($37.35 in chips) 
Seat 9: hldtom ($32.76 in chips) 
Trip_Krowns: posts small blind $0.10
leo2095: posts big blind $0.25
*** HOLE CARDS ***
Dealt to chiyuki [Qc 2d]
masterkoolb: folds 
chiyuki: folds 
Perstenev: folds 
kwkim73: folds 
Silveystryk: folds 
hldtom: raises $0.50 to $0.75
soul_5577: folds 
Trip_Krowns: folds 
leo2095: raises $0.50 to $1.25
hldtom: calls $0.50
*** FLOP *** [4s 2h Ac]
leo2095: bets $0.50
hldtom: calls $0.50
*** TURN *** [4s 2h Ac] [Qd]
leo2095: bets $0.50
hldtom: raises $2.22 to $2.72
leo2095: calls $2.22
*** RIVER *** [4s 2h Ac Qd] [7s]
leo2095: checks 
hldtom: checks 
*** SHOW DOWN ***
leo2095: shows [Js Ah] (a pair of Aces)
hldtom: mucks hand 
leo2095 collected $8.63 from pot
*** SUMMARY ***
Total pot $9.04 | Rake $0.41 
Board [4s 2h Ac Qd 7s]
Seat 1: soul_5577 (button) folded before Flop (didn't bet)
Seat 2: Trip_Krowns (small blind) folded before Flop
Seat 3: leo2095 (big blind) showed [Js Ah] and won ($8.63) with a pair of Aces
Seat 4: masterkoolb folded before Flop (didn't bet)
Seat 5: chiyuki folded before Flop (didn't bet)
Seat 6: Perstenev folded before Flop (didn't bet)
Seat 7: kwkim73 folded before Flop (didn't bet)
Seat 8: Silveystryk folded before Flop (didn't bet)
Seat 9: hldtom mucked [Qh 9h]



PokerStars Zoom Hand #84300673182:  Hold'em No Limit ($0.10/$0.25) - 2012/08/05 15:43:40 JST [2012/08/05 2:43:40 ET]
Table 'Whirlpool' 9-max Seat #1 is the button
Seat 1: chiyuki ($40.84 in chips) 
Seat 2: Spheroff ($20.62 in chips) 
Seat 3: DutchShultzs ($46.61 in chips) 
Seat 4: mjmichi ($37.54 in chips) 
Seat 5: GSDP ($49.10 in chips) 
Seat 6: Ozboy80 ($27.09 in chips) 
Seat 7: 1Karina1 ($33.54 in chips) 
Seat 8: masterkoolb ($16.52 in chips) 
Seat 9: Perstenev ($7.75 in chips) 
Spheroff: posts small blind $0.10
DutchShultzs: posts big blind $0.25
*** HOLE CARDS ***
Dealt to chiyuki [9h Qs]
mjmichi: folds 
GSDP: calls $0.25
Ozboy80: raises $0.50 to $0.75
1Karina1: folds 
masterkoolb: folds 
Perstenev: folds 
chiyuki: folds 
Spheroff: calls $0.65
DutchShultzs: folds 
GSDP: calls $0.50
*** FLOP *** [5c 6c Jd]
Spheroff: checks 
GSDP: bets $1.50
Ozboy80: folds 
Spheroff: folds 
Uncalled bet ($1.50) returned to GSDP
GSDP collected $2.39 from pot
GSDP: doesn't show hand 
*** SUMMARY ***
Total pot $2.50 | Rake $0.11 
Board [5c 6c Jd]
Seat 1: chiyuki (button) folded before Flop (didn't bet)
Seat 2: Spheroff (small blind) folded on the Flop
Seat 3: DutchShultzs (big blind) folded before Flop
Seat 4: mjmichi folded before Flop (didn't bet)
Seat 5: GSDP collected ($2.39)
Seat 6: Ozboy80 folded on the Flop
Seat 7: 1Karina1 folded before Flop (didn't bet)
Seat 8: masterkoolb folded before Flop (didn't bet)
Seat 9: Perstenev folded before Flop (didn't bet)



PokerStars Zoom Hand #84300674965:  Hold'em No Limit ($0.10/$0.25) - 2012/08/05 15:43:47 JST [2012/08/05 2:43:47 ET]
Table 'Whirlpool' 9-max Seat #1 is the button
Seat 1: Dejacob ($25 in chips) 
Seat 2: chiyuki ($40.84 in chips) 
Seat 3: AAAKK777 ($18.27 in chips) 
Seat 4: Fructionar ($32.76 in chips) 
Seat 5: NENE54 ($18.47 in chips) 
Seat 6: KeLevro0 ($9.16 in chips) 
Seat 7: Perstenev ($12.97 in chips) 
Seat 8: kamikkaze ($12.38 in chips) 
Seat 9: AntoineHunt ($41.69 in chips) 
chiyuki: posts small blind $0.10
AAAKK777: posts big blind $0.25
*** HOLE CARDS ***
Dealt to chiyuki [6d Kc]
Fructionar: folds 
NENE54: calls $0.25
KeLevro0: folds 
Perstenev: raises $0.75 to $1
kamikkaze: folds 
AntoineHunt: folds 
Dejacob: folds 
chiyuki: folds 
AAAKK777: raises $1 to $2
NENE54: folds 
Perstenev: calls $1
*** FLOP *** [3c As 9h]
AAAKK777: checks 
Perstenev: checks 
*** TURN *** [3c As 9h] [4h]
AAAKK777: checks 
Perstenev: bets $1.50
AAAKK777: raises $1.50 to $3
Perstenev: raises $7.97 to $10.97 and is all-in
AAAKK777: calls $7.97
*** RIVER *** [3c As 9h 4h] [7s]
*** SHOW DOWN ***
AAAKK777: shows [Js Jh] (a pair of Jacks)
Perstenev: shows [9d 9c] (three of a kind, Nines)
Perstenev collected $25.11 from pot
*** SUMMARY ***
Total pot $26.29 | Rake $1.18 
Board [3c As 9h 4h 7s]
Seat 1: Dejacob (button) folded before Flop (didn't bet)
Seat 2: chiyuki (small blind) folded before Flop
Seat 3: AAAKK777 (big blind) showed [Js Jh] and lost with a pair of Jacks
Seat 4: Fructionar folded before Flop (didn't bet)
Seat 5: NENE54 folded before Flop
Seat 6: KeLevro0 folded before Flop (didn't bet)
Seat 7: Perstenev showed [9d 9c] and won ($25.11) with three of a kind, Nines
Seat 8: kamikkaze folded before Flop (didn't bet)
Seat 9: AntoineHunt folded before Flop (didn't bet)



PokerStars Zoom Hand #84300684633:  Hold'em No Limit ($0.10/$0.25) - 2012/08/05 15:44:26 JST [2012/08/05 2:44:26 ET]
Table 'Whirlpool' 9-max Seat #1 is the button
Seat 1: DutchShultzs ($27.13 in chips) 
Seat 2: Perstenev ($8.88 in chips) 
Seat 3: chiyuki ($41.09 in chips) 
Seat 4: phate-1up ($68.35 in chips) 
Seat 5: KeLevro0 ($8.73 in chips) 
Seat 6: GovGus ($43.60 in chips) 
Seat 7: ZhukOFFskI ($65.60 in chips) 
Seat 8: kamikkaze ($18.42 in chips) 
Seat 9: nice.franki ($7.70 in chips) 
Perstenev: posts small blind $0.10
chiyuki: posts big blind $0.25
*** HOLE CARDS ***
Dealt to chiyuki [Jc 5s]
phate-1up: folds 
KeLevro0: folds 
GovGus: raises $0.75 to $1
ZhukOFFskI: folds 
kamikkaze: folds 
nice.franki: folds 
DutchShultzs: folds 
Perstenev: folds 
chiyuki: folds 
Uncalled bet ($0.75) returned to GovGus
GovGus collected $0.60 from pot
GovGus: doesn't show hand 
*** SUMMARY ***
Total pot $0.60 | Rake $0 
Seat 1: DutchShultzs (button) folded before Flop (didn't bet)
Seat 2: Perstenev (small blind) folded before Flop
Seat 3: chiyuki (big blind) folded before Flop
Seat 4: phate-1up folded before Flop (didn't bet)
Seat 5: KeLevro0 folded before Flop (didn't bet)
Seat 6: GovGus collected ($0.60)
Seat 7: ZhukOFFskI folded before Flop (didn't bet)
Seat 8: kamikkaze folded before Flop (didn't bet)
Seat 9: nice.franki folded before Flop (didn't bet)



PokerStars Zoom Hand #84300682789:  Hold'em No Limit ($0.10/$0.25) - 2012/08/05 15:44:19 JST [2012/08/05 2:44:19 ET]
Table 'Whirlpool' 9-max Seat #1 is the button
Seat 1: Spheroff ($19.87 in chips) 
Seat 2: silvno31 ($67.09 in chips) 
Seat 3: Alvinpe85 ($56.39 in chips) 
Seat 4: TorTrade ($26.04 in chips) 
Seat 5: Perstenev ($8.88 in chips) 
Seat 6: seula i ($25.41 in chips) 
Seat 7: Ozboy80 ($26.34 in chips) 
Seat 8: snejokCoxx ($13.25 in chips) 
Seat 9: chiyuki ($41.09 in chips) 
silvno31: posts small blind $0.10
Alvinpe85: posts big blind $0.25
*** HOLE CARDS ***
Dealt to chiyuki [2d Js]
TorTrade: folds 
Perstenev: folds 
seula i: raises $0.75 to $1
Ozboy80: folds 
snejokCoxx: folds 
chiyuki: folds 
Spheroff: folds 
silvno31: calls $0.90
Alvinpe85: folds 
*** FLOP *** [2c Qs Jd]
silvno31: checks 
seula i: bets $1.75
silvno31: folds 
Uncalled bet ($1.75) returned to seula i
seula i collected $2.15 from pot
seula i: doesn't show hand 
*** SUMMARY ***
Total pot $2.25 | Rake $0.10 
Board [2c Qs Jd]
Seat 1: Spheroff (button) folded before Flop (didn't bet)
Seat 2: silvno31 (small blind) folded on the Flop
Seat 3: Alvinpe85 (big blind) folded before Flop
Seat 4: TorTrade folded before Flop (didn't bet)
Seat 5: Perstenev folded before Flop (didn't bet)
Seat 6: seula i collected ($2.15)
Seat 7: Ozboy80 folded before Flop (didn't bet)
Seat 8: snejokCoxx folded before Flop (didn't bet)
Seat 9: chiyuki folded before Flop (didn't bet)



PokerStars Zoom Hand #84300693330:  Hold'em No Limit ($0.10/$0.25) - 2012/08/05 15:45:00 JST [2012/08/05 2:45:00 ET]
Table 'Whirlpool' 9-max Seat #1 is the button
Seat 1: kwkim73 ($25 in chips) 
Seat 2: Nerkit ($12.25 in chips) 
Seat 3: ChrisCDee ($62.05 in chips) 
Seat 4: Silveystryk ($24.79 in chips) 
Seat 5: Grishukps ($13.35 in chips) 
Seat 6: chiyuki ($40.84 in chips) 
Seat 7: TorTrade ($26.39 in chips) 
Seat 8: DutchShultzs ($34.86 in chips) 
Seat 9: Gichboy ($11.65 in chips) 
Nerkit: posts small blind $0.10
ChrisCDee: posts big blind $0.25
*** HOLE CARDS ***
Dealt to chiyuki [8d 8c]
Silveystryk: folds 
Grishukps: folds 
chiyuki: raises $0.50 to $0.75
TorTrade: folds 
DutchShultzs: folds 
Gichboy: folds 
kwkim73: folds 
Nerkit: folds 
ChrisCDee: folds 
Uncalled bet ($0.50) returned to chiyuki
chiyuki collected $0.60 from pot
chiyuki: doesn't show hand 
*** SUMMARY ***
Total pot $0.60 | Rake $0 
Seat 1: kwkim73 (button) folded before Flop (didn't bet)
Seat 2: Nerkit (small blind) folded before Flop
Seat 3: ChrisCDee (big blind) folded before Flop
Seat 4: Silveystryk folded before Flop (didn't bet)
Seat 5: Grishukps folded before Flop (didn't bet)
Seat 6: chiyuki collected ($0.60)
Seat 7: TorTrade folded before Flop (didn't bet)
Seat 8: DutchShultzs folded before Flop (didn't bet)
Seat 9: Gichboy folded before Flop (didn't bet)



PokerStars Zoom Hand #84300683861:  Hold'em No Limit ($0.10/$0.25) - 2012/08/05 15:44:23 JST [2012/08/05 2:44:23 ET]
Table 'Whirlpool' 9-max Seat #1 is the button
Seat 1: Saruotiss ($62.72 in chips) 
Seat 2: fwnaf ($15.10 in chips) 
Seat 3: kwkim73 ($27.14 in chips) 
Seat 4: chiyuki ($41.09 in chips) 
Seat 5: risekuku468 ($28.39 in chips) 
Seat 6: Ellen1947 ($22.25 in chips) 
Seat 7: Dejacob ($25 in chips) 
Seat 8: TorTrade ($26.04 in chips) 
Seat 9: KeLevro0 ($12.15 in chips) 
fwnaf: posts small blind $0.10
kwkim73: posts big blind $0.25
*** HOLE CARDS ***
Dealt to chiyuki [4d 8h]
chiyuki: folds 
risekuku468: folds 
Ellen1947: folds 
Dejacob: folds 
TorTrade: folds 
KeLevro0: folds 
Saruotiss: raises $0.25 to $0.50
fwnaf: calls $0.40
kwkim73: folds 
*** FLOP *** [Kh As Qs]
fwnaf: checks 
Saruotiss: checks 
*** TURN *** [Kh As Qs] [5s]
fwnaf: bets $0.50
Saruotiss: calls $0.50
*** RIVER *** [Kh As Qs 5s] [7h]
fwnaf: checks 
Saruotiss: checks 
*** SHOW DOWN ***
fwnaf: shows [8d 8c] (a pair of Eights)
Saruotiss: shows [Qh Jc] (a pair of Queens)
Saruotiss collected $2.15 from pot
*** SUMMARY ***
Total pot $2.25 | Rake $0.10 
Board [Kh As Qs 5s 7h]
Seat 1: Saruotiss (button) showed [Qh Jc] and won ($2.15) with a pair of Queens
Seat 2: fwnaf (small blind) showed [8d 8c] and lost with a pair of Eights
Seat 3: kwkim73 (big blind) folded before Flop
Seat 4: chiyuki folded before Flop (didn't bet)
Seat 5: risekuku468 folded before Flop (didn't bet)
Seat 6: Ellen1947 folded before Flop (didn't bet)
Seat 7: Dejacob folded before Flop (didn't bet)
Seat 8: TorTrade folded before Flop (didn't bet)
Seat 9: KeLevro0 folded before Flop (didn't bet)



PokerStars Zoom Hand #84300698577:  Hold'em No Limit ($0.10/$0.25) - 2012/08/05 15:45:21 JST [2012/08/05 2:45:21 ET]
Table 'Whirlpool' 9-max Seat #1 is the button
Seat 1: Ellen1947 ($22.25 in chips) 
Seat 2: GSDP ($21.94 in chips) 
Seat 3: Dejacob ($26.70 in chips) 
Seat 4: kwkim73 ($56.51 in chips) 
Seat 5: Grishukps ($13.10 in chips) 
Seat 6: seula i ($26.56 in chips) 
Seat 7: chiyuki ($41.19 in chips) 
Seat 8: risekuku468 ($29.06 in chips) 
Seat 9: snejokCoxx ($12.75 in chips) 
GSDP: posts small blind $0.10
Dejacob: posts big blind $0.25
*** HOLE CARDS ***
Dealt to chiyuki [3d Ah]
kwkim73: folds 
Grishukps: folds 
seula i: folds 
chiyuki: folds 
risekuku468: folds 
snejokCoxx: folds 
Ellen1947: raises $0.37 to $0.62
GSDP: folds 
Dejacob: folds 
Uncalled bet ($0.37) returned to Ellen1947
Ellen1947 collected $0.60 from pot
Ellen1947: doesn't show hand 
*** SUMMARY ***
Total pot $0.60 | Rake $0 
Seat 1: Ellen1947 (button) collected ($0.60)
Seat 2: GSDP (small blind) folded before Flop
Seat 3: Dejacob (big blind) folded before Flop
Seat 4: kwkim73 folded before Flop (didn't bet)
Seat 5: Grishukps folded before Flop (didn't bet)
Seat 6: seula i folded before Flop (didn't bet)
Seat 7: chiyuki folded before Flop (didn't bet)
Seat 8: risekuku468 folded before Flop (didn't bet)
Seat 9: snejokCoxx folded before Flop (didn't bet)



PokerStars Zoom Hand #84300691796:  Hold'em No Limit ($0.10/$0.25) - 2012/08/05 15:44:54 JST [2012/08/05 2:44:54 ET]
Table 'Whirlpool' 9-max Seat #1 is the button
Seat 1: AntoineHunt ($40.94 in chips) 
Seat 2: kamikkaze ($12.48 in chips) 
Seat 3: Dejacob ($25 in chips) 
Seat 4: Serge Claws ($26.37 in chips) 
Seat 5: 4plankton ($24.78 in chips) 
Seat 6: silvno31 ($66.09 in chips) 
Seat 7: Ellen1947 ($22.15 in chips) 
Seat 8: chiyuki ($40.84 in chips) 
Seat 9: snejokCoxx ($12.50 in chips) 
kamikkaze: posts small blind $0.10
Dejacob: posts big blind $0.25
*** HOLE CARDS ***
Dealt to chiyuki [4h Kh]
Serge Claws: raises $0.50 to $0.75
4plankton: folds 
silvno31: folds 
Ellen1947: folds 
chiyuki: folds 
snejokCoxx: folds 
AntoineHunt: folds 
kamikkaze: folds 
Dejacob: calls $0.50
*** FLOP *** [8s Ah Qc]
Dejacob: checks 
Serge Claws: bets $1
Dejacob: raises $2 to $3
Serge Claws: folds 
Uncalled bet ($2) returned to Dejacob
Dejacob collected $3.44 from pot
Dejacob: doesn't show hand 
*** SUMMARY ***
Total pot $3.60 | Rake $0.16 
Board [8s Ah Qc]
Seat 1: AntoineHunt (button) folded before Flop (didn't bet)
Seat 2: kamikkaze (small blind) folded before Flop
Seat 3: Dejacob (big blind) collected ($3.44)
Seat 4: Serge Claws folded on the Flop
Seat 5: 4plankton folded before Flop (didn't bet)
Seat 6: silvno31 folded before Flop (didn't bet)
Seat 7: Ellen1947 folded before Flop (didn't bet)
Seat 8: chiyuki folded before Flop (didn't bet)
Seat 9: snejokCoxx folded before Flop (didn't bet)



PokerStars Zoom Hand #84300700592:  Hold'em No Limit ($0.10/$0.25) - 2012/08/05 15:45:29 JST [2012/08/05 2:45:29 ET]
Table 'Whirlpool' 9-max Seat #1 is the button
Seat 1: jacquelinewu ($68.78 in chips) 
Seat 2: Silveystryk ($25.11 in chips) 
Seat 3: seula i ($27.56 in chips) 
Seat 4: chiyuki ($41.19 in chips) 
Seat 5: nice.franki ($7.35 in chips) 
Seat 6: ChrisCDee ($61.80 in chips) 
Seat 7: KeLevro0 ($8.63 in chips) 
Seat 8: AntoineHunt ($40.94 in chips) 
Seat 9: Serge Claws ($42.13 in chips) 
Silveystryk: posts small blind $0.10
seula i: posts big blind $0.25
*** HOLE CARDS ***
Dealt to chiyuki [6c 8s]
chiyuki: folds 
nice.franki: folds 
ChrisCDee: raises $0.50 to $0.75
KeLevro0: folds 
AntoineHunt: folds 
Serge Claws: folds 
jacquelinewu: folds 
Silveystryk: folds 
seula i: folds 
Uncalled bet ($0.50) returned to ChrisCDee
ChrisCDee collected $0.60 from pot
ChrisCDee: doesn't show hand 
*** SUMMARY ***
Total pot $0.60 | Rake $0 
Seat 1: jacquelinewu (button) folded before Flop (didn't bet)
Seat 2: Silveystryk (small blind) folded before Flop
Seat 3: seula i (big blind) folded before Flop
Seat 4: chiyuki folded before Flop (didn't bet)
Seat 5: nice.franki folded before Flop (didn't bet)
Seat 6: ChrisCDee collected ($0.60)
Seat 7: KeLevro0 folded before Flop (didn't bet)
Seat 8: AntoineHunt folded before Flop (didn't bet)
Seat 9: Serge Claws folded before Flop (didn't bet)



PokerStars Zoom Hand #84300702920:  Hold'em No Limit ($0.10/$0.25) - 2012/08/05 15:45:38 JST [2012/08/05 2:45:38 ET]
Table 'Whirlpool' 9-max Seat #1 is the button
Seat 1: Spheroff ($19.52 in chips) 
Seat 2: chiyuki ($41.19 in chips) 
Seat 3: Fructionar ($34.58 in chips) 
Seat 4: WARIBANA7777 ($14.89 in chips) 
Seat 5: KeLevro0 ($8.71 in chips) 
Seat 6: Rilko1975 ($24.65 in chips) 
Seat 7: Serge Claws ($42.13 in chips) 
Seat 8: 0 operator 0 ($33.47 in chips) 
Seat 9: Kasperlmusik ($25 in chips) 
chiyuki: posts small blind $0.10
Fructionar: posts big blind $0.25
*** HOLE CARDS ***
Dealt to chiyuki [7h Qh]
WARIBANA7777: folds 
KeLevro0: folds 
Rilko1975: folds 
Serge Claws: folds 
0 operator 0: folds 
Kasperlmusik: folds 
Spheroff: folds 
chiyuki: raises $0.50 to $0.75
Fructionar: raises $1.25 to $2
chiyuki: folds 
Uncalled bet ($1.25) returned to Fructionar
Fructionar collected $1.50 from pot
Fructionar: doesn't show hand 
*** SUMMARY ***
Total pot $1.50 | Rake $0 
Seat 1: Spheroff (button) folded before Flop (didn't bet)
Seat 2: chiyuki (small blind) folded before Flop
Seat 3: Fructionar (big blind) collected ($1.50)
Seat 4: WARIBANA7777 folded before Flop (didn't bet)
Seat 5: KeLevro0 folded before Flop (didn't bet)
Seat 6: Rilko1975 folded before Flop (didn't bet)
Seat 7: Serge Claws folded before Flop (didn't bet)
Seat 8: 0 operator 0 folded before Flop (didn't bet)
Seat 9: Kasperlmusik folded before Flop (didn't bet)



PokerStars Zoom Hand #84300712040:  Hold'em No Limit ($0.10/$0.25) - 2012/08/05 15:46:13 JST [2012/08/05 2:46:13 ET]
Table 'Whirlpool' 9-max Seat #1 is the button
Seat 1: chiyuki ($40.44 in chips) 
Seat 2: phate-1up ($41.29 in chips) 
Seat 3: snejokCoxx ($11.75 in chips) 
Seat 4: kamikkaze ($19.10 in chips) 
Seat 5: kkbruins0408 ($21.20 in chips) 
Seat 6: silvno31 ($66.76 in chips) 
Seat 7: Fructionar ($35.33 in chips) 
Seat 8: macmauret ($5.32 in chips) 
Seat 9: yvasilik ($22.94 in chips) 
phate-1up: posts small blind $0.10
snejokCoxx: posts big blind $0.25
*** HOLE CARDS ***
Dealt to chiyuki [5h 7s]
kamikkaze: folds 
kkbruins0408: calls $0.25
silvno31: folds 
Fructionar: folds 
macmauret: raises $5.07 to $5.32 and is all-in
yvasilik: folds 
chiyuki: folds 
phate-1up: folds 
snejokCoxx: folds 
kkbruins0408: folds 
Uncalled bet ($5.07) returned to macmauret
macmauret collected $0.85 from pot
macmauret: doesn't show hand 
*** SUMMARY ***
Total pot $0.85 | Rake $0 
Seat 1: chiyuki (button) folded before Flop (didn't bet)
Seat 2: phate-1up (small blind) folded before Flop
Seat 3: snejokCoxx (big blind) folded before Flop
Seat 4: kamikkaze folded before Flop (didn't bet)
Seat 5: kkbruins0408 folded before Flop
Seat 6: silvno31 folded before Flop (didn't bet)
Seat 7: Fructionar folded before Flop (didn't bet)
Seat 8: macmauret collected ($0.85)
Seat 9: yvasilik folded before Flop (didn't bet)



PokerStars Zoom Hand #84300701625:  Hold'em No Limit ($0.10/$0.25) - 2012/08/05 15:45:33 JST [2012/08/05 2:45:33 ET]
Table 'Whirlpool' 9-max Seat #1 is the button
Seat 1: GSDP ($21.84 in chips) 
Seat 2: phate-1up ($57.72 in chips) 
Seat 3: AntoineHunt ($40.94 in chips) 
Seat 4: nice.franki ($7.35 in chips) 
Seat 5: chiyuki ($41.19 in chips) 
Seat 6: hldtom ($28.04 in chips) 
Seat 7: snejokCoxx ($12.75 in chips) 
Seat 8: fwnaf ($14.10 in chips) 
Seat 9: Grishukps ($13.10 in chips) 
phate-1up: posts small blind $0.10
AntoineHunt: posts big blind $0.25
*** HOLE CARDS ***
Dealt to chiyuki [4d Tc]
nice.franki: folds 
chiyuki: folds 
hldtom: folds 
snejokCoxx: raises $0.40 to $0.65
fwnaf: folds 
Grishukps: folds 
GSDP: calls $0.65
phate-1up: folds 
AntoineHunt: folds 
*** FLOP *** [3c Ts 7d]
snejokCoxx: bets $1.11
GSDP: raises $1.14 to $2.25
snejokCoxx: calls $1.14
*** TURN *** [3c Ts 7d] [4s]
snejokCoxx: checks 
GSDP: checks 
*** RIVER *** [3c Ts 7d 4s] [Qd]
snejokCoxx: checks 
GSDP: checks 
*** SHOW DOWN ***
snejokCoxx: shows [As Ah] (a pair of Aces)
GSDP: mucks hand 
snejokCoxx collected $5.87 from pot
*** SUMMARY ***
Total pot $6.15 | Rake $0.28 
Board [3c Ts 7d 4s Qd]
Seat 1: GSDP (button) mucked [9h 7h]
Seat 2: phate-1up (small blind) folded before Flop
Seat 3: AntoineHunt (big blind) folded before Flop
Seat 4: nice.franki folded before Flop (didn't bet)
Seat 5: chiyuki folded before Flop (didn't bet)
Seat 6: hldtom folded before Flop (didn't bet)
Seat 7: snejokCoxx showed [As Ah] and won ($5.87) with a pair of Aces
Seat 8: fwnaf folded before Flop (didn't bet)
Seat 9: Grishukps folded before Flop (didn't bet)



PokerStars Zoom Hand #84300712830:  Hold'em No Limit ($0.10/$0.25) - 2012/08/05 15:46:17 JST [2012/08/05 2:46:17 ET]
Table 'Whirlpool' 9-max Seat #1 is the button
Seat 1: Silveystryk ($47.11 in chips) 
Seat 2: 1Karina1 ($25 in chips) 
Seat 3: hldtom ($26.07 in chips) 
Seat 4: Grishukps ($12.90 in chips) 
Seat 5: GovGus ($43.95 in chips) 
Seat 6: 4plankton ($22.43 in chips) 
Seat 7: jacquelinewu ($28.96 in chips) 
Seat 8: herkko11 ($6.18 in chips) 
Seat 9: chiyuki ($40.44 in chips) 
1Karina1: posts small blind $0.10
hldtom: posts big blind $0.25
*** HOLE CARDS ***
Dealt to chiyuki [Th Kh]
Grishukps: folds 
GovGus: folds 
4plankton: folds 
jacquelinewu: folds 
herkko11: folds 
chiyuki: raises $0.50 to $0.75
Silveystryk: calls $0.75
1Karina1: folds 
hldtom: folds 
*** FLOP *** [3c 4h 2d]
chiyuki: checks 
Silveystryk: bets $0.75
chiyuki: folds 
Uncalled bet ($0.75) returned to Silveystryk
Silveystryk collected $1.77 from pot
Silveystryk: doesn't show hand 
*** SUMMARY ***
Total pot $1.85 | Rake $0.08 
Board [3c 4h 2d]
Seat 1: Silveystryk (button) collected ($1.77)
Seat 2: 1Karina1 (small blind) folded before Flop
Seat 3: hldtom (big blind) folded before Flop
Seat 4: Grishukps folded before Flop (didn't bet)
Seat 5: GovGus folded before Flop (didn't bet)
Seat 6: 4plankton folded before Flop (didn't bet)
Seat 7: jacquelinewu folded before Flop (didn't bet)
Seat 8: herkko11 folded before Flop (didn't bet)
Seat 9: chiyuki folded on the Flop



PokerStars Zoom Hand #84300726934:  Hold'em No Limit ($0.10/$0.25) - 2012/08/05 15:47:11 JST [2012/08/05 2:47:11 ET]
Table 'Whirlpool' 9-max Seat #1 is the button
Seat 1: jacquelinewu ($68.38 in chips) 
Seat 2: masterkoolb ($20.34 in chips) 
Seat 3: kwkim73 ($25 in chips) 
Seat 4: seula i ($26.91 in chips) 
Seat 5: DutchShultzs ($26.13 in chips) 
Seat 6: chiyuki ($39.69 in chips) 
Seat 7: Silveystryk ($48.13 in chips) 
Seat 8: KrystalAA ($27.75 in chips) 
Seat 9: moku36 ($46.03 in chips) 
masterkoolb: posts small blind $0.10
kwkim73: posts big blind $0.25
*** HOLE CARDS ***
Dealt to chiyuki [9s Qs]
seula i: folds 
DutchShultzs: folds 
chiyuki: folds 
Silveystryk: folds 
KrystalAA: folds 
moku36: folds 
jacquelinewu: raises $0.50 to $0.75
masterkoolb: folds 
kwkim73: folds 
Uncalled bet ($0.50) returned to jacquelinewu
jacquelinewu collected $0.60 from pot
jacquelinewu: doesn't show hand 
*** SUMMARY ***
Total pot $0.60 | Rake $0 
Seat 1: jacquelinewu (button) collected ($0.60)
Seat 2: masterkoolb (small blind) folded before Flop
Seat 3: kwkim73 (big blind) folded before Flop
Seat 4: seula i folded before Flop (didn't bet)
Seat 5: DutchShultzs folded before Flop (didn't bet)
Seat 6: chiyuki folded before Flop (didn't bet)
Seat 7: Silveystryk folded before Flop (didn't bet)
Seat 8: KrystalAA folded before Flop (didn't bet)
Seat 9: moku36 folded before Flop (didn't bet)



PokerStars Zoom Hand #84300728562:  Hold'em No Limit ($0.10/$0.25) - 2012/08/05 15:47:17 JST [2012/08/05 2:47:17 ET]
Table 'Whirlpool' 9-max Seat #1 is the button
Seat 1: Kasperlmusik ($25 in chips) 
Seat 2: Grishukps ($12.65 in chips) 
Seat 3: chiyuki ($39.69 in chips) 
Seat 4: Rici47 ($30.12 in chips) 
Seat 5: hldtom ($28.64 in chips) 
Seat 6: INSP!RON ($39.79 in chips) 
Seat 7: Trip_Krowns ($24.44 in chips) 
Seat 8: 4plankton ($22.08 in chips) 
Seat 9: Silveystryk ($48.13 in chips) 
Grishukps: posts small blind $0.10
chiyuki: posts big blind $0.25
*** HOLE CARDS ***
Dealt to chiyuki [8c 8h]
Rici47: calls $0.25
hldtom: folds 
INSP!RON: folds 
Trip_Krowns: folds 
4plankton: folds 
Silveystryk: folds 
Kasperlmusik: folds 
Grishukps: folds 
chiyuki: raises $0.75 to $1
Rici47: calls $0.75
*** FLOP *** [9s 6d As]
chiyuki: bets $1.25
Rici47: calls $1.25
*** TURN *** [9s 6d As] [5d]
chiyuki: checks 
Rici47: checks 
*** RIVER *** [9s 6d As 5d] [4d]
chiyuki: checks 
Rici47: bets $1.50
chiyuki: folds 
Uncalled bet ($1.50) returned to Rici47
Rici47 collected $4.39 from pot
Rici47: doesn't show hand 
*** SUMMARY ***
Total pot $4.60 | Rake $0.21 
Board [9s 6d As 5d 4d]
Seat 1: Kasperlmusik (button) folded before Flop (didn't bet)
Seat 2: Grishukps (small blind) folded before Flop
Seat 3: chiyuki (big blind) folded on the River
Seat 4: Rici47 collected ($4.39)
Seat 5: hldtom folded before Flop (didn't bet)
Seat 6: INSP!RON folded before Flop (didn't bet)
Seat 7: Trip_Krowns folded before Flop (didn't bet)
Seat 8: 4plankton folded before Flop (didn't bet)
Seat 9: Silveystryk folded before Flop (didn't bet)



PokerStars Zoom Hand #84300738903:  Hold'em No Limit ($0.10/$0.25) - 2012/08/05 15:47:58 JST [2012/08/05 2:47:58 ET]
Table 'Whirlpool' 9-max Seat #1 is the button
Seat 1: moku36 ($46.03 in chips) 
Seat 2: PPP7SSS ($18.93 in chips) 
Seat 3: jacquelinewu ($28.11 in chips) 
Seat 4: snejokCoxx ($12.35 in chips) 
Seat 5: Silveystryk ($22.69 in chips) 
Seat 6: Alvinpe85 ($46.52 in chips) 
Seat 7: seula i ($26.21 in chips) 
Seat 8: chiyuki ($37.44 in chips) 
Seat 9: Kasperlmusik ($25 in chips) 
PPP7SSS: posts small blind $0.10
jacquelinewu: posts big blind $0.25
*** HOLE CARDS ***
Dealt to chiyuki [5s Kd]
snejokCoxx: folds 
Silveystryk: folds 
Alvinpe85: folds 
seula i: folds 
chiyuki: folds 
Kasperlmusik: folds 
moku36: folds 
PPP7SSS: folds 
Uncalled bet ($0.15) returned to jacquelinewu
jacquelinewu collected $0.20 from pot
jacquelinewu: doesn't show hand 
*** SUMMARY ***
Total pot $0.20 | Rake $0 
Seat 1: moku36 (button) folded before Flop (didn't bet)
Seat 2: PPP7SSS (small blind) folded before Flop
Seat 3: jacquelinewu (big blind) collected ($0.20)
Seat 4: snejokCoxx folded before Flop (didn't bet)
Seat 5: Silveystryk folded before Flop (didn't bet)
Seat 6: Alvinpe85 folded before Flop (didn't bet)
Seat 7: seula i folded before Flop (didn't bet)
Seat 8: chiyuki folded before Flop (didn't bet)
Seat 9: Kasperlmusik folded before Flop (didn't bet)



PokerStars Zoom Hand #84300742384:  Hold'em No Limit ($0.10/$0.25) - 2012/08/05 15:48:11 JST [2012/08/05 2:48:11 ET]
Table 'Whirlpool' 9-max Seat #1 is the button
Seat 1: nice.franki ($10.70 in chips) 
Seat 2: Silveystryk ($47.88 in chips) 
Seat 3: snejokCoxx ($12.50 in chips) 
Seat 4: DutchShultzs ($35.63 in chips) 
Seat 5: Ellen1947 ($29.23 in chips) 
Seat 6: ShaninPeter ($11.72 in chips) 
Seat 7: chiyuki ($37.44 in chips) 
Seat 8: Jene4kaBest ($20.05 in chips) 
Seat 9: AAAKK777 ($11.98 in chips) 
Silveystryk: posts small blind $0.10
snejokCoxx: posts big blind $0.25
*** HOLE CARDS ***
Dealt to chiyuki [Jh Ac]
DutchShultzs: folds 
Ellen1947: folds 
ShaninPeter: raises $0.75 to $1
chiyuki: folds 
Jene4kaBest: folds 
AAAKK777: folds 
nice.franki: folds 
Silveystryk: folds 
snejokCoxx: folds 
Uncalled bet ($0.75) returned to ShaninPeter
ShaninPeter collected $0.60 from pot
ShaninPeter: doesn't show hand 
*** SUMMARY ***
Total pot $0.60 | Rake $0 
Seat 1: nice.franki (button) folded before Flop (didn't bet)
Seat 2: Silveystryk (small blind) folded before Flop
Seat 3: snejokCoxx (big blind) folded before Flop
Seat 4: DutchShultzs folded before Flop (didn't bet)
Seat 5: Ellen1947 folded before Flop (didn't bet)
Seat 6: ShaninPeter collected ($0.60)
Seat 7: chiyuki folded before Flop (didn't bet)
Seat 8: Jene4kaBest folded before Flop (didn't bet)
Seat 9: AAAKK777 folded before Flop (didn't bet)



PokerStars Zoom Hand #84300744941:  Hold'em No Limit ($0.10/$0.25) - 2012/08/05 15:48:21 JST [2012/08/05 2:48:21 ET]
Table 'Whirlpool' 9-max Seat #1 is the button
Seat 1: chiyuki ($37.44 in chips) 
Seat 2: leo2095 ($28.49 in chips) 
Seat 3: kesstukas25 ($17.07 in chips) 
Seat 4: masterkoolb ($12.50 in chips) 
Seat 5: mjmichi ($40.86 in chips) 
Seat 6: nice.franki ($10.70 in chips) 
Seat 7: Dan Royal ($26.22 in chips) 
Seat 8: KeLevro0 ($12.53 in chips) 
Seat 9: HighDuka ($31.40 in chips) 
leo2095: posts small blind $0.10
kesstukas25: posts big blind $0.25
*** HOLE CARDS ***
Dealt to chiyuki [3h 6c]
masterkoolb: folds 
mjmichi: folds 
nice.franki: raises $0.50 to $0.75
Dan Royal: folds 
KeLevro0: folds 
HighDuka: folds 
chiyuki: folds 
leo2095: folds 
kesstukas25: folds 
Uncalled bet ($0.50) returned to nice.franki
nice.franki collected $0.60 from pot
nice.franki: doesn't show hand 
*** SUMMARY ***
Total pot $0.60 | Rake $0 
Seat 1: chiyuki (button) folded before Flop (didn't bet)
Seat 2: leo2095 (small blind) folded before Flop
Seat 3: kesstukas25 (big blind) folded before Flop
Seat 4: masterkoolb folded before Flop (didn't bet)
Seat 5: mjmichi folded before Flop (didn't bet)
Seat 6: nice.franki collected ($0.60)
Seat 7: Dan Royal folded before Flop (didn't bet)
Seat 8: KeLevro0 folded before Flop (didn't bet)
Seat 9: HighDuka folded before Flop (didn't bet)



PokerStars Zoom Hand #84300745922:  Hold'em No Limit ($0.10/$0.25) - 2012/08/05 15:48:25 JST [2012/08/05 2:48:25 ET]
Table 'Whirlpool' 9-max Seat #1 is the button
Seat 1: Silveystryk ($47.78 in chips) 
Seat 2: tribunpdm ($93.63 in chips) 
Seat 3: KeLevro0 ($12.53 in chips) 
Seat 4: chiyuki ($37.44 in chips) 
Seat 5: phate-1up ($42.64 in chips) 
Seat 6: herkko11 ($9.53 in chips) 
Seat 7: Serge Claws ($26.85 in chips) 
Seat 8: Kozyavkin ($20.80 in chips) 
Seat 9: leo2095 ($28.39 in chips) 
tribunpdm: posts small blind $0.10
KeLevro0: posts big blind $0.25
*** HOLE CARDS ***
Dealt to chiyuki [6h 6s]
chiyuki: folds 
phate-1up: folds 
herkko11: folds 
Serge Claws: folds 
Kozyavkin: raises $0.25 to $0.50
leo2095: folds 
Silveystryk: folds 
tribunpdm: calls $0.40
KeLevro0: folds 
*** FLOP *** [2c Js 9d]
tribunpdm: checks 
Kozyavkin: bets $0.50
tribunpdm: folds 
Uncalled bet ($0.50) returned to Kozyavkin
Kozyavkin collected $1.19 from pot
Kozyavkin: doesn't show hand 
*** SUMMARY ***
Total pot $1.25 | Rake $0.06 
Board [2c Js 9d]
Seat 1: Silveystryk (button) folded before Flop (didn't bet)
Seat 2: tribunpdm (small blind) folded on the Flop
Seat 3: KeLevro0 (big blind) folded before Flop
Seat 4: chiyuki folded before Flop (didn't bet)
Seat 5: phate-1up folded before Flop (didn't bet)
Seat 6: herkko11 folded before Flop (didn't bet)
Seat 7: Serge Claws folded before Flop (didn't bet)
Seat 8: Kozyavkin collected ($1.19)
Seat 9: leo2095 folded before Flop (didn't bet)



PokerStars Zoom Hand #84300749135:  Hold'em No Limit ($0.10/$0.25) - 2012/08/05 15:48:37 JST [2012/08/05 2:48:37 ET]
Table 'Whirlpool' 9-max Seat #1 is the button
Seat 1: Perstenev ($7.18 in chips) 
Seat 2: Limoilou ($32.50 in chips) 
Seat 3: nice.franki ($12.15 in chips) 
Seat 4: Fructionar ($35.54 in chips) 
Seat 5: Serge Claws ($39.58 in chips) 
Seat 6: chiyuki ($37.34 in chips) 
Seat 7: drunk_bender ($19.21 in chips) 
Seat 8: 1Karina1 ($37.32 in chips) 
Seat 9: Silveystryk ($47.78 in chips) 
Limoilou: posts small blind $0.10
nice.franki: posts big blind $0.25
*** HOLE CARDS ***
Dealt to chiyuki [4s 5s]
Fructionar: folds 
Serge Claws: folds 
chiyuki: folds 
drunk_bender: folds 
1Karina1: folds 
Silveystryk: folds 
Perstenev: folds 
Limoilou: folds 
Uncalled bet ($0.15) returned to nice.franki
nice.franki collected $0.20 from pot
nice.franki: doesn't show hand 
*** SUMMARY ***
Total pot $0.20 | Rake $0 
Seat 1: Perstenev (button) folded before Flop (didn't bet)
Seat 2: Limoilou (small blind) folded before Flop
Seat 3: nice.franki (big blind) collected ($0.20)
Seat 4: Fructionar folded before Flop (didn't bet)
Seat 5: Serge Claws folded before Flop (didn't bet)
Seat 6: chiyuki folded before Flop (didn't bet)
Seat 7: drunk_bender folded before Flop (didn't bet)
Seat 8: 1Karina1 folded before Flop (didn't bet)
Seat 9: Silveystryk folded before Flop (didn't bet)



PokerStars Zoom Hand #84300751527:  Hold'em No Limit ($0.10/$0.25) - 2012/08/05 15:48:47 JST [2012/08/05 2:48:47 ET]
Table 'Whirlpool' 9-max Seat #1 is the button
Seat 1: masterkoolb ($13.50 in chips) 
Seat 2: Femali54 ($26.34 in chips) 
Seat 3: Silveystryk ($22.07 in chips) 
Seat 4: Ozboy80 ($23.53 in chips) 
Seat 5: seula i ($26.91 in chips) 
Seat 6: snejokCoxx ($11.99 in chips) 
Seat 7: 1Karina1 ($44.59 in chips) 
Seat 8: Grishukps ($12.50 in chips) 
Seat 9: chiyuki ($37.34 in chips) 
Femali54: posts small blind $0.10
Silveystryk: posts big blind $0.25
*** HOLE CARDS ***
Dealt to chiyuki [9d 3s]
Ozboy80: raises $0.25 to $0.50
seula i: folds 
snejokCoxx: folds 
1Karina1: folds 
Grishukps: folds 
chiyuki: folds 
masterkoolb: folds 
Femali54: folds 
Silveystryk: folds 
Uncalled bet ($0.25) returned to Ozboy80
Ozboy80 collected $0.60 from pot
Ozboy80: doesn't show hand 
*** SUMMARY ***
Total pot $0.60 | Rake $0 
Seat 1: masterkoolb (button) folded before Flop (didn't bet)
Seat 2: Femali54 (small blind) folded before Flop
Seat 3: Silveystryk (big blind) folded before Flop
Seat 4: Ozboy80 collected ($0.60)
Seat 5: seula i folded before Flop (didn't bet)
Seat 6: snejokCoxx folded before Flop (didn't bet)
Seat 7: 1Karina1 folded before Flop (didn't bet)
Seat 8: Grishukps folded before Flop (didn't bet)
Seat 9: chiyuki folded before Flop (didn't bet)



PokerStars Zoom Hand #84300747024:  Hold'em No Limit ($0.10/$0.25) - 2012/08/05 15:48:29 JST [2012/08/05 2:48:29 ET]
Table 'Whirlpool' 9-max Seat #1 is the button
Seat 1: herkko11 ($9.53 in chips) 
Seat 2: chiyuki ($37.44 in chips) 
Seat 3: Kasperlmusik ($25 in chips) 
Seat 4: rey2040 ($23.62 in chips) 
Seat 5: hldtom ($25.57 in chips) 
Seat 6: GovGus ($42.76 in chips) 
Seat 7: kwkim73 ($29.08 in chips) 
Seat 8: leo2095 ($28.39 in chips) 
Seat 9: Kreiler ($12.15 in chips) 
chiyuki: posts small blind $0.10
Kasperlmusik: posts big blind $0.25
*** HOLE CARDS ***
Dealt to chiyuki [Ts 5c]
rey2040: folds 
hldtom has timed out
hldtom: folds 
GovGus: folds 
kwkim73: folds 
leo2095: folds 
Kreiler: raises $0.50 to $0.75
herkko11: folds 
chiyuki: folds 
Kasperlmusik: raises $1.50 to $2.25
Kreiler: calls $1.50
*** FLOP *** [4d 6h 2c]
Kasperlmusik: checks 
Kreiler: checks 
*** TURN *** [4d 6h 2c] [Kh]
Kasperlmusik: bets $2.25
Kreiler: raises $2.75 to $5
Kasperlmusik: raises $7 to $12
Kreiler: calls $4.90 and is all-in
Uncalled bet ($2.10) returned to Kasperlmusik
*** RIVER *** [4d 6h 2c Kh] [Tc]
*** SHOW DOWN ***
Kasperlmusik: shows [Ac Ks] (a pair of Kings)
Kreiler: shows [Kd Jh] (a pair of Kings - lower kicker)
Kasperlmusik collected $23.30 from pot
*** SUMMARY ***
Total pot $24.40 | Rake $1.10 
Board [4d 6h 2c Kh Tc]
Seat 1: herkko11 (button) folded before Flop (didn't bet)
Seat 2: chiyuki (small blind) folded before Flop
Seat 3: Kasperlmusik (big blind) showed [Ac Ks] and won ($23.30) with a pair of Kings
Seat 4: rey2040 folded before Flop (didn't bet)
Seat 5: hldtom folded before Flop (didn't bet)
Seat 6: GovGus folded before Flop (didn't bet)
Seat 7: kwkim73 folded before Flop (didn't bet)
Seat 8: leo2095 folded before Flop (didn't bet)
Seat 9: Kreiler showed [Kd Jh] and lost with a pair of Kings



PokerStars Zoom Hand #84300752568:  Hold'em No Limit ($0.10/$0.25) - 2012/08/05 15:48:51 JST [2012/08/05 2:48:51 ET]
Table 'Whirlpool' 9-max Seat #1 is the button
Seat 1: phate-1up ($42.39 in chips) 
Seat 2: ShaninPeter ($12.17 in chips) 
Seat 3: 1Karina1 ($44.59 in chips) 
Seat 4: INSP!RON ($39.94 in chips) 
Seat 5: chiyuki ($37.34 in chips) 
Seat 6: Grishukps ($12.50 in chips) 
Seat 7: DrunkTyphoon ($29.80 in chips) 
Seat 8: masterkoolb ($13.50 in chips) 
Seat 9: gatorswamp ($19.65 in chips) 
ShaninPeter: posts small blind $0.10
1Karina1: posts big blind $0.25
*** HOLE CARDS ***
Dealt to chiyuki [Jc 9h]
INSP!RON: folds 
chiyuki: folds 
Grishukps: folds 
DrunkTyphoon: folds 
masterkoolb: folds 
gatorswamp: calls $0.25
phate-1up: raises $0.75 to $1
ShaninPeter: folds 
1Karina1: folds 
gatorswamp: calls $0.75
*** FLOP *** [Qs 3c Kd]
gatorswamp: checks 
phate-1up: bets $1.50
gatorswamp: folds 
Uncalled bet ($1.50) returned to phate-1up
phate-1up collected $2.24 from pot
phate-1up: doesn't show hand 
*** SUMMARY ***
Total pot $2.35 | Rake $0.11 
Board [Qs 3c Kd]
Seat 1: phate-1up (button) collected ($2.24)
Seat 2: ShaninPeter (small blind) folded before Flop
Seat 3: 1Karina1 (big blind) folded before Flop
Seat 4: INSP!RON folded before Flop (didn't bet)
Seat 5: chiyuki folded before Flop (didn't bet)
Seat 6: Grishukps folded before Flop (didn't bet)
Seat 7: DrunkTyphoon folded before Flop (didn't bet)
Seat 8: masterkoolb folded before Flop (didn't bet)
Seat 9: gatorswamp folded on the Flop



PokerStars Zoom Hand #84300754445:  Hold'em No Limit ($0.10/$0.25) - 2012/08/05 15:48:58 JST [2012/08/05 2:48:58 ET]
Table 'Whirlpool' 9-max Seat #1 is the button
Seat 1: tribunpdm ($93.13 in chips) 
Seat 2: Ellen1947 ($25 in chips) 
Seat 3: chiyuki ($37.34 in chips) 
Seat 4: phate-1up ($40.64 in chips) 
Seat 5: INSP!RON ($40.14 in chips) 
Seat 6: Serge Claws ($26.60 in chips) 
Seat 7: jvds114 ($38 in chips) 
Seat 8: romanian c4 ($18.32 in chips) 
Seat 9: DutchShultzs ($25.28 in chips) 
Ellen1947: posts small blind $0.10
chiyuki: posts big blind $0.25
*** HOLE CARDS ***
Dealt to chiyuki [Kd Ad]
phate-1up: raises $0.50 to $0.75
INSP!RON: folds 
Serge Claws: folds 
jvds114: folds 
romanian c4: folds 
DutchShultzs: folds 
tribunpdm: folds 
Ellen1947: folds 
chiyuki: calls $0.50
*** FLOP *** [5d 3d 2s]
chiyuki: checks 
phate-1up: checks 
*** TURN *** [5d 3d 2s] [Js]
chiyuki: checks 
phate-1up: bets $1
chiyuki: calls $1
*** RIVER *** [5d 3d 2s Js] [Tc]
chiyuki: checks 
phate-1up: bets $2.50
chiyuki: folds 
Uncalled bet ($2.50) returned to phate-1up
phate-1up collected $3.44 from pot
phate-1up: doesn't show hand 
*** SUMMARY ***
Total pot $3.60 | Rake $0.16 
Board [5d 3d 2s Js Tc]
Seat 1: tribunpdm (button) folded before Flop (didn't bet)
Seat 2: Ellen1947 (small blind) folded before Flop
Seat 3: chiyuki (big blind) folded on the River
Seat 4: phate-1up collected ($3.44)
Seat 5: INSP!RON folded before Flop (didn't bet)
Seat 6: Serge Claws folded before Flop (didn't bet)
Seat 7: jvds114 folded before Flop (didn't bet)
Seat 8: romanian c4 folded before Flop (didn't bet)
Seat 9: DutchShultzs folded before Flop (didn't bet)



PokerStars Zoom Hand #84300770209:  Hold'em No Limit ($0.10/$0.25) - 2012/08/05 15:50:00 JST [2012/08/05 2:50:00 ET]
Table 'Whirlpool' 9-max Seat #1 is the button
Seat 1: River_GmbH ($15.87 in chips) 
Seat 2: Grishukps ($12.50 in chips) 
Seat 3: fil740 ($4.97 in chips) 
Seat 4: chiyuki ($35.59 in chips) 
Seat 5: snejokCoxx ($10.40 in chips) 
Seat 6: mr_pugsley69 ($18.40 in chips) 
Seat 7: kwkim73 ($28.33 in chips) 
Seat 8: Perstenev ($12.43 in chips) 
Seat 9: phate-1up ($43.63 in chips) 
Grishukps: posts small blind $0.10
fil740: posts big blind $0.25
*** HOLE CARDS ***
Dealt to chiyuki [Ac 2c]
chiyuki: folds 
snejokCoxx: folds 
mr_pugsley69: folds 
kwkim73: folds 
Perstenev: folds 
phate-1up: folds 
River_GmbH: folds 
Grishukps: folds 
Uncalled bet ($0.15) returned to fil740
fil740 collected $0.20 from pot
fil740: doesn't show hand 
*** SUMMARY ***
Total pot $0.20 | Rake $0 
Seat 1: River_GmbH (button) folded before Flop (didn't bet)
Seat 2: Grishukps (small blind) folded before Flop
Seat 3: fil740 (big blind) collected ($0.20)
Seat 4: chiyuki folded before Flop (didn't bet)
Seat 5: snejokCoxx folded before Flop (didn't bet)
Seat 6: mr_pugsley69 folded before Flop (didn't bet)
Seat 7: kwkim73 folded before Flop (didn't bet)
Seat 8: Perstenev folded before Flop (didn't bet)
Seat 9: phate-1up folded before Flop (didn't bet)



PokerStars Zoom Hand #84300768411:  Hold'em No Limit ($0.10/$0.25) - 2012/08/05 15:49:52 JST [2012/08/05 2:49:52 ET]
Table 'Whirlpool' 9-max Seat #1 is the button
Seat 1: nice.franki ($6.55 in chips) 
Seat 2: Ozboy80 ($25.02 in chips) 
Seat 3: slapshot2011 ($24.96 in chips) 
Seat 4: River_GmbH ($15.87 in chips) 
Seat 5: INSP!RON ($39.79 in chips) 
Seat 6: snejokCoxx ($12.35 in chips) 
Seat 7: jacquelinewu ($27.46 in chips) 
Seat 8: chiyuki ($35.59 in chips) 
Seat 9: kkbruins0408 ($12.17 in chips) 
Ozboy80: posts small blind $0.10
slapshot2011: posts big blind $0.25
*** HOLE CARDS ***
Dealt to chiyuki [8h 3c]
River_GmbH: folds 
INSP!RON: raises $0.50 to $0.75
snejokCoxx: folds 
jacquelinewu: folds 
chiyuki: folds 
kkbruins0408: folds 
nice.franki: folds 
Ozboy80: folds 
slapshot2011: calls $0.50
*** FLOP *** [7h 8d Ts]
slapshot2011: checks 
INSP!RON: bets $1.10
slapshot2011: folds 
Uncalled bet ($1.10) returned to INSP!RON
INSP!RON collected $1.53 from pot
INSP!RON: doesn't show hand 
*** SUMMARY ***
Total pot $1.60 | Rake $0.07 
Board [7h 8d Ts]
Seat 1: nice.franki (button) folded before Flop (didn't bet)
Seat 2: Ozboy80 (small blind) folded before Flop
Seat 3: slapshot2011 (big blind) folded on the Flop
Seat 4: River_GmbH folded before Flop (didn't bet)
Seat 5: INSP!RON collected ($1.53)
Seat 6: snejokCoxx folded before Flop (didn't bet)
Seat 7: jacquelinewu folded before Flop (didn't bet)
Seat 8: chiyuki folded before Flop (didn't bet)
Seat 9: kkbruins0408 folded before Flop (didn't bet)



PokerStars Zoom Hand #84300771271:  Hold'em No Limit ($0.10/$0.25) - 2012/08/05 15:50:04 JST [2012/08/05 2:50:04 ET]
Table 'Whirlpool' 9-max Seat #1 is the button
Seat 1: Ozboy80 ($24.92 in chips) 
Seat 2: tribunpdm ($93.58 in chips) 
Seat 3: 4plankton ($22.08 in chips) 
Seat 4: Trip_Krowns ($23.61 in chips) 
Seat 5: silvno31 ($66 in chips) 
Seat 6: 1Karina1 ($25.35 in chips) 
Seat 7: chiyuki ($35.59 in chips) 
Seat 8: 0 operator 0 ($34.30 in chips) 
Seat 9: KrystalAA ($35.42 in chips) 
tribunpdm: posts small blind $0.10
4plankton: posts big blind $0.25
*** HOLE CARDS ***
Dealt to chiyuki [As Ts]
Trip_Krowns: folds 
silvno31: folds 
1Karina1: folds 
chiyuki: raises $0.50 to $0.75
0 operator 0: raises $1.25 to $2
KrystalAA: calls $2
Ozboy80: folds 
tribunpdm: calls $1.90
4plankton: folds 
chiyuki: folds 
*** FLOP *** [Ks 8c Qh]
tribunpdm: checks 
0 operator 0: bets $6.68
KrystalAA: calls $6.68
tribunpdm: calls $6.68
*** TURN *** [Ks 8c Qh] [3h]
tribunpdm: checks 
0 operator 0: bets $19.36
KrystalAA: folds 
tribunpdm: folds 
Uncalled bet ($19.36) returned to 0 operator 0
0 operator 0 collected $25.82 from pot
0 operator 0: doesn't show hand 
*** SUMMARY ***
Total pot $27.04 | Rake $1.22 
Board [Ks 8c Qh 3h]
Seat 1: Ozboy80 (button) folded before Flop (didn't bet)
Seat 2: tribunpdm (small blind) folded on the Turn
Seat 3: 4plankton (big blind) folded before Flop
Seat 4: Trip_Krowns folded before Flop (didn't bet)
Seat 5: silvno31 folded before Flop (didn't bet)
Seat 6: 1Karina1 folded before Flop (didn't bet)
Seat 7: chiyuki folded before Flop
Seat 8: 0 operator 0 collected ($25.82)
Seat 9: KrystalAA folded on the Turn



PokerStars Zoom Hand #84300777485:  Hold'em No Limit ($0.10/$0.25) - 2012/08/05 15:50:28 JST [2012/08/05 2:50:28 ET]
Table 'Whirlpool' 9-max Seat #1 is the button
Seat 1: mr_pugsley69 ($18.30 in chips) 
Seat 2: chiyuki ($34.84 in chips) 
Seat 3: MurMurRu ($25 in chips) 
Seat 4: mjmichi ($38.61 in chips) 
Seat 5: Perstenev ($12.43 in chips) 
Seat 6: Nerkit ($11.92 in chips) 
Seat 7: GovGus ($42.41 in chips) 
Seat 8: Serge Claws ($39.48 in chips) 
Seat 9: jacquelinewu ($66.03 in chips) 
chiyuki: posts small blind $0.10
MurMurRu: posts big blind $0.25
*** HOLE CARDS ***
Dealt to chiyuki [Js Qc]
mjmichi: folds 
Perstenev: folds 
Nerkit: folds 
GovGus: folds 
Serge Claws: folds 
jacquelinewu: raises $0.50 to $0.75
mr_pugsley69: raises $1.50 to $2.25
chiyuki: folds 
MurMurRu: folds 
jacquelinewu: folds 
Uncalled bet ($1.50) returned to mr_pugsley69
mr_pugsley69 collected $1.85 from pot
mr_pugsley69: doesn't show hand 
*** SUMMARY ***
Total pot $1.85 | Rake $0 
Seat 1: mr_pugsley69 (button) collected ($1.85)
Seat 2: chiyuki (small blind) folded before Flop
Seat 3: MurMurRu (big blind) folded before Flop
Seat 4: mjmichi folded before Flop (didn't bet)
Seat 5: Perstenev folded before Flop (didn't bet)
Seat 6: Nerkit folded before Flop (didn't bet)
Seat 7: GovGus folded before Flop (didn't bet)
Seat 8: Serge Claws folded before Flop (didn't bet)
Seat 9: jacquelinewu folded before Flop



PokerStars Zoom Hand #84300791370:  Hold'em No Limit ($0.10/$0.25) - 2012/08/05 15:51:23 JST [2012/08/05 2:51:23 ET]
Table 'Whirlpool' 9-max Seat #1 is the button
Seat 1: chiyuki ($34.74 in chips) 
Seat 2: Perstenev ($12.43 in chips) 
Seat 3: KeLevro0 ($11.48 in chips) 
Seat 4: kamikkaze ($21.47 in chips) 
Seat 5: Spheroff ($7.27 in chips) 
Seat 6: JhonnyP1979 ($15.55 in chips) 
Seat 7: GSDP ($22.66 in chips) 
Seat 8: Nerkit ($11.71 in chips) 
Seat 9: Afcawins25 ($17.03 in chips) 
Perstenev: posts small blind $0.10
KeLevro0: posts big blind $0.25
*** HOLE CARDS ***
Dealt to chiyuki [9s 6s]
kamikkaze: folds 
Spheroff: raises $0.50 to $0.75
JhonnyP1979: folds 
GSDP: folds 
Nerkit: folds 
Afcawins25: folds 
chiyuki: folds 
Perstenev: folds 
KeLevro0: folds 
Uncalled bet ($0.50) returned to Spheroff
Spheroff collected $0.60 from pot
Spheroff: doesn't show hand 
*** SUMMARY ***
Total pot $0.60 | Rake $0 
Seat 1: chiyuki (button) folded before Flop (didn't bet)
Seat 2: Perstenev (small blind) folded before Flop
Seat 3: KeLevro0 (big blind) folded before Flop
Seat 4: kamikkaze folded before Flop (didn't bet)
Seat 5: Spheroff collected ($0.60)
Seat 6: JhonnyP1979 folded before Flop (didn't bet)
Seat 7: GSDP folded before Flop (didn't bet)
Seat 8: Nerkit folded before Flop (didn't bet)
Seat 9: Afcawins25 folded before Flop (didn't bet)



PokerStars Zoom Hand #84300786993:  Hold'em No Limit ($0.10/$0.25) - 2012/08/05 15:51:05 JST [2012/08/05 2:51:05 ET]
Table 'Whirlpool' 9-max Seat #1 is the button
Seat 1: mjmichi ($68.98 in chips) 
Seat 2: aivvo ($7 in chips) 
Seat 3: xxx Spb xxx ($26.04 in chips) 
Seat 4: 4plankton ($21.73 in chips) 
Seat 5: chiyuki ($34.74 in chips) 
Seat 6: INSP!RON ($35.51 in chips) 
Seat 7: KeLevro0 ($11.48 in chips) 
Seat 8: Perstenev ($12.65 in chips) 
Seat 9: DrunkTyphoon ($28.87 in chips) 
aivvo: posts small blind $0.10
xxx Spb xxx: posts big blind $0.25
*** HOLE CARDS ***
Dealt to chiyuki [7d Qs]
4plankton: folds 
chiyuki: folds 
INSP!RON: folds 
KeLevro0: folds 
Perstenev: folds 
DrunkTyphoon: calls $0.25
mjmichi: folds 
aivvo: calls $0.15
xxx Spb xxx: checks 
*** FLOP *** [Ks 7c 2s]
aivvo: checks 
xxx Spb xxx: checks 
DrunkTyphoon: bets $0.48
aivvo: folds 
xxx Spb xxx: folds 
Uncalled bet ($0.48) returned to DrunkTyphoon
DrunkTyphoon collected $0.72 from pot
DrunkTyphoon: doesn't show hand 
*** SUMMARY ***
Total pot $0.75 | Rake $0.03 
Board [Ks 7c 2s]
Seat 1: mjmichi (button) folded before Flop (didn't bet)
Seat 2: aivvo (small blind) folded on the Flop
Seat 3: xxx Spb xxx (big blind) folded on the Flop
Seat 4: 4plankton folded before Flop (didn't bet)
Seat 5: chiyuki folded before Flop (didn't bet)
Seat 6: INSP!RON folded before Flop (didn't bet)
Seat 7: KeLevro0 folded before Flop (didn't bet)
Seat 8: Perstenev folded before Flop (didn't bet)
Seat 9: DrunkTyphoon collected ($0.72)



PokerStars Zoom Hand #84300792920:  Hold'em No Limit ($0.10/$0.25) - 2012/08/05 15:51:29 JST [2012/08/05 2:51:29 ET]
Table 'Whirlpool' 9-max Seat #1 is the button
Seat 1: kesstukas25 ($14.72 in chips) 
Seat 2: snejokCoxx ($10.50 in chips) 
Seat 3: chiyuki ($34.74 in chips) 
Seat 4: seula i ($50.76 in chips) 
Seat 5: hldtom ($13.75 in chips) 
Seat 6: fwnaf ($21.56 in chips) 
Seat 7: nice.franki ($6.20 in chips) 
Seat 8: MurMurRu ($25 in chips) 
Seat 9: 4plankton ($21.48 in chips) 
snejokCoxx: posts small blind $0.10
chiyuki: posts big blind $0.25
*** HOLE CARDS ***
Dealt to chiyuki [7h Jc]
seula i: folds 
hldtom: folds 
fwnaf: folds 
nice.franki: folds 
MurMurRu: folds 
4plankton: folds 
kesstukas25: raises $0.50 to $0.75
snejokCoxx: folds 
chiyuki: folds 
Uncalled bet ($0.50) returned to kesstukas25
kesstukas25 collected $0.60 from pot
kesstukas25: doesn't show hand 
*** SUMMARY ***
Total pot $0.60 | Rake $0 
Seat 1: kesstukas25 (button) collected ($0.60)
Seat 2: snejokCoxx (small blind) folded before Flop
Seat 3: chiyuki (big blind) folded before Flop
Seat 4: seula i folded before Flop (didn't bet)
Seat 5: hldtom folded before Flop (didn't bet)
Seat 6: fwnaf folded before Flop (didn't bet)
Seat 7: nice.franki folded before Flop (didn't bet)
Seat 8: MurMurRu folded before Flop (didn't bet)
Seat 9: 4plankton folded before Flop (didn't bet)



PokerStars Zoom Hand #84300802243:  Hold'em No Limit ($0.10/$0.25) - 2012/08/05 15:52:05 JST [2012/08/05 2:52:05 ET]
Table 'Whirlpool' 9-max Seat #1 is the button
Seat 1: opie62 ($20.30 in chips) 
Seat 2: Kasperlmusik ($31.95 in chips) 
Seat 3: kwkim73 ($25 in chips) 
Seat 4: nice.franki ($5.95 in chips) 
Seat 5: vpetrovi ($12.32 in chips) 
Seat 6: Perstenev ($10.83 in chips) 
Seat 7: Lasutchik ($10.82 in chips) 
Seat 8: Grishukps ($12.50 in chips) 
Seat 9: chiyuki ($34.49 in chips) 
Kasperlmusik: posts small blind $0.10
kwkim73: posts big blind $0.25
*** HOLE CARDS ***
Dealt to chiyuki [9s 2d]
nice.franki: folds 
vpetrovi: folds 
Perstenev: folds 
Lasutchik: raises $0.50 to $0.75
Grishukps: folds 
chiyuki: folds 
opie62: folds 
Kasperlmusik: folds 
kwkim73: folds 
Uncalled bet ($0.50) returned to Lasutchik
Lasutchik collected $0.60 from pot
Lasutchik: doesn't show hand 
*** SUMMARY ***
Total pot $0.60 | Rake $0 
Seat 1: opie62 (button) folded before Flop (didn't bet)
Seat 2: Kasperlmusik (small blind) folded before Flop
Seat 3: kwkim73 (big blind) folded before Flop
Seat 4: nice.franki folded before Flop (didn't bet)
Seat 5: vpetrovi folded before Flop (didn't bet)
Seat 6: Perstenev folded before Flop (didn't bet)
Seat 7: Lasutchik collected ($0.60)
Seat 8: Grishukps folded before Flop (didn't bet)
Seat 9: chiyuki folded before Flop (didn't bet)



PokerStars Zoom Hand #84300805319:  Hold'em No Limit ($0.10/$0.25) - 2012/08/05 15:52:18 JST [2012/08/05 2:52:18 ET]
Table 'Whirlpool' 9-max Seat #1 is the button
Seat 1: xxx Spb xxx ($28.76 in chips) 
Seat 2: 1Karina1 ($43.64 in chips) 
Seat 3: Serge Claws ($25 in chips) 
Seat 4: kamikkaze ($22.83 in chips) 
Seat 5: munky3 ($25.43 in chips) 
Seat 6: chiyuki ($34.49 in chips) 
Seat 7: Perstenev ($13.60 in chips) 
Seat 8: JhonnyP1979 ($15.55 in chips) 
Seat 9: kkbruins0408 ($9.67 in chips) 
1Karina1: posts small blind $0.10
Serge Claws: posts big blind $0.25
*** HOLE CARDS ***
Dealt to chiyuki [Td 8s]
kamikkaze: folds 
munky3: raises $0.70 to $0.95
chiyuki: folds 
Perstenev: folds 
JhonnyP1979: folds 
kkbruins0408: folds 
xxx Spb xxx: folds 
1Karina1: folds 
Serge Claws: folds 
Uncalled bet ($0.70) returned to munky3
munky3 collected $0.60 from pot
munky3: doesn't show hand 
*** SUMMARY ***
Total pot $0.60 | Rake $0 
Seat 1: xxx Spb xxx (button) folded before Flop (didn't bet)
Seat 2: 1Karina1 (small blind) folded before Flop
Seat 3: Serge Claws (big blind) folded before Flop
Seat 4: kamikkaze folded before Flop (didn't bet)
Seat 5: munky3 collected ($0.60)
Seat 6: chiyuki folded before Flop (didn't bet)
Seat 7: Perstenev folded before Flop (didn't bet)
Seat 8: JhonnyP1979 folded before Flop (didn't bet)
Seat 9: kkbruins0408 folded before Flop (didn't bet)



PokerStars Zoom Hand #84300807155:  Hold'em No Limit ($0.10/$0.25) - 2012/08/05 15:52:25 JST [2012/08/05 2:52:25 ET]
Table 'Whirlpool' 9-max Seat #1 is the button
Seat 1: leo2095 ($28.50 in chips) 
Seat 2: GSDP ($24.39 in chips) 
Seat 3: Grishukps ($12.50 in chips) 
Seat 4: nice.franki ($8.48 in chips) 
Seat 5: ChrisCDee ($58.02 in chips) 
Seat 6: Dejacob ($25 in chips) 
Seat 7: chiyuki ($34.49 in chips) 
Seat 8: DrunkTyphoon ($29.88 in chips) 
Seat 9: Limoilou ($28.22 in chips) 
GSDP: posts small blind $0.10
Grishukps: posts big blind $0.25
*** HOLE CARDS ***
Dealt to chiyuki [3h 2c]
nice.franki: folds 
ChrisCDee: folds 
Dejacob: folds 
chiyuki: folds 
DrunkTyphoon: folds 
Limoilou: raises $0.37 to $0.62
leo2095: folds 
GSDP: folds 
Grishukps: folds 
Uncalled bet ($0.37) returned to Limoilou
Limoilou collected $0.60 from pot
Limoilou: doesn't show hand 
*** SUMMARY ***
Total pot $0.60 | Rake $0 
Seat 1: leo2095 (button) folded before Flop (didn't bet)
Seat 2: GSDP (small blind) folded before Flop
Seat 3: Grishukps (big blind) folded before Flop
Seat 4: nice.franki folded before Flop (didn't bet)
Seat 5: ChrisCDee folded before Flop (didn't bet)
Seat 6: Dejacob folded before Flop (didn't bet)
Seat 7: chiyuki folded before Flop (didn't bet)
Seat 8: DrunkTyphoon folded before Flop (didn't bet)
Seat 9: Limoilou collected ($0.60)



PokerStars Zoom Hand #84300804563:  Hold'em No Limit ($0.10/$0.25) - 2012/08/05 15:52:14 JST [2012/08/05 2:52:14 ET]
Table 'Whirlpool' 9-max Seat #1 is the button
Seat 1: Perstenev ($13.60 in chips) 
Seat 2: drunk_bender ($11.11 in chips) 
Seat 3: vpetrovi ($12.32 in chips) 
Seat 4: chiyuki ($34.49 in chips) 
Seat 5: ShockLaMuc ($24.78 in chips) 
Seat 6: DrunkTyphoon ($29.88 in chips) 
Seat 7: Serge Claws ($31.07 in chips) 
Seat 8: nice.franki ($12.93 in chips) 
Seat 9: Rici47 ($34.43 in chips) 
drunk_bender: posts small blind $0.10
vpetrovi: posts big blind $0.25
*** HOLE CARDS ***
Dealt to chiyuki [Jh Kh]
chiyuki: folds 
ShockLaMuc: folds 
DrunkTyphoon: folds 
Serge Claws: folds 
nice.franki: folds 
Rici47: raises $0.50 to $0.75
Perstenev: folds 
drunk_bender: folds 
vpetrovi: calls $0.50
*** FLOP *** [4c 8d Ac]
vpetrovi: checks 
Rici47: checks 
*** TURN *** [4c 8d Ac] [As]
vpetrovi: checks 
Rici47: checks 
*** RIVER *** [4c 8d Ac As] [Js]
vpetrovi: checks 
Rici47: checks 
*** SHOW DOWN ***
vpetrovi: shows [Qs Kd] (a pair of Aces)
Rici47: shows [Tc Jc] (two pair, Aces and Jacks)
Rici47 collected $1.53 from pot
*** SUMMARY ***
Total pot $1.60 | Rake $0.07 
Board [4c 8d Ac As Js]
Seat 1: Perstenev (button) folded before Flop (didn't bet)
Seat 2: drunk_bender (small blind) folded before Flop
Seat 3: vpetrovi (big blind) showed [Qs Kd] and lost with a pair of Aces
Seat 4: chiyuki folded before Flop (didn't bet)
Seat 5: ShockLaMuc folded before Flop (didn't bet)
Seat 6: DrunkTyphoon folded before Flop (didn't bet)
Seat 7: Serge Claws folded before Flop (didn't bet)
Seat 8: nice.franki folded before Flop (didn't bet)
Seat 9: Rici47 showed [Tc Jc] and won ($1.53) with two pair, Aces and Jacks



PokerStars Zoom Hand #84300809229:  Hold'em No Limit ($0.10/$0.25) - 2012/08/05 15:52:33 JST [2012/08/05 2:52:33 ET]
Table 'Whirlpool' 9-max Seat #1 is the button
Seat 1: slapshot2011 ($21.94 in chips) 
Seat 2: westhavenbc ($19.75 in chips) 
Seat 3: panaam ($36.41 in chips) 
Seat 4: seula i ($26.56 in chips) 
Seat 5: chiyuki ($34.39 in chips) 
Seat 6: Kozyavkin ($20.38 in chips) 
Seat 7: masterkoolb ($13.27 in chips) 
Seat 8: snejokCoxx ($10.75 in chips) 
Seat 9: 1Karina1 ($43.54 in chips) 
westhavenbc: posts small blind $0.10
panaam: posts big blind $0.25
*** HOLE CARDS ***
Dealt to chiyuki [8d Kc]
seula i: raises $0.50 to $0.75
chiyuki: folds 
Kozyavkin: folds 
masterkoolb: folds 
snejokCoxx: folds 
1Karina1: folds 
slapshot2011: calls $0.75
westhavenbc: folds 
panaam: folds 
*** FLOP *** [Jc Th 5c]
seula i: bets $1.50
slapshot2011: calls $1.50
*** TURN *** [Jc Th 5c] [Ac]
seula i: bets $1.75
slapshot2011: folds 
Uncalled bet ($1.75) returned to seula i
seula i collected $4.63 from pot
seula i: doesn't show hand 
*** SUMMARY ***
Total pot $4.85 | Rake $0.22 
Board [Jc Th 5c Ac]
Seat 1: slapshot2011 (button) folded on the Turn
Seat 2: westhavenbc (small blind) folded before Flop
Seat 3: panaam (big blind) folded before Flop
Seat 4: seula i collected ($4.63)
Seat 5: chiyuki folded before Flop (didn't bet)
Seat 6: Kozyavkin folded before Flop (didn't bet)
Seat 7: masterkoolb folded before Flop (didn't bet)
Seat 8: snejokCoxx folded before Flop (didn't bet)
Seat 9: 1Karina1 folded before Flop (didn't bet)



PokerStars Zoom Hand #84300813359:  Hold'em No Limit ($0.10/$0.25) - 2012/08/05 15:52:49 JST [2012/08/05 2:52:49 ET]
Table 'Whirlpool' 9-max Seat #1 is the button
Seat 1: kamikkaze ($22.73 in chips) 
Seat 2: risekuku468 ($34.86 in chips) 
Seat 3: Alvinpe85 ($44.80 in chips) 
Seat 4: snejokCoxx ($12.15 in chips) 
Seat 5: nice.franki ($6.20 in chips) 
Seat 6: Femali54 ($24.84 in chips) 
Seat 7: xxx Spb xxx ($28.76 in chips) 
Seat 8: phate-1up ($59.38 in chips) 
Seat 9: chiyuki ($34.39 in chips) 
risekuku468: posts small blind $0.10
Alvinpe85: posts big blind $0.25
*** HOLE CARDS ***
Dealt to chiyuki [5h 3d]
snejokCoxx: folds 
nice.franki: folds 
Femali54: raises $0.50 to $0.75
xxx Spb xxx: folds 
phate-1up: folds 
chiyuki: folds 
kamikkaze: folds 
risekuku468: folds 
Alvinpe85: folds 
Uncalled bet ($0.50) returned to Femali54
Femali54 collected $0.60 from pot
Femali54: doesn't show hand 
*** SUMMARY ***
Total pot $0.60 | Rake $0 
Seat 1: kamikkaze (button) folded before Flop (didn't bet)
Seat 2: risekuku468 (small blind) folded before Flop
Seat 3: Alvinpe85 (big blind) folded before Flop
Seat 4: snejokCoxx folded before Flop (didn't bet)
Seat 5: nice.franki folded before Flop (didn't bet)
Seat 6: Femali54 collected ($0.60)
Seat 7: xxx Spb xxx folded before Flop (didn't bet)
Seat 8: phate-1up folded before Flop (didn't bet)
Seat 9: chiyuki folded before Flop (didn't bet)



PokerStars Zoom Hand #84300814132:  Hold'em No Limit ($0.10/$0.25) - 2012/08/05 15:52:52 JST [2012/08/05 2:52:52 ET]
Table 'Whirlpool' 9-max Seat #1 is the button
Seat 1: Serge Claws ($30.72 in chips) 
Seat 2: Rilko1975 ($25.40 in chips) 
Seat 3: masterkoolb ($13.90 in chips) 
Seat 4: chiyuki ($34.39 in chips) 
Seat 5: KeLevro0 ($12.50 in chips) 
Seat 6: nice.franki ($6.20 in chips) 
Seat 7: MurMurRu ($25.25 in chips) 
Seat 8: Perstenev ($11.73 in chips) 
Seat 9: Ellen1947 ($29.90 in chips) 
Rilko1975: posts small blind $0.10
masterkoolb: posts big blind $0.25
*** HOLE CARDS ***
Dealt to chiyuki [9d 4s]
chiyuki: folds 
KeLevro0: folds 
nice.franki: folds 
MurMurRu: raises $0.42 to $0.67
Perstenev: folds 
Ellen1947: folds 
Serge Claws: folds 
Rilko1975: folds 
masterkoolb: folds 
Uncalled bet ($0.42) returned to MurMurRu
MurMurRu collected $0.60 from pot
MurMurRu: doesn't show hand 
*** SUMMARY ***
Total pot $0.60 | Rake $0 
Seat 1: Serge Claws (button) folded before Flop (didn't bet)
Seat 2: Rilko1975 (small blind) folded before Flop
Seat 3: masterkoolb (big blind) folded before Flop
Seat 4: chiyuki folded before Flop (didn't bet)
Seat 5: KeLevro0 folded before Flop (didn't bet)
Seat 6: nice.franki folded before Flop (didn't bet)
Seat 7: MurMurRu collected ($0.60)
Seat 8: Perstenev folded before Flop (didn't bet)
Seat 9: Ellen1947 folded before Flop (didn't bet)



PokerStars Zoom Hand #84300814921:  Hold'em No Limit ($0.10/$0.25) - 2012/08/05 15:52:55 JST [2012/08/05 2:52:55 ET]
Table 'Whirlpool' 9-max Seat #1 is the button
Seat 1: Saruotiss ($63.43 in chips) 
Seat 2: Kasperlmusik ($25 in chips) 
Seat 3: chiyuki ($34.39 in chips) 
Seat 4: 1Karina1 ($25 in chips) 
Seat 5: KrystalAA ($15.26 in chips) 
Seat 6: Perstenev ($10.48 in chips) 
Seat 7: Rici47 ($41.88 in chips) 
Seat 8: mjmichi ($36.76 in chips) 
Seat 9: silvno31 ($62.10 in chips) 
Kasperlmusik: posts small blind $0.10
chiyuki: posts big blind $0.25
*** HOLE CARDS ***
Dealt to chiyuki [7h 8c]
1Karina1: folds 
KrystalAA: folds 
Perstenev: folds 
Rici47: folds 
mjmichi: folds 
silvno31: folds 
Saruotiss: folds 
Kasperlmusik: folds 
Uncalled bet ($0.15) returned to chiyuki
chiyuki collected $0.20 from pot
chiyuki: doesn't show hand 
*** SUMMARY ***
Total pot $0.20 | Rake $0 
Seat 1: Saruotiss (button) folded before Flop (didn't bet)
Seat 2: Kasperlmusik (small blind) folded before Flop
Seat 3: chiyuki (big blind) collected ($0.20)
Seat 4: 1Karina1 folded before Flop (didn't bet)
Seat 5: KrystalAA folded before Flop (didn't bet)
Seat 6: Perstenev folded before Flop (didn't bet)
Seat 7: Rici47 folded before Flop (didn't bet)
Seat 8: mjmichi folded before Flop (didn't bet)
Seat 9: silvno31 folded before Flop (didn't bet)



PokerStars Zoom Hand #84300808458:  Hold'em No Limit ($0.10/$0.25) - 2012/08/05 15:52:30 JST [2012/08/05 2:52:30 ET]
Table 'Whirlpool' 9-max Seat #1 is the button
Seat 1: NENE54 ($16.16 in chips) 
Seat 2: chiyuki ($34.49 in chips) 
Seat 3: God)Squall ($28.99 in chips) 
Seat 4: Jene4kaBest ($18.93 in chips) 
Seat 5: nice.franki ($8.48 in chips) 
Seat 6: kkbruins0408 ($9.67 in chips) 
Seat 7: Perstenev ($12.62 in chips) 
Seat 8: Silveystryk ($46.53 in chips) 
Seat 9: kesstukas25 ($18.43 in chips) 
chiyuki: posts small blind $0.10
God)Squall: posts big blind $0.25
*** HOLE CARDS ***
Dealt to chiyuki [2d 7s]
Jene4kaBest: folds 
nice.franki: folds 
kkbruins0408: folds 
Perstenev: raises $0.50 to $0.75
Silveystryk: folds 
kesstukas25: folds 
NENE54: calls $0.75
chiyuki: folds 
God)Squall: calls $0.50
*** FLOP *** [Th 2c 7h]
God)Squall: checks 
Perstenev: checks 
NENE54: checks 
*** TURN *** [Th 2c 7h] [7d]
God)Squall: checks 
Perstenev: checks 
NENE54: checks 
*** RIVER *** [Th 2c 7h 7d] [2s]
God)Squall: checks 
Perstenev: checks 
NENE54: bets $0.75
God)Squall: folds 
Perstenev: calls $0.75
*** SHOW DOWN ***
NENE54: shows [5s Ah] (two pair, Sevens and Deuces)
Perstenev: shows [Ac Kd] (two pair, Sevens and Deuces)
Perstenev collected $1.84 from pot
NENE54 collected $1.84 from pot
*** SUMMARY ***
Total pot $3.85 | Rake $0.17 
Board [Th 2c 7h 7d 2s]
Seat 1: NENE54 (button) showed [5s Ah] and won ($1.84) with two pair, Sevens and Deuces
Seat 2: chiyuki (small blind) folded before Flop
Seat 3: God)Squall (big blind) folded on the River
Seat 4: Jene4kaBest folded before Flop (didn't bet)
Seat 5: nice.franki folded before Flop (didn't bet)
Seat 6: kkbruins0408 folded before Flop (didn't bet)
Seat 7: Perstenev showed [Ac Kd] and won ($1.84) with two pair, Sevens and Deuces
Seat 8: Silveystryk folded before Flop (didn't bet)
Seat 9: kesstukas25 folded before Flop (didn't bet)



PokerStars Zoom Hand #84300810502:  Hold'em No Limit ($0.10/$0.25) - 2012/08/05 15:52:38 JST [2012/08/05 2:52:38 ET]
Table 'Whirlpool' 9-max Seat #1 is the button
Seat 1: chiyuki ($34.39 in chips) 
Seat 2: kamikkaze ($22.83 in chips) 
Seat 3: Kozyavkin ($20.38 in chips) 
Seat 4: DrunkTyphoon ($28.99 in chips) 
Seat 5: Rilko1975 ($23.37 in chips) 
Seat 6: pawn909 ($24.58 in chips) 
Seat 7: Dejacob ($25 in chips) 
Seat 8: INSP!RON ($37.54 in chips) 
Seat 9: 1Karina1 ($36.57 in chips) 
kamikkaze: posts small blind $0.10
Kozyavkin: posts big blind $0.25
*** HOLE CARDS ***
Dealt to chiyuki [3h 4c]
DrunkTyphoon: folds 
Rilko1975: folds 
pawn909: folds 
Dejacob: raises $0.50 to $0.75
INSP!RON: folds 
1Karina1: calls $0.75
chiyuki: folds 
kamikkaze: folds 
Kozyavkin: calls $0.50
*** FLOP *** [Ts 7c 9h]
Kozyavkin: checks 
Dejacob: bets $1.75
1Karina1: folds 
Kozyavkin: folds 
Uncalled bet ($1.75) returned to Dejacob
Dejacob collected $2.24 from pot
Dejacob: doesn't show hand 
*** SUMMARY ***
Total pot $2.35 | Rake $0.11 
Board [Ts 7c 9h]
Seat 1: chiyuki (button) folded before Flop (didn't bet)
Seat 2: kamikkaze (small blind) folded before Flop
Seat 3: Kozyavkin (big blind) folded on the Flop
Seat 4: DrunkTyphoon folded before Flop (didn't bet)
Seat 5: Rilko1975 folded before Flop (didn't bet)
Seat 6: pawn909 folded before Flop (didn't bet)
Seat 7: Dejacob collected ($2.24)
Seat 8: INSP!RON folded before Flop (didn't bet)
Seat 9: 1Karina1 folded on the Flop



PokerStars Zoom Hand #84300821725:  Hold'em No Limit ($0.10/$0.25) - 2012/08/05 15:53:21 JST [2012/08/05 2:53:21 ET]
Table 'Whirlpool' 9-max Seat #1 is the button
Seat 1: rey2040 ($14.15 in chips) 
Seat 2: KrystalAA ($15.01 in chips) 
Seat 3: KeLevro0 ($12.50 in chips) 
Seat 4: masterkoolb ($13.65 in chips) 
Seat 5: MurMurRu ($25 in chips) 
Seat 6: chiyuki ($34.49 in chips) 
Seat 7: vpetrovi ($11.47 in chips) 
Seat 8: hldtom ($30.09 in chips) 
Seat 9: kwkim73 ($26.78 in chips) 
KrystalAA: posts small blind $0.10
KeLevro0: posts big blind $0.25
*** HOLE CARDS ***
Dealt to chiyuki [6c Qc]
masterkoolb: folds 
MurMurRu: folds 
chiyuki: folds 
vpetrovi: folds 
hldtom: folds 
kwkim73: folds 
rey2040: raises $0.50 to $0.75
KrystalAA: folds 
KeLevro0: folds 
Uncalled bet ($0.50) returned to rey2040
rey2040 collected $0.60 from pot
rey2040: doesn't show hand 
*** SUMMARY ***
Total pot $0.60 | Rake $0 
Seat 1: rey2040 (button) collected ($0.60)
Seat 2: KrystalAA (small blind) folded before Flop
Seat 3: KeLevro0 (big blind) folded before Flop
Seat 4: masterkoolb folded before Flop (didn't bet)
Seat 5: MurMurRu folded before Flop (didn't bet)
Seat 6: chiyuki folded before Flop (didn't bet)
Seat 7: vpetrovi folded before Flop (didn't bet)
Seat 8: hldtom folded before Flop (didn't bet)
Seat 9: kwkim73 folded before Flop (didn't bet)



PokerStars Zoom Hand #84300803506:  Hold'em No Limit ($0.10/$0.25) - 2012/08/05 15:52:10 JST [2012/08/05 2:52:10 ET]
Table 'Whirlpool' 9-max Seat #1 is the button
Seat 1: 1Karina1 ($36.57 in chips) 
Seat 2: Alvinpe85 ($44.90 in chips) 
Seat 3: Kasperlmusik ($31.85 in chips) 
Seat 4: mjmichi ($68.98 in chips) 
Seat 5: nastya040 ($18.51 in chips) 
Seat 6: MurMurRu ($25 in chips) 
Seat 7: TorTrade ($25.29 in chips) 
Seat 8: chiyuki ($34.49 in chips) 
Seat 9: NENE54 ($16.16 in chips) 
Alvinpe85: posts small blind $0.10
Kasperlmusik: posts big blind $0.25
*** HOLE CARDS ***
Dealt to chiyuki [Kc 5c]
mjmichi: raises $0.50 to $0.75
nastya040: calls $0.75
MurMurRu: folds 
TorTrade: folds 
chiyuki: folds 
NENE54: folds 
1Karina1: folds 
Alvinpe85: folds 
Kasperlmusik: folds 
*** FLOP *** [4h Td Ts]
mjmichi: checks 
nastya040: bets $0.50
mjmichi: calls $0.50
*** TURN *** [4h Td Ts] [Tc]
mjmichi: checks 
nastya040: checks 
*** RIVER *** [4h Td Ts Tc] [6c]
mjmichi: bets $2.75
nastya040: raises $2.75 to $5.50
mjmichi: raises $62.23 to $67.73 and is all-in
nastya040: calls $11.76 and is all-in
Uncalled bet ($50.47) returned to mjmichi
*** SHOW DOWN ***
mjmichi: shows [Th Jh] (four of a kind, Tens)
nastya040: shows [Qc Qs] (a full house, Tens full of Queens)
mjmichi collected $35.69 from pot
*** SUMMARY ***
Total pot $37.37 | Rake $1.68 
Board [4h Td Ts Tc 6c]
Seat 1: 1Karina1 (button) folded before Flop (didn't bet)
Seat 2: Alvinpe85 (small blind) folded before Flop
Seat 3: Kasperlmusik (big blind) folded before Flop
Seat 4: mjmichi showed [Th Jh] and won ($35.69) with four of a kind, Tens
Seat 5: nastya040 showed [Qc Qs] and lost with a full house, Tens full of Queens
Seat 6: MurMurRu folded before Flop (didn't bet)
Seat 7: TorTrade folded before Flop (didn't bet)
Seat 8: chiyuki folded before Flop (didn't bet)
Seat 9: NENE54 folded before Flop (didn't bet)



PokerStars Zoom Hand #84300820446:  Hold'em No Limit ($0.10/$0.25) - 2012/08/05 15:53:16 JST [2012/08/05 2:53:16 ET]
Table 'Whirlpool' 9-max Seat #1 is the button
Seat 1: drunk_bender ($11.36 in chips) 
Seat 2: 1Karina1 ($35.82 in chips) 
Seat 3: jacquelinewu ($73.42 in chips) 
Seat 4: GovGus ($25 in chips) 
Seat 5: Perstenev ($12.96 in chips) 
Seat 6: Saruotiss ($63.18 in chips) 
Seat 7: DrunkTyphoon ($32.62 in chips) 
Seat 8: chiyuki ($34.49 in chips) 
Seat 9: Nerkit ($12.62 in chips) 
1Karina1: posts small blind $0.10
jacquelinewu: posts big blind $0.25
*** HOLE CARDS ***
Dealt to chiyuki [7c Ts]
GovGus: folds 
Perstenev: folds 
Saruotiss: folds 
DrunkTyphoon: folds 
chiyuki: folds 
Nerkit: folds 
drunk_bender: raises $0.50 to $0.75
1Karina1: folds 
jacquelinewu: raises $1.25 to $2
drunk_bender: calls $1.25
*** FLOP *** [Ks 7s 5s]
jacquelinewu: checks 
drunk_bender: checks 
*** TURN *** [Ks 7s 5s] [9h]
jacquelinewu: checks 
drunk_bender: bets $1.25
jacquelinewu: calls $1.25
*** RIVER *** [Ks 7s 5s 9h] [9s]
jacquelinewu: checks 
drunk_bender: checks 
*** SHOW DOWN ***
jacquelinewu: shows [Jc Jh] (two pair, Jacks and Nines)
drunk_bender: shows [Kc Qh] (two pair, Kings and Nines)
drunk_bender collected $6.30 from pot
*** SUMMARY ***
Total pot $6.60 | Rake $0.30 
Board [Ks 7s 5s 9h 9s]
Seat 1: drunk_bender (button) showed [Kc Qh] and won ($6.30) with two pair, Kings and Nines
Seat 2: 1Karina1 (small blind) folded before Flop
Seat 3: jacquelinewu (big blind) showed [Jc Jh] and lost with two pair, Jacks and Nines
Seat 4: GovGus folded before Flop (didn't bet)
Seat 5: Perstenev folded before Flop (didn't bet)
Seat 6: Saruotiss folded before Flop (didn't bet)
Seat 7: DrunkTyphoon folded before Flop (didn't bet)
Seat 8: chiyuki folded before Flop (didn't bet)
Seat 9: Nerkit folded before Flop (didn't bet)



PokerStars Zoom Hand #84300823987:  Hold'em No Limit ($0.10/$0.25) - 2012/08/05 15:53:31 JST [2012/08/05 2:53:31 ET]
Table 'Whirlpool' 9-max Seat #1 is the button
Seat 1: 4plankton ($21.13 in chips) 
Seat 2: chiyuki ($34.49 in chips) 
Seat 3: Ellen1947 ($30.92 in chips) 
Seat 4: Rilko1975 ($25.65 in chips) 
Seat 5: kwkim73 ($25 in chips) 
Seat 6: Alvinpe85 ($44.45 in chips) 
Seat 7: Fructionar ($37.98 in chips) 
Seat 8: Grishukps ($12.50 in chips) 
Seat 9: Limoilou ($28.22 in chips) 
chiyuki: posts small blind $0.10
Ellen1947: posts big blind $0.25
*** HOLE CARDS ***
Dealt to chiyuki [Jc Kd]
Rilko1975: folds 
kwkim73: folds 
Alvinpe85: folds 
Fructionar: calls $0.25
Grishukps: calls $0.25
Limoilou: folds 
4plankton: folds 
chiyuki: calls $0.15
Ellen1947: checks 
*** FLOP *** [3h 9c Kc]
chiyuki: checks 
Ellen1947: checks 
Fructionar: checks 
Grishukps: checks 
*** TURN *** [3h 9c Kc] [Ah]
chiyuki: checks 
Ellen1947: checks 
Fructionar: checks 
Grishukps: checks 
*** RIVER *** [3h 9c Kc Ah] [Jd]
chiyuki: bets $0.75
Ellen1947: folds 
Fructionar: folds 
Grishukps: folds 
Uncalled bet ($0.75) returned to chiyuki
chiyuki collected $0.96 from pot
chiyuki: doesn't show hand 
*** SUMMARY ***
Total pot $1 | Rake $0.04 
Board [3h 9c Kc Ah Jd]
Seat 1: 4plankton (button) folded before Flop (didn't bet)
Seat 2: chiyuki (small blind) collected ($0.96)
Seat 3: Ellen1947 (big blind) folded on the River
Seat 4: Rilko1975 folded before Flop (didn't bet)
Seat 5: kwkim73 folded before Flop (didn't bet)
Seat 6: Alvinpe85 folded before Flop (didn't bet)
Seat 7: Fructionar folded on the River
Seat 8: Grishukps folded on the River
Seat 9: Limoilou folded before Flop (didn't bet)



PokerStars Zoom Hand #84300839479:  Hold'em No Limit ($0.10/$0.25) - 2012/08/05 15:54:31 JST [2012/08/05 2:54:31 ET]
Table 'Whirlpool' 9-max Seat #1 is the button
Seat 1: Rici47 ($27.96 in chips) 
Seat 2: Ellen1947 ($30.67 in chips) 
Seat 3: River_GmbH ($21.79 in chips) 
Seat 4: 1Karina1 ($34.87 in chips) 
Seat 5: Serge Claws ($29.62 in chips) 
Seat 6: kamikkaze ($18.05 in chips) 
Seat 7: chiyuki ($35.20 in chips) 
Seat 8: nice.franki ($12.23 in chips) 
Seat 9: phate-1up ($53.82 in chips) 
Ellen1947: posts small blind $0.10
River_GmbH: posts big blind $0.25
*** HOLE CARDS ***
Dealt to chiyuki [Qs 6c]
1Karina1: folds 
Serge Claws: folds 
kamikkaze: folds 
chiyuki: folds 
nice.franki: folds 
phate-1up: raises $0.50 to $0.75
Rici47: folds 
Ellen1947: folds 
River_GmbH: folds 
Uncalled bet ($0.50) returned to phate-1up
phate-1up collected $0.60 from pot
phate-1up: doesn't show hand 
*** SUMMARY ***
Total pot $0.60 | Rake $0 
Seat 1: Rici47 (button) folded before Flop (didn't bet)
Seat 2: Ellen1947 (small blind) folded before Flop
Seat 3: River_GmbH (big blind) folded before Flop
Seat 4: 1Karina1 folded before Flop (didn't bet)
Seat 5: Serge Claws folded before Flop (didn't bet)
Seat 6: kamikkaze folded before Flop (didn't bet)
Seat 7: chiyuki folded before Flop (didn't bet)
Seat 8: nice.franki folded before Flop (didn't bet)
Seat 9: phate-1up collected ($0.60)



PokerStars Zoom Hand #84300840768:  Hold'em No Limit ($0.10/$0.25) - 2012/08/05 15:54:36 JST [2012/08/05 2:54:36 ET]
Table 'Whirlpool' 9-max Seat #1 is the button
Seat 1: Alvinpe85 ($43.48 in chips) 
Seat 2: CrittHunter ($29.29 in chips) 
Seat 3: Serge Claws ($29.62 in chips) 
Seat 4: SAILUSI ($32.17 in chips) 
Seat 5: chiyuki ($35.20 in chips) 
Seat 6: Kozyavkin ($19.38 in chips) 
Seat 7: MurMurRu ($26.99 in chips) 
Seat 8: ChrisCDee ($44.99 in chips) 
Seat 9: 4plankton ($20.78 in chips) 
CrittHunter: posts small blind $0.10
Serge Claws: posts big blind $0.25
*** HOLE CARDS ***
Dealt to chiyuki [8h 8c]
SAILUSI: folds 
chiyuki: raises $0.50 to $0.75
Kozyavkin: folds 
MurMurRu: folds 
ChrisCDee: folds 
4plankton: folds 
Alvinpe85: folds 
CrittHunter: folds 
Serge Claws: calls $0.50
*** FLOP *** [8d 4h 5h]
Serge Claws: checks 
chiyuki: bets $1
Serge Claws: calls $1
*** TURN *** [8d 4h 5h] [6d]
Serge Claws: bets $2
chiyuki: calls $2
*** RIVER *** [8d 4h 5h 6d] [4d]
Serge Claws: checks 
chiyuki: bets $6
Serge Claws: folds 
Uncalled bet ($6) returned to chiyuki
chiyuki collected $7.26 from pot
chiyuki: doesn't show hand 
*** SUMMARY ***
Total pot $7.60 | Rake $0.34 
Board [8d 4h 5h 6d 4d]
Seat 1: Alvinpe85 (button) folded before Flop (didn't bet)
Seat 2: CrittHunter (small blind) folded before Flop
Seat 3: Serge Claws (big blind) folded on the River
Seat 4: SAILUSI folded before Flop (didn't bet)
Seat 5: chiyuki collected ($7.26)
Seat 6: Kozyavkin folded before Flop (didn't bet)
Seat 7: MurMurRu folded before Flop (didn't bet)
Seat 8: ChrisCDee folded before Flop (didn't bet)
Seat 9: 4plankton folded before Flop (didn't bet)



PokerStars Zoom Hand #84300852661:  Hold'em No Limit ($0.10/$0.25) - 2012/08/05 15:55:28 JST [2012/08/05 2:55:28 ET]
Table 'Whirlpool' 9-max Seat #1 is the button
Seat 1: kesstukas25 ($17.46 in chips) 
Seat 2: DrunkTyphoon ($37.76 in chips) 
Seat 3: masterkoolb ($18.19 in chips) 
Seat 4: chiyuki ($38.71 in chips) 
Seat 5: ShockLaMuc ($22.30 in chips) 
Seat 6: kamikkaze ($17.70 in chips) 
Seat 7: Rilko1975 ($25 in chips) 
Seat 8: Grishukps ($14.85 in chips) 
Seat 9: Rici47 ($36.78 in chips) 
DrunkTyphoon: posts small blind $0.10
masterkoolb: posts big blind $0.25
*** HOLE CARDS ***
Dealt to chiyuki [8d Js]
chiyuki: folds 
ShockLaMuc: folds 
kamikkaze: folds 
Rilko1975: folds 
Grishukps: folds 
Rici47: folds 
kesstukas25: folds 
DrunkTyphoon: folds 
Uncalled bet ($0.15) returned to masterkoolb
masterkoolb collected $0.20 from pot
masterkoolb: doesn't show hand 
*** SUMMARY ***
Total pot $0.20 | Rake $0 
Seat 1: kesstukas25 (button) folded before Flop (didn't bet)
Seat 2: DrunkTyphoon (small blind) folded before Flop
Seat 3: masterkoolb (big blind) collected ($0.20)
Seat 4: chiyuki folded before Flop (didn't bet)
Seat 5: ShockLaMuc folded before Flop (didn't bet)
Seat 6: kamikkaze folded before Flop (didn't bet)
Seat 7: Rilko1975 folded before Flop (didn't bet)
Seat 8: Grishukps folded before Flop (didn't bet)
Seat 9: Rici47 folded before Flop (didn't bet)



PokerStars Zoom Hand #84300854524:  Hold'em No Limit ($0.10/$0.25) - 2012/08/05 15:55:37 JST [2012/08/05 2:55:37 ET]
Table 'Whirlpool' 9-max Seat #1 is the button
Seat 1: Ellen1947 ($30.05 in chips) 
Seat 2: Perstenev ($8.53 in chips) 
Seat 3: Rilko1975 ($25 in chips) 
Seat 4: opie62 ($24.65 in chips) 
Seat 5: MurMurRu ($25 in chips) 
Seat 6: GovGus ($61.30 in chips) 
Seat 7: DrunkTyphoon ($37.66 in chips) 
Seat 8: seula i ($47.41 in chips) 
Seat 9: chiyuki ($38.71 in chips) 
Perstenev: posts small blind $0.10
Rilko1975: posts big blind $0.25
*** HOLE CARDS ***
Dealt to chiyuki [2c 2h]
opie62: raises $0.50 to $0.75
MurMurRu: folds 
GovGus: folds 
DrunkTyphoon: folds 
seula i: folds 
chiyuki: folds 
Ellen1947: folds 
Perstenev: folds 
Rilko1975: folds 
Uncalled bet ($0.50) returned to opie62
opie62 collected $0.60 from pot
opie62: doesn't show hand 
*** SUMMARY ***
Total pot $0.60 | Rake $0 
Seat 1: Ellen1947 (button) folded before Flop (didn't bet)
Seat 2: Perstenev (small blind) folded before Flop
Seat 3: Rilko1975 (big blind) folded before Flop
Seat 4: opie62 collected ($0.60)
Seat 5: MurMurRu folded before Flop (didn't bet)
Seat 6: GovGus folded before Flop (didn't bet)
Seat 7: DrunkTyphoon folded before Flop (didn't bet)
Seat 8: seula i folded before Flop (didn't bet)
Seat 9: chiyuki folded before Flop (didn't bet)



PokerStars Zoom Hand #84300858349:  Hold'em No Limit ($0.10/$0.25) - 2012/08/05 15:55:55 JST [2012/08/05 2:55:55 ET]
Table 'Whirlpool' 9-max Seat #1 is the button
Seat 1: 1Karina1 ($25 in chips) 
Seat 2: mjmichi ($87.13 in chips) 
Seat 3: snejokCoxx ($10.44 in chips) 
Seat 4: INSP!RON ($31.56 in chips) 
Seat 5: seula i ($47.31 in chips) 
Seat 6: MurMurRu ($25 in chips) 
Seat 7: Spheroff ($7.42 in chips) 
Seat 8: chiyuki ($38.71 in chips) 
Seat 9: kwkim73 ($25 in chips) 
mjmichi: posts small blind $0.10
snejokCoxx: posts big blind $0.25
*** HOLE CARDS ***
Dealt to chiyuki [Qh 8h]
INSP!RON: raises $0.50 to $0.75
seula i: folds 
MurMurRu: folds 
Spheroff: folds 
chiyuki: folds 
kwkim73: folds 
1Karina1: folds 
mjmichi: folds 
snejokCoxx: folds 
Uncalled bet ($0.50) returned to INSP!RON
INSP!RON collected $0.60 from pot
INSP!RON: doesn't show hand 
*** SUMMARY ***
Total pot $0.60 | Rake $0 
Seat 1: 1Karina1 (button) folded before Flop (didn't bet)
Seat 2: mjmichi (small blind) folded before Flop
Seat 3: snejokCoxx (big blind) folded before Flop
Seat 4: INSP!RON collected ($0.60)
Seat 5: seula i folded before Flop (didn't bet)
Seat 6: MurMurRu folded before Flop (didn't bet)
Seat 7: Spheroff folded before Flop (didn't bet)
Seat 8: chiyuki folded before Flop (didn't bet)
Seat 9: kwkim73 folded before Flop (didn't bet)



PokerStars Zoom Hand #84300853269:  Hold'em No Limit ($0.10/$0.25) - 2012/08/05 15:55:31 JST [2012/08/05 2:55:31 ET]
Table 'Whirlpool' 9-max Seat #1 is the button
Seat 1: chiyuki ($38.71 in chips) 
Seat 2: Bahia gyn ($17.01 in chips) 
Seat 3: Silveystryk ($30.61 in chips) 
Seat 4: phate-1up ($62.22 in chips) 
Seat 5: jacquelinewu ($71.09 in chips) 
Seat 6: pandaaaaaa ($14.90 in chips) 
Seat 7: herkko11 ($8.20 in chips) 
Seat 8: seula i ($29.61 in chips) 
Seat 9: rey2040 ($14.90 in chips) 
Bahia gyn: posts small blind $0.10
Silveystryk: posts big blind $0.25
*** HOLE CARDS ***
Dealt to chiyuki [7s Kd]
phate-1up: folds 
jacquelinewu: folds 
pandaaaaaa: folds 
herkko11: raises $0.50 to $0.75
seula i: folds 
rey2040: folds 
chiyuki: folds 
Bahia gyn: calls $0.65
Silveystryk: folds 
*** FLOP *** [6s Ah As]
Bahia gyn: checks 
herkko11: bets $0.75
Bahia gyn: calls $0.75
*** TURN *** [6s Ah As] [Kh]
Bahia gyn: checks 
herkko11: bets $1
Bahia gyn: calls $1
*** RIVER *** [6s Ah As Kh] [3s]
Bahia gyn: checks 
herkko11: checks 
*** SHOW DOWN ***
Bahia gyn: shows [9s Ts] (a flush, Ace high)
herkko11: mucks hand 
Bahia gyn collected $5.01 from pot
*** SUMMARY ***
Total pot $5.25 | Rake $0.24 
Board [6s Ah As Kh 3s]
Seat 1: chiyuki (button) folded before Flop (didn't bet)
Seat 2: Bahia gyn (small blind) showed [9s Ts] and won ($5.01) with a flush, Ace high
Seat 3: Silveystryk (big blind) folded before Flop
Seat 4: phate-1up folded before Flop (didn't bet)
Seat 5: jacquelinewu folded before Flop (didn't bet)
Seat 6: pandaaaaaa folded before Flop (didn't bet)
Seat 7: herkko11 mucked [Ac Qh]
Seat 8: seula i folded before Flop (didn't bet)
Seat 9: rey2040 folded before Flop (didn't bet)



PokerStars Zoom Hand #84300860459:  Hold'em No Limit ($0.10/$0.25) - 2012/08/05 15:56:06 JST [2012/08/05 2:56:06 ET]
Table 'Whirlpool' 9-max Seat #1 is the button
Seat 1: opie62 ($25 in chips) 
Seat 2: Perstenev ($11.40 in chips) 
Seat 3: chiyuki ($38.71 in chips) 
Seat 4: kkbruins0408 ($8.29 in chips) 
Seat 5: Jene4kaBest ($13.58 in chips) 
Seat 6: munky3 ($28.38 in chips) 
Seat 7: DrunkTyphoon ($45.54 in chips) 
Seat 8: laurentzu84 ($25 in chips) 
Seat 9: SAILUSI ($33.06 in chips) 
Perstenev: posts small blind $0.10
chiyuki: posts big blind $0.25
*** HOLE CARDS ***
Dealt to chiyuki [Ts 8c]
kkbruins0408: folds 
Jene4kaBest: folds 
munky3: folds 
DrunkTyphoon: folds 
laurentzu84: raises $0.50 to $0.75
SAILUSI: folds 
opie62: calls $0.75
Perstenev: folds 
chiyuki: folds 
*** FLOP *** [8s 3h Ac]
laurentzu84: bets $1
opie62: folds 
Uncalled bet ($1) returned to laurentzu84
laurentzu84 collected $1.77 from pot
laurentzu84: doesn't show hand 
*** SUMMARY ***
Total pot $1.85 | Rake $0.08 
Board [8s 3h Ac]
Seat 1: opie62 (button) folded on the Flop
Seat 2: Perstenev (small blind) folded before Flop
Seat 3: chiyuki (big blind) folded before Flop
Seat 4: kkbruins0408 folded before Flop (didn't bet)
Seat 5: Jene4kaBest folded before Flop (didn't bet)
Seat 6: munky3 folded before Flop (didn't bet)
Seat 7: DrunkTyphoon folded before Flop (didn't bet)
Seat 8: laurentzu84 collected ($1.77)
Seat 9: SAILUSI folded before Flop (didn't bet)



PokerStars Zoom Hand #84300863373:  Hold'em No Limit ($0.10/$0.25) - 2012/08/05 15:56:20 JST [2012/08/05 2:56:20 ET]
Table 'Whirlpool' 9-max Seat #1 is the button
Seat 1: masterkoolb ($18.19 in chips) 
Seat 2: phate-1up ($40.68 in chips) 
Seat 3: Spheroff ($7.42 in chips) 
Seat 4: GovGus ($28.87 in chips) 
Seat 5: Grishukps ($17.06 in chips) 
Seat 6: chiyuki ($38.46 in chips) 
Seat 7: Silveystryk ($30.26 in chips) 
Seat 8: snejokCoxx ($11.50 in chips) 
Seat 9: Ellen1947 ($29.80 in chips) 
phate-1up: posts small blind $0.10
Spheroff: posts big blind $0.25
*** HOLE CARDS ***
Dealt to chiyuki [Jh 2s]
GovGus: folds 
Grishukps: folds 
chiyuki: folds 
Silveystryk: folds 
snejokCoxx: folds 
Ellen1947: folds 
masterkoolb: folds 
phate-1up: folds 
Uncalled bet ($0.15) returned to Spheroff
Spheroff collected $0.20 from pot
Spheroff: doesn't show hand 
*** SUMMARY ***
Total pot $0.20 | Rake $0 
Seat 1: masterkoolb (button) folded before Flop (didn't bet)
Seat 2: phate-1up (small blind) folded before Flop
Seat 3: Spheroff (big blind) collected ($0.20)
Seat 4: GovGus folded before Flop (didn't bet)
Seat 5: Grishukps folded before Flop (didn't bet)
Seat 6: chiyuki folded before Flop (didn't bet)
Seat 7: Silveystryk folded before Flop (didn't bet)
Seat 8: snejokCoxx folded before Flop (didn't bet)
Seat 9: Ellen1947 folded before Flop (didn't bet)



PokerStars Zoom Hand #84300865910:  Hold'em No Limit ($0.10/$0.25) - 2012/08/05 15:56:32 JST [2012/08/05 2:56:32 ET]
Table 'Whirlpool' 9-max Seat #1 is the button
Seat 1: Perstenev ($11.05 in chips) 
Seat 2: chiyuki ($38.46 in chips) 
Seat 3: schoof 2 ($25.51 in chips) 
Seat 4: masterkoolb ($18.19 in chips) 
Seat 5: nice.franki ($7.53 in chips) 
Seat 6: kwkim73 ($25.35 in chips) 
Seat 7: TorTrade ($21.85 in chips) 
Seat 8: risekuku468 ($33.81 in chips) 
Seat 9: Afcawins25 ($15.74 in chips) 
chiyuki: posts small blind $0.10
schoof 2: posts big blind $0.25
*** HOLE CARDS ***
Dealt to chiyuki [5c 7c]
masterkoolb: folds 
nice.franki: folds 
kwkim73: raises $0.50 to $0.75
TorTrade: folds 
risekuku468: folds 
Afcawins25: folds 
Perstenev: folds 
chiyuki: folds 
schoof 2: folds 
Uncalled bet ($0.50) returned to kwkim73
kwkim73 collected $0.60 from pot
kwkim73: doesn't show hand 
*** SUMMARY ***
Total pot $0.60 | Rake $0 
Seat 1: Perstenev (button) folded before Flop (didn't bet)
Seat 2: chiyuki (small blind) folded before Flop
Seat 3: schoof 2 (big blind) folded before Flop
Seat 4: masterkoolb folded before Flop (didn't bet)
Seat 5: nice.franki folded before Flop (didn't bet)
Seat 6: kwkim73 collected ($0.60)
Seat 7: TorTrade folded before Flop (didn't bet)
Seat 8: risekuku468 folded before Flop (didn't bet)
Seat 9: Afcawins25 folded before Flop (didn't bet)



PokerStars Zoom Hand #84300864838:  Hold'em No Limit ($0.10/$0.25) - 2012/08/05 15:56:27 JST [2012/08/05 2:56:27 ET]
Table 'Whirlpool' 9-max Seat #1 is the button
Seat 1: MurMurRu ($27.36 in chips) 
Seat 2: jvds114 ($41.11 in chips) 
Seat 3: misskitty354 ($12.50 in chips) 
Seat 4: chiyuki ($38.46 in chips) 
Seat 5: risekuku468 ($33.81 in chips) 
Seat 6: Serge Claws ($27.60 in chips) 
Seat 7: 1Karina1 ($34.12 in chips) 
Seat 8: Ozboy80 ($25.06 in chips) 
Seat 9: masterkoolb ($18.19 in chips) 
jvds114: posts small blind $0.10
misskitty354: posts big blind $0.25
*** HOLE CARDS ***
Dealt to chiyuki [6d 6s]
chiyuki: folds 
risekuku468: folds 
Serge Claws: folds 
1Karina1: folds 
Ozboy80: folds 
masterkoolb: folds 
MurMurRu: folds 
jvds114: folds 
Uncalled bet ($0.15) returned to misskitty354
misskitty354 collected $0.20 from pot
misskitty354: doesn't show hand 
*** SUMMARY ***
Total pot $0.20 | Rake $0 
Seat 1: MurMurRu (button) folded before Flop (didn't bet)
Seat 2: jvds114 (small blind) folded before Flop
Seat 3: misskitty354 (big blind) collected ($0.20)
Seat 4: chiyuki folded before Flop (didn't bet)
Seat 5: risekuku468 folded before Flop (didn't bet)
Seat 6: Serge Claws folded before Flop (didn't bet)
Seat 7: 1Karina1 folded before Flop (didn't bet)
Seat 8: Ozboy80 folded before Flop (didn't bet)
Seat 9: masterkoolb folded before Flop (didn't bet)



PokerStars Zoom Hand #84300867385:  Hold'em No Limit ($0.10/$0.25) - 2012/08/05 15:56:39 JST [2012/08/05 2:56:39 ET]
Table 'Whirlpool' 9-max Seat #1 is the button
Seat 1: Dejacob ($30.99 in chips) 
Seat 2: Grishukps ($17.41 in chips) 
Seat 3: herkko11 ($5.70 in chips) 
Seat 4: yvasilik ($25.43 in chips) 
Seat 5: pandaaaaaa ($15.89 in chips) 
Seat 6: slapshot2011 ($18.84 in chips) 
Seat 7: Nerkit ($14.22 in chips) 
Seat 8: Serge Claws ($27.35 in chips) 
Seat 9: chiyuki ($38.36 in chips) 
Grishukps: posts small blind $0.10
herkko11: posts big blind $0.25
*** HOLE CARDS ***
Dealt to chiyuki [3d 8h]
yvasilik: folds 
pandaaaaaa: folds 
slapshot2011: folds 
Nerkit: folds 
Serge Claws: raises $0.50 to $0.75
chiyuki: folds 
Dejacob: folds 
Grishukps: folds 
herkko11: folds 
Uncalled bet ($0.50) returned to Serge Claws
Serge Claws collected $0.60 from pot
Serge Claws: doesn't show hand 
*** SUMMARY ***
Total pot $0.60 | Rake $0 
Seat 1: Dejacob (button) folded before Flop (didn't bet)
Seat 2: Grishukps (small blind) folded before Flop
Seat 3: herkko11 (big blind) folded before Flop
Seat 4: yvasilik folded before Flop (didn't bet)
Seat 5: pandaaaaaa folded before Flop (didn't bet)
Seat 6: slapshot2011 folded before Flop (didn't bet)
Seat 7: Nerkit folded before Flop (didn't bet)
Seat 8: Serge Claws collected ($0.60)
Seat 9: chiyuki folded before Flop (didn't bet)



PokerStars Zoom Hand #84300868194:  Hold'em No Limit ($0.10/$0.25) - 2012/08/05 15:56:43 JST [2012/08/05 2:56:43 ET]
Table 'Whirlpool' 9-max Seat #1 is the button
Seat 1: chiyuki ($38.36 in chips) 
Seat 2: yvasilik ($25.43 in chips) 
Seat 3: masterkoolb ($18.19 in chips) 
Seat 4: KrystalAA ($17.07 in chips) 
Seat 5: schoof 2 ($25.26 in chips) 
Seat 6: hldtom ($12.50 in chips) 
Seat 7: jacquelinewu ($71.54 in chips) 
Seat 8: Komissar82 ($10.45 in chips) 
Seat 9: Kasperlmusik ($31.35 in chips) 
yvasilik: posts small blind $0.10
masterkoolb: posts big blind $0.25
*** HOLE CARDS ***
Dealt to chiyuki [9h Kc]
KrystalAA: folds 
schoof 2: folds 
hldtom: folds 
jacquelinewu: folds 
Komissar82: folds 
Kasperlmusik: folds 
chiyuki: folds 
yvasilik: folds 
Uncalled bet ($0.15) returned to masterkoolb
masterkoolb collected $0.20 from pot
masterkoolb: doesn't show hand 
*** SUMMARY ***
Total pot $0.20 | Rake $0 
Seat 1: chiyuki (button) folded before Flop (didn't bet)
Seat 2: yvasilik (small blind) folded before Flop
Seat 3: masterkoolb (big blind) collected ($0.20)
Seat 4: KrystalAA folded before Flop (didn't bet)
Seat 5: schoof 2 folded before Flop (didn't bet)
Seat 6: hldtom folded before Flop (didn't bet)
Seat 7: jacquelinewu folded before Flop (didn't bet)
Seat 8: Komissar82 folded before Flop (didn't bet)
Seat 9: Kasperlmusik folded before Flop (didn't bet)



PokerStars Zoom Hand #84300869502:  Hold'em No Limit ($0.10/$0.25) - 2012/08/05 15:56:49 JST [2012/08/05 2:56:49 ET]
Table 'Whirlpool' 9-max Seat #1 is the button
Seat 1: rey2040 ($13.65 in chips) 
Seat 2: Rici47 ($37.85 in chips) 
Seat 3: Dejacob ($25 in chips) 
Seat 4: mjmichi ($39.24 in chips) 
Seat 5: 1Karina1 ($25 in chips) 
Seat 6: Trip_Krowns ($33.91 in chips) 
Seat 7: chiyuki ($38.36 in chips) 
Seat 8: Perstenev ($8.53 in chips) 
Seat 9: munky3 ($28.03 in chips) 
Rici47: posts small blind $0.10
Dejacob: posts big blind $0.25
*** HOLE CARDS ***
Dealt to chiyuki [Ac 3s]
mjmichi: folds 
1Karina1: folds 
Trip_Krowns: folds 
chiyuki: folds 
Perstenev: folds 
munky3: folds 
rey2040: folds 
Rici47: folds 
Uncalled bet ($0.15) returned to Dejacob
Dejacob collected $0.20 from pot
Dejacob: doesn't show hand 
*** SUMMARY ***
Total pot $0.20 | Rake $0 
Seat 1: rey2040 (button) folded before Flop (didn't bet)
Seat 2: Rici47 (small blind) folded before Flop
Seat 3: Dejacob (big blind) collected ($0.20)
Seat 4: mjmichi folded before Flop (didn't bet)
Seat 5: 1Karina1 folded before Flop (didn't bet)
Seat 6: Trip_Krowns folded before Flop (didn't bet)
Seat 7: chiyuki folded before Flop (didn't bet)
Seat 8: Perstenev folded before Flop (didn't bet)
Seat 9: munky3 folded before Flop (didn't bet)



PokerStars Zoom Hand #84300871662:  Hold'em No Limit ($0.10/$0.25) - 2012/08/05 15:56:59 JST [2012/08/05 2:56:59 ET]
Table 'Whirlpool' 9-max Seat #1 is the button
Seat 1: romanian c4 ($11.25 in chips) 
Seat 2: nice.franki ($12.73 in chips) 
Seat 3: Dan Royal ($33.58 in chips) 
Seat 4: slapshot2011 ($18.74 in chips) 
Seat 5: Jene4kaBest ($14.27 in chips) 
Seat 6: Rici47 ($37.75 in chips) 
Seat 7: chiyuki ($38.36 in chips) 
Seat 8: westhavenbc ($16.86 in chips) 
Seat 9: Serge Claws ($39.82 in chips) 
nice.franki: posts small blind $0.10
Dan Royal: posts big blind $0.25
*** HOLE CARDS ***
Dealt to chiyuki [Kc 5s]
slapshot2011: folds 
Jene4kaBest: folds 
Rici47: folds 
chiyuki: folds 
westhavenbc: folds 
Serge Claws: raises $0.50 to $0.75
romanian c4: folds 
nice.franki: folds 
Dan Royal: folds 
Uncalled bet ($0.50) returned to Serge Claws
Serge Claws collected $0.60 from pot
Serge Claws: doesn't show hand 
*** SUMMARY ***
Total pot $0.60 | Rake $0 
Seat 1: romanian c4 (button) folded before Flop (didn't bet)
Seat 2: nice.franki (small blind) folded before Flop
Seat 3: Dan Royal (big blind) folded before Flop
Seat 4: slapshot2011 folded before Flop (didn't bet)
Seat 5: Jene4kaBest folded before Flop (didn't bet)
Seat 6: Rici47 folded before Flop (didn't bet)
Seat 7: chiyuki folded before Flop (didn't bet)
Seat 8: westhavenbc folded before Flop (didn't bet)
Seat 9: Serge Claws collected ($0.60)



PokerStars Zoom Hand #84300872511:  Hold'em No Limit ($0.10/$0.25) - 2012/08/05 15:57:03 JST [2012/08/05 2:57:03 ET]
Table 'Whirlpool' 9-max Seat #1 is the button
Seat 1: Spheroff ($7.42 in chips) 
Seat 2: leo2095 ($27.25 in chips) 
Seat 3: chiyuki ($38.36 in chips) 
Seat 4: Jene4kaBest ($14.27 in chips) 
Seat 5: Rilko1975 ($25.42 in chips) 
Seat 6: INSP!RON ($39.46 in chips) 
Seat 7: westhavenbc ($16.86 in chips) 
Seat 8: Ellen1947 ($29.70 in chips) 
Seat 9: rey2040 ($13.55 in chips) 
leo2095: posts small blind $0.10
chiyuki: posts big blind $0.25
*** HOLE CARDS ***
Dealt to chiyuki [3c 7c]
Jene4kaBest: raises $0.50 to $0.75
Rilko1975: folds 
INSP!RON: folds 
westhavenbc: folds 
Ellen1947: folds 
rey2040: folds 
Spheroff: folds 
leo2095: folds 
chiyuki: folds 
Uncalled bet ($0.50) returned to Jene4kaBest
Jene4kaBest collected $0.60 from pot
Jene4kaBest: doesn't show hand 
*** SUMMARY ***
Total pot $0.60 | Rake $0 
Seat 1: Spheroff (button) folded before Flop (didn't bet)
Seat 2: leo2095 (small blind) folded before Flop
Seat 3: chiyuki (big blind) folded before Flop
Seat 4: Jene4kaBest collected ($0.60)
Seat 5: Rilko1975 folded before Flop (didn't bet)
Seat 6: INSP!RON folded before Flop (didn't bet)
Seat 7: westhavenbc folded before Flop (didn't bet)
Seat 8: Ellen1947 folded before Flop (didn't bet)
Seat 9: rey2040 folded before Flop (didn't bet)



PokerStars Zoom Hand #84300870415:  Hold'em No Limit ($0.10/$0.25) - 2012/08/05 15:56:53 JST [2012/08/05 2:56:53 ET]
Table 'Whirlpool' 9-max Seat #1 is the button
Seat 1: Jene4kaBest ($14.27 in chips) 
Seat 2: Lasutchik ($28.33 in chips) 
Seat 3: ChrisCDee ($30.36 in chips) 
Seat 4: pandaaaaaa ($15.89 in chips) 
Seat 5: Silveystryk ($30.26 in chips) 
Seat 6: chiyuki ($38.36 in chips) 
Seat 7: munky3 ($28.03 in chips) 
Seat 8: herkko11 ($5.45 in chips) 
Seat 9: Grishukps ($12.90 in chips) 
Lasutchik: posts small blind $0.10
ChrisCDee: posts big blind $0.25
*** HOLE CARDS ***
Dealt to chiyuki [9c 4s]
pandaaaaaa: folds 
Silveystryk: folds 
chiyuki: folds 
munky3: calls $0.25
herkko11: folds 
Grishukps: folds 
Jene4kaBest: folds 
Lasutchik: calls $0.15
ChrisCDee: checks 
*** FLOP *** [Kh 5h 2d]
Lasutchik: checks 
ChrisCDee: checks 
munky3: bets $0.50
Lasutchik: folds 
ChrisCDee: folds 
Uncalled bet ($0.50) returned to munky3
munky3 collected $0.72 from pot
munky3: doesn't show hand 
*** SUMMARY ***
Total pot $0.75 | Rake $0.03 
Board [Kh 5h 2d]
Seat 1: Jene4kaBest (button) folded before Flop (didn't bet)
Seat 2: Lasutchik (small blind) folded on the Flop
Seat 3: ChrisCDee (big blind) folded on the Flop
Seat 4: pandaaaaaa folded before Flop (didn't bet)
Seat 5: Silveystryk folded before Flop (didn't bet)
Seat 6: chiyuki folded before Flop (didn't bet)
Seat 7: munky3 collected ($0.72)
Seat 8: herkko11 folded before Flop (didn't bet)
Seat 9: Grishukps folded before Flop (didn't bet)



PokerStars Zoom Hand #84300876371:  Hold'em No Limit ($0.10/$0.25) - 2012/08/05 15:57:22 JST [2012/08/05 2:57:22 ET]
Table 'Whirlpool' 9-max Seat #1 is the button
Seat 1: Grishukps ($12.65 in chips) 
Seat 2: boboshooter ($27.79 in chips) 
Seat 3: pandaaaaaa ($15.79 in chips) 
Seat 4: Saruotiss ($61.41 in chips) 
Seat 5: Perstenev ($10.95 in chips) 
Seat 6: jacquelinewu ($71.44 in chips) 
Seat 7: chiyuki ($38.11 in chips) 
Seat 8: Dejacob ($26.35 in chips) 
Seat 9: phate-1up ($40.33 in chips) 
boboshooter: posts small blind $0.10
pandaaaaaa: posts big blind $0.25
*** HOLE CARDS ***
Dealt to chiyuki [4c 7d]
Saruotiss: folds 
Perstenev: folds 
jacquelinewu: folds 
chiyuki: folds 
Dejacob: raises $0.50 to $0.75
phate-1up: folds 
Grishukps: folds 
boboshooter: folds 
pandaaaaaa: folds 
Uncalled bet ($0.50) returned to Dejacob
Dejacob collected $0.60 from pot
Dejacob: doesn't show hand 
*** SUMMARY ***
Total pot $0.60 | Rake $0 
Seat 1: Grishukps (button) folded before Flop (didn't bet)
Seat 2: boboshooter (small blind) folded before Flop
Seat 3: pandaaaaaa (big blind) folded before Flop
Seat 4: Saruotiss folded before Flop (didn't bet)
Seat 5: Perstenev folded before Flop (didn't bet)
Seat 6: jacquelinewu folded before Flop (didn't bet)
Seat 7: chiyuki folded before Flop (didn't bet)
Seat 8: Dejacob collected ($0.60)
Seat 9: phate-1up folded before Flop (didn't bet)



PokerStars Zoom Hand #84300874410:  Hold'em No Limit ($0.10/$0.25) - 2012/08/05 15:57:13 JST [2012/08/05 2:57:13 ET]
Table 'Whirlpool' 9-max Seat #1 is the button
Seat 1: scaredsare ($14.25 in chips) 
Seat 2: fil740 ($9.74 in chips) 
Seat 3: 1Karina1 ($25 in chips) 
Seat 4: phate-1up ($57.58 in chips) 
Seat 5: chiyuki ($38.11 in chips) 
Seat 6: risekuku468 ($33.81 in chips) 
Seat 7: INSP!RON ($39.46 in chips) 
Seat 8: GSDP ($20.69 in chips) 
Seat 9: masterkoolb ($12.50 in chips) 
fil740: posts small blind $0.10
1Karina1: posts big blind $0.25
*** HOLE CARDS ***
Dealt to chiyuki [Jc 6d]
phate-1up: folds 
chiyuki: folds 
risekuku468: folds 
INSP!RON: folds 
GSDP: raises $0.75 to $1
masterkoolb: folds 
scaredsare: folds 
fil740: raises $0.75 to $1.75
1Karina1: folds 
GSDP: calls $0.75
*** FLOP *** [4c 4d 5h]
fil740: bets $4
GSDP: folds 
Uncalled bet ($4) returned to fil740
fil740 collected $3.58 from pot
fil740: doesn't show hand 
*** SUMMARY ***
Total pot $3.75 | Rake $0.17 
Board [4c 4d 5h]
Seat 1: scaredsare (button) folded before Flop (didn't bet)
Seat 2: fil740 (small blind) collected ($3.58)
Seat 3: 1Karina1 (big blind) folded before Flop
Seat 4: phate-1up folded before Flop (didn't bet)
Seat 5: chiyuki folded before Flop (didn't bet)
Seat 6: risekuku468 folded before Flop (didn't bet)
Seat 7: INSP!RON folded before Flop (didn't bet)
Seat 8: GSDP folded on the Flop
Seat 9: masterkoolb folded before Flop (didn't bet)



PokerStars Zoom Hand #84300877024:  Hold'em No Limit ($0.10/$0.25) - 2012/08/05 15:57:25 JST [2012/08/05 2:57:25 ET]
Table 'Whirlpool' 9-max Seat #1 is the button
Seat 1: slapshot2011 ($18.84 in chips) 
Seat 2: chiyuki ($38.11 in chips) 
Seat 3: Nerkit ($15.57 in chips) 
Seat 4: misskitty354 ($11.85 in chips) 
Seat 5: Rilko1975 ($24.10 in chips) 
Seat 6: seula i ($29.47 in chips) 
Seat 7: Spheroff ($7.42 in chips) 
Seat 8: nice.franki ($7.78 in chips) 
Seat 9: MurMurRu ($26.93 in chips) 
chiyuki: posts small blind $0.10
Nerkit: posts big blind $0.25
*** HOLE CARDS ***
Dealt to chiyuki [Jd 5c]
misskitty354: folds 
Rilko1975: folds 
seula i: folds 
Spheroff: folds 
nice.franki: folds 
MurMurRu: folds 
slapshot2011: folds 
chiyuki: folds 
Uncalled bet ($0.15) returned to Nerkit
Nerkit collected $0.20 from pot
Nerkit: doesn't show hand 
*** SUMMARY ***
Total pot $0.20 | Rake $0 
Seat 1: slapshot2011 (button) folded before Flop (didn't bet)
Seat 2: chiyuki (small blind) folded before Flop
Seat 3: Nerkit (big blind) collected ($0.20)
Seat 4: misskitty354 folded before Flop (didn't bet)
Seat 5: Rilko1975 folded before Flop (didn't bet)
Seat 6: seula i folded before Flop (didn't bet)
Seat 7: Spheroff folded before Flop (didn't bet)
Seat 8: nice.franki folded before Flop (didn't bet)
Seat 9: MurMurRu folded before Flop (didn't bet)



PokerStars Zoom Hand #84300871056:  Hold'em No Limit ($0.10/$0.25) - 2012/08/05 15:56:56 JST [2012/08/05 2:56:56 ET]
Table 'Whirlpool' 9-max Seat #1 is the button
Seat 1: hldtom ($25 in chips) 
Seat 2: Spheroff ($7.52 in chips) 
Seat 3: scaredsare ($14.50 in chips) 
Seat 4: HighDuka ($26.66 in chips) 
Seat 5: phate-1up ($40.58 in chips) 
Seat 6: Komissar82 ($10.45 in chips) 
Seat 7: kwkim73 ($25.70 in chips) 
Seat 8: chiyuki ($38.36 in chips) 
Seat 9: MurMurRu ($25.25 in chips) 
Spheroff: posts small blind $0.10
scaredsare: posts big blind $0.25
*** HOLE CARDS ***
Dealt to chiyuki [3c Jd]
HighDuka: raises $0.50 to $0.75
phate-1up: folds 
Komissar82: calls $0.75
kwkim73: folds 
chiyuki: folds 
MurMurRu: calls $0.75
hldtom: folds 
Spheroff: folds 
scaredsare: folds 
*** FLOP *** [9c 8c Qh]
HighDuka: bets $1
Komissar82: raises $1 to $2
MurMurRu: folds 
HighDuka: calls $1
*** TURN *** [9c 8c Qh] [6h]
HighDuka: checks 
Komissar82: bets $7.70 and is all-in
HighDuka: calls $7.70
*** RIVER *** [9c 8c Qh 6h] [Ac]
*** SHOW DOWN ***
HighDuka: shows [Js Jh] (a pair of Jacks)
Komissar82: shows [6c Jc] (a flush, Ace high)
Komissar82 collected $21.01 from pot
*** SUMMARY ***
Total pot $22 | Rake $0.99 
Board [9c 8c Qh 6h Ac]
Seat 1: hldtom (button) folded before Flop (didn't bet)
Seat 2: Spheroff (small blind) folded before Flop
Seat 3: scaredsare (big blind) folded before Flop
Seat 4: HighDuka showed [Js Jh] and lost with a pair of Jacks
Seat 5: phate-1up folded before Flop (didn't bet)
Seat 6: Komissar82 showed [6c Jc] and won ($21.01) with a flush, Ace high
Seat 7: kwkim73 folded before Flop (didn't bet)
Seat 8: chiyuki folded before Flop (didn't bet)
Seat 9: MurMurRu folded on the Flop



PokerStars Zoom Hand #84300875299:  Hold'em No Limit ($0.10/$0.25) - 2012/08/05 15:57:17 JST [2012/08/05 2:57:17 ET]
Table 'Whirlpool' 9-max Seat #1 is the button
Seat 1: ChrisCDee ($57.99 in chips) 
Seat 2: kesstukas25 ($31.26 in chips) 
Seat 3: westhavenbc ($16.86 in chips) 
Seat 4: chiyuki ($38.11 in chips) 
Seat 5: Nerkit ($15.57 in chips) 
Seat 6: Grishukps ($12.65 in chips) 
Seat 7: Kasperlmusik ($25 in chips) 
Seat 8: Rilko1975 ($25.42 in chips) 
Seat 9: Dejacob ($26.35 in chips) 
kesstukas25: posts small blind $0.10
westhavenbc: posts big blind $0.25
*** HOLE CARDS ***
Dealt to chiyuki [Qd 5d]
chiyuki: folds 
Nerkit: folds 
Grishukps: folds 
Kasperlmusik: folds 
Rilko1975: folds 
Dejacob: folds 
ChrisCDee: raises $0.50 to $0.75
kesstukas25: folds 
westhavenbc: calls $0.50
*** FLOP *** [4d Qs 5h]
westhavenbc: checks 
ChrisCDee: bets $0.91
westhavenbc: calls $0.91
*** TURN *** [4d Qs 5h] [9h]
westhavenbc: checks 
ChrisCDee: checks 
*** RIVER *** [4d Qs 5h 9h] [2d]
westhavenbc: checks 
ChrisCDee: checks 
*** SHOW DOWN ***
westhavenbc: shows [Ac Kh] (high card Ace)
ChrisCDee: mucks hand 
westhavenbc collected $3.27 from pot
*** SUMMARY ***
Total pot $3.42 | Rake $0.15 
Board [4d Qs 5h 9h 2d]
Seat 1: ChrisCDee (button) mucked [Kc Td]
Seat 2: kesstukas25 (small blind) folded before Flop
Seat 3: westhavenbc (big blind) showed [Ac Kh] and won ($3.27) with high card Ace
Seat 4: chiyuki folded before Flop (didn't bet)
Seat 5: Nerkit folded before Flop (didn't bet)
Seat 6: Grishukps folded before Flop (didn't bet)
Seat 7: Kasperlmusik folded before Flop (didn't bet)
Seat 8: Rilko1975 folded before Flop (didn't bet)
Seat 9: Dejacob folded before Flop (didn't bet)



PokerStars Zoom Hand #84300879408:  Hold'em No Limit ($0.10/$0.25) - 2012/08/05 15:57:36 JST [2012/08/05 2:57:36 ET]
Table 'Whirlpool' 9-max Seat #1 is the button
Seat 1: jacquelinewu ($31.61 in chips) 
Seat 2: phate-1up ($40.33 in chips) 
Seat 3: Bahia gyn ($19.62 in chips) 
Seat 4: pandaaaaaa ($15.54 in chips) 
Seat 5: Alvinpe85 ($95.94 in chips) 
Seat 6: hldtom ($25 in chips) 
Seat 7: GSDP ($41.58 in chips) 
Seat 8: misskitty354 ($11.85 in chips) 
Seat 9: chiyuki ($38.01 in chips) 
phate-1up: posts small blind $0.10
Bahia gyn: posts big blind $0.25
*** HOLE CARDS ***
Dealt to chiyuki [2d 8d]
pandaaaaaa: folds 
Alvinpe85: folds 
hldtom: folds 
GSDP: folds 
misskitty354: folds 
chiyuki: folds 
jacquelinewu: raises $0.50 to $0.75
phate-1up: folds 
Bahia gyn: folds 
Uncalled bet ($0.50) returned to jacquelinewu
jacquelinewu collected $0.60 from pot
jacquelinewu: doesn't show hand 
*** SUMMARY ***
Total pot $0.60 | Rake $0 
Seat 1: jacquelinewu (button) collected ($0.60)
Seat 2: phate-1up (small blind) folded before Flop
Seat 3: Bahia gyn (big blind) folded before Flop
Seat 4: pandaaaaaa folded before Flop (didn't bet)
Seat 5: Alvinpe85 folded before Flop (didn't bet)
Seat 6: hldtom folded before Flop (didn't bet)
Seat 7: GSDP folded before Flop (didn't bet)
Seat 8: misskitty354 folded before Flop (didn't bet)
Seat 9: chiyuki folded before Flop (didn't bet)



PokerStars Zoom Hand #84300883318:  Hold'em No Limit ($0.10/$0.25) - 2012/08/05 15:57:54 JST [2012/08/05 2:57:54 ET]
Table 'Whirlpool' 9-max Seat #1 is the button
Seat 1: pandaaaaaa ($15.54 in chips) 
Seat 2: Serge Claws ($39.92 in chips) 
Seat 3: chiyuki ($38.01 in chips) 
Seat 4: Perstenev ($10.49 in chips) 
Seat 5: kwkim73 ($37.41 in chips) 
Seat 6: nice.franki ($7.78 in chips) 
Seat 7: ChrisCDee ($30.11 in chips) 
Seat 8: MurMurRu ($26.93 in chips) 
Seat 9: Spheroff ($7.52 in chips) 
Serge Claws: posts small blind $0.10
chiyuki: posts big blind $0.25
*** HOLE CARDS ***
Dealt to chiyuki [4s 8c]
Perstenev: folds 
kwkim73: folds 
nice.franki: folds 
ChrisCDee: folds 
MurMurRu: folds 
Spheroff: folds 
pandaaaaaa: raises $0.75 to $1
Serge Claws: folds 
chiyuki: folds 
Uncalled bet ($0.75) returned to pandaaaaaa
pandaaaaaa collected $0.60 from pot
pandaaaaaa: doesn't show hand 
*** SUMMARY ***
Total pot $0.60 | Rake $0 
Seat 1: pandaaaaaa (button) collected ($0.60)
Seat 2: Serge Claws (small blind) folded before Flop
Seat 3: chiyuki (big blind) folded before Flop
Seat 4: Perstenev folded before Flop (didn't bet)
Seat 5: kwkim73 folded before Flop (didn't bet)
Seat 6: nice.franki folded before Flop (didn't bet)
Seat 7: ChrisCDee folded before Flop (didn't bet)
Seat 8: MurMurRu folded before Flop (didn't bet)
Seat 9: Spheroff folded before Flop (didn't bet)



PokerStars Zoom Hand #84300881625:  Hold'em No Limit ($0.10/$0.25) - 2012/08/05 15:57:46 JST [2012/08/05 2:57:46 ET]
Table 'Whirlpool' 9-max Seat #1 is the button
Seat 1: chiyuki ($38.01 in chips) 
Seat 2: snejokCoxx ($11.25 in chips) 
Seat 3: drunk_bender ($25.57 in chips) 
Seat 4: misskitty354 ($11.85 in chips) 
Seat 5: rey2040 ($13.90 in chips) 
Seat 6: Spheroff ($7.52 in chips) 
Seat 7: nice.franki ($7.78 in chips) 
Seat 8: yvasilik ($23.83 in chips) 
Seat 9: Alvinpe85 ($40.15 in chips) 
snejokCoxx: posts small blind $0.10
drunk_bender: posts big blind $0.25
*** HOLE CARDS ***
Dealt to chiyuki [Qh 3s]
misskitty354: folds 
rey2040: folds 
Spheroff: folds 
nice.franki: folds 
yvasilik: folds 
Alvinpe85: raises $0.37 to $0.62
chiyuki: folds 
snejokCoxx: folds 
drunk_bender: calls $0.37
*** FLOP *** [Ks As Jc]
drunk_bender: checks 
Alvinpe85: bets $0.76
drunk_bender: folds 
Uncalled bet ($0.76) returned to Alvinpe85
Alvinpe85 collected $1.28 from pot
Alvinpe85: doesn't show hand 
*** SUMMARY ***
Total pot $1.34 | Rake $0.06 
Board [Ks As Jc]
Seat 1: chiyuki (button) folded before Flop (didn't bet)
Seat 2: snejokCoxx (small blind) folded before Flop
Seat 3: drunk_bender (big blind) folded on the Flop
Seat 4: misskitty354 folded before Flop (didn't bet)
Seat 5: rey2040 folded before Flop (didn't bet)
Seat 6: Spheroff folded before Flop (didn't bet)
Seat 7: nice.franki folded before Flop (didn't bet)
Seat 8: yvasilik folded before Flop (didn't bet)
Seat 9: Alvinpe85 collected ($1.28)



PokerStars Zoom Hand #84300882299:  Hold'em No Limit ($0.10/$0.25) - 2012/08/05 15:57:49 JST [2012/08/05 2:57:49 ET]
Table 'Whirlpool' 9-max Seat #1 is the button
Seat 1: hldtom ($12.50 in chips) 
Seat 2: wildy29 ($56.24 in chips) 
Seat 3: phate-1up ($57.48 in chips) 
Seat 4: Grishukps ($12.50 in chips) 
Seat 5: Perstenev ($10.49 in chips) 
Seat 6: kwkim73 ($37.41 in chips) 
Seat 7: SAILUSI ($32.46 in chips) 
Seat 8: chiyuki ($38.01 in chips) 
Seat 9: kesstukas25 ($31.16 in chips) 
wildy29: posts small blind $0.10
phate-1up: posts big blind $0.25
*** HOLE CARDS ***
Dealt to chiyuki [Jh 6c]
Grishukps: raises $0.50 to $0.75
Perstenev: folds 
kwkim73: folds 
SAILUSI: calls $0.75
chiyuki: folds 
kesstukas25: folds 
hldtom: calls $0.75
wildy29: folds 
phate-1up: calls $0.50
*** FLOP *** [Qh Ac 2c]
phate-1up: checks 
Grishukps: bets $2.20
SAILUSI: folds 
hldtom: folds 
phate-1up: calls $2.20
*** TURN *** [Qh Ac 2c] [9c]
phate-1up: bets $9.75
Grishukps: folds 
Uncalled bet ($9.75) returned to phate-1up
phate-1up collected $7.16 from pot
phate-1up: doesn't show hand 
*** SUMMARY ***
Total pot $7.50 | Rake $0.34 
Board [Qh Ac 2c 9c]
Seat 1: hldtom (button) folded on the Flop
Seat 2: wildy29 (small blind) folded before Flop
Seat 3: phate-1up (big blind) collected ($7.16)
Seat 4: Grishukps folded on the Turn
Seat 5: Perstenev folded before Flop (didn't bet)
Seat 6: kwkim73 folded before Flop (didn't bet)
Seat 7: SAILUSI folded on the Flop
Seat 8: chiyuki folded before Flop (didn't bet)
Seat 9: kesstukas25 folded before Flop (didn't bet)



PokerStars Zoom Hand #84300895117:  Hold'em No Limit ($0.10/$0.25) - 2012/08/05 15:58:49 JST [2012/08/05 2:58:49 ET]
Table 'Whirlpool' 9-max Seat #1 is the button
Seat 1: Serge Claws ($39.57 in chips) 
Seat 2: kkbruins0408 ($9.94 in chips) 
Seat 3: hldtom ($12.50 in chips) 
Seat 4: herkko11 ($5 in chips) 
Seat 5: chiyuki ($37.66 in chips) 
Seat 6: Kasperlmusik ($25.10 in chips) 
Seat 7: misskitty354 ($9.75 in chips) 
Seat 8: schoof 2 ($28.71 in chips) 
Seat 9: andy0815r ($24.65 in chips) 
kkbruins0408: posts small blind $0.10
hldtom: posts big blind $0.25
*** HOLE CARDS ***
Dealt to chiyuki [2h 8s]
herkko11: folds 
chiyuki: folds 
Kasperlmusik: folds 
misskitty354: folds 
schoof 2: folds 
andy0815r: folds 
Serge Claws: folds 
kkbruins0408: folds 
Uncalled bet ($0.15) returned to hldtom
hldtom collected $0.20 from pot
hldtom: doesn't show hand 
*** SUMMARY ***
Total pot $0.20 | Rake $0 
Seat 1: Serge Claws (button) folded before Flop (didn't bet)
Seat 2: kkbruins0408 (small blind) folded before Flop
Seat 3: hldtom (big blind) collected ($0.20)
Seat 4: herkko11 folded before Flop (didn't bet)
Seat 5: chiyuki folded before Flop (didn't bet)
Seat 6: Kasperlmusik folded before Flop (didn't bet)
Seat 7: misskitty354 folded before Flop (didn't bet)
Seat 8: schoof 2 folded before Flop (didn't bet)
Seat 9: andy0815r folded before Flop (didn't bet)



PokerStars Zoom Hand #84300894451:  Hold'em No Limit ($0.10/$0.25) - 2012/08/05 15:58:46 JST [2012/08/05 2:58:46 ET]
Table 'Whirlpool' 9-max Seat #1 is the button
Seat 1: jacquelinewu ($77.01 in chips) 
Seat 2: Grishukps ($12.95 in chips) 
Seat 3: seula i ($72.82 in chips) 
Seat 4: Rilko1975 ($25.17 in chips) 
Seat 5: GSDP ($38.68 in chips) 
Seat 6: chiyuki ($37.66 in chips) 
Seat 7: dergeb ($16.34 in chips) 
Seat 8: nice.franki ($12.40 in chips) 
Seat 9: Alvinpe85 ($95.59 in chips) 
Grishukps: posts small blind $0.10
seula i: posts big blind $0.25
*** HOLE CARDS ***
Dealt to chiyuki [2d 6h]
Rilko1975: folds 
GSDP: folds 
chiyuki: folds 
dergeb: folds 
nice.franki: folds 
Alvinpe85: folds 
jacquelinewu: raises $0.50 to $0.75
Grishukps: folds 
seula i: folds 
Uncalled bet ($0.50) returned to jacquelinewu
jacquelinewu collected $0.60 from pot
jacquelinewu: doesn't show hand 
*** SUMMARY ***
Total pot $0.60 | Rake $0 
Seat 1: jacquelinewu (button) collected ($0.60)
Seat 2: Grishukps (small blind) folded before Flop
Seat 3: seula i (big blind) folded before Flop
Seat 4: Rilko1975 folded before Flop (didn't bet)
Seat 5: GSDP folded before Flop (didn't bet)
Seat 6: chiyuki folded before Flop (didn't bet)
Seat 7: dergeb folded before Flop (didn't bet)
Seat 8: nice.franki folded before Flop (didn't bet)
Seat 9: Alvinpe85 folded before Flop (didn't bet)



PokerStars Zoom Hand #84300888555:  Hold'em No Limit ($0.10/$0.25) - 2012/08/05 15:58:19 JST [2012/08/05 2:58:19 ET]
Table 'Whirlpool' 9-max Seat #1 is the button
Seat 1: Kozyavkin ($14.53 in chips) 
Seat 2: chiyuki ($37.76 in chips) 
Seat 3: masterkoolb ($12.85 in chips) 
Seat 4: INSP!RON ($39.46 in chips) 
Seat 5: jacquelinewu ($31.71 in chips) 
Seat 6: MurMurRu ($26.93 in chips) 
Seat 7: GovGus ($34.49 in chips) 
Seat 8: Dejacob ($26.35 in chips) 
Seat 9: Grishukps ($12.50 in chips) 
chiyuki: posts small blind $0.10
masterkoolb: posts big blind $0.25
*** HOLE CARDS ***
Dealt to chiyuki [6d 8h]
INSP!RON: folds 
jacquelinewu: raises $0.50 to $0.75
MurMurRu: folds 
GovGus: folds 
Dejacob: folds 
Grishukps: folds 
Kozyavkin: folds 
chiyuki: folds 
masterkoolb: calls $0.50
*** FLOP *** [2h Qs 9d]
masterkoolb: checks 
jacquelinewu: checks 
*** TURN *** [2h Qs 9d] [9c]
masterkoolb: checks 
jacquelinewu: checks 
*** RIVER *** [2h Qs 9d 9c] [Kd]
masterkoolb: checks 
jacquelinewu: bets $1
masterkoolb: folds 
Uncalled bet ($1) returned to jacquelinewu
jacquelinewu collected $1.53 from pot
jacquelinewu: doesn't show hand 
*** SUMMARY ***
Total pot $1.60 | Rake $0.07 
Board [2h Qs 9d 9c Kd]
Seat 1: Kozyavkin (button) folded before Flop (didn't bet)
Seat 2: chiyuki (small blind) folded before Flop
Seat 3: masterkoolb (big blind) folded on the River
Seat 4: INSP!RON folded before Flop (didn't bet)
Seat 5: jacquelinewu collected ($1.53)
Seat 6: MurMurRu folded before Flop (didn't bet)
Seat 7: GovGus folded before Flop (didn't bet)
Seat 8: Dejacob folded before Flop (didn't bet)
Seat 9: Grishukps folded before Flop (didn't bet)



PokerStars Zoom Hand #84300890509:  Hold'em No Limit ($0.10/$0.25) - 2012/08/05 15:58:28 JST [2012/08/05 2:58:28 ET]
Table 'Whirlpool' 9-max Seat #1 is the button
Seat 1: nice.franki ($12.50 in chips) 
Seat 2: INSP!RON ($38.60 in chips) 
Seat 3: kwkim73 ($26.06 in chips) 
Seat 4: ShockLaMuc ($15.85 in chips) 
Seat 5: Kasperlmusik ($25 in chips) 
Seat 6: westhavenbc ($18.36 in chips) 
Seat 7: Perstenev ($10.70 in chips) 
Seat 8: hldtom ($12.50 in chips) 
Seat 9: chiyuki ($37.66 in chips) 
INSP!RON: posts small blind $0.10
kwkim73: posts big blind $0.25
*** HOLE CARDS ***
Dealt to chiyuki [Th Jd]
ShockLaMuc: folds 
Kasperlmusik: folds 
westhavenbc: folds 
Perstenev: calls $0.25
hldtom: folds 
chiyuki: folds 
nice.franki: folds 
INSP!RON: raises $0.75 to $1
kwkim73: folds 
Perstenev: calls $0.75
*** FLOP *** [Tc 3h 9s]
INSP!RON: bets $1.50
Perstenev: calls $1.50
*** TURN *** [Tc 3h 9s] [Kd]
INSP!RON: bets $2.50
Perstenev: folds 
Uncalled bet ($2.50) returned to INSP!RON
INSP!RON collected $5.01 from pot
INSP!RON: doesn't show hand 
*** SUMMARY ***
Total pot $5.25 | Rake $0.24 
Board [Tc 3h 9s Kd]
Seat 1: nice.franki (button) folded before Flop (didn't bet)
Seat 2: INSP!RON (small blind) collected ($5.01)
Seat 3: kwkim73 (big blind) folded before Flop
Seat 4: ShockLaMuc folded before Flop (didn't bet)
Seat 5: Kasperlmusik folded before Flop (didn't bet)
Seat 6: westhavenbc folded before Flop (didn't bet)
Seat 7: Perstenev folded on the Turn
Seat 8: hldtom folded before Flop (didn't bet)
Seat 9: chiyuki folded before Flop (didn't bet)



PokerStars Zoom Hand #84300901440:  Hold'em No Limit ($0.10/$0.25) - 2012/08/05 15:59:18 JST [2012/08/05 2:59:18 ET]
Table 'Whirlpool' 9-max Seat #1 is the button
Seat 1: Silveystryk ($28.77 in chips) 
Seat 2: Alvinpe85 ($95.34 in chips) 
Seat 3: KrystalAA ($17.46 in chips) 
Seat 4: Perstenev ($16.54 in chips) 
Seat 5: Roglus ($12.39 in chips) 
Seat 6: jvds114 ($56.29 in chips) 
Seat 7: chiyuki ($37.66 in chips) 
Seat 8: Dejacob ($28.49 in chips) 
Seat 9: Nerkit ($12.61 in chips) 
Alvinpe85: posts small blind $0.10
KrystalAA: posts big blind $0.25
*** HOLE CARDS ***
Dealt to chiyuki [9s Ks]
Perstenev: folds 
Roglus: folds 
jvds114: folds 
chiyuki: folds 
Dejacob: folds 
Nerkit: folds 
Silveystryk: folds 
Alvinpe85: folds 
Uncalled bet ($0.15) returned to KrystalAA
KrystalAA collected $0.20 from pot
KrystalAA: doesn't show hand 
*** SUMMARY ***
Total pot $0.20 | Rake $0 
Seat 1: Silveystryk (button) folded before Flop (didn't bet)
Seat 2: Alvinpe85 (small blind) folded before Flop
Seat 3: KrystalAA (big blind) collected ($0.20)
Seat 4: Perstenev folded before Flop (didn't bet)
Seat 5: Roglus folded before Flop (didn't bet)
Seat 6: jvds114 folded before Flop (didn't bet)
Seat 7: chiyuki folded before Flop (didn't bet)
Seat 8: Dejacob folded before Flop (didn't bet)
Seat 9: Nerkit folded before Flop (didn't bet)



PokerStars Zoom Hand #84300896877:  Hold'em No Limit ($0.10/$0.25) - 2012/08/05 15:58:57 JST [2012/08/05 2:58:57 ET]
Table 'Whirlpool' 9-max Seat #1 is the button
Seat 1: chiyuki ($37.66 in chips) 
Seat 2: Spheroff ($25 in chips) 
Seat 3: Kozyavkin ($14.53 in chips) 
Seat 4: ViTiV2010 ($12.50 in chips) 
Seat 5: seula i ($72.57 in chips) 
Seat 6: AAAKK777 ($15.85 in chips) 
Seat 7: jacquelinewu ($25 in chips) 
Seat 8: KrystalAA ($17.46 in chips) 
Seat 9: nice.franki ($7.43 in chips) 
Spheroff: posts small blind $0.10
Kozyavkin: posts big blind $0.25
*** HOLE CARDS ***
Dealt to chiyuki [8c Kc]
ViTiV2010: folds 
seula i: folds 
AAAKK777: raises $0.25 to $0.50
jacquelinewu: folds 
KrystalAA: folds 
nice.franki: folds 
chiyuki: folds 
Spheroff: folds 
Kozyavkin: calls $0.25
*** FLOP *** [Ac 2c 4h]
Kozyavkin: bets $0.25
AAAKK777: calls $0.25
*** TURN *** [Ac 2c 4h] [6c]
Kozyavkin: bets $0.25
AAAKK777: calls $0.25
*** RIVER *** [Ac 2c 4h 6c] [5d]
Kozyavkin: bets $0.50
AAAKK777: folds 
Uncalled bet ($0.50) returned to Kozyavkin
Kozyavkin collected $2.01 from pot
Kozyavkin: doesn't show hand 
*** SUMMARY ***
Total pot $2.10 | Rake $0.09 
Board [Ac 2c 4h 6c 5d]
Seat 1: chiyuki (button) folded before Flop (didn't bet)
Seat 2: Spheroff (small blind) folded before Flop
Seat 3: Kozyavkin (big blind) collected ($2.01)
Seat 4: ViTiV2010 folded before Flop (didn't bet)
Seat 5: seula i folded before Flop (didn't bet)
Seat 6: AAAKK777 folded on the River
Seat 7: jacquelinewu folded before Flop (didn't bet)
Seat 8: KrystalAA folded before Flop (didn't bet)
Seat 9: nice.franki folded before Flop (didn't bet)



PokerStars Zoom Hand #84300903781:  Hold'em No Limit ($0.10/$0.25) - 2012/08/05 15:59:29 JST [2012/08/05 2:59:29 ET]
Table 'Whirlpool' 9-max Seat #1 is the button
Seat 1: masterkoolb ($19.37 in chips) 
Seat 2: Ellen1947 ($26.73 in chips) 
Seat 3: NoWurriz ($25.01 in chips) 
Seat 4: Nerkit ($16.32 in chips) 
Seat 5: 6nikola9 ($20.61 in chips) 
Seat 6: Trip_Krowns ($27.97 in chips) 
Seat 7: 1Karina1 ($33.37 in chips) 
Seat 8: chiyuki ($37.66 in chips) 
Seat 9: kwkim73 ($26.48 in chips) 
Ellen1947: posts small blind $0.10
NoWurriz: posts big blind $0.25
*** HOLE CARDS ***
Dealt to chiyuki [Jd 6c]
Nerkit: folds 
6nikola9: folds 
Trip_Krowns: folds 
1Karina1: folds 
chiyuki: folds 
kwkim73: folds 
masterkoolb: folds 
Ellen1947: folds 
Uncalled bet ($0.15) returned to NoWurriz
NoWurriz collected $0.20 from pot
NoWurriz: doesn't show hand 
*** SUMMARY ***
Total pot $0.20 | Rake $0 
Seat 1: masterkoolb (button) folded before Flop (didn't bet)
Seat 2: Ellen1947 (small blind) folded before Flop
Seat 3: NoWurriz (big blind) collected ($0.20)
Seat 4: Nerkit folded before Flop (didn't bet)
Seat 5: 6nikola9 folded before Flop (didn't bet)
Seat 6: Trip_Krowns folded before Flop (didn't bet)
Seat 7: 1Karina1 folded before Flop (didn't bet)
Seat 8: chiyuki folded before Flop (didn't bet)
Seat 9: kwkim73 folded before Flop (didn't bet)



PokerStars Zoom Hand #84300906645:  Hold'em No Limit ($0.10/$0.25) - 2012/08/05 15:59:43 JST [2012/08/05 2:59:43 ET]
Table 'Whirlpool' 9-max Seat #1 is the button
Seat 1: masterkoolb ($12.50 in chips) 
Seat 2: seula i ($72.57 in chips) 
Seat 3: chiyuki ($37.66 in chips) 
Seat 4: kwkim73 ($26.48 in chips) 
Seat 5: AAAKK777 ($14.85 in chips) 
Seat 6: Fructionar ($44.84 in chips) 
Seat 7: Perstenev ($9.89 in chips) 
Seat 8: GovGus ($34.49 in chips) 
Seat 9: mjmichi ($81.11 in chips) 
seula i: posts small blind $0.10
chiyuki: posts big blind $0.25
*** HOLE CARDS ***
Dealt to chiyuki [2c Kh]
kwkim73: raises $0.50 to $0.75
AAAKK777: raises $0.50 to $1.25
Fructionar: folds 
Perstenev: folds 
GovGus: folds 
mjmichi: folds 
masterkoolb: folds 
seula i: folds 
chiyuki: folds 
kwkim73: folds 
Uncalled bet ($0.50) returned to AAAKK777
AAAKK777 collected $1.85 from pot
AAAKK777: doesn't show hand 
*** SUMMARY ***
Total pot $1.85 | Rake $0 
Seat 1: masterkoolb (button) folded before Flop (didn't bet)
Seat 2: seula i (small blind) folded before Flop
Seat 3: chiyuki (big blind) folded before Flop
Seat 4: kwkim73 folded before Flop
Seat 5: AAAKK777 collected ($1.85)
Seat 6: Fructionar folded before Flop (didn't bet)
Seat 7: Perstenev folded before Flop (didn't bet)
Seat 8: GovGus folded before Flop (didn't bet)
Seat 9: mjmichi folded before Flop (didn't bet)



PokerStars Zoom Hand #84300904467:  Hold'em No Limit ($0.10/$0.25) - 2012/08/05 15:59:32 JST [2012/08/05 2:59:32 ET]
Table 'Whirlpool' 9-max Seat #1 is the button
Seat 1: deepakmbh ($27.22 in chips) 
Seat 2: KrystalAA ($43.56 in chips) 
Seat 3: Spheroff ($24.90 in chips) 
Seat 4: TorTrade ($21.50 in chips) 
Seat 5: chiyuki ($37.66 in chips) 
Seat 6: nice.franki ($7.18 in chips) 
Seat 7: herkko11 ($5.10 in chips) 
Seat 8: Nerkit ($16.32 in chips) 
Seat 9: Perstenev ($9.89 in chips) 
KrystalAA: posts small blind $0.10
Spheroff: posts big blind $0.25
*** HOLE CARDS ***
Dealt to chiyuki [3d 4s]
TorTrade: folds 
chiyuki: folds 
nice.franki: folds 
herkko11: raises $0.50 to $0.75
Nerkit: folds 
Perstenev: folds 
deepakmbh: folds 
KrystalAA: raises $1.34 to $2.09
Spheroff: folds 
herkko11: raises $3.01 to $5.10 and is all-in
KrystalAA: calls $3.01
*** FLOP *** [Ks Kc 4d]
*** TURN *** [Ks Kc 4d] [Td]
*** RIVER *** [Ks Kc 4d Td] [6d]
*** SHOW DOWN ***
KrystalAA: shows [Ts Tc] (a full house, Tens full of Kings)
herkko11: shows [Js Jc] (two pair, Kings and Jacks)
KrystalAA collected $9.98 from pot
*** SUMMARY ***
Total pot $10.45 | Rake $0.47 
Board [Ks Kc 4d Td 6d]
Seat 1: deepakmbh (button) folded before Flop (didn't bet)
Seat 2: KrystalAA (small blind) showed [Ts Tc] and won ($9.98) with a full house, Tens full of Kings
Seat 3: Spheroff (big blind) folded before Flop
Seat 4: TorTrade folded before Flop (didn't bet)
Seat 5: chiyuki folded before Flop (didn't bet)
Seat 6: nice.franki folded before Flop (didn't bet)
Seat 7: herkko11 showed [Js Jc] and lost with two pair, Kings and Jacks
Seat 8: Nerkit folded before Flop (didn't bet)
Seat 9: Perstenev folded before Flop (didn't bet)



PokerStars Zoom Hand #84300910046:  Hold'em No Limit ($0.10/$0.25) - 2012/08/05 15:59:58 JST [2012/08/05 2:59:58 ET]
Table 'Whirlpool' 9-max Seat #1 is the button
Seat 1: xxASSO124xx ($11.05 in chips) 
Seat 2: hldtom ($12.50 in chips) 
Seat 3: slapshot2011 ($30.47 in chips) 
Seat 4: MurMurRu ($28.20 in chips) 
Seat 5: DrunkTyphoon ($36.21 in chips) 
Seat 6: chiyuki ($37.41 in chips) 
Seat 7: drunk_bender ($24.55 in chips) 
Seat 8: JhonnyP1979 ($15.48 in chips) 
Seat 9: jacquelinewu ($25 in chips) 
hldtom: posts small blind $0.10
slapshot2011: posts big blind $0.25
*** HOLE CARDS ***
Dealt to chiyuki [Jc Ah]
MurMurRu: folds 
DrunkTyphoon: folds 
chiyuki: raises $0.50 to $0.75
drunk_bender: folds 
JhonnyP1979: calls $0.75
jacquelinewu: folds 
xxASSO124xx: folds 
hldtom: folds 
slapshot2011: folds 
*** FLOP *** [Ks 6s 9s]
chiyuki: bets $1.25
JhonnyP1979: folds 
Uncalled bet ($1.25) returned to chiyuki
chiyuki collected $1.77 from pot
chiyuki: doesn't show hand 
*** SUMMARY ***
Total pot $1.85 | Rake $0.08 
Board [Ks 6s 9s]
Seat 1: xxASSO124xx (button) folded before Flop (didn't bet)
Seat 2: hldtom (small blind) folded before Flop
Seat 3: slapshot2011 (big blind) folded before Flop
Seat 4: MurMurRu folded before Flop (didn't bet)
Seat 5: DrunkTyphoon folded before Flop (didn't bet)
Seat 6: chiyuki collected ($1.77)
Seat 7: drunk_bender folded before Flop (didn't bet)
Seat 8: JhonnyP1979 folded on the Flop
Seat 9: jacquelinewu folded before Flop (didn't bet)



PokerStars Zoom Hand #84300915599:  Hold'em No Limit ($0.10/$0.25) - 2012/08/05 16:00:23 JST [2012/08/05 3:00:23 ET]
Table 'Whirlpool' 9-max Seat #1 is the button
Seat 1: CrittHunter ($24.90 in chips) 
Seat 2: chiyuki ($38.43 in chips) 
Seat 3: Dejacob ($25.95 in chips) 
Seat 4: phate-1up ($36.48 in chips) 
Seat 5: HighDuka ($18.48 in chips) 
Seat 6: GSDP ($38.68 in chips) 
Seat 7: Fructionar ($44.34 in chips) 
Seat 8: seula i ($27.32 in chips) 
Seat 9: munky3 ($39.35 in chips) 
chiyuki: posts small blind $0.10
Dejacob: posts big blind $0.25
*** HOLE CARDS ***
Dealt to chiyuki [4h Ah]
phate-1up: folds 
HighDuka: folds 
GSDP: raises $0.75 to $1
Fructionar: folds 
seula i: folds 
munky3: folds 
CrittHunter: folds 
chiyuki: folds 
Dejacob: folds 
Uncalled bet ($0.75) returned to GSDP
GSDP collected $0.60 from pot
GSDP: doesn't show hand 
*** SUMMARY ***
Total pot $0.60 | Rake $0 
Seat 1: CrittHunter (button) folded before Flop (didn't bet)
Seat 2: chiyuki (small blind) folded before Flop
Seat 3: Dejacob (big blind) folded before Flop
Seat 4: phate-1up folded before Flop (didn't bet)
Seat 5: HighDuka folded before Flop (didn't bet)
Seat 6: GSDP collected ($0.60)
Seat 7: Fructionar folded before Flop (didn't bet)
Seat 8: seula i folded before Flop (didn't bet)
Seat 9: munky3 folded before Flop (didn't bet)



PokerStars Zoom Hand #84300905562:  Hold'em No Limit ($0.10/$0.25) - 2012/08/05 15:59:38 JST [2012/08/05 2:59:38 ET]
Table 'Whirlpool' 9-max Seat #1 is the button
Seat 1: Rilko1975 ($24.57 in chips) 
Seat 2: leo2095 ($17.35 in chips) 
Seat 3: kkbruins0408 ($9.84 in chips) 
Seat 4: chiyuki ($37.66 in chips) 
Seat 5: ShockLaMuc ($22.55 in chips) 
Seat 6: Serge Claws ($39.57 in chips) 
Seat 7: Nerkit ($16.32 in chips) 
Seat 8: EvgenyBaikov ($23.43 in chips) 
Seat 9: deepakmbh ($27.22 in chips) 
leo2095: posts small blind $0.10
kkbruins0408: posts big blind $0.25
*** HOLE CARDS ***
Dealt to chiyuki [Kd 8d]
chiyuki: folds 
ShockLaMuc: calls $0.25
Serge Claws: folds 
Nerkit: folds 
EvgenyBaikov: raises $0.50 to $0.75
deepakmbh: calls $0.75
Rilko1975: folds 
leo2095: folds 
kkbruins0408: calls $0.50
ShockLaMuc: calls $0.50
*** FLOP *** [5d 3c 3d]
kkbruins0408: checks 
ShockLaMuc: checks 
EvgenyBaikov: bets $1.50
deepakmbh: folds 
kkbruins0408: calls $1.50
ShockLaMuc: folds 
*** TURN *** [5d 3c 3d] [6h]
kkbruins0408: checks 
EvgenyBaikov: checks 
*** RIVER *** [5d 3c 3d 6h] [3h]
kkbruins0408: bets $3
EvgenyBaikov: calls $3
*** SHOW DOWN ***
kkbruins0408: shows [Qd Ad] (three of a kind, Threes)
EvgenyBaikov: mucks hand 
kkbruins0408 collected $11.56 from pot
*** SUMMARY ***
Total pot $12.10 | Rake $0.54 
Board [5d 3c 3d 6h 3h]
Seat 1: Rilko1975 (button) folded before Flop (didn't bet)
Seat 2: leo2095 (small blind) folded before Flop
Seat 3: kkbruins0408 (big blind) showed [Qd Ad] and won ($11.56) with three of a kind, Threes
Seat 4: chiyuki folded before Flop (didn't bet)
Seat 5: ShockLaMuc folded on the Flop
Seat 6: Serge Claws folded before Flop (didn't bet)
Seat 7: Nerkit folded before Flop (didn't bet)
Seat 8: EvgenyBaikov mucked [9c As]
Seat 9: deepakmbh folded on the Flop



PokerStars Zoom Hand #84300919822:  Hold'em No Limit ($0.10/$0.25) - 2012/08/05 16:00:41 JST [2012/08/05 3:00:41 ET]
Table 'Whirlpool' 9-max Seat #1 is the button
Seat 1: ChrisCDee ($55.23 in chips) 
Seat 2: Dejacob ($25.70 in chips) 
Seat 3: FoRlan77 ($27.73 in chips) 
Seat 4: chiyuki ($38.33 in chips) 
Seat 5: xxASSO124xx ($10.80 in chips) 
Seat 6: westhavenbc ($18.89 in chips) 
Seat 7: Rici47 ($31.02 in chips) 
Seat 8: KrystalAA ($11.51 in chips) 
Seat 9: ShockLaMuc ($27 in chips) 
Dejacob: posts small blind $0.10
FoRlan77: posts big blind $0.25
*** HOLE CARDS ***
Dealt to chiyuki [3s Kh]
chiyuki: folds 
xxASSO124xx: folds 
westhavenbc: folds 
Rici47: folds 
KrystalAA: raises $0.46 to $0.71
ShockLaMuc: folds 
ChrisCDee: folds 
Dejacob: folds 
FoRlan77: folds 
Uncalled bet ($0.46) returned to KrystalAA
KrystalAA collected $0.60 from pot
KrystalAA: doesn't show hand 
*** SUMMARY ***
Total pot $0.60 | Rake $0 
Seat 1: ChrisCDee (button) folded before Flop (didn't bet)
Seat 2: Dejacob (small blind) folded before Flop
Seat 3: FoRlan77 (big blind) folded before Flop
Seat 4: chiyuki folded before Flop (didn't bet)
Seat 5: xxASSO124xx folded before Flop (didn't bet)
Seat 6: westhavenbc folded before Flop (didn't bet)
Seat 7: Rici47 folded before Flop (didn't bet)
Seat 8: KrystalAA collected ($0.60)
Seat 9: ShockLaMuc folded before Flop (didn't bet)



PokerStars Zoom Hand #84300920520:  Hold'em No Limit ($0.10/$0.25) - 2012/08/05 16:00:45 JST [2012/08/05 3:00:45 ET]
Table 'Whirlpool' 9-max Seat #1 is the button
Seat 1: chiyuki ($38.33 in chips) 
Seat 2: seula i ($72.22 in chips) 
Seat 3: Grishukps ($12.50 in chips) 
Seat 4: leo2095 ($17 in chips) 
Seat 5: masterkoolb ($12.50 in chips) 
Seat 6: drunk_bender ($24.30 in chips) 
Seat 7: kwkim73 ($25 in chips) 
Seat 8: phate-1up ($66.26 in chips) 
Seat 9: nice.franki ($4.68 in chips) 
seula i: posts small blind $0.10
Grishukps: posts big blind $0.25
*** HOLE CARDS ***
Dealt to chiyuki [Qs Kh]
leo2095: folds 
masterkoolb: folds 
drunk_bender: folds 
kwkim73: folds 
phate-1up: folds 
nice.franki: folds 
chiyuki: raises $0.50 to $0.75
seula i: folds 
Grishukps: folds 
Uncalled bet ($0.50) returned to chiyuki
chiyuki collected $0.60 from pot
chiyuki: doesn't show hand 
*** SUMMARY ***
Total pot $0.60 | Rake $0 
Seat 1: chiyuki (button) collected ($0.60)
Seat 2: seula i (small blind) folded before Flop
Seat 3: Grishukps (big blind) folded before Flop
Seat 4: leo2095 folded before Flop (didn't bet)
Seat 5: masterkoolb folded before Flop (didn't bet)
Seat 6: drunk_bender folded before Flop (didn't bet)
Seat 7: kwkim73 folded before Flop (didn't bet)
Seat 8: phate-1up folded before Flop (didn't bet)
Seat 9: nice.franki folded before Flop (didn't bet)



PokerStars Zoom Hand #84300918343:  Hold'em No Limit ($0.10/$0.25) - 2012/08/05 16:00:35 JST [2012/08/05 3:00:35 ET]
Table 'Whirlpool' 9-max Seat #1 is the button
Seat 1: Bahia gyn ($34.96 in chips) 
Seat 2: Rilko1975 ($24.32 in chips) 
Seat 3: Grishukps ($12.75 in chips) 
Seat 4: Lasutchik ($27.56 in chips) 
Seat 5: chiyuki ($38.33 in chips) 
Seat 6: andy0815r ($31.97 in chips) 
Seat 7: hldtom ($13.90 in chips) 
Seat 8: Perstenev ($16.19 in chips) 
Seat 9: snejokCoxx ($12.50 in chips) 
Rilko1975: posts small blind $0.10
Grishukps: posts big blind $0.25
*** HOLE CARDS ***
Dealt to chiyuki [Jd 4d]
Lasutchik: folds 
chiyuki: folds 
andy0815r: raises $0.50 to $0.75
hldtom: calls $0.75
Perstenev: folds 
snejokCoxx: folds 
Bahia gyn: folds 
Rilko1975: folds 
Grishukps: folds 
*** FLOP *** [9d 3d 3s]
andy0815r: bets $0.88
hldtom: calls $0.88
*** TURN *** [9d 3d 3s] [7s]
andy0815r: bets $1.50
hldtom: calls $1.50
*** RIVER *** [9d 3d 3s 7s] [7h]
andy0815r: bets $2
hldtom: calls $2
*** SHOW DOWN ***
andy0815r: shows [Ad 8d] (two pair, Sevens and Threes)
hldtom: shows [Kc 9c] (two pair, Nines and Sevens)
hldtom collected $10.13 from pot
*** SUMMARY ***
Total pot $10.61 | Rake $0.48 
Board [9d 3d 3s 7s 7h]
Seat 1: Bahia gyn (button) folded before Flop (didn't bet)
Seat 2: Rilko1975 (small blind) folded before Flop
Seat 3: Grishukps (big blind) folded before Flop
Seat 4: Lasutchik folded before Flop (didn't bet)
Seat 5: chiyuki folded before Flop (didn't bet)
Seat 6: andy0815r showed [Ad 8d] and lost with two pair, Sevens and Threes
Seat 7: hldtom showed [Kc 9c] and won ($10.13) with two pair, Nines and Sevens
Seat 8: Perstenev folded before Flop (didn't bet)
Seat 9: snejokCoxx folded before Flop (didn't bet)



PokerStars Zoom Hand #84300930369:  Hold'em No Limit ($0.10/$0.25) - 2012/08/05 16:01:25 JST [2012/08/05 3:01:25 ET]
Table 'Whirlpool' 9-max Seat #1 is the button
Seat 1: Ellen1947 ($32.78 in chips) 
Seat 2: Alvinpe85 ($93.95 in chips) 
Seat 3: chiyuki ($38.68 in chips) 
Seat 4: romanian c4 ($14.34 in chips) 
Seat 5: poorpoor6551 ($11.80 in chips) 
Seat 6: jvds114 ($63.26 in chips) 
Seat 7: Spheroff ($24.65 in chips) 
Seat 8: ViTiV2010 ($12.50 in chips) 
Seat 9: phate-1up ($60.34 in chips) 
Alvinpe85: posts small blind $0.10
chiyuki: posts big blind $0.25
*** HOLE CARDS ***
Dealt to chiyuki [8d Ah]
romanian c4: folds 
poorpoor6551: folds 
jvds114: folds 
Spheroff: folds 
ViTiV2010: folds 
phate-1up: folds 
Ellen1947: raises $0.50 to $0.75
Alvinpe85: folds 
chiyuki: folds 
Uncalled bet ($0.50) returned to Ellen1947
Ellen1947 collected $0.60 from pot
Ellen1947: doesn't show hand 
*** SUMMARY ***
Total pot $0.60 | Rake $0 
Seat 1: Ellen1947 (button) collected ($0.60)
Seat 2: Alvinpe85 (small blind) folded before Flop
Seat 3: chiyuki (big blind) folded before Flop
Seat 4: romanian c4 folded before Flop (didn't bet)
Seat 5: poorpoor6551 folded before Flop (didn't bet)
Seat 6: jvds114 folded before Flop (didn't bet)
Seat 7: Spheroff folded before Flop (didn't bet)
Seat 8: ViTiV2010 folded before Flop (didn't bet)
Seat 9: phate-1up folded before Flop (didn't bet)



PokerStars Zoom Hand #84300941353:  Hold'em No Limit ($0.10/$0.25) - 2012/08/05 16:02:10 JST [2012/08/05 3:02:10 ET]
Table 'Whirlpool' 9-max Seat #1 is the button
Seat 1: jacquelinewu ($30.64 in chips) 
Seat 2: phate-1up ($60.34 in chips) 
Seat 3: DanielWhyte ($23.02 in chips) 
Seat 4: INSP!RON ($25 in chips) 
Seat 5: Dan Royal ($33.13 in chips) 
Seat 6: Jene4kaBest ($15.86 in chips) 
Seat 7: chiyuki ($38.43 in chips) 
Seat 8: Cripple86 ($25 in chips) 
Seat 9: westhavenbc ($19.57 in chips) 
phate-1up: posts small blind $0.10
DanielWhyte: posts big blind $0.25
*** HOLE CARDS ***
Dealt to chiyuki [Kc 7h]
INSP!RON: folds 
Dan Royal: calls $0.25
Jene4kaBest: folds 
chiyuki: folds 
Cripple86: folds 
westhavenbc: calls $0.25
jacquelinewu: folds 
phate-1up: folds 
DanielWhyte: checks 
*** FLOP *** [Js 8h 6h]
DanielWhyte: bets $0.50
Dan Royal: folds 
westhavenbc: folds 
Uncalled bet ($0.50) returned to DanielWhyte
DanielWhyte collected $0.81 from pot
DanielWhyte: doesn't show hand 
*** SUMMARY ***
Total pot $0.85 | Rake $0.04 
Board [Js 8h 6h]
Seat 1: jacquelinewu (button) folded before Flop (didn't bet)
Seat 2: phate-1up (small blind) folded before Flop
Seat 3: DanielWhyte (big blind) collected ($0.81)
Seat 4: INSP!RON folded before Flop (didn't bet)
Seat 5: Dan Royal folded on the Flop
Seat 6: Jene4kaBest folded before Flop (didn't bet)
Seat 7: chiyuki folded before Flop (didn't bet)
Seat 8: Cripple86 folded before Flop (didn't bet)
Seat 9: westhavenbc folded on the Flop



PokerStars Zoom Hand #84300938903:  Hold'em No Limit ($0.10/$0.25) - 2012/08/05 16:02:00 JST [2012/08/05 3:02:00 ET]
Table 'Whirlpool' 9-max Seat #1 is the button
Seat 1: snejokCoxx ($18.40 in chips) 
Seat 2: kwkim73 ($25.35 in chips) 
Seat 3: Lindikor ($15 in chips) 
Seat 4: xxASSO124xx ($11.15 in chips) 
Seat 5: 1Karina1 ($55.05 in chips) 
Seat 6: Perstenev ($9.03 in chips) 
Seat 7: Cripple86 ($25 in chips) 
Seat 8: chiyuki ($38.43 in chips) 
Seat 9: hldtom ($19.25 in chips) 
kwkim73: posts small blind $0.10
Lindikor: posts big blind $0.25
*** HOLE CARDS ***
Dealt to chiyuki [Th Qc]
xxASSO124xx: folds 
1Karina1: folds 
Perstenev: folds 
Cripple86: folds 
chiyuki: folds 
hldtom: raises $0.50 to $0.75
snejokCoxx: raises $1.65 to $2.40
kwkim73: folds 
Lindikor: folds 
hldtom: folds 
Uncalled bet ($1.65) returned to snejokCoxx
snejokCoxx collected $1.85 from pot
snejokCoxx: doesn't show hand 
*** SUMMARY ***
Total pot $1.85 | Rake $0 
Seat 1: snejokCoxx (button) collected ($1.85)
Seat 2: kwkim73 (small blind) folded before Flop
Seat 3: Lindikor (big blind) folded before Flop
Seat 4: xxASSO124xx folded before Flop (didn't bet)
Seat 5: 1Karina1 folded before Flop (didn't bet)
Seat 6: Perstenev folded before Flop (didn't bet)
Seat 7: Cripple86 folded before Flop (didn't bet)
Seat 8: chiyuki folded before Flop (didn't bet)
Seat 9: hldtom folded before Flop



PokerStars Zoom Hand #84300927728:  Hold'em No Limit ($0.10/$0.25) - 2012/08/05 16:01:15 JST [2012/08/05 3:01:15 ET]
Table 'Whirlpool' 9-max Seat #1 is the button
Seat 1: leo2095 ($16.90 in chips) 
Seat 2: 1Karina1 ($33.12 in chips) 
Seat 3: Dejacob ($25.79 in chips) 
Seat 4: Nerkit ($24.56 in chips) 
Seat 5: MurMurRu ($25 in chips) 
Seat 6: jacquelinewu ($26.59 in chips) 
Seat 7: KsuhaLove ($11.29 in chips) 
Seat 8: xxx Spb xxx ($25 in chips) 
Seat 9: chiyuki ($38.68 in chips) 
1Karina1: posts small blind $0.10
Dejacob: posts big blind $0.25
*** HOLE CARDS ***
Dealt to chiyuki [2d 4d]
Nerkit: folds 
MurMurRu: folds 
jacquelinewu: folds 
KsuhaLove: raises $0.25 to $0.50
xxx Spb xxx: folds 
chiyuki: folds 
leo2095: raises $1.25 to $1.75
1Karina1: folds 
Dejacob: folds 
KsuhaLove: calls $1.25
*** FLOP *** [6s 5d 9h]
KsuhaLove: bets $1.25
leo2095: raises $2.50 to $3.75
KsuhaLove: calls $2.50
*** TURN *** [6s 5d 9h] [4h]
KsuhaLove: bets $5.79 and is all-in
leo2095: calls $5.79
*** RIVER *** [6s 5d 9h 4h] [Qd]
*** SHOW DOWN ***
KsuhaLove: shows [Tc Th] (a pair of Tens)
leo2095: shows [Ah Ac] (a pair of Aces)
leo2095 collected $21.90 from pot
*** SUMMARY ***
Total pot $22.93 | Rake $1.03 
Board [6s 5d 9h 4h Qd]
Seat 1: leo2095 (button) showed [Ah Ac] and won ($21.90) with a pair of Aces
Seat 2: 1Karina1 (small blind) folded before Flop
Seat 3: Dejacob (big blind) folded before Flop
Seat 4: Nerkit folded before Flop (didn't bet)
Seat 5: MurMurRu folded before Flop (didn't bet)
Seat 6: jacquelinewu folded before Flop (didn't bet)
Seat 7: KsuhaLove showed [Tc Th] and lost with a pair of Tens
Seat 8: xxx Spb xxx folded before Flop (didn't bet)
Seat 9: chiyuki folded before Flop (didn't bet)



PokerStars Zoom Hand #84300942121:  Hold'em No Limit ($0.10/$0.25) - 2012/08/05 16:02:13 JST [2012/08/05 3:02:13 ET]
Table 'Whirlpool' 9-max Seat #1 is the button
Seat 1: chiyuki ($38.43 in chips) 
Seat 2: Faantomace ($36.05 in chips) 
Seat 3: Grishukps ($12.50 in chips) 
Seat 4: HighDuka ($20.53 in chips) 
Seat 5: Perstenev ($15.94 in chips) 
Seat 6: ShockLaMuc ($26.90 in chips) 
Seat 7: nice.franki ($6.73 in chips) 
Seat 8: kesstukas25 ($30.83 in chips) 
Seat 9: Dejacob ($44.21 in chips) 
Faantomace: posts small blind $0.10
Grishukps: posts big blind $0.25
*** HOLE CARDS ***
Dealt to chiyuki [5s 2c]
HighDuka: folds 
Perstenev: folds 
ShockLaMuc: folds 
nice.franki: folds 
kesstukas25: folds 
Dejacob: folds 
chiyuki: folds 
Faantomace: raises $0.50 to $0.75
Grishukps: folds 
Uncalled bet ($0.50) returned to Faantomace
Faantomace collected $0.50 from pot
Faantomace: doesn't show hand 
*** SUMMARY ***
Total pot $0.50 | Rake $0 
Seat 1: chiyuki (button) folded before Flop (didn't bet)
Seat 2: Faantomace (small blind) collected ($0.50)
Seat 3: Grishukps (big blind) folded before Flop
Seat 4: HighDuka folded before Flop (didn't bet)
Seat 5: Perstenev folded before Flop (didn't bet)
Seat 6: ShockLaMuc folded before Flop (didn't bet)
Seat 7: nice.franki folded before Flop (didn't bet)
Seat 8: kesstukas25 folded before Flop (didn't bet)
Seat 9: Dejacob folded before Flop (didn't bet)



PokerStars Zoom Hand #84300944289:  Hold'em No Limit ($0.10/$0.25) - 2012/08/05 16:02:21 JST [2012/08/05 3:02:21 ET]
Table 'Whirlpool' 9-max Seat #1 is the button
Seat 1: Cripple86 ($25 in chips) 
Seat 2: Nerkit ($15.45 in chips) 
Seat 3: phate-1up ($60.24 in chips) 
Seat 4: chiyuki ($38.43 in chips) 
Seat 5: xxx Spb xxx ($26.66 in chips) 
Seat 6: Rici47 ($25.40 in chips) 
Seat 7: Perstenev ($9.03 in chips) 
Seat 8: westhavenbc ($17.01 in chips) 
Seat 9: MurMurRu ($25.35 in chips) 
Nerkit: posts small blind $0.10
phate-1up: posts big blind $0.25
*** HOLE CARDS ***
Dealt to chiyuki [6h 3h]
chiyuki: folds 
xxx Spb xxx: folds 
Rici47: folds 
Perstenev: folds 
westhavenbc: folds 
MurMurRu: folds 
Cripple86: raises $0.50 to $0.75
Nerkit: folds 
phate-1up: folds 
Uncalled bet ($0.50) returned to Cripple86
Cripple86 collected $0.60 from pot
Cripple86: doesn't show hand 
*** SUMMARY ***
Total pot $0.60 | Rake $0 
Seat 1: Cripple86 (button) collected ($0.60)
Seat 2: Nerkit (small blind) folded before Flop
Seat 3: phate-1up (big blind) folded before Flop
Seat 4: chiyuki folded before Flop (didn't bet)
Seat 5: xxx Spb xxx folded before Flop (didn't bet)
Seat 6: Rici47 folded before Flop (didn't bet)
Seat 7: Perstenev folded before Flop (didn't bet)
Seat 8: westhavenbc folded before Flop (didn't bet)
Seat 9: MurMurRu folded before Flop (didn't bet)



PokerStars Zoom Hand #84300940126:  Hold'em No Limit ($0.10/$0.25) - 2012/08/05 16:02:05 JST [2012/08/05 3:02:05 ET]
Table 'Whirlpool' 9-max Seat #1 is the button
Seat 1: Nerkit ($15.45 in chips) 
Seat 2: GovGus ($25 in chips) 
Seat 3: pandaaaaaa ($19.16 in chips) 
Seat 4: FoRlan77 ($25 in chips) 
Seat 5: MurMurRu ($25 in chips) 
Seat 6: chiyuki ($38.43 in chips) 
Seat 7: Rici47 ($30.42 in chips) 
Seat 8: Grishukps ($12.50 in chips) 
Seat 9: Perstenev ($9.03 in chips) 
GovGus: posts small blind $0.10
pandaaaaaa: posts big blind $0.25
*** HOLE CARDS ***
Dealt to chiyuki [3s 7c]
FoRlan77: folds 
MurMurRu: calls $0.25
chiyuki: folds 
Rici47: folds 
Grishukps: folds 
Perstenev: folds 
Nerkit: folds 
GovGus: calls $0.15
pandaaaaaa: checks 
*** FLOP *** [6d 7d 5s]
GovGus: checks 
pandaaaaaa: checks 
MurMurRu: bets $0.61
GovGus: calls $0.61
pandaaaaaa: folds 
*** TURN *** [6d 7d 5s] [Qh]
GovGus: checks 
MurMurRu: bets $1.41
GovGus: folds 
Uncalled bet ($1.41) returned to MurMurRu
MurMurRu collected $1.88 from pot
MurMurRu: doesn't show hand 
*** SUMMARY ***
Total pot $1.97 | Rake $0.09 
Board [6d 7d 5s Qh]
Seat 1: Nerkit (button) folded before Flop (didn't bet)
Seat 2: GovGus (small blind) folded on the Turn
Seat 3: pandaaaaaa (big blind) folded on the Flop
Seat 4: FoRlan77 folded before Flop (didn't bet)
Seat 5: MurMurRu collected ($1.88)
Seat 6: chiyuki folded before Flop (didn't bet)
Seat 7: Rici47 folded before Flop (didn't bet)
Seat 8: Grishukps folded before Flop (didn't bet)
Seat 9: Perstenev folded before Flop (didn't bet)



PokerStars Zoom Hand #84300945564:  Hold'em No Limit ($0.10/$0.25) - 2012/08/05 16:02:26 JST [2012/08/05 3:02:26 ET]
Table 'Whirlpool' 9-max Seat #1 is the button
Seat 1: Grishukps ($12.50 in chips) 
Seat 2: chiyuki ($38.43 in chips) 
Seat 3: nice.franki ($6.73 in chips) 
Seat 4: DrunkTyphoon ($36.34 in chips) 
Seat 5: tribunpdm ($86.74 in chips) 
Seat 6: Rici47 ($30.32 in chips) 
Seat 7: Dejacob ($44.21 in chips) 
Seat 8: ivan130 ($24 in chips) 
Seat 9: Cripple86 ($25 in chips) 
chiyuki: posts small blind $0.10
nice.franki: posts big blind $0.25
*** HOLE CARDS ***
Dealt to chiyuki [Js Jh]
DrunkTyphoon: folds 
tribunpdm: raises $0.50 to $0.75
Rici47: raises $0.75 to $1.50
Dejacob: folds 
ivan130: folds 
Cripple86: folds 
Grishukps: folds 
chiyuki: calls $1.40
nice.franki: folds 
tribunpdm: calls $0.75
*** FLOP *** [5s 5d Ks]
chiyuki: checks 
tribunpdm: checks 
Rici47: checks 
*** TURN *** [5s 5d Ks] [4c]
chiyuki: checks 
tribunpdm: checks 
Rici47: bets $1
chiyuki: calls $1
tribunpdm: calls $1
*** RIVER *** [5s 5d Ks 4c] [Qs]
chiyuki: checks 
tribunpdm: checks 
Rici47: checks 
*** SHOW DOWN ***
chiyuki: shows [Js Jh] (two pair, Jacks and Fives)
tribunpdm: mucks hand 
Rici47: mucks hand 
chiyuki collected $7.40 from pot
*** SUMMARY ***
Total pot $7.75 | Rake $0.35 
Board [5s 5d Ks 4c Qs]
Seat 1: Grishukps (button) folded before Flop (didn't bet)
Seat 2: chiyuki (small blind) showed [Js Jh] and won ($7.40) with two pair, Jacks and Fives
Seat 3: nice.franki (big blind) folded before Flop
Seat 4: DrunkTyphoon folded before Flop (didn't bet)
Seat 5: tribunpdm mucked [6c 6d]
Seat 6: Rici47 mucked [Th Ts]
Seat 7: Dejacob folded before Flop (didn't bet)
Seat 8: ivan130 folded before Flop (didn't bet)
Seat 9: Cripple86 folded before Flop (didn't bet)



PokerStars Zoom Hand #84300961401:  Hold'em No Limit ($0.10/$0.25) - 2012/08/05 16:03:28 JST [2012/08/05 3:03:28 ET]
Table 'Whirlpool' 9-max Seat #1 is the button
Seat 1: ShockLaMuc ($22.55 in chips) 
Seat 2: seula i ($44.63 in chips) 
Seat 3: DrunkTyphoon ($36.34 in chips) 
Seat 4: tribunpdm ($84.24 in chips) 
Seat 5: pandaaaaaa ($18.81 in chips) 
Seat 6: chiyuki ($43.33 in chips) 
Seat 7: INSP!RON ($32.87 in chips) 
Seat 8: silvno31 ($68.05 in chips) 
Seat 9: Rici47 ($27.82 in chips) 
seula i: posts small blind $0.10
DrunkTyphoon: posts big blind $0.25
*** HOLE CARDS ***
Dealt to chiyuki [Qd Ah]
tribunpdm: folds 
pandaaaaaa: folds 
chiyuki: raises $0.50 to $0.75
INSP!RON: folds 
silvno31: folds 
Rici47: raises $1.25 to $2
ShockLaMuc: folds 
seula i: folds 
DrunkTyphoon: folds 
chiyuki: raises $4 to $6
Rici47: calls $4
*** FLOP *** [4h 2s Js]
chiyuki: bets $5.89
Rici47: calls $5.89
*** TURN *** [4h 2s Js] [Ts]
chiyuki: checks 
Rici47: bets $15.93 and is all-in
chiyuki: folds 
Uncalled bet ($15.93) returned to Rici47
Rici47 collected $23.04 from pot
Rici47: doesn't show hand 
*** SUMMARY ***
Total pot $24.13 | Rake $1.09 
Board [4h 2s Js Ts]
Seat 1: ShockLaMuc (button) folded before Flop (didn't bet)
Seat 2: seula i (small blind) folded before Flop
Seat 3: DrunkTyphoon (big blind) folded before Flop
Seat 4: tribunpdm folded before Flop (didn't bet)
Seat 5: pandaaaaaa folded before Flop (didn't bet)
Seat 6: chiyuki folded on the Turn
Seat 7: INSP!RON folded before Flop (didn't bet)
Seat 8: silvno31 folded before Flop (didn't bet)
Seat 9: Rici47 collected ($23.04)



PokerStars Zoom Hand #84300984891:  Hold'em No Limit ($0.10/$0.25) - 2012/08/05 16:04:57 JST [2012/08/05 3:04:57 ET]
Table 'Whirlpool' 9-max Seat #1 is the button
Seat 1: phate-1up ($40.72 in chips) 
Seat 2: 4plankton ($10.38 in chips) 
Seat 3: Perstenev ($8.78 in chips) 
Seat 4: Faantomace ($30.05 in chips) 
Seat 5: snejokCoxx ($12.15 in chips) 
Seat 6: Cripple86 ($25 in chips) 
Seat 7: chiyuki ($31.44 in chips) 
Seat 8: Grumpy as 2 ($12.65 in chips) 
Seat 9: kesstukas25 ($30.73 in chips) 
4plankton: posts small blind $0.10
Perstenev: posts big blind $0.25
*** HOLE CARDS ***
Dealt to chiyuki [3d 6d]
Faantomace: raises $1 to $1.25
snejokCoxx: folds 
Cripple86: folds 
chiyuki: folds 
Grumpy as 2: folds 
kesstukas25: folds 
phate-1up: folds 
4plankton: folds 
Perstenev: folds 
Uncalled bet ($1) returned to Faantomace
Faantomace collected $0.60 from pot
Faantomace: doesn't show hand 
*** SUMMARY ***
Total pot $0.60 | Rake $0 
Seat 1: phate-1up (button) folded before Flop (didn't bet)
Seat 2: 4plankton (small blind) folded before Flop
Seat 3: Perstenev (big blind) folded before Flop
Seat 4: Faantomace collected ($0.60)
Seat 5: snejokCoxx folded before Flop (didn't bet)
Seat 6: Cripple86 folded before Flop (didn't bet)
Seat 7: chiyuki folded before Flop (didn't bet)
Seat 8: Grumpy as 2 folded before Flop (didn't bet)
Seat 9: kesstukas25 folded before Flop (didn't bet)



PokerStars Zoom Hand #84300987559:  Hold'em No Limit ($0.10/$0.25) - 2012/08/05 16:05:07 JST [2012/08/05 3:05:07 ET]
Table 'Whirlpool' 9-max Seat #1 is the button
Seat 1: INSP!RON ($32.12 in chips) 
Seat 2: Cripple86 ($25.35 in chips) 
Seat 3: Rici47 ($38.97 in chips) 
Seat 4: hldtom ($43.54 in chips) 
Seat 5: 6nikola9 ($6.49 in chips) 
Seat 6: phate-1up ($59.64 in chips) 
Seat 7: 4plankton ($10.28 in chips) 
Seat 8: chiyuki ($31.44 in chips) 
Seat 9: ShockLaMuc ($22.20 in chips) 
Cripple86: posts small blind $0.10
Rici47: posts big blind $0.25
*** HOLE CARDS ***
Dealt to chiyuki [4s Ac]
hldtom: folds 
6nikola9: folds 
phate-1up: folds 
4plankton: folds 
chiyuki: folds 
ShockLaMuc: folds 
INSP!RON: folds 
Cripple86: folds 
Uncalled bet ($0.15) returned to Rici47
Rici47 collected $0.20 from pot
Rici47: doesn't show hand 
*** SUMMARY ***
Total pot $0.20 | Rake $0 
Seat 1: INSP!RON (button) folded before Flop (didn't bet)
Seat 2: Cripple86 (small blind) folded before Flop
Seat 3: Rici47 (big blind) collected ($0.20)
Seat 4: hldtom folded before Flop (didn't bet)
Seat 5: 6nikola9 folded before Flop (didn't bet)
Seat 6: phate-1up folded before Flop (didn't bet)
Seat 7: 4plankton folded before Flop (didn't bet)
Seat 8: chiyuki folded before Flop (didn't bet)
Seat 9: ShockLaMuc folded before Flop (didn't bet)



PokerStars Zoom Hand #84300985945:  Hold'em No Limit ($0.10/$0.25) - 2012/08/05 16:05:01 JST [2012/08/05 3:05:01 ET]
Table 'Whirlpool' 9-max Seat #1 is the button
Seat 1: TorTrade ($22.27 in chips) 
Seat 2: Ellen1947 ($33.12 in chips) 
Seat 3: DrunkTyphoon ($36.34 in chips) 
Seat 4: 1Karina1 ($38.11 in chips) 
Seat 5: kesstukas25 ($30.73 in chips) 
Seat 6: phate-1up ($40.72 in chips) 
Seat 7: westhavenbc ($15.16 in chips) 
Seat 8: FoRlan77 ($25 in chips) 
Seat 9: chiyuki ($31.44 in chips) 
Ellen1947: posts small blind $0.10
DrunkTyphoon: posts big blind $0.25
*** HOLE CARDS ***
Dealt to chiyuki [9d 2s]
1Karina1: folds 
kesstukas25: folds 
phate-1up: folds 
westhavenbc: raises $0.25 to $0.50
FoRlan77: folds 
chiyuki: folds 
TorTrade: folds 
Ellen1947: folds 
DrunkTyphoon: folds 
Uncalled bet ($0.25) returned to westhavenbc
westhavenbc collected $0.60 from pot
westhavenbc: doesn't show hand 
*** SUMMARY ***
Total pot $0.60 | Rake $0 
Seat 1: TorTrade (button) folded before Flop (didn't bet)
Seat 2: Ellen1947 (small blind) folded before Flop
Seat 3: DrunkTyphoon (big blind) folded before Flop
Seat 4: 1Karina1 folded before Flop (didn't bet)
Seat 5: kesstukas25 folded before Flop (didn't bet)
Seat 6: phate-1up folded before Flop (didn't bet)
Seat 7: westhavenbc collected ($0.60)
Seat 8: FoRlan77 folded before Flop (didn't bet)
Seat 9: chiyuki folded before Flop (didn't bet)



PokerStars Zoom Hand #84300988681:  Hold'em No Limit ($0.10/$0.25) - 2012/08/05 16:05:11 JST [2012/08/05 3:05:11 ET]
Table 'Whirlpool' 9-max Seat #1 is the button
Seat 1: jacquelinewu ($25.34 in chips) 
Seat 2: Lindikor ($5.11 in chips) 
Seat 3: chiyuki ($31.44 in chips) 
Seat 4: snejokCoxx ($12.15 in chips) 
Seat 5: azizmimi ($32.15 in chips) 
Seat 6: Grumpy as 2 ($12.65 in chips) 
Seat 7: INSP!RON ($32.12 in chips) 
Seat 8: Tonychanman ($18.10 in chips) 
Seat 9: kwkim73 ($29.54 in chips) 
Lindikor: posts small blind $0.10
chiyuki: posts big blind $0.25
*** HOLE CARDS ***
Dealt to chiyuki [4d 3s]
snejokCoxx: raises $0.40 to $0.65
azizmimi: folds 
Grumpy as 2: calls $0.65
INSP!RON: folds 
Tonychanman: folds 
kwkim73: raises $2.30 to $2.95
jacquelinewu: folds 
Lindikor: folds 
chiyuki: folds 
snejokCoxx: folds 
Grumpy as 2: folds 
Uncalled bet ($2.30) returned to kwkim73
kwkim73 collected $2.30 from pot
kwkim73: doesn't show hand 
*** SUMMARY ***
Total pot $2.30 | Rake $0 
Seat 1: jacquelinewu (button) folded before Flop (didn't bet)
Seat 2: Lindikor (small blind) folded before Flop
Seat 3: chiyuki (big blind) folded before Flop
Seat 4: snejokCoxx folded before Flop
Seat 5: azizmimi folded before Flop (didn't bet)
Seat 6: Grumpy as 2 folded before Flop
Seat 7: INSP!RON folded before Flop (didn't bet)
Seat 8: Tonychanman folded before Flop (didn't bet)
Seat 9: kwkim73 collected ($2.30)



PokerStars Zoom Hand #84300994861:  Hold'em No Limit ($0.10/$0.25) - 2012/08/05 16:05:35 JST [2012/08/05 3:05:35 ET]
Table 'Whirlpool' 9-max Seat #1 is the button
Seat 1: Saruotiss ($59.78 in chips) 
Seat 2: zongo1 ($24.10 in chips) 
Seat 3: Roglus ($12.71 in chips) 
Seat 4: GovGus ($47.39 in chips) 
Seat 5: chiyuki ($31.19 in chips) 
Seat 6: 1Karina1 ($55.19 in chips) 
Seat 7: Perstenev ($16.02 in chips) 
Seat 8: phate-1up ($40.62 in chips) 
Seat 9: Blue-GumBum ($9.24 in chips) 
zongo1: posts small blind $0.10
Roglus: posts big blind $0.25
*** HOLE CARDS ***
Dealt to chiyuki [9c Qd]
GovGus: folds 
chiyuki: folds 
1Karina1: folds 
Perstenev: folds 
phate-1up: folds 
Blue-GumBum: folds 
Saruotiss has timed out
Saruotiss: folds 
zongo1: folds 
Uncalled bet ($0.15) returned to Roglus
Roglus collected $0.20 from pot
Roglus: doesn't show hand 
*** SUMMARY ***
Total pot $0.20 | Rake $0 
Seat 1: Saruotiss (button) folded before Flop (didn't bet)
Seat 2: zongo1 (small blind) folded before Flop
Seat 3: Roglus (big blind) collected ($0.20)
Seat 4: GovGus folded before Flop (didn't bet)
Seat 5: chiyuki folded before Flop (didn't bet)
Seat 6: 1Karina1 folded before Flop (didn't bet)
Seat 7: Perstenev folded before Flop (didn't bet)
Seat 8: phate-1up folded before Flop (didn't bet)
Seat 9: Blue-GumBum folded before Flop (didn't bet)



PokerStars Zoom Hand #84300995679:  Hold'em No Limit ($0.10/$0.25) - 2012/08/05 16:05:38 JST [2012/08/05 3:05:38 ET]
Table 'Whirlpool' 9-max Seat #1 is the button
Seat 1: Grishukps ($13.84 in chips) 
Seat 2: Faantomace ($30.40 in chips) 
Seat 3: fil740 ($13 in chips) 
Seat 4: chiyuki ($31.19 in chips) 
Seat 5: scaredsare ($30.09 in chips) 
Seat 6: nice.franki ($5.38 in chips) 
Seat 7: Cripple86 ($25.25 in chips) 
Seat 8: hldtom ($19.73 in chips) 
Seat 9: silvno31 ($66.64 in chips) 
Faantomace: posts small blind $0.10
fil740: posts big blind $0.25
*** HOLE CARDS ***
Dealt to chiyuki [Kh Ac]
chiyuki: raises $0.50 to $0.75
scaredsare: folds 
nice.franki: folds 
Cripple86: folds 
hldtom: folds 
silvno31: folds 
Grishukps: folds 
Faantomace: folds 
fil740: folds 
Uncalled bet ($0.50) returned to chiyuki
chiyuki collected $0.60 from pot
chiyuki: doesn't show hand 
*** SUMMARY ***
Total pot $0.60 | Rake $0 
Seat 1: Grishukps (button) folded before Flop (didn't bet)
Seat 2: Faantomace (small blind) folded before Flop
Seat 3: fil740 (big blind) folded before Flop
Seat 4: chiyuki collected ($0.60)
Seat 5: scaredsare folded before Flop (didn't bet)
Seat 6: nice.franki folded before Flop (didn't bet)
Seat 7: Cripple86 folded before Flop (didn't bet)
Seat 8: hldtom folded before Flop (didn't bet)
Seat 9: silvno31 folded before Flop (didn't bet)



PokerStars Zoom Hand #84301004207:  Hold'em No Limit ($0.10/$0.25) - 2012/08/05 16:06:10 JST [2012/08/05 3:06:10 ET]
Table 'Whirlpool' 9-max Seat #1 is the button
Seat 1: MurMurRu ($41.74 in chips) 
Seat 2: chiyuki ($31.54 in chips) 
Seat 3: teaser07 ($25 in chips) 
Seat 4: Blue-GumBum ($9.14 in chips) 
Seat 5: Vall179 ($24.65 in chips) 
Seat 6: 4ydo yogurt ($65.31 in chips) 
Seat 7: GSDP ($37.60 in chips) 
Seat 8: Perstenev ($12.61 in chips) 
Seat 9: NEZZA177 ($24.15 in chips) 
chiyuki: posts small blind $0.10
teaser07: posts big blind $0.25
*** HOLE CARDS ***
Dealt to chiyuki [3h 5c]
Blue-GumBum: folds 
Vall179: folds 
4ydo yogurt: folds 
GSDP: folds 
Perstenev: folds 
NEZZA177: folds 
MurMurRu: raises $0.42 to $0.67
chiyuki: folds 
teaser07: folds 
Uncalled bet ($0.42) returned to MurMurRu
MurMurRu collected $0.60 from pot
MurMurRu: doesn't show hand 
*** SUMMARY ***
Total pot $0.60 | Rake $0 
Seat 1: MurMurRu (button) collected ($0.60)
Seat 2: chiyuki (small blind) folded before Flop
Seat 3: teaser07 (big blind) folded before Flop
Seat 4: Blue-GumBum folded before Flop (didn't bet)
Seat 5: Vall179 folded before Flop (didn't bet)
Seat 6: 4ydo yogurt folded before Flop (didn't bet)
Seat 7: GSDP folded before Flop (didn't bet)
Seat 8: Perstenev folded before Flop (didn't bet)
Seat 9: NEZZA177 folded before Flop (didn't bet)



PokerStars Zoom Hand #84301008518:  Hold'em No Limit ($0.10/$0.25) - 2012/08/05 16:06:26 JST [2012/08/05 3:06:26 ET]
Table 'Whirlpool' 9-max Seat #1 is the button
Seat 1: soul_5577 ($43.23 in chips) 
Seat 2: phate-1up ($56.39 in chips) 
Seat 3: Perstenev ($16.25 in chips) 
Seat 4: chiyuki ($31.44 in chips) 
Seat 5: Cripple86 ($27.26 in chips) 
Seat 6: GSDP ($37.60 in chips) 
Seat 7: DrunkTyphoon ($36.09 in chips) 
Seat 8: NEZZA177 ($24.15 in chips) 
Seat 9: andy0815r ($31.71 in chips) 
phate-1up: posts small blind $0.10
Perstenev: posts big blind $0.25
*** HOLE CARDS ***
Dealt to chiyuki [4h 6h]
chiyuki: folds 
Cripple86: folds 
GSDP: raises $0.75 to $1
DrunkTyphoon: folds 
NEZZA177: folds 
andy0815r: folds 
soul_5577: folds 
phate-1up: folds 
Perstenev: folds 
Uncalled bet ($0.75) returned to GSDP
GSDP collected $0.60 from pot
GSDP: doesn't show hand 
*** SUMMARY ***
Total pot $0.60 | Rake $0 
Seat 1: soul_5577 (button) folded before Flop (didn't bet)
Seat 2: phate-1up (small blind) folded before Flop
Seat 3: Perstenev (big blind) folded before Flop
Seat 4: chiyuki folded before Flop (didn't bet)
Seat 5: Cripple86 folded before Flop (didn't bet)
Seat 6: GSDP collected ($0.60)
Seat 7: DrunkTyphoon folded before Flop (didn't bet)
Seat 8: NEZZA177 folded before Flop (didn't bet)
Seat 9: andy0815r folded before Flop (didn't bet)



PokerStars Zoom Hand #84301009838:  Hold'em No Limit ($0.10/$0.25) - 2012/08/05 16:06:31 JST [2012/08/05 3:06:31 ET]
Table 'Whirlpool' 9-max Seat #1 is the button
Seat 1: phate-1up ($56.29 in chips) 
Seat 2: Loholov ($15 in chips) 
Seat 3: silvno31 ($66.89 in chips) 
Seat 4: deepakmbh ($31.96 in chips) 
Seat 5: GovGus ($47.39 in chips) 
Seat 6: mjmichi ($76.36 in chips) 
Seat 7: Grishukps ($12.75 in chips) 
Seat 8: Rici47 ($26.46 in chips) 
Seat 9: chiyuki ($31.44 in chips) 
Loholov: posts small blind $0.10
silvno31: posts big blind $0.25
*** HOLE CARDS ***
Dealt to chiyuki [6d 9d]
deepakmbh: raises $0.50 to $0.75
GovGus: folds 
mjmichi: folds 
Grishukps: folds 
Rici47: folds 
chiyuki: folds 
phate-1up: folds 
Loholov: folds 
silvno31: folds 
Uncalled bet ($0.50) returned to deepakmbh
deepakmbh collected $0.60 from pot
deepakmbh: doesn't show hand 
*** SUMMARY ***
Total pot $0.60 | Rake $0 
Seat 1: phate-1up (button) folded before Flop (didn't bet)
Seat 2: Loholov (small blind) folded before Flop
Seat 3: silvno31 (big blind) folded before Flop
Seat 4: deepakmbh collected ($0.60)
Seat 5: GovGus folded before Flop (didn't bet)
Seat 6: mjmichi folded before Flop (didn't bet)
Seat 7: Grishukps folded before Flop (didn't bet)
Seat 8: Rici47 folded before Flop (didn't bet)
Seat 9: chiyuki folded before Flop (didn't bet)



PokerStars Zoom Hand #84301011739:  Hold'em No Limit ($0.10/$0.25) - 2012/08/05 16:06:38 JST [2012/08/05 3:06:38 ET]
Table 'Whirlpool' 9-max Seat #1 is the button
Seat 1: chiyuki ($31.44 in chips) 
Seat 2: nice.franki ($13.05 in chips) 
Seat 3: INSP!RON ($31.77 in chips) 
Seat 4: Serge Claws ($40.13 in chips) 
Seat 5: Grishukps ($12.85 in chips) 
Seat 6: Nerkit ($20.80 in chips) 
Seat 7: Dejacob ($33.77 in chips) 
Seat 8: Cripple86 ($27.26 in chips) 
Seat 9: silvno31 ($66.64 in chips) 
nice.franki: posts small blind $0.10
INSP!RON: posts big blind $0.25
*** HOLE CARDS ***
Dealt to chiyuki [Ad Kh]
Serge Claws: folds 
Grishukps: folds 
Nerkit: folds 
Dejacob: folds 
Cripple86: folds 
silvno31: folds 
chiyuki: raises $0.50 to $0.75
nice.franki: folds 
INSP!RON: folds 
Uncalled bet ($0.50) returned to chiyuki
chiyuki collected $0.60 from pot
chiyuki: doesn't show hand 
*** SUMMARY ***
Total pot $0.60 | Rake $0 
Seat 1: chiyuki (button) collected ($0.60)
Seat 2: nice.franki (small blind) folded before Flop
Seat 3: INSP!RON (big blind) folded before Flop
Seat 4: Serge Claws folded before Flop (didn't bet)
Seat 5: Grishukps folded before Flop (didn't bet)
Seat 6: Nerkit folded before Flop (didn't bet)
Seat 7: Dejacob folded before Flop (didn't bet)
Seat 8: Cripple86 folded before Flop (didn't bet)
Seat 9: silvno31 folded before Flop (didn't bet)



PokerStars Zoom Hand #84301015496:  Hold'em No Limit ($0.10/$0.25) - 2012/08/05 16:06:53 JST [2012/08/05 3:06:53 ET]
Table 'Whirlpool' 9-max Seat #1 is the button
Seat 1: Vall179 ($24.65 in chips) 
Seat 2: Rici47 ($39.75 in chips) 
Seat 3: Nerkit ($20.80 in chips) 
Seat 4: Alvinpe85 ($95.27 in chips) 
Seat 5: PPP7SSS ($52.98 in chips) 
Seat 6: soul_5577 ($42.98 in chips) 
Seat 7: pawn909 ($22.07 in chips) 
Seat 8: chiyuki ($31.79 in chips) 
Seat 9: INSP!RON ($25 in chips) 
Rici47: posts small blind $0.10
Nerkit: posts big blind $0.25
*** HOLE CARDS ***
Dealt to chiyuki [4h Ts]
Alvinpe85: raises $0.50 to $0.75
PPP7SSS: folds 
soul_5577: folds 
pawn909: folds 
chiyuki: folds 
INSP!RON: calls $0.75
Vall179: raises $2.50 to $3.25
Rici47: folds 
Nerkit: folds 
Alvinpe85: folds 
INSP!RON: folds 
Uncalled bet ($2.50) returned to Vall179
Vall179 collected $2.60 from pot
Vall179: doesn't show hand 
*** SUMMARY ***
Total pot $2.60 | Rake $0 
Seat 1: Vall179 (button) collected ($2.60)
Seat 2: Rici47 (small blind) folded before Flop
Seat 3: Nerkit (big blind) folded before Flop
Seat 4: Alvinpe85 folded before Flop
Seat 5: PPP7SSS folded before Flop (didn't bet)
Seat 6: soul_5577 folded before Flop (didn't bet)
Seat 7: pawn909 folded before Flop (didn't bet)
Seat 8: chiyuki folded before Flop (didn't bet)
Seat 9: INSP!RON folded before Flop



PokerStars Zoom Hand #84301016786:  Hold'em No Limit ($0.10/$0.25) - 2012/08/05 16:06:58 JST [2012/08/05 3:06:58 ET]
Table 'Whirlpool' 9-max Seat #1 is the button
Seat 1: azizmimi ($30.93 in chips) 
Seat 2: Limoilou ($28.23 in chips) 
Seat 3: hldtom ($62.89 in chips) 
Seat 4: Mytea88 ($13.65 in chips) 
Seat 5: ShockLaMuc ($22.20 in chips) 
Seat 6: Perstenev ($11.38 in chips) 
Seat 7: chiyuki ($31.79 in chips) 
Seat 8: Serge Claws ($65.05 in chips) 
Seat 9: seula i ($43.18 in chips) 
Limoilou: posts small blind $0.10
hldtom: posts big blind $0.25
*** HOLE CARDS ***
Dealt to chiyuki [6c Qd]
Mytea88: folds 
ShockLaMuc: folds 
Perstenev: raises $0.50 to $0.75
chiyuki: folds 
Serge Claws: folds 
seula i: folds 
azizmimi: folds 
Limoilou: folds 
hldtom: folds 
Uncalled bet ($0.50) returned to Perstenev
Perstenev collected $0.60 from pot
Perstenev: doesn't show hand 
*** SUMMARY ***
Total pot $0.60 | Rake $0 
Seat 1: azizmimi (button) folded before Flop (didn't bet)
Seat 2: Limoilou (small blind) folded before Flop
Seat 3: hldtom (big blind) folded before Flop
Seat 4: Mytea88 folded before Flop (didn't bet)
Seat 5: ShockLaMuc folded before Flop (didn't bet)
Seat 6: Perstenev collected ($0.60)
Seat 7: chiyuki folded before Flop (didn't bet)
Seat 8: Serge Claws folded before Flop (didn't bet)
Seat 9: seula i folded before Flop (didn't bet)



PokerStars Zoom Hand #84301028104:  Hold'em No Limit ($0.10/$0.25) - 2012/08/05 16:07:40 JST [2012/08/05 3:07:40 ET]
Table 'Whirlpool' 9-max Seat #1 is the button
Seat 1: fwnaf ($21.76 in chips) 
Seat 2: Bahia gyn ($19.91 in chips) 
Seat 3: codan23 ($15.26 in chips) 
Seat 4: 4plankton ($8.68 in chips) 
Seat 5: Loholov ($15 in chips) 
Seat 6: chiyuki ($31.54 in chips) 
Seat 7: Nerkit ($8.90 in chips) 
Seat 8: scaredsare ($25.03 in chips) 
Seat 9: men1989 ($23.89 in chips) 
Bahia gyn: posts small blind $0.10
codan23: posts big blind $0.25
*** HOLE CARDS ***
Dealt to chiyuki [Tc 3h]
4plankton: folds 
Loholov: folds 
chiyuki: folds 
Nerkit: folds 
scaredsare: folds 
men1989: folds 
fwnaf: folds 
Bahia gyn: folds 
Uncalled bet ($0.15) returned to codan23
codan23 collected $0.20 from pot
codan23: doesn't show hand 
*** SUMMARY ***
Total pot $0.20 | Rake $0 
Seat 1: fwnaf (button) folded before Flop (didn't bet)
Seat 2: Bahia gyn (small blind) folded before Flop
Seat 3: codan23 (big blind) collected ($0.20)
Seat 4: 4plankton folded before Flop (didn't bet)
Seat 5: Loholov folded before Flop (didn't bet)
Seat 6: chiyuki folded before Flop (didn't bet)
Seat 7: Nerkit folded before Flop (didn't bet)
Seat 8: scaredsare folded before Flop (didn't bet)
Seat 9: men1989 folded before Flop (didn't bet)



PokerStars Zoom Hand #84301019447:  Hold'em No Limit ($0.10/$0.25) - 2012/08/05 16:07:08 JST [2012/08/05 3:07:08 ET]
Table 'Whirlpool' 9-max Seat #1 is the button
Seat 1: Vall179 ($24.30 in chips) 
Seat 2: Serge Claws ($25 in chips) 
Seat 3: chiyuki ($31.79 in chips) 
Seat 4: 1Karina1 ($36.26 in chips) 
Seat 5: wildy29 ($91.14 in chips) 
Seat 6: slapshot2011 ($33.51 in chips) 
Seat 7: INSP!RON ($31.93 in chips) 
Seat 8: drunk_bender ($13.80 in chips) 
Seat 9: men1989 ($23.89 in chips) 
Serge Claws: posts small blind $0.10
chiyuki: posts big blind $0.25
*** HOLE CARDS ***
Dealt to chiyuki [8c Ts]
1Karina1: folds 
wildy29: calls $0.25
slapshot2011: folds 
INSP!RON: folds 
drunk_bender: folds 
men1989: folds 
Vall179: folds 
Serge Claws: calls $0.15
chiyuki: checks 
*** FLOP *** [5c 9c 2d]
Serge Claws: bets $0.50
chiyuki: folds 
wildy29: calls $0.50
*** TURN *** [5c 9c 2d] [Js]
Serge Claws: checks 
wildy29: bets $0.50
Serge Claws: calls $0.50
*** RIVER *** [5c 9c 2d Js] [5h]
Serge Claws: checks 
wildy29: bets $1.50
Serge Claws: calls $1.50
*** SHOW DOWN ***
wildy29: shows [5s 8s] (three of a kind, Fives)
Serge Claws: mucks hand 
wildy29 collected $5.49 from pot
*** SUMMARY ***
Total pot $5.75 | Rake $0.26 
Board [5c 9c 2d Js 5h]
Seat 1: Vall179 (button) folded before Flop (didn't bet)
Seat 2: Serge Claws (small blind) mucked [Ah 9s]
Seat 3: chiyuki (big blind) folded on the Flop
Seat 4: 1Karina1 folded before Flop (didn't bet)
Seat 5: wildy29 showed [5s 8s] and won ($5.49) with three of a kind, Fives
Seat 6: slapshot2011 folded before Flop (didn't bet)
Seat 7: INSP!RON folded before Flop (didn't bet)
Seat 8: drunk_bender folded before Flop (didn't bet)
Seat 9: men1989 folded before Flop (didn't bet)



PokerStars Zoom Hand #84301029166:  Hold'em No Limit ($0.10/$0.25) - 2012/08/05 16:07:44 JST [2012/08/05 3:07:44 ET]
Table 'Whirlpool' 9-max Seat #1 is the button
Seat 1: GovGus ($30.12 in chips) 
Seat 2: chiyuki ($31.54 in chips) 
Seat 3: men1989 ($23.89 in chips) 
Seat 4: 4plankton ($8.68 in chips) 
Seat 5: DrunkTyphoon ($39.06 in chips) 
Seat 6: teaser07 ($25 in chips) 
Seat 7: Vall179 ($24.65 in chips) 
Seat 8: silvno31 ($66.64 in chips) 
Seat 9: kwkim73 ($25.78 in chips) 
chiyuki: posts small blind $0.10
men1989: posts big blind $0.25
*** HOLE CARDS ***
Dealt to chiyuki [3s Kh]
4plankton: folds 
DrunkTyphoon: folds 
teaser07: folds 
Vall179: raises $0.50 to $0.75
silvno31: folds 
kwkim73: folds 
GovGus: calls $0.75
chiyuki: folds 
men1989: folds 
*** FLOP *** [2h 6s Th]
Vall179: bets $1.07
GovGus: folds 
Uncalled bet ($1.07) returned to Vall179
Vall179 collected $1.77 from pot
Vall179: doesn't show hand 
*** SUMMARY ***
Total pot $1.85 | Rake $0.08 
Board [2h 6s Th]
Seat 1: GovGus (button) folded on the Flop
Seat 2: chiyuki (small blind) folded before Flop
Seat 3: men1989 (big blind) folded before Flop
Seat 4: 4plankton folded before Flop (didn't bet)
Seat 5: DrunkTyphoon folded before Flop (didn't bet)
Seat 6: teaser07 folded before Flop (didn't bet)
Seat 7: Vall179 collected ($1.77)
Seat 8: silvno31 folded before Flop (didn't bet)
Seat 9: kwkim73 folded before Flop (didn't bet)



PokerStars Zoom Hand #84301026495:  Hold'em No Limit ($0.10/$0.25) - 2012/08/05 16:07:34 JST [2012/08/05 3:07:34 ET]
Table 'Whirlpool' 9-max Seat #1 is the button
Seat 1: CrittHunter ($21.61 in chips) 
Seat 2: .7.DanDan.7. ($16.83 in chips) 
Seat 3: Mytea88 ($14.31 in chips) 
Seat 4: Perstenev ($15.90 in chips) 
Seat 5: chiyuki ($31.54 in chips) 
Seat 6: pandaaaaaa ($18.11 in chips) 
Seat 7: Vall179 ($24.30 in chips) 
Seat 8: teaser07 ($25 in chips) 
Seat 9: hldtom ($62.54 in chips) 
.7.DanDan.7.: posts small blind $0.10
Mytea88: posts big blind $0.25
*** HOLE CARDS ***
Dealt to chiyuki [As 2h]
Perstenev: folds 
chiyuki: folds 
pandaaaaaa: folds 
Vall179: folds 
teaser07: folds 
hldtom: raises $0.50 to $0.75
CrittHunter: folds 
.7.DanDan.7.: calls $0.65
Mytea88: folds 
*** FLOP *** [5c 5d 7d]
.7.DanDan.7.: checks 
hldtom: checks 
*** TURN *** [5c 5d 7d] [Kc]
.7.DanDan.7.: checks 
hldtom: bets $1.26
.7.DanDan.7.: calls $1.26
*** RIVER *** [5c 5d 7d Kc] [9s]
.7.DanDan.7.: checks 
hldtom: bets $2.04
.7.DanDan.7.: folds 
Uncalled bet ($2.04) returned to hldtom
hldtom collected $4.08 from pot
hldtom: doesn't show hand 
*** SUMMARY ***
Total pot $4.27 | Rake $0.19 
Board [5c 5d 7d Kc 9s]
Seat 1: CrittHunter (button) folded before Flop (didn't bet)
Seat 2: .7.DanDan.7. (small blind) folded on the River
Seat 3: Mytea88 (big blind) folded before Flop
Seat 4: Perstenev folded before Flop (didn't bet)
Seat 5: chiyuki folded before Flop (didn't bet)
Seat 6: pandaaaaaa folded before Flop (didn't bet)
Seat 7: Vall179 folded before Flop (didn't bet)
Seat 8: teaser07 folded before Flop (didn't bet)
Seat 9: hldtom collected ($4.08)



PokerStars Zoom Hand #84301034248:  Hold'em No Limit ($0.10/$0.25) - 2012/08/05 16:08:04 JST [2012/08/05 3:08:04 ET]
Table 'Whirlpool' 9-max Seat #1 is the button
Seat 1: chiyuki ($31.44 in chips) 
Seat 2: Serge Claws ($39.43 in chips) 
Seat 3: PAMBOS.L ($15 in chips) 
Seat 4: ShockLaMuc ($21.85 in chips) 
Seat 5: soul_5577 ($42.63 in chips) 
Seat 6: 1Karina1 ($30.16 in chips) 
Seat 7: Lindikor ($17.19 in chips) 
Seat 8: kwkim73 ($25.78 in chips) 
Seat 9: DrunkTyphoon ($42 in chips) 
Serge Claws: posts small blind $0.10
PAMBOS.L: posts big blind $0.25
*** HOLE CARDS ***
Dealt to chiyuki [3c Ah]
ShockLaMuc: folds 
soul_5577: raises $0.25 to $0.50
1Karina1: folds 
Lindikor: folds 
kwkim73: folds 
DrunkTyphoon: folds 
chiyuki: folds 
Serge Claws: folds 
PAMBOS.L: calls $0.25
*** FLOP *** [3h 6s Jd]
PAMBOS.L: checks 
soul_5577: bets $1
PAMBOS.L: folds 
Uncalled bet ($1) returned to soul_5577
soul_5577 collected $1.05 from pot
soul_5577: doesn't show hand 
*** SUMMARY ***
Total pot $1.10 | Rake $0.05 
Board [3h 6s Jd]
Seat 1: chiyuki (button) folded before Flop (didn't bet)
Seat 2: Serge Claws (small blind) folded before Flop
Seat 3: PAMBOS.L (big blind) folded on the Flop
Seat 4: ShockLaMuc folded before Flop (didn't bet)
Seat 5: soul_5577 collected ($1.05)
Seat 6: 1Karina1 folded before Flop (didn't bet)
Seat 7: Lindikor folded before Flop (didn't bet)
Seat 8: kwkim73 folded before Flop (didn't bet)
Seat 9: DrunkTyphoon folded before Flop (didn't bet)



PokerStars Zoom Hand #84301038605:  Hold'em No Limit ($0.10/$0.25) - 2012/08/05 16:08:20 JST [2012/08/05 3:08:20 ET]
Table 'Whirlpool' 9-max Seat #1 is the button
Seat 1: Bahia gyn ($19.56 in chips) 
Seat 2: CrittHunter ($21.36 in chips) 
Seat 3: xxASSO124xx ($10.11 in chips) 
Seat 4: Lindikor ($17.19 in chips) 
Seat 5: Jene4kaBest ($9.03 in chips) 
Seat 6: chiyuki ($31.44 in chips) 
Seat 7: silvno31 ($66.54 in chips) 
Seat 8: ShockLaMuc ($21.53 in chips) 
Seat 9: kesstukas25 ($29.95 in chips) 
CrittHunter: posts small blind $0.10
xxASSO124xx: posts big blind $0.25
*** HOLE CARDS ***
Dealt to chiyuki [Jd Qh]
Lindikor: folds 
Jene4kaBest: folds 
chiyuki: folds 
silvno31: folds 
ShockLaMuc: folds 
kesstukas25: folds 
Bahia gyn: raises $0.50 to $0.75
CrittHunter: folds 
xxASSO124xx: folds 
Uncalled bet ($0.50) returned to Bahia gyn
Bahia gyn collected $0.60 from pot
Bahia gyn: doesn't show hand 
*** SUMMARY ***
Total pot $0.60 | Rake $0 
Seat 1: Bahia gyn (button) collected ($0.60)
Seat 2: CrittHunter (small blind) folded before Flop
Seat 3: xxASSO124xx (big blind) folded before Flop
Seat 4: Lindikor folded before Flop (didn't bet)
Seat 5: Jene4kaBest folded before Flop (didn't bet)
Seat 6: chiyuki folded before Flop (didn't bet)
Seat 7: silvno31 folded before Flop (didn't bet)
Seat 8: ShockLaMuc folded before Flop (didn't bet)
Seat 9: kesstukas25 folded before Flop (didn't bet)



PokerStars Zoom Hand #84301042611:  Hold'em No Limit ($0.10/$0.25) - 2012/08/05 16:08:35 JST [2012/08/05 3:08:35 ET]
Table 'Whirlpool' 9-max Seat #1 is the button
Seat 1: FoRlan77 ($25 in chips) 
Seat 2: GSDP ($47.04 in chips) 
Seat 3: silvno31 ($66.54 in chips) 
Seat 4: CrittHunter ($21.26 in chips) 
Seat 5: Grishukps ($12.50 in chips) 
Seat 6: Perstenev ($5.03 in chips) 
Seat 7: Serge Claws ($39.93 in chips) 
Seat 8: chiyuki ($31.44 in chips) 
Seat 9: kwkim73 ($35.23 in chips) 
GSDP: posts small blind $0.10
silvno31: posts big blind $0.25
*** HOLE CARDS ***
Dealt to chiyuki [9d 2d]
CrittHunter: folds 
Grishukps: folds 
Perstenev: raises $0.50 to $0.75
Serge Claws: folds 
chiyuki: folds 
kwkim73: folds 
FoRlan77: folds 
GSDP: folds 
silvno31: folds 
Uncalled bet ($0.50) returned to Perstenev
Perstenev collected $0.60 from pot
Perstenev: doesn't show hand 
*** SUMMARY ***
Total pot $0.60 | Rake $0 
Seat 1: FoRlan77 (button) folded before Flop (didn't bet)
Seat 2: GSDP (small blind) folded before Flop
Seat 3: silvno31 (big blind) folded before Flop
Seat 4: CrittHunter folded before Flop (didn't bet)
Seat 5: Grishukps folded before Flop (didn't bet)
Seat 6: Perstenev collected ($0.60)
Seat 7: Serge Claws folded before Flop (didn't bet)
Seat 8: chiyuki folded before Flop (didn't bet)
Seat 9: kwkim73 folded before Flop (didn't bet)



PokerStars Zoom Hand #84301041503:  Hold'em No Limit ($0.10/$0.25) - 2012/08/05 16:08:31 JST [2012/08/05 3:08:31 ET]
Table 'Whirlpool' 9-max Seat #1 is the button
Seat 1: silvno31 ($66.54 in chips) 
Seat 2: Dejacob ($33.80 in chips) 
Seat 3: Lindikor ($17.19 in chips) 
Seat 4: kesstukas25 ($29.95 in chips) 
Seat 5: chiyuki ($31.44 in chips) 
Seat 6: Grishukps ($12.50 in chips) 
Seat 7: Vall179 ($26.60 in chips) 
Seat 8: nice.franki ($10.20 in chips) 
Seat 9: CrittHunter ($21.26 in chips) 
Dejacob: posts small blind $0.10
Lindikor: posts big blind $0.25
*** HOLE CARDS ***
Dealt to chiyuki [3c 6d]
kesstukas25: raises $0.50 to $0.75
chiyuki: folds 
Grishukps: folds 
Vall179: folds 
nice.franki: folds 
CrittHunter: folds 
silvno31: folds 
Dejacob: calls $0.65
Lindikor: folds 
*** FLOP *** [8d 4d 7h]
Dejacob: checks 
kesstukas25: checks 
*** TURN *** [8d 4d 7h] [9d]
Dejacob: checks 
kesstukas25: bets $0.75
Dejacob: folds 
Uncalled bet ($0.75) returned to kesstukas25
kesstukas25 collected $1.67 from pot
kesstukas25: doesn't show hand 
*** SUMMARY ***
Total pot $1.75 | Rake $0.08 
Board [8d 4d 7h 9d]
Seat 1: silvno31 (button) folded before Flop (didn't bet)
Seat 2: Dejacob (small blind) folded on the Turn
Seat 3: Lindikor (big blind) folded before Flop
Seat 4: kesstukas25 collected ($1.67)
Seat 5: chiyuki folded before Flop (didn't bet)
Seat 6: Grishukps folded before Flop (didn't bet)
Seat 7: Vall179 folded before Flop (didn't bet)
Seat 8: nice.franki folded before Flop (didn't bet)
Seat 9: CrittHunter folded before Flop (didn't bet)



PokerStars Zoom Hand #84301043937:  Hold'em No Limit ($0.10/$0.25) - 2012/08/05 16:08:40 JST [2012/08/05 3:08:40 ET]
Table 'Whirlpool' 9-max Seat #1 is the button
Seat 1: xxx Spb xxx ($30.21 in chips) 
Seat 2: ShockLaMuc ($21.85 in chips) 
Seat 3: chiyuki ($31.44 in chips) 
Seat 4: masterkoolb ($12.63 in chips) 
Seat 5: seula i ($61.25 in chips) 
Seat 6: kwkim73 ($35.23 in chips) 
Seat 7: leo2095 ($24.31 in chips) 
Seat 8: hldtom ($64.61 in chips) 
Seat 9: Grishukps ($12.50 in chips) 
ShockLaMuc: posts small blind $0.10
chiyuki: posts big blind $0.25
*** HOLE CARDS ***
Dealt to chiyuki [Td 6s]
masterkoolb: folds 
seula i: folds 
kwkim73: folds 
leo2095: raises $0.25 to $0.50
hldtom: folds 
Grishukps: folds 
xxx Spb xxx: folds 
ShockLaMuc: folds 
chiyuki: calls $0.25
*** FLOP *** [4c 4s Jh]
chiyuki: checks 
leo2095: checks 
*** TURN *** [4c 4s Jh] [3s]
chiyuki: checks 
leo2095: checks 
*** RIVER *** [4c 4s Jh 3s] [Kh]
chiyuki: checks 
leo2095: checks 
*** SHOW DOWN ***
chiyuki: shows [Td 6s] (a pair of Fours)
leo2095: shows [2c Ac] (a pair of Fours - Ace kicker)
leo2095 collected $1.05 from pot
*** SUMMARY ***
Total pot $1.10 | Rake $0.05 
Board [4c 4s Jh 3s Kh]
Seat 1: xxx Spb xxx (button) folded before Flop (didn't bet)
Seat 2: ShockLaMuc (small blind) folded before Flop
Seat 3: chiyuki (big blind) showed [Td 6s] and lost with a pair of Fours
Seat 4: masterkoolb folded before Flop (didn't bet)
Seat 5: seula i folded before Flop (didn't bet)
Seat 6: kwkim73 folded before Flop (didn't bet)
Seat 7: leo2095 showed [2c Ac] and won ($1.05) with a pair of Fours
Seat 8: hldtom folded before Flop (didn't bet)
Seat 9: Grishukps folded before Flop (didn't bet)



PokerStars Zoom Hand #84301037265:  Hold'em No Limit ($0.10/$0.25) - 2012/08/05 16:08:15 JST [2012/08/05 3:08:15 ET]
Table 'Whirlpool' 9-max Seat #1 is the button
Seat 1: Cripple86 ($27.51 in chips) 
Seat 2: INSP!RON ($25.60 in chips) 
Seat 3: GovGus ($29.37 in chips) 
Seat 4: phate-1up ($40.07 in chips) 
Seat 5: DrunkTyphoon ($42 in chips) 
Seat 6: masterkoolb ($12.88 in chips) 
Seat 7: kwkim73 ($25.78 in chips) 
Seat 8: ShockLaMuc ($21.85 in chips) 
Seat 9: chiyuki ($31.44 in chips) 
INSP!RON: posts small blind $0.10
GovGus: posts big blind $0.25
*** HOLE CARDS ***
Dealt to chiyuki [5s 6h]
phate-1up: raises $0.50 to $0.75
DrunkTyphoon: calls $0.75
masterkoolb: folds 
kwkim73: calls $0.75
ShockLaMuc: folds 
chiyuki: folds 
Cripple86: calls $0.75
INSP!RON: folds 
GovGus: calls $0.50
*** FLOP *** [9c 9d 3s]
GovGus: checks 
phate-1up: bets $2.75
DrunkTyphoon: calls $2.75
kwkim73: folds 
Cripple86: folds 
GovGus: folds 
*** TURN *** [9c 9d 3s] [4h]
phate-1up: checks 
DrunkTyphoon: checks 
*** RIVER *** [9c 9d 3s 4h] [7h]
phate-1up: checks 
DrunkTyphoon: bets $4.46
phate-1up: folds 
Uncalled bet ($4.46) returned to DrunkTyphoon
DrunkTyphoon collected $8.93 from pot
DrunkTyphoon: doesn't show hand 
*** SUMMARY ***
Total pot $9.35 | Rake $0.42 
Board [9c 9d 3s 4h 7h]
Seat 1: Cripple86 (button) folded on the Flop
Seat 2: INSP!RON (small blind) folded before Flop
Seat 3: GovGus (big blind) folded on the Flop
Seat 4: phate-1up folded on the River
Seat 5: DrunkTyphoon collected ($8.93)
Seat 6: masterkoolb folded before Flop (didn't bet)
Seat 7: kwkim73 folded on the Flop
Seat 8: ShockLaMuc folded before Flop (didn't bet)
Seat 9: chiyuki folded before Flop (didn't bet)



PokerStars Zoom Hand #84301057989:  Hold'em No Limit ($0.10/$0.25) - 2012/08/05 16:09:33 JST [2012/08/05 3:09:33 ET]
Table 'Whirlpool' 9-max Seat #1 is the button
Seat 1: INSP!RON ($30.72 in chips) 
Seat 2: yoube ($71.01 in chips) 
Seat 3: snejokCoxx ($11.50 in chips) 
Seat 4: leo2095 ($24.86 in chips) 
Seat 5: Lasutchik ($28.66 in chips) 
Seat 6: teaser07 ($25.35 in chips) 
Seat 7: chiyuki ($30.94 in chips) 
Seat 8: silvno31 ($65.44 in chips) 
Seat 9: Loholov ($15 in chips) 
yoube: posts small blind $0.10
snejokCoxx: posts big blind $0.25
*** HOLE CARDS ***
Dealt to chiyuki [Jc Kc]
leo2095: folds 
Lasutchik: folds 
teaser07: folds 
chiyuki: folds 
silvno31: folds 
Loholov: folds 
INSP!RON: raises $0.35 to $0.60
yoube: folds 
snejokCoxx: folds 
Uncalled bet ($0.35) returned to INSP!RON
INSP!RON collected $0.60 from pot
INSP!RON: doesn't show hand 
*** SUMMARY ***
Total pot $0.60 | Rake $0 
Seat 1: INSP!RON (button) collected ($0.60)
Seat 2: yoube (small blind) folded before Flop
Seat 3: snejokCoxx (big blind) folded before Flop
Seat 4: leo2095 folded before Flop (didn't bet)
Seat 5: Lasutchik folded before Flop (didn't bet)
Seat 6: teaser07 folded before Flop (didn't bet)
Seat 7: chiyuki folded before Flop (didn't bet)
Seat 8: silvno31 folded before Flop (didn't bet)
Seat 9: Loholov folded before Flop (didn't bet)



PokerStars Zoom Hand #84301059030:  Hold'em No Limit ($0.10/$0.25) - 2012/08/05 16:09:37 JST [2012/08/05 3:09:37 ET]
Table 'Whirlpool' 9-max Seat #1 is the button
Seat 1: silvno31 ($65.44 in chips) 
Seat 2: PAMBOS.L ($14.15 in chips) 
Seat 3: Limoilou ($27.13 in chips) 
Seat 4: phate-1up ($36.57 in chips) 
Seat 5: chiyuki ($30.94 in chips) 
Seat 6: CrittHunter ($20.91 in chips) 
Seat 7: nice.franki ($10 in chips) 
Seat 8: Serge Claws ($25 in chips) 
Seat 9: ShockLaMuc ($21.18 in chips) 
PAMBOS.L: posts small blind $0.10
Limoilou: posts big blind $0.25
*** HOLE CARDS ***
Dealt to chiyuki [9s 4s]
phate-1up: raises $0.50 to $0.75
chiyuki: folds 
CrittHunter: folds 
nice.franki: folds 
Serge Claws: folds 
ShockLaMuc: folds 
silvno31: folds 
PAMBOS.L: folds 
Limoilou: folds 
Uncalled bet ($0.50) returned to phate-1up
phate-1up collected $0.60 from pot
phate-1up: doesn't show hand 
*** SUMMARY ***
Total pot $0.60 | Rake $0 
Seat 1: silvno31 (button) folded before Flop (didn't bet)
Seat 2: PAMBOS.L (small blind) folded before Flop
Seat 3: Limoilou (big blind) folded before Flop
Seat 4: phate-1up collected ($0.60)
Seat 5: chiyuki folded before Flop (didn't bet)
Seat 6: CrittHunter folded before Flop (didn't bet)
Seat 7: nice.franki folded before Flop (didn't bet)
Seat 8: Serge Claws folded before Flop (didn't bet)
Seat 9: ShockLaMuc folded before Flop (didn't bet)



PokerStars Zoom Hand #84301060145:  Hold'em No Limit ($0.10/$0.25) - 2012/08/05 16:09:41 JST [2012/08/05 3:09:41 ET]
Table 'Whirlpool' 9-max Seat #1 is the button
Seat 1: kwkim73 ($30.69 in chips) 
Seat 2: chiyuki ($30.94 in chips) 
Seat 3: ShockLaMuc ($21.18 in chips) 
Seat 4: DanielWhyte ($32.32 in chips) 
Seat 5: teaser07 ($25.35 in chips) 
Seat 6: kesstukas25 ($30.52 in chips) 
Seat 7: AAAKK777 ($20.78 in chips) 
Seat 8: roksmokndonk ($20.90 in chips) 
Seat 9: seula i ($36.58 in chips) 
chiyuki: posts small blind $0.10
ShockLaMuc: posts big blind $0.25
*** HOLE CARDS ***
Dealt to chiyuki [9s As]
DanielWhyte: calls $0.25
teaser07: folds 
kesstukas25: raises $0.75 to $1
AAAKK777: folds 
roksmokndonk: folds 
seula i: folds 
kwkim73: folds 
chiyuki: folds 
ShockLaMuc: folds 
DanielWhyte: calls $0.75
*** FLOP *** [Kc 7h 2h]
DanielWhyte: checks 
kesstukas25: bets $1.50
DanielWhyte: folds 
Uncalled bet ($1.50) returned to kesstukas25
kesstukas25 collected $2.24 from pot
kesstukas25: doesn't show hand 
*** SUMMARY ***
Total pot $2.35 | Rake $0.11 
Board [Kc 7h 2h]
Seat 1: kwkim73 (button) folded before Flop (didn't bet)
Seat 2: chiyuki (small blind) folded before Flop
Seat 3: ShockLaMuc (big blind) folded before Flop
Seat 4: DanielWhyte folded on the Flop
Seat 5: teaser07 folded before Flop (didn't bet)
Seat 6: kesstukas25 collected ($2.24)
Seat 7: AAAKK777 folded before Flop (didn't bet)
Seat 8: roksmokndonk folded before Flop (didn't bet)
Seat 9: seula i folded before Flop (didn't bet)



PokerStars Zoom Hand #84301065063:  Hold'em No Limit ($0.10/$0.25) - 2012/08/05 16:09:59 JST [2012/08/05 3:09:59 ET]
Table 'Whirlpool' 9-max Seat #1 is the button
Seat 1: seula i ($71.21 in chips) 
Seat 2: fwnaf ($20.68 in chips) 
Seat 3: Roglus ($6.51 in chips) 
Seat 4: chiyuki ($30.84 in chips) 
Seat 5: Kasperlmusik ($32.89 in chips) 
Seat 6: kwkim73 ($35.48 in chips) 
Seat 7: Alvinpe85 ($29.24 in chips) 
Seat 8: Femali54 ($27.12 in chips) 
Seat 9: wildy29 ($96.75 in chips) 
fwnaf: posts small blind $0.10
Roglus: posts big blind $0.25
*** HOLE CARDS ***
Dealt to chiyuki [Qd 5c]
chiyuki: folds 
Kasperlmusik: folds 
kwkim73: folds 
Alvinpe85: folds 
Femali54: folds 
wildy29: calls $0.25
seula i: folds 
fwnaf: folds 
Roglus: raises $0.75 to $1
wildy29: folds 
Uncalled bet ($0.75) returned to Roglus
Roglus collected $0.60 from pot
Roglus: doesn't show hand 
*** SUMMARY ***
Total pot $0.60 | Rake $0 
Seat 1: seula i (button) folded before Flop (didn't bet)
Seat 2: fwnaf (small blind) folded before Flop
Seat 3: Roglus (big blind) collected ($0.60)
Seat 4: chiyuki folded before Flop (didn't bet)
Seat 5: Kasperlmusik folded before Flop (didn't bet)
Seat 6: kwkim73 folded before Flop (didn't bet)
Seat 7: Alvinpe85 folded before Flop (didn't bet)
Seat 8: Femali54 folded before Flop (didn't bet)
Seat 9: wildy29 folded before Flop



PokerStars Zoom Hand #84301064227:  Hold'em No Limit ($0.10/$0.25) - 2012/08/05 16:09:56 JST [2012/08/05 3:09:56 ET]
Table 'Whirlpool' 9-max Seat #1 is the button
Seat 1: Vall179 ($30.44 in chips) 
Seat 2: xxASSO124xx ($8.36 in chips) 
Seat 3: teaser07 ($25.35 in chips) 
Seat 4: chiyuki ($30.84 in chips) 
Seat 5: 1Karina1 ($35.66 in chips) 
Seat 6: seula i ($36.58 in chips) 
Seat 7: poorpoor6551 ($16.16 in chips) 
Seat 8: kwkim73 ($30.59 in chips) 
Seat 9: PAMBOS.L ($14.05 in chips) 
xxASSO124xx: posts small blind $0.10
teaser07: posts big blind $0.25
*** HOLE CARDS ***
Dealt to chiyuki [8d 3s]
chiyuki: folds 
1Karina1: folds 
seula i: folds 
poorpoor6551: folds 
kwkim73: folds 
PAMBOS.L: raises $0.35 to $0.60
Vall179: folds 
xxASSO124xx: folds 
teaser07: folds 
Uncalled bet ($0.35) returned to PAMBOS.L
PAMBOS.L collected $0.60 from pot
PAMBOS.L: doesn't show hand 
*** SUMMARY ***
Total pot $0.60 | Rake $0 
Seat 1: Vall179 (button) folded before Flop (didn't bet)
Seat 2: xxASSO124xx (small blind) folded before Flop
Seat 3: teaser07 (big blind) folded before Flop
Seat 4: chiyuki folded before Flop (didn't bet)
Seat 5: 1Karina1 folded before Flop (didn't bet)
Seat 6: seula i folded before Flop (didn't bet)
Seat 7: poorpoor6551 folded before Flop (didn't bet)
Seat 8: kwkim73 folded before Flop (didn't bet)
Seat 9: PAMBOS.L collected ($0.60)



PokerStars Zoom Hand #84301067734:  Hold'em No Limit ($0.10/$0.25) - 2012/08/05 16:10:09 JST [2012/08/05 3:10:09 ET]
Table 'Whirlpool' 9-max Seat #1 is the button
Seat 1: Kasperlmusik ($32.64 in chips) 
Seat 2: GSDP ($25.94 in chips) 
Seat 3: chiyuki ($30.84 in chips) 
Seat 4: roksmokndonk ($20.90 in chips) 
Seat 5: Limoilou ($26.88 in chips) 
Seat 6: ShockLaMuc ($20.83 in chips) 
Seat 7: hldtom ($19.31 in chips) 
Seat 8: Nerkit ($13.42 in chips) 
Seat 9: Trip_Krowns ($28.87 in chips) 
GSDP: posts small blind $0.10
chiyuki: posts big blind $0.25
*** HOLE CARDS ***
Dealt to chiyuki [8h 6d]
roksmokndonk: folds 
Limoilou: folds 
ShockLaMuc: folds 
hldtom: folds 
Nerkit: folds 
Trip_Krowns: folds 
Kasperlmusik: folds 
GSDP: raises $0.50 to $0.75
chiyuki: folds 
Uncalled bet ($0.50) returned to GSDP
GSDP collected $0.50 from pot
GSDP: doesn't show hand 
*** SUMMARY ***
Total pot $0.50 | Rake $0 
Seat 1: Kasperlmusik (button) folded before Flop (didn't bet)
Seat 2: GSDP (small blind) collected ($0.50)
Seat 3: chiyuki (big blind) folded before Flop
Seat 4: roksmokndonk folded before Flop (didn't bet)
Seat 5: Limoilou folded before Flop (didn't bet)
Seat 6: ShockLaMuc folded before Flop (didn't bet)
Seat 7: hldtom folded before Flop (didn't bet)
Seat 8: Nerkit folded before Flop (didn't bet)
Seat 9: Trip_Krowns folded before Flop (didn't bet)



PokerStars Zoom Hand #84301073222:  Hold'em No Limit ($0.10/$0.25) - 2012/08/05 16:10:30 JST [2012/08/05 3:10:30 ET]
Table 'Whirlpool' 9-max Seat #1 is the button
Seat 1: Serge Claws ($25 in chips) 
Seat 2: chiyuki ($30.59 in chips) 
Seat 3: Grumpy as 2 ($14.10 in chips) 
Seat 4: kwkim73 ($35.38 in chips) 
Seat 5: Femali54 ($26.77 in chips) 
Seat 6: 1Karina1 ($35.56 in chips) 
Seat 7: Fructionar ($45.61 in chips) 
Seat 8: GovGus ($28.87 in chips) 
Seat 9: 4plankton ($7.63 in chips) 
chiyuki: posts small blind $0.10
Grumpy as 2: posts big blind $0.25
*** HOLE CARDS ***
Dealt to chiyuki [6h 6s]
kwkim73: folds 
Femali54: raises $0.50 to $0.75
1Karina1: folds 
Fructionar: folds 
GovGus: folds 
4plankton: folds 
Serge Claws: folds 
chiyuki: folds 
Grumpy as 2: folds 
Uncalled bet ($0.50) returned to Femali54
Femali54 collected $0.60 from pot
Femali54: doesn't show hand 
*** SUMMARY ***
Total pot $0.60 | Rake $0 
Seat 1: Serge Claws (button) folded before Flop (didn't bet)
Seat 2: chiyuki (small blind) folded before Flop
Seat 3: Grumpy as 2 (big blind) folded before Flop
Seat 4: kwkim73 folded before Flop (didn't bet)
Seat 5: Femali54 collected ($0.60)
Seat 6: 1Karina1 folded before Flop (didn't bet)
Seat 7: Fructionar folded before Flop (didn't bet)
Seat 8: GovGus folded before Flop (didn't bet)
Seat 9: 4plankton folded before Flop (didn't bet)



PokerStars Zoom Hand #84301072061:  Hold'em No Limit ($0.10/$0.25) - 2012/08/05 16:10:26 JST [2012/08/05 3:10:26 ET]
Table 'Whirlpool' 9-max Seat #1 is the button
Seat 1: Femali54 ($26.77 in chips) 
Seat 2: Serge Claws ($25 in chips) 
Seat 3: Grishukps ($12.75 in chips) 
Seat 4: Loholov ($15 in chips) 
Seat 5: INSP!RON ($34.21 in chips) 
Seat 6: GSDP ($26.19 in chips) 
Seat 7: Lindikor ($18.53 in chips) 
Seat 8: Vall179 ($22.98 in chips) 
Seat 9: chiyuki ($30.59 in chips) 
Serge Claws: posts small blind $0.10
Grishukps: posts big blind $0.25
*** HOLE CARDS ***
Dealt to chiyuki [Ks 9d]
Loholov: folds 
INSP!RON: folds 
GSDP: folds 
Lindikor: raises $1 to $1.25
Vall179: folds 
chiyuki: folds 
Femali54: folds 
Serge Claws: folds 
Grishukps: folds 
Uncalled bet ($1) returned to Lindikor
Lindikor collected $0.60 from pot
Lindikor: doesn't show hand 
*** SUMMARY ***
Total pot $0.60 | Rake $0 
Seat 1: Femali54 (button) folded before Flop (didn't bet)
Seat 2: Serge Claws (small blind) folded before Flop
Seat 3: Grishukps (big blind) folded before Flop
Seat 4: Loholov folded before Flop (didn't bet)
Seat 5: INSP!RON folded before Flop (didn't bet)
Seat 6: GSDP folded before Flop (didn't bet)
Seat 7: Lindikor collected ($0.60)
Seat 8: Vall179 folded before Flop (didn't bet)
Seat 9: chiyuki folded before Flop (didn't bet)



PokerStars Zoom Hand #84301066388:  Hold'em No Limit ($0.10/$0.25) - 2012/08/05 16:10:04 JST [2012/08/05 3:10:04 ET]
Table 'Whirlpool' 9-max Seat #1 is the button
Seat 1: chiyuki ($30.84 in chips) 
Seat 2: GovGus ($28.62 in chips) 
Seat 3: slapshot2011 ($37.60 in chips) 
Seat 4: Angi858 ($21.03 in chips) 
Seat 5: Faantomace ($35.82 in chips) 
Seat 6: 1Karina1 ($62.05 in chips) 
Seat 7: Loholov ($16.15 in chips) 
Seat 8: Serge Claws ($71.76 in chips) 
Seat 9: Lasutchik ($12.15 in chips) 
GovGus: posts small blind $0.10
slapshot2011: posts big blind $0.25
*** HOLE CARDS ***
Dealt to chiyuki [2h Kd]
Angi858: folds 
Faantomace: raises $0.50 to $0.75
1Karina1: folds 
Loholov: folds 
Serge Claws: folds 
Lasutchik: folds 
chiyuki: folds 
GovGus: folds 
slapshot2011: calls $0.50
*** FLOP *** [8s Jh Ks]
slapshot2011: checks 
Faantomace: bets $1.25
slapshot2011: calls $1.25
*** TURN *** [8s Jh Ks] [4d]
slapshot2011: checks 
Faantomace: checks 
*** RIVER *** [8s Jh Ks 4d] [8d]
slapshot2011: checks 
Faantomace: checks 
*** SHOW DOWN ***
slapshot2011: shows [9s Td] (a pair of Eights)
Faantomace: shows [Js 9c] (two pair, Jacks and Eights)
Faantomace collected $3.92 from pot
*** SUMMARY ***
Total pot $4.10 | Rake $0.18 
Board [8s Jh Ks 4d 8d]
Seat 1: chiyuki (button) folded before Flop (didn't bet)
Seat 2: GovGus (small blind) folded before Flop
Seat 3: slapshot2011 (big blind) showed [9s Td] and lost with a pair of Eights
Seat 4: Angi858 folded before Flop (didn't bet)
Seat 5: Faantomace showed [Js 9c] and won ($3.92) with two pair, Jacks and Eights
Seat 6: 1Karina1 folded before Flop (didn't bet)
Seat 7: Loholov folded before Flop (didn't bet)
Seat 8: Serge Claws folded before Flop (didn't bet)
Seat 9: Lasutchik folded before Flop (didn't bet)



PokerStars Zoom Hand #84301076208:  Hold'em No Limit ($0.10/$0.25) - 2012/08/05 16:10:41 JST [2012/08/05 3:10:41 ET]
Table 'Whirlpool' 9-max Seat #1 is the button
Seat 1: Perstenev ($14.20 in chips) 
Seat 2: PAMBOS.L ($14.40 in chips) 
Seat 3: Kasperlmusik ($32.54 in chips) 
Seat 4: xxx Spb xxx ($29.81 in chips) 
Seat 5: Grumpy as 2 ($13.85 in chips) 
Seat 6: Lasutchik ($33.64 in chips) 
Seat 7: nice.franki ($17.14 in chips) 
Seat 8: chiyuki ($30.49 in chips) 
Seat 9: munky3 ($26.63 in chips) 
PAMBOS.L: posts small blind $0.10
Kasperlmusik: posts big blind $0.25
*** HOLE CARDS ***
Dealt to chiyuki [Ts Qs]
xxx Spb xxx: folds 
Grumpy as 2: folds 
Lasutchik: raises $0.37 to $0.62
nice.franki: folds 
chiyuki: folds 
munky3: folds 
Perstenev: folds 
PAMBOS.L: folds 
Kasperlmusik: folds 
Uncalled bet ($0.37) returned to Lasutchik
Lasutchik collected $0.60 from pot
Lasutchik: doesn't show hand 
*** SUMMARY ***
Total pot $0.60 | Rake $0 
Seat 1: Perstenev (button) folded before Flop (didn't bet)
Seat 2: PAMBOS.L (small blind) folded before Flop
Seat 3: Kasperlmusik (big blind) folded before Flop
Seat 4: xxx Spb xxx folded before Flop (didn't bet)
Seat 5: Grumpy as 2 folded before Flop (didn't bet)
Seat 6: Lasutchik collected ($0.60)
Seat 7: nice.franki folded before Flop (didn't bet)
Seat 8: chiyuki folded before Flop (didn't bet)
Seat 9: munky3 folded before Flop (didn't bet)



PokerStars Zoom Hand #84301079154:  Hold'em No Limit ($0.10/$0.25) - 2012/08/05 16:10:52 JST [2012/08/05 3:10:52 ET]
Table 'Whirlpool' 9-max Seat #1 is the button
Seat 1: Bahia gyn ($19.56 in chips) 
Seat 2: Kozyavkin ($8.31 in chips) 
Seat 3: teaser07 ($25 in chips) 
Seat 4: Kasperlmusik ($32.29 in chips) 
Seat 5: silvno31 ($63.09 in chips) 
Seat 6: seula i ($60.40 in chips) 
Seat 7: chiyuki ($30.49 in chips) 
Seat 8: Grumpy as 2 ($13.85 in chips) 
Seat 9: roksmokndonk ($20.65 in chips) 
Kozyavkin: posts small blind $0.10
teaser07: posts big blind $0.25
*** HOLE CARDS ***
Dealt to chiyuki [Qs 5c]
Kasperlmusik: folds 
silvno31: folds 
seula i: folds 
chiyuki: folds 
Grumpy as 2: folds 
roksmokndonk: folds 
Bahia gyn: folds 
Kozyavkin: folds 
Uncalled bet ($0.15) returned to teaser07
teaser07 collected $0.20 from pot
teaser07: doesn't show hand 
*** SUMMARY ***
Total pot $0.20 | Rake $0 
Seat 1: Bahia gyn (button) folded before Flop (didn't bet)
Seat 2: Kozyavkin (small blind) folded before Flop
Seat 3: teaser07 (big blind) collected ($0.20)
Seat 4: Kasperlmusik folded before Flop (didn't bet)
Seat 5: silvno31 folded before Flop (didn't bet)
Seat 6: seula i folded before Flop (didn't bet)
Seat 7: chiyuki folded before Flop (didn't bet)
Seat 8: Grumpy as 2 folded before Flop (didn't bet)
Seat 9: roksmokndonk folded before Flop (didn't bet)



PokerStars Zoom Hand #84301081873:  Hold'em No Limit ($0.10/$0.25) - 2012/08/05 16:11:02 JST [2012/08/05 3:11:02 ET]
Table 'Whirlpool' 9-max Seat #1 is the button
Seat 1: Dejacob ($25 in chips) 
Seat 2: INSP!RON ($34.56 in chips) 
Seat 3: Lasutchik ($33.99 in chips) 
Seat 4: TorTrade ($28.42 in chips) 
Seat 5: chiyuki ($30.49 in chips) 
Seat 6: DrunkTyphoon ($36.64 in chips) 
Seat 7: hldtom ($64.71 in chips) 
Seat 8: fwnaf ($20.43 in chips) 
Seat 9: xxASSO124xx ($8.01 in chips) 
INSP!RON: posts small blind $0.10
Lasutchik: posts big blind $0.25
*** HOLE CARDS ***
Dealt to chiyuki [2d Jh]
TorTrade: folds 
chiyuki: folds 
DrunkTyphoon: folds 
hldtom: folds 
fwnaf: raises $0.75 to $1
xxASSO124xx: folds 
Dejacob: folds 
INSP!RON: folds 
Lasutchik: folds 
Uncalled bet ($0.75) returned to fwnaf
fwnaf collected $0.60 from pot
fwnaf: doesn't show hand 
*** SUMMARY ***
Total pot $0.60 | Rake $0 
Seat 1: Dejacob (button) folded before Flop (didn't bet)
Seat 2: INSP!RON (small blind) folded before Flop
Seat 3: Lasutchik (big blind) folded before Flop
Seat 4: TorTrade folded before Flop (didn't bet)
Seat 5: chiyuki folded before Flop (didn't bet)
Seat 6: DrunkTyphoon folded before Flop (didn't bet)
Seat 7: hldtom folded before Flop (didn't bet)
Seat 8: fwnaf collected ($0.60)
Seat 9: xxASSO124xx folded before Flop (didn't bet)



PokerStars Zoom Hand #84301080245:  Hold'em No Limit ($0.10/$0.25) - 2012/08/05 16:10:56 JST [2012/08/05 3:10:56 ET]
Table 'Whirlpool' 9-max Seat #1 is the button
Seat 1: loszavera ($25 in chips) 
Seat 2: roksmokndonk ($20.65 in chips) 
Seat 3: Perstenev ($5.38 in chips) 
Seat 4: Loholov ($15 in chips) 
Seat 5: xxx Spb xxx ($27.58 in chips) 
Seat 6: chiyuki ($30.49 in chips) 
Seat 7: RRMM_again ($24.59 in chips) 
Seat 8: PAMBOS.L ($14.30 in chips) 
Seat 9: Alvinpe85 ($28.99 in chips) 
roksmokndonk: posts small blind $0.10
Perstenev: posts big blind $0.25
*** HOLE CARDS ***
Dealt to chiyuki [6h 9h]
Loholov: folds 
xxx Spb xxx: folds 
chiyuki: folds 
RRMM_again: folds 
PAMBOS.L: raises $0.35 to $0.60
Alvinpe85: calls $0.60
loszavera: folds 
roksmokndonk: calls $0.50
Perstenev: folds 
*** FLOP *** [Tc 5h 7c]
roksmokndonk: checks 
PAMBOS.L: checks 
Alvinpe85: checks 
*** TURN *** [Tc 5h 7c] [9s]
roksmokndonk: checks 
PAMBOS.L: bets $1.47
Alvinpe85: folds 
roksmokndonk: folds 
Uncalled bet ($1.47) returned to PAMBOS.L
PAMBOS.L collected $1.96 from pot
PAMBOS.L: doesn't show hand 
*** SUMMARY ***
Total pot $2.05 | Rake $0.09 
Board [Tc 5h 7c 9s]
Seat 1: loszavera (button) folded before Flop (didn't bet)
Seat 2: roksmokndonk (small blind) folded on the Turn
Seat 3: Perstenev (big blind) folded before Flop
Seat 4: Loholov folded before Flop (didn't bet)
Seat 5: xxx Spb xxx folded before Flop (didn't bet)
Seat 6: chiyuki folded before Flop (didn't bet)
Seat 7: RRMM_again folded before Flop (didn't bet)
Seat 8: PAMBOS.L collected ($1.96)
Seat 9: Alvinpe85 folded on the Turn



PokerStars Zoom Hand #84301082697:  Hold'em No Limit ($0.10/$0.25) - 2012/08/05 16:11:05 JST [2012/08/05 3:11:05 ET]
Table 'Whirlpool' 9-max Seat #1 is the button
Seat 1: poorpoor6551 ($16.36 in chips) 
Seat 2: RRMM_again ($24.59 in chips) 
Seat 3: INSP!RON ($34.46 in chips) 
Seat 4: seula i ($70.96 in chips) 
Seat 5: teaser07 ($25.10 in chips) 
Seat 6: chiyuki ($30.49 in chips) 
Seat 7: kwkim73 ($31.74 in chips) 
Seat 8: Spheroff ($13.80 in chips) 
Seat 9: phate-1up ($60.13 in chips) 
RRMM_again: posts small blind $0.10
INSP!RON: posts big blind $0.25
*** HOLE CARDS ***
Dealt to chiyuki [3h 7c]
seula i: folds 
teaser07: folds 
chiyuki: folds 
kwkim73: folds 
Spheroff: folds 
phate-1up: folds 
poorpoor6551: calls $0.25
RRMM_again: calls $0.15
INSP!RON: checks 
*** FLOP *** [8c Qc 5s]
RRMM_again: checks 
INSP!RON: checks 
poorpoor6551: bets $0.50
RRMM_again: calls $0.50
INSP!RON: folds 
*** TURN *** [8c Qc 5s] [Kh]
RRMM_again: checks 
poorpoor6551: checks 
*** RIVER *** [8c Qc 5s Kh] [8s]
RRMM_again: bets $1
poorpoor6551: folds 
Uncalled bet ($1) returned to RRMM_again
RRMM_again collected $1.67 from pot
RRMM_again: doesn't show hand 
*** SUMMARY ***
Total pot $1.75 | Rake $0.08 
Board [8c Qc 5s Kh 8s]
Seat 1: poorpoor6551 (button) folded on the River
Seat 2: RRMM_again (small blind) collected ($1.67)
Seat 3: INSP!RON (big blind) folded on the Flop
Seat 4: seula i folded before Flop (didn't bet)
Seat 5: teaser07 folded before Flop (didn't bet)
Seat 6: chiyuki folded before Flop (didn't bet)
Seat 7: kwkim73 folded before Flop (didn't bet)
Seat 8: Spheroff folded before Flop (didn't bet)
Seat 9: phate-1up folded before Flop (didn't bet)



PokerStars Zoom Hand #84301090035:  Hold'em No Limit ($0.10/$0.25) - 2012/08/05 16:11:32 JST [2012/08/05 3:11:32 ET]
Table 'Whirlpool' 9-max Seat #1 is the button
Seat 1: Cripple86 ($27.88 in chips) 
Seat 2: DrunkTyphoon ($47.10 in chips) 
Seat 3: .7.DanDan.7. ($16.29 in chips) 
Seat 4: chiyuki ($30.49 in chips) 
Seat 5: phate-1up ($60.03 in chips) 
Seat 6: teaser07 ($25 in chips) 
Seat 7: Perstenev ($5.13 in chips) 
Seat 8: Serge Claws ($73.56 in chips) 
Seat 9: deepakmbh ($26.26 in chips) 
DrunkTyphoon: posts small blind $0.10
.7.DanDan.7.: posts big blind $0.25
*** HOLE CARDS ***
Dealt to chiyuki [Ks 2h]
chiyuki: folds 
phate-1up: folds 
teaser07: folds 
Perstenev: folds 
Serge Claws: folds 
deepakmbh: folds 
Cripple86: raises $0.50 to $0.75
DrunkTyphoon: folds 
.7.DanDan.7.: folds 
Uncalled bet ($0.50) returned to Cripple86
Cripple86 collected $0.60 from pot
Cripple86: doesn't show hand 
*** SUMMARY ***
Total pot $0.60 | Rake $0 
Seat 1: Cripple86 (button) collected ($0.60)
Seat 2: DrunkTyphoon (small blind) folded before Flop
Seat 3: .7.DanDan.7. (big blind) folded before Flop
Seat 4: chiyuki folded before Flop (didn't bet)
Seat 5: phate-1up folded before Flop (didn't bet)
Seat 6: teaser07 folded before Flop (didn't bet)
Seat 7: Perstenev folded before Flop (didn't bet)
Seat 8: Serge Claws folded before Flop (didn't bet)
Seat 9: deepakmbh folded before Flop (didn't bet)



PokerStars Zoom Hand #84301084875:  Hold'em No Limit ($0.10/$0.25) - 2012/08/05 16:11:13 JST [2012/08/05 3:11:13 ET]
Table 'Whirlpool' 9-max Seat #1 is the button
Seat 1: chiyuki ($30.49 in chips) 
Seat 2: Rici47 ($53.02 in chips) 
Seat 3: Limoilou ($27.13 in chips) 
Seat 4: Angi858 ($20.68 in chips) 
Seat 5: phate-1up ($84.51 in chips) 
Seat 6: hldtom ($64.71 in chips) 
Seat 7: GovGus ($46.74 in chips) 
Seat 8: Dejacob ($25 in chips) 
Seat 9: Ellen1947 ($28.66 in chips) 
Rici47: posts small blind $0.10
Limoilou: posts big blind $0.25
*** HOLE CARDS ***
Dealt to chiyuki [Ad Ts]
Angi858: folds 
phate-1up: folds 
hldtom: folds 
GovGus: folds 
Dejacob: raises $0.50 to $0.75
Ellen1947: folds 
chiyuki: folds 
Rici47: raises $2 to $2.75
Limoilou: folds 
Dejacob: calls $2
*** FLOP *** [4c 3h 6s]
Rici47: bets $2.50
Dejacob: calls $2.50
*** TURN *** [4c 3h 6s] [6c]
Rici47: checks 
Dejacob: bets $6
Rici47: folds 
Uncalled bet ($6) returned to Dejacob
Dejacob collected $10.27 from pot
Dejacob: doesn't show hand 
*** SUMMARY ***
Total pot $10.75 | Rake $0.48 
Board [4c 3h 6s 6c]
Seat 1: chiyuki (button) folded before Flop (didn't bet)
Seat 2: Rici47 (small blind) folded on the Turn
Seat 3: Limoilou (big blind) folded before Flop
Seat 4: Angi858 folded before Flop (didn't bet)
Seat 5: phate-1up folded before Flop (didn't bet)
Seat 6: hldtom folded before Flop (didn't bet)
Seat 7: GovGus folded before Flop (didn't bet)
Seat 8: Dejacob collected ($10.27)
Seat 9: Ellen1947 folded before Flop (didn't bet)



PokerStars Zoom Hand #84301091354:  Hold'em No Limit ($0.10/$0.25) - 2012/08/05 16:11:38 JST [2012/08/05 3:11:38 ET]
Table 'Whirlpool' 9-max Seat #1 is the button
Seat 1: seula i ($70.86 in chips) 
Seat 2: 1Karina1 ($64 in chips) 
Seat 3: chiyuki ($30.49 in chips) 
Seat 4: Dejacob ($29.20 in chips) 
Seat 5: nice.franki ($12.50 in chips) 
Seat 6: deepakmbh ($26.26 in chips) 
Seat 7: INSP!RON ($34.21 in chips) 
Seat 8: Ellen1947 ($28.56 in chips) 
Seat 9: Limoilou ($26.88 in chips) 
1Karina1: posts small blind $0.10
chiyuki: posts big blind $0.25
*** HOLE CARDS ***
Dealt to chiyuki [8c Kc]
Dejacob: folds 
nice.franki: folds 
deepakmbh: folds 
INSP!RON: folds 
Ellen1947: raises $0.50 to $0.75
Limoilou: calls $0.75
seula i: folds 
1Karina1: folds 
chiyuki: folds 
*** FLOP *** [5d 4s Ah]
Ellen1947: checks 
Limoilou: checks 
*** TURN *** [5d 4s Ah] [Jc]
Ellen1947: bets $0.88
Limoilou: folds 
Uncalled bet ($0.88) returned to Ellen1947
Ellen1947 collected $1.77 from pot
Ellen1947: doesn't show hand 
*** SUMMARY ***
Total pot $1.85 | Rake $0.08 
Board [5d 4s Ah Jc]
Seat 1: seula i (button) folded before Flop (didn't bet)
Seat 2: 1Karina1 (small blind) folded before Flop
Seat 3: chiyuki (big blind) folded before Flop
Seat 4: Dejacob folded before Flop (didn't bet)
Seat 5: nice.franki folded before Flop (didn't bet)
Seat 6: deepakmbh folded before Flop (didn't bet)
Seat 7: INSP!RON folded before Flop (didn't bet)
Seat 8: Ellen1947 collected ($1.77)
Seat 9: Limoilou folded on the Turn



PokerStars Zoom Hand #84301097623:  Hold'em No Limit ($0.10/$0.25) - 2012/08/05 16:12:01 JST [2012/08/05 3:12:01 ET]
Table 'Whirlpool' 9-max Seat #1 is the button
Seat 1: laurentzu84 ($30.74 in chips) 
Seat 2: INSP!RON ($34.56 in chips) 
Seat 3: olligol123 ($25 in chips) 
Seat 4: drunk_bender ($27.98 in chips) 
Seat 5: Vall179 ($29.94 in chips) 
Seat 6: 4ydo yogurt ($62.21 in chips) 
Seat 7: snejokCoxx ($13.43 in chips) 
Seat 8: Nerkit ($13.07 in chips) 
Seat 9: chiyuki ($30.24 in chips) 
INSP!RON: posts small blind $0.10
olligol123: posts big blind $0.25
*** HOLE CARDS ***
Dealt to chiyuki [Tc Qs]
drunk_bender: raises $0.50 to $0.75
Vall179: folds 
4ydo yogurt: folds 
snejokCoxx: folds 
Nerkit: folds 
chiyuki: folds 
laurentzu84: folds 
INSP!RON: folds 
olligol123: calls $0.50
*** FLOP *** [3c Kc Qc]
olligol123: checks 
drunk_bender: bets $1
olligol123: folds 
Uncalled bet ($1) returned to drunk_bender
drunk_bender collected $1.53 from pot
drunk_bender: doesn't show hand 
*** SUMMARY ***
Total pot $1.60 | Rake $0.07 
Board [3c Kc Qc]
Seat 1: laurentzu84 (button) folded before Flop (didn't bet)
Seat 2: INSP!RON (small blind) folded before Flop
Seat 3: olligol123 (big blind) folded on the Flop
Seat 4: drunk_bender collected ($1.53)
Seat 5: Vall179 folded before Flop (didn't bet)
Seat 6: 4ydo yogurt folded before Flop (didn't bet)
Seat 7: snejokCoxx folded before Flop (didn't bet)
Seat 8: Nerkit folded before Flop (didn't bet)
Seat 9: chiyuki folded before Flop (didn't bet)



PokerStars Zoom Hand #84301102599:  Hold'em No Limit ($0.10/$0.25) - 2012/08/05 16:12:19 JST [2012/08/05 3:12:19 ET]
Table 'Whirlpool' 9-max Seat #1 is the button
Seat 1: 4ydo yogurt ($62.56 in chips) 
Seat 2: Lindikor ($5.96 in chips) 
Seat 3: mamlind ($15.19 in chips) 
Seat 4: Roglus ($9.03 in chips) 
Seat 5: scaredsare ($26.53 in chips) 
Seat 6: kesstukas25 ($31.76 in chips) 
Seat 7: chiyuki ($30.24 in chips) 
Seat 8: Limoilou ($26.13 in chips) 
Seat 9: 1Karina1 ($36.03 in chips) 
Lindikor: posts small blind $0.10
mamlind: posts big blind $0.25
*** HOLE CARDS ***
Dealt to chiyuki [7c Kh]
Roglus: folds 
scaredsare: folds 
kesstukas25: folds 
chiyuki: folds 
Limoilou: folds 
1Karina1: folds 
4ydo yogurt: folds 
Lindikor: folds 
Uncalled bet ($0.15) returned to mamlind
mamlind collected $0.20 from pot
mamlind: doesn't show hand 
*** SUMMARY ***
Total pot $0.20 | Rake $0 
Seat 1: 4ydo yogurt (button) folded before Flop (didn't bet)
Seat 2: Lindikor (small blind) folded before Flop
Seat 3: mamlind (big blind) collected ($0.20)
Seat 4: Roglus folded before Flop (didn't bet)
Seat 5: scaredsare folded before Flop (didn't bet)
Seat 6: kesstukas25 folded before Flop (didn't bet)
Seat 7: chiyuki folded before Flop (didn't bet)
Seat 8: Limoilou folded before Flop (didn't bet)
Seat 9: 1Karina1 folded before Flop (didn't bet)



PokerStars Zoom Hand #84301100928:  Hold'em No Limit ($0.10/$0.25) - 2012/08/05 16:12:13 JST [2012/08/05 3:12:13 ET]
Table 'Whirlpool' 9-max Seat #1 is the button
Seat 1: seula i ($59.65 in chips) 
Seat 2: kwkim73 ($25 in chips) 
Seat 3: Perstenev ($5.03 in chips) 
Seat 4: DrunkTyphoon ($46.75 in chips) 
Seat 5: opie62 ($26.39 in chips) 
Seat 6: yoube ($72.03 in chips) 
Seat 7: Vall179 ($29.94 in chips) 
Seat 8: chiyuki ($30.24 in chips) 
Seat 9: INSP!RON ($28.17 in chips) 
kwkim73: posts small blind $0.10
Perstenev: posts big blind $0.25
*** HOLE CARDS ***
Dealt to chiyuki [6s 3h]
DrunkTyphoon: folds 
opie62: raises $0.50 to $0.75
yoube: folds 
Vall179: folds 
chiyuki: folds 
INSP!RON: folds 
seula i has timed out
seula i: folds 
kwkim73: folds 
Perstenev: folds 
Uncalled bet ($0.50) returned to opie62
opie62 collected $0.60 from pot
opie62: doesn't show hand 
*** SUMMARY ***
Total pot $0.60 | Rake $0 
Seat 1: seula i (button) folded before Flop (didn't bet)
Seat 2: kwkim73 (small blind) folded before Flop
Seat 3: Perstenev (big blind) folded before Flop
Seat 4: DrunkTyphoon folded before Flop (didn't bet)
Seat 5: opie62 collected ($0.60)
Seat 6: yoube folded before Flop (didn't bet)
Seat 7: Vall179 folded before Flop (didn't bet)
Seat 8: chiyuki folded before Flop (didn't bet)
Seat 9: INSP!RON folded before Flop (didn't bet)



PokerStars Zoom Hand #84301104759:  Hold'em No Limit ($0.10/$0.25) - 2012/08/05 16:12:27 JST [2012/08/05 3:12:27 ET]
Table 'Whirlpool' 9-max Seat #1 is the button
Seat 1: DrunkTyphoon ($46.65 in chips) 
Seat 2: chiyuki ($30.24 in chips) 
Seat 3: top gun 2950 ($41.48 in chips) 
Seat 4: Loholov ($15 in chips) 
Seat 5: nice.franki ($10.42 in chips) 
Seat 6: Limoilou ($26.13 in chips) 
Seat 7: codan23 ($11.66 in chips) 
Seat 8: xxx Spb xxx ($27.93 in chips) 
Seat 9: Dejacob ($29.92 in chips) 
chiyuki: posts small blind $0.10
top gun 2950: posts big blind $0.25
*** HOLE CARDS ***
Dealt to chiyuki [7h Ah]
Loholov: folds 
nice.franki: folds 
Limoilou: raises $0.50 to $0.75
codan23: folds 
xxx Spb xxx: folds 
Dejacob: folds 
DrunkTyphoon: folds 
chiyuki: folds 
top gun 2950: folds 
Uncalled bet ($0.50) returned to Limoilou
Limoilou collected $0.60 from pot
Limoilou: doesn't show hand 
*** SUMMARY ***
Total pot $0.60 | Rake $0 
Seat 1: DrunkTyphoon (button) folded before Flop (didn't bet)
Seat 2: chiyuki (small blind) folded before Flop
Seat 3: top gun 2950 (big blind) folded before Flop
Seat 4: Loholov folded before Flop (didn't bet)
Seat 5: nice.franki folded before Flop (didn't bet)
Seat 6: Limoilou collected ($0.60)
Seat 7: codan23 folded before Flop (didn't bet)
Seat 8: xxx Spb xxx folded before Flop (didn't bet)
Seat 9: Dejacob folded before Flop (didn't bet)



PokerStars Zoom Hand #84301107963:  Hold'em No Limit ($0.10/$0.25) - 2012/08/05 16:12:39 JST [2012/08/05 3:12:39 ET]
Table 'Whirlpool' 9-max Seat #1 is the button
Seat 1: codan23 ($11.66 in chips) 
Seat 2: FoRlan77 ($25 in chips) 
Seat 3: Kasperlmusik ($33.21 in chips) 
Seat 4: GovGus ($54.80 in chips) 
Seat 5: nice.franki ($12.50 in chips) 
Seat 6: xxx Spb xxx ($27.93 in chips) 
Seat 7: kesstukas25 ($12.60 in chips) 
Seat 8: chiyuki ($30.14 in chips) 
Seat 9: 19MJJ21 ($16.54 in chips) 
FoRlan77: posts small blind $0.10
Kasperlmusik: posts big blind $0.25
*** HOLE CARDS ***
Dealt to chiyuki [8h 3c]
GovGus: raises $0.75 to $1
nice.franki: folds 
xxx Spb xxx: folds 
kesstukas25: folds 
chiyuki: folds 
19MJJ21: folds 
codan23: folds 
FoRlan77: folds 
Kasperlmusik: folds 
Uncalled bet ($0.75) returned to GovGus
GovGus collected $0.60 from pot
GovGus: doesn't show hand 
*** SUMMARY ***
Total pot $0.60 | Rake $0 
Seat 1: codan23 (button) folded before Flop (didn't bet)
Seat 2: FoRlan77 (small blind) folded before Flop
Seat 3: Kasperlmusik (big blind) folded before Flop
Seat 4: GovGus collected ($0.60)
Seat 5: nice.franki folded before Flop (didn't bet)
Seat 6: xxx Spb xxx folded before Flop (didn't bet)
Seat 7: kesstukas25 folded before Flop (didn't bet)
Seat 8: chiyuki folded before Flop (didn't bet)
Seat 9: 19MJJ21 folded before Flop (didn't bet)



PokerStars Zoom Hand #84301108796:  Hold'em No Limit ($0.10/$0.25) - 2012/08/05 16:12:42 JST [2012/08/05 3:12:42 ET]
Table 'Whirlpool' 9-max Seat #1 is the button
Seat 1: chiyuki ($30.14 in chips) 
Seat 2: AntoineHunt ($37.46 in chips) 
Seat 3: Vall179 ($24.04 in chips) 
Seat 4: 19MJJ21 ($16.54 in chips) 
Seat 5: RRMM_again ($26.29 in chips) 
Seat 6: Lindikor ($19.23 in chips) 
Seat 7: mjmichi ($25 in chips) 
Seat 8: Grishukps ($18.34 in chips) 
Seat 9: kwkim73 ($37.40 in chips) 
AntoineHunt: posts small blind $0.10
Vall179: posts big blind $0.25
*** HOLE CARDS ***
Dealt to chiyuki [Ah 6d]
19MJJ21: folds 
RRMM_again: folds 
Lindikor: folds 
mjmichi: folds 
Grishukps: folds 
kwkim73: folds 
chiyuki: raises $0.50 to $0.75
AntoineHunt: folds 
Vall179: folds 
Uncalled bet ($0.50) returned to chiyuki
chiyuki collected $0.60 from pot
chiyuki: doesn't show hand 
*** SUMMARY ***
Total pot $0.60 | Rake $0 
Seat 1: chiyuki (button) collected ($0.60)
Seat 2: AntoineHunt (small blind) folded before Flop
Seat 3: Vall179 (big blind) folded before Flop
Seat 4: 19MJJ21 folded before Flop (didn't bet)
Seat 5: RRMM_again folded before Flop (didn't bet)
Seat 6: Lindikor folded before Flop (didn't bet)
Seat 7: mjmichi folded before Flop (didn't bet)
Seat 8: Grishukps folded before Flop (didn't bet)
Seat 9: kwkim73 folded before Flop (didn't bet)



PokerStars Zoom Hand #84301114210:  Hold'em No Limit ($0.10/$0.25) - 2012/08/05 16:13:03 JST [2012/08/05 3:13:03 ET]
Table 'Whirlpool' 9-max Seat #1 is the button
Seat 1: Patient90122 ($26.69 in chips) 
Seat 2: risekuku468 ($28.51 in chips) 
Seat 3: INSP!RON ($32.80 in chips) 
Seat 4: Rici47 ($44.79 in chips) 
Seat 5: ivan130 ($28.16 in chips) 
Seat 6: chiyuki ($30.49 in chips) 
Seat 7: deepakmbh ($29.48 in chips) 
Seat 8: nice.franki ($12.60 in chips) 
Seat 9: Nerkit ($10.90 in chips) 
risekuku468: posts small blind $0.10
INSP!RON: posts big blind $0.25
*** HOLE CARDS ***
Dealt to chiyuki [As Qs]
Rici47: folds 
ivan130: folds 
chiyuki: raises $0.50 to $0.75
deepakmbh: raises $1.75 to $2.50
nice.franki: folds 
Nerkit: folds 
Patient90122: folds 
risekuku468: folds 
INSP!RON: folds 
chiyuki: folds 
Uncalled bet ($1.75) returned to deepakmbh
deepakmbh collected $1.85 from pot
deepakmbh: doesn't show hand 
*** SUMMARY ***
Total pot $1.85 | Rake $0 
Seat 1: Patient90122 (button) folded before Flop (didn't bet)
Seat 2: risekuku468 (small blind) folded before Flop
Seat 3: INSP!RON (big blind) folded before Flop
Seat 4: Rici47 folded before Flop (didn't bet)
Seat 5: ivan130 folded before Flop (didn't bet)
Seat 6: chiyuki folded before Flop
Seat 7: deepakmbh collected ($1.85)
Seat 8: nice.franki folded before Flop (didn't bet)
Seat 9: Nerkit folded before Flop (didn't bet)



PokerStars Zoom Hand #84301125861:  Hold'em No Limit ($0.10/$0.25) - 2012/08/05 16:13:46 JST [2012/08/05 3:13:46 ET]
Table 'Whirlpool' 9-max Seat #1 is the button
Seat 1: Loholov ($15 in chips) 
Seat 2: chiyuki ($29.74 in chips) 
Seat 3: xxx Spb xxx ($31.67 in chips) 
Seat 4: Alvinpe85 ($28.29 in chips) 
Seat 5: AntoineHunt ($36.11 in chips) 
Seat 6: Tonychanman ($22.46 in chips) 
Seat 7: poorpoor6551 ($11.78 in chips) 
Seat 8: nice.franki ($3.56 in chips) 
Seat 9: seula i ($37.38 in chips) 
chiyuki: posts small blind $0.10
xxx Spb xxx: posts big blind $0.25
*** HOLE CARDS ***
Dealt to chiyuki [3s 5c]
Alvinpe85: folds 
AntoineHunt: folds 
Tonychanman: folds 
poorpoor6551: folds 
nice.franki: folds 
seula i: folds 
Loholov: folds 
chiyuki: folds 
Uncalled bet ($0.15) returned to xxx Spb xxx
xxx Spb xxx collected $0.20 from pot
xxx Spb xxx: doesn't show hand 
*** SUMMARY ***
Total pot $0.20 | Rake $0 
Seat 1: Loholov (button) folded before Flop (didn't bet)
Seat 2: chiyuki (small blind) folded before Flop
Seat 3: xxx Spb xxx (big blind) collected ($0.20)
Seat 4: Alvinpe85 folded before Flop (didn't bet)
Seat 5: AntoineHunt folded before Flop (didn't bet)
Seat 6: Tonychanman folded before Flop (didn't bet)
Seat 7: poorpoor6551 folded before Flop (didn't bet)
Seat 8: nice.franki folded before Flop (didn't bet)
Seat 9: seula i folded before Flop (didn't bet)



PokerStars Zoom Hand #84301124795:  Hold'em No Limit ($0.10/$0.25) - 2012/08/05 16:13:42 JST [2012/08/05 3:13:42 ET]
Table 'Whirlpool' 9-max Seat #1 is the button
Seat 1: kwkim73 ($35.16 in chips) 
Seat 2: Blue-GumBum ($15.47 in chips) 
Seat 3: 4ydo yogurt ($58.21 in chips) 
Seat 4: xxx Spb xxx ($31.67 in chips) 
Seat 5: chiyuki ($29.74 in chips) 
Seat 6: Grumpy as 2 ($12.48 in chips) 
Seat 7: nice.franki ($3.56 in chips) 
Seat 8: Vall179 ($30.19 in chips) 
Seat 9: wildy29 ($98.82 in chips) 
Blue-GumBum: posts small blind $0.10
4ydo yogurt: posts big blind $0.25
*** HOLE CARDS ***
Dealt to chiyuki [8s As]
xxx Spb xxx: folds 
chiyuki: folds 
Grumpy as 2: folds 
nice.franki: folds 
Vall179: folds 
wildy29: folds 
kwkim73: folds 
Blue-GumBum: calls $0.15
4ydo yogurt: checks 
*** FLOP *** [2d 7c 4d]
Blue-GumBum: checks 
4ydo yogurt: checks 
*** TURN *** [2d 7c 4d] [Qc]
Blue-GumBum: checks 
4ydo yogurt: bets $0.36
Blue-GumBum: calls $0.36
*** RIVER *** [2d 7c 4d Qc] [7s]
Blue-GumBum: checks 
4ydo yogurt: bets $1.17
Blue-GumBum: folds 
Uncalled bet ($1.17) returned to 4ydo yogurt
4ydo yogurt collected $1.17 from pot
4ydo yogurt: doesn't show hand 
*** SUMMARY ***
Total pot $1.22 | Rake $0.05 
Board [2d 7c 4d Qc 7s]
Seat 1: kwkim73 (button) folded before Flop (didn't bet)
Seat 2: Blue-GumBum (small blind) folded on the River
Seat 3: 4ydo yogurt (big blind) collected ($1.17)
Seat 4: xxx Spb xxx folded before Flop (didn't bet)
Seat 5: chiyuki folded before Flop (didn't bet)
Seat 6: Grumpy as 2 folded before Flop (didn't bet)
Seat 7: nice.franki folded before Flop (didn't bet)
Seat 8: Vall179 folded before Flop (didn't bet)
Seat 9: wildy29 folded before Flop (didn't bet)



PokerStars Zoom Hand #84301123461:  Hold'em No Limit ($0.10/$0.25) - 2012/08/05 16:13:37 JST [2012/08/05 3:13:37 ET]
Table 'Whirlpool' 9-max Seat #1 is the button
Seat 1: risekuku468 ($27.91 in chips) 
Seat 2: nice.franki ($3.66 in chips) 
Seat 3: benjuer ($25 in chips) 
Seat 4: phate-1up ($35.82 in chips) 
Seat 5: 4ydo yogurt ($58.21 in chips) 
Seat 6: GovGus ($46.59 in chips) 
Seat 7: Grumpy as 2 ($12.48 in chips) 
Seat 8: Dejacob ($31.72 in chips) 
Seat 9: chiyuki ($29.74 in chips) 
nice.franki: posts small blind $0.10
benjuer: posts big blind $0.25
*** HOLE CARDS ***
Dealt to chiyuki [2s 3d]
phate-1up: folds 
4ydo yogurt: folds 
GovGus: folds 
Grumpy as 2: folds 
Dejacob: raises $0.50 to $0.75
chiyuki: folds 
risekuku468: folds 
nice.franki: folds 
benjuer: calls $0.50
*** FLOP *** [Ac 5h 5d]
benjuer: bets $0.75
Dejacob: calls $0.75
*** TURN *** [Ac 5h 5d] [9h]
benjuer: bets $1.25
Dejacob: folds 
Uncalled bet ($1.25) returned to benjuer
benjuer collected $2.96 from pot
benjuer: doesn't show hand 
*** SUMMARY ***
Total pot $3.10 | Rake $0.14 
Board [Ac 5h 5d 9h]
Seat 1: risekuku468 (button) folded before Flop (didn't bet)
Seat 2: nice.franki (small blind) folded before Flop
Seat 3: benjuer (big blind) collected ($2.96)
Seat 4: phate-1up folded before Flop (didn't bet)
Seat 5: 4ydo yogurt folded before Flop (didn't bet)
Seat 6: GovGus folded before Flop (didn't bet)
Seat 7: Grumpy as 2 folded before Flop (didn't bet)
Seat 8: Dejacob folded on the Turn
Seat 9: chiyuki folded before Flop (didn't bet)



PokerStars Zoom Hand #84301126693:  Hold'em No Limit ($0.10/$0.25) - 2012/08/05 16:13:49 JST [2012/08/05 3:13:49 ET]
Table 'Whirlpool' 9-max Seat #1 is the button
Seat 1: loszavera ($30.34 in chips) 
Seat 2: ivan130 ($26.41 in chips) 
Seat 3: chiyuki ($29.64 in chips) 
Seat 4: d4dda ($24.30 in chips) 
Seat 5: nice.franki ($3.56 in chips) 
Seat 6: Vall179 ($30.19 in chips) 
Seat 7: risekuku468 ($27.91 in chips) 
Seat 8: top gun 2950 ($41.76 in chips) 
Seat 9: phate-1up ($53.99 in chips) 
ivan130: posts small blind $0.10
chiyuki: posts big blind $0.25
*** HOLE CARDS ***
Dealt to chiyuki [9d Jd]
d4dda: raises $0.50 to $0.75
nice.franki: folds 
Vall179: folds 
risekuku468: folds 
top gun 2950: calls $0.75
phate-1up: folds 
loszavera: folds 
ivan130: folds 
chiyuki: calls $0.50
*** FLOP *** [2s Jc Kc]
chiyuki: checks 
d4dda: checks 
top gun 2950: bets $0.75
chiyuki: calls $0.75
d4dda: calls $0.75
*** TURN *** [2s Jc Kc] [4h]
chiyuki: checks 
d4dda: checks 
top gun 2950: bets $0.75
chiyuki: calls $0.75
d4dda: calls $0.75
*** RIVER *** [2s Jc Kc 4h] [9h]
chiyuki: bets $4
d4dda: folds 
top gun 2950: folds 
Uncalled bet ($4) returned to chiyuki
chiyuki collected $6.54 from pot
chiyuki: doesn't show hand 
*** SUMMARY ***
Total pot $6.85 | Rake $0.31 
Board [2s Jc Kc 4h 9h]
Seat 1: loszavera (button) folded before Flop (didn't bet)
Seat 2: ivan130 (small blind) folded before Flop
Seat 3: chiyuki (big blind) collected ($6.54)
Seat 4: d4dda folded on the River
Seat 5: nice.franki folded before Flop (didn't bet)
Seat 6: Vall179 folded before Flop (didn't bet)
Seat 7: risekuku468 folded before Flop (didn't bet)
Seat 8: top gun 2950 folded on the River
Seat 9: phate-1up folded before Flop (didn't bet)



PokerStars Zoom Hand #84301144037:  Hold'em No Limit ($0.10/$0.25) - 2012/08/05 16:14:54 JST [2012/08/05 3:14:54 ET]
Table 'Whirlpool' 9-max Seat #1 is the button
Seat 1: pikhtovnikov ($26.25 in chips) 
Seat 2: Lindikor ($14.82 in chips) 
Seat 3: kwkim73 ($25.35 in chips) 
Seat 4: GovGus ($53.15 in chips) 
Seat 5: Femali54 ($15.74 in chips) 
Seat 6: Serge Claws ($29.27 in chips) 
Seat 7: chiyuki ($33.93 in chips) 
Seat 8: Perstenev ($9.90 in chips) 
Seat 9: snejokCoxx ($12.64 in chips) 
Lindikor: posts small blind $0.10
kwkim73: posts big blind $0.25
*** HOLE CARDS ***
Dealt to chiyuki [5s 2d]
GovGus: folds 
Femali54: folds 
Serge Claws: folds 
chiyuki: folds 
Perstenev: folds 
snejokCoxx: folds 
pikhtovnikov: raises $1.25 to $1.50
Lindikor: folds 
kwkim73: folds 
Uncalled bet ($1.25) returned to pikhtovnikov
pikhtovnikov collected $0.60 from pot
pikhtovnikov: doesn't show hand 
*** SUMMARY ***
Total pot $0.60 | Rake $0 
Seat 1: pikhtovnikov (button) collected ($0.60)
Seat 2: Lindikor (small blind) folded before Flop
Seat 3: kwkim73 (big blind) folded before Flop
Seat 4: GovGus folded before Flop (didn't bet)
Seat 5: Femali54 folded before Flop (didn't bet)
Seat 6: Serge Claws folded before Flop (didn't bet)
Seat 7: chiyuki folded before Flop (didn't bet)
Seat 8: Perstenev folded before Flop (didn't bet)
Seat 9: snejokCoxx folded before Flop (didn't bet)



PokerStars Zoom Hand #84301144862:  Hold'em No Limit ($0.10/$0.25) - 2012/08/05 16:14:57 JST [2012/08/05 3:14:57 ET]
Table 'Whirlpool' 9-max Seat #1 is the button
Seat 1: Nerkit ($12.15 in chips) 
Seat 2: kesstukas25 ($30.11 in chips) 
Seat 3: Mytea88 ($13.30 in chips) 
Seat 4: GSDP ($37.29 in chips) 
Seat 5: chiyuki ($33.93 in chips) 
Seat 6: olligol123 ($25 in chips) 
Seat 7: Ih8niknames ($20 in chips) 
Seat 8: Blue-GumBum ($14.36 in chips) 
Seat 9: Cripple86 ($25.84 in chips) 
kesstukas25: posts small blind $0.10
Mytea88: posts big blind $0.25
*** HOLE CARDS ***
Dealt to chiyuki [2d 9d]
GSDP: folds 
chiyuki: folds 
olligol123: folds 
Ih8niknames: folds 
Blue-GumBum: folds 
Cripple86: folds 
Nerkit: raises $0.37 to $0.62
kesstukas25: folds 
Mytea88: folds 
Uncalled bet ($0.37) returned to Nerkit
Nerkit collected $0.60 from pot
Nerkit: doesn't show hand 
*** SUMMARY ***
Total pot $0.60 | Rake $0 
Seat 1: Nerkit (button) collected ($0.60)
Seat 2: kesstukas25 (small blind) folded before Flop
Seat 3: Mytea88 (big blind) folded before Flop
Seat 4: GSDP folded before Flop (didn't bet)
Seat 5: chiyuki folded before Flop (didn't bet)
Seat 6: olligol123 folded before Flop (didn't bet)
Seat 7: Ih8niknames folded before Flop (didn't bet)
Seat 8: Blue-GumBum folded before Flop (didn't bet)
Seat 9: Cripple86 folded before Flop (didn't bet)



PokerStars Zoom Hand #84301145675:  Hold'em No Limit ($0.10/$0.25) - 2012/08/05 16:15:00 JST [2012/08/05 3:15:00 ET]
Table 'Whirlpool' 9-max Seat #1 is the button
Seat 1: chiyuki ($33.93 in chips) 
Seat 2: snejokCoxx ($12.64 in chips) 
Seat 3: d4dda ($22.05 in chips) 
Seat 4: teaser07 ($25.50 in chips) 
Seat 5: Angi858 ($26.75 in chips) 
Seat 6: phate-1up ($52.99 in chips) 
Seat 7: wildy29 ($97.97 in chips) 
Seat 8: roksmokndonk ($24.06 in chips) 
Seat 9: Grishukps ($12.50 in chips) 
snejokCoxx: posts small blind $0.10
d4dda: posts big blind $0.25
*** HOLE CARDS ***
Dealt to chiyuki [7h 6h]
teaser07: raises $0.75 to $1
Angi858: folds 
phate-1up: folds 
wildy29: folds 
roksmokndonk: folds 
Grishukps: folds 
chiyuki: folds 
snejokCoxx: folds 
d4dda: folds 
Uncalled bet ($0.75) returned to teaser07
teaser07 collected $0.60 from pot
teaser07: doesn't show hand 
*** SUMMARY ***
Total pot $0.60 | Rake $0 
Seat 1: chiyuki (button) folded before Flop (didn't bet)
Seat 2: snejokCoxx (small blind) folded before Flop
Seat 3: d4dda (big blind) folded before Flop
Seat 4: teaser07 collected ($0.60)
Seat 5: Angi858 folded before Flop (didn't bet)
Seat 6: phate-1up folded before Flop (didn't bet)
Seat 7: wildy29 folded before Flop (didn't bet)
Seat 8: roksmokndonk folded before Flop (didn't bet)
Seat 9: Grishukps folded before Flop (didn't bet)



PokerStars Zoom Hand #84301147625:  Hold'em No Limit ($0.10/$0.25) - 2012/08/05 16:15:07 JST [2012/08/05 3:15:07 ET]
Table 'Whirlpool' 9-max Seat #1 is the button
Seat 1: kwkim73 ($25.10 in chips) 
Seat 2: seula i ($60.59 in chips) 
Seat 3: Cripple86 ($28.91 in chips) 
Seat 4: chiyuki ($33.93 in chips) 
Seat 5: phate-1up ($58.68 in chips) 
Seat 6: GovGus ($53.15 in chips) 
Seat 7: nice.franki ($2.81 in chips) 
Seat 8: Grumpy as 2 ($12.13 in chips) 
Seat 9: AntoineHunt ($36.21 in chips) 
seula i: posts small blind $0.10
Cripple86: posts big blind $0.25
*** HOLE CARDS ***
Dealt to chiyuki [Jd 5s]
chiyuki: folds 
phate-1up: folds 
GovGus: folds 
nice.franki: folds 
Grumpy as 2: folds 
AntoineHunt: folds 
kwkim73: raises $0.50 to $0.75
seula i: folds 
Cripple86: folds 
Uncalled bet ($0.50) returned to kwkim73
kwkim73 collected $0.60 from pot
kwkim73: doesn't show hand 
*** SUMMARY ***
Total pot $0.60 | Rake $0 
Seat 1: kwkim73 (button) collected ($0.60)
Seat 2: seula i (small blind) folded before Flop
Seat 3: Cripple86 (big blind) folded before Flop
Seat 4: chiyuki folded before Flop (didn't bet)
Seat 5: phate-1up folded before Flop (didn't bet)
Seat 6: GovGus folded before Flop (didn't bet)
Seat 7: nice.franki folded before Flop (didn't bet)
Seat 8: Grumpy as 2 folded before Flop (didn't bet)
Seat 9: AntoineHunt folded before Flop (didn't bet)



PokerStars Zoom Hand #84301153457:  Hold'em No Limit ($0.10/$0.25) - 2012/08/05 16:15:29 JST [2012/08/05 3:15:29 ET]
Table 'Whirlpool' 9-max Seat #1 is the button
Seat 1: phate-1up ($58.58 in chips) 
Seat 2: Perstenev ($12.14 in chips) 
Seat 3: chiyuki ($33.93 in chips) 
Seat 4: seula i ($60.49 in chips) 
Seat 5: Nerkit ($11.33 in chips) 
Seat 6: d4dda ($21.70 in chips) 
Seat 7: masterkoolb ($13.20 in chips) 
Seat 8: mamlind ($14.84 in chips) 
Seat 9: kwkim73 ($34.06 in chips) 
Perstenev: posts small blind $0.10
chiyuki: posts big blind $0.25
*** HOLE CARDS ***
Dealt to chiyuki [3s 9h]
seula i: raises $0.50 to $0.75
Nerkit: folds 
d4dda: calls $0.75
masterkoolb: folds 
mamlind: folds 
kwkim73: folds 
phate-1up: folds 
Perstenev: folds 
chiyuki: folds 
*** FLOP *** [Jd 5h Qs]
seula i: bets $1.25
d4dda: folds 
Uncalled bet ($1.25) returned to seula i
seula i collected $1.77 from pot
seula i: doesn't show hand 
*** SUMMARY ***
Total pot $1.85 | Rake $0.08 
Board [Jd 5h Qs]
Seat 1: phate-1up (button) folded before Flop (didn't bet)
Seat 2: Perstenev (small blind) folded before Flop
Seat 3: chiyuki (big blind) folded before Flop
Seat 4: seula i collected ($1.77)
Seat 5: Nerkit folded before Flop (didn't bet)
Seat 6: d4dda folded on the Flop
Seat 7: masterkoolb folded before Flop (didn't bet)
Seat 8: mamlind folded before Flop (didn't bet)
Seat 9: kwkim73 folded before Flop (didn't bet)



PokerStars Zoom Hand #84301148461:  Hold'em No Limit ($0.10/$0.25) - 2012/08/05 16:15:11 JST [2012/08/05 3:15:11 ET]
Table 'Whirlpool' 9-max Seat #1 is the button
Seat 1: 4plankton ($4.28 in chips) 
Seat 2: phate-1up ($58.68 in chips) 
Seat 3: Perstenev ($4.33 in chips) 
Seat 4: Ih8niknames ($20 in chips) 
Seat 5: kwkim73 ($46.62 in chips) 
Seat 6: Loholov ($15 in chips) 
Seat 7: Dejacob ($32.87 in chips) 
Seat 8: Vall179 ($28.08 in chips) 
Seat 9: chiyuki ($33.93 in chips) 
phate-1up: posts small blind $0.10
Perstenev: posts big blind $0.25
*** HOLE CARDS ***
Dealt to chiyuki [6d Qs]
Ih8niknames: folds 
kwkim73: folds 
Loholov: raises $0.50 to $0.75
Dejacob: calls $0.75
Vall179: folds 
chiyuki: folds 
4plankton: folds 
phate-1up: folds 
Perstenev: calls $0.50
*** FLOP *** [Jh 6h 5c]
Perstenev: checks 
Loholov: checks 
Dejacob: bets $1.75
Perstenev: folds 
Loholov: calls $1.75
*** TURN *** [Jh 6h 5c] [7s]
Loholov: checks 
Dejacob: bets $3.75
Loholov: folds 
Uncalled bet ($3.75) returned to Dejacob
Dejacob collected $5.59 from pot
Dejacob: doesn't show hand 
*** SUMMARY ***
Total pot $5.85 | Rake $0.26 
Board [Jh 6h 5c 7s]
Seat 1: 4plankton (button) folded before Flop (didn't bet)
Seat 2: phate-1up (small blind) folded before Flop
Seat 3: Perstenev (big blind) folded on the Flop
Seat 4: Ih8niknames folded before Flop (didn't bet)
Seat 5: kwkim73 folded before Flop (didn't bet)
Seat 6: Loholov folded on the Turn
Seat 7: Dejacob collected ($5.59)
Seat 8: Vall179 folded before Flop (didn't bet)
Seat 9: chiyuki folded before Flop (didn't bet)



PokerStars Zoom Hand #84301152594:  Hold'em No Limit ($0.10/$0.25) - 2012/08/05 16:15:26 JST [2012/08/05 3:15:26 ET]
Table 'Whirlpool' 9-max Seat #1 is the button
Seat 1: nice.franki ($12.42 in chips) 
Seat 2: 1Karina1 ($30.69 in chips) 
Seat 3: Cripple86 ($25.84 in chips) 
Seat 4: kesstukas25 ($29.44 in chips) 
Seat 5: deepakmbh ($30.27 in chips) 
Seat 6: MurMurRu ($42.19 in chips) 
Seat 7: Nerkit ($11.33 in chips) 
Seat 8: chiyuki ($33.93 in chips) 
Seat 9: xxx Spb xxx ($33.74 in chips) 
1Karina1: posts small blind $0.10
Cripple86: posts big blind $0.25
*** HOLE CARDS ***
Dealt to chiyuki [9c 8c]
kesstukas25: raises $0.50 to $0.75
deepakmbh: raises $1.75 to $2.50
MurMurRu: folds 
Nerkit: folds 
chiyuki: folds 
xxx Spb xxx: folds 
nice.franki: folds 
1Karina1: folds 
Cripple86: folds 
kesstukas25: folds 
Uncalled bet ($1.75) returned to deepakmbh
deepakmbh collected $1.85 from pot
deepakmbh: doesn't show hand 
*** SUMMARY ***
Total pot $1.85 | Rake $0 
Seat 1: nice.franki (button) folded before Flop (didn't bet)
Seat 2: 1Karina1 (small blind) folded before Flop
Seat 3: Cripple86 (big blind) folded before Flop
Seat 4: kesstukas25 folded before Flop
Seat 5: deepakmbh collected ($1.85)
Seat 6: MurMurRu folded before Flop (didn't bet)
Seat 7: Nerkit folded before Flop (didn't bet)
Seat 8: chiyuki folded before Flop (didn't bet)
Seat 9: xxx Spb xxx folded before Flop (didn't bet)



PokerStars Zoom Hand #84301157292:  Hold'em No Limit ($0.10/$0.25) - 2012/08/05 16:15:43 JST [2012/08/05 3:15:43 ET]
Table 'Whirlpool' 9-max Seat #1 is the button
Seat 1: Cripple86 ($28.56 in chips) 
Seat 2: chiyuki ($33.68 in chips) 
Seat 3: Grishukps ($13.21 in chips) 
Seat 4: Alvinpe85 ($104.24 in chips) 
Seat 5: Dejacob ($29.72 in chips) 
Seat 6: hldtom ($12.50 in chips) 
Seat 7: nice.franki ($11.82 in chips) 
Seat 8: Serge Claws ($40.42 in chips) 
Seat 9: roksmokndonk ($23.71 in chips) 
chiyuki: posts small blind $0.10
Grishukps: posts big blind $0.25
*** HOLE CARDS ***
Dealt to chiyuki [6d 4s]
Alvinpe85: folds 
Dejacob: folds 
hldtom: folds 
nice.franki: folds 
Serge Claws: folds 
roksmokndonk: calls $0.25
Cripple86: folds 
chiyuki: folds 
Grishukps: checks 
*** FLOP *** [7d 7h 3d]
Grishukps: checks 
roksmokndonk: checks 
*** TURN *** [7d 7h 3d] [9s]
Grishukps: bets $0.50
roksmokndonk: folds 
Uncalled bet ($0.50) returned to Grishukps
Grishukps collected $0.57 from pot
Grishukps: doesn't show hand 
*** SUMMARY ***
Total pot $0.60 | Rake $0.03 
Board [7d 7h 3d 9s]
Seat 1: Cripple86 (button) folded before Flop (didn't bet)
Seat 2: chiyuki (small blind) folded before Flop
Seat 3: Grishukps (big blind) collected ($0.57)
Seat 4: Alvinpe85 folded before Flop (didn't bet)
Seat 5: Dejacob folded before Flop (didn't bet)
Seat 6: hldtom folded before Flop (didn't bet)
Seat 7: nice.franki folded before Flop (didn't bet)
Seat 8: Serge Claws folded before Flop (didn't bet)
Seat 9: roksmokndonk folded on the Turn



PokerStars Zoom Hand #84301159486:  Hold'em No Limit ($0.10/$0.25) - 2012/08/05 16:15:51 JST [2012/08/05 3:15:51 ET]
Table 'Whirlpool' 9-max Seat #1 is the button
Seat 1: Vall179 ($24.44 in chips) 
Seat 2: Loholov ($15 in chips) 
Seat 3: FoRlan77 ($25 in chips) 
Seat 4: chiyuki ($33.58 in chips) 
Seat 5: slapshot2011 ($33.44 in chips) 
Seat 6: kwkim73 ($25.35 in chips) 
Seat 7: Dejacob ($29.72 in chips) 
Seat 8: phate-1up ($58.33 in chips) 
Seat 9: nice.franki ($11.82 in chips) 
Loholov: posts small blind $0.10
FoRlan77: posts big blind $0.25
*** HOLE CARDS ***
Dealt to chiyuki [Th 4h]
chiyuki: folds 
slapshot2011: folds 
kwkim73: folds 
Dejacob: folds 
phate-1up: folds 
nice.franki: folds 
Vall179: raises $0.50 to $0.75
Loholov: folds 
FoRlan77: raises $1.50 to $2.25
Vall179: folds 
Uncalled bet ($1.50) returned to FoRlan77
FoRlan77 collected $1.60 from pot
FoRlan77: doesn't show hand 
*** SUMMARY ***
Total pot $1.60 | Rake $0 
Seat 1: Vall179 (button) folded before Flop
Seat 2: Loholov (small blind) folded before Flop
Seat 3: FoRlan77 (big blind) collected ($1.60)
Seat 4: chiyuki folded before Flop (didn't bet)
Seat 5: slapshot2011 folded before Flop (didn't bet)
Seat 6: kwkim73 folded before Flop (didn't bet)
Seat 7: Dejacob folded before Flop (didn't bet)
Seat 8: phate-1up folded before Flop (didn't bet)
Seat 9: nice.franki folded before Flop (didn't bet)



PokerStars Zoom Hand #84301156463:  Hold'em No Limit ($0.10/$0.25) - 2012/08/05 16:15:40 JST [2012/08/05 3:15:40 ET]
Table 'Whirlpool' 9-max Seat #1 is the button
Seat 1: Perstenev ($9.80 in chips) 
Seat 2: GovGus ($40.41 in chips) 
Seat 3: DrunkTyphoon ($43.54 in chips) 
Seat 4: INSP!RON ($29.57 in chips) 
Seat 5: Vall179 ($27.98 in chips) 
Seat 6: chiyuki ($33.68 in chips) 
Seat 7: Limoilou ($31.56 in chips) 
Seat 8: snejokCoxx ($11.13 in chips) 
Seat 9: kwkim73 ($26.49 in chips) 
GovGus: posts small blind $0.10
DrunkTyphoon: posts big blind $0.25
*** HOLE CARDS ***
Dealt to chiyuki [4h 3s]
INSP!RON: folds 
Vall179: folds 
chiyuki: folds 
Limoilou: folds 
snejokCoxx: folds 
kwkim73: raises $0.50 to $0.75
Perstenev: folds 
GovGus: folds 
DrunkTyphoon: calls $0.50
*** FLOP *** [Jc 2c 6d]
DrunkTyphoon: checks 
kwkim73: bets $1.07
DrunkTyphoon: calls $1.07
*** TURN *** [Jc 2c 6d] [8c]
DrunkTyphoon: checks 
kwkim73: checks 
*** RIVER *** [Jc 2c 6d 8c] [Ac]
DrunkTyphoon: bets $2.39
kwkim73: folds 
Uncalled bet ($2.39) returned to DrunkTyphoon
DrunkTyphoon collected $3.57 from pot
DrunkTyphoon: doesn't show hand 
*** SUMMARY ***
Total pot $3.74 | Rake $0.17 
Board [Jc 2c 6d 8c Ac]
Seat 1: Perstenev (button) folded before Flop (didn't bet)
Seat 2: GovGus (small blind) folded before Flop
Seat 3: DrunkTyphoon (big blind) collected ($3.57)
Seat 4: INSP!RON folded before Flop (didn't bet)
Seat 5: Vall179 folded before Flop (didn't bet)
Seat 6: chiyuki folded before Flop (didn't bet)
Seat 7: Limoilou folded before Flop (didn't bet)
Seat 8: snejokCoxx folded before Flop (didn't bet)
Seat 9: kwkim73 folded on the River



PokerStars Zoom Hand #84301161399:  Hold'em No Limit ($0.10/$0.25) - 2012/08/05 16:15:58 JST [2012/08/05 3:15:58 ET]
Table 'Whirlpool' 9-max Seat #1 is the button
Seat 1: PAMBOS.L ($17.94 in chips) 
Seat 2: Ih8niknames ($20 in chips) 
Seat 3: Lindikor ($14.72 in chips) 
Seat 4: Nerkit ($11.33 in chips) 
Seat 5: Kasperlmusik ($31.46 in chips) 
Seat 6: snejokCoxx ($11.13 in chips) 
Seat 7: chiyuki ($33.58 in chips) 
Seat 8: 1Karina1 ($30.59 in chips) 
Seat 9: phate-1up ($58.33 in chips) 
Ih8niknames: posts small blind $0.10
Lindikor: posts big blind $0.25
*** HOLE CARDS ***
Dealt to chiyuki [Kh Kc]
Nerkit: folds 
Kasperlmusik: folds 
snejokCoxx: folds 
chiyuki: raises $0.50 to $0.75
1Karina1: folds 
phate-1up: raises $1.50 to $2.25
PAMBOS.L: folds 
Ih8niknames: folds 
Lindikor: folds 
chiyuki: raises $4 to $6.25
phate-1up: folds 
Uncalled bet ($4) returned to chiyuki
chiyuki collected $4.85 from pot
chiyuki: doesn't show hand 
*** SUMMARY ***
Total pot $4.85 | Rake $0 
Seat 1: PAMBOS.L (button) folded before Flop (didn't bet)
Seat 2: Ih8niknames (small blind) folded before Flop
Seat 3: Lindikor (big blind) folded before Flop
Seat 4: Nerkit folded before Flop (didn't bet)
Seat 5: Kasperlmusik folded before Flop (didn't bet)
Seat 6: snejokCoxx folded before Flop (didn't bet)
Seat 7: chiyuki collected ($4.85)
Seat 8: 1Karina1 folded before Flop (didn't bet)
Seat 9: phate-1up folded before Flop



PokerStars Zoom Hand #84301175465:  Hold'em No Limit ($0.10/$0.25) - 2012/08/05 16:16:50 JST [2012/08/05 3:16:50 ET]
Table 'Whirlpool' 9-max Seat #1 is the button
Seat 1: Kasperlmusik ($31.11 in chips) 
Seat 2: nice.franki ($12.38 in chips) 
Seat 3: new85new85 ($25 in chips) 
Seat 4: 1Karina1 ($33.27 in chips) 
Seat 5: Loholov ($15 in chips) 
Seat 6: codan23 ($12.46 in chips) 
Seat 7: top gun 2950 ($37.81 in chips) 
Seat 8: loszavera ($29.21 in chips) 
Seat 9: chiyuki ($36.18 in chips) 
nice.franki: posts small blind $0.10
new85new85: posts big blind $0.25
*** HOLE CARDS ***
Dealt to chiyuki [6s As]
1Karina1: folds 
Loholov: folds 
codan23: folds 
top gun 2950: folds 
loszavera: folds 
chiyuki: raises $0.50 to $0.75
Kasperlmusik: folds 
nice.franki: folds 
new85new85: folds 
Uncalled bet ($0.50) returned to chiyuki
chiyuki collected $0.60 from pot
chiyuki: doesn't show hand 
*** SUMMARY ***
Total pot $0.60 | Rake $0 
Seat 1: Kasperlmusik (button) folded before Flop (didn't bet)
Seat 2: nice.franki (small blind) folded before Flop
Seat 3: new85new85 (big blind) folded before Flop
Seat 4: 1Karina1 folded before Flop (didn't bet)
Seat 5: Loholov folded before Flop (didn't bet)
Seat 6: codan23 folded before Flop (didn't bet)
Seat 7: top gun 2950 folded before Flop (didn't bet)
Seat 8: loszavera folded before Flop (didn't bet)
Seat 9: chiyuki collected ($0.60)



PokerStars Zoom Hand #84301180151:  Hold'em No Limit ($0.10/$0.25) - 2012/08/05 16:17:07 JST [2012/08/05 3:17:07 ET]
Table 'Whirlpool' 9-max Seat #1 is the button
Seat 1: chiyuki ($36.53 in chips) 
Seat 2: soul_5577 ($35.33 in chips) 
Seat 3: silvno31 ($67.29 in chips) 
Seat 4: phate-1up ($101.65 in chips) 
Seat 5: Nerkit ($14.70 in chips) 
Seat 6: loszavera ($29.11 in chips) 
Seat 7: Serge Claws ($39.07 in chips) 
Seat 8: Bondvsta ($26.80 in chips) 
Seat 9: olligol123 ($26.28 in chips) 
soul_5577: posts small blind $0.10
silvno31: posts big blind $0.25
*** HOLE CARDS ***
Dealt to chiyuki [7c 6c]
phate-1up: folds 
Nerkit: folds 
loszavera: folds 
Serge Claws: folds 
Bondvsta: folds 
olligol123: folds 
chiyuki: folds 
soul_5577: folds 
Uncalled bet ($0.15) returned to silvno31
silvno31 collected $0.20 from pot
silvno31: doesn't show hand 
*** SUMMARY ***
Total pot $0.20 | Rake $0 
Seat 1: chiyuki (button) folded before Flop (didn't bet)
Seat 2: soul_5577 (small blind) folded before Flop
Seat 3: silvno31 (big blind) collected ($0.20)
Seat 4: phate-1up folded before Flop (didn't bet)
Seat 5: Nerkit folded before Flop (didn't bet)
Seat 6: loszavera folded before Flop (didn't bet)
Seat 7: Serge Claws folded before Flop (didn't bet)
Seat 8: Bondvsta folded before Flop (didn't bet)
Seat 9: olligol123 folded before Flop (didn't bet)



PokerStars Zoom Hand #84301181030:  Hold'em No Limit ($0.10/$0.25) - 2012/08/05 16:17:10 JST [2012/08/05 3:17:10 ET]
Table 'Whirlpool' 9-max Seat #1 is the button
Seat 1: Cripple86 ($25 in chips) 
Seat 2: 1Karina1 ($66.64 in chips) 
Seat 3: kwkim73 ($33.71 in chips) 
Seat 4: DrunkTyphoon ($45.76 in chips) 
Seat 5: Serge Claws ($39.07 in chips) 
Seat 6: Grishukps ($13.28 in chips) 
Seat 7: Nerkit ($14.70 in chips) 
Seat 8: chiyuki ($36.53 in chips) 
Seat 9: PPP7SSS ($40.32 in chips) 
1Karina1: posts small blind $0.10
kwkim73: posts big blind $0.25
*** HOLE CARDS ***
Dealt to chiyuki [8d 5d]
DrunkTyphoon: folds 
Serge Claws: folds 
Grishukps: folds 
Nerkit: folds 
chiyuki: folds 
PPP7SSS: folds 
Cripple86: raises $0.50 to $0.75
1Karina1: folds 
kwkim73: folds 
Uncalled bet ($0.50) returned to Cripple86
Cripple86 collected $0.60 from pot
Cripple86: doesn't show hand 
*** SUMMARY ***
Total pot $0.60 | Rake $0 
Seat 1: Cripple86 (button) collected ($0.60)
Seat 2: 1Karina1 (small blind) folded before Flop
Seat 3: kwkim73 (big blind) folded before Flop
Seat 4: DrunkTyphoon folded before Flop (didn't bet)
Seat 5: Serge Claws folded before Flop (didn't bet)
Seat 6: Grishukps folded before Flop (didn't bet)
Seat 7: Nerkit folded before Flop (didn't bet)
Seat 8: chiyuki folded before Flop (didn't bet)
Seat 9: PPP7SSS folded before Flop (didn't bet)



PokerStars Zoom Hand #84301182643:  Hold'em No Limit ($0.10/$0.25) - 2012/08/05 16:17:16 JST [2012/08/05 3:17:16 ET]
Table 'Whirlpool' 9-max Seat #1 is the button
Seat 1: Ellen1947 ($23.25 in chips) 
Seat 2: mungroo ($24.75 in chips) 
Seat 3: Perstenev ($9.04 in chips) 
Seat 4: INSP!RON ($28.09 in chips) 
Seat 5: Grishukps ($13.28 in chips) 
Seat 6: chiyuki ($36.53 in chips) 
Seat 7: phate-1up ($101.65 in chips) 
Seat 8: Angi858 ($25.47 in chips) 
Seat 9: Dejacob ($36.64 in chips) 
mungroo: posts small blind $0.10
Perstenev: posts big blind $0.25
*** HOLE CARDS ***
Dealt to chiyuki [3s Jh]
INSP!RON: folds 
Grishukps: folds 
chiyuki: folds 
phate-1up: folds 
Angi858: folds 
Dejacob: folds 
Ellen1947: raises $0.45 to $0.70
mungroo: folds 
Perstenev: folds 
Uncalled bet ($0.45) returned to Ellen1947
Ellen1947 collected $0.60 from pot
Ellen1947: doesn't show hand 
*** SUMMARY ***
Total pot $0.60 | Rake $0 
Seat 1: Ellen1947 (button) collected ($0.60)
Seat 2: mungroo (small blind) folded before Flop
Seat 3: Perstenev (big blind) folded before Flop
Seat 4: INSP!RON folded before Flop (didn't bet)
Seat 5: Grishukps folded before Flop (didn't bet)
Seat 6: chiyuki folded before Flop (didn't bet)
Seat 7: phate-1up folded before Flop (didn't bet)
Seat 8: Angi858 folded before Flop (didn't bet)
Seat 9: Dejacob folded before Flop (didn't bet)



PokerStars Zoom Hand #84301185387:  Hold'em No Limit ($0.10/$0.25) - 2012/08/05 16:17:26 JST [2012/08/05 3:17:26 ET]
Table 'Whirlpool' 9-max Seat #1 is the button
Seat 1: Patient90122 ($27.22 in chips) 
Seat 2: mungroo ($26.94 in chips) 
Seat 3: chiyuki ($36.53 in chips) 
Seat 4: Ih8niknames ($20 in chips) 
Seat 5: Nerkit ($14.70 in chips) 
Seat 6: Limoilou ($31.56 in chips) 
Seat 7: Loholov ($20.22 in chips) 
Seat 8: phate-1up ($34.82 in chips) 
Seat 9: Vall179 ($37.40 in chips) 
mungroo: posts small blind $0.10
chiyuki: posts big blind $0.25
*** HOLE CARDS ***
Dealt to chiyuki [Th 7d]
Ih8niknames: folds 
Nerkit: folds 
Limoilou: folds 
Loholov: raises $0.50 to $0.75
phate-1up: folds 
Vall179: folds 
Patient90122: folds 
mungroo: folds 
chiyuki: folds 
Uncalled bet ($0.50) returned to Loholov
Loholov collected $0.60 from pot
Loholov: doesn't show hand 
*** SUMMARY ***
Total pot $0.60 | Rake $0 
Seat 1: Patient90122 (button) folded before Flop (didn't bet)
Seat 2: mungroo (small blind) folded before Flop
Seat 3: chiyuki (big blind) folded before Flop
Seat 4: Ih8niknames folded before Flop (didn't bet)
Seat 5: Nerkit folded before Flop (didn't bet)
Seat 6: Limoilou folded before Flop (didn't bet)
Seat 7: Loholov collected ($0.60)
Seat 8: phate-1up folded before Flop (didn't bet)
Seat 9: Vall179 folded before Flop (didn't bet)



PokerStars Zoom Hand #84301183680:  Hold'em No Limit ($0.10/$0.25) - 2012/08/05 16:17:20 JST [2012/08/05 3:17:20 ET]
Table 'Whirlpool' 9-max Seat #1 is the button
Seat 1: DrunkTyphoon ($34.44 in chips) 
Seat 2: INSP!RON ($28.09 in chips) 
Seat 3: kwkim73 ($46.22 in chips) 
Seat 4: Loholov ($15 in chips) 
Seat 5: chiyuki ($36.53 in chips) 
Seat 6: Dejacob ($36.64 in chips) 
Seat 7: Alvinpe85 ($109.33 in chips) 
Seat 8: xxx Spb xxx ($28.47 in chips) 
Seat 9: GSDP ($24.50 in chips) 
INSP!RON: posts small blind $0.10
kwkim73: posts big blind $0.25
*** HOLE CARDS ***
Dealt to chiyuki [3c 6s]
Loholov: folds 
chiyuki: folds 
Dejacob: folds 
Alvinpe85: folds 
xxx Spb xxx: folds 
GSDP: folds 
DrunkTyphoon: raises $0.50 to $0.75
INSP!RON: folds 
kwkim73: folds 
Uncalled bet ($0.50) returned to DrunkTyphoon
DrunkTyphoon collected $0.60 from pot
DrunkTyphoon: doesn't show hand 
*** SUMMARY ***
Total pot $0.60 | Rake $0 
Seat 1: DrunkTyphoon (button) collected ($0.60)
Seat 2: INSP!RON (small blind) folded before Flop
Seat 3: kwkim73 (big blind) folded before Flop
Seat 4: Loholov folded before Flop (didn't bet)
Seat 5: chiyuki folded before Flop (didn't bet)
Seat 6: Dejacob folded before Flop (didn't bet)
Seat 7: Alvinpe85 folded before Flop (didn't bet)
Seat 8: xxx Spb xxx folded before Flop (didn't bet)
Seat 9: GSDP folded before Flop (didn't bet)



PokerStars Zoom Hand #84301184551:  Hold'em No Limit ($0.10/$0.25) - 2012/08/05 16:17:23 JST [2012/08/05 3:17:23 ET]
Table 'Whirlpool' 9-max Seat #1 is the button
Seat 1: deepakmbh ($23.83 in chips) 
Seat 2: Grishukps ($13.28 in chips) 
Seat 3: MurMurRu ($25.68 in chips) 
Seat 4: chiyuki ($36.53 in chips) 
Seat 5: Lindikor ($14.12 in chips) 
Seat 6: CrittHunter ($25.90 in chips) 
Seat 7: tribunpdm ($76.31 in chips) 
Seat 8: 1Karina1 ($30.34 in chips) 
Seat 9: RRMM_again ($25.39 in chips) 
Grishukps: posts small blind $0.10
MurMurRu: posts big blind $0.25
*** HOLE CARDS ***
Dealt to chiyuki [8h 6d]
chiyuki: folds 
Lindikor: raises $0.50 to $0.75
CrittHunter: folds 
tribunpdm: folds 
1Karina1: folds 
RRMM_again: folds 
deepakmbh: calls $0.75
Grishukps: folds 
MurMurRu: raises $2.35 to $3.10
Lindikor: folds 
deepakmbh: folds 
Uncalled bet ($2.35) returned to MurMurRu
MurMurRu collected $2.35 from pot
MurMurRu: doesn't show hand 
*** SUMMARY ***
Total pot $2.35 | Rake $0 
Seat 1: deepakmbh (button) folded before Flop
Seat 2: Grishukps (small blind) folded before Flop
Seat 3: MurMurRu (big blind) collected ($2.35)
Seat 4: chiyuki folded before Flop (didn't bet)
Seat 5: Lindikor folded before Flop
Seat 6: CrittHunter folded before Flop (didn't bet)
Seat 7: tribunpdm folded before Flop (didn't bet)
Seat 8: 1Karina1 folded before Flop (didn't bet)
Seat 9: RRMM_again folded before Flop (didn't bet)



PokerStars Zoom Hand #84301195095:  Hold'em No Limit ($0.10/$0.25) - 2012/08/05 16:18:02 JST [2012/08/05 3:18:02 ET]
Table 'Whirlpool' 9-max Seat #1 is the button
Seat 1: RRMM_again ($25.04 in chips) 
Seat 2: 4plankton ($3.58 in chips) 
Seat 3: top gun 2950 ($35.81 in chips) 
Seat 4: Dejacob ($32.28 in chips) 
Seat 5: Grishukps ($17.57 in chips) 
Seat 6: chiyuki ($36.18 in chips) 
Seat 7: Vall179 ($29.59 in chips) 
Seat 8: benjuer ($29.51 in chips) 
Seat 9: kwkim73 ($33.36 in chips) 
4plankton: posts small blind $0.10
top gun 2950: posts big blind $0.25
*** HOLE CARDS ***
Dealt to chiyuki [Kh Qh]
Dejacob: raises $0.50 to $0.75
Grishukps: folds 
chiyuki: folds 
Vall179: folds 
benjuer: folds 
kwkim73: folds 
RRMM_again: folds 
4plankton: folds 
top gun 2950: folds 
Uncalled bet ($0.50) returned to Dejacob
Dejacob collected $0.60 from pot
Dejacob: doesn't show hand 
*** SUMMARY ***
Total pot $0.60 | Rake $0 
Seat 1: RRMM_again (button) folded before Flop (didn't bet)
Seat 2: 4plankton (small blind) folded before Flop
Seat 3: top gun 2950 (big blind) folded before Flop
Seat 4: Dejacob collected ($0.60)
Seat 5: Grishukps folded before Flop (didn't bet)
Seat 6: chiyuki folded before Flop (didn't bet)
Seat 7: Vall179 folded before Flop (didn't bet)
Seat 8: benjuer folded before Flop (didn't bet)
Seat 9: kwkim73 folded before Flop (didn't bet)



PokerStars Zoom Hand #84301188705:  Hold'em No Limit ($0.10/$0.25) - 2012/08/05 16:17:39 JST [2012/08/05 3:17:39 ET]
Table 'Whirlpool' 9-max Seat #1 is the button
Seat 1: kwkim73 ($45.97 in chips) 
Seat 2: 1Karina1 ($30.34 in chips) 
Seat 3: INSP!RON ($33.64 in chips) 
Seat 4: Nerkit ($10.48 in chips) 
Seat 5: Cripple86 ($26.81 in chips) 
Seat 6: kesstukas25 ($24.19 in chips) 
Seat 7: chiyuki ($36.28 in chips) 
Seat 8: scaredsare ($24.41 in chips) 
Seat 9: nice.franki ($12.17 in chips) 
1Karina1: posts small blind $0.10
INSP!RON: posts big blind $0.25
*** HOLE CARDS ***
Dealt to chiyuki [6c 6h]
Nerkit: folds 
Cripple86: folds 
kesstukas25: folds 
chiyuki: folds 
scaredsare: calls $0.25
nice.franki: folds 
kwkim73: folds 
1Karina1: folds 
INSP!RON: raises $0.88 to $1.13
scaredsare: calls $0.88
*** FLOP *** [6d 3h Qs]
INSP!RON: bets $1.60
scaredsare: calls $1.60
*** TURN *** [6d 3h Qs] [3s]
INSP!RON: checks 
scaredsare: checks 
*** RIVER *** [6d 3h Qs 3s] [Td]
INSP!RON: checks 
scaredsare: checks 
*** SHOW DOWN ***
INSP!RON: shows [Ah 5h] (a pair of Threes)
scaredsare: shows [9d 9s] (two pair, Nines and Threes)
scaredsare collected $5.31 from pot
*** SUMMARY ***
Total pot $5.56 | Rake $0.25 
Board [6d 3h Qs 3s Td]
Seat 1: kwkim73 (button) folded before Flop (didn't bet)
Seat 2: 1Karina1 (small blind) folded before Flop
Seat 3: INSP!RON (big blind) showed [Ah 5h] and lost with a pair of Threes
Seat 4: Nerkit folded before Flop (didn't bet)
Seat 5: Cripple86 folded before Flop (didn't bet)
Seat 6: kesstukas25 folded before Flop (didn't bet)
Seat 7: chiyuki folded before Flop (didn't bet)
Seat 8: scaredsare showed [9d 9s] and won ($5.31) with two pair, Nines and Threes
Seat 9: nice.franki folded before Flop (didn't bet)



PokerStars Zoom Hand #84301198750:  Hold'em No Limit ($0.10/$0.25) - 2012/08/05 16:18:15 JST [2012/08/05 3:18:15 ET]
Table 'Whirlpool' 9-max Seat #1 is the button
Seat 1: men1989 ($22.67 in chips) 
Seat 2: masterkoolb ($12.50 in chips) 
Seat 3: nice.franki ($12.07 in chips) 
Seat 4: FoRlan77 ($25.35 in chips) 
Seat 5: deepakmbh ($30.08 in chips) 
Seat 6: kwkim73 ($25.45 in chips) 
Seat 7: top gun 2950 ($35.46 in chips) 
Seat 8: 4plankton ($3.48 in chips) 
Seat 9: chiyuki ($36.18 in chips) 
masterkoolb: posts small blind $0.10
nice.franki: posts big blind $0.25
*** HOLE CARDS ***
Dealt to chiyuki [Ac 4s]
FoRlan77: folds 
deepakmbh: folds 
kwkim73: folds 
top gun 2950: folds 
4plankton: folds 
chiyuki: folds 
men1989: raises $0.50 to $0.75
masterkoolb: folds 
nice.franki: folds 
Uncalled bet ($0.50) returned to men1989
men1989 collected $0.60 from pot
men1989: doesn't show hand 
*** SUMMARY ***
Total pot $0.60 | Rake $0 
Seat 1: men1989 (button) collected ($0.60)
Seat 2: masterkoolb (small blind) folded before Flop
Seat 3: nice.franki (big blind) folded before Flop
Seat 4: FoRlan77 folded before Flop (didn't bet)
Seat 5: deepakmbh folded before Flop (didn't bet)
Seat 6: kwkim73 folded before Flop (didn't bet)
Seat 7: top gun 2950 folded before Flop (didn't bet)
Seat 8: 4plankton folded before Flop (didn't bet)
Seat 9: chiyuki folded before Flop (didn't bet)



PokerStars Zoom Hand #84301190381:  Hold'em No Limit ($0.10/$0.25) - 2012/08/05 16:17:45 JST [2012/08/05 3:17:45 ET]
Table 'Whirlpool' 9-max Seat #1 is the button
Seat 1: Dejacob ($27.32 in chips) 
Seat 2: chiyuki ($36.28 in chips) 
Seat 3: Angi858 ($25.47 in chips) 
Seat 4: Cripple86 ($25.59 in chips) 
Seat 5: olligol123 ($27.51 in chips) 
Seat 6: Perstenev ($8.80 in chips) 
Seat 7: nice.franki ($12.15 in chips) 
Seat 8: FoRlan77 ($25 in chips) 
Seat 9: Ih8niknames ($20 in chips) 
chiyuki: posts small blind $0.10
Angi858: posts big blind $0.25
*** HOLE CARDS ***
Dealt to chiyuki [Ac Jc]
Cripple86: folds 
olligol123: raises $0.50 to $0.75
Perstenev: folds 
nice.franki: folds 
FoRlan77: raises $1.50 to $2.25
Ih8niknames: folds 
Dejacob: folds 
chiyuki: folds 
Angi858: folds 
olligol123: folds 
Uncalled bet ($1.50) returned to FoRlan77
FoRlan77 collected $1.85 from pot
FoRlan77: doesn't show hand 
*** SUMMARY ***
Total pot $1.85 | Rake $0 
Seat 1: Dejacob (button) folded before Flop (didn't bet)
Seat 2: chiyuki (small blind) folded before Flop
Seat 3: Angi858 (big blind) folded before Flop
Seat 4: Cripple86 folded before Flop (didn't bet)
Seat 5: olligol123 folded before Flop
Seat 6: Perstenev folded before Flop (didn't bet)
Seat 7: nice.franki folded before Flop (didn't bet)
Seat 8: FoRlan77 collected ($1.85)
Seat 9: Ih8niknames folded before Flop (didn't bet)



PokerStars Zoom Hand #84301196821:  Hold'em No Limit ($0.10/$0.25) - 2012/08/05 16:18:08 JST [2012/08/05 3:18:08 ET]
Table 'Whirlpool' 9-max Seat #1 is the button
Seat 1: chiyuki ($36.18 in chips) 
Seat 2: mjmichi ($87.49 in chips) 
Seat 3: GSDP ($23.75 in chips) 
Seat 4: Alvinpe85 ($31.22 in chips) 
Seat 5: Patient90122 ($26.87 in chips) 
Seat 6: Cripple86 ($31.97 in chips) 
Seat 7: silvno31 ($67.29 in chips) 
Seat 8: opie62 ($19.16 in chips) 
Seat 9: benjuer ($25.47 in chips) 
mjmichi: posts small blind $0.10
GSDP: posts big blind $0.25
*** HOLE CARDS ***
Dealt to chiyuki [5s 4c]
Alvinpe85: folds 
Patient90122: folds 
Cripple86: folds 
silvno31: folds 
opie62: folds 
benjuer: folds 
chiyuki: folds 
mjmichi: folds 
Uncalled bet ($0.15) returned to GSDP
GSDP collected $0.20 from pot
GSDP: doesn't show hand 
*** SUMMARY ***
Total pot $0.20 | Rake $0 
Seat 1: chiyuki (button) folded before Flop (didn't bet)
Seat 2: mjmichi (small blind) folded before Flop
Seat 3: GSDP (big blind) collected ($0.20)
Seat 4: Alvinpe85 folded before Flop (didn't bet)
Seat 5: Patient90122 folded before Flop (didn't bet)
Seat 6: Cripple86 folded before Flop (didn't bet)
Seat 7: silvno31 folded before Flop (didn't bet)
Seat 8: opie62 folded before Flop (didn't bet)
Seat 9: benjuer folded before Flop (didn't bet)



PokerStars Zoom Hand #84301200394:  Hold'em No Limit ($0.10/$0.25) - 2012/08/05 16:18:21 JST [2012/08/05 3:18:21 ET]
Table 'Whirlpool' 9-max Seat #1 is the button
Seat 1: benjuer ($25.47 in chips) 
Seat 2: GovGus ($42.85 in chips) 
Seat 3: chiyuki ($36.18 in chips) 
Seat 4: Dejacob ($26.57 in chips) 
Seat 5: kwkim73 ($25.45 in chips) 
Seat 6: Bondvsta ($26.30 in chips) 
Seat 7: Wolfgang03 ($23.90 in chips) 
Seat 8: RRMM_again ($25.04 in chips) 
Seat 9: Cripple86 ($25.84 in chips) 
GovGus: posts small blind $0.10
chiyuki: posts big blind $0.25
*** HOLE CARDS ***
Dealt to chiyuki [4c Jc]
Dejacob: folds 
kwkim73: folds 
Bondvsta: folds 
Wolfgang03 has timed out while disconnected
Wolfgang03: folds 
RRMM_again: raises $0.50 to $0.75
Cripple86: folds 
benjuer: folds 
GovGus: folds 
chiyuki: folds 
Uncalled bet ($0.50) returned to RRMM_again
RRMM_again collected $0.60 from pot
RRMM_again: doesn't show hand 
*** SUMMARY ***
Total pot $0.60 | Rake $0 
Seat 1: benjuer (button) folded before Flop (didn't bet)
Seat 2: GovGus (small blind) folded before Flop
Seat 3: chiyuki (big blind) folded before Flop
Seat 4: Dejacob folded before Flop (didn't bet)
Seat 5: kwkim73 folded before Flop (didn't bet)
Seat 6: Bondvsta folded before Flop (didn't bet)
Seat 7: Wolfgang03 folded before Flop (didn't bet)
Seat 8: RRMM_again collected ($0.60)
Seat 9: Cripple86 folded before Flop (didn't bet)



PokerStars Zoom Hand #84301209825:  Hold'em No Limit ($0.10/$0.25) - 2012/08/05 16:18:56 JST [2012/08/05 3:18:56 ET]
Table 'Whirlpool' 9-max Seat #1 is the button
Seat 1: FoRlan77 ($26 in chips) 
Seat 2: Dejacob ($32.73 in chips) 
Seat 3: risekuku468 ($30.21 in chips) 
Seat 4: 1Karina1 ($29.99 in chips) 
Seat 5: Blue-GumBum ($12.35 in chips) 
Seat 6: Patient90122 ($26.52 in chips) 
Seat 7: phate-1up ($34.53 in chips) 
Seat 8: chiyuki ($35.93 in chips) 
Seat 9: mungroo ($23.55 in chips) 
Dejacob: posts small blind $0.10
risekuku468: posts big blind $0.25
*** HOLE CARDS ***
Dealt to chiyuki [8s 6h]
1Karina1: folds 
Blue-GumBum: folds 
Patient90122: folds 
phate-1up: folds 
chiyuki: folds 
mungroo: folds 
FoRlan77: folds 
Dejacob: folds 
Uncalled bet ($0.15) returned to risekuku468
risekuku468 collected $0.20 from pot
risekuku468: doesn't show hand 
*** SUMMARY ***
Total pot $0.20 | Rake $0 
Seat 1: FoRlan77 (button) folded before Flop (didn't bet)
Seat 2: Dejacob (small blind) folded before Flop
Seat 3: risekuku468 (big blind) collected ($0.20)
Seat 4: 1Karina1 folded before Flop (didn't bet)
Seat 5: Blue-GumBum folded before Flop (didn't bet)
Seat 6: Patient90122 folded before Flop (didn't bet)
Seat 7: phate-1up folded before Flop (didn't bet)
Seat 8: chiyuki folded before Flop (didn't bet)
Seat 9: mungroo folded before Flop (didn't bet)



PokerStars Zoom Hand #84301210622:  Hold'em No Limit ($0.10/$0.25) - 2012/08/05 16:18:59 JST [2012/08/05 3:18:59 ET]
Table 'Whirlpool' 9-max Seat #1 is the button
Seat 1: kwkim73 ($45.12 in chips) 
Seat 2: Kozyavkin ($5.28 in chips) 
Seat 3: INSP!RON ($25 in chips) 
Seat 4: chiyuki ($35.93 in chips) 
Seat 5: new85new85 ($24.75 in chips) 
Seat 6: Alvinpe85 ($104.78 in chips) 
Seat 7: Perstenev ($8.45 in chips) 
Seat 8: GovGus ($42.75 in chips) 
Seat 9: Cripple86 ($26.46 in chips) 
Kozyavkin: posts small blind $0.10
INSP!RON: posts big blind $0.25
*** HOLE CARDS ***
Dealt to chiyuki [Ah 4s]
chiyuki: folds 
new85new85: calls $0.25
Alvinpe85: folds 
Perstenev: folds 
GovGus: folds 
Cripple86: folds 
kwkim73: raises $0.85 to $1.10
Kozyavkin: folds 
INSP!RON: folds 
new85new85: folds 
Uncalled bet ($0.85) returned to kwkim73
kwkim73 collected $0.85 from pot
kwkim73: doesn't show hand 
kwkim73 is disconnected 
*** SUMMARY ***
Total pot $0.85 | Rake $0 
Seat 1: kwkim73 (button) collected ($0.85)
Seat 2: Kozyavkin (small blind) folded before Flop
Seat 3: INSP!RON (big blind) folded before Flop
Seat 4: chiyuki folded before Flop (didn't bet)
Seat 5: new85new85 folded before Flop
Seat 6: Alvinpe85 folded before Flop (didn't bet)
Seat 7: Perstenev folded before Flop (didn't bet)
Seat 8: GovGus folded before Flop (didn't bet)
Seat 9: Cripple86 folded before Flop (didn't bet)



PokerStars Zoom Hand #84301212006:  Hold'em No Limit ($0.10/$0.25) - 2012/08/05 16:19:04 JST [2012/08/05 3:19:04 ET]
Table 'Whirlpool' 9-max Seat #1 is the button
Seat 1: Ellen1947 ($21.42 in chips) 
Seat 2: chiyuki ($35.93 in chips) 
Seat 3: Cripple86 ($26.46 in chips) 
Seat 4: men1989 ($23.02 in chips) 
Seat 5: Kozyavkin ($5.18 in chips) 
Seat 6: AntoineHunt ($14.52 in chips) 
Seat 7: Grishukps ($13.18 in chips) 
Seat 8: phate-1up ($34.53 in chips) 
Seat 9: Femali54 ($26.63 in chips) 
chiyuki: posts small blind $0.10
Cripple86: posts big blind $0.25
*** HOLE CARDS ***
Dealt to chiyuki [Ac 6s]
men1989: folds 
Kozyavkin: folds 
AntoineHunt: folds 
Grishukps: raises $0.50 to $0.75
phate-1up: folds 
Femali54: folds 
Ellen1947: folds 
chiyuki: folds 
Cripple86: folds 
Uncalled bet ($0.50) returned to Grishukps
Grishukps collected $0.60 from pot
Grishukps: doesn't show hand 
*** SUMMARY ***
Total pot $0.60 | Rake $0 
Seat 1: Ellen1947 (button) folded before Flop (didn't bet)
Seat 2: chiyuki (small blind) folded before Flop
Seat 3: Cripple86 (big blind) folded before Flop
Seat 4: men1989 folded before Flop (didn't bet)
Seat 5: Kozyavkin folded before Flop (didn't bet)
Seat 6: AntoineHunt folded before Flop (didn't bet)
Seat 7: Grishukps collected ($0.60)
Seat 8: phate-1up folded before Flop (didn't bet)
Seat 9: Femali54 folded before Flop (didn't bet)



PokerStars Zoom Hand #84301214528:  Hold'em No Limit ($0.10/$0.25) - 2012/08/05 16:19:13 JST [2012/08/05 3:19:13 ET]
Table 'Whirlpool' 9-max Seat #1 is the button
Seat 1: wildy29 ($106.05 in chips) 
Seat 2: Vall179 ($31.04 in chips) 
Seat 3: nice.franki ($12.63 in chips) 
Seat 4: d4dda ($28.03 in chips) 
Seat 5: chiyuki ($35.83 in chips) 
Seat 6: MurMurRu ($41.49 in chips) 
Seat 7: mamlind ($12.95 in chips) 
Seat 8: Dejacob ($36.24 in chips) 
Seat 9: deepakmbh ($28.20 in chips) 
Vall179: posts small blind $0.10
nice.franki: posts big blind $0.25
*** HOLE CARDS ***
Dealt to chiyuki [9s 6d]
d4dda: folds 
chiyuki: folds 
MurMurRu: folds 
mamlind: folds 
Dejacob: folds 
deepakmbh: folds 
wildy29: folds 
Vall179: folds 
Uncalled bet ($0.15) returned to nice.franki
nice.franki collected $0.20 from pot
nice.franki: doesn't show hand 
*** SUMMARY ***
Total pot $0.20 | Rake $0 
Seat 1: wildy29 (button) folded before Flop (didn't bet)
Seat 2: Vall179 (small blind) folded before Flop
Seat 3: nice.franki (big blind) collected ($0.20)
Seat 4: d4dda folded before Flop (didn't bet)
Seat 5: chiyuki folded before Flop (didn't bet)
Seat 6: MurMurRu folded before Flop (didn't bet)
Seat 7: mamlind folded before Flop (didn't bet)
Seat 8: Dejacob folded before Flop (didn't bet)
Seat 9: deepakmbh folded before Flop (didn't bet)



PokerStars Zoom Hand #84301220066:  Hold'em No Limit ($0.10/$0.25) - 2012/08/05 16:19:33 JST [2012/08/05 3:19:33 ET]
Table 'Whirlpool' 9-max Seat #1 is the button
Seat 1: chiyuki ($35.83 in chips) 
Seat 2: benjuer ($50.47 in chips) 
Seat 3: dlogic27 ($15 in chips) 
Seat 4: FoRlan77 ($26 in chips) 
Seat 5: Loholov ($16.01 in chips) 
Seat 6: RRMM_again ($24.65 in chips) 
Seat 7: men1989 ($21.92 in chips) 
Seat 8: tribunpdm ($75.48 in chips) 
Seat 9: 4plankton ($4.29 in chips) 
benjuer: posts small blind $0.10
dlogic27: posts big blind $0.25
*** HOLE CARDS ***
Dealt to chiyuki [5s As]
FoRlan77: folds 
Loholov: folds 
RRMM_again: folds 
men1989: folds 
tribunpdm: raises $0.50 to $0.75
4plankton: folds 
chiyuki: folds 
benjuer: folds 
dlogic27: folds 
Uncalled bet ($0.50) returned to tribunpdm
tribunpdm collected $0.60 from pot
tribunpdm: doesn't show hand 
*** SUMMARY ***
Total pot $0.60 | Rake $0 
Seat 1: chiyuki (button) folded before Flop (didn't bet)
Seat 2: benjuer (small blind) folded before Flop
Seat 3: dlogic27 (big blind) folded before Flop
Seat 4: FoRlan77 folded before Flop (didn't bet)
Seat 5: Loholov folded before Flop (didn't bet)
Seat 6: RRMM_again folded before Flop (didn't bet)
Seat 7: men1989 folded before Flop (didn't bet)
Seat 8: tribunpdm collected ($0.60)
Seat 9: 4plankton folded before Flop (didn't bet)



PokerStars Zoom Hand #84301217547:  Hold'em No Limit ($0.10/$0.25) - 2012/08/05 16:19:24 JST [2012/08/05 3:19:24 ET]
Table 'Whirlpool' 9-max Seat #1 is the button
Seat 1: Angi858 ($23.83 in chips) 
Seat 2: yoube ($98.78 in chips) 
Seat 3: laurentzu84 ($48.13 in chips) 
Seat 4: chiyuki ($35.83 in chips) 
Seat 5: 1Karina1 ($47.89 in chips) 
Seat 6: Faantomace ($42.04 in chips) 
Seat 7: new85new85 ($24.05 in chips) 
Seat 8: slapshot2011 ($45.38 in chips) 
Seat 9: AAT Shark ($12.50 in chips) 
yoube: posts small blind $0.10
laurentzu84: posts big blind $0.25
*** HOLE CARDS ***
Dealt to chiyuki [3c Kc]
chiyuki: folds 
1Karina1: folds 
Faantomace: folds 
new85new85: folds 
slapshot2011: folds 
AAT Shark: raises $0.37 to $0.62
Angi858: folds 
yoube: folds 
laurentzu84: calls $0.37
*** FLOP *** [Tc Qs Ah]
laurentzu84: checks 
AAT Shark: bets $1.15
laurentzu84: folds 
Uncalled bet ($1.15) returned to AAT Shark
AAT Shark collected $1.28 from pot
AAT Shark: doesn't show hand 
*** SUMMARY ***
Total pot $1.34 | Rake $0.06 
Board [Tc Qs Ah]
Seat 1: Angi858 (button) folded before Flop (didn't bet)
Seat 2: yoube (small blind) folded before Flop
Seat 3: laurentzu84 (big blind) folded on the Flop
Seat 4: chiyuki folded before Flop (didn't bet)
Seat 5: 1Karina1 folded before Flop (didn't bet)
Seat 6: Faantomace folded before Flop (didn't bet)
Seat 7: new85new85 folded before Flop (didn't bet)
Seat 8: slapshot2011 folded before Flop (didn't bet)
Seat 9: AAT Shark collected ($1.28)



PokerStars Zoom Hand #84301216713:  Hold'em No Limit ($0.10/$0.25) - 2012/08/05 16:19:21 JST [2012/08/05 3:19:21 ET]
Table 'Whirlpool' 9-max Seat #1 is the button
Seat 1: masterkoolb ($12.50 in chips) 
Seat 2: Lasutchik ($32.64 in chips) 
Seat 3: Grishukps ($13.53 in chips) 
Seat 4: pandaaaaaa ($14.88 in chips) 
Seat 5: nice.franki ($11.80 in chips) 
Seat 6: Loholov ($16.01 in chips) 
Seat 7: chiyuki ($35.83 in chips) 
Seat 8: DrunkTyphoon ($33.11 in chips) 
Seat 9: teaser07 ($26.92 in chips) 
Lasutchik: posts small blind $0.10
Grishukps: posts big blind $0.25
*** HOLE CARDS ***
Dealt to chiyuki [7c 4s]
pandaaaaaa: raises $0.75 to $1
nice.franki: folds 
Loholov: folds 
chiyuki: folds 
DrunkTyphoon: folds 
teaser07: folds 
masterkoolb: calls $1
Lasutchik: folds 
Grishukps: folds 
*** FLOP *** [5s 3d 7d]
pandaaaaaa: checks 
masterkoolb: checks 
*** TURN *** [5s 3d 7d] [9c]
pandaaaaaa: checks 
masterkoolb: checks 
*** RIVER *** [5s 3d 7d 9c] [6h]
pandaaaaaa: checks 
masterkoolb: checks 
*** SHOW DOWN ***
pandaaaaaa: shows [As Kd] (high card Ace)
masterkoolb: mucks hand 
pandaaaaaa collected $2.24 from pot
*** SUMMARY ***
Total pot $2.35 | Rake $0.11 
Board [5s 3d 7d 9c 6h]
Seat 1: masterkoolb (button) mucked [Ah Qc]
Seat 2: Lasutchik (small blind) folded before Flop
Seat 3: Grishukps (big blind) folded before Flop
Seat 4: pandaaaaaa showed [As Kd] and won ($2.24) with high card Ace
Seat 5: nice.franki folded before Flop (didn't bet)
Seat 6: Loholov folded before Flop (didn't bet)
Seat 7: chiyuki folded before Flop (didn't bet)
Seat 8: DrunkTyphoon folded before Flop (didn't bet)
Seat 9: teaser07 folded before Flop (didn't bet)



PokerStars Zoom Hand #84301218689:  Hold'em No Limit ($0.10/$0.25) - 2012/08/05 16:19:28 JST [2012/08/05 3:19:28 ET]
Table 'Whirlpool' 9-max Seat #1 is the button
Seat 1: AAT Shark ($12.50 in chips) 
Seat 2: men1989 ($22.02 in chips) 
Seat 3: Lindikor ($13.35 in chips) 
Seat 4: masterkoolb ($17.42 in chips) 
Seat 5: chiyuki ($35.83 in chips) 
Seat 6: Vall179 ($37.05 in chips) 
Seat 7: tribunpdm ($75.48 in chips) 
Seat 8: Serge Claws ($65.69 in chips) 
Seat 9: fwnaf ($30.93 in chips) 
men1989: posts small blind $0.10
Lindikor: posts big blind $0.25
*** HOLE CARDS ***
Dealt to chiyuki [9s Ac]
masterkoolb: folds 
chiyuki: folds 
Vall179: folds 
tribunpdm: folds 
Serge Claws: folds 
fwnaf: calls $0.25
AAT Shark: raises $0.85 to $1.10
men1989: folds 
Lindikor: folds 
fwnaf: calls $0.85
*** FLOP *** [7h Ah As]
fwnaf: checks 
AAT Shark: bets $2.19
fwnaf: folds 
Uncalled bet ($2.19) returned to AAT Shark
AAT Shark collected $2.44 from pot
AAT Shark: doesn't show hand 
*** SUMMARY ***
Total pot $2.55 | Rake $0.11 
Board [7h Ah As]
Seat 1: AAT Shark (button) collected ($2.44)
Seat 2: men1989 (small blind) folded before Flop
Seat 3: Lindikor (big blind) folded before Flop
Seat 4: masterkoolb folded before Flop (didn't bet)
Seat 5: chiyuki folded before Flop (didn't bet)
Seat 6: Vall179 folded before Flop (didn't bet)
Seat 7: tribunpdm folded before Flop (didn't bet)
Seat 8: Serge Claws folded before Flop (didn't bet)
Seat 9: fwnaf folded on the Flop



PokerStars Zoom Hand #84301226397:  Hold'em No Limit ($0.10/$0.25) - 2012/08/05 16:19:56 JST [2012/08/05 3:19:56 ET]
Table 'Whirlpool' 9-max Seat #1 is the button
Seat 1: masterkoolb ($17.42 in chips) 
Seat 2: kesstukas25 ($36.59 in chips) 
Seat 3: Loholov ($21.04 in chips) 
Seat 4: munky3 ($26.61 in chips) 
Seat 5: wildy29 ($105.55 in chips) 
Seat 6: tribunpdm ($75.83 in chips) 
Seat 7: new85new85 ($23.55 in chips) 
Seat 8: FoRlan77 ($25 in chips) 
Seat 9: chiyuki ($35.83 in chips) 
kesstukas25: posts small blind $0.10
Loholov: posts big blind $0.25
*** HOLE CARDS ***
Dealt to chiyuki [4s 4h]
munky3: folds 
wildy29: raises $0.50 to $0.75
tribunpdm: folds 
new85new85: folds 
FoRlan77: folds 
chiyuki: folds 
masterkoolb: folds 
kesstukas25: folds 
Loholov: folds 
Uncalled bet ($0.50) returned to wildy29
wildy29 collected $0.60 from pot
wildy29: doesn't show hand 
*** SUMMARY ***
Total pot $0.60 | Rake $0 
Seat 1: masterkoolb (button) folded before Flop (didn't bet)
Seat 2: kesstukas25 (small blind) folded before Flop
Seat 3: Loholov (big blind) folded before Flop
Seat 4: munky3 folded before Flop (didn't bet)
Seat 5: wildy29 collected ($0.60)
Seat 6: tribunpdm folded before Flop (didn't bet)
Seat 7: new85new85 folded before Flop (didn't bet)
Seat 8: FoRlan77 folded before Flop (didn't bet)
Seat 9: chiyuki folded before Flop (didn't bet)



PokerStars Zoom Hand #84301228928:  Hold'em No Limit ($0.10/$0.25) - 2012/08/05 16:20:06 JST [2012/08/05 3:20:06 ET]
Table 'Whirlpool' 9-max Seat #1 is the button
Seat 1: Grishukps ($12.85 in chips) 
Seat 2: Loholov ($15.76 in chips) 
Seat 3: 4ydo yogurt ($61.02 in chips) 
Seat 4: Dejacob ($33.87 in chips) 
Seat 5: GovGus ($41.46 in chips) 
Seat 6: chiyuki ($35.83 in chips) 
Seat 7: drunk_bender ($28.51 in chips) 
Seat 8: nice.franki ($11.45 in chips) 
Seat 9: munky3 ($26.61 in chips) 
Loholov: posts small blind $0.10
4ydo yogurt: posts big blind $0.25
*** HOLE CARDS ***
Dealt to chiyuki [9h Qs]
Dejacob: folds 
GovGus: folds 
chiyuki: folds 
drunk_bender: folds 
nice.franki: folds 
munky3: calls $0.25
Grishukps: folds 
Loholov: folds 
4ydo yogurt: checks 
*** FLOP *** [Ad 6c Kc]
4ydo yogurt: bets $0.28
munky3: folds 
Uncalled bet ($0.28) returned to 4ydo yogurt
4ydo yogurt collected $0.57 from pot
4ydo yogurt: doesn't show hand 
*** SUMMARY ***
Total pot $0.60 | Rake $0.03 
Board [Ad 6c Kc]
Seat 1: Grishukps (button) folded before Flop (didn't bet)
Seat 2: Loholov (small blind) folded before Flop
Seat 3: 4ydo yogurt (big blind) collected ($0.57)
Seat 4: Dejacob folded before Flop (didn't bet)
Seat 5: GovGus folded before Flop (didn't bet)
Seat 6: chiyuki folded before Flop (didn't bet)
Seat 7: drunk_bender folded before Flop (didn't bet)
Seat 8: nice.franki folded before Flop (didn't bet)
Seat 9: munky3 folded on the Flop



PokerStars Zoom Hand #84301231343:  Hold'em No Limit ($0.10/$0.25) - 2012/08/05 16:20:15 JST [2012/08/05 3:20:15 ET]
Table 'Whirlpool' 9-max Seat #1 is the button
Seat 1: mjmichi ($26.17 in chips) 
Seat 2: chiyuki ($35.83 in chips) 
Seat 3: hldtom ($17.61 in chips) 
Seat 4: leo2095 ($27.68 in chips) 
Seat 5: nice.franki ($14.48 in chips) 
Seat 6: Cripple86 ($25.36 in chips) 
Seat 7: KeLevro0 ($12.15 in chips) 
Seat 8: roksmokndonk ($16.05 in chips) 
Seat 9: TorTrade ($31.93 in chips) 
chiyuki: posts small blind $0.10
hldtom: posts big blind $0.25
*** HOLE CARDS ***
Dealt to chiyuki [6d 9d]
leo2095: raises $0.50 to $0.75
nice.franki: folds 
Cripple86: folds 
KeLevro0: raises $1.75 to $2.50
roksmokndonk: folds 
TorTrade: folds 
mjmichi: folds 
chiyuki: folds 
hldtom: folds 
leo2095: calls $1.75
*** FLOP *** [2s 5h 7d]
leo2095: checks 
KeLevro0: bets $2.86
leo2095: folds 
Uncalled bet ($2.86) returned to KeLevro0
KeLevro0 collected $5.11 from pot
KeLevro0: doesn't show hand 
*** SUMMARY ***
Total pot $5.35 | Rake $0.24 
Board [2s 5h 7d]
Seat 1: mjmichi (button) folded before Flop (didn't bet)
Seat 2: chiyuki (small blind) folded before Flop
Seat 3: hldtom (big blind) folded before Flop
Seat 4: leo2095 folded on the Flop
Seat 5: nice.franki folded before Flop (didn't bet)
Seat 6: Cripple86 folded before Flop (didn't bet)
Seat 7: KeLevro0 collected ($5.11)
Seat 8: roksmokndonk folded before Flop (didn't bet)
Seat 9: TorTrade folded before Flop (didn't bet)



PokerStars Zoom Hand #84301224466:  Hold'em No Limit ($0.10/$0.25) - 2012/08/05 16:19:49 JST [2012/08/05 3:19:49 ET]
Table 'Whirlpool' 9-max Seat #1 is the button
Seat 1: new85new85 ($23.55 in chips) 
Seat 2: dlogic27 ($14.75 in chips) 
Seat 3: Blue-GumBum ($13.49 in chips) 
Seat 4: Grishukps ($13.28 in chips) 
Seat 5: d4dda ($28.38 in chips) 
Seat 6: mungroo ($24.57 in chips) 
Seat 7: seula i ($39.70 in chips) 
Seat 8: chiyuki ($35.83 in chips) 
Seat 9: drunk_bender ($28.61 in chips) 
dlogic27: posts small blind $0.10
Blue-GumBum: posts big blind $0.25
*** HOLE CARDS ***
Dealt to chiyuki [Kh 5c]
Grishukps: raises $0.50 to $0.75
d4dda: folds 
mungroo: folds 
seula i: folds 
chiyuki: folds 
drunk_bender: folds 
new85new85: folds 
dlogic27: folds 
Blue-GumBum: calls $0.50
*** FLOP *** [9s 8s Ts]
Blue-GumBum: checks 
Grishukps: bets $1.10
Blue-GumBum: calls $1.10
*** TURN *** [9s 8s Ts] [9d]
Blue-GumBum: checks 
Grishukps: bets $2.40
Blue-GumBum: calls $2.40
*** RIVER *** [9s 8s Ts 9d] [9h]
Blue-GumBum: checks 
Grishukps: checks 
*** SHOW DOWN ***
Blue-GumBum: shows [Js Kc] (three of a kind, Nines)
Grishukps: shows [Th Td] (a full house, Tens full of Nines)
Grishukps collected $8.21 from pot
*** SUMMARY ***
Total pot $8.60 | Rake $0.39 
Board [9s 8s Ts 9d 9h]
Seat 1: new85new85 (button) folded before Flop (didn't bet)
Seat 2: dlogic27 (small blind) folded before Flop
Seat 3: Blue-GumBum (big blind) showed [Js Kc] and lost with three of a kind, Nines
Seat 4: Grishukps showed [Th Td] and won ($8.21) with a full house, Tens full of Nines
Seat 5: d4dda folded before Flop (didn't bet)
Seat 6: mungroo folded before Flop (didn't bet)
Seat 7: seula i folded before Flop (didn't bet)
Seat 8: chiyuki folded before Flop (didn't bet)
Seat 9: drunk_bender folded before Flop (didn't bet)



PokerStars Zoom Hand #84301242157:  Hold'em No Limit ($0.10/$0.25) - 2012/08/05 16:20:54 JST [2012/08/05 3:20:54 ET]
Table 'Whirlpool' 9-max Seat #1 is the button
Seat 1: dlogic27 ($14.40 in chips) 
Seat 2: Grishukps ($12.50 in chips) 
Seat 3: new85new85 ($23.30 in chips) 
Seat 4: KeLevro0 ($12.15 in chips) 
Seat 5: chiyuki ($35.48 in chips) 
Seat 6: Limoilou ($32.36 in chips) 
Seat 7: Cripple86 ($25.11 in chips) 
Seat 8: xxx Spb xxx ($33.76 in chips) 
Seat 9: <BlaaKKnite> ($36.40 in chips) 
Grishukps: posts small blind $0.10
new85new85: posts big blind $0.25
*** HOLE CARDS ***
Dealt to chiyuki [7h 2h]
KeLevro0: folds 
chiyuki: folds 
Limoilou: folds 
Cripple86: folds 
xxx Spb xxx: folds 
<BlaaKKnite>: folds 
dlogic27: folds 
Grishukps: raises $0.37 to $0.62
new85new85: folds 
Uncalled bet ($0.37) returned to Grishukps
Grishukps collected $0.50 from pot
Grishukps: doesn't show hand 
*** SUMMARY ***
Total pot $0.50 | Rake $0 
Seat 1: dlogic27 (button) folded before Flop (didn't bet)
Seat 2: Grishukps (small blind) collected ($0.50)
Seat 3: new85new85 (big blind) folded before Flop
Seat 4: KeLevro0 folded before Flop (didn't bet)
Seat 5: chiyuki folded before Flop (didn't bet)
Seat 6: Limoilou folded before Flop (didn't bet)
Seat 7: Cripple86 folded before Flop (didn't bet)
Seat 8: xxx Spb xxx folded before Flop (didn't bet)
Seat 9: <BlaaKKnite> folded before Flop (didn't bet)



PokerStars Zoom Hand #84301232784:  Hold'em No Limit ($0.10/$0.25) - 2012/08/05 16:20:20 JST [2012/08/05 3:20:20 ET]
Table 'Whirlpool' 9-max Seat #1 is the button
Seat 1: DrunkTyphoon ($32.86 in chips) 
Seat 2: Vall179 ($36.80 in chips) 
Seat 3: chiyuki ($35.73 in chips) 
Seat 4: codan23 ($14.27 in chips) 
Seat 5: Lindikor ($12.48 in chips) 
Seat 6: roksmokndonk ($16.05 in chips) 
Seat 7: teaser07 ($26.92 in chips) 
Seat 8: TorTrade ($31.93 in chips) 
Seat 9: nice.franki ($14.48 in chips) 
Vall179: posts small blind $0.10
chiyuki: posts big blind $0.25
*** HOLE CARDS ***
Dealt to chiyuki [3h Th]
codan23: folds 
Lindikor: folds 
roksmokndonk: folds 
teaser07: raises $0.50 to $0.75
TorTrade: folds 
nice.franki: folds 
DrunkTyphoon: calls $0.75
Vall179: folds 
chiyuki: folds 
*** FLOP *** [Qd 3d Qh]
teaser07: bets $1.06
DrunkTyphoon: calls $1.06
*** TURN *** [Qd 3d Qh] [9h]
teaser07: checks 
DrunkTyphoon: bets $1.89
teaser07: calls $1.89
*** RIVER *** [Qd 3d Qh 9h] [Qs]
teaser07: checks 
DrunkTyphoon: checks 
*** SHOW DOWN ***
teaser07: shows [Jh Jc] (a full house, Queens full of Jacks)
DrunkTyphoon: mucks hand 
teaser07 collected $7.40 from pot
*** SUMMARY ***
Total pot $7.75 | Rake $0.35 
Board [Qd 3d Qh 9h Qs]
Seat 1: DrunkTyphoon (button) mucked [6h 6d]
Seat 2: Vall179 (small blind) folded before Flop
Seat 3: chiyuki (big blind) folded before Flop
Seat 4: codan23 folded before Flop (didn't bet)
Seat 5: Lindikor folded before Flop (didn't bet)
Seat 6: roksmokndonk folded before Flop (didn't bet)
Seat 7: teaser07 showed [Jh Jc] and won ($7.40) with a full house, Queens full of Jacks
Seat 8: TorTrade folded before Flop (didn't bet)
Seat 9: nice.franki folded before Flop (didn't bet)



PokerStars Zoom Hand #84301244323:  Hold'em No Limit ($0.10/$0.25) - 2012/08/05 16:21:02 JST [2012/08/05 3:21:02 ET]
Table 'Whirlpool' 9-max Seat #1 is the button
Seat 1: Vall179 ($28.70 in chips) 
Seat 2: nice.franki ($0.56 in chips) 
Seat 3: MurMurRu ($27.92 in chips) 
Seat 4: Ellen1947 ($22.10 in chips) 
Seat 5: GSDP ($31.97 in chips) 
Seat 6: chiyuki ($35.48 in chips) 
Seat 7: INSP!RON ($27.06 in chips) 
Seat 8: <BlaaKKnite> ($36.40 in chips) 
Seat 9: seula i ($56.05 in chips) 
nice.franki: posts small blind $0.10
MurMurRu: posts big blind $0.25
*** HOLE CARDS ***
Dealt to chiyuki [4c 9h]
Ellen1947: folds 
GSDP: folds 
chiyuki: folds 
INSP!RON: folds 
<BlaaKKnite>: folds 
seula i: raises $0.50 to $0.75
Vall179: folds 
nice.franki: calls $0.46 and is all-in
MurMurRu: folds 
Uncalled bet ($0.19) returned to seula i
*** FLOP *** [Qs Jh 6h]
*** TURN *** [Qs Jh 6h] [3c]
*** RIVER *** [Qs Jh 6h 3c] [7s]
*** SHOW DOWN ***
nice.franki: shows [Jc Ks] (a pair of Jacks)
seula i: shows [8d 8c] (a pair of Eights)
nice.franki collected $1.31 from pot
*** SUMMARY ***
Total pot $1.37 | Rake $0.06 
Board [Qs Jh 6h 3c 7s]
Seat 1: Vall179 (button) folded before Flop (didn't bet)
Seat 2: nice.franki (small blind) showed [Jc Ks] and won ($1.31) with a pair of Jacks
Seat 3: MurMurRu (big blind) folded before Flop
Seat 4: Ellen1947 folded before Flop (didn't bet)
Seat 5: GSDP folded before Flop (didn't bet)
Seat 6: chiyuki folded before Flop (didn't bet)
Seat 7: INSP!RON folded before Flop (didn't bet)
Seat 8: <BlaaKKnite> folded before Flop (didn't bet)
Seat 9: seula i showed [8d 8c] and lost with a pair of Eights



PokerStars Zoom Hand #84301245733:  Hold'em No Limit ($0.10/$0.25) - 2012/08/05 16:21:07 JST [2012/08/05 3:21:07 ET]
Table 'Whirlpool' 9-max Seat #1 is the button
Seat 1: chiyuki ($35.48 in chips) 
Seat 2: Serge Claws ($41.45 in chips) 
Seat 3: INSP!RON ($29.51 in chips) 
Seat 4: 280128si ($17.19 in chips) 
Seat 5: Grishukps ($12.85 in chips) 
Seat 6: AAT Shark ($13.16 in chips) 
Seat 7: seula i ($38.95 in chips) 
Seat 8: new85new85 ($23.65 in chips) 
Seat 9: KeLevro0 ($12.15 in chips) 
Serge Claws: posts small blind $0.10
INSP!RON: posts big blind $0.25
*** HOLE CARDS ***
Dealt to chiyuki [Qs Td]
280128si: folds 
Grishukps: folds 
AAT Shark: folds 
seula i: folds 
new85new85: folds 
KeLevro0: folds 
chiyuki: raises $0.50 to $0.75
Serge Claws: folds 
INSP!RON: raises $1.95 to $2.70
chiyuki: folds 
Uncalled bet ($1.95) returned to INSP!RON
INSP!RON collected $1.60 from pot
INSP!RON: doesn't show hand 
*** SUMMARY ***
Total pot $1.60 | Rake $0 
Seat 1: chiyuki (button) folded before Flop
Seat 2: Serge Claws (small blind) folded before Flop
Seat 3: INSP!RON (big blind) collected ($1.60)
Seat 4: 280128si folded before Flop (didn't bet)
Seat 5: Grishukps folded before Flop (didn't bet)
Seat 6: AAT Shark folded before Flop (didn't bet)
Seat 7: seula i folded before Flop (didn't bet)
Seat 8: new85new85 folded before Flop (didn't bet)
Seat 9: KeLevro0 folded before Flop (didn't bet)



