PokerStars Zoom Hand #84298198879:  Hold'em No Limit ($0.10/$0.25) - 2012/08/05 13:00:03 JST [2012/08/05 0:00:03 ET]
Table 'Whirlpool' 9-max Seat #1 is the button
Seat 1: Sharks_Nica ($66.43 in chips) 
Seat 2: polk11 ($23.23 in chips) 
Seat 3: fwani ($26.18 in chips) 
Seat 4: chiyuki ($36.61 in chips) 
Seat 5: softdesign ($23.31 in chips) 
Seat 6: ll_LaMeR_ll ($15.76 in chips) 
Seat 7: Th3Fog ($21.99 in chips) 
Seat 8: TraderYao ($29.15 in chips) 
Seat 9: TErr18 ($20.57 in chips) 
polk11: posts small blind $0.10
fwani: posts big blind $0.25
*** HOLE CARDS ***
Dealt to chiyuki [As Qc]
chiyuki: raises $0.50 to $0.75
softdesign: folds 
ll_LaMeR_ll: folds 
Th3Fog: folds 
TraderYao: folds 
TErr18: folds 
Sharks_Nica: folds 
polk11: folds 
fwani: folds 
Uncalled bet ($0.50) returned to chiyuki
chiyuki collected $0.60 from pot
chiyuki: doesn't show hand 
*** SUMMARY ***
Total pot $0.60 | Rake $0 
Seat 1: Sharks_Nica (button) folded before Flop (didn't bet)
Seat 2: polk11 (small blind) folded before Flop
Seat 3: fwani (big blind) folded before Flop
Seat 4: chiyuki collected ($0.60)
Seat 5: softdesign folded before Flop (didn't bet)
Seat 6: ll_LaMeR_ll folded before Flop (didn't bet)
Seat 7: Th3Fog folded before Flop (didn't bet)
Seat 8: TraderYao folded before Flop (didn't bet)
Seat 9: TErr18 folded before Flop (didn't bet)



PokerStars Zoom Hand #84298204190:  Hold'em No Limit ($0.10/$0.25) - 2012/08/05 13:00:26 JST [2012/08/05 0:00:26 ET]
Table 'Whirlpool' 9-max Seat #1 is the button
Seat 1: Medic8681 ($19.10 in chips) 
Seat 2: AndiM64 ($28.65 in chips) 
Seat 3: Sharks_Nica ($31.77 in chips) 
Seat 4: TankAbbott1 ($24.39 in chips) 
Seat 5: chiyuki ($36.96 in chips) 
Seat 6: doanut13 ($27.82 in chips) 
Seat 7: gunbowler ($96.34 in chips) 
Seat 8: RomarioJa ($11.31 in chips) 
Seat 9: BlOnDhOlIc ($36.61 in chips) 
AndiM64: posts small blind $0.10
Sharks_Nica: posts big blind $0.25
*** HOLE CARDS ***
Dealt to chiyuki [2s Kc]
TankAbbott1: folds 
chiyuki: folds 
doanut13: folds 
gunbowler: folds 
RomarioJa: raises $0.37 to $0.62
BlOnDhOlIc: folds 
Medic8681: folds 
AndiM64: folds 
Sharks_Nica: folds 
Uncalled bet ($0.37) returned to RomarioJa
RomarioJa collected $0.60 from pot
RomarioJa: doesn't show hand 
*** SUMMARY ***
Total pot $0.60 | Rake $0 
Seat 1: Medic8681 (button) folded before Flop (didn't bet)
Seat 2: AndiM64 (small blind) folded before Flop
Seat 3: Sharks_Nica (big blind) folded before Flop
Seat 4: TankAbbott1 folded before Flop (didn't bet)
Seat 5: chiyuki folded before Flop (didn't bet)
Seat 6: doanut13 folded before Flop (didn't bet)
Seat 7: gunbowler folded before Flop (didn't bet)
Seat 8: RomarioJa collected ($0.60)
Seat 9: BlOnDhOlIc folded before Flop (didn't bet)



PokerStars Zoom Hand #84298205333:  Hold'em No Limit ($0.10/$0.25) - 2012/08/05 13:00:31 JST [2012/08/05 0:00:31 ET]
Table 'Whirlpool' 9-max Seat #1 is the button
Seat 1: BlOnDhOlIc ($44.32 in chips) 
Seat 2: TankAbbott1 ($24.39 in chips) 
Seat 3: Th3Fog ($21.99 in chips) 
Seat 4: Ring Circus ($23.12 in chips) 
Seat 5: 1474 BigJohn ($24.27 in chips) 
Seat 6: TErr18 ($20.57 in chips) 
Seat 7: Seadogvcd ($12.84 in chips) 
Seat 8: chiyuki ($36.96 in chips) 
Seat 9: DooMSDaY1337 ($39.19 in chips) 
TankAbbott1: posts small blind $0.10
Th3Fog: posts big blind $0.25
*** HOLE CARDS ***
Dealt to chiyuki [Ad 7d]
Ring Circus: calls $0.25
1474 BigJohn: folds 
TErr18: folds 
Seadogvcd: folds 
chiyuki: folds 
DooMSDaY1337: raises $0.75 to $1
BlOnDhOlIc: folds 
TankAbbott1: folds 
Th3Fog: folds 
Ring Circus: raises $22.12 to $23.12 and is all-in
DooMSDaY1337: folds 
Uncalled bet ($22.12) returned to Ring Circus
Ring Circus collected $2.35 from pot
Ring Circus: doesn't show hand 
*** SUMMARY ***
Total pot $2.35 | Rake $0 
Seat 1: BlOnDhOlIc (button) folded before Flop (didn't bet)
Seat 2: TankAbbott1 (small blind) folded before Flop
Seat 3: Th3Fog (big blind) folded before Flop
Seat 4: Ring Circus collected ($2.35)
Seat 5: 1474 BigJohn folded before Flop (didn't bet)
Seat 6: TErr18 folded before Flop (didn't bet)
Seat 7: Seadogvcd folded before Flop (didn't bet)
Seat 8: chiyuki folded before Flop (didn't bet)
Seat 9: DooMSDaY1337 folded before Flop



PokerStars Zoom Hand #84298207476:  Hold'em No Limit ($0.10/$0.25) - 2012/08/05 13:00:40 JST [2012/08/05 0:00:40 ET]
Table 'Whirlpool' 9-max Seat #1 is the button
Seat 1: fwani ($33.24 in chips) 
Seat 2: slickthis ($23.01 in chips) 
Seat 3: chiyuki ($36.96 in chips) 
Seat 4: simonzez ($30.36 in chips) 
Seat 5: AndiM64 ($28.55 in chips) 
Seat 6: AUGH-AUGH ($33.24 in chips) 
Seat 7: 2997qwer ($12.15 in chips) 
Seat 8: Shugana ($26.14 in chips) 
Seat 9: agurio ($25 in chips) 
slickthis: posts small blind $0.10
chiyuki: posts big blind $0.25
*** HOLE CARDS ***
Dealt to chiyuki [3c 9s]
simonzez: folds 
AndiM64: raises $0.50 to $0.75
AUGH-AUGH: folds 
2997qwer: folds 
Shugana: folds 
agurio: folds 
fwani: folds 
slickthis: folds 
chiyuki: folds 
Uncalled bet ($0.50) returned to AndiM64
AndiM64 collected $0.60 from pot
AndiM64: doesn't show hand 
*** SUMMARY ***
Total pot $0.60 | Rake $0 
Seat 1: fwani (button) folded before Flop (didn't bet)
Seat 2: slickthis (small blind) folded before Flop
Seat 3: chiyuki (big blind) folded before Flop
Seat 4: simonzez folded before Flop (didn't bet)
Seat 5: AndiM64 collected ($0.60)
Seat 6: AUGH-AUGH folded before Flop (didn't bet)
Seat 7: 2997qwer folded before Flop (didn't bet)
Seat 8: Shugana folded before Flop (didn't bet)
Seat 9: agurio folded before Flop (didn't bet)



PokerStars Zoom Hand #84298203236:  Hold'em No Limit ($0.10/$0.25) - 2012/08/05 13:00:22 JST [2012/08/05 0:00:22 ET]
Table 'Whirlpool' 9-max Seat #1 is the button
Seat 1: DooMSDaY1337 ($39.19 in chips) 
Seat 2: 2997qwer ($12.25 in chips) 
Seat 3: TraderYao ($29.15 in chips) 
Seat 4: AUGH-AUGH ($25 in chips) 
Seat 5: taksist889 ($18.75 in chips) 
Seat 6: Th3Fog ($61.21 in chips) 
Seat 7: Oswulf ($14.33 in chips) 
Seat 8: AndiM64 ($28.65 in chips) 
Seat 9: chiyuki ($36.96 in chips) 
2997qwer: posts small blind $0.10
TraderYao: posts big blind $0.25
*** HOLE CARDS ***
Dealt to chiyuki [7c Qh]
AUGH-AUGH: raises $0.50 to $0.75
taksist889: calls $0.75
Th3Fog: folds 
Oswulf: folds 
AndiM64: folds 
chiyuki: folds 
DooMSDaY1337: folds 
2997qwer: folds 
TraderYao: calls $0.50
*** FLOP *** [Jc 4d Qc]
TraderYao: checks 
AUGH-AUGH: bets $1.75
taksist889: folds 
TraderYao: folds 
Uncalled bet ($1.75) returned to AUGH-AUGH
AUGH-AUGH collected $2.24 from pot
AUGH-AUGH: doesn't show hand 
*** SUMMARY ***
Total pot $2.35 | Rake $0.11 
Board [Jc 4d Qc]
Seat 1: DooMSDaY1337 (button) folded before Flop (didn't bet)
Seat 2: 2997qwer (small blind) folded before Flop
Seat 3: TraderYao (big blind) folded on the Flop
Seat 4: AUGH-AUGH collected ($2.24)
Seat 5: taksist889 folded on the Flop
Seat 6: Th3Fog folded before Flop (didn't bet)
Seat 7: Oswulf folded before Flop (didn't bet)
Seat 8: AndiM64 folded before Flop (didn't bet)
Seat 9: chiyuki folded before Flop (didn't bet)



PokerStars Zoom Hand #84298211425:  Hold'em No Limit ($0.10/$0.25) - 2012/08/05 13:00:56 JST [2012/08/05 0:00:56 ET]
Table 'Whirlpool' 9-max Seat #1 is the button
Seat 1: chiyuki ($36.71 in chips) 
Seat 2: nice.franki ($4.57 in chips) 
Seat 3: Ring Circus ($24.47 in chips) 
Seat 4: BlOnDhOlIc ($44.32 in chips) 
Seat 5: KeLevro0 ($12.15 in chips) 
Seat 6: TErr18 ($20.84 in chips) 
Seat 7: agurio ($30.56 in chips) 
Seat 8: Lasutchik ($12 in chips) 
Seat 9: 2997qwer ($12.15 in chips) 
nice.franki: posts small blind $0.10
Ring Circus: posts big blind $0.25
*** HOLE CARDS ***
Dealt to chiyuki [Kd 8c]
BlOnDhOlIc: folds 
KeLevro0: folds 
TErr18: folds 
agurio: folds 
Lasutchik: folds 
2997qwer: folds 
chiyuki: folds 
nice.franki: folds 
Uncalled bet ($0.15) returned to Ring Circus
Ring Circus collected $0.20 from pot
Ring Circus: doesn't show hand 
*** SUMMARY ***
Total pot $0.20 | Rake $0 
Seat 1: chiyuki (button) folded before Flop (didn't bet)
Seat 2: nice.franki (small blind) folded before Flop
Seat 3: Ring Circus (big blind) collected ($0.20)
Seat 4: BlOnDhOlIc folded before Flop (didn't bet)
Seat 5: KeLevro0 folded before Flop (didn't bet)
Seat 6: TErr18 folded before Flop (didn't bet)
Seat 7: agurio folded before Flop (didn't bet)
Seat 8: Lasutchik folded before Flop (didn't bet)
Seat 9: 2997qwer folded before Flop (didn't bet)



PokerStars Zoom Hand #84298212688:  Hold'em No Limit ($0.10/$0.25) - 2012/08/05 13:01:01 JST [2012/08/05 0:01:01 ET]
Table 'Whirlpool' 9-max Seat #1 is the button
Seat 1: seula i ($25 in chips) 
Seat 2: MATT361 ($11.37 in chips) 
Seat 3: TraderYao ($25.25 in chips) 
Seat 4: chiyuki ($36.71 in chips) 
Seat 5: taksist889 ($18 in chips) 
Seat 6: KrystalAA ($21.96 in chips) 
Seat 7: wtu1986 ($24.90 in chips) 
Seat 8: kamikkaze ($39.25 in chips) 
Seat 9: KeLevro0 ($12.67 in chips) 
MATT361: posts small blind $0.10
TraderYao: posts big blind $0.25
*** HOLE CARDS ***
Dealt to chiyuki [Jh 3c]
chiyuki: folds 
taksist889: folds 
KrystalAA: folds 
wtu1986: folds 
kamikkaze: folds 
KeLevro0: folds 
seula i: folds 
MATT361: calls $0.15
TraderYao: checks 
*** FLOP *** [7d 3d 3s]
MATT361: checks 
TraderYao: checks 
*** TURN *** [7d 3d 3s] [6c]
MATT361: checks 
TraderYao: checks 
*** RIVER *** [7d 3d 3s 6c] [Th]
MATT361: bets $0.50
TraderYao: folds 
Uncalled bet ($0.50) returned to MATT361
MATT361 collected $0.48 from pot
MATT361: doesn't show hand 
*** SUMMARY ***
Total pot $0.50 | Rake $0.02 
Board [7d 3d 3s 6c Th]
Seat 1: seula i (button) folded before Flop (didn't bet)
Seat 2: MATT361 (small blind) collected ($0.48)
Seat 3: TraderYao (big blind) folded on the River
Seat 4: chiyuki folded before Flop (didn't bet)
Seat 5: taksist889 folded before Flop (didn't bet)
Seat 6: KrystalAA folded before Flop (didn't bet)
Seat 7: wtu1986 folded before Flop (didn't bet)
Seat 8: kamikkaze folded before Flop (didn't bet)
Seat 9: KeLevro0 folded before Flop (didn't bet)



PokerStars Zoom Hand #84298218258:  Hold'em No Limit ($0.10/$0.25) - 2012/08/05 13:01:24 JST [2012/08/05 0:01:24 ET]
Table 'Whirlpool' 9-max Seat #1 is the button
Seat 1: Medic8681 ($18.91 in chips) 
Seat 2: RomarioJa ($11.66 in chips) 
Seat 3: Sørbråten ($66.97 in chips) 
Seat 4: Shugana ($25 in chips) 
Seat 5: Catrban ($23.62 in chips) 
Seat 6: Jippyflip ($18.96 in chips) 
Seat 7: Lasutchik ($11.75 in chips) 
Seat 8: masterkoolb ($14.27 in chips) 
Seat 9: chiyuki ($36.61 in chips) 
RomarioJa: posts small blind $0.10
Sørbråten: posts big blind $0.25
*** HOLE CARDS ***
Dealt to chiyuki [6c Kh]
Shugana: folds 
Catrban: folds 
Jippyflip: folds 
Lasutchik: folds 
masterkoolb: folds 
chiyuki: folds 
Medic8681: raises $0.50 to $0.75
RomarioJa: folds 
Sørbråten: folds 
Uncalled bet ($0.50) returned to Medic8681
Medic8681 collected $0.60 from pot
Medic8681: doesn't show hand 
*** SUMMARY ***
Total pot $0.60 | Rake $0 
Seat 1: Medic8681 (button) collected ($0.60)
Seat 2: RomarioJa (small blind) folded before Flop
Seat 3: Sørbråten (big blind) folded before Flop
Seat 4: Shugana folded before Flop (didn't bet)
Seat 5: Catrban folded before Flop (didn't bet)
Seat 6: Jippyflip folded before Flop (didn't bet)
Seat 7: Lasutchik folded before Flop (didn't bet)
Seat 8: masterkoolb folded before Flop (didn't bet)
Seat 9: chiyuki folded before Flop (didn't bet)



PokerStars Zoom Hand #84298213931:  Hold'em No Limit ($0.10/$0.25) - 2012/08/05 13:01:06 JST [2012/08/05 0:01:06 ET]
Table 'Whirlpool' 9-max Seat #1 is the button
Seat 1: agurio ($25 in chips) 
Seat 2: chiyuki ($36.71 in chips) 
Seat 3: s9999999 ($25 in chips) 
Seat 4: Sørbråten ($66.97 in chips) 
Seat 5: Medic8681 ($12.85 in chips) 
Seat 6: Lasutchik ($12 in chips) 
Seat 7: TErr18 ($20.22 in chips) 
Seat 8: KeLevro0 ($12.67 in chips) 
Seat 9: cR!Ma*aRm ($22.71 in chips) 
chiyuki: posts small blind $0.10
s9999999: posts big blind $0.25
*** HOLE CARDS ***
Dealt to chiyuki [Ks 2s]
Sørbråten: folds 
Medic8681: folds 
Lasutchik: folds 
TErr18: calls $0.25
KeLevro0: folds 
cR!Ma*aRm: folds 
agurio: folds 
chiyuki: folds 
s9999999: checks 
*** FLOP *** [9h Kd Qd]
s9999999: checks 
TErr18: checks 
*** TURN *** [9h Kd Qd] [Qs]
s9999999: bets $1
TErr18: calls $1
*** RIVER *** [9h Kd Qd Qs] [4d]
s9999999: bets $0.50
TErr18: raises $2 to $2.50
s9999999: folds 
Uncalled bet ($2) returned to TErr18
TErr18 collected $3.44 from pot
TErr18: doesn't show hand 
*** SUMMARY ***
Total pot $3.60 | Rake $0.16 
Board [9h Kd Qd Qs 4d]
Seat 1: agurio (button) folded before Flop (didn't bet)
Seat 2: chiyuki (small blind) folded before Flop
Seat 3: s9999999 (big blind) folded on the River
Seat 4: Sørbråten folded before Flop (didn't bet)
Seat 5: Medic8681 folded before Flop (didn't bet)
Seat 6: Lasutchik folded before Flop (didn't bet)
Seat 7: TErr18 collected ($3.44)
Seat 8: KeLevro0 folded before Flop (didn't bet)
Seat 9: cR!Ma*aRm folded before Flop (didn't bet)



PokerStars Zoom Hand #84298220612:  Hold'em No Limit ($0.10/$0.25) - 2012/08/05 13:01:33 JST [2012/08/05 0:01:33 ET]
Table 'Whirlpool' 9-max Seat #1 is the button
Seat 1: KeLevro0 ($11.68 in chips) 
Seat 2: Th3Fog ($21.64 in chips) 
Seat 3: AUGH-AUGH ($31.17 in chips) 
Seat 4: AndiM64 ($25 in chips) 
Seat 5: nice.franki ($9.85 in chips) 
Seat 6: chiyuki ($36.61 in chips) 
Seat 7: monst3r4119 ($21.58 in chips) 
Seat 8: Ring Circus ($24.47 in chips) 
Seat 9: Medic8681 ($19.35 in chips) 
Th3Fog: posts small blind $0.10
AUGH-AUGH: posts big blind $0.25
*** HOLE CARDS ***
Dealt to chiyuki [Ac 5c]
AndiM64: raises $0.50 to $0.75
nice.franki: folds 
chiyuki: folds 
monst3r4119: folds 
Ring Circus: folds 
Medic8681: raises $1.50 to $2.25
KeLevro0: folds 
Th3Fog: folds 
AUGH-AUGH: folds 
AndiM64: folds 
Uncalled bet ($1.50) returned to Medic8681
Medic8681 collected $1.85 from pot
Medic8681: doesn't show hand 
*** SUMMARY ***
Total pot $1.85 | Rake $0 
Seat 1: KeLevro0 (button) folded before Flop (didn't bet)
Seat 2: Th3Fog (small blind) folded before Flop
Seat 3: AUGH-AUGH (big blind) folded before Flop
Seat 4: AndiM64 folded before Flop
Seat 5: nice.franki folded before Flop (didn't bet)
Seat 6: chiyuki folded before Flop (didn't bet)
Seat 7: monst3r4119 folded before Flop (didn't bet)
Seat 8: Ring Circus folded before Flop (didn't bet)
Seat 9: Medic8681 collected ($1.85)



PokerStars Zoom Hand #84298216516:  Hold'em No Limit ($0.10/$0.25) - 2012/08/05 13:01:17 JST [2012/08/05 0:01:17 ET]
Table 'Whirlpool' 9-max Seat #1 is the button
Seat 1: RomarioJa ($12.66 in chips) 
Seat 2: KeLevro0 ($11.90 in chips) 
Seat 3: 2997qwer ($13.80 in chips) 
Seat 4: puffy5533 ($23.33 in chips) 
Seat 5: wtu1986 ($25 in chips) 
Seat 6: Rsonal ($34.71 in chips) 
Seat 7: chiyuki ($36.61 in chips) 
Seat 8: nice.franki ($12.45 in chips) 
Seat 9: KrystalAA ($36.34 in chips) 
KeLevro0: posts small blind $0.10
2997qwer: posts big blind $0.25
*** HOLE CARDS ***
Dealt to chiyuki [Jd Kc]
puffy5533: folds 
wtu1986: folds 
Rsonal: raises $0.50 to $0.75
chiyuki: folds 
nice.franki: folds 
KrystalAA: raises $0.75 to $1.50
RomarioJa: folds 
KeLevro0: folds 
2997qwer: folds 
Rsonal: calls $0.75
*** FLOP *** [6s 2s 4d]
Rsonal: checks 
KrystalAA: checks 
*** TURN *** [6s 2s 4d] [Td]
Rsonal: bets $1.75
KrystalAA: folds 
Uncalled bet ($1.75) returned to Rsonal
Rsonal collected $3.20 from pot
Rsonal: doesn't show hand 
*** SUMMARY ***
Total pot $3.35 | Rake $0.15 
Board [6s 2s 4d Td]
Seat 1: RomarioJa (button) folded before Flop (didn't bet)
Seat 2: KeLevro0 (small blind) folded before Flop
Seat 3: 2997qwer (big blind) folded before Flop
Seat 4: puffy5533 folded before Flop (didn't bet)
Seat 5: wtu1986 folded before Flop (didn't bet)
Seat 6: Rsonal collected ($3.20)
Seat 7: chiyuki folded before Flop (didn't bet)
Seat 8: nice.franki folded before Flop (didn't bet)
Seat 9: KrystalAA folded on the Turn



PokerStars Zoom Hand #84298226864:  Hold'em No Limit ($0.10/$0.25) - 2012/08/05 13:01:56 JST [2012/08/05 0:01:56 ET]
Table 'Whirlpool' 9-max Seat #1 is the button
Seat 1: agurio ($30.56 in chips) 
Seat 2: Medic8681 ($12.60 in chips) 
Seat 3: chiyuki ($36.61 in chips) 
Seat 4: Anafim ($17.90 in chips) 
Seat 5: 5zzzz33 ($18.65 in chips) 
Seat 6: s9999999 ($13.25 in chips) 
Seat 7: KeLevro0 ($12.25 in chips) 
Seat 8: KrystalAA ($34.84 in chips) 
Seat 9: nice.franki ($7.61 in chips) 
Medic8681: posts small blind $0.10
chiyuki: posts big blind $0.25
*** HOLE CARDS ***
Dealt to chiyuki [5d 6c]
Anafim: folds 
5zzzz33: folds 
s9999999: folds 
KeLevro0: folds 
KrystalAA: folds 
nice.franki: folds 
agurio: folds 
Medic8681: raises $0.50 to $0.75
chiyuki: folds 
Uncalled bet ($0.50) returned to Medic8681
Medic8681 collected $0.50 from pot
Medic8681: doesn't show hand 
*** SUMMARY ***
Total pot $0.50 | Rake $0 
Seat 1: agurio (button) folded before Flop (didn't bet)
Seat 2: Medic8681 (small blind) collected ($0.50)
Seat 3: chiyuki (big blind) folded before Flop
Seat 4: Anafim folded before Flop (didn't bet)
Seat 5: 5zzzz33 folded before Flop (didn't bet)
Seat 6: s9999999 folded before Flop (didn't bet)
Seat 7: KeLevro0 folded before Flop (didn't bet)
Seat 8: KrystalAA folded before Flop (didn't bet)
Seat 9: nice.franki folded before Flop (didn't bet)



PokerStars Zoom Hand #84298219316:  Hold'em No Limit ($0.10/$0.25) - 2012/08/05 13:01:28 JST [2012/08/05 0:01:28 ET]
Table 'Whirlpool' 9-max Seat #1 is the button
Seat 1: vfo.pt ($12.15 in chips) 
Seat 2: cR!Ma*aRm ($22.71 in chips) 
Seat 3: mid22 ($16.16 in chips) 
Seat 4: AndiM64 ($28.15 in chips) 
Seat 5: luyifei ($12.72 in chips) 
Seat 6: chiyuki ($36.61 in chips) 
Seat 7: DooMSDaY1337 ($32.99 in chips) 
Seat 8: richardwmck ($28.16 in chips) 
Seat 9: Ring Circus ($24.47 in chips) 
cR!Ma*aRm: posts small blind $0.10
mid22: posts big blind $0.25
*** HOLE CARDS ***
Dealt to chiyuki [2d Qc]
AndiM64: folds 
luyifei: calls $0.25
chiyuki: folds 
DooMSDaY1337: folds 
richardwmck: folds 
Ring Circus: folds 
vfo.pt: calls $0.25
cR!Ma*aRm: folds 
mid22: checks 
*** FLOP *** [Js Jd 6d]
mid22: checks 
luyifei: bets $0.25
vfo.pt: folds 
mid22: calls $0.25
*** TURN *** [Js Jd 6d] [5d]
mid22: checks 
luyifei: checks 
*** RIVER *** [Js Jd 6d 5d] [2s]
mid22: bets $0.25
luyifei: raises $1 to $1.25
mid22: folds 
Uncalled bet ($1) returned to luyifei
luyifei collected $1.77 from pot
luyifei: doesn't show hand 
*** SUMMARY ***
Total pot $1.85 | Rake $0.08 
Board [Js Jd 6d 5d 2s]
Seat 1: vfo.pt (button) folded on the Flop
Seat 2: cR!Ma*aRm (small blind) folded before Flop
Seat 3: mid22 (big blind) folded on the River
Seat 4: AndiM64 folded before Flop (didn't bet)
Seat 5: luyifei collected ($1.77)
Seat 6: chiyuki folded before Flop (didn't bet)
Seat 7: DooMSDaY1337 folded before Flop (didn't bet)
Seat 8: richardwmck folded before Flop (didn't bet)
Seat 9: Ring Circus folded before Flop (didn't bet)



PokerStars Zoom Hand #84298221951:  Hold'em No Limit ($0.10/$0.25) - 2012/08/05 13:01:38 JST [2012/08/05 0:01:38 ET]
Table 'Whirlpool' 9-max Seat #1 is the button
Seat 1: chiyuki ($36.61 in chips) 
Seat 2: wtu1986 ($25 in chips) 
Seat 3: cR!Ma*aRm ($22.61 in chips) 
Seat 4: a_tasmanian ($60.86 in chips) 
Seat 5: mistownboi ($13.70 in chips) 
Seat 6: Shugana ($25 in chips) 
Seat 7: KeLevro0 ($11.80 in chips) 
Seat 8: monst3r4119 ($21.58 in chips) 
Seat 9: 2997qwer ($13.55 in chips) 
wtu1986: posts small blind $0.10
cR!Ma*aRm: posts big blind $0.25
*** HOLE CARDS ***
Dealt to chiyuki [Qh Jc]
a_tasmanian: calls $0.25
mistownboi: folds 
Shugana: folds 
KeLevro0: folds 
monst3r4119: folds 
2997qwer: folds 
chiyuki: folds 
wtu1986: folds 
cR!Ma*aRm: checks 
*** FLOP *** [3c 9d 8h]
cR!Ma*aRm: bets $0.25
a_tasmanian: calls $0.25
*** TURN *** [3c 9d 8h] [Ks]
cR!Ma*aRm: bets $0.25
a_tasmanian: calls $0.25
*** RIVER *** [3c 9d 8h Ks] [6d]
cR!Ma*aRm: bets $0.25
a_tasmanian: folds 
Uncalled bet ($0.25) returned to cR!Ma*aRm
cR!Ma*aRm collected $1.53 from pot
cR!Ma*aRm: doesn't show hand 
*** SUMMARY ***
Total pot $1.60 | Rake $0.07 
Board [3c 9d 8h Ks 6d]
Seat 1: chiyuki (button) folded before Flop (didn't bet)
Seat 2: wtu1986 (small blind) folded before Flop
Seat 3: cR!Ma*aRm (big blind) collected ($1.53)
Seat 4: a_tasmanian folded on the River
Seat 5: mistownboi folded before Flop (didn't bet)
Seat 6: Shugana folded before Flop (didn't bet)
Seat 7: KeLevro0 folded before Flop (didn't bet)
Seat 8: monst3r4119 folded before Flop (didn't bet)
Seat 9: 2997qwer folded before Flop (didn't bet)



PokerStars Zoom Hand #84298233309:  Hold'em No Limit ($0.10/$0.25) - 2012/08/05 13:02:16 JST [2012/08/05 0:02:16 ET]
Table 'Whirlpool' 9-max Seat #1 is the button
Seat 1: mid22 ($15.41 in chips) 
Seat 2: Sharks_Nica ($66.53 in chips) 
Seat 3: AndiM64 ($25 in chips) 
Seat 4: 2997qwer ($12.15 in chips) 
Seat 5: D@vidMed ($24.11 in chips) 
Seat 6: masterkoolb ($12.50 in chips) 
Seat 7: chiyuki ($36.36 in chips) 
Seat 8: fwani ($27.68 in chips) 
Seat 9: richardwmck ($27.31 in chips) 
Sharks_Nica: posts small blind $0.10
AndiM64: posts big blind $0.25
*** HOLE CARDS ***
Dealt to chiyuki [8d Th]
2997qwer: folds 
D@vidMed: folds 
masterkoolb: folds 
chiyuki: folds 
fwani: raises $0.35 to $0.60
richardwmck: folds 
mid22: folds 
Sharks_Nica: folds 
AndiM64: folds 
Uncalled bet ($0.35) returned to fwani
fwani collected $0.60 from pot
fwani: doesn't show hand 
*** SUMMARY ***
Total pot $0.60 | Rake $0 
Seat 1: mid22 (button) folded before Flop (didn't bet)
Seat 2: Sharks_Nica (small blind) folded before Flop
Seat 3: AndiM64 (big blind) folded before Flop
Seat 4: 2997qwer folded before Flop (didn't bet)
Seat 5: D@vidMed folded before Flop (didn't bet)
Seat 6: masterkoolb folded before Flop (didn't bet)
Seat 7: chiyuki folded before Flop (didn't bet)
Seat 8: fwani collected ($0.60)
Seat 9: richardwmck folded before Flop (didn't bet)



PokerStars Zoom Hand #84298235509:  Hold'em No Limit ($0.10/$0.25) - 2012/08/05 13:02:25 JST [2012/08/05 0:02:25 ET]
Table 'Whirlpool' 9-max Seat #1 is the button
Seat 1: jamielniak ($29.49 in chips) 
Seat 2: Anafim ($12.60 in chips) 
Seat 3: Medic8681 ($16.42 in chips) 
Seat 4: KrystalAA ($34.84 in chips) 
Seat 5: 2997qwer ($12.15 in chips) 
Seat 6: KeLevro0 ($12.15 in chips) 
Seat 7: vfo.pt ($11.90 in chips) 
Seat 8: chiyuki ($36.36 in chips) 
Seat 9: Lasutchik ($26.48 in chips) 
Anafim: posts small blind $0.10
Medic8681: posts big blind $0.25
*** HOLE CARDS ***
Dealt to chiyuki [7c Jd]
KrystalAA: folds 
2997qwer: raises $0.50 to $0.75
KeLevro0: folds 
vfo.pt: folds 
chiyuki: folds 
Lasutchik: folds 
jamielniak: folds 
Anafim: folds 
Medic8681: folds 
Uncalled bet ($0.50) returned to 2997qwer
2997qwer collected $0.60 from pot
2997qwer: doesn't show hand 
*** SUMMARY ***
Total pot $0.60 | Rake $0 
Seat 1: jamielniak (button) folded before Flop (didn't bet)
Seat 2: Anafim (small blind) folded before Flop
Seat 3: Medic8681 (big blind) folded before Flop
Seat 4: KrystalAA folded before Flop (didn't bet)
Seat 5: 2997qwer collected ($0.60)
Seat 6: KeLevro0 folded before Flop (didn't bet)
Seat 7: vfo.pt folded before Flop (didn't bet)
Seat 8: chiyuki folded before Flop (didn't bet)
Seat 9: Lasutchik folded before Flop (didn't bet)



PokerStars Zoom Hand #84298234452:  Hold'em No Limit ($0.10/$0.25) - 2012/08/05 13:02:20 JST [2012/08/05 0:02:20 ET]
Table 'Whirlpool' 9-max Seat #1 is the button
Seat 1: AUGH-AUGH ($30.82 in chips) 
Seat 2: jamielniak ($29.59 in chips) 
Seat 3: DooMSDaY1337 ($32.99 in chips) 
Seat 4: masterkoolb ($12.50 in chips) 
Seat 5: chiyuki ($36.36 in chips) 
Seat 6: mid22 ($15.41 in chips) 
Seat 7: richardwmck ($27.31 in chips) 
Seat 8: RomarioJa ($8.30 in chips) 
Seat 9: mayathebee83 ($11.75 in chips) 
jamielniak: posts small blind $0.10
DooMSDaY1337: posts big blind $0.25
*** HOLE CARDS ***
Dealt to chiyuki [4h 2h]
masterkoolb: folds 
chiyuki: folds 
mid22: calls $0.25
richardwmck: calls $0.25
RomarioJa: folds 
mayathebee83: calls $0.25
AUGH-AUGH: folds 
jamielniak: folds 
DooMSDaY1337: checks 
*** FLOP *** [Kc 2c 5c]
DooMSDaY1337: checks 
mid22: checks 
richardwmck: checks 
mayathebee83: checks 
*** TURN *** [Kc 2c 5c] [Qd]
DooMSDaY1337: checks 
mid22: checks 
richardwmck: bets $0.50
mayathebee83: folds 
DooMSDaY1337: folds 
mid22: calls $0.50
*** RIVER *** [Kc 2c 5c Qd] [Tc]
mid22: checks 
richardwmck: bets $1
mid22: folds 
Uncalled bet ($1) returned to richardwmck
richardwmck collected $2.01 from pot
richardwmck: doesn't show hand 
*** SUMMARY ***
Total pot $2.10 | Rake $0.09 
Board [Kc 2c 5c Qd Tc]
Seat 1: AUGH-AUGH (button) folded before Flop (didn't bet)
Seat 2: jamielniak (small blind) folded before Flop
Seat 3: DooMSDaY1337 (big blind) folded on the Turn
Seat 4: masterkoolb folded before Flop (didn't bet)
Seat 5: chiyuki folded before Flop (didn't bet)
Seat 6: mid22 folded on the River
Seat 7: richardwmck collected ($2.01)
Seat 8: RomarioJa folded before Flop (didn't bet)
Seat 9: mayathebee83 folded on the Turn



PokerStars Zoom Hand #84298237116:  Hold'em No Limit ($0.10/$0.25) - 2012/08/05 13:02:31 JST [2012/08/05 0:02:31 ET]
Table 'Whirlpool' 9-max Seat #1 is the button
Seat 1: Sharks_Nica ($66.43 in chips) 
Seat 2: deadmoneykid ($22.50 in chips) 
Seat 3: Assassin365 ($29.88 in chips) 
Seat 4: chiyuki ($36.36 in chips) 
Seat 5: vfo.pt ($11.90 in chips) 
Seat 6: nice.franki ($12.35 in chips) 
Seat 7: Anafim ($12.50 in chips) 
Seat 8: AndiM64 ($25 in chips) 
Seat 9: wtu1986 ($24.90 in chips) 
deadmoneykid: posts small blind $0.10
Assassin365: posts big blind $0.25
*** HOLE CARDS ***
Dealt to chiyuki [5h Ad]
chiyuki: folds 
vfo.pt: raises $0.50 to $0.75
nice.franki: folds 
Anafim: folds 
AndiM64: calls $0.75
wtu1986: folds 
Sharks_Nica: folds 
deadmoneykid: folds 
Assassin365: calls $0.50
*** FLOP *** [3c 3s 2s]
Assassin365: checks 
vfo.pt: checks 
AndiM64: bets $1.25
Assassin365: folds 
vfo.pt: folds 
Uncalled bet ($1.25) returned to AndiM64
AndiM64 collected $2.24 from pot
AndiM64: doesn't show hand 
*** SUMMARY ***
Total pot $2.35 | Rake $0.11 
Board [3c 3s 2s]
Seat 1: Sharks_Nica (button) folded before Flop (didn't bet)
Seat 2: deadmoneykid (small blind) folded before Flop
Seat 3: Assassin365 (big blind) folded on the Flop
Seat 4: chiyuki folded before Flop (didn't bet)
Seat 5: vfo.pt folded on the Flop
Seat 6: nice.franki folded before Flop (didn't bet)
Seat 7: Anafim folded before Flop (didn't bet)
Seat 8: AndiM64 collected ($2.24)
Seat 9: wtu1986 folded before Flop (didn't bet)



PokerStars Zoom Hand #84298240397:  Hold'em No Limit ($0.10/$0.25) - 2012/08/05 13:02:43 JST [2012/08/05 0:02:43 ET]
Table 'Whirlpool' 9-max Seat #1 is the button
Seat 1: TraderYao ($26.47 in chips) 
Seat 2: chiyuki ($36.36 in chips) 
Seat 3: Ring Circus ($18.62 in chips) 
Seat 4: RomarioJa ($11.66 in chips) 
Seat 5: kkbruins0408 ($62.82 in chips) 
Seat 6: Anafim ($12.50 in chips) 
Seat 7: KeLevro0 ($10.88 in chips) 
Seat 8: wtu1986 ($24.90 in chips) 
Seat 9: Loholov ($15 in chips) 
chiyuki: posts small blind $0.10
Ring Circus: posts big blind $0.25
*** HOLE CARDS ***
Dealt to chiyuki [Kc 6d]
RomarioJa: raises $0.50 to $0.75
kkbruins0408: calls $0.75
Anafim: folds 
KeLevro0: folds 
wtu1986: folds 
Loholov: folds 
TraderYao: folds 
chiyuki: folds 
Ring Circus: calls $0.50
*** FLOP *** [4h 9s Ah]
Ring Circus: checks 
RomarioJa: checks 
kkbruins0408: checks 
*** TURN *** [4h 9s Ah] [6h]
Ring Circus: bets $1.50
RomarioJa: folds 
kkbruins0408: calls $1.50
*** RIVER *** [4h 9s Ah 6h] [2d]
Ring Circus: bets $4
kkbruins0408: folds 
Uncalled bet ($4) returned to Ring Circus
Ring Circus collected $5.11 from pot
Ring Circus: doesn't show hand 
*** SUMMARY ***
Total pot $5.35 | Rake $0.24 
Board [4h 9s Ah 6h 2d]
Seat 1: TraderYao (button) folded before Flop (didn't bet)
Seat 2: chiyuki (small blind) folded before Flop
Seat 3: Ring Circus (big blind) collected ($5.11)
Seat 4: RomarioJa folded on the Turn
Seat 5: kkbruins0408 folded on the River
Seat 6: Anafim folded before Flop (didn't bet)
Seat 7: KeLevro0 folded before Flop (didn't bet)
Seat 8: wtu1986 folded before Flop (didn't bet)
Seat 9: Loholov folded before Flop (didn't bet)



PokerStars Zoom Hand #84298248043:  Hold'em No Limit ($0.10/$0.25) - 2012/08/05 13:03:09 JST [2012/08/05 0:03:09 ET]
Table 'Whirlpool' 9-max Seat #1 is the button
Seat 1: Shugana ($25 in chips) 
Seat 2: puffy5533 ($13.83 in chips) 
Seat 3: chiyuki ($36.26 in chips) 
Seat 4: Medic8681 ($20.28 in chips) 
Seat 5: BlOnDhOlIc ($33.05 in chips) 
Seat 6: silvno31 ($47.58 in chips) 
Seat 7: slapshot2011 ($31.80 in chips) 
Seat 8: 1474 BigJohn ($31.96 in chips) 
Seat 9: Seadogvcd ($5.84 in chips) 
puffy5533: posts small blind $0.10
chiyuki: posts big blind $0.25
*** HOLE CARDS ***
Dealt to chiyuki [4s Tc]
Medic8681: folds 
BlOnDhOlIc: folds 
silvno31: folds 
slapshot2011: calls $0.25
1474 BigJohn: calls $0.25
Seadogvcd: folds 
Shugana: folds 
puffy5533: calls $0.15
chiyuki: checks 
*** FLOP *** [Qs 7h 8s]
puffy5533: checks 
chiyuki: checks 
slapshot2011: bets $0.75
1474 BigJohn: folds 
puffy5533: folds 
chiyuki: folds 
Uncalled bet ($0.75) returned to slapshot2011
slapshot2011 collected $0.96 from pot
slapshot2011: doesn't show hand 
*** SUMMARY ***
Total pot $1 | Rake $0.04 
Board [Qs 7h 8s]
Seat 1: Shugana (button) folded before Flop (didn't bet)
Seat 2: puffy5533 (small blind) folded on the Flop
Seat 3: chiyuki (big blind) folded on the Flop
Seat 4: Medic8681 folded before Flop (didn't bet)
Seat 5: BlOnDhOlIc folded before Flop (didn't bet)
Seat 6: silvno31 folded before Flop (didn't bet)
Seat 7: slapshot2011 collected ($0.96)
Seat 8: 1474 BigJohn folded on the Flop
Seat 9: Seadogvcd folded before Flop (didn't bet)



PokerStars Zoom Hand #84298246971:  Hold'em No Limit ($0.10/$0.25) - 2012/08/05 13:03:06 JST [2012/08/05 0:03:06 ET]
Table 'Whirlpool' 9-max Seat #1 is the button
Seat 1: DooMSDaY1337 ($25 in chips) 
Seat 2: fwani ($25 in chips) 
Seat 3: nice.franki ($12.35 in chips) 
Seat 4: monst3r4119 ($21.23 in chips) 
Seat 5: richardwmck ($28.57 in chips) 
Seat 6: wtu1986 ($24.65 in chips) 
Seat 7: cR!Ma*aRm ($22.89 in chips) 
Seat 8: Anafim ($12.50 in chips) 
Seat 9: chiyuki ($36.26 in chips) 
fwani: posts small blind $0.10
nice.franki: posts big blind $0.25
*** HOLE CARDS ***
Dealt to chiyuki [9h 5c]
monst3r4119: folds 
richardwmck: folds 
wtu1986: folds 
cR!Ma*aRm: calls $0.25
Anafim: folds 
chiyuki: folds 
DooMSDaY1337: folds 
fwani: raises $0.75 to $1
nice.franki: folds 
cR!Ma*aRm: calls $0.75
*** FLOP *** [9s Tc 8c]
fwani: bets $1.60
cR!Ma*aRm: calls $1.60
*** TURN *** [9s Tc 8c] [3s]
fwani: checks 
cR!Ma*aRm: bets $1.25
fwani: folds 
Uncalled bet ($1.25) returned to cR!Ma*aRm
cR!Ma*aRm collected $5.20 from pot
cR!Ma*aRm: doesn't show hand 
*** SUMMARY ***
Total pot $5.45 | Rake $0.25 
Board [9s Tc 8c 3s]
Seat 1: DooMSDaY1337 (button) folded before Flop (didn't bet)
Seat 2: fwani (small blind) folded on the Turn
Seat 3: nice.franki (big blind) folded before Flop
Seat 4: monst3r4119 folded before Flop (didn't bet)
Seat 5: richardwmck folded before Flop (didn't bet)
Seat 6: wtu1986 folded before Flop (didn't bet)
Seat 7: cR!Ma*aRm collected ($5.20)
Seat 8: Anafim folded before Flop (didn't bet)
Seat 9: chiyuki folded before Flop (didn't bet)



PokerStars Zoom Hand #84298244723:  Hold'em No Limit ($0.10/$0.25) - 2012/08/05 13:02:58 JST [2012/08/05 0:02:58 ET]
Table 'Whirlpool' 9-max Seat #1 is the button
Seat 1: Seadogvcd ($5.84 in chips) 
Seat 2: KeLevro0 ($10.88 in chips) 
Seat 3: kamikkaze ($41.83 in chips) 
Seat 4: BlOnDhOlIc ($44.07 in chips) 
Seat 5: jamielniak ($25 in chips) 
Seat 6: chiyuki ($36.26 in chips) 
Seat 7: Sharks_Nica ($31.52 in chips) 
Seat 8: wtu1986 ($25 in chips) 
Seat 9: TraderYao ($26.47 in chips) 
KeLevro0: posts small blind $0.10
kamikkaze: posts big blind $0.25
*** HOLE CARDS ***
Dealt to chiyuki [5s Qh]
BlOnDhOlIc: folds 
jamielniak: raises $0.50 to $0.75
chiyuki: folds 
Sharks_Nica: folds 
wtu1986: folds 
TraderYao: calls $0.75
Seadogvcd: folds 
KeLevro0: calls $0.65
kamikkaze: folds 
*** FLOP *** [As 8d Kc]
KeLevro0: checks 
jamielniak: bets $1.50
TraderYao: folds 
KeLevro0: calls $1.50
*** TURN *** [As 8d Kc] [Js]
KeLevro0: checks 
jamielniak: checks 
*** RIVER *** [As 8d Kc Js] [5h]
KeLevro0: bets $2.94
jamielniak: calls $2.94
*** SHOW DOWN ***
KeLevro0: shows [Ah Jh] (two pair, Aces and Jacks)
jamielniak: mucks hand 
KeLevro0 collected $10.87 from pot
*** SUMMARY ***
Total pot $11.38 | Rake $0.51 
Board [As 8d Kc Js 5h]
Seat 1: Seadogvcd (button) folded before Flop (didn't bet)
Seat 2: KeLevro0 (small blind) showed [Ah Jh] and won ($10.87) with two pair, Aces and Jacks
Seat 3: kamikkaze (big blind) folded before Flop
Seat 4: BlOnDhOlIc folded before Flop (didn't bet)
Seat 5: jamielniak mucked [5c 6c]
Seat 6: chiyuki folded before Flop (didn't bet)
Seat 7: Sharks_Nica folded before Flop (didn't bet)
Seat 8: wtu1986 folded before Flop (didn't bet)
Seat 9: TraderYao folded on the Flop



PokerStars Zoom Hand #84298262131:  Hold'em No Limit ($0.10/$0.25) - 2012/08/05 13:03:58 JST [2012/08/05 0:03:58 ET]
Table 'Whirlpool' 9-max Seat #1 is the button
Seat 1: puffy5533 ($23.58 in chips) 
Seat 2: KrystalAA ($35.61 in chips) 
Seat 3: ShevchukAI ($12.50 in chips) 
Seat 4: Medic8681 ($16.17 in chips) 
Seat 5: chiyuki ($36.01 in chips) 
Seat 6: Ring Circus ($21.48 in chips) 
Seat 7: nice.franki ($7.36 in chips) 
Seat 8: Loholov ($15.35 in chips) 
Seat 9: Th3Fog ($60.54 in chips) 
KrystalAA: posts small blind $0.10
ShevchukAI: posts big blind $0.25
*** HOLE CARDS ***
Dealt to chiyuki [Qc Kd]
Medic8681: folds 
chiyuki: folds 
Ring Circus: folds 
nice.franki: folds 
Loholov: folds 
Th3Fog: folds 
puffy5533: raises $0.50 to $0.75
KrystalAA: folds 
ShevchukAI: folds 
Uncalled bet ($0.50) returned to puffy5533
puffy5533 collected $0.60 from pot
puffy5533: doesn't show hand 
*** SUMMARY ***
Total pot $0.60 | Rake $0 
Seat 1: puffy5533 (button) collected ($0.60)
Seat 2: KrystalAA (small blind) folded before Flop
Seat 3: ShevchukAI (big blind) folded before Flop
Seat 4: Medic8681 folded before Flop (didn't bet)
Seat 5: chiyuki folded before Flop (didn't bet)
Seat 6: Ring Circus folded before Flop (didn't bet)
Seat 7: nice.franki folded before Flop (didn't bet)
Seat 8: Loholov folded before Flop (didn't bet)
Seat 9: Th3Fog folded before Flop (didn't bet)



PokerStars Zoom Hand #84298265364:  Hold'em No Limit ($0.10/$0.25) - 2012/08/05 13:04:09 JST [2012/08/05 0:04:09 ET]
Table 'Whirlpool' 9-max Seat #1 is the button
Seat 1: BlOnDhOlIc ($25.40 in chips) 
Seat 2: MibNe ($24.63 in chips) 
Seat 3: slapshot2011 ($32.51 in chips) 
Seat 4: KeLevro0 ($13.27 in chips) 
Seat 5: TraderYao ($25.72 in chips) 
Seat 6: eagie20 ($142.27 in chips) 
Seat 7: masterkoolb ($12.50 in chips) 
Seat 8: chiyuki ($36.01 in chips) 
Seat 9: KrystalAA ($35.51 in chips) 
MibNe: posts small blind $0.10
slapshot2011: posts big blind $0.25
*** HOLE CARDS ***
Dealt to chiyuki [9c Js]
KeLevro0: folds 
TraderYao: folds 
eagie20: folds 
masterkoolb: folds 
chiyuki: folds 
KrystalAA: folds 
BlOnDhOlIc: folds 
MibNe: folds 
Uncalled bet ($0.15) returned to slapshot2011
slapshot2011 collected $0.20 from pot
slapshot2011: doesn't show hand 
*** SUMMARY ***
Total pot $0.20 | Rake $0 
Seat 1: BlOnDhOlIc (button) folded before Flop (didn't bet)
Seat 2: MibNe (small blind) folded before Flop
Seat 3: slapshot2011 (big blind) collected ($0.20)
Seat 4: KeLevro0 folded before Flop (didn't bet)
Seat 5: TraderYao folded before Flop (didn't bet)
Seat 6: eagie20 folded before Flop (didn't bet)
Seat 7: masterkoolb folded before Flop (didn't bet)
Seat 8: chiyuki folded before Flop (didn't bet)
Seat 9: KrystalAA folded before Flop (didn't bet)



PokerStars Zoom Hand #84298266897:  Hold'em No Limit ($0.10/$0.25) - 2012/08/05 13:04:14 JST [2012/08/05 0:04:14 ET]
Table 'Whirlpool' 9-max Seat #1 is the button
Seat 1: MibNe ($24.53 in chips) 
Seat 2: KeLevro0 ($12.88 in chips) 
Seat 3: Sharks_Nica ($29.13 in chips) 
Seat 4: nice.franki ($12 in chips) 
Seat 5: mayathebee83 ($9.85 in chips) 
Seat 6: masterkoolb ($12.50 in chips) 
Seat 7: chiyuki ($36.01 in chips) 
Seat 8: BlOnDhOlIc ($25.40 in chips) 
Seat 9: eagie20 ($142.27 in chips) 
KeLevro0: posts small blind $0.10
Sharks_Nica: posts big blind $0.25
*** HOLE CARDS ***
Dealt to chiyuki [Ks Qh]
nice.franki: folds 
mayathebee83: folds 
masterkoolb: folds 
chiyuki: raises $0.50 to $0.75
BlOnDhOlIc: folds 
eagie20: folds 
MibNe: folds 
KeLevro0: folds 
Sharks_Nica: folds 
Uncalled bet ($0.50) returned to chiyuki
chiyuki collected $0.60 from pot
chiyuki: doesn't show hand 
*** SUMMARY ***
Total pot $0.60 | Rake $0 
Seat 1: MibNe (button) folded before Flop (didn't bet)
Seat 2: KeLevro0 (small blind) folded before Flop
Seat 3: Sharks_Nica (big blind) folded before Flop
Seat 4: nice.franki folded before Flop (didn't bet)
Seat 5: mayathebee83 folded before Flop (didn't bet)
Seat 6: masterkoolb folded before Flop (didn't bet)
Seat 7: chiyuki collected ($0.60)
Seat 8: BlOnDhOlIc folded before Flop (didn't bet)
Seat 9: eagie20 folded before Flop (didn't bet)



PokerStars Zoom Hand #84298263920:  Hold'em No Limit ($0.10/$0.25) - 2012/08/05 13:04:04 JST [2012/08/05 0:04:04 ET]
Table 'Whirlpool' 9-max Seat #1 is the button
Seat 1: chiyuki ($36.01 in chips) 
Seat 2: nice.franki ($12.50 in chips) 
Seat 3: RomarioJa ($13.01 in chips) 
Seat 4: mikifeio ($33.25 in chips) 
Seat 5: Anafim ($27.60 in chips) 
Seat 6: slapshot2011 ($32.51 in chips) 
Seat 7: eagie20 ($142.27 in chips) 
Seat 8: KeLevro0 ($13.27 in chips) 
Seat 9: Sharks_Nica ($29.13 in chips) 
nice.franki: posts small blind $0.10
RomarioJa: posts big blind $0.25
*** HOLE CARDS ***
Dealt to chiyuki [3c 5c]
mikifeio: calls $0.25
Anafim: folds 
slapshot2011: folds 
eagie20: folds 
KeLevro0: folds 
Sharks_Nica: folds 
chiyuki: folds 
nice.franki: folds 
RomarioJa: checks 
*** FLOP *** [6d Kd Ad]
RomarioJa: checks 
mikifeio: bets $0.28
RomarioJa: folds 
Uncalled bet ($0.28) returned to mikifeio
mikifeio collected $0.57 from pot
mikifeio: doesn't show hand 
*** SUMMARY ***
Total pot $0.60 | Rake $0.03 
Board [6d Kd Ad]
Seat 1: chiyuki (button) folded before Flop (didn't bet)
Seat 2: nice.franki (small blind) folded before Flop
Seat 3: RomarioJa (big blind) folded on the Flop
Seat 4: mikifeio collected ($0.57)
Seat 5: Anafim folded before Flop (didn't bet)
Seat 6: slapshot2011 folded before Flop (didn't bet)
Seat 7: eagie20 folded before Flop (didn't bet)
Seat 8: KeLevro0 folded before Flop (didn't bet)
Seat 9: Sharks_Nica folded before Flop (didn't bet)



PokerStars Zoom Hand #84298273641:  Hold'em No Limit ($0.10/$0.25) - 2012/08/05 13:04:37 JST [2012/08/05 0:04:37 ET]
Table 'Whirlpool' 9-max Seat #1 is the button
Seat 1: BlOnDhOlIc ($43.62 in chips) 
Seat 2: Medic8681 ($17.02 in chips) 
Seat 3: jamielniak ($25 in chips) 
Seat 4: chiyuki ($36.26 in chips) 
Seat 5: Loholov ($15 in chips) 
Seat 6: AndiM64 ($82.30 in chips) 
Seat 7: monst3r4119 ($23.17 in chips) 
Seat 8: Oswulf ($13.98 in chips) 
Seat 9: deadmoneykid ($23.65 in chips) 
Medic8681: posts small blind $0.10
jamielniak: posts big blind $0.25
*** HOLE CARDS ***
Dealt to chiyuki [Td 5d]
chiyuki: folds 
Loholov: folds 
AndiM64: folds 
monst3r4119: folds 
Oswulf: folds 
deadmoneykid: folds 
BlOnDhOlIc: folds 
Medic8681: raises $0.50 to $0.75
jamielniak: folds 
Uncalled bet ($0.50) returned to Medic8681
Medic8681 collected $0.50 from pot
Medic8681: doesn't show hand 
*** SUMMARY ***
Total pot $0.50 | Rake $0 
Seat 1: BlOnDhOlIc (button) folded before Flop (didn't bet)
Seat 2: Medic8681 (small blind) collected ($0.50)
Seat 3: jamielniak (big blind) folded before Flop
Seat 4: chiyuki folded before Flop (didn't bet)
Seat 5: Loholov folded before Flop (didn't bet)
Seat 6: AndiM64 folded before Flop (didn't bet)
Seat 7: monst3r4119 folded before Flop (didn't bet)
Seat 8: Oswulf folded before Flop (didn't bet)
Seat 9: deadmoneykid folded before Flop (didn't bet)



PokerStars Zoom Hand #84298272214:  Hold'em No Limit ($0.10/$0.25) - 2012/08/05 13:04:32 JST [2012/08/05 0:04:32 ET]
Table 'Whirlpool' 9-max Seat #1 is the button
Seat 1: AndiM64 ($82.30 in chips) 
Seat 2: chiyuki ($36.36 in chips) 
Seat 3: Th3Fog ($21.04 in chips) 
Seat 4: Sharks_Nica ($28.88 in chips) 
Seat 5: jamielniak ($25 in chips) 
Seat 6: deadmoneykid ($23.65 in chips) 
Seat 7: 2997qwer ($12.35 in chips) 
Seat 8: doanut13 ($21.39 in chips) 
Seat 9: DooMSDaY1337 ($63.45 in chips) 
chiyuki: posts small blind $0.10
Th3Fog: posts big blind $0.25
*** HOLE CARDS ***
Dealt to chiyuki [Th 6s]
Sharks_Nica: folds 
jamielniak: folds 
deadmoneykid: folds 
2997qwer: folds 
doanut13: calls $0.25
DooMSDaY1337: folds 
AndiM64: folds 
chiyuki: folds 
Th3Fog: checks 
*** FLOP *** [4c Kc Jd]
Th3Fog: checks 
doanut13: checks 
*** TURN *** [4c Kc Jd] [8c]
Th3Fog: bets $0.33
doanut13: calls $0.33
*** RIVER *** [4c Kc Jd 8c] [8h]
Th3Fog: bets $0.70
doanut13: calls $0.70
*** SHOW DOWN ***
Th3Fog: shows [Tc Qc] (a flush, King high)
doanut13: mucks hand 
Th3Fog collected $2.54 from pot
*** SUMMARY ***
Total pot $2.66 | Rake $0.12 
Board [4c Kc Jd 8c 8h]
Seat 1: AndiM64 (button) folded before Flop (didn't bet)
Seat 2: chiyuki (small blind) folded before Flop
Seat 3: Th3Fog (big blind) showed [Tc Qc] and won ($2.54) with a flush, King high
Seat 4: Sharks_Nica folded before Flop (didn't bet)
Seat 5: jamielniak folded before Flop (didn't bet)
Seat 6: deadmoneykid folded before Flop (didn't bet)
Seat 7: 2997qwer folded before Flop (didn't bet)
Seat 8: doanut13 mucked [5h Kh]
Seat 9: DooMSDaY1337 folded before Flop (didn't bet)



PokerStars Zoom Hand #84298278266:  Hold'em No Limit ($0.10/$0.25) - 2012/08/05 13:04:53 JST [2012/08/05 0:04:53 ET]
Table 'Whirlpool' 9-max Seat #1 is the button
Seat 1: mayathebee83 ($9.50 in chips) 
Seat 2: RomarioJa ($10.56 in chips) 
Seat 3: masterkoolb ($13.37 in chips) 
Seat 4: AUGH-AUGH ($30.47 in chips) 
Seat 5: fwani ($25 in chips) 
Seat 6: BlOnDhOlIc ($25.15 in chips) 
Seat 7: jtedecaliss ($175.77 in chips) 
Seat 8: Medic8681 ($12.85 in chips) 
Seat 9: chiyuki ($36.26 in chips) 
RomarioJa: posts small blind $0.10
masterkoolb: posts big blind $0.25
*** HOLE CARDS ***
Dealt to chiyuki [9s 6h]
AUGH-AUGH: folds 
fwani: folds 
BlOnDhOlIc: folds 
jtedecaliss: folds 
Medic8681: folds 
chiyuki: folds 
mayathebee83: folds 
RomarioJa: folds 
Uncalled bet ($0.15) returned to masterkoolb
masterkoolb collected $0.20 from pot
masterkoolb: doesn't show hand 
*** SUMMARY ***
Total pot $0.20 | Rake $0 
Seat 1: mayathebee83 (button) folded before Flop (didn't bet)
Seat 2: RomarioJa (small blind) folded before Flop
Seat 3: masterkoolb (big blind) collected ($0.20)
Seat 4: AUGH-AUGH folded before Flop (didn't bet)
Seat 5: fwani folded before Flop (didn't bet)
Seat 6: BlOnDhOlIc folded before Flop (didn't bet)
Seat 7: jtedecaliss folded before Flop (didn't bet)
Seat 8: Medic8681 folded before Flop (didn't bet)
Seat 9: chiyuki folded before Flop (didn't bet)



PokerStars Zoom Hand #84298275444:  Hold'em No Limit ($0.10/$0.25) - 2012/08/05 13:04:43 JST [2012/08/05 0:04:43 ET]
Table 'Whirlpool' 9-max Seat #1 is the button
Seat 1: Lasutchik ($26.36 in chips) 
Seat 2: Oswulf ($13.98 in chips) 
Seat 3: fwani ($25 in chips) 
Seat 4: KeLevro0 ($13.02 in chips) 
Seat 5: Loholov ($16.10 in chips) 
Seat 6: chiyuki ($36.26 in chips) 
Seat 7: silvno31 ($44.48 in chips) 
Seat 8: monst3r4119 ($23.17 in chips) 
Seat 9: BlOnDhOlIc ($43.62 in chips) 
Oswulf: posts small blind $0.10
fwani: posts big blind $0.25
*** HOLE CARDS ***
Dealt to chiyuki [7d 3c]
KeLevro0: raises $0.42 to $0.67
Loholov: raises $1.08 to $1.75
chiyuki: folds 
silvno31: folds 
monst3r4119: folds 
BlOnDhOlIc: folds 
Lasutchik: folds 
Oswulf: folds 
fwani: folds 
KeLevro0: raises $11.27 to $13.02 and is all-in
Loholov: calls $11.27
*** FLOP *** [Jd Jc Qs]
*** TURN *** [Jd Jc Qs] [2c]
*** RIVER *** [Jd Jc Qs 2c] [Ac]
*** SHOW DOWN ***
KeLevro0: shows [Ah Kc] (two pair, Aces and Jacks)
Loholov: shows [As Qd] (two pair, Aces and Queens)
Loholov collected $25.20 from pot
*** SUMMARY ***
Total pot $26.39 | Rake $1.19 
Board [Jd Jc Qs 2c Ac]
Seat 1: Lasutchik (button) folded before Flop (didn't bet)
Seat 2: Oswulf (small blind) folded before Flop
Seat 3: fwani (big blind) folded before Flop
Seat 4: KeLevro0 showed [Ah Kc] and lost with two pair, Aces and Jacks
Seat 5: Loholov showed [As Qd] and won ($25.20) with two pair, Aces and Queens
Seat 6: chiyuki folded before Flop (didn't bet)
Seat 7: silvno31 folded before Flop (didn't bet)
Seat 8: monst3r4119 folded before Flop (didn't bet)
Seat 9: BlOnDhOlIc folded before Flop (didn't bet)



PokerStars Zoom Hand #84298280548:  Hold'em No Limit ($0.10/$0.25) - 2012/08/05 13:05:01 JST [2012/08/05 0:05:01 ET]
Table 'Whirlpool' 9-max Seat #1 is the button
Seat 1: jethaz ($80.72 in chips) 
Seat 2: THE_BIG_BOTT ($12.12 in chips) 
Seat 3: Sharks_Nica ($31.77 in chips) 
Seat 4: TErr18 ($25.68 in chips) 
Seat 5: chiyuki ($36.26 in chips) 
Seat 6: DooMSDaY1337 ($38.79 in chips) 
Seat 7: vit 111 ($48.17 in chips) 
Seat 8: AndiM64 ($40.70 in chips) 
Seat 9: slickthis ($27.66 in chips) 
THE_BIG_BOTT: posts small blind $0.10
Sharks_Nica: posts big blind $0.25
*** HOLE CARDS ***
Dealt to chiyuki [Jd 7h]
TErr18: calls $0.25
chiyuki: folds 
DooMSDaY1337: raises $0.75 to $1
vit 111: folds 
AndiM64: folds 
slickthis: folds 
jethaz: folds 
THE_BIG_BOTT: folds 
Sharks_Nica: folds 
TErr18: calls $0.75
*** FLOP *** [3s Kd Ts]
TErr18: checks 
DooMSDaY1337: bets $1.12
TErr18: folds 
Uncalled bet ($1.12) returned to DooMSDaY1337
DooMSDaY1337 collected $2.24 from pot
DooMSDaY1337: doesn't show hand 
*** SUMMARY ***
Total pot $2.35 | Rake $0.11 
Board [3s Kd Ts]
Seat 1: jethaz (button) folded before Flop (didn't bet)
Seat 2: THE_BIG_BOTT (small blind) folded before Flop
Seat 3: Sharks_Nica (big blind) folded before Flop
Seat 4: TErr18 folded on the Flop
Seat 5: chiyuki folded before Flop (didn't bet)
Seat 6: DooMSDaY1337 collected ($2.24)
Seat 7: vit 111 folded before Flop (didn't bet)
Seat 8: AndiM64 folded before Flop (didn't bet)
Seat 9: slickthis folded before Flop (didn't bet)



PokerStars Zoom Hand #84298287103:  Hold'em No Limit ($0.10/$0.25) - 2012/08/05 13:05:23 JST [2012/08/05 0:05:23 ET]
Table 'Whirlpool' 9-max Seat #1 is the button
Seat 1: chiyuki ($36.26 in chips) 
Seat 2: mollybally1 ($14.97 in chips) 
Seat 3: PetitAlejo ($25 in chips) 
Seat 4: deadmoneykid ($22.05 in chips) 
Seat 5: Oswulf ($13.88 in chips) 
Seat 6: KeLevro0 ($12.50 in chips) 
Seat 7: s9999999 ($13.65 in chips) 
Seat 8: seula i ($83.97 in chips) 
Seat 9: Th3Fog ($22.30 in chips) 
mollybally1: posts small blind $0.10
PetitAlejo: posts big blind $0.25
*** HOLE CARDS ***
Dealt to chiyuki [9c 7s]
deadmoneykid: calls $0.25
Oswulf: folds 
KeLevro0: folds 
s9999999: folds 
seula i: folds 
Th3Fog: folds 
chiyuki: folds 
mollybally1: calls $0.15
PetitAlejo: checks 
*** FLOP *** [Ad 3c 4c]
mollybally1: checks 
PetitAlejo: bets $0.50
deadmoneykid: folds 
mollybally1: folds 
Uncalled bet ($0.50) returned to PetitAlejo
PetitAlejo collected $0.72 from pot
PetitAlejo: doesn't show hand 
*** SUMMARY ***
Total pot $0.75 | Rake $0.03 
Board [Ad 3c 4c]
Seat 1: chiyuki (button) folded before Flop (didn't bet)
Seat 2: mollybally1 (small blind) folded on the Flop
Seat 3: PetitAlejo (big blind) collected ($0.72)
Seat 4: deadmoneykid folded on the Flop
Seat 5: Oswulf folded before Flop (didn't bet)
Seat 6: KeLevro0 folded before Flop (didn't bet)
Seat 7: s9999999 folded before Flop (didn't bet)
Seat 8: seula i folded before Flop (didn't bet)
Seat 9: Th3Fog folded before Flop (didn't bet)



PokerStars Zoom Hand #84298281730:  Hold'em No Limit ($0.10/$0.25) - 2012/08/05 13:05:05 JST [2012/08/05 0:05:05 ET]
Table 'Whirlpool' 9-max Seat #1 is the button
Seat 1: pyty_82 ($50.39 in chips) 
Seat 2: KrystalAA ($35.51 in chips) 
Seat 3: Medic8681 ($13.57 in chips) 
Seat 4: chiyuki ($36.26 in chips) 
Seat 5: 1474 BigJohn ($33.11 in chips) 
Seat 6: Lasutchik ($10.75 in chips) 
Seat 7: Assassin365 ($33.20 in chips) 
Seat 8: KeLevro0 ($12.03 in chips) 
Seat 9: THE_BIG_BOTT ($12.02 in chips) 
KrystalAA: posts small blind $0.10
Medic8681: posts big blind $0.25
*** HOLE CARDS ***
Dealt to chiyuki [7c Kh]
chiyuki: folds 
1474 BigJohn: calls $0.25
Lasutchik: folds 
Assassin365: folds 
KeLevro0: folds 
THE_BIG_BOTT: folds 
pyty_82: folds 
KrystalAA: calls $0.15
Medic8681: raises $0.75 to $1
1474 BigJohn: calls $0.75
KrystalAA: calls $0.75
*** FLOP *** [2d 6h 5s]
KrystalAA: checks 
Medic8681: bets $2
1474 BigJohn: folds 
KrystalAA: folds 
Uncalled bet ($2) returned to Medic8681
Medic8681 collected $2.86 from pot
Medic8681: doesn't show hand 
*** SUMMARY ***
Total pot $3 | Rake $0.14 
Board [2d 6h 5s]
Seat 1: pyty_82 (button) folded before Flop (didn't bet)
Seat 2: KrystalAA (small blind) folded on the Flop
Seat 3: Medic8681 (big blind) collected ($2.86)
Seat 4: chiyuki folded before Flop (didn't bet)
Seat 5: 1474 BigJohn folded on the Flop
Seat 6: Lasutchik folded before Flop (didn't bet)
Seat 7: Assassin365 folded before Flop (didn't bet)
Seat 8: KeLevro0 folded before Flop (didn't bet)
Seat 9: THE_BIG_BOTT folded before Flop (didn't bet)



PokerStars Zoom Hand #84298282888:  Hold'em No Limit ($0.10/$0.25) - 2012/08/05 13:05:09 JST [2012/08/05 0:05:09 ET]
Table 'Whirlpool' 9-max Seat #1 is the button
Seat 1: THE_BIG_BOTT ($12.02 in chips) 
Seat 2: BlOnDhOlIc ($25.15 in chips) 
Seat 3: taksist889 ($25.17 in chips) 
Seat 4: slickthis ($27.66 in chips) 
Seat 5: chiyuki ($36.26 in chips) 
Seat 6: RomarioJa ($12.66 in chips) 
Seat 7: puffy5533 ($23.43 in chips) 
Seat 8: fwani ($42.37 in chips) 
Seat 9: Anafim ($27.25 in chips) 
BlOnDhOlIc: posts small blind $0.10
taksist889: posts big blind $0.25
*** HOLE CARDS ***
Dealt to chiyuki [8h Ah]
slickthis: raises $0.25 to $0.50
chiyuki: folds 
RomarioJa: folds 
puffy5533: folds 
fwani: folds 
Anafim: folds 
THE_BIG_BOTT: folds 
BlOnDhOlIc: calls $0.40
taksist889: folds 
*** FLOP *** [6d 9s Jc]
BlOnDhOlIc: bets $0.89
slickthis: raises $0.89 to $1.78
BlOnDhOlIc: calls $0.89
*** TURN *** [6d 9s Jc] [2h]
BlOnDhOlIc: checks 
slickthis: bets $1.75
BlOnDhOlIc: calls $1.75
*** RIVER *** [6d 9s Jc 2h] [6s]
BlOnDhOlIc: checks 
slickthis: bets $3
BlOnDhOlIc: folds 
Uncalled bet ($3) returned to slickthis
slickthis collected $7.94 from pot
slickthis: doesn't show hand 
*** SUMMARY ***
Total pot $8.31 | Rake $0.37 
Board [6d 9s Jc 2h 6s]
Seat 1: THE_BIG_BOTT (button) folded before Flop (didn't bet)
Seat 2: BlOnDhOlIc (small blind) folded on the River
Seat 3: taksist889 (big blind) folded before Flop
Seat 4: slickthis collected ($7.94)
Seat 5: chiyuki folded before Flop (didn't bet)
Seat 6: RomarioJa folded before Flop (didn't bet)
Seat 7: puffy5533 folded before Flop (didn't bet)
Seat 8: fwani folded before Flop (didn't bet)
Seat 9: Anafim folded before Flop (didn't bet)



PokerStars Zoom Hand #84298306237:  Hold'em No Limit ($0.10/$0.25) - 2012/08/05 13:06:29 JST [2012/08/05 0:06:29 ET]
Table 'Whirlpool' 9-max Seat #1 is the button
Seat 1: silvno31 ($44.48 in chips) 
Seat 2: PetitAlejo ($26.10 in chips) 
Seat 3: Zugrug ($25 in chips) 
Seat 4: TraderYao ($25.37 in chips) 
Seat 5: Alvinpe85 ($26.68 in chips) 
Seat 6: hassantas ($25 in chips) 
Seat 7: chiyuki ($36.01 in chips) 
Seat 8: RomarioJa ($6.30 in chips) 
Seat 9: masterkoolb ($13.22 in chips) 
PetitAlejo: posts small blind $0.10
Zugrug: posts big blind $0.25
*** HOLE CARDS ***
Dealt to chiyuki [7d 2h]
TraderYao: raises $0.50 to $0.75
Alvinpe85: folds 
hassantas: folds 
chiyuki: folds 
RomarioJa: folds 
masterkoolb: folds 
silvno31: folds 
PetitAlejo: folds 
Zugrug: folds 
Uncalled bet ($0.50) returned to TraderYao
TraderYao collected $0.60 from pot
TraderYao: doesn't show hand 
*** SUMMARY ***
Total pot $0.60 | Rake $0 
Seat 1: silvno31 (button) folded before Flop (didn't bet)
Seat 2: PetitAlejo (small blind) folded before Flop
Seat 3: Zugrug (big blind) folded before Flop
Seat 4: TraderYao collected ($0.60)
Seat 5: Alvinpe85 folded before Flop (didn't bet)
Seat 6: hassantas folded before Flop (didn't bet)
Seat 7: chiyuki folded before Flop (didn't bet)
Seat 8: RomarioJa folded before Flop (didn't bet)
Seat 9: masterkoolb folded before Flop (didn't bet)



PokerStars Zoom Hand #84298304214:  Hold'em No Limit ($0.10/$0.25) - 2012/08/05 13:06:22 JST [2012/08/05 0:06:22 ET]
Table 'Whirlpool' 9-max Seat #1 is the button
Seat 1: DooMSDaY1337 ($27.17 in chips) 
Seat 2: Th3Fog ($23.75 in chips) 
Seat 3: MibNe ($29.38 in chips) 
Seat 4: jamielniak ($25 in chips) 
Seat 5: BlOnDhOlIc ($28.55 in chips) 
Seat 6: Lasutchik ($26.92 in chips) 
Seat 7: mid22 ($12.06 in chips) 
Seat 8: chiyuki ($36.01 in chips) 
Seat 9: THE_BIG_BOTT ($12.68 in chips) 
Th3Fog: posts small blind $0.10
MibNe: posts big blind $0.25
*** HOLE CARDS ***
Dealt to chiyuki [4d 9h]
jamielniak: folds 
BlOnDhOlIc: raises $0.25 to $0.50
Lasutchik: folds 
mid22: folds 
chiyuki: folds 
THE_BIG_BOTT: folds 
DooMSDaY1337: raises $1.50 to $2
Th3Fog: folds 
MibNe: folds 
BlOnDhOlIc: raises $2.25 to $4.25
DooMSDaY1337: folds 
Uncalled bet ($2.25) returned to BlOnDhOlIc
BlOnDhOlIc collected $4.35 from pot
BlOnDhOlIc: doesn't show hand 
*** SUMMARY ***
Total pot $4.35 | Rake $0 
Seat 1: DooMSDaY1337 (button) folded before Flop
Seat 2: Th3Fog (small blind) folded before Flop
Seat 3: MibNe (big blind) folded before Flop
Seat 4: jamielniak folded before Flop (didn't bet)
Seat 5: BlOnDhOlIc collected ($4.35)
Seat 6: Lasutchik folded before Flop (didn't bet)
Seat 7: mid22 folded before Flop (didn't bet)
Seat 8: chiyuki folded before Flop (didn't bet)
Seat 9: THE_BIG_BOTT folded before Flop (didn't bet)



PokerStars Zoom Hand #84298292706:  Hold'em No Limit ($0.10/$0.25) - 2012/08/05 13:05:42 JST [2012/08/05 0:05:42 ET]
Table 'Whirlpool' 9-max Seat #1 is the button
Seat 1: TErr18 ($24.33 in chips) 
Seat 2: mid22 ($12.91 in chips) 
Seat 3: chiyuki ($36.26 in chips) 
Seat 4: wtu1986 ($25 in chips) 
Seat 5: Sharks_Nica ($28.78 in chips) 
Seat 6: luyifei ($15.53 in chips) 
Seat 7: DooMSDaY1337 ($32.74 in chips) 
Seat 8: slapshot2011 ($36.48 in chips) 
Seat 9: Loholov ($16.02 in chips) 
mid22: posts small blind $0.10
chiyuki: posts big blind $0.25
*** HOLE CARDS ***
Dealt to chiyuki [9s Tc]
wtu1986: folds 
Sharks_Nica: folds 
luyifei: calls $0.25
DooMSDaY1337: folds 
slapshot2011: folds 
Loholov: folds 
TErr18: calls $0.25
mid22: folds 
chiyuki: checks 
*** FLOP *** [5h Jc Ks]
chiyuki: checks 
luyifei: bets $0.75
TErr18: calls $0.75
chiyuki: folds 
*** TURN *** [5h Jc Ks] [Kc]
luyifei: checks 
TErr18: bets $1
luyifei: calls $1
*** RIVER *** [5h Jc Ks Kc] [3d]
luyifei: bets $2.25
TErr18: folds 
Uncalled bet ($2.25) returned to luyifei
luyifei collected $4.15 from pot
luyifei: doesn't show hand 
*** SUMMARY ***
Total pot $4.35 | Rake $0.20 
Board [5h Jc Ks Kc 3d]
Seat 1: TErr18 (button) folded on the River
Seat 2: mid22 (small blind) folded before Flop
Seat 3: chiyuki (big blind) folded on the Flop
Seat 4: wtu1986 folded before Flop (didn't bet)
Seat 5: Sharks_Nica folded before Flop (didn't bet)
Seat 6: luyifei collected ($4.15)
Seat 7: DooMSDaY1337 folded before Flop (didn't bet)
Seat 8: slapshot2011 folded before Flop (didn't bet)
Seat 9: Loholov folded before Flop (didn't bet)



PokerStars Zoom Hand #84298311576:  Hold'em No Limit ($0.10/$0.25) - 2012/08/05 13:06:47 JST [2012/08/05 0:06:47 ET]
Table 'Whirlpool' 9-max Seat #1 is the button
Seat 1: deadmoneykid ($25.14 in chips) 
Seat 2: softdesign ($41.67 in chips) 
Seat 3: TraderYao ($25 in chips) 
Seat 4: Jippyflip ($22.57 in chips) 
Seat 5: s9999999 ($15.30 in chips) 
Seat 6: KeLevro0 ($10.95 in chips) 
Seat 7: PetitAlejo ($26 in chips) 
Seat 8: wtu1986 ($25.66 in chips) 
Seat 9: chiyuki ($35.91 in chips) 
softdesign: posts small blind $0.10
TraderYao: posts big blind $0.25
*** HOLE CARDS ***
Dealt to chiyuki [3c 7d]
Jippyflip: folds 
s9999999: folds 
KeLevro0: folds 
PetitAlejo: folds 
wtu1986: folds 
chiyuki: folds 
deadmoneykid: raises $0.35 to $0.60
softdesign: folds 
TraderYao: folds 
Uncalled bet ($0.35) returned to deadmoneykid
deadmoneykid collected $0.60 from pot
deadmoneykid: doesn't show hand 
*** SUMMARY ***
Total pot $0.60 | Rake $0 
Seat 1: deadmoneykid (button) collected ($0.60)
Seat 2: softdesign (small blind) folded before Flop
Seat 3: TraderYao (big blind) folded before Flop
Seat 4: Jippyflip folded before Flop (didn't bet)
Seat 5: s9999999 folded before Flop (didn't bet)
Seat 6: KeLevro0 folded before Flop (didn't bet)
Seat 7: PetitAlejo folded before Flop (didn't bet)
Seat 8: wtu1986 folded before Flop (didn't bet)
Seat 9: chiyuki folded before Flop (didn't bet)



PokerStars Zoom Hand #84298310070:  Hold'em No Limit ($0.10/$0.25) - 2012/08/05 13:06:42 JST [2012/08/05 0:06:42 ET]
Table 'Whirlpool' 9-max Seat #1 is the button
Seat 1: masterkoolb ($13.12 in chips) 
Seat 2: chiyuki ($36.01 in chips) 
Seat 3: gunbowler ($87.94 in chips) 
Seat 4: Seadogvcd ($5.71 in chips) 
Seat 5: Jippyflip ($22.57 in chips) 
Seat 6: seula i ($84.07 in chips) 
Seat 7: BlOnDhOlIc ($25.35 in chips) 
Seat 8: jamielniak ($25 in chips) 
Seat 9: RomarioJa ($6.30 in chips) 
chiyuki: posts small blind $0.10
gunbowler: posts big blind $0.25
*** HOLE CARDS ***
Dealt to chiyuki [7c 8h]
Seadogvcd: calls $0.25
Jippyflip: folds 
seula i: calls $0.25
BlOnDhOlIc: folds 
jamielniak: folds 
RomarioJa: raises $0.50 to $0.75
masterkoolb: folds 
chiyuki: folds 
gunbowler: raises $1.75 to $2.50
Seadogvcd: raises $3.21 to $5.71 and is all-in
seula i: folds 
RomarioJa: folds 
gunbowler: calls $3.21
*** FLOP *** [Th 9c Js]
*** TURN *** [Th 9c Js] [4h]
*** RIVER *** [Th 9c Js 4h] [6s]
*** SHOW DOWN ***
gunbowler: shows [Qc Qd] (a pair of Queens)
Seadogvcd: shows [6c 5c] (a pair of Sixes)
gunbowler collected $11.96 from pot
*** SUMMARY ***
Total pot $12.52 | Rake $0.56 
Board [Th 9c Js 4h 6s]
Seat 1: masterkoolb (button) folded before Flop (didn't bet)
Seat 2: chiyuki (small blind) folded before Flop
Seat 3: gunbowler (big blind) showed [Qc Qd] and won ($11.96) with a pair of Queens
Seat 4: Seadogvcd showed [6c 5c] and lost with a pair of Sixes
Seat 5: Jippyflip folded before Flop (didn't bet)
Seat 6: seula i folded before Flop
Seat 7: BlOnDhOlIc folded before Flop (didn't bet)
Seat 8: jamielniak folded before Flop (didn't bet)
Seat 9: RomarioJa folded before Flop



PokerStars Zoom Hand #84298315085:  Hold'em No Limit ($0.10/$0.25) - 2012/08/05 13:06:59 JST [2012/08/05 0:06:59 ET]
Table 'Whirlpool' 9-max Seat #1 is the button
Seat 1: slickthis ($31.22 in chips) 
Seat 2: Zugrug ($25 in chips) 
Seat 3: chiyuki ($35.91 in chips) 
Seat 4: RomarioJa ($10.56 in chips) 
Seat 5: Medic8681 ($12.60 in chips) 
Seat 6: Th3Fog ($24 in chips) 
Seat 7: silvno31 ($44.48 in chips) 
Seat 8: Loholov ($15 in chips) 
Seat 9: kamikkaze ($43.70 in chips) 
Zugrug: posts small blind $0.10
chiyuki: posts big blind $0.25
*** HOLE CARDS ***
Dealt to chiyuki [5d Th]
RomarioJa: folds 
Medic8681 has timed out
Medic8681: folds 
Th3Fog: folds 
silvno31: folds 
Loholov: folds 
kamikkaze: folds 
slickthis: folds 
Zugrug: folds 
Uncalled bet ($0.15) returned to chiyuki
chiyuki collected $0.20 from pot
chiyuki: doesn't show hand 
*** SUMMARY ***
Total pot $0.20 | Rake $0 
Seat 1: slickthis (button) folded before Flop (didn't bet)
Seat 2: Zugrug (small blind) folded before Flop
Seat 3: chiyuki (big blind) collected ($0.20)
Seat 4: RomarioJa folded before Flop (didn't bet)
Seat 5: Medic8681 folded before Flop (didn't bet)
Seat 6: Th3Fog folded before Flop (didn't bet)
Seat 7: silvno31 folded before Flop (didn't bet)
Seat 8: Loholov folded before Flop (didn't bet)
Seat 9: kamikkaze folded before Flop (didn't bet)



PokerStars Zoom Hand #84298313917:  Hold'em No Limit ($0.10/$0.25) - 2012/08/05 13:06:55 JST [2012/08/05 0:06:55 ET]
Table 'Whirlpool' 9-max Seat #1 is the button
Seat 1: kamikkaze ($43.70 in chips) 
Seat 2: monst3r4119 ($27.38 in chips) 
Seat 3: s9999999 ($15.30 in chips) 
Seat 4: chiyuki ($35.91 in chips) 
Seat 5: nice.franki ($13.25 in chips) 
Seat 6: Th3Fog ($61.81 in chips) 
Seat 7: BlOnDhOlIc ($30.90 in chips) 
Seat 8: silvno31 ($44.48 in chips) 
Seat 9: KeLevro0 ($10.95 in chips) 
monst3r4119: posts small blind $0.10
s9999999: posts big blind $0.25
*** HOLE CARDS ***
Dealt to chiyuki [Ad 7h]
chiyuki: folds 
nice.franki: folds 
Th3Fog: folds 
BlOnDhOlIc: raises $0.37 to $0.62
silvno31: folds 
KeLevro0: folds 
kamikkaze: folds 
monst3r4119: folds 
s9999999: calls $0.37
*** FLOP *** [Th 5s Qd]
s9999999: checks 
BlOnDhOlIc: bets $1
s9999999: calls $1
*** TURN *** [Th 5s Qd] [4s]
s9999999: checks 
BlOnDhOlIc: checks 
*** RIVER *** [Th 5s Qd 4s] [2h]
s9999999: bets $1
BlOnDhOlIc: calls $1
*** SHOW DOWN ***
s9999999: shows [As Ts] (a pair of Tens)
BlOnDhOlIc: shows [Jd Jc] (a pair of Jacks)
BlOnDhOlIc collected $5.10 from pot
*** SUMMARY ***
Total pot $5.34 | Rake $0.24 
Board [Th 5s Qd 4s 2h]
Seat 1: kamikkaze (button) folded before Flop (didn't bet)
Seat 2: monst3r4119 (small blind) folded before Flop
Seat 3: s9999999 (big blind) showed [As Ts] and lost with a pair of Tens
Seat 4: chiyuki folded before Flop (didn't bet)
Seat 5: nice.franki folded before Flop (didn't bet)
Seat 6: Th3Fog folded before Flop (didn't bet)
Seat 7: BlOnDhOlIc showed [Jd Jc] and won ($5.10) with a pair of Jacks
Seat 8: silvno31 folded before Flop (didn't bet)
Seat 9: KeLevro0 folded before Flop (didn't bet)



PokerStars Zoom Hand #84298323470:  Hold'em No Limit ($0.10/$0.25) - 2012/08/05 13:07:28 JST [2012/08/05 0:07:28 ET]
Table 'Whirlpool' 9-max Seat #1 is the button
Seat 1: chiyuki ($36.01 in chips) 
Seat 2: seula i ($83.82 in chips) 
Seat 3: slickthis ($31.22 in chips) 
Seat 4: DooMSDaY1337 ($66.09 in chips) 
Seat 5: Chevydale ($11.36 in chips) 
Seat 6: wtu1986 ($24.90 in chips) 
Seat 7: Loholov ($15 in chips) 
Seat 8: Th3Fog ($61.56 in chips) 
Seat 9: monst3r4119 ($27.28 in chips) 
seula i: posts small blind $0.10
slickthis: posts big blind $0.25
*** HOLE CARDS ***
Dealt to chiyuki [7h Ah]
DooMSDaY1337: folds 
Chevydale: folds 
wtu1986: folds 
Loholov: folds 
Th3Fog: folds 
monst3r4119: folds 
chiyuki: raises $0.50 to $0.75
seula i: folds 
slickthis: calls $0.50
*** FLOP *** [4s 6c 3d]
slickthis: bets $0.25
chiyuki: raises $0.50 to $0.75
slickthis: calls $0.50
*** TURN *** [4s 6c 3d] [As]
slickthis: bets $0.25
chiyuki: raises $1 to $1.25
slickthis: calls $1
*** RIVER *** [4s 6c 3d As] [4d]
slickthis: bets $2.25
chiyuki: calls $2.25
*** SHOW DOWN ***
slickthis: shows [5s Js] (a pair of Fours)
chiyuki: shows [7h Ah] (two pair, Aces and Fours)
chiyuki collected $9.65 from pot
*** SUMMARY ***
Total pot $10.10 | Rake $0.45 
Board [4s 6c 3d As 4d]
Seat 1: chiyuki (button) showed [7h Ah] and won ($9.65) with two pair, Aces and Fours
Seat 2: seula i (small blind) folded before Flop
Seat 3: slickthis (big blind) showed [5s Js] and lost with a pair of Fours
Seat 4: DooMSDaY1337 folded before Flop (didn't bet)
Seat 5: Chevydale folded before Flop (didn't bet)
Seat 6: wtu1986 folded before Flop (didn't bet)
Seat 7: Loholov folded before Flop (didn't bet)
Seat 8: Th3Fog folded before Flop (didn't bet)
Seat 9: monst3r4119 folded before Flop (didn't bet)



PokerStars Zoom Hand #84298350450:  Hold'em No Limit ($0.10/$0.25) - 2012/08/05 13:09:01 JST [2012/08/05 0:09:01 ET]
Table 'Whirlpool' 9-max Seat #1 is the button
Seat 1: SlimeyGash ($22.75 in chips) 
Seat 2: Roglus ($21.69 in chips) 
Seat 3: Th3Fog ($61.46 in chips) 
Seat 4: Lasutchik ($26.17 in chips) 
Seat 5: DooMSDaY1337 ($25.45 in chips) 
Seat 6: chiyuki ($40.66 in chips) 
Seat 7: RomarioJa ($11.39 in chips) 
Seat 8: JAMES3FINGER ($332.37 in chips) 
Seat 9: TraderYao ($25 in chips) 
Roglus: posts small blind $0.10
Th3Fog: posts big blind $0.25
*** HOLE CARDS ***
Dealt to chiyuki [9h Qs]
Lasutchik: folds 
DooMSDaY1337: folds 
chiyuki: folds 
RomarioJa: raises $0.37 to $0.62
JAMES3FINGER: folds 
TraderYao: folds 
SlimeyGash: folds 
Roglus: folds 
Th3Fog: folds 
Uncalled bet ($0.37) returned to RomarioJa
RomarioJa collected $0.60 from pot
RomarioJa: doesn't show hand 
*** SUMMARY ***
Total pot $0.60 | Rake $0 
Seat 1: SlimeyGash (button) folded before Flop (didn't bet)
Seat 2: Roglus (small blind) folded before Flop
Seat 3: Th3Fog (big blind) folded before Flop
Seat 4: Lasutchik folded before Flop (didn't bet)
Seat 5: DooMSDaY1337 folded before Flop (didn't bet)
Seat 6: chiyuki folded before Flop (didn't bet)
Seat 7: RomarioJa collected ($0.60)
Seat 8: JAMES3FINGER folded before Flop (didn't bet)
Seat 9: TraderYao folded before Flop (didn't bet)



PokerStars Zoom Hand #84298352487:  Hold'em No Limit ($0.10/$0.25) - 2012/08/05 13:09:08 JST [2012/08/05 0:09:08 ET]
Table 'Whirlpool' 9-max Seat #1 is the button
Seat 1: nice.franki ($13.65 in chips) 
Seat 2: Jene4kaBest ($8.38 in chips) 
Seat 3: Roglus ($16.35 in chips) 
Seat 4: masterkoolb ($13.88 in chips) 
Seat 5: DanyArdaggo ($24.30 in chips) 
Seat 6: seula i ($25.68 in chips) 
Seat 7: chiyuki ($40.66 in chips) 
Seat 8: TErr18 ($21.63 in chips) 
Seat 9: SlimeyGash ($22.75 in chips) 
Jene4kaBest: posts small blind $0.10
Roglus: posts big blind $0.25
*** HOLE CARDS ***
Dealt to chiyuki [4h 4c]
masterkoolb: folds 
DanyArdaggo: folds 
seula i: folds 
chiyuki: raises $0.50 to $0.75
TErr18: calls $0.75
SlimeyGash: folds 
nice.franki: folds 
Jene4kaBest: folds 
Roglus: folds 
*** FLOP *** [9s 3s 7d]
chiyuki: bets $1
TErr18: folds 
Uncalled bet ($1) returned to chiyuki
chiyuki collected $1.77 from pot
chiyuki: doesn't show hand 
*** SUMMARY ***
Total pot $1.85 | Rake $0.08 
Board [9s 3s 7d]
Seat 1: nice.franki (button) folded before Flop (didn't bet)
Seat 2: Jene4kaBest (small blind) folded before Flop
Seat 3: Roglus (big blind) folded before Flop
Seat 4: masterkoolb folded before Flop (didn't bet)
Seat 5: DanyArdaggo folded before Flop (didn't bet)
Seat 6: seula i folded before Flop (didn't bet)
Seat 7: chiyuki collected ($1.77)
Seat 8: TErr18 folded on the Flop
Seat 9: SlimeyGash folded before Flop (didn't bet)



PokerStars Zoom Hand #84298347279:  Hold'em No Limit ($0.10/$0.25) - 2012/08/05 13:08:50 JST [2012/08/05 0:08:50 ET]
Table 'Whirlpool' 9-max Seat #1 is the button
Seat 1: slickthis ($26.22 in chips) 
Seat 2: PetitAlejo ($40.72 in chips) 
Seat 3: fwani ($42.71 in chips) 
Seat 4: Lab50att ($16.57 in chips) 
Seat 5: eagie20 ($146.65 in chips) 
Seat 6: wtu1986 ($24.75 in chips) 
Seat 7: Medic8681 ($12.50 in chips) 
Seat 8: chiyuki ($40.66 in chips) 
Seat 9: slapshot2011 ($37.72 in chips) 
PetitAlejo: posts small blind $0.10
fwani: posts big blind $0.25
*** HOLE CARDS ***
Dealt to chiyuki [6d Ts]
Lab50att: folds 
eagie20: raises $0.50 to $0.75
wtu1986: folds 
Medic8681: folds 
chiyuki: folds 
slapshot2011: folds 
slickthis: folds 
PetitAlejo: folds 
fwani: calls $0.50
*** FLOP *** [Ac 8s 6c]
fwani: checks 
eagie20: bets $1
fwani: folds 
Uncalled bet ($1) returned to eagie20
eagie20 collected $1.53 from pot
eagie20: doesn't show hand 
*** SUMMARY ***
Total pot $1.60 | Rake $0.07 
Board [Ac 8s 6c]
Seat 1: slickthis (button) folded before Flop (didn't bet)
Seat 2: PetitAlejo (small blind) folded before Flop
Seat 3: fwani (big blind) folded on the Flop
Seat 4: Lab50att folded before Flop (didn't bet)
Seat 5: eagie20 collected ($1.53)
Seat 6: wtu1986 folded before Flop (didn't bet)
Seat 7: Medic8681 folded before Flop (didn't bet)
Seat 8: chiyuki folded before Flop (didn't bet)
Seat 9: slapshot2011 folded before Flop (didn't bet)



PokerStars Zoom Hand #84298361617:  Hold'em No Limit ($0.10/$0.25) - 2012/08/05 13:09:40 JST [2012/08/05 0:09:40 ET]
Table 'Whirlpool' 9-max Seat #1 is the button
Seat 1: Rodina-Kr ($25 in chips) 
Seat 2: chiyuki ($41.68 in chips) 
Seat 3: doanut13 ($17.70 in chips) 
Seat 4: TraderYao ($25 in chips) 
Seat 5: Th3Fog ($23.85 in chips) 
Seat 6: Medic8681 ($12.50 in chips) 
Seat 7: taksist889 ($30.31 in chips) 
Seat 8: Zugrug ($25.45 in chips) 
Seat 9: BlOnDhOlIc ($25 in chips) 
chiyuki: posts small blind $0.10
doanut13: posts big blind $0.25
*** HOLE CARDS ***
Dealt to chiyuki [4s Kd]
TraderYao: folds 
Th3Fog: raises $0.35 to $0.60
Medic8681: folds 
taksist889: folds 
Zugrug: folds 
BlOnDhOlIc: folds 
Rodina-Kr: folds 
chiyuki: folds 
doanut13: folds 
Uncalled bet ($0.35) returned to Th3Fog
Th3Fog collected $0.60 from pot
Th3Fog: doesn't show hand 
*** SUMMARY ***
Total pot $0.60 | Rake $0 
Seat 1: Rodina-Kr (button) folded before Flop (didn't bet)
Seat 2: chiyuki (small blind) folded before Flop
Seat 3: doanut13 (big blind) folded before Flop
Seat 4: TraderYao folded before Flop (didn't bet)
Seat 5: Th3Fog collected ($0.60)
Seat 6: Medic8681 folded before Flop (didn't bet)
Seat 7: taksist889 folded before Flop (didn't bet)
Seat 8: Zugrug folded before Flop (didn't bet)
Seat 9: BlOnDhOlIc folded before Flop (didn't bet)



PokerStars Zoom Hand #84298366887:  Hold'em No Limit ($0.10/$0.25) - 2012/08/05 13:09:58 JST [2012/08/05 0:09:58 ET]
Table 'Whirlpool' 9-max Seat #1 is the button
Seat 1: masterkoolb ($12.50 in chips) 
Seat 2: Alvinpe85 ($25.35 in chips) 
Seat 3: chiyuki ($41.58 in chips) 
Seat 4: Loholov ($15.60 in chips) 
Seat 5: KrystalAA ($38.60 in chips) 
Seat 6: taksist889 ($30.31 in chips) 
Seat 7: BlOnDhOlIc ($49.80 in chips) 
Seat 8: vit 111 ($38.29 in chips) 
Seat 9: TErr18 ($16.89 in chips) 
Alvinpe85: posts small blind $0.10
chiyuki: posts big blind $0.25
*** HOLE CARDS ***
Dealt to chiyuki [8s Jd]
Loholov: folds 
KrystalAA: folds 
taksist889: folds 
BlOnDhOlIc: folds 
vit 111: folds 
TErr18: folds 
masterkoolb: folds 
Alvinpe85: folds 
Uncalled bet ($0.15) returned to chiyuki
chiyuki collected $0.20 from pot
chiyuki: doesn't show hand 
*** SUMMARY ***
Total pot $0.20 | Rake $0 
Seat 1: masterkoolb (button) folded before Flop (didn't bet)
Seat 2: Alvinpe85 (small blind) folded before Flop
Seat 3: chiyuki (big blind) collected ($0.20)
Seat 4: Loholov folded before Flop (didn't bet)
Seat 5: KrystalAA folded before Flop (didn't bet)
Seat 6: taksist889 folded before Flop (didn't bet)
Seat 7: BlOnDhOlIc folded before Flop (didn't bet)
Seat 8: vit 111 folded before Flop (didn't bet)
Seat 9: TErr18 folded before Flop (didn't bet)



PokerStars Zoom Hand #84298359829:  Hold'em No Limit ($0.10/$0.25) - 2012/08/05 13:09:33 JST [2012/08/05 0:09:33 ET]
Table 'Whirlpool' 9-max Seat #1 is the button
Seat 1: kamikkaze ($47.05 in chips) 
Seat 2: Lasutchik ($11.90 in chips) 
Seat 3: TraderYao ($25 in chips) 
Seat 4: chiyuki ($41.68 in chips) 
Seat 5: envious_0007 ($16.80 in chips) 
Seat 6: fwani ($41.96 in chips) 
Seat 7: hassantas ($25 in chips) 
Seat 8: Roglus ($16 in chips) 
Seat 9: monst3r4119 ($28.07 in chips) 
Lasutchik: posts small blind $0.10
TraderYao: posts big blind $0.25
*** HOLE CARDS ***
Dealt to chiyuki [Qh 7c]
chiyuki: folds 
envious_0007: folds 
fwani: folds 
hassantas: folds 
Roglus: folds 
monst3r4119: folds 
kamikkaze: folds 
Lasutchik has timed out
Lasutchik: folds 
Uncalled bet ($0.15) returned to TraderYao
TraderYao collected $0.20 from pot
TraderYao: doesn't show hand 
*** SUMMARY ***
Total pot $0.20 | Rake $0 
Seat 1: kamikkaze (button) folded before Flop (didn't bet)
Seat 2: Lasutchik (small blind) folded before Flop
Seat 3: TraderYao (big blind) collected ($0.20)
Seat 4: chiyuki folded before Flop (didn't bet)
Seat 5: envious_0007 folded before Flop (didn't bet)
Seat 6: fwani folded before Flop (didn't bet)
Seat 7: hassantas folded before Flop (didn't bet)
Seat 8: Roglus folded before Flop (didn't bet)
Seat 9: monst3r4119 folded before Flop (didn't bet)



PokerStars Zoom Hand #84298364824:  Hold'em No Limit ($0.10/$0.25) - 2012/08/05 13:09:51 JST [2012/08/05 0:09:51 ET]
Table 'Whirlpool' 9-max Seat #1 is the button
Seat 1: doanut13 ($17.45 in chips) 
Seat 2: TraderYao ($25 in chips) 
Seat 3: silvno31 ($42.16 in chips) 
Seat 4: BlOnDhOlIc ($25 in chips) 
Seat 5: chiyuki ($41.58 in chips) 
Seat 6: NastyMcNast ($62.07 in chips) 
Seat 7: ShevchukAI ($20.16 in chips) 
Seat 8: mollybally1 ($13.38 in chips) 
Seat 9: Rodina-Kr ($25 in chips) 
TraderYao: posts small blind $0.10
silvno31: posts big blind $0.25
*** HOLE CARDS ***
Dealt to chiyuki [4d 6s]
BlOnDhOlIc: folds 
chiyuki: folds 
NastyMcNast: raises $0.50 to $0.75
ShevchukAI: folds 
mollybally1: calls $0.75
Rodina-Kr: folds 
doanut13: calls $0.75
TraderYao: folds 
silvno31: folds 
*** FLOP *** [Ah 7s 7h]
NastyMcNast: bets $1.73
mollybally1: calls $1.73
doanut13: raises $14.97 to $16.70 and is all-in
NastyMcNast: calls $14.97
mollybally1: calls $10.90 and is all-in
*** TURN *** [Ah 7s 7h] [Jd]
*** RIVER *** [Ah 7s 7h Jd] [Ac]
*** SHOW DOWN ***
NastyMcNast: shows [7c 6c] (a full house, Sevens full of Aces)
doanut13: shows [As 5d] (a full house, Aces full of Sevens)
doanut13 collected $7.96 from side pot
mollybally1: mucks hand 
doanut13 collected $38.67 from main pot
*** SUMMARY ***
Total pot $48.63 Main pot $38.67. Side pot $7.96. | Rake $2 
Board [Ah 7s 7h Jd Ac]
Seat 1: doanut13 (button) showed [As 5d] and won ($46.63) with a full house, Aces full of Sevens
Seat 2: TraderYao (small blind) folded before Flop
Seat 3: silvno31 (big blind) folded before Flop
Seat 4: BlOnDhOlIc folded before Flop (didn't bet)
Seat 5: chiyuki folded before Flop (didn't bet)
Seat 6: NastyMcNast showed [7c 6c] and lost with a full house, Sevens full of Aces
Seat 7: ShevchukAI folded before Flop (didn't bet)
Seat 8: mollybally1 mucked [Qc Qd]
Seat 9: Rodina-Kr folded before Flop (didn't bet)



PokerStars Zoom Hand #84298377177:  Hold'em No Limit ($0.10/$0.25) - 2012/08/05 13:10:33 JST [2012/08/05 0:10:33 ET]
Table 'Whirlpool' 9-max Seat #1 is the button
Seat 1: puffy5533 ($20.03 in chips) 
Seat 2: BlOnDhOlIc ($25 in chips) 
Seat 3: PetitAlejo ($40.87 in chips) 
Seat 4: Loholov ($15 in chips) 
Seat 5: 2997qwer ($11.45 in chips) 
Seat 6: chiyuki ($41.68 in chips) 
Seat 7: masterkoolb ($12.50 in chips) 
Seat 8: a_tasmanian ($55.42 in chips) 
Seat 9: jtedecaliss ($181.38 in chips) 
BlOnDhOlIc: posts small blind $0.10
PetitAlejo: posts big blind $0.25
*** HOLE CARDS ***
Dealt to chiyuki [3c Kd]
Loholov: folds 
2997qwer: folds 
chiyuki: folds 
masterkoolb: folds 
a_tasmanian: folds 
jtedecaliss: folds 
puffy5533: folds 
BlOnDhOlIc: folds 
Uncalled bet ($0.15) returned to PetitAlejo
PetitAlejo collected $0.20 from pot
PetitAlejo: doesn't show hand 
*** SUMMARY ***
Total pot $0.20 | Rake $0 
Seat 1: puffy5533 (button) folded before Flop (didn't bet)
Seat 2: BlOnDhOlIc (small blind) folded before Flop
Seat 3: PetitAlejo (big blind) collected ($0.20)
Seat 4: Loholov folded before Flop (didn't bet)
Seat 5: 2997qwer folded before Flop (didn't bet)
Seat 6: chiyuki folded before Flop (didn't bet)
Seat 7: masterkoolb folded before Flop (didn't bet)
Seat 8: a_tasmanian folded before Flop (didn't bet)
Seat 9: jtedecaliss folded before Flop (didn't bet)



PokerStars Zoom Hand #84298374795:  Hold'em No Limit ($0.10/$0.25) - 2012/08/05 13:10:25 JST [2012/08/05 0:10:25 ET]
Table 'Whirlpool' 9-max Seat #1 is the button
Seat 1: a_tasmanian ($55.42 in chips) 
Seat 2: deadmoneykid ($21.20 in chips) 
Seat 3: Alvinpe85 ($25.25 in chips) 
Seat 4: KeLevro0 ($10.60 in chips) 
Seat 5: THE_BIG_BOTT ($14.19 in chips) 
Seat 6: NastyMcNast ($54.27 in chips) 
Seat 7: silvno31 ($41.81 in chips) 
Seat 8: chiyuki ($41.68 in chips) 
Seat 9: ShevchukAI ($19.91 in chips) 
deadmoneykid: posts small blind $0.10
Alvinpe85: posts big blind $0.25
*** HOLE CARDS ***
Dealt to chiyuki [7c 4h]
KeLevro0: folds 
THE_BIG_BOTT: raises $0.75 to $1
NastyMcNast: folds 
silvno31: folds 
chiyuki: folds 
ShevchukAI: folds 
a_tasmanian: folds 
deadmoneykid: folds 
Alvinpe85: calls $0.75
*** FLOP *** [Kd Qc 4s]
Alvinpe85: checks 
THE_BIG_BOTT: bets $1
Alvinpe85: calls $1
*** TURN *** [Kd Qc 4s] [3d]
Alvinpe85: checks 
THE_BIG_BOTT: bets $1.50
Alvinpe85: folds 
Uncalled bet ($1.50) returned to THE_BIG_BOTT
THE_BIG_BOTT collected $3.92 from pot
THE_BIG_BOTT: doesn't show hand 
*** SUMMARY ***
Total pot $4.10 | Rake $0.18 
Board [Kd Qc 4s 3d]
Seat 1: a_tasmanian (button) folded before Flop (didn't bet)
Seat 2: deadmoneykid (small blind) folded before Flop
Seat 3: Alvinpe85 (big blind) folded on the Turn
Seat 4: KeLevro0 folded before Flop (didn't bet)
Seat 5: THE_BIG_BOTT collected ($3.92)
Seat 6: NastyMcNast folded before Flop (didn't bet)
Seat 7: silvno31 folded before Flop (didn't bet)
Seat 8: chiyuki folded before Flop (didn't bet)
Seat 9: ShevchukAI folded before Flop (didn't bet)



PokerStars Zoom Hand #84298376267:  Hold'em No Limit ($0.10/$0.25) - 2012/08/05 13:10:30 JST [2012/08/05 0:10:30 ET]
Table 'Whirlpool' 9-max Seat #1 is the button
Seat 1: DooMSDaY1337 ($27.07 in chips) 
Seat 2: RomarioJa ($12.49 in chips) 
Seat 3: TErr18 ($21.55 in chips) 
Seat 4: Roglus ($22.29 in chips) 
Seat 5: silvno31 ($41.81 in chips) 
Seat 6: cR!Ma*aRm ($18.13 in chips) 
Seat 7: chiyuki ($41.68 in chips) 
Seat 8: KeLevro0 ($10.60 in chips) 
Seat 9: nice.franki ($13.30 in chips) 
RomarioJa: posts small blind $0.10
TErr18: posts big blind $0.25
*** HOLE CARDS ***
Dealt to chiyuki [7h As]
Roglus: folds 
silvno31: raises $0.75 to $1
cR!Ma*aRm: folds 
chiyuki: folds 
KeLevro0: folds 
nice.franki: folds 
DooMSDaY1337: calls $1
RomarioJa: folds 
TErr18: folds 
*** FLOP *** [5c Qc 4s]
silvno31: bets $2.75
DooMSDaY1337: calls $2.75
*** TURN *** [5c Qc 4s] [8c]
silvno31: bets $38.06 and is all-in
DooMSDaY1337: calls $23.32 and is all-in
Uncalled bet ($14.74) returned to silvno31
*** RIVER *** [5c Qc 4s 8c] [Ks]
*** SHOW DOWN ***
silvno31: shows [Qh Ah] (a pair of Queens)
DooMSDaY1337: shows [4d 4h] (three of a kind, Fours)
DooMSDaY1337 collected $52.49 from pot
*** SUMMARY ***
Total pot $54.49 | Rake $2 
Board [5c Qc 4s 8c Ks]
Seat 1: DooMSDaY1337 (button) showed [4d 4h] and won ($52.49) with three of a kind, Fours
Seat 2: RomarioJa (small blind) folded before Flop
Seat 3: TErr18 (big blind) folded before Flop
Seat 4: Roglus folded before Flop (didn't bet)
Seat 5: silvno31 showed [Qh Ah] and lost with a pair of Queens
Seat 6: cR!Ma*aRm folded before Flop (didn't bet)
Seat 7: chiyuki folded before Flop (didn't bet)
Seat 8: KeLevro0 folded before Flop (didn't bet)
Seat 9: nice.franki folded before Flop (didn't bet)



PokerStars Zoom Hand #84298371549:  Hold'em No Limit ($0.10/$0.25) - 2012/08/05 13:10:14 JST [2012/08/05 0:10:14 ET]
Table 'Whirlpool' 9-max Seat #1 is the button
Seat 1: Medic8681 ($12.50 in chips) 
Seat 2: MibNe ($29.14 in chips) 
Seat 3: Rodina-Kr ($25 in chips) 
Seat 4: Loholov ($15 in chips) 
Seat 5: bigrasbig ($20.62 in chips) 
Seat 6: PetitAlejo ($25.70 in chips) 
Seat 7: mikifeio ($30.95 in chips) 
Seat 8: wtu1986 ($25 in chips) 
Seat 9: chiyuki ($41.68 in chips) 
MibNe: posts small blind $0.10
Rodina-Kr: posts big blind $0.25
*** HOLE CARDS ***
Dealt to chiyuki [7d 2c]
Loholov: folds 
bigrasbig: folds 
PetitAlejo: folds 
mikifeio: folds 
wtu1986: folds 
chiyuki: folds 
Medic8681: raises $0.50 to $0.75
MibNe: raises $1 to $1.75
Rodina-Kr: folds 
Medic8681: calls $1
*** FLOP *** [Qc 5d 6s]
MibNe: checks 
Medic8681: checks 
*** TURN *** [Qc 5d 6s] [Jh]
MibNe: bets $2.68
Medic8681: folds 
Uncalled bet ($2.68) returned to MibNe
MibNe collected $3.58 from pot
MibNe: doesn't show hand 
*** SUMMARY ***
Total pot $3.75 | Rake $0.17 
Board [Qc 5d 6s Jh]
Seat 1: Medic8681 (button) folded on the Turn
Seat 2: MibNe (small blind) collected ($3.58)
Seat 3: Rodina-Kr (big blind) folded before Flop
Seat 4: Loholov folded before Flop (didn't bet)
Seat 5: bigrasbig folded before Flop (didn't bet)
Seat 6: PetitAlejo folded before Flop (didn't bet)
Seat 7: mikifeio folded before Flop (didn't bet)
Seat 8: wtu1986 folded before Flop (didn't bet)
Seat 9: chiyuki folded before Flop (didn't bet)



PokerStars Zoom Hand #84298381222:  Hold'em No Limit ($0.10/$0.25) - 2012/08/05 13:10:47 JST [2012/08/05 0:10:47 ET]
Table 'Whirlpool' 9-max Seat #1 is the button
Seat 1: fwani ($31.83 in chips) 
Seat 2: masterkoolb ($12.50 in chips) 
Seat 3: Loholov ($15.85 in chips) 
Seat 4: chiyuki ($41.68 in chips) 
Seat 5: TErr18 ($21.30 in chips) 
Seat 6: Alvinpe85 ($25.50 in chips) 
Seat 7: RomarioJa ($7.58 in chips) 
Seat 8: eagie20 ($140.18 in chips) 
Seat 9: KrystalAA ($18.34 in chips) 
masterkoolb: posts small blind $0.10
Loholov: posts big blind $0.25
*** HOLE CARDS ***
Dealt to chiyuki [Kd Ad]
chiyuki: raises $0.50 to $0.75
TErr18: folds 
Alvinpe85: folds 
RomarioJa: folds 
eagie20: folds 
KrystalAA: folds 
fwani: folds 
masterkoolb: folds 
Loholov: folds 
Uncalled bet ($0.50) returned to chiyuki
chiyuki collected $0.60 from pot
chiyuki: doesn't show hand 
*** SUMMARY ***
Total pot $0.60 | Rake $0 
Seat 1: fwani (button) folded before Flop (didn't bet)
Seat 2: masterkoolb (small blind) folded before Flop
Seat 3: Loholov (big blind) folded before Flop
Seat 4: chiyuki collected ($0.60)
Seat 5: TErr18 folded before Flop (didn't bet)
Seat 6: Alvinpe85 folded before Flop (didn't bet)
Seat 7: RomarioJa folded before Flop (didn't bet)
Seat 8: eagie20 folded before Flop (didn't bet)
Seat 9: KrystalAA folded before Flop (didn't bet)



PokerStars Zoom Hand #84298379203:  Hold'em No Limit ($0.10/$0.25) - 2012/08/05 13:10:40 JST [2012/08/05 0:10:40 ET]
Table 'Whirlpool' 9-max Seat #1 is the button
Seat 1: Zugrug ($26.26 in chips) 
Seat 2: nice.franki ($7.47 in chips) 
Seat 3: masterkoolb ($12.50 in chips) 
Seat 4: cR!Ma*aRm ($18.13 in chips) 
Seat 5: Rodina-Kr ($25 in chips) 
Seat 6: NastyMcNast ($54.27 in chips) 
Seat 7: seula i ($26.28 in chips) 
Seat 8: KeLevro0 ($10.22 in chips) 
Seat 9: chiyuki ($41.68 in chips) 
nice.franki: posts small blind $0.10
masterkoolb: posts big blind $0.25
*** HOLE CARDS ***
Dealt to chiyuki [9c Qd]
cR!Ma*aRm: raises $0.25 to $0.50
Rodina-Kr: folds 
NastyMcNast: folds 
seula i: folds 
KeLevro0: calls $0.50
chiyuki: folds 
Zugrug: folds 
nice.franki: folds 
masterkoolb: folds 
*** FLOP *** [3h As Jd]
cR!Ma*aRm: bets $0.25
KeLevro0: calls $0.25
*** TURN *** [3h As Jd] [3d]
cR!Ma*aRm: bets $0.50
KeLevro0: folds 
Uncalled bet ($0.50) returned to cR!Ma*aRm
cR!Ma*aRm collected $1.77 from pot
cR!Ma*aRm: doesn't show hand 
*** SUMMARY ***
Total pot $1.85 | Rake $0.08 
Board [3h As Jd 3d]
Seat 1: Zugrug (button) folded before Flop (didn't bet)
Seat 2: nice.franki (small blind) folded before Flop
Seat 3: masterkoolb (big blind) folded before Flop
Seat 4: cR!Ma*aRm collected ($1.77)
Seat 5: Rodina-Kr folded before Flop (didn't bet)
Seat 6: NastyMcNast folded before Flop (didn't bet)
Seat 7: seula i folded before Flop (didn't bet)
Seat 8: KeLevro0 folded on the Turn
Seat 9: chiyuki folded before Flop (didn't bet)



PokerStars Zoom Hand #84298389395:  Hold'em No Limit ($0.10/$0.25) - 2012/08/05 13:11:16 JST [2012/08/05 0:11:16 ET]
Table 'Whirlpool' 9-max Seat #1 is the button
Seat 1: fwani ($45.29 in chips) 
Seat 2: chiyuki ($42.03 in chips) 
Seat 3: puffy5533 ($19.93 in chips) 
Seat 4: TraderYao ($24.90 in chips) 
Seat 5: a_tasmanian ($54.82 in chips) 
Seat 6: Zugrug ($26.49 in chips) 
Seat 7: TankAbbott1 ($26.37 in chips) 
Seat 8: petersmiths ($33.71 in chips) 
Seat 9: RomarioJa ($10.32 in chips) 
chiyuki: posts small blind $0.10
puffy5533: posts big blind $0.25
*** HOLE CARDS ***
Dealt to chiyuki [Jc 7s]
TraderYao: folds 
a_tasmanian: folds 
Zugrug: folds 
TankAbbott1: folds 
petersmiths: raises $0.25 to $0.50
RomarioJa: folds 
fwani: folds 
chiyuki: folds 
puffy5533: folds 
Uncalled bet ($0.25) returned to petersmiths
petersmiths collected $0.60 from pot
petersmiths: doesn't show hand 
*** SUMMARY ***
Total pot $0.60 | Rake $0 
Seat 1: fwani (button) folded before Flop (didn't bet)
Seat 2: chiyuki (small blind) folded before Flop
Seat 3: puffy5533 (big blind) folded before Flop
Seat 4: TraderYao folded before Flop (didn't bet)
Seat 5: a_tasmanian folded before Flop (didn't bet)
Seat 6: Zugrug folded before Flop (didn't bet)
Seat 7: TankAbbott1 folded before Flop (didn't bet)
Seat 8: petersmiths collected ($0.60)
Seat 9: RomarioJa folded before Flop (didn't bet)



PokerStars Zoom Hand #84298373285:  Hold'em No Limit ($0.10/$0.25) - 2012/08/05 13:10:20 JST [2012/08/05 0:10:20 ET]
Table 'Whirlpool' 9-max Seat #1 is the button
Seat 1: chiyuki ($41.68 in chips) 
Seat 2: Rsonal ($66.70 in chips) 
Seat 3: Zugrug ($25.35 in chips) 
Seat 4: Lab50att ($16.57 in chips) 
Seat 5: deadmoneykid ($21.20 in chips) 
Seat 6: TraderYao ($25 in chips) 
Seat 7: lixilox ($24.25 in chips) 
Seat 8: silvno31 ($41.81 in chips) 
Seat 9: KINGKILERACE ($44.43 in chips) 
Rsonal: posts small blind $0.10
Zugrug: posts big blind $0.25
*** HOLE CARDS ***
Dealt to chiyuki [4d 9s]
Lab50att: calls $0.25
deadmoneykid: folds 
TraderYao: calls $0.25
lixilox: raises $0.75 to $1
silvno31: folds 
KINGKILERACE: folds 
chiyuki: folds 
Rsonal: calls $0.90
Zugrug: folds 
Lab50att: calls $0.75
TraderYao: calls $0.75
*** FLOP *** [4s 9d Jc]
Rsonal: bets $1.25
Lab50att: calls $1.25
TraderYao: calls $1.25
lixilox: calls $1.25
*** TURN *** [4s 9d Jc] [6d]
Rsonal: checks 
Lab50att: checks 
TraderYao: checks 
lixilox: checks 
*** RIVER *** [4s 9d Jc 6d] [7s]
Rsonal: bets $3.75
Lab50att: folds 
TraderYao: calls $3.75
lixilox: folds 
*** SHOW DOWN ***
Rsonal: shows [Ac 9c] (a pair of Nines)
TraderYao: shows [Jd Td] (a pair of Jacks)
TraderYao collected $16 from pot
*** SUMMARY ***
Total pot $16.75 | Rake $0.75 
Board [4s 9d Jc 6d 7s]
Seat 1: chiyuki (button) folded before Flop (didn't bet)
Seat 2: Rsonal (small blind) showed [Ac 9c] and lost with a pair of Nines
Seat 3: Zugrug (big blind) folded before Flop
Seat 4: Lab50att folded on the River
Seat 5: deadmoneykid folded before Flop (didn't bet)
Seat 6: TraderYao showed [Jd Td] and won ($16) with a pair of Jacks
Seat 7: lixilox folded on the River
Seat 8: silvno31 folded before Flop (didn't bet)
Seat 9: KINGKILERACE folded before Flop (didn't bet)



PokerStars Zoom Hand #84298391127:  Hold'em No Limit ($0.10/$0.25) - 2012/08/05 13:11:22 JST [2012/08/05 0:11:22 ET]
Table 'Whirlpool' 9-max Seat #1 is the button
Seat 1: PetitAlejo ($25.35 in chips) 
Seat 2: nice.franki ($13.47 in chips) 
Seat 3: Zugrug ($25 in chips) 
Seat 4: Alvinpe85 ($25.40 in chips) 
Seat 5: Loholov ($15 in chips) 
Seat 6: chiyuki ($41.93 in chips) 
Seat 7: masterkoolb ($12.50 in chips) 
Seat 8: deadmoneykid ($21.10 in chips) 
Seat 9: a_tasmanian ($54.82 in chips) 
nice.franki: posts small blind $0.10
Zugrug: posts big blind $0.25
*** HOLE CARDS ***
Dealt to chiyuki [3d Ts]
Alvinpe85: folds 
Loholov: folds 
chiyuki: folds 
masterkoolb: folds 
deadmoneykid: folds 
a_tasmanian: folds 
PetitAlejo: raises $0.50 to $0.75
nice.franki: raises $1.50 to $2.25
Zugrug: folds 
PetitAlejo: folds 
Uncalled bet ($1.50) returned to nice.franki
nice.franki collected $1.75 from pot
nice.franki: doesn't show hand 
*** SUMMARY ***
Total pot $1.75 | Rake $0 
Seat 1: PetitAlejo (button) folded before Flop
Seat 2: nice.franki (small blind) collected ($1.75)
Seat 3: Zugrug (big blind) folded before Flop
Seat 4: Alvinpe85 folded before Flop (didn't bet)
Seat 5: Loholov folded before Flop (didn't bet)
Seat 6: chiyuki folded before Flop (didn't bet)
Seat 7: masterkoolb folded before Flop (didn't bet)
Seat 8: deadmoneykid folded before Flop (didn't bet)
Seat 9: a_tasmanian folded before Flop (didn't bet)



PokerStars Zoom Hand #84298401289:  Hold'em No Limit ($0.10/$0.25) - 2012/08/05 13:11:57 JST [2012/08/05 0:11:57 ET]
Table 'Whirlpool' 9-max Seat #1 is the button
Seat 1: chiyuki ($41.68 in chips) 
Seat 2: puffy5533 ($19.68 in chips) 
Seat 3: deadmoneykid ($21 in chips) 
Seat 4: TErr18 ($20.30 in chips) 
Seat 5: leo2095 ($18.65 in chips) 
Seat 6: KINGKILERACE ($42.58 in chips) 
Seat 7: Medic8681 ($12.50 in chips) 
Seat 8: RomarioJa ($9.97 in chips) 
Seat 9: PetitAlejo ($25 in chips) 
puffy5533: posts small blind $0.10
deadmoneykid: posts big blind $0.25
*** HOLE CARDS ***
Dealt to chiyuki [4c 2d]
TErr18: folds 
leo2095: folds 
KINGKILERACE: folds 
Medic8681: folds 
RomarioJa: folds 
PetitAlejo: raises $0.50 to $0.75
chiyuki: folds 
puffy5533: folds 
deadmoneykid: folds 
Uncalled bet ($0.50) returned to PetitAlejo
PetitAlejo collected $0.60 from pot
PetitAlejo: doesn't show hand 
*** SUMMARY ***
Total pot $0.60 | Rake $0 
Seat 1: chiyuki (button) folded before Flop (didn't bet)
Seat 2: puffy5533 (small blind) folded before Flop
Seat 3: deadmoneykid (big blind) folded before Flop
Seat 4: TErr18 folded before Flop (didn't bet)
Seat 5: leo2095 folded before Flop (didn't bet)
Seat 6: KINGKILERACE folded before Flop (didn't bet)
Seat 7: Medic8681 folded before Flop (didn't bet)
Seat 8: RomarioJa folded before Flop (didn't bet)
Seat 9: PetitAlejo collected ($0.60)



PokerStars Zoom Hand #84298402113:  Hold'em No Limit ($0.10/$0.25) - 2012/08/05 13:12:00 JST [2012/08/05 0:12:00 ET]
Table 'Whirlpool' 9-max Seat #1 is the button
Seat 1: DooMSDaY1337 ($66.65 in chips) 
Seat 2: BlOnDhOlIc ($25 in chips) 
Seat 3: Loholov ($15.78 in chips) 
Seat 4: 2997qwer ($8.97 in chips) 
Seat 5: fwani ($25 in chips) 
Seat 6: softdesign ($51.46 in chips) 
Seat 7: MibNe ($30.45 in chips) 
Seat 8: envious_0007 ($10.05 in chips) 
Seat 9: chiyuki ($41.68 in chips) 
BlOnDhOlIc: posts small blind $0.10
Loholov: posts big blind $0.25
*** HOLE CARDS ***
Dealt to chiyuki [9s As]
2997qwer: folds 
fwani: folds 
softdesign: calls $0.25
MibNe: folds 
envious_0007: folds 
chiyuki: folds 
DooMSDaY1337: folds 
BlOnDhOlIc: folds 
Loholov: checks 
*** FLOP *** [6h 5h 7d]
Loholov: checks 
softdesign: bets $0.75
Loholov: folds 
Uncalled bet ($0.75) returned to softdesign
softdesign collected $0.57 from pot
softdesign: doesn't show hand 
*** SUMMARY ***
Total pot $0.60 | Rake $0.03 
Board [6h 5h 7d]
Seat 1: DooMSDaY1337 (button) folded before Flop (didn't bet)
Seat 2: BlOnDhOlIc (small blind) folded before Flop
Seat 3: Loholov (big blind) folded on the Flop
Seat 4: 2997qwer folded before Flop (didn't bet)
Seat 5: fwani folded before Flop (didn't bet)
Seat 6: softdesign collected ($0.57)
Seat 7: MibNe folded before Flop (didn't bet)
Seat 8: envious_0007 folded before Flop (didn't bet)
Seat 9: chiyuki folded before Flop (didn't bet)



PokerStars Zoom Hand #84298396853:  Hold'em No Limit ($0.10/$0.25) - 2012/08/05 13:11:42 JST [2012/08/05 0:11:42 ET]
Table 'Whirlpool' 9-max Seat #1 is the button
Seat 1: Alvinpe85 ($25 in chips) 
Seat 2: deadmoneykid ($21.10 in chips) 
Seat 3: chiyuki ($41.93 in chips) 
Seat 4: THE_BIG_BOTT ($15.76 in chips) 
Seat 5: a_tasmanian ($54.82 in chips) 
Seat 6: TErr18 ($15.54 in chips) 
Seat 7: Tasman007 ($21.86 in chips) 
Seat 8: Roglus ($22.29 in chips) 
Seat 9: KeLevro0 ($10.49 in chips) 
deadmoneykid: posts small blind $0.10
chiyuki: posts big blind $0.25
*** HOLE CARDS ***
Dealt to chiyuki [Qc 4s]
THE_BIG_BOTT: folds 
a_tasmanian: folds 
TErr18: folds 
Tasman007: raises $0.50 to $0.75
Roglus: raises $1.25 to $2
KeLevro0: folds 
Alvinpe85: folds 
deadmoneykid: folds 
chiyuki: folds 
Tasman007: calls $1.25
*** FLOP *** [5h 9d 6d]
Tasman007: checks 
Roglus: bets $2.75
Tasman007: calls $2.75
*** TURN *** [5h 9d 6d] [Jd]
Tasman007: checks 
Roglus: bets $3.29
Tasman007: calls $3.29
*** RIVER *** [5h 9d 6d Jd] [2s]
Tasman007: checks 
Roglus: bets $5.49
Tasman007: calls $5.49
*** SHOW DOWN ***
Roglus: shows [Qh Qs] (a pair of Queens)
Tasman007: mucks hand 
Roglus collected $26.18 from pot
*** SUMMARY ***
Total pot $27.41 | Rake $1.23 
Board [5h 9d 6d Jd 2s]
Seat 1: Alvinpe85 (button) folded before Flop (didn't bet)
Seat 2: deadmoneykid (small blind) folded before Flop
Seat 3: chiyuki (big blind) folded before Flop
Seat 4: THE_BIG_BOTT folded before Flop (didn't bet)
Seat 5: a_tasmanian folded before Flop (didn't bet)
Seat 6: TErr18 folded before Flop (didn't bet)
Seat 7: Tasman007 mucked [7c 7d]
Seat 8: Roglus showed [Qh Qs] and won ($26.18) with a pair of Queens
Seat 9: KeLevro0 folded before Flop (didn't bet)



PokerStars Zoom Hand #84298405293:  Hold'em No Limit ($0.10/$0.25) - 2012/08/05 13:12:12 JST [2012/08/05 0:12:12 ET]
Table 'Whirlpool' 9-max Seat #1 is the button
Seat 1: Lab50att ($13.70 in chips) 
Seat 2: gAm813r ($26.81 in chips) 
Seat 3: TErr18 ($15.44 in chips) 
Seat 4: Loholov ($15 in chips) 
Seat 5: deadmoneykid ($20.75 in chips) 
Seat 6: BlOnDhOlIc ($25 in chips) 
Seat 7: 2997qwer ($13.20 in chips) 
Seat 8: chiyuki ($41.68 in chips) 
Seat 9: Oswulf ($16.21 in chips) 
gAm813r: posts small blind $0.10
TErr18: posts big blind $0.25
*** HOLE CARDS ***
Dealt to chiyuki [5c Qh]
Loholov: folds 
deadmoneykid: folds 
BlOnDhOlIc: folds 
2997qwer: folds 
chiyuki: folds 
Oswulf: folds 
Lab50att: folds 
gAm813r: folds 
Uncalled bet ($0.15) returned to TErr18
TErr18 collected $0.20 from pot
TErr18: doesn't show hand 
*** SUMMARY ***
Total pot $0.20 | Rake $0 
Seat 1: Lab50att (button) folded before Flop (didn't bet)
Seat 2: gAm813r (small blind) folded before Flop
Seat 3: TErr18 (big blind) collected ($0.20)
Seat 4: Loholov folded before Flop (didn't bet)
Seat 5: deadmoneykid folded before Flop (didn't bet)
Seat 6: BlOnDhOlIc folded before Flop (didn't bet)
Seat 7: 2997qwer folded before Flop (didn't bet)
Seat 8: chiyuki folded before Flop (didn't bet)
Seat 9: Oswulf folded before Flop (didn't bet)



PokerStars Zoom Hand #84298407367:  Hold'em No Limit ($0.10/$0.25) - 2012/08/05 13:12:19 JST [2012/08/05 0:12:19 ET]
Table 'Whirlpool' 9-max Seat #1 is the button
Seat 1: s9999999 ($30.64 in chips) 
Seat 2: chiyuki ($41.68 in chips) 
Seat 3: Zugrug ($25.91 in chips) 
Seat 4: Oswulf ($16.21 in chips) 
Seat 5: BlOnDhOlIc ($25 in chips) 
Seat 6: deadmoneykid ($24.49 in chips) 
Seat 7: Alvinpe85 ($25 in chips) 
Seat 8: Th3Fog ($55.18 in chips) 
Seat 9: nice.franki ($14.47 in chips) 
chiyuki: posts small blind $0.10
Zugrug: posts big blind $0.25
*** HOLE CARDS ***
Dealt to chiyuki [7d 7h]
Oswulf: raises $0.37 to $0.62
BlOnDhOlIc: folds 
deadmoneykid: folds 
Alvinpe85: folds 
Th3Fog: folds 
nice.franki: folds 
s9999999: folds 
chiyuki: calls $0.52
Zugrug: folds 
*** FLOP *** [9s 3s Qs]
chiyuki: checks 
Oswulf: bets $1.06
chiyuki: folds 
Uncalled bet ($1.06) returned to Oswulf
Oswulf collected $1.42 from pot
Oswulf: doesn't show hand 
*** SUMMARY ***
Total pot $1.49 | Rake $0.07 
Board [9s 3s Qs]
Seat 1: s9999999 (button) folded before Flop (didn't bet)
Seat 2: chiyuki (small blind) folded on the Flop
Seat 3: Zugrug (big blind) folded before Flop
Seat 4: Oswulf collected ($1.42)
Seat 5: BlOnDhOlIc folded before Flop (didn't bet)
Seat 6: deadmoneykid folded before Flop (didn't bet)
Seat 7: Alvinpe85 folded before Flop (didn't bet)
Seat 8: Th3Fog folded before Flop (didn't bet)
Seat 9: nice.franki folded before Flop (didn't bet)



PokerStars Zoom Hand #84298394567:  Hold'em No Limit ($0.10/$0.25) - 2012/08/05 13:11:34 JST [2012/08/05 0:11:34 ET]
Table 'Whirlpool' 9-max Seat #1 is the button
Seat 1: masterkoolb ($12.50 in chips) 
Seat 2: wtu1986 ($26.80 in chips) 
Seat 3: Zugrug ($26.49 in chips) 
Seat 4: PetitAlejo ($25.70 in chips) 
Seat 5: chiyuki ($41.93 in chips) 
Seat 6: jtedecaliss ($181.03 in chips) 
Seat 7: DooMSDaY1337 ($37.22 in chips) 
Seat 8: nice.franki ($7.47 in chips) 
Seat 9: THE_BIG_BOTT ($15.76 in chips) 
wtu1986: posts small blind $0.10
Zugrug: posts big blind $0.25
*** HOLE CARDS ***
Dealt to chiyuki [Th 3s]
PetitAlejo: folds 
chiyuki: folds 
jtedecaliss: raises $0.50 to $0.75
DooMSDaY1337: folds 
nice.franki: folds 
THE_BIG_BOTT: folds 
masterkoolb: calls $0.75
wtu1986: raises $2.25 to $3
Zugrug: folds 
jtedecaliss: calls $2.25
masterkoolb: folds 
*** FLOP *** [Qh 6c Kd]
wtu1986: bets $3.20
jtedecaliss: raises $6.30 to $9.50
wtu1986: folds 
Uncalled bet ($6.30) returned to jtedecaliss
jtedecaliss collected $12.80 from pot
jtedecaliss: doesn't show hand 
*** SUMMARY ***
Total pot $13.40 | Rake $0.60 
Board [Qh 6c Kd]
Seat 1: masterkoolb (button) folded before Flop
Seat 2: wtu1986 (small blind) folded on the Flop
Seat 3: Zugrug (big blind) folded before Flop
Seat 4: PetitAlejo folded before Flop (didn't bet)
Seat 5: chiyuki folded before Flop (didn't bet)
Seat 6: jtedecaliss collected ($12.80)
Seat 7: DooMSDaY1337 folded before Flop (didn't bet)
Seat 8: nice.franki folded before Flop (didn't bet)
Seat 9: THE_BIG_BOTT folded before Flop (didn't bet)



PokerStars Zoom Hand #84298406524:  Hold'em No Limit ($0.10/$0.25) - 2012/08/05 13:12:16 JST [2012/08/05 0:12:16 ET]
Table 'Whirlpool' 9-max Seat #1 is the button
Seat 1: PetitAlejo ($25.35 in chips) 
Seat 2: RomarioJa ($13.27 in chips) 
Seat 3: Loholov ($15 in chips) 
Seat 4: Oswulf ($16.21 in chips) 
Seat 5: fwani ($25 in chips) 
Seat 6: Lab50att ($13.70 in chips) 
Seat 7: chiyuki ($41.68 in chips) 
Seat 8: nice.franki ($14.47 in chips) 
Seat 9: Rodina-Kr ($25 in chips) 
RomarioJa: posts small blind $0.10
Loholov: posts big blind $0.25
*** HOLE CARDS ***
Dealt to chiyuki [8s 9s]
Oswulf: folds 
fwani: folds 
Lab50att: folds 
chiyuki: folds 
nice.franki: folds 
Rodina-Kr: folds 
PetitAlejo: raises $0.50 to $0.75
RomarioJa: raises $1.35 to $2.10
Loholov: folds 
PetitAlejo: raises $23.25 to $25.35 and is all-in
RomarioJa: folds 
Uncalled bet ($23.25) returned to PetitAlejo
PetitAlejo collected $4.45 from pot
PetitAlejo: doesn't show hand 
*** SUMMARY ***
Total pot $4.45 | Rake $0 
Seat 1: PetitAlejo (button) collected ($4.45)
Seat 2: RomarioJa (small blind) folded before Flop
Seat 3: Loholov (big blind) folded before Flop
Seat 4: Oswulf folded before Flop (didn't bet)
Seat 5: fwani folded before Flop (didn't bet)
Seat 6: Lab50att folded before Flop (didn't bet)
Seat 7: chiyuki folded before Flop (didn't bet)
Seat 8: nice.franki folded before Flop (didn't bet)
Seat 9: Rodina-Kr folded before Flop (didn't bet)



PokerStars Zoom Hand #84298414541:  Hold'em No Limit ($0.10/$0.25) - 2012/08/05 13:12:44 JST [2012/08/05 0:12:44 ET]
Table 'Whirlpool' 9-max Seat #1 is the button
Seat 1: Th3Fog ($22.75 in chips) 
Seat 2: taksist889 ($34.50 in chips) 
Seat 3: RomarioJa ($10.44 in chips) 
Seat 4: petersmiths ($33.66 in chips) 
Seat 5: eagie20 ($144.60 in chips) 
Seat 6: chiyuki ($41.06 in chips) 
Seat 7: Zugrug ($25.25 in chips) 
Seat 8: bigrasbig ($37.28 in chips) 
Seat 9: cR!Ma*aRm ($18.05 in chips) 
taksist889: posts small blind $0.10
RomarioJa: posts big blind $0.25
*** HOLE CARDS ***
Dealt to chiyuki [5d Kd]
petersmiths: folds 
eagie20: raises $0.50 to $0.75
chiyuki: folds 
Zugrug: folds 
bigrasbig: folds 
cR!Ma*aRm: folds 
Th3Fog: folds 
taksist889: folds 
RomarioJa: folds 
Uncalled bet ($0.50) returned to eagie20
eagie20 collected $0.60 from pot
eagie20: doesn't show hand 
*** SUMMARY ***
Total pot $0.60 | Rake $0 
Seat 1: Th3Fog (button) folded before Flop (didn't bet)
Seat 2: taksist889 (small blind) folded before Flop
Seat 3: RomarioJa (big blind) folded before Flop
Seat 4: petersmiths folded before Flop (didn't bet)
Seat 5: eagie20 collected ($0.60)
Seat 6: chiyuki folded before Flop (didn't bet)
Seat 7: Zugrug folded before Flop (didn't bet)
Seat 8: bigrasbig folded before Flop (didn't bet)
Seat 9: cR!Ma*aRm folded before Flop (didn't bet)



PokerStars Zoom Hand #84298423948:  Hold'em No Limit ($0.10/$0.25) - 2012/08/05 13:13:18 JST [2012/08/05 0:13:18 ET]
Table 'Whirlpool' 9-max Seat #1 is the button
Seat 1: TErr18 ($19.45 in chips) 
Seat 2: deadmoneykid ($20.75 in chips) 
Seat 3: chiyuki ($41.06 in chips) 
Seat 4: BlOnDhOlIc ($39.71 in chips) 
Seat 5: KINGKILERACE ($31.33 in chips) 
Seat 6: Loholov ($18.87 in chips) 
Seat 7: DooMSDaY1337 ($52.63 in chips) 
Seat 8: PetitAlejo ($27.70 in chips) 
Seat 9: masterkoolb ($12.50 in chips) 
deadmoneykid: posts small blind $0.10
chiyuki: posts big blind $0.25
*** HOLE CARDS ***
Dealt to chiyuki [3s Qs]
BlOnDhOlIc: folds 
KINGKILERACE: folds 
Loholov: folds 
DooMSDaY1337: folds 
PetitAlejo: folds 
masterkoolb: folds 
TErr18: folds 
deadmoneykid: folds 
Uncalled bet ($0.15) returned to chiyuki
chiyuki collected $0.20 from pot
chiyuki: doesn't show hand 
*** SUMMARY ***
Total pot $0.20 | Rake $0 
Seat 1: TErr18 (button) folded before Flop (didn't bet)
Seat 2: deadmoneykid (small blind) folded before Flop
Seat 3: chiyuki (big blind) collected ($0.20)
Seat 4: BlOnDhOlIc folded before Flop (didn't bet)
Seat 5: KINGKILERACE folded before Flop (didn't bet)
Seat 6: Loholov folded before Flop (didn't bet)
Seat 7: DooMSDaY1337 folded before Flop (didn't bet)
Seat 8: PetitAlejo folded before Flop (didn't bet)
Seat 9: masterkoolb folded before Flop (didn't bet)



PokerStars Zoom Hand #84298416233:  Hold'em No Limit ($0.10/$0.25) - 2012/08/05 13:12:50 JST [2012/08/05 0:12:50 ET]
Table 'Whirlpool' 9-max Seat #1 is the button
Seat 1: Paranoix1990 ($25.10 in chips) 
Seat 2: Medic8681 ($12.50 in chips) 
Seat 3: SlimeyGash ($23.48 in chips) 
Seat 4: taksist889 ($34.40 in chips) 
Seat 5: chiyuki ($41.06 in chips) 
Seat 6: slapshot2011 ($34.19 in chips) 
Seat 7: PetitAlejo ($40.62 in chips) 
Seat 8: seula i ($53.05 in chips) 
Seat 9: TraderYao ($25 in chips) 
Medic8681: posts small blind $0.10
SlimeyGash: posts big blind $0.25
*** HOLE CARDS ***
Dealt to chiyuki [Ad 3h]
taksist889: folds 
chiyuki: folds 
slapshot2011: folds 
PetitAlejo: folds 
seula i: folds 
TraderYao: folds 
Paranoix1990: calls $0.25
Medic8681: raises $0.75 to $1
SlimeyGash: folds 
Paranoix1990: calls $0.75
*** FLOP *** [4c Ac 9c]
Medic8681: checks 
Paranoix1990: checks 
*** TURN *** [4c Ac 9c] [2h]
Medic8681: bets $1.25
Paranoix1990: calls $1.25
*** RIVER *** [4c Ac 9c 2h] [6c]
Medic8681: checks 
Paranoix1990: checks 
*** SHOW DOWN ***
Medic8681: shows [Js Jd] (a pair of Jacks)
Paranoix1990: mucks hand 
Medic8681 collected $4.54 from pot
*** SUMMARY ***
Total pot $4.75 | Rake $0.21 
Board [4c Ac 9c 2h 6c]
Seat 1: Paranoix1990 (button) mucked [4h 7h]
Seat 2: Medic8681 (small blind) showed [Js Jd] and won ($4.54) with a pair of Jacks
Seat 3: SlimeyGash (big blind) folded before Flop
Seat 4: taksist889 folded before Flop (didn't bet)
Seat 5: chiyuki folded before Flop (didn't bet)
Seat 6: slapshot2011 folded before Flop (didn't bet)
Seat 7: PetitAlejo folded before Flop (didn't bet)
Seat 8: seula i folded before Flop (didn't bet)
Seat 9: TraderYao folded before Flop (didn't bet)



PokerStars Zoom Hand #84298419137:  Hold'em No Limit ($0.10/$0.25) - 2012/08/05 13:13:00 JST [2012/08/05 0:13:00 ET]
Table 'Whirlpool' 9-max Seat #1 is the button
Seat 1: KeLevro0 ($13.29 in chips) 
Seat 2: wtu1986 ($25.10 in chips) 
Seat 3: 2997qwer ($13.10 in chips) 
Seat 4: PetitAlejo ($25.35 in chips) 
Seat 5: Zugrug ($40.58 in chips) 
Seat 6: D@vidMed ($28.12 in chips) 
Seat 7: chiyuki ($41.06 in chips) 
Seat 8: Tasman007 ($8.43 in chips) 
Seat 9: ShevchukAI ($12.15 in chips) 
wtu1986: posts small blind $0.10
2997qwer: posts big blind $0.25
*** HOLE CARDS ***
Dealt to chiyuki [5s 9h]
PetitAlejo: folds 
Zugrug: folds 
D@vidMed: raises $0.57 to $0.82
chiyuki: folds 
Tasman007: folds 
ShevchukAI has timed out while being disconnected
ShevchukAI: folds 
KeLevro0: folds 
wtu1986: folds 
2997qwer: folds 
Uncalled bet ($0.57) returned to D@vidMed
D@vidMed collected $0.60 from pot
D@vidMed: doesn't show hand 
*** SUMMARY ***
Total pot $0.60 | Rake $0 
Seat 1: KeLevro0 (button) folded before Flop (didn't bet)
Seat 2: wtu1986 (small blind) folded before Flop
Seat 3: 2997qwer (big blind) folded before Flop
Seat 4: PetitAlejo folded before Flop (didn't bet)
Seat 5: Zugrug folded before Flop (didn't bet)
Seat 6: D@vidMed collected ($0.60)
Seat 7: chiyuki folded before Flop (didn't bet)
Seat 8: Tasman007 folded before Flop (didn't bet)
Seat 9: ShevchukAI folded before Flop (didn't bet)



PokerStars Zoom Hand #84298430003:  Hold'em No Limit ($0.10/$0.25) - 2012/08/05 13:13:39 JST [2012/08/05 0:13:39 ET]
Table 'Whirlpool' 9-max Seat #1 is the button
Seat 1: petersmiths ($32.66 in chips) 
Seat 2: seula i ($53.05 in chips) 
Seat 3: BlOnDhOlIc ($44.50 in chips) 
Seat 4: luyifei ($22.58 in chips) 
Seat 5: pyty_82 ($57.90 in chips) 
Seat 6: KeLevro0 ($12.62 in chips) 
Seat 7: slapshot2011 ($33.84 in chips) 
Seat 8: chiyuki ($41.16 in chips) 
Seat 9: Roglus ($34.94 in chips) 
seula i: posts small blind $0.10
BlOnDhOlIc: posts big blind $0.25
*** HOLE CARDS ***
Dealt to chiyuki [3s Td]
luyifei: folds 
pyty_82: folds 
KeLevro0: folds 
slapshot2011: folds 
chiyuki: folds 
Roglus: folds 
petersmiths: folds 
seula i: folds 
Uncalled bet ($0.15) returned to BlOnDhOlIc
BlOnDhOlIc collected $0.20 from pot
BlOnDhOlIc: doesn't show hand 
*** SUMMARY ***
Total pot $0.20 | Rake $0 
Seat 1: petersmiths (button) folded before Flop (didn't bet)
Seat 2: seula i (small blind) folded before Flop
Seat 3: BlOnDhOlIc (big blind) collected ($0.20)
Seat 4: luyifei folded before Flop (didn't bet)
Seat 5: pyty_82 folded before Flop (didn't bet)
Seat 6: KeLevro0 folded before Flop (didn't bet)
Seat 7: slapshot2011 folded before Flop (didn't bet)
Seat 8: chiyuki folded before Flop (didn't bet)
Seat 9: Roglus folded before Flop (didn't bet)



PokerStars Zoom Hand #84298422842:  Hold'em No Limit ($0.10/$0.25) - 2012/08/05 13:13:13 JST [2012/08/05 0:13:13 ET]
Table 'Whirlpool' 9-max Seat #1 is the button
Seat 1: wtu1986 ($25.04 in chips) 
Seat 2: Tasman007 ($8.43 in chips) 
Seat 3: MATT361 ($15.51 in chips) 
Seat 4: chiyuki ($41.06 in chips) 
Seat 5: TraderYao ($25 in chips) 
Seat 6: Zugrug ($40.58 in chips) 
Seat 7: nice.franki ($12.23 in chips) 
Seat 8: DooMSDaY1337 ($52.63 in chips) 
Seat 9: SlimeyGash ($23.23 in chips) 
Tasman007: posts small blind $0.10
MATT361: posts big blind $0.25
*** HOLE CARDS ***
Dealt to chiyuki [Qh 6h]
chiyuki: folds 
TraderYao: folds 
Zugrug: folds 
nice.franki: raises $0.50 to $0.75
DooMSDaY1337: folds 
SlimeyGash: calls $0.75
wtu1986: folds 
Tasman007: folds 
MATT361: folds 
*** FLOP *** [8h 7s Jh]
nice.franki: checks 
SlimeyGash: checks 
*** TURN *** [8h 7s Jh] [4s]
nice.franki: checks 
SlimeyGash: checks 
*** RIVER *** [8h 7s Jh 4s] [3h]
nice.franki: checks 
SlimeyGash: checks 
*** SHOW DOWN ***
nice.franki: shows [Qc Ah] (high card Ace)
SlimeyGash: shows [Qd As] (high card Ace)
nice.franki collected $0.89 from pot
SlimeyGash collected $0.88 from pot
*** SUMMARY ***
Total pot $1.85 | Rake $0.08 
Board [8h 7s Jh 4s 3h]
Seat 1: wtu1986 (button) folded before Flop (didn't bet)
Seat 2: Tasman007 (small blind) folded before Flop
Seat 3: MATT361 (big blind) folded before Flop
Seat 4: chiyuki folded before Flop (didn't bet)
Seat 5: TraderYao folded before Flop (didn't bet)
Seat 6: Zugrug folded before Flop (didn't bet)
Seat 7: nice.franki showed [Qc Ah] and won ($0.89) with high card Ace
Seat 8: DooMSDaY1337 folded before Flop (didn't bet)
Seat 9: SlimeyGash showed [Qd As] and won ($0.88) with high card Ace



PokerStars Zoom Hand #84298432283:  Hold'em No Limit ($0.10/$0.25) - 2012/08/05 13:13:47 JST [2012/08/05 0:13:47 ET]
Table 'Whirlpool' 9-max Seat #1 is the button
Seat 1: KeLevro0 ($22.07 in chips) 
Seat 2: seula i ($80.29 in chips) 
Seat 3: D@vidMed ($28.47 in chips) 
Seat 4: Zugrug ($25 in chips) 
Seat 5: s9999999 ($31.63 in chips) 
Seat 6: BlOnDhOlIc ($39.61 in chips) 
Seat 7: Roglus ($34.94 in chips) 
Seat 8: Medic8681 ($12.75 in chips) 
Seat 9: chiyuki ($41.16 in chips) 
seula i: posts small blind $0.10
D@vidMed: posts big blind $0.25
*** HOLE CARDS ***
Dealt to chiyuki [Ks 6s]
Zugrug: folds 
s9999999: folds 
BlOnDhOlIc: folds 
Roglus: folds 
Medic8681: folds 
chiyuki: folds 
KeLevro0: folds 
seula i: raises $0.50 to $0.75
D@vidMed: folds 
Uncalled bet ($0.50) returned to seula i
seula i collected $0.50 from pot
seula i: doesn't show hand 
*** SUMMARY ***
Total pot $0.50 | Rake $0 
Seat 1: KeLevro0 (button) folded before Flop (didn't bet)
Seat 2: seula i (small blind) collected ($0.50)
Seat 3: D@vidMed (big blind) folded before Flop
Seat 4: Zugrug folded before Flop (didn't bet)
Seat 5: s9999999 folded before Flop (didn't bet)
Seat 6: BlOnDhOlIc folded before Flop (didn't bet)
Seat 7: Roglus folded before Flop (didn't bet)
Seat 8: Medic8681 folded before Flop (didn't bet)
Seat 9: chiyuki folded before Flop (didn't bet)



PokerStars Zoom Hand #84298428835:  Hold'em No Limit ($0.10/$0.25) - 2012/08/05 13:13:35 JST [2012/08/05 0:13:35 ET]
Table 'Whirlpool' 9-max Seat #1 is the button
Seat 1: chiyuki ($41.16 in chips) 
Seat 2: deadmoneykid ($25.37 in chips) 
Seat 3: Th3Fog ($65.66 in chips) 
Seat 4: DooMSDaY1337 ($28.62 in chips) 
Seat 5: KrystalAA ($54.93 in chips) 
Seat 6: s9999999 ($31.63 in chips) 
Seat 7: TraderYao ($24.90 in chips) 
Seat 8: Roglus ($34.94 in chips) 
Seat 9: petersmiths ($32.66 in chips) 
deadmoneykid: posts small blind $0.10
Th3Fog: posts big blind $0.25
*** HOLE CARDS ***
Dealt to chiyuki [8h 2h]
DooMSDaY1337: raises $0.50 to $0.75
KrystalAA: folds 
s9999999: folds 
TraderYao: folds 
Roglus: folds 
petersmiths: folds 
chiyuki: folds 
deadmoneykid: folds 
Th3Fog: folds 
Uncalled bet ($0.50) returned to DooMSDaY1337
DooMSDaY1337 collected $0.60 from pot
DooMSDaY1337: doesn't show hand 
*** SUMMARY ***
Total pot $0.60 | Rake $0 
Seat 1: chiyuki (button) folded before Flop (didn't bet)
Seat 2: deadmoneykid (small blind) folded before Flop
Seat 3: Th3Fog (big blind) folded before Flop
Seat 4: DooMSDaY1337 collected ($0.60)
Seat 5: KrystalAA folded before Flop (didn't bet)
Seat 6: s9999999 folded before Flop (didn't bet)
Seat 7: TraderYao folded before Flop (didn't bet)
Seat 8: Roglus folded before Flop (didn't bet)
Seat 9: petersmiths folded before Flop (didn't bet)



PokerStars Zoom Hand #84298431174:  Hold'em No Limit ($0.10/$0.25) - 2012/08/05 13:13:43 JST [2012/08/05 0:13:43 ET]
Table 'Whirlpool' 9-max Seat #1 is the button
Seat 1: Alvinpe85 ($25 in chips) 
Seat 2: Suhoff76 ($25 in chips) 
Seat 3: wtu1986 ($25 in chips) 
Seat 4: chiyuki ($41.16 in chips) 
Seat 5: mikifeio ($49.24 in chips) 
Seat 6: Zugrug ($25 in chips) 
Seat 7: Tasman007 ($8.33 in chips) 
Seat 8: petersmiths ($32.66 in chips) 
Seat 9: pyty_82 ($57.90 in chips) 
Suhoff76: posts small blind $0.10
wtu1986: posts big blind $0.25
*** HOLE CARDS ***
Dealt to chiyuki [Jc 4c]
chiyuki: folds 
mikifeio: raises $0.25 to $0.50
Zugrug: folds 
Tasman007: folds 
petersmiths: calls $0.50
pyty_82: folds 
Alvinpe85: raises $1.75 to $2.25
Suhoff76: folds 
wtu1986: folds 
mikifeio: folds 
petersmiths: calls $1.75
*** FLOP *** [Ac 5h 3s]
petersmiths: checks 
Alvinpe85: bets $3.06
petersmiths: folds 
Uncalled bet ($3.06) returned to Alvinpe85
Alvinpe85 collected $5.11 from pot
Alvinpe85: doesn't show hand 
*** SUMMARY ***
Total pot $5.35 | Rake $0.24 
Board [Ac 5h 3s]
Seat 1: Alvinpe85 (button) collected ($5.11)
Seat 2: Suhoff76 (small blind) folded before Flop
Seat 3: wtu1986 (big blind) folded before Flop
Seat 4: chiyuki folded before Flop (didn't bet)
Seat 5: mikifeio folded before Flop
Seat 6: Zugrug folded before Flop (didn't bet)
Seat 7: Tasman007 folded before Flop (didn't bet)
Seat 8: petersmiths folded on the Flop
Seat 9: pyty_82 folded before Flop (didn't bet)



PokerStars Zoom Hand #84298436538:  Hold'em No Limit ($0.10/$0.25) - 2012/08/05 13:14:02 JST [2012/08/05 0:14:02 ET]
Table 'Whirlpool' 9-max Seat #1 is the button
Seat 1: nice.franki ($12.37 in chips) 
Seat 2: KeLevro0 ($9.82 in chips) 
Seat 3: Alvinpe85 ($28.85 in chips) 
Seat 4: fwani ($45.52 in chips) 
Seat 5: chiyuki ($41.06 in chips) 
Seat 6: DT_Jesus ($30.61 in chips) 
Seat 7: luyifei ($22.58 in chips) 
Seat 8: mikifeio ($48.74 in chips) 
Seat 9: Suhoff76 ($25 in chips) 
KeLevro0: posts small blind $0.10
Alvinpe85: posts big blind $0.25
*** HOLE CARDS ***
Dealt to chiyuki [Kc Ks]
fwani: folds 
chiyuki: raises $0.50 to $0.75
DT_Jesus: folds 
luyifei: folds 
mikifeio: folds 
Suhoff76: folds 
nice.franki: folds 
KeLevro0: folds 
Alvinpe85: folds 
Uncalled bet ($0.50) returned to chiyuki
chiyuki collected $0.60 from pot
chiyuki: doesn't show hand 
*** SUMMARY ***
Total pot $0.60 | Rake $0 
Seat 1: nice.franki (button) folded before Flop (didn't bet)
Seat 2: KeLevro0 (small blind) folded before Flop
Seat 3: Alvinpe85 (big blind) folded before Flop
Seat 4: fwani folded before Flop (didn't bet)
Seat 5: chiyuki collected ($0.60)
Seat 6: DT_Jesus folded before Flop (didn't bet)
Seat 7: luyifei folded before Flop (didn't bet)
Seat 8: mikifeio folded before Flop (didn't bet)
Seat 9: Suhoff76 folded before Flop (didn't bet)



PokerStars Zoom Hand #84298441946:  Hold'em No Limit ($0.10/$0.25) - 2012/08/05 13:14:21 JST [2012/08/05 0:14:21 ET]
Table 'Whirlpool' 9-max Seat #1 is the button
Seat 1: Suhoff76 ($25.25 in chips) 
Seat 2: fwani ($45.52 in chips) 
Seat 3: KrystalAA ($55.28 in chips) 
Seat 4: chiyuki ($41.41 in chips) 
Seat 5: deadmoneykid ($23.29 in chips) 
Seat 6: nice.franki ($11.55 in chips) 
Seat 7: kamikkaze ($50.18 in chips) 
Seat 8: RomarioJa ($9 in chips) 
Seat 9: seula i ($65.82 in chips) 
fwani: posts small blind $0.10
KrystalAA: posts big blind $0.25
*** HOLE CARDS ***
Dealt to chiyuki [Jh 3h]
chiyuki: folds 
deadmoneykid: folds 
nice.franki: folds 
kamikkaze: folds 
RomarioJa: folds 
seula i: folds 
Suhoff76: folds 
fwani: raises $0.35 to $0.60
KrystalAA: folds 
Uncalled bet ($0.35) returned to fwani
fwani collected $0.50 from pot
fwani: doesn't show hand 
*** SUMMARY ***
Total pot $0.50 | Rake $0 
Seat 1: Suhoff76 (button) folded before Flop (didn't bet)
Seat 2: fwani (small blind) collected ($0.50)
Seat 3: KrystalAA (big blind) folded before Flop
Seat 4: chiyuki folded before Flop (didn't bet)
Seat 5: deadmoneykid folded before Flop (didn't bet)
Seat 6: nice.franki folded before Flop (didn't bet)
Seat 7: kamikkaze folded before Flop (didn't bet)
Seat 8: RomarioJa folded before Flop (didn't bet)
Seat 9: seula i folded before Flop (didn't bet)



PokerStars Zoom Hand #84298445668:  Hold'em No Limit ($0.10/$0.25) - 2012/08/05 13:14:35 JST [2012/08/05 0:14:35 ET]
Table 'Whirlpool' 9-max Seat #1 is the button
Seat 1: TankAbbott1 ($40.74 in chips) 
Seat 2: Zugrug ($25.35 in chips) 
Seat 3: chiyuki ($41.41 in chips) 
Seat 4: RomarioJa ($9 in chips) 
Seat 5: 5zzzz33 ($19.05 in chips) 
Seat 6: kamikkaze ($50.18 in chips) 
Seat 7: agurio ($25 in chips) 
Seat 8: PetitAlejo ($25 in chips) 
Seat 9: DooMSDaY1337 ($56.24 in chips) 
Zugrug: posts small blind $0.10
chiyuki: posts big blind $0.25
*** HOLE CARDS ***
Dealt to chiyuki [2d Qs]
RomarioJa: folds 
5zzzz33: folds 
kamikkaze: folds 
agurio: folds 
PetitAlejo: folds 
DooMSDaY1337: folds 
TankAbbott1: folds 
Zugrug: raises $0.25 to $0.50
chiyuki: folds 
Uncalled bet ($0.25) returned to Zugrug
Zugrug collected $0.50 from pot
Zugrug: doesn't show hand 
*** SUMMARY ***
Total pot $0.50 | Rake $0 
Seat 1: TankAbbott1 (button) folded before Flop (didn't bet)
Seat 2: Zugrug (small blind) collected ($0.50)
Seat 3: chiyuki (big blind) folded before Flop
Seat 4: RomarioJa folded before Flop (didn't bet)
Seat 5: 5zzzz33 folded before Flop (didn't bet)
Seat 6: kamikkaze folded before Flop (didn't bet)
Seat 7: agurio folded before Flop (didn't bet)
Seat 8: PetitAlejo folded before Flop (didn't bet)
Seat 9: DooMSDaY1337 folded before Flop (didn't bet)



PokerStars Zoom Hand #84298443115:  Hold'em No Limit ($0.10/$0.25) - 2012/08/05 13:14:26 JST [2012/08/05 0:14:26 ET]
Table 'Whirlpool' 9-max Seat #1 is the button
Seat 1: seula i ($25.58 in chips) 
Seat 2: Medic8681 ($12.60 in chips) 
Seat 3: nice.franki ($12.72 in chips) 
Seat 4: wtu1986 ($25.50 in chips) 
Seat 5: Suhoff76 ($25 in chips) 
Seat 6: leo2095 ($16.20 in chips) 
Seat 7: hassantas ($25 in chips) 
Seat 8: chiyuki ($41.41 in chips) 
Seat 9: deadmoneykid ($20.40 in chips) 
Medic8681: posts small blind $0.10
nice.franki: posts big blind $0.25
*** HOLE CARDS ***
Dealt to chiyuki [4h Kd]
wtu1986: folds 
Suhoff76: folds 
leo2095: folds 
hassantas: folds 
chiyuki: folds 
deadmoneykid: folds 
seula i: raises $0.50 to $0.75
Medic8681: folds 
nice.franki: folds 
Uncalled bet ($0.50) returned to seula i
seula i collected $0.60 from pot
seula i: doesn't show hand 
*** SUMMARY ***
Total pot $0.60 | Rake $0 
Seat 1: seula i (button) collected ($0.60)
Seat 2: Medic8681 (small blind) folded before Flop
Seat 3: nice.franki (big blind) folded before Flop
Seat 4: wtu1986 folded before Flop (didn't bet)
Seat 5: Suhoff76 folded before Flop (didn't bet)
Seat 6: leo2095 folded before Flop (didn't bet)
Seat 7: hassantas folded before Flop (didn't bet)
Seat 8: chiyuki folded before Flop (didn't bet)
Seat 9: deadmoneykid folded before Flop (didn't bet)



PokerStars Zoom Hand #84298434564:  Hold'em No Limit ($0.10/$0.25) - 2012/08/05 13:13:55 JST [2012/08/05 0:13:55 ET]
Table 'Whirlpool' 9-max Seat #1 is the button
Seat 1: DooMSDaY1337 ($67.91 in chips) 
Seat 2: chiyuki ($41.16 in chips) 
Seat 3: a_tasmanian ($57.55 in chips) 
Seat 4: ll_LaMeR_ll ($21.17 in chips) 
Seat 5: MibNe ($29.75 in chips) 
Seat 6: nice.franki ($12.37 in chips) 
Seat 7: silvno31 ($14.82 in chips) 
Seat 8: SlimeyGash ($23.36 in chips) 
Seat 9: BlOnDhOlIc ($44.50 in chips) 
chiyuki: posts small blind $0.10
a_tasmanian: posts big blind $0.25
*** HOLE CARDS ***
Dealt to chiyuki [7c 3s]
ll_LaMeR_ll: folds 
MibNe: raises $0.62 to $0.87
nice.franki: folds 
silvno31: folds 
SlimeyGash: calls $0.87
BlOnDhOlIc: calls $0.87
DooMSDaY1337: folds 
chiyuki: folds 
a_tasmanian: calls $0.62
*** FLOP *** [Th 5c Jc]
a_tasmanian: checks 
MibNe: bets $1.71
SlimeyGash: folds 
BlOnDhOlIc: calls $1.71
a_tasmanian: calls $1.71
*** TURN *** [Th 5c Jc] [4d]
a_tasmanian: checks 
MibNe: bets $2.50
BlOnDhOlIc: calls $2.50
a_tasmanian: calls $2.50
*** RIVER *** [Th 5c Jc 4d] [9d]
a_tasmanian: checks 
MibNe: checks 
BlOnDhOlIc: checks 
*** SHOW DOWN ***
a_tasmanian: shows [Qc Qs] (a pair of Queens)
MibNe: mucks hand 
BlOnDhOlIc: mucks hand 
a_tasmanian collected $15.48 from pot
*** SUMMARY ***
Total pot $16.21 | Rake $0.73 
Board [Th 5c Jc 4d 9d]
Seat 1: DooMSDaY1337 (button) folded before Flop (didn't bet)
Seat 2: chiyuki (small blind) folded before Flop
Seat 3: a_tasmanian (big blind) showed [Qc Qs] and won ($15.48) with a pair of Queens
Seat 4: ll_LaMeR_ll folded before Flop (didn't bet)
Seat 5: MibNe mucked [Kd Jh]
Seat 6: nice.franki folded before Flop (didn't bet)
Seat 7: silvno31 folded before Flop (didn't bet)
Seat 8: SlimeyGash folded on the Flop
Seat 9: BlOnDhOlIc mucked [Ad Td]



PokerStars Zoom Hand #84298453674:  Hold'em No Limit ($0.10/$0.25) - 2012/08/05 13:15:03 JST [2012/08/05 0:15:03 ET]
Table 'Whirlpool' 9-max Seat #1 is the button
Seat 1: kamikkaze ($49.83 in chips) 
Seat 2: nice.franki ($12.47 in chips) 
Seat 3: seula i ($77.79 in chips) 
Seat 4: mikifeio ($47.99 in chips) 
Seat 5: bigrasbig ($35.28 in chips) 
Seat 6: hassantas ($25 in chips) 
Seat 7: Roglus ($35.29 in chips) 
Seat 8: envious_0007 ($21.46 in chips) 
Seat 9: chiyuki ($41.16 in chips) 
nice.franki: posts small blind $0.10
seula i: posts big blind $0.25
*** HOLE CARDS ***
Dealt to chiyuki [8c 3s]
mikifeio: folds 
bigrasbig: folds 
hassantas: folds 
Roglus: folds 
envious_0007: folds 
chiyuki: folds 
kamikkaze: folds 
nice.franki: folds 
Uncalled bet ($0.15) returned to seula i
seula i collected $0.20 from pot
seula i: doesn't show hand 
*** SUMMARY ***
Total pot $0.20 | Rake $0 
Seat 1: kamikkaze (button) folded before Flop (didn't bet)
Seat 2: nice.franki (small blind) folded before Flop
Seat 3: seula i (big blind) collected ($0.20)
Seat 4: mikifeio folded before Flop (didn't bet)
Seat 5: bigrasbig folded before Flop (didn't bet)
Seat 6: hassantas folded before Flop (didn't bet)
Seat 7: Roglus folded before Flop (didn't bet)
Seat 8: envious_0007 folded before Flop (didn't bet)
Seat 9: chiyuki folded before Flop (didn't bet)



PokerStars Zoom Hand #84298451414:  Hold'em No Limit ($0.10/$0.25) - 2012/08/05 13:14:55 JST [2012/08/05 0:14:55 ET]
Table 'Whirlpool' 9-max Seat #1 is the button
Seat 1: wtu1986 ($25.25 in chips) 
Seat 2: gAm813r ($28.72 in chips) 
Seat 3: fwani ($26.66 in chips) 
Seat 4: slapshot2011 ($33.49 in chips) 
Seat 5: DooMSDaY1337 ($56.14 in chips) 
Seat 6: chiyuki ($41.16 in chips) 
Seat 7: RomarioJa ($9.44 in chips) 
Seat 8: ll_LaMeR_ll ($21.85 in chips) 
Seat 9: KeLevro0 ($7.42 in chips) 
gAm813r: posts small blind $0.10
fwani: posts big blind $0.25
*** HOLE CARDS ***
Dealt to chiyuki [2c 6h]
slapshot2011: folds 
DooMSDaY1337: folds 
chiyuki: folds 
RomarioJa: folds 
ll_LaMeR_ll: folds 
KeLevro0: folds 
wtu1986: folds 
gAm813r: folds 
Uncalled bet ($0.15) returned to fwani
fwani collected $0.20 from pot
fwani: doesn't show hand 
*** SUMMARY ***
Total pot $0.20 | Rake $0 
Seat 1: wtu1986 (button) folded before Flop (didn't bet)
Seat 2: gAm813r (small blind) folded before Flop
Seat 3: fwani (big blind) collected ($0.20)
Seat 4: slapshot2011 folded before Flop (didn't bet)
Seat 5: DooMSDaY1337 folded before Flop (didn't bet)
Seat 6: chiyuki folded before Flop (didn't bet)
Seat 7: RomarioJa folded before Flop (didn't bet)
Seat 8: ll_LaMeR_ll folded before Flop (didn't bet)
Seat 9: KeLevro0 folded before Flop (didn't bet)



PokerStars Zoom Hand #84298454510:  Hold'em No Limit ($0.10/$0.25) - 2012/08/05 13:15:06 JST [2012/08/05 0:15:06 ET]
Table 'Whirlpool' 9-max Seat #1 is the button
Seat 1: pyty_82 ($59.94 in chips) 
Seat 2: chiyuki ($41.16 in chips) 
Seat 3: wtu1986 ($24.94 in chips) 
Seat 4: slapshot2011 ($33.49 in chips) 
Seat 5: masterkoolb ($12.50 in chips) 
Seat 6: leo2095 ($16.20 in chips) 
Seat 7: vit 111 ($41.02 in chips) 
Seat 8: Alvinpe85 ($27.86 in chips) 
Seat 9: RomarioJa ($8.75 in chips) 
chiyuki: posts small blind $0.10
wtu1986: posts big blind $0.25
*** HOLE CARDS ***
Dealt to chiyuki [3d 8d]
slapshot2011: folds 
masterkoolb: folds 
leo2095: raises $1 to $1.25
vit 111: folds 
Alvinpe85: folds 
RomarioJa: folds 
pyty_82: folds 
chiyuki: folds 
wtu1986: folds 
Uncalled bet ($1) returned to leo2095
leo2095 collected $0.60 from pot
leo2095: doesn't show hand 
*** SUMMARY ***
Total pot $0.60 | Rake $0 
Seat 1: pyty_82 (button) folded before Flop (didn't bet)
Seat 2: chiyuki (small blind) folded before Flop
Seat 3: wtu1986 (big blind) folded before Flop
Seat 4: slapshot2011 folded before Flop (didn't bet)
Seat 5: masterkoolb folded before Flop (didn't bet)
Seat 6: leo2095 collected ($0.60)
Seat 7: vit 111 folded before Flop (didn't bet)
Seat 8: Alvinpe85 folded before Flop (didn't bet)
Seat 9: RomarioJa folded before Flop (didn't bet)



PokerStars Zoom Hand #84298448814:  Hold'em No Limit ($0.10/$0.25) - 2012/08/05 13:14:46 JST [2012/08/05 0:14:46 ET]
Table 'Whirlpool' 9-max Seat #1 is the button
Seat 1: chiyuki ($41.16 in chips) 
Seat 2: ll_LaMeR_ll ($21.95 in chips) 
Seat 3: PetitAlejo ($27.60 in chips) 
Seat 4: SlimeyGash ($22.39 in chips) 
Seat 5: agurio ($25 in chips) 
Seat 6: nice.franki ($14.57 in chips) 
Seat 7: slickthis ($23.35 in chips) 
Seat 8: seula i ($65.82 in chips) 
Seat 9: Alvinpe85 ($27.86 in chips) 
ll_LaMeR_ll: posts small blind $0.10
PetitAlejo: posts big blind $0.25
*** HOLE CARDS ***
Dealt to chiyuki [6s 4s]
SlimeyGash: folds 
agurio: folds 
nice.franki: folds 
slickthis: calls $0.25
seula i: folds 
Alvinpe85: folds 
chiyuki: folds 
ll_LaMeR_ll: folds 
PetitAlejo: checks 
*** FLOP *** [5h 6h 6d]
PetitAlejo: checks 
slickthis: checks 
*** TURN *** [5h 6h 6d] [Kh]
PetitAlejo: checks 
slickthis: bets $0.25
PetitAlejo: folds 
Uncalled bet ($0.25) returned to slickthis
slickthis collected $0.57 from pot
slickthis: doesn't show hand 
*** SUMMARY ***
Total pot $0.60 | Rake $0.03 
Board [5h 6h 6d Kh]
Seat 1: chiyuki (button) folded before Flop (didn't bet)
Seat 2: ll_LaMeR_ll (small blind) folded before Flop
Seat 3: PetitAlejo (big blind) folded on the Turn
Seat 4: SlimeyGash folded before Flop (didn't bet)
Seat 5: agurio folded before Flop (didn't bet)
Seat 6: nice.franki folded before Flop (didn't bet)
Seat 7: slickthis collected ($0.57)
Seat 8: seula i folded before Flop (didn't bet)
Seat 9: Alvinpe85 folded before Flop (didn't bet)



PokerStars Zoom Hand #84298458635:  Hold'em No Limit ($0.10/$0.25) - 2012/08/05 13:15:20 JST [2012/08/05 0:15:20 ET]
Table 'Whirlpool' 9-max Seat #1 is the button
Seat 1: Rodina-Kr ($25 in chips) 
Seat 2: Roglus ($12.74 in chips) 
Seat 3: PetitAlejo ($25 in chips) 
Seat 4: Tasman007 ($8.33 in chips) 
Seat 5: chiyuki ($41.06 in chips) 
Seat 6: TraderYao ($24.90 in chips) 
Seat 7: RomarioJa ($8.65 in chips) 
Seat 8: kamikkaze ($49.83 in chips) 
Seat 9: DooMSDaY1337 ($70.81 in chips) 
Roglus: posts small blind $0.10
PetitAlejo: posts big blind $0.25
*** HOLE CARDS ***
Dealt to chiyuki [Td Jd]
Tasman007: folds 
chiyuki: folds 
TraderYao: folds 
RomarioJa: folds 
kamikkaze: folds 
DooMSDaY1337: folds 
Rodina-Kr: raises $0.65 to $0.90
Roglus: folds 
PetitAlejo: folds 
Uncalled bet ($0.65) returned to Rodina-Kr
Rodina-Kr collected $0.60 from pot
Rodina-Kr: doesn't show hand 
*** SUMMARY ***
Total pot $0.60 | Rake $0 
Seat 1: Rodina-Kr (button) collected ($0.60)
Seat 2: Roglus (small blind) folded before Flop
Seat 3: PetitAlejo (big blind) folded before Flop
Seat 4: Tasman007 folded before Flop (didn't bet)
Seat 5: chiyuki folded before Flop (didn't bet)
Seat 6: TraderYao folded before Flop (didn't bet)
Seat 7: RomarioJa folded before Flop (didn't bet)
Seat 8: kamikkaze folded before Flop (didn't bet)
Seat 9: DooMSDaY1337 folded before Flop (didn't bet)



PokerStars Zoom Hand #84298457465:  Hold'em No Limit ($0.10/$0.25) - 2012/08/05 13:15:16 JST [2012/08/05 0:15:16 ET]
Table 'Whirlpool' 9-max Seat #1 is the button
Seat 1: Jippyflip ($26.11 in chips) 
Seat 2: kkbruins0408 ($12.63 in chips) 
Seat 3: envious_0007 ($21.46 in chips) 
Seat 4: masterkoolb ($12.50 in chips) 
Seat 5: TankAbbott1 ($40.74 in chips) 
Seat 6: kamikkaze ($49.83 in chips) 
Seat 7: chiyuki ($41.06 in chips) 
Seat 8: taksist889 ($35.28 in chips) 
Seat 9: Suhoff76 ($25 in chips) 
kkbruins0408: posts small blind $0.10
envious_0007: posts big blind $0.25
*** HOLE CARDS ***
Dealt to chiyuki [Jh 8h]
masterkoolb: folds 
TankAbbott1: folds 
kamikkaze: folds 
chiyuki: folds 
taksist889: raises $0.50 to $0.75
Suhoff76: folds 
Jippyflip: folds 
kkbruins0408: calls $0.65
envious_0007: folds 
*** FLOP *** [4h Qd 2h]
kkbruins0408: checks 
taksist889: bets $1.25
kkbruins0408: folds 
Uncalled bet ($1.25) returned to taksist889
taksist889 collected $1.67 from pot
taksist889: doesn't show hand 
*** SUMMARY ***
Total pot $1.75 | Rake $0.08 
Board [4h Qd 2h]
Seat 1: Jippyflip (button) folded before Flop (didn't bet)
Seat 2: kkbruins0408 (small blind) folded on the Flop
Seat 3: envious_0007 (big blind) folded before Flop
Seat 4: masterkoolb folded before Flop (didn't bet)
Seat 5: TankAbbott1 folded before Flop (didn't bet)
Seat 6: kamikkaze folded before Flop (didn't bet)
Seat 7: chiyuki folded before Flop (didn't bet)
Seat 8: taksist889 collected ($1.67)
Seat 9: Suhoff76 folded before Flop (didn't bet)



PokerStars Zoom Hand #84298449976:  Hold'em No Limit ($0.10/$0.25) - 2012/08/05 13:14:50 JST [2012/08/05 0:14:50 ET]
Table 'Whirlpool' 9-max Seat #1 is the button
Seat 1: ll_LaMeR_ll ($21.85 in chips) 
Seat 2: TraderYao ($25 in chips) 
Seat 3: deadmoneykid ($23.29 in chips) 
Seat 4: agurio ($25 in chips) 
Seat 5: Loholov ($15.13 in chips) 
Seat 6: Medic8681 ($15.39 in chips) 
Seat 7: chiyuki ($41.16 in chips) 
Seat 8: fwani ($26.66 in chips) 
Seat 9: BlOnDhOlIc ($26.02 in chips) 
TraderYao: posts small blind $0.10
deadmoneykid: posts big blind $0.25
*** HOLE CARDS ***
Dealt to chiyuki [9d Th]
agurio: folds 
Loholov: raises $0.50 to $0.75
Medic8681: folds 
chiyuki: folds 
fwani: folds 
BlOnDhOlIc: folds 
ll_LaMeR_ll: folds 
TraderYao: calls $0.65
deadmoneykid: calls $0.50
*** FLOP *** [Qd Tc Kc]
TraderYao: checks 
deadmoneykid: checks 
Loholov: checks 
*** TURN *** [Qd Tc Kc] [Ts]
TraderYao: checks 
deadmoneykid: checks 
Loholov: checks 
*** RIVER *** [Qd Tc Kc Ts] [2c]
TraderYao: checks 
deadmoneykid: checks 
Loholov: bets $1.50
TraderYao: folds 
deadmoneykid: folds 
Uncalled bet ($1.50) returned to Loholov
Loholov collected $2.15 from pot
Loholov: doesn't show hand 
*** SUMMARY ***
Total pot $2.25 | Rake $0.10 
Board [Qd Tc Kc Ts 2c]
Seat 1: ll_LaMeR_ll (button) folded before Flop (didn't bet)
Seat 2: TraderYao (small blind) folded on the River
Seat 3: deadmoneykid (big blind) folded on the River
Seat 4: agurio folded before Flop (didn't bet)
Seat 5: Loholov collected ($2.15)
Seat 6: Medic8681 folded before Flop (didn't bet)
Seat 7: chiyuki folded before Flop (didn't bet)
Seat 8: fwani folded before Flop (didn't bet)
Seat 9: BlOnDhOlIc folded before Flop (didn't bet)



PokerStars Zoom Hand #84298462084:  Hold'em No Limit ($0.10/$0.25) - 2012/08/05 13:15:32 JST [2012/08/05 0:15:32 ET]
Table 'Whirlpool' 9-max Seat #1 is the button
Seat 1: nice.franki ($8.22 in chips) 
Seat 2: RomarioJa ($9.54 in chips) 
Seat 3: chiyuki ($41.06 in chips) 
Seat 4: PetitAlejo ($28.83 in chips) 
Seat 5: softdesign ($52.92 in chips) 
Seat 6: ll_LaMeR_ll ($21.15 in chips) 
Seat 7: simonzez ($38.09 in chips) 
Seat 8: seula i ($59.51 in chips) 
Seat 9: doanut13 ($34.52 in chips) 
RomarioJa: posts small blind $0.10
chiyuki: posts big blind $0.25
*** HOLE CARDS ***
Dealt to chiyuki [3c Jc]
PetitAlejo: raises $0.50 to $0.75
softdesign: calls $0.75
ll_LaMeR_ll: folds 
simonzez: folds 
seula i: folds 
doanut13: folds 
nice.franki: folds 
RomarioJa: folds 
chiyuki: folds 
*** FLOP *** [4d 5h 8d]
PetitAlejo: bets $1.25
softdesign: folds 
Uncalled bet ($1.25) returned to PetitAlejo
PetitAlejo collected $1.77 from pot
PetitAlejo: doesn't show hand 
*** SUMMARY ***
Total pot $1.85 | Rake $0.08 
Board [4d 5h 8d]
Seat 1: nice.franki (button) folded before Flop (didn't bet)
Seat 2: RomarioJa (small blind) folded before Flop
Seat 3: chiyuki (big blind) folded before Flop
Seat 4: PetitAlejo collected ($1.77)
Seat 5: softdesign folded on the Flop
Seat 6: ll_LaMeR_ll folded before Flop (didn't bet)
Seat 7: simonzez folded before Flop (didn't bet)
Seat 8: seula i folded before Flop (didn't bet)
Seat 9: doanut13 folded before Flop (didn't bet)



PokerStars Zoom Hand #84298468659:  Hold'em No Limit ($0.10/$0.25) - 2012/08/05 13:15:56 JST [2012/08/05 0:15:56 ET]
Table 'Whirlpool' 9-max Seat #1 is the button
Seat 1: Th3Fog ($24.33 in chips) 
Seat 2: Medic8681 ($12.50 in chips) 
Seat 3: Roglus ($40.17 in chips) 
Seat 4: DooMSDaY1337 ($54.39 in chips) 
Seat 5: MibNe ($25.69 in chips) 
Seat 6: wtu1986 ($25.35 in chips) 
Seat 7: nice.franki ($8.22 in chips) 
Seat 8: chiyuki ($40.81 in chips) 
Seat 9: 5zzzz33 ($20.77 in chips) 
Medic8681: posts small blind $0.10
Roglus: posts big blind $0.25
*** HOLE CARDS ***
Dealt to chiyuki [2h Kc]
DooMSDaY1337: folds 
MibNe: raises $0.37 to $0.62
wtu1986: folds 
nice.franki: folds 
chiyuki: folds 
5zzzz33: folds 
Th3Fog: folds 
Medic8681: folds 
Roglus: calls $0.37
*** FLOP *** [6h 9d 9s]
Roglus: checks 
MibNe: bets $0.96
Roglus: folds 
Uncalled bet ($0.96) returned to MibNe
MibNe collected $1.28 from pot
MibNe: doesn't show hand 
*** SUMMARY ***
Total pot $1.34 | Rake $0.06 
Board [6h 9d 9s]
Seat 1: Th3Fog (button) folded before Flop (didn't bet)
Seat 2: Medic8681 (small blind) folded before Flop
Seat 3: Roglus (big blind) folded on the Flop
Seat 4: DooMSDaY1337 folded before Flop (didn't bet)
Seat 5: MibNe collected ($1.28)
Seat 6: wtu1986 folded before Flop (didn't bet)
Seat 7: nice.franki folded before Flop (didn't bet)
Seat 8: chiyuki folded before Flop (didn't bet)
Seat 9: 5zzzz33 folded before Flop (didn't bet)



PokerStars Zoom Hand #84298470578:  Hold'em No Limit ($0.10/$0.25) - 2012/08/05 13:16:03 JST [2012/08/05 0:16:03 ET]
Table 'Whirlpool' 9-max Seat #1 is the button
Seat 1: chiyuki ($40.81 in chips) 
Seat 2: DooMSDaY1337 ($33.77 in chips) 
Seat 3: Suhoff76 ($25.35 in chips) 
Seat 4: Medic8681 ($12.50 in chips) 
Seat 5: BlOnDhOlIc ($50.68 in chips) 
Seat 6: seula i ($65.47 in chips) 
Seat 7: Th3Fog ($24.33 in chips) 
Seat 8: luyifei ($22.20 in chips) 
Seat 9: PetitAlejo ($25.35 in chips) 
DooMSDaY1337: posts small blind $0.10
Suhoff76: posts big blind $0.25
*** HOLE CARDS ***
Dealt to chiyuki [3c 2d]
Medic8681: folds 
BlOnDhOlIc: raises $0.37 to $0.62
seula i: folds 
Th3Fog: folds 
luyifei: folds 
PetitAlejo: folds 
chiyuki: folds 
DooMSDaY1337: folds 
Suhoff76: folds 
Uncalled bet ($0.37) returned to BlOnDhOlIc
BlOnDhOlIc collected $0.60 from pot
BlOnDhOlIc: doesn't show hand 
*** SUMMARY ***
Total pot $0.60 | Rake $0 
Seat 1: chiyuki (button) folded before Flop (didn't bet)
Seat 2: DooMSDaY1337 (small blind) folded before Flop
Seat 3: Suhoff76 (big blind) folded before Flop
Seat 4: Medic8681 folded before Flop (didn't bet)
Seat 5: BlOnDhOlIc collected ($0.60)
Seat 6: seula i folded before Flop (didn't bet)
Seat 7: Th3Fog folded before Flop (didn't bet)
Seat 8: luyifei folded before Flop (didn't bet)
Seat 9: PetitAlejo folded before Flop (didn't bet)



PokerStars Zoom Hand #84298474264:  Hold'em No Limit ($0.10/$0.25) - 2012/08/05 13:16:16 JST [2012/08/05 0:16:16 ET]
Table 'Whirlpool' 9-max Seat #1 is the button
Seat 1: Loholov ($16.53 in chips) 
Seat 2: vit 111 ($42.71 in chips) 
Seat 3: nice.franki ($11.20 in chips) 
Seat 4: chiyuki ($40.81 in chips) 
Seat 5: mikifeio ($46.89 in chips) 
Seat 6: PetitAlejo ($25 in chips) 
Seat 7: DooMSDaY1337 ($33.67 in chips) 
Seat 8: softdesign ($52.17 in chips) 
Seat 9: TraderYao ($25.35 in chips) 
vit 111: posts small blind $0.10
nice.franki: posts big blind $0.25
*** HOLE CARDS ***
Dealt to chiyuki [3s 8h]
chiyuki: folds 
mikifeio: folds 
PetitAlejo: folds 
DooMSDaY1337: folds 
softdesign: folds 
TraderYao: folds 
Loholov: folds 
vit 111: folds 
Uncalled bet ($0.15) returned to nice.franki
nice.franki collected $0.20 from pot
nice.franki: doesn't show hand 
*** SUMMARY ***
Total pot $0.20 | Rake $0 
Seat 1: Loholov (button) folded before Flop (didn't bet)
Seat 2: vit 111 (small blind) folded before Flop
Seat 3: nice.franki (big blind) collected ($0.20)
Seat 4: chiyuki folded before Flop (didn't bet)
Seat 5: mikifeio folded before Flop (didn't bet)
Seat 6: PetitAlejo folded before Flop (didn't bet)
Seat 7: DooMSDaY1337 folded before Flop (didn't bet)
Seat 8: softdesign folded before Flop (didn't bet)
Seat 9: TraderYao folded before Flop (didn't bet)



PokerStars Zoom Hand #84298476574:  Hold'em No Limit ($0.10/$0.25) - 2012/08/05 13:16:24 JST [2012/08/05 0:16:24 ET]
Table 'Whirlpool' 9-max Seat #1 is the button
Seat 1: Th3Fog ($51.83 in chips) 
Seat 2: chiyuki ($40.81 in chips) 
Seat 3: Lasutchik ($26.17 in chips) 
Seat 4: fwani ($46.95 in chips) 
Seat 5: seula i ($78.14 in chips) 
Seat 6: leo2095 ($16.20 in chips) 
Seat 7: TraderYao ($24.90 in chips) 
Seat 8: Roglus ($13.09 in chips) 
Seat 9: Zugrug ($25.95 in chips) 
chiyuki: posts small blind $0.10
Lasutchik: posts big blind $0.25
*** HOLE CARDS ***
Dealt to chiyuki [8s 5s]
fwani: folds 
seula i: folds 
leo2095: folds 
TraderYao: folds 
Roglus: folds 
Zugrug: folds 
Th3Fog: folds 
chiyuki: folds 
Uncalled bet ($0.15) returned to Lasutchik
Lasutchik collected $0.20 from pot
Lasutchik: doesn't show hand 
*** SUMMARY ***
Total pot $0.20 | Rake $0 
Seat 1: Th3Fog (button) folded before Flop (didn't bet)
Seat 2: chiyuki (small blind) folded before Flop
Seat 3: Lasutchik (big blind) collected ($0.20)
Seat 4: fwani folded before Flop (didn't bet)
Seat 5: seula i folded before Flop (didn't bet)
Seat 6: leo2095 folded before Flop (didn't bet)
Seat 7: TraderYao folded before Flop (didn't bet)
Seat 8: Roglus folded before Flop (didn't bet)
Seat 9: Zugrug folded before Flop (didn't bet)



PokerStars Zoom Hand #84298473425:  Hold'em No Limit ($0.10/$0.25) - 2012/08/05 13:16:13 JST [2012/08/05 0:16:13 ET]
Table 'Whirlpool' 9-max Seat #1 is the button
Seat 1: Lasutchik ($11.80 in chips) 
Seat 2: DonSimonUsa ($23.83 in chips) 
Seat 3: NastyMcNast ($32.71 in chips) 
Seat 4: gAm813r ($28.62 in chips) 
Seat 5: chiyuki ($40.81 in chips) 
Seat 6: a_tasmanian ($67.10 in chips) 
Seat 7: Suhoff76 ($25 in chips) 
Seat 8: gedavaca ($27.18 in chips) 
Seat 9: 4ydo yogurt ($19.82 in chips) 
DonSimonUsa: posts small blind $0.10
NastyMcNast: posts big blind $0.25
*** HOLE CARDS ***
Dealt to chiyuki [4d 3h]
gAm813r: folds 
chiyuki: folds 
a_tasmanian: raises $0.50 to $0.75
Suhoff76: folds 
gedavaca: folds 
4ydo yogurt: folds 
Lasutchik: folds 
DonSimonUsa: calls $0.65
NastyMcNast: folds 
*** FLOP *** [6c 6s 6d]
DonSimonUsa: checks 
a_tasmanian: bets $1
DonSimonUsa: folds 
Uncalled bet ($1) returned to a_tasmanian
a_tasmanian collected $1.67 from pot
a_tasmanian: doesn't show hand 
*** SUMMARY ***
Total pot $1.75 | Rake $0.08 
Board [6c 6s 6d]
Seat 1: Lasutchik (button) folded before Flop (didn't bet)
Seat 2: DonSimonUsa (small blind) folded on the Flop
Seat 3: NastyMcNast (big blind) folded before Flop
Seat 4: gAm813r folded before Flop (didn't bet)
Seat 5: chiyuki folded before Flop (didn't bet)
Seat 6: a_tasmanian collected ($1.67)
Seat 7: Suhoff76 folded before Flop (didn't bet)
Seat 8: gedavaca folded before Flop (didn't bet)
Seat 9: 4ydo yogurt folded before Flop (didn't bet)



PokerStars Zoom Hand #84298472518:  Hold'em No Limit ($0.10/$0.25) - 2012/08/05 13:16:10 JST [2012/08/05 0:16:10 ET]
Table 'Whirlpool' 9-max Seat #1 is the button
Seat 1: Loholov ($16.48 in chips) 
Seat 2: deadmoneykid ($20.50 in chips) 
Seat 3: ShockLaMuc ($25 in chips) 
Seat 4: Medic8681 ($12.85 in chips) 
Seat 5: DooMSDaY1337 ($70.56 in chips) 
Seat 6: chiyuki ($40.81 in chips) 
Seat 7: hassantas ($24.50 in chips) 
Seat 8: D@vidMed ($30.72 in chips) 
Seat 9: eagie20 ($143.11 in chips) 
deadmoneykid: posts small blind $0.10
ShockLaMuc: posts big blind $0.25
*** HOLE CARDS ***
Dealt to chiyuki [Kc 7c]
Medic8681: folds 
DooMSDaY1337: folds 
chiyuki: folds 
hassantas: folds 
D@vidMed has timed out
D@vidMed: folds 
eagie20: raises $0.50 to $0.75
Loholov has timed out
Loholov: folds 
deadmoneykid: folds 
ShockLaMuc: folds 
Uncalled bet ($0.50) returned to eagie20
eagie20 collected $0.60 from pot
eagie20: doesn't show hand 
*** SUMMARY ***
Total pot $0.60 | Rake $0 
Seat 1: Loholov (button) folded before Flop (didn't bet)
Seat 2: deadmoneykid (small blind) folded before Flop
Seat 3: ShockLaMuc (big blind) folded before Flop
Seat 4: Medic8681 folded before Flop (didn't bet)
Seat 5: DooMSDaY1337 folded before Flop (didn't bet)
Seat 6: chiyuki folded before Flop (didn't bet)
Seat 7: hassantas folded before Flop (didn't bet)
Seat 8: D@vidMed folded before Flop (didn't bet)
Seat 9: eagie20 collected ($0.60)



PokerStars Zoom Hand #84298481556:  Hold'em No Limit ($0.10/$0.25) - 2012/08/05 13:16:41 JST [2012/08/05 0:16:41 ET]
Table 'Whirlpool' 9-max Seat #1 is the button
Seat 1: envious_0007 ($20.86 in chips) 
Seat 2: NastyMcNast ($32.46 in chips) 
Seat 3: PetitAlejo ($29.75 in chips) 
Seat 4: Zugrug ($25.95 in chips) 
Seat 5: TraderYao ($24.90 in chips) 
Seat 6: MATT361 ($7.63 in chips) 
Seat 7: fwani ($29.37 in chips) 
Seat 8: chiyuki ($40.71 in chips) 
Seat 9: Rodina-Kr ($25.32 in chips) 
NastyMcNast: posts small blind $0.10
PetitAlejo: posts big blind $0.25
*** HOLE CARDS ***
Dealt to chiyuki [6c Ts]
Zugrug: folds 
TraderYao: folds 
MATT361: folds 
fwani: folds 
chiyuki: folds 
Rodina-Kr: folds 
envious_0007: folds 
NastyMcNast: folds 
Uncalled bet ($0.15) returned to PetitAlejo
PetitAlejo collected $0.20 from pot
PetitAlejo: doesn't show hand 
*** SUMMARY ***
Total pot $0.20 | Rake $0 
Seat 1: envious_0007 (button) folded before Flop (didn't bet)
Seat 2: NastyMcNast (small blind) folded before Flop
Seat 3: PetitAlejo (big blind) collected ($0.20)
Seat 4: Zugrug folded before Flop (didn't bet)
Seat 5: TraderYao folded before Flop (didn't bet)
Seat 6: MATT361 folded before Flop (didn't bet)
Seat 7: fwani folded before Flop (didn't bet)
Seat 8: chiyuki folded before Flop (didn't bet)
Seat 9: Rodina-Kr folded before Flop (didn't bet)



PokerStars Zoom Hand #84298479763:  Hold'em No Limit ($0.10/$0.25) - 2012/08/05 13:16:35 JST [2012/08/05 0:16:35 ET]
Table 'Whirlpool' 9-max Seat #1 is the button
Seat 1: RomarioJa ($6.49 in chips) 
Seat 2: TErr18 ($25.80 in chips) 
Seat 3: wtu1986 ($24.59 in chips) 
Seat 4: leo2095 ($16.20 in chips) 
Seat 5: Zugrug ($25.95 in chips) 
Seat 6: puffy5533 ($18.63 in chips) 
Seat 7: deadmoneykid ($20.40 in chips) 
Seat 8: KeLevro0 ($9.40 in chips) 
Seat 9: chiyuki ($40.71 in chips) 
TErr18: posts small blind $0.10
wtu1986: posts big blind $0.25
*** HOLE CARDS ***
Dealt to chiyuki [Kc 7h]
leo2095: folds 
Zugrug: folds 
puffy5533: folds 
deadmoneykid: folds 
KeLevro0: folds 
chiyuki: folds 
RomarioJa: raises $0.37 to $0.62
TErr18: raises $0.88 to $1.50
wtu1986: folds 
RomarioJa: folds 
Uncalled bet ($0.88) returned to TErr18
TErr18 collected $1.49 from pot
TErr18: doesn't show hand 
*** SUMMARY ***
Total pot $1.49 | Rake $0 
Seat 1: RomarioJa (button) folded before Flop
Seat 2: TErr18 (small blind) collected ($1.49)
Seat 3: wtu1986 (big blind) folded before Flop
Seat 4: leo2095 folded before Flop (didn't bet)
Seat 5: Zugrug folded before Flop (didn't bet)
Seat 6: puffy5533 folded before Flop (didn't bet)
Seat 7: deadmoneykid folded before Flop (didn't bet)
Seat 8: KeLevro0 folded before Flop (didn't bet)
Seat 9: chiyuki folded before Flop (didn't bet)



PokerStars Zoom Hand #84298475418:  Hold'em No Limit ($0.10/$0.25) - 2012/08/05 13:16:20 JST [2012/08/05 0:16:20 ET]
Table 'Whirlpool' 9-max Seat #1 is the button
Seat 1: DT_Jesus ($26.27 in chips) 
Seat 2: Roglus ($39.55 in chips) 
Seat 3: DooMSDaY1337 ($26.22 in chips) 
Seat 4: chiyuki ($40.81 in chips) 
Seat 5: KeLevro0 ($9.65 in chips) 
Seat 6: Jene4kaBest ($7.31 in chips) 
Seat 7: fwani ($29.37 in chips) 
Seat 8: cR!Ma*aRm ($26.16 in chips) 
Seat 9: deadmoneykid ($22.44 in chips) 
Roglus: posts small blind $0.10
DooMSDaY1337: posts big blind $0.25
*** HOLE CARDS ***
Dealt to chiyuki [Ac Td]
chiyuki: folds 
KeLevro0: folds 
Jene4kaBest: folds 
fwani: folds 
cR!Ma*aRm: folds 
deadmoneykid: folds 
DT_Jesus: folds 
Roglus: raises $0.50 to $0.75
DooMSDaY1337: calls $0.50
*** FLOP *** [6h Jh 7c]
Roglus: bets $0.97
DooMSDaY1337: calls $0.97
*** TURN *** [6h Jh 7c] [2c]
Roglus: bets $1.75
DooMSDaY1337: calls $1.75
*** RIVER *** [6h Jh 7c 2c] [As]
Roglus: bets $3.75
DooMSDaY1337: folds 
Uncalled bet ($3.75) returned to Roglus
Roglus collected $6.63 from pot
Roglus: doesn't show hand 
*** SUMMARY ***
Total pot $6.94 | Rake $0.31 
Board [6h Jh 7c 2c As]
Seat 1: DT_Jesus (button) folded before Flop (didn't bet)
Seat 2: Roglus (small blind) collected ($6.63)
Seat 3: DooMSDaY1337 (big blind) folded on the River
Seat 4: chiyuki folded before Flop (didn't bet)
Seat 5: KeLevro0 folded before Flop (didn't bet)
Seat 6: Jene4kaBest folded before Flop (didn't bet)
Seat 7: fwani folded before Flop (didn't bet)
Seat 8: cR!Ma*aRm folded before Flop (didn't bet)
Seat 9: deadmoneykid folded before Flop (didn't bet)



PokerStars Zoom Hand #84298484305:  Hold'em No Limit ($0.10/$0.25) - 2012/08/05 13:16:52 JST [2012/08/05 0:16:52 ET]
Table 'Whirlpool' 9-max Seat #1 is the button
Seat 1: Rodina-Kr ($25 in chips) 
Seat 2: KeLevro0 ($9.40 in chips) 
Seat 3: chiyuki ($40.71 in chips) 
Seat 4: leo2095 ($16.20 in chips) 
Seat 5: TraderYao ($24.90 in chips) 
Seat 6: Suhoff76 ($25 in chips) 
Seat 7: puffy5533 ($18.38 in chips) 
Seat 8: fwani ($25 in chips) 
Seat 9: ShockLaMuc ($24.65 in chips) 
KeLevro0: posts small blind $0.10
chiyuki: posts big blind $0.25
*** HOLE CARDS ***
Dealt to chiyuki [2s Jh]
leo2095: raises $0.25 to $0.50
TraderYao: folds 
Suhoff76: folds 
puffy5533: folds 
fwani: folds 
ShockLaMuc: calls $0.50
Rodina-Kr: folds 
KeLevro0: folds 
chiyuki: calls $0.25
*** FLOP *** [3s 4s 6d]
chiyuki: checks 
leo2095: checks 
ShockLaMuc: bets $1.05
chiyuki: folds 
leo2095: folds 
Uncalled bet ($1.05) returned to ShockLaMuc
ShockLaMuc collected $1.53 from pot
ShockLaMuc: doesn't show hand 
*** SUMMARY ***
Total pot $1.60 | Rake $0.07 
Board [3s 4s 6d]
Seat 1: Rodina-Kr (button) folded before Flop (didn't bet)
Seat 2: KeLevro0 (small blind) folded before Flop
Seat 3: chiyuki (big blind) folded on the Flop
Seat 4: leo2095 folded on the Flop
Seat 5: TraderYao folded before Flop (didn't bet)
Seat 6: Suhoff76 folded before Flop (didn't bet)
Seat 7: puffy5533 folded before Flop (didn't bet)
Seat 8: fwani folded before Flop (didn't bet)
Seat 9: ShockLaMuc collected ($1.53)



PokerStars Zoom Hand #84298482979:  Hold'em No Limit ($0.10/$0.25) - 2012/08/05 13:16:46 JST [2012/08/05 0:16:46 ET]
Table 'Whirlpool' 9-max Seat #1 is the button
Seat 1: chiyuki ($40.71 in chips) 
Seat 2: simonzez ($44.34 in chips) 
Seat 3: DonSimonUsa ($23.08 in chips) 
Seat 4: leo2095 ($16.20 in chips) 
Seat 5: Jene4kaBest ($7.31 in chips) 
Seat 6: KeLevro0 ($9.40 in chips) 
Seat 7: ryanjp2323 ($30.12 in chips) 
Seat 8: MATT361 ($7.63 in chips) 
Seat 9: Zugrug ($26.50 in chips) 
simonzez: posts small blind $0.10
DonSimonUsa: posts big blind $0.25
*** HOLE CARDS ***
Dealt to chiyuki [3h 8c]
leo2095: folds 
Jene4kaBest: raises $0.50 to $0.75
KeLevro0: folds 
ryanjp2323: folds 
MATT361: folds 
Zugrug: folds 
chiyuki: folds 
simonzez: folds 
DonSimonUsa: calls $0.50
*** FLOP *** [3s Js Th]
DonSimonUsa: checks 
Jene4kaBest: bets $0.61
DonSimonUsa: calls $0.61
*** TURN *** [3s Js Th] [Kh]
DonSimonUsa: checks 
Jene4kaBest: checks 
*** RIVER *** [3s Js Th Kh] [Ts]
DonSimonUsa: checks 
Jene4kaBest: bets $1.50
DonSimonUsa: calls $1.50
*** SHOW DOWN ***
Jene4kaBest: shows [Td Ad] (three of a kind, Tens)
DonSimonUsa: mucks hand 
Jene4kaBest collected $5.56 from pot
*** SUMMARY ***
Total pot $5.82 | Rake $0.26 
Board [3s Js Th Kh Ts]
Seat 1: chiyuki (button) folded before Flop (didn't bet)
Seat 2: simonzez (small blind) folded before Flop
Seat 3: DonSimonUsa (big blind) mucked [Kd Ac]
Seat 4: leo2095 folded before Flop (didn't bet)
Seat 5: Jene4kaBest showed [Td Ad] and won ($5.56) with three of a kind, Tens
Seat 6: KeLevro0 folded before Flop (didn't bet)
Seat 7: ryanjp2323 folded before Flop (didn't bet)
Seat 8: MATT361 folded before Flop (didn't bet)
Seat 9: Zugrug folded before Flop (didn't bet)



PokerStars Zoom Hand #84298492480:  Hold'em No Limit ($0.10/$0.25) - 2012/08/05 13:17:21 JST [2012/08/05 0:17:21 ET]
Table 'Whirlpool' 9-max Seat #1 is the button
Seat 1: NastyMcNast ($32.36 in chips) 
Seat 2: PetitAlejo ($25 in chips) 
Seat 3: TraderYao ($24.80 in chips) 
Seat 4: KeLevro0 ($12.40 in chips) 
Seat 5: BlOnDhOlIc ($26.08 in chips) 
Seat 6: chiyuki ($40.21 in chips) 
Seat 7: Suhoff76 ($25 in chips) 
Seat 8: Medic8681 ($14.14 in chips) 
Seat 9: goldstone ($24.65 in chips) 
PetitAlejo: posts small blind $0.10
TraderYao: posts big blind $0.25
*** HOLE CARDS ***
Dealt to chiyuki [Qd Ad]
KeLevro0: folds 
BlOnDhOlIc: folds 
chiyuki: raises $0.50 to $0.75
Suhoff76: folds 
Medic8681: folds 
goldstone: folds 
NastyMcNast: folds 
PetitAlejo: folds 
TraderYao: folds 
Uncalled bet ($0.50) returned to chiyuki
chiyuki collected $0.60 from pot
chiyuki: doesn't show hand 
*** SUMMARY ***
Total pot $0.60 | Rake $0 
Seat 1: NastyMcNast (button) folded before Flop (didn't bet)
Seat 2: PetitAlejo (small blind) folded before Flop
Seat 3: TraderYao (big blind) folded before Flop
Seat 4: KeLevro0 folded before Flop (didn't bet)
Seat 5: BlOnDhOlIc folded before Flop (didn't bet)
Seat 6: chiyuki collected ($0.60)
Seat 7: Suhoff76 folded before Flop (didn't bet)
Seat 8: Medic8681 folded before Flop (didn't bet)
Seat 9: goldstone folded before Flop (didn't bet)



PokerStars Zoom Hand #84298496699:  Hold'em No Limit ($0.10/$0.25) - 2012/08/05 13:17:36 JST [2012/08/05 0:17:36 ET]
Table 'Whirlpool' 9-max Seat #1 is the button
Seat 1: kkbruins0408 ($11.53 in chips) 
Seat 2: DT_Jesus ($27.40 in chips) 
Seat 3: Jene4kaBest ($10.01 in chips) 
Seat 4: eagie20 ($144.01 in chips) 
Seat 5: pyty_82 ($57.92 in chips) 
Seat 6: Catrban ($33.21 in chips) 
Seat 7: chiyuki ($40.56 in chips) 
Seat 8: Zugrug ($28.69 in chips) 
Seat 9: Alvinpe85 ($33.43 in chips) 
DT_Jesus: posts small blind $0.10
Jene4kaBest: posts big blind $0.25
*** HOLE CARDS ***
Dealt to chiyuki [4d 3d]
eagie20: folds 
pyty_82: raises $0.37 to $0.62
Catrban: folds 
chiyuki: folds 
Zugrug: folds 
Alvinpe85: calls $0.62
kkbruins0408: folds 
DT_Jesus: folds 
Jene4kaBest: calls $0.37
*** FLOP *** [6h 7d 2s]
Jene4kaBest: checks 
pyty_82: checks 
Alvinpe85: bets $1.12
Jene4kaBest: raises $2.87 to $3.99
pyty_82: folds 
Alvinpe85: folds 
Uncalled bet ($2.87) returned to Jene4kaBest
Jene4kaBest collected $4.01 from pot
Jene4kaBest: doesn't show hand 
*** SUMMARY ***
Total pot $4.20 | Rake $0.19 
Board [6h 7d 2s]
Seat 1: kkbruins0408 (button) folded before Flop (didn't bet)
Seat 2: DT_Jesus (small blind) folded before Flop
Seat 3: Jene4kaBest (big blind) collected ($4.01)
Seat 4: eagie20 folded before Flop (didn't bet)
Seat 5: pyty_82 folded on the Flop
Seat 6: Catrban folded before Flop (didn't bet)
Seat 7: chiyuki folded before Flop (didn't bet)
Seat 8: Zugrug folded before Flop (didn't bet)
Seat 9: Alvinpe85 folded on the Flop



PokerStars Zoom Hand #84298500032:  Hold'em No Limit ($0.10/$0.25) - 2012/08/05 13:17:48 JST [2012/08/05 0:17:48 ET]
Table 'Whirlpool' 9-max Seat #1 is the button
Seat 1: MATT361 ($6.88 in chips) 
Seat 2: 4ydo yogurt ($19.42 in chips) 
Seat 3: DooMSDaY1337 ($55.74 in chips) 
Seat 4: Catrban ($33.21 in chips) 
Seat 5: chiyuki ($40.56 in chips) 
Seat 6: silvno31 ($21.48 in chips) 
Seat 7: petersmiths ($35.48 in chips) 
Seat 8: BlOnDhOlIc ($25.83 in chips) 
Seat 9: Zugrug ($25.60 in chips) 
4ydo yogurt: posts small blind $0.10
DooMSDaY1337: posts big blind $0.25
*** HOLE CARDS ***
Dealt to chiyuki [8d 8c]
Catrban: folds 
chiyuki: raises $0.50 to $0.75
silvno31: folds 
petersmiths: folds 
BlOnDhOlIc: folds 
Zugrug: folds 
MATT361: calls $0.75
4ydo yogurt: folds 
DooMSDaY1337: calls $0.50
*** FLOP *** [Ts Js 5s]
DooMSDaY1337: checks 
chiyuki: checks 
MATT361: bets $0.75
DooMSDaY1337: folds 
chiyuki: folds 
Uncalled bet ($0.75) returned to MATT361
MATT361 collected $2.24 from pot
MATT361: doesn't show hand 
*** SUMMARY ***
Total pot $2.35 | Rake $0.11 
Board [Ts Js 5s]
Seat 1: MATT361 (button) collected ($2.24)
Seat 2: 4ydo yogurt (small blind) folded before Flop
Seat 3: DooMSDaY1337 (big blind) folded on the Flop
Seat 4: Catrban folded before Flop (didn't bet)
Seat 5: chiyuki folded on the Flop
Seat 6: silvno31 folded before Flop (didn't bet)
Seat 7: petersmiths folded before Flop (didn't bet)
Seat 8: BlOnDhOlIc folded before Flop (didn't bet)
Seat 9: Zugrug folded before Flop (didn't bet)



PokerStars Zoom Hand #84298497820:  Hold'em No Limit ($0.10/$0.25) - 2012/08/05 13:17:40 JST [2012/08/05 0:17:40 ET]
Table 'Whirlpool' 9-max Seat #1 is the button
Seat 1: Medic8681 ($15.11 in chips) 
Seat 2: TraderYao ($25.88 in chips) 
Seat 3: seula i ($59.67 in chips) 
Seat 4: chiyuki ($40.56 in chips) 
Seat 5: Catrban ($33.21 in chips) 
Seat 6: Zugrug ($28.69 in chips) 
Seat 7: masterkoolb ($12.75 in chips) 
Seat 8: KINGKILERACE ($27.34 in chips) 
Seat 9: deadmoneykid ($25 in chips) 
TraderYao: posts small blind $0.10
seula i: posts big blind $0.25
*** HOLE CARDS ***
Dealt to chiyuki [3s Kd]
chiyuki: folds 
Catrban: folds 
Zugrug: folds 
masterkoolb: folds 
KINGKILERACE: calls $0.25
deadmoneykid: folds 
Medic8681: calls $0.25
TraderYao: folds 
seula i: raises $1.25 to $1.50
KINGKILERACE: calls $1.25
Medic8681: folds 
*** FLOP *** [5s 8h Tc]
seula i: bets $1.75
KINGKILERACE: calls $1.75
*** TURN *** [5s 8h Tc] [3c]
seula i: checks 
KINGKILERACE: checks 
*** RIVER *** [5s 8h Tc 3c] [4d]
seula i: checks 
KINGKILERACE: checks 
*** SHOW DOWN ***
seula i: shows [Ad Kh] (high card Ace)
KINGKILERACE: shows [5h Jh] (a pair of Fives)
KINGKILERACE collected $6.54 from pot
*** SUMMARY ***
Total pot $6.85 | Rake $0.31 
Board [5s 8h Tc 3c 4d]
Seat 1: Medic8681 (button) folded before Flop
Seat 2: TraderYao (small blind) folded before Flop
Seat 3: seula i (big blind) showed [Ad Kh] and lost with high card Ace
Seat 4: chiyuki folded before Flop (didn't bet)
Seat 5: Catrban folded before Flop (didn't bet)
Seat 6: Zugrug folded before Flop (didn't bet)
Seat 7: masterkoolb folded before Flop (didn't bet)
Seat 8: KINGKILERACE showed [5h Jh] and won ($6.54) with a pair of Fives
Seat 9: deadmoneykid folded before Flop (didn't bet)



PokerStars Zoom Hand #84298498886:  Hold'em No Limit ($0.10/$0.25) - 2012/08/05 13:17:44 JST [2012/08/05 0:17:44 ET]
Table 'Whirlpool' 9-max Seat #1 is the button
Seat 1: Medic8681 ($14.28 in chips) 
Seat 2: wtu1986 ($25.45 in chips) 
Seat 3: agurio ($25 in chips) 
Seat 4: 4ydo yogurt ($19.42 in chips) 
Seat 5: NastyMcNast ($49.87 in chips) 
Seat 6: nice.franki ($14.12 in chips) 
Seat 7: gunbowler ($97.11 in chips) 
Seat 8: KeLevro0 ($12.57 in chips) 
Seat 9: chiyuki ($40.56 in chips) 
wtu1986: posts small blind $0.10
agurio: posts big blind $0.25
*** HOLE CARDS ***
Dealt to chiyuki [4s 6s]
4ydo yogurt: folds 
NastyMcNast: raises $0.50 to $0.75
nice.franki: folds 
gunbowler: raises $1.05 to $1.80
KeLevro0: folds 
chiyuki: folds 
Medic8681: folds 
wtu1986: folds 
agurio: folds 
NastyMcNast: calls $1.05
*** FLOP *** [Kh 9d 2h]
NastyMcNast: checks 
gunbowler: bets $1.90
NastyMcNast: folds 
Uncalled bet ($1.90) returned to gunbowler
gunbowler collected $3.77 from pot
gunbowler: doesn't show hand 
*** SUMMARY ***
Total pot $3.95 | Rake $0.18 
Board [Kh 9d 2h]
Seat 1: Medic8681 (button) folded before Flop (didn't bet)
Seat 2: wtu1986 (small blind) folded before Flop
Seat 3: agurio (big blind) folded before Flop
Seat 4: 4ydo yogurt folded before Flop (didn't bet)
Seat 5: NastyMcNast folded on the Flop
Seat 6: nice.franki folded before Flop (didn't bet)
Seat 7: gunbowler collected ($3.77)
Seat 8: KeLevro0 folded before Flop (didn't bet)
Seat 9: chiyuki folded before Flop (didn't bet)



PokerStars Zoom Hand #84298510993:  Hold'em No Limit ($0.10/$0.25) - 2012/08/05 13:18:28 JST [2012/08/05 0:18:28 ET]
Table 'Whirlpool' 9-max Seat #1 is the button
Seat 1: agurio ($25 in chips) 
Seat 2: chiyuki ($39.81 in chips) 
Seat 3: Th3Fog ($68.57 in chips) 
Seat 4: NastyMcNast ($25.87 in chips) 
Seat 5: Suhoff76 ($25 in chips) 
Seat 6: luyifei ($20.98 in chips) 
Seat 7: PetitAlejo ($28.21 in chips) 
Seat 8: DooMSDaY1337 ($26.27 in chips) 
Seat 9: BlOnDhOlIc ($36.67 in chips) 
chiyuki: posts small blind $0.10
Th3Fog: posts big blind $0.25
*** HOLE CARDS ***
Dealt to chiyuki [2h 2c]
NastyMcNast: folds 
Suhoff76: folds 
luyifei: raises $0.50 to $0.75
PetitAlejo: folds 
DooMSDaY1337: folds 
BlOnDhOlIc: folds 
agurio: folds 
chiyuki: folds 
Th3Fog: folds 
Uncalled bet ($0.50) returned to luyifei
luyifei collected $0.60 from pot
luyifei: doesn't show hand 
*** SUMMARY ***
Total pot $0.60 | Rake $0 
Seat 1: agurio (button) folded before Flop (didn't bet)
Seat 2: chiyuki (small blind) folded before Flop
Seat 3: Th3Fog (big blind) folded before Flop
Seat 4: NastyMcNast folded before Flop (didn't bet)
Seat 5: Suhoff76 folded before Flop (didn't bet)
Seat 6: luyifei collected ($0.60)
Seat 7: PetitAlejo folded before Flop (didn't bet)
Seat 8: DooMSDaY1337 folded before Flop (didn't bet)
Seat 9: BlOnDhOlIc folded before Flop (didn't bet)



PokerStars Zoom Hand #84298515532:  Hold'em No Limit ($0.10/$0.25) - 2012/08/05 13:18:44 JST [2012/08/05 0:18:44 ET]
Table 'Whirlpool' 9-max Seat #1 is the button
Seat 1: Zugrug ($25.35 in chips) 
Seat 2: goldstone ($24.10 in chips) 
Seat 3: 4ydo yogurt ($20.10 in chips) 
Seat 4: Loholov ($41.44 in chips) 
Seat 5: nice.franki ($13.77 in chips) 
Seat 6: chiyuki ($39.71 in chips) 
Seat 7: mikifeio ($44.29 in chips) 
Seat 8: wtu1986 ($25.35 in chips) 
Seat 9: pyty_82 ($57.20 in chips) 
goldstone: posts small blind $0.10
4ydo yogurt: posts big blind $0.25
*** HOLE CARDS ***
Dealt to chiyuki [Ks Ah]
Loholov: folds 
nice.franki: folds 
chiyuki: raises $0.50 to $0.75
mikifeio: folds 
wtu1986: folds 
pyty_82: folds 
Zugrug: folds 
goldstone: folds 
4ydo yogurt: folds 
Uncalled bet ($0.50) returned to chiyuki
chiyuki collected $0.60 from pot
chiyuki: doesn't show hand 
*** SUMMARY ***
Total pot $0.60 | Rake $0 
Seat 1: Zugrug (button) folded before Flop (didn't bet)
Seat 2: goldstone (small blind) folded before Flop
Seat 3: 4ydo yogurt (big blind) folded before Flop
Seat 4: Loholov folded before Flop (didn't bet)
Seat 5: nice.franki folded before Flop (didn't bet)
Seat 6: chiyuki collected ($0.60)
Seat 7: mikifeio folded before Flop (didn't bet)
Seat 8: wtu1986 folded before Flop (didn't bet)
Seat 9: pyty_82 folded before Flop (didn't bet)



PokerStars Zoom Hand #84298522154:  Hold'em No Limit ($0.10/$0.25) - 2012/08/05 13:19:08 JST [2012/08/05 0:19:08 ET]
Table 'Whirlpool' 9-max Seat #1 is the button
Seat 1: masterkoolb ($12.85 in chips) 
Seat 2: RomarioJa ($8.57 in chips) 
Seat 3: Jippyflip ($25.65 in chips) 
Seat 4: Zugrug ($28.34 in chips) 
Seat 5: NastyMcNast ($26.72 in chips) 
Seat 6: fwani ($25.35 in chips) 
Seat 7: Rodina-Kr ($25 in chips) 
Seat 8: chiyuki ($40.06 in chips) 
Seat 9: ryanjp2323 ($31.27 in chips) 
RomarioJa: posts small blind $0.10
Jippyflip: posts big blind $0.25
*** HOLE CARDS ***
Dealt to chiyuki [Jh Qs]
Zugrug: folds 
NastyMcNast: folds 
fwani: folds 
Rodina-Kr: folds 
chiyuki: folds 
ryanjp2323: folds 
masterkoolb: folds 
RomarioJa: raises $0.50 to $0.75
Jippyflip: folds 
Uncalled bet ($0.50) returned to RomarioJa
RomarioJa collected $0.50 from pot
RomarioJa: doesn't show hand 
*** SUMMARY ***
Total pot $0.50 | Rake $0 
Seat 1: masterkoolb (button) folded before Flop (didn't bet)
Seat 2: RomarioJa (small blind) collected ($0.50)
Seat 3: Jippyflip (big blind) folded before Flop
Seat 4: Zugrug folded before Flop (didn't bet)
Seat 5: NastyMcNast folded before Flop (didn't bet)
Seat 6: fwani folded before Flop (didn't bet)
Seat 7: Rodina-Kr folded before Flop (didn't bet)
Seat 8: chiyuki folded before Flop (didn't bet)
Seat 9: ryanjp2323 folded before Flop (didn't bet)



PokerStars Zoom Hand #84298524152:  Hold'em No Limit ($0.10/$0.25) - 2012/08/05 13:19:16 JST [2012/08/05 0:19:16 ET]
Table 'Whirlpool' 9-max Seat #1 is the button
Seat 1: BlOnDhOlIc ($50.43 in chips) 
Seat 2: DonSimonUsa ($17.37 in chips) 
Seat 3: chiyuki ($40.06 in chips) 
Seat 4: TraderYao ($29.24 in chips) 
Seat 5: gedavaca ($31.45 in chips) 
Seat 6: NastyMcNast ($48.32 in chips) 
Seat 7: BlackZafiro ($25.35 in chips) 
Seat 8: masterkoolb ($14.39 in chips) 
Seat 9: fwani ($25.35 in chips) 
DonSimonUsa: posts small blind $0.10
chiyuki: posts big blind $0.25
*** HOLE CARDS ***
Dealt to chiyuki [5h 3h]
TraderYao: raises $0.50 to $0.75
gedavaca: folds 
NastyMcNast: folds 
BlackZafiro: folds 
masterkoolb: folds 
fwani: folds 
BlOnDhOlIc: calls $0.75
DonSimonUsa: folds 
chiyuki: folds 
*** FLOP *** [4s 2d 5d]
TraderYao: bets $1.09
BlOnDhOlIc: calls $1.09
*** TURN *** [4s 2d 5d] [8s]
TraderYao: bets $2.38
BlOnDhOlIc: calls $2.38
*** RIVER *** [4s 2d 5d 8s] [2s]
TraderYao: checks 
BlOnDhOlIc: checks 
*** SHOW DOWN ***
TraderYao: shows [Jd Td] (a pair of Deuces)
BlOnDhOlIc: shows [9h 9s] (two pair, Nines and Deuces)
BlOnDhOlIc collected $8.39 from pot
*** SUMMARY ***
Total pot $8.79 | Rake $0.40 
Board [4s 2d 5d 8s 2s]
Seat 1: BlOnDhOlIc (button) showed [9h 9s] and won ($8.39) with two pair, Nines and Deuces
Seat 2: DonSimonUsa (small blind) folded before Flop
Seat 3: chiyuki (big blind) folded before Flop
Seat 4: TraderYao showed [Jd Td] and lost with a pair of Deuces
Seat 5: gedavaca folded before Flop (didn't bet)
Seat 6: NastyMcNast folded before Flop (didn't bet)
Seat 7: BlackZafiro folded before Flop (didn't bet)
Seat 8: masterkoolb folded before Flop (didn't bet)
Seat 9: fwani folded before Flop (didn't bet)



PokerStars Zoom Hand #84298535112:  Hold'em No Limit ($0.10/$0.25) - 2012/08/05 13:19:55 JST [2012/08/05 0:19:55 ET]
Table 'Whirlpool' 9-max Seat #1 is the button
Seat 1: nice.franki ($7.27 in chips) 
Seat 2: DT_Jesus ($15.27 in chips) 
Seat 3: Zugrug ($29.19 in chips) 
Seat 4: chiyuki ($39.81 in chips) 
Seat 5: PetitAlejo ($27.46 in chips) 
Seat 6: Roglus ($18.46 in chips) 
Seat 7: Medic8681 ($13.86 in chips) 
Seat 8: mikifeio ($43.44 in chips) 
Seat 9: MibNe ($29.64 in chips) 
DT_Jesus: posts small blind $0.10
Zugrug: posts big blind $0.25
*** HOLE CARDS ***
Dealt to chiyuki [As 3s]
chiyuki: folds 
PetitAlejo: folds 
Roglus: folds 
Medic8681: folds 
mikifeio: folds 
MibNe: folds 
nice.franki: folds 
DT_Jesus: folds 
Uncalled bet ($0.15) returned to Zugrug
Zugrug collected $0.20 from pot
Zugrug: doesn't show hand 
*** SUMMARY ***
Total pot $0.20 | Rake $0 
Seat 1: nice.franki (button) folded before Flop (didn't bet)
Seat 2: DT_Jesus (small blind) folded before Flop
Seat 3: Zugrug (big blind) collected ($0.20)
Seat 4: chiyuki folded before Flop (didn't bet)
Seat 5: PetitAlejo folded before Flop (didn't bet)
Seat 6: Roglus folded before Flop (didn't bet)
Seat 7: Medic8681 folded before Flop (didn't bet)
Seat 8: mikifeio folded before Flop (didn't bet)
Seat 9: MibNe folded before Flop (didn't bet)



PokerStars Zoom Hand #84298531449:  Hold'em No Limit ($0.10/$0.25) - 2012/08/05 13:19:42 JST [2012/08/05 0:19:42 ET]
Table 'Whirlpool' 9-max Seat #1 is the button
Seat 1: wtu1986 ($25.93 in chips) 
Seat 2: 5zzzz33 ($17.74 in chips) 
Seat 3: nice.franki ($7.52 in chips) 
Seat 4: Zugrug ($36.17 in chips) 
Seat 5: BlOnDhOlIc ($36.07 in chips) 
Seat 6: ll_LaMeR_ll ($23.52 in chips) 
Seat 7: chiyuki ($39.81 in chips) 
Seat 8: ShockLaMuc ($27.88 in chips) 
Seat 9: KeLevro0 ($11.40 in chips) 
5zzzz33: posts small blind $0.10
nice.franki: posts big blind $0.25
*** HOLE CARDS ***
Dealt to chiyuki [5c 4d]
Zugrug: folds 
BlOnDhOlIc: folds 
ll_LaMeR_ll: raises $0.50 to $0.75
chiyuki: folds 
ShockLaMuc: calls $0.75
KeLevro0: folds 
wtu1986: folds 
5zzzz33: calls $0.65
nice.franki: folds 
*** FLOP *** [9h Jd 6s]
5zzzz33: checks 
ll_LaMeR_ll: bets $1.25
ShockLaMuc: folds 
5zzzz33: folds 
Uncalled bet ($1.25) returned to ll_LaMeR_ll
ll_LaMeR_ll collected $2.39 from pot
ll_LaMeR_ll: doesn't show hand 
*** SUMMARY ***
Total pot $2.50 | Rake $0.11 
Board [9h Jd 6s]
Seat 1: wtu1986 (button) folded before Flop (didn't bet)
Seat 2: 5zzzz33 (small blind) folded on the Flop
Seat 3: nice.franki (big blind) folded before Flop
Seat 4: Zugrug folded before Flop (didn't bet)
Seat 5: BlOnDhOlIc folded before Flop (didn't bet)
Seat 6: ll_LaMeR_ll collected ($2.39)
Seat 7: chiyuki folded before Flop (didn't bet)
Seat 8: ShockLaMuc folded on the Flop
Seat 9: KeLevro0 folded before Flop (didn't bet)



PokerStars Zoom Hand #84298533121:  Hold'em No Limit ($0.10/$0.25) - 2012/08/05 13:19:48 JST [2012/08/05 0:19:48 ET]
Table 'Whirlpool' 9-max Seat #1 is the button
Seat 1: chiyuki ($39.81 in chips) 
Seat 2: BlackZafiro ($25.10 in chips) 
Seat 3: hirozo ($25 in chips) 
Seat 4: Medic8681 ($15.43 in chips) 
Seat 5: Loholov ($15 in chips) 
Seat 6: Th3Fog ($68.22 in chips) 
Seat 7: TraderYao ($25.35 in chips) 
Seat 8: Alvinpe85 ($25 in chips) 
Seat 9: seula i ($25.23 in chips) 
BlackZafiro: posts small blind $0.10
hirozo: posts big blind $0.25
*** HOLE CARDS ***
Dealt to chiyuki [3c 5c]
Medic8681: folds 
Loholov: folds 
Th3Fog: raises $0.47 to $0.72
TraderYao: folds 
Alvinpe85: folds 
seula i: folds 
chiyuki: folds 
BlackZafiro: folds 
hirozo: folds 
Uncalled bet ($0.47) returned to Th3Fog
Th3Fog collected $0.60 from pot
Th3Fog: doesn't show hand 
*** SUMMARY ***
Total pot $0.60 | Rake $0 
Seat 1: chiyuki (button) folded before Flop (didn't bet)
Seat 2: BlackZafiro (small blind) folded before Flop
Seat 3: hirozo (big blind) folded before Flop
Seat 4: Medic8681 folded before Flop (didn't bet)
Seat 5: Loholov folded before Flop (didn't bet)
Seat 6: Th3Fog collected ($0.60)
Seat 7: TraderYao folded before Flop (didn't bet)
Seat 8: Alvinpe85 folded before Flop (didn't bet)
Seat 9: seula i folded before Flop (didn't bet)



PokerStars Zoom Hand #84298533980:  Hold'em No Limit ($0.10/$0.25) - 2012/08/05 13:19:51 JST [2012/08/05 0:19:51 ET]
Table 'Whirlpool' 9-max Seat #1 is the button
Seat 1: RomarioJa ($8.82 in chips) 
Seat 2: KeLevro0 ($11.40 in chips) 
Seat 3: taksist889 ($33.53 in chips) 
Seat 4: chiyuki ($39.81 in chips) 
Seat 5: nice.franki ($9.15 in chips) 
Seat 6: Zugrug ($25.25 in chips) 
Seat 7: Suhoff76 ($25.22 in chips) 
Seat 8: wtu1986 ($25.93 in chips) 
Seat 9: BlOnDhOlIc ($25.80 in chips) 
KeLevro0: posts small blind $0.10
taksist889: posts big blind $0.25
*** HOLE CARDS ***
Dealt to chiyuki [5d 2c]
chiyuki: folds 
nice.franki: folds 
Zugrug: folds 
Suhoff76: folds 
wtu1986: raises $0.50 to $0.75
BlOnDhOlIc: folds 
RomarioJa: folds 
KeLevro0: raises $1.75 to $2.50
taksist889: folds 
wtu1986: folds 
Uncalled bet ($1.75) returned to KeLevro0
KeLevro0 collected $1.75 from pot
KeLevro0: doesn't show hand 
*** SUMMARY ***
Total pot $1.75 | Rake $0 
Seat 1: RomarioJa (button) folded before Flop (didn't bet)
Seat 2: KeLevro0 (small blind) collected ($1.75)
Seat 3: taksist889 (big blind) folded before Flop
Seat 4: chiyuki folded before Flop (didn't bet)
Seat 5: nice.franki folded before Flop (didn't bet)
Seat 6: Zugrug folded before Flop (didn't bet)
Seat 7: Suhoff76 folded before Flop (didn't bet)
Seat 8: wtu1986 folded before Flop
Seat 9: BlOnDhOlIc folded before Flop (didn't bet)



PokerStars Zoom Hand #84298560586:  Hold'em No Limit ($0.10/$0.25) - 2012/08/05 13:21:27 JST [2012/08/05 0:21:27 ET]
Table 'Whirlpool' 9-max Seat #1 is the button
Seat 1: Lasutchik ($26.27 in chips) 
Seat 2: PetitAlejo ($27.30 in chips) 
Seat 3: Suhoff76 ($25.75 in chips) 
Seat 4: TraderYao ($25.78 in chips) 
Seat 5: KeLevro0 ($8.55 in chips) 
Seat 6: Zugrug ($29.19 in chips) 
Seat 7: hirozo ($25 in chips) 
Seat 8: chiyuki ($38.21 in chips) 
Seat 9: seula i ($62.80 in chips) 
PetitAlejo: posts small blind $0.10
Suhoff76: posts big blind $0.25
*** HOLE CARDS ***
Dealt to chiyuki [6c Kd]
TraderYao: folds 
KeLevro0: folds 
Zugrug: folds 
hirozo: folds 
chiyuki: folds 
seula i: raises $0.50 to $0.75
Lasutchik: folds 
PetitAlejo: folds 
Suhoff76: folds 
Uncalled bet ($0.50) returned to seula i
seula i collected $0.60 from pot
seula i: doesn't show hand 
*** SUMMARY ***
Total pot $0.60 | Rake $0 
Seat 1: Lasutchik (button) folded before Flop (didn't bet)
Seat 2: PetitAlejo (small blind) folded before Flop
Seat 3: Suhoff76 (big blind) folded before Flop
Seat 4: TraderYao folded before Flop (didn't bet)
Seat 5: KeLevro0 folded before Flop (didn't bet)
Seat 6: Zugrug folded before Flop (didn't bet)
Seat 7: hirozo folded before Flop (didn't bet)
Seat 8: chiyuki folded before Flop (didn't bet)
Seat 9: seula i collected ($0.60)



PokerStars Zoom Hand #84298537049:  Hold'em No Limit ($0.10/$0.25) - 2012/08/05 13:20:02 JST [2012/08/05 0:20:02 ET]
Table 'Whirlpool' 9-max Seat #1 is the button
Seat 1: wtu1986 ($25.10 in chips) 
Seat 2: Suhoff76 ($25 in chips) 
Seat 3: Roglus ($41.09 in chips) 
Seat 4: MibNe ($29.64 in chips) 
Seat 5: deadmoneykid ($25.09 in chips) 
Seat 6: chiyuki ($39.81 in chips) 
Seat 7: luyifei ($21.93 in chips) 
Seat 8: nice.franki ($9.05 in chips) 
Seat 9: Loholov ($20.32 in chips) 
Suhoff76: posts small blind $0.10
Roglus: posts big blind $0.25
*** HOLE CARDS ***
Dealt to chiyuki [7h 7d]
MibNe: folds 
deadmoneykid has timed out
deadmoneykid: folds 
chiyuki: raises $0.50 to $0.75
luyifei: calls $0.75
nice.franki: folds 
Loholov: folds 
wtu1986: folds 
Suhoff76: folds 
Roglus: calls $0.50
*** FLOP *** [4c 4h Qd]
Roglus: checks 
chiyuki: checks 
luyifei: bets $0.75
Roglus: calls $0.75
chiyuki: calls $0.75
*** TURN *** [4c 4h Qd] [Ah]
Roglus: bets $2.98
chiyuki: folds 
luyifei: calls $2.98
*** RIVER *** [4c 4h Qd Ah] [Ts]
Roglus: bets $3.52
luyifei: folds 
Uncalled bet ($3.52) returned to Roglus
Roglus collected $10.08 from pot
Roglus: doesn't show hand 
*** SUMMARY ***
Total pot $10.56 | Rake $0.48 
Board [4c 4h Qd Ah Ts]
Seat 1: wtu1986 (button) folded before Flop (didn't bet)
Seat 2: Suhoff76 (small blind) folded before Flop
Seat 3: Roglus (big blind) collected ($10.08)
Seat 4: MibNe folded before Flop (didn't bet)
Seat 5: deadmoneykid folded before Flop (didn't bet)
Seat 6: chiyuki folded on the Turn
Seat 7: luyifei folded on the River
Seat 8: nice.franki folded before Flop (didn't bet)
Seat 9: Loholov folded before Flop (didn't bet)



PokerStars Zoom Hand #84298558366:  Hold'em No Limit ($0.10/$0.25) - 2012/08/05 13:21:19 JST [2012/08/05 0:21:19 ET]
Table 'Whirlpool' 9-max Seat #1 is the button
Seat 1: KINGKILERACE ($20.05 in chips) 
Seat 2: Medic8681 ($12.50 in chips) 
Seat 3: nice.franki ($13.77 in chips) 
Seat 4: Suhoff76 ($25.75 in chips) 
Seat 5: MibNe ($27.29 in chips) 
Seat 6: ShockLaMuc ($26.61 in chips) 
Seat 7: Roglus ($19.59 in chips) 
Seat 8: Th3Fog ($70.21 in chips) 
Seat 9: chiyuki ($38.21 in chips) 
Medic8681: posts small blind $0.10
nice.franki: posts big blind $0.25
*** HOLE CARDS ***
Dealt to chiyuki [Qd 7s]
Suhoff76: folds 
MibNe: folds 
ShockLaMuc: folds 
Roglus: raises $0.50 to $0.75
Th3Fog: folds 
chiyuki: folds 
KINGKILERACE: calls $0.75
Medic8681: calls $0.65
nice.franki: folds 
*** FLOP *** [9s Ah 2c]
Medic8681: checks 
Roglus: checks 
KINGKILERACE: bets $0.50
Medic8681: folds 
Roglus: folds 
Uncalled bet ($0.50) returned to KINGKILERACE
KINGKILERACE collected $2.39 from pot
KINGKILERACE: doesn't show hand 
*** SUMMARY ***
Total pot $2.50 | Rake $0.11 
Board [9s Ah 2c]
Seat 1: KINGKILERACE (button) collected ($2.39)
Seat 2: Medic8681 (small blind) folded on the Flop
Seat 3: nice.franki (big blind) folded before Flop
Seat 4: Suhoff76 folded before Flop (didn't bet)
Seat 5: MibNe folded before Flop (didn't bet)
Seat 6: ShockLaMuc folded before Flop (didn't bet)
Seat 7: Roglus folded on the Flop
Seat 8: Th3Fog folded before Flop (didn't bet)
Seat 9: chiyuki folded before Flop (didn't bet)



PokerStars Zoom Hand #84298561725:  Hold'em No Limit ($0.10/$0.25) - 2012/08/05 13:21:31 JST [2012/08/05 0:21:31 ET]
Table 'Whirlpool' 9-max Seat #1 is the button
Seat 1: Alvinpe85 ($28.04 in chips) 
Seat 2: Th3Fog ($28.72 in chips) 
Seat 3: chiyuki ($38.21 in chips) 
Seat 4: masterkoolb ($13.24 in chips) 
Seat 5: SlimeyGash ($22.31 in chips) 
Seat 6: MibNe ($27.29 in chips) 
Seat 7: wtu1986 ($25.95 in chips) 
Seat 8: gedavaca ($32.47 in chips) 
Seat 9: gunbowler ($99.39 in chips) 
Th3Fog: posts small blind $0.10
chiyuki: posts big blind $0.25
*** HOLE CARDS ***
Dealt to chiyuki [4c 7d]
masterkoolb: folds 
SlimeyGash: folds 
MibNe: folds 
wtu1986: folds 
gedavaca: folds 
gunbowler: raises $0.50 to $0.75
Alvinpe85: folds 
Th3Fog: folds 
chiyuki: folds 
Uncalled bet ($0.50) returned to gunbowler
gunbowler collected $0.60 from pot
gunbowler: doesn't show hand 
*** SUMMARY ***
Total pot $0.60 | Rake $0 
Seat 1: Alvinpe85 (button) folded before Flop (didn't bet)
Seat 2: Th3Fog (small blind) folded before Flop
Seat 3: chiyuki (big blind) folded before Flop
Seat 4: masterkoolb folded before Flop (didn't bet)
Seat 5: SlimeyGash folded before Flop (didn't bet)
Seat 6: MibNe folded before Flop (didn't bet)
Seat 7: wtu1986 folded before Flop (didn't bet)
Seat 8: gedavaca folded before Flop (didn't bet)
Seat 9: gunbowler collected ($0.60)



PokerStars Zoom Hand #84298556964:  Hold'em No Limit ($0.10/$0.25) - 2012/08/05 13:21:14 JST [2012/08/05 0:21:14 ET]
Table 'Whirlpool' 9-max Seat #1 is the button
Seat 1: kkbruins0408 ($10.92 in chips) 
Seat 2: chiyuki ($38.31 in chips) 
Seat 3: ryanjp2323 ($30.67 in chips) 
Seat 4: Suhoff76 ($32.33 in chips) 
Seat 5: TraderYao ($25.12 in chips) 
Seat 6: a_tasmanian ($73.13 in chips) 
Seat 7: fwani ($27.77 in chips) 
Seat 8: wtu1986 ($25.95 in chips) 
Seat 9: NastyMcNast ($26.37 in chips) 
chiyuki: posts small blind $0.10
ryanjp2323: posts big blind $0.25
*** HOLE CARDS ***
Dealt to chiyuki [5d 8d]
Suhoff76: folds 
TraderYao: folds 
a_tasmanian: raises $0.50 to $0.75
fwani: folds 
wtu1986: folds 
NastyMcNast: folds 
kkbruins0408: folds 
chiyuki: folds 
ryanjp2323: raises $1.25 to $2
a_tasmanian: calls $1.25
*** FLOP *** [4d Th Qc]
ryanjp2323: bets $2.25
a_tasmanian: calls $2.25
*** TURN *** [4d Th Qc] [5c]
ryanjp2323: bets $4
a_tasmanian: folds 
Uncalled bet ($4) returned to ryanjp2323
ryanjp2323 collected $8.21 from pot
ryanjp2323: doesn't show hand 
*** SUMMARY ***
Total pot $8.60 | Rake $0.39 
Board [4d Th Qc 5c]
Seat 1: kkbruins0408 (button) folded before Flop (didn't bet)
Seat 2: chiyuki (small blind) folded before Flop
Seat 3: ryanjp2323 (big blind) collected ($8.21)
Seat 4: Suhoff76 folded before Flop (didn't bet)
Seat 5: TraderYao folded before Flop (didn't bet)
Seat 6: a_tasmanian folded on the Turn
Seat 7: fwani folded before Flop (didn't bet)
Seat 8: wtu1986 folded before Flop (didn't bet)
Seat 9: NastyMcNast folded before Flop (didn't bet)



PokerStars Zoom Hand #84298567919:  Hold'em No Limit ($0.10/$0.25) - 2012/08/05 13:21:54 JST [2012/08/05 0:21:54 ET]
Table 'Whirlpool' 9-max Seat #1 is the button
Seat 1: gunbowler ($99.74 in chips) 
Seat 2: DT_Jesus ($13.22 in chips) 
Seat 3: slapshot2011 ($36.69 in chips) 
Seat 4: Loholov ($15.35 in chips) 
Seat 5: chiyuki ($37.96 in chips) 
Seat 6: deadmoneykid ($23.39 in chips) 
Seat 7: hirozo ($25.35 in chips) 
Seat 8: nice.franki ($13.52 in chips) 
Seat 9: Suhoff76 ($25.79 in chips) 
DT_Jesus: posts small blind $0.10
slapshot2011: posts big blind $0.25
*** HOLE CARDS ***
Dealt to chiyuki [5s 2d]
Loholov: folds 
chiyuki: folds 
deadmoneykid: folds 
hirozo: folds 
nice.franki: folds 
Suhoff76: folds 
gunbowler: folds 
DT_Jesus: folds 
Uncalled bet ($0.15) returned to slapshot2011
slapshot2011 collected $0.20 from pot
slapshot2011: doesn't show hand 
*** SUMMARY ***
Total pot $0.20 | Rake $0 
Seat 1: gunbowler (button) folded before Flop (didn't bet)
Seat 2: DT_Jesus (small blind) folded before Flop
Seat 3: slapshot2011 (big blind) collected ($0.20)
Seat 4: Loholov folded before Flop (didn't bet)
Seat 5: chiyuki folded before Flop (didn't bet)
Seat 6: deadmoneykid folded before Flop (didn't bet)
Seat 7: hirozo folded before Flop (didn't bet)
Seat 8: nice.franki folded before Flop (didn't bet)
Seat 9: Suhoff76 folded before Flop (didn't bet)



PokerStars Zoom Hand #84298568988:  Hold'em No Limit ($0.10/$0.25) - 2012/08/05 13:21:58 JST [2012/08/05 0:21:58 ET]
Table 'Whirlpool' 9-max Seat #1 is the button
Seat 1: chiyuki ($37.96 in chips) 
Seat 2: wtu1986 ($24.83 in chips) 
Seat 3: RomarioJa ($7.86 in chips) 
Seat 4: Suhoff76 ($25.79 in chips) 
Seat 5: BlackZafiro ($25.35 in chips) 
Seat 6: Jene4kaBest ($13.53 in chips) 
Seat 7: Roglus ($46.59 in chips) 
Seat 8: fwani ($27.67 in chips) 
Seat 9: DT_Jesus ($13.12 in chips) 
wtu1986: posts small blind $0.10
RomarioJa: posts big blind $0.25
*** HOLE CARDS ***
Dealt to chiyuki [9h 4d]
Suhoff76: raises $0.50 to $0.75
BlackZafiro: folds 
Jene4kaBest: folds 
Roglus: folds 
fwani: folds 
DT_Jesus: calls $0.75
chiyuki: folds 
wtu1986: folds 
RomarioJa: folds 
*** FLOP *** [6c 4c 5d]
Suhoff76: checks 
DT_Jesus: bets $1.77
Suhoff76: folds 
Uncalled bet ($1.77) returned to DT_Jesus
DT_Jesus collected $1.77 from pot
DT_Jesus: doesn't show hand 
*** SUMMARY ***
Total pot $1.85 | Rake $0.08 
Board [6c 4c 5d]
Seat 1: chiyuki (button) folded before Flop (didn't bet)
Seat 2: wtu1986 (small blind) folded before Flop
Seat 3: RomarioJa (big blind) folded before Flop
Seat 4: Suhoff76 folded on the Flop
Seat 5: BlackZafiro folded before Flop (didn't bet)
Seat 6: Jene4kaBest folded before Flop (didn't bet)
Seat 7: Roglus folded before Flop (didn't bet)
Seat 8: fwani folded before Flop (didn't bet)
Seat 9: DT_Jesus collected ($1.77)



PokerStars Zoom Hand #84298572332:  Hold'em No Limit ($0.10/$0.25) - 2012/08/05 13:22:10 JST [2012/08/05 0:22:10 ET]
Table 'Whirlpool' 9-max Seat #1 is the button
Seat 1: gAm813r ($23.82 in chips) 
Seat 2: ryanjp2323 ($34.63 in chips) 
Seat 3: RomarioJa ($11.62 in chips) 
Seat 4: PetitAlejo ($27.55 in chips) 
Seat 5: wtu1986 ($24.75 in chips) 
Seat 6: Zugrug ($39.91 in chips) 
Seat 7: Lasutchik ($27.18 in chips) 
Seat 8: leo2095 ($15.70 in chips) 
Seat 9: chiyuki ($37.96 in chips) 
ryanjp2323: posts small blind $0.10
RomarioJa: posts big blind $0.25
*** HOLE CARDS ***
Dealt to chiyuki [5s Th]
PetitAlejo: folds 
wtu1986: folds 
Zugrug: folds 
Lasutchik: folds 
leo2095: folds 
chiyuki: folds 
gAm813r: raises $0.50 to $0.75
ryanjp2323: folds 
RomarioJa: folds 
Uncalled bet ($0.50) returned to gAm813r
gAm813r collected $0.60 from pot
gAm813r: doesn't show hand 
*** SUMMARY ***
Total pot $0.60 | Rake $0 
Seat 1: gAm813r (button) collected ($0.60)
Seat 2: ryanjp2323 (small blind) folded before Flop
Seat 3: RomarioJa (big blind) folded before Flop
Seat 4: PetitAlejo folded before Flop (didn't bet)
Seat 5: wtu1986 folded before Flop (didn't bet)
Seat 6: Zugrug folded before Flop (didn't bet)
Seat 7: Lasutchik folded before Flop (didn't bet)
Seat 8: leo2095 folded before Flop (didn't bet)
Seat 9: chiyuki folded before Flop (didn't bet)



PokerStars Zoom Hand #84298571265:  Hold'em No Limit ($0.10/$0.25) - 2012/08/05 13:22:06 JST [2012/08/05 0:22:06 ET]
Table 'Whirlpool' 9-max Seat #1 is the button
Seat 1: BlOnDhOlIc ($26.60 in chips) 
Seat 2: leo2095 ($15.80 in chips) 
Seat 3: ll_LaMeR_ll ($25.40 in chips) 
Seat 4: jtedecaliss ($155.89 in chips) 
Seat 5: KeLevro0 ($13.32 in chips) 
Seat 6: Medic8681 ($13.11 in chips) 
Seat 7: chiyuki ($37.96 in chips) 
Seat 8: Suhoff76 ($25.40 in chips) 
Seat 9: fwani ($27.67 in chips) 
leo2095: posts small blind $0.10
ll_LaMeR_ll: posts big blind $0.25
*** HOLE CARDS ***
Dealt to chiyuki [9d 2c]
jtedecaliss: raises $0.50 to $0.75
KeLevro0: raises $2 to $2.75
Medic8681: folds 
chiyuki: folds 
Suhoff76: folds 
fwani: folds 
BlOnDhOlIc: folds 
leo2095: folds 
ll_LaMeR_ll: folds 
jtedecaliss: raises $84.25 to $87
KeLevro0: calls $10.57 and is all-in
Uncalled bet ($73.68) returned to jtedecaliss
*** FLOP *** [4s Ts 5c]
*** TURN *** [4s Ts 5c] [2h]
*** RIVER *** [4s Ts 5c 2h] [4d]
*** SHOW DOWN ***
jtedecaliss: shows [Ks Ac] (a pair of Fours)
KeLevro0: shows [Kh Kc] (two pair, Kings and Fours)
KeLevro0 collected $25.78 from pot
*** SUMMARY ***
Total pot $26.99 | Rake $1.21 
Board [4s Ts 5c 2h 4d]
Seat 1: BlOnDhOlIc (button) folded before Flop (didn't bet)
Seat 2: leo2095 (small blind) folded before Flop
Seat 3: ll_LaMeR_ll (big blind) folded before Flop
Seat 4: jtedecaliss showed [Ks Ac] and lost with a pair of Fours
Seat 5: KeLevro0 showed [Kh Kc] and won ($25.78) with two pair, Kings and Fours
Seat 6: Medic8681 folded before Flop (didn't bet)
Seat 7: chiyuki folded before Flop (didn't bet)
Seat 8: Suhoff76 folded before Flop (didn't bet)
Seat 9: fwani folded before Flop (didn't bet)



PokerStars Zoom Hand #84298574891:  Hold'em No Limit ($0.10/$0.25) - 2012/08/05 13:22:19 JST [2012/08/05 0:22:19 ET]
Table 'Whirlpool' 9-max Seat #1 is the button
Seat 1: DooMSDaY1337 ($57.89 in chips) 
Seat 2: chiyuki ($37.96 in chips) 
Seat 3: RomarioJa ($8.82 in chips) 
Seat 4: agurio ($25 in chips) 
Seat 5: NastyMcNast ($25.17 in chips) 
Seat 6: fwani ($28.32 in chips) 
Seat 7: TraderYao ($27.72 in chips) 
Seat 8: wtu1986 ($24.73 in chips) 
Seat 9: Rodina-Kr ($25.82 in chips) 
chiyuki: posts small blind $0.10
RomarioJa: posts big blind $0.25
*** HOLE CARDS ***
Dealt to chiyuki [Qd 9c]
agurio: folds 
NastyMcNast: folds 
fwani: folds 
TraderYao: folds 
wtu1986: folds 
Rodina-Kr: folds 
DooMSDaY1337: folds 
chiyuki: folds 
Uncalled bet ($0.15) returned to RomarioJa
RomarioJa collected $0.20 from pot
RomarioJa: doesn't show hand 
*** SUMMARY ***
Total pot $0.20 | Rake $0 
Seat 1: DooMSDaY1337 (button) folded before Flop (didn't bet)
Seat 2: chiyuki (small blind) folded before Flop
Seat 3: RomarioJa (big blind) collected ($0.20)
Seat 4: agurio folded before Flop (didn't bet)
Seat 5: NastyMcNast folded before Flop (didn't bet)
Seat 6: fwani folded before Flop (didn't bet)
Seat 7: TraderYao folded before Flop (didn't bet)
Seat 8: wtu1986 folded before Flop (didn't bet)
Seat 9: Rodina-Kr folded before Flop (didn't bet)



PokerStars Zoom Hand #84298574049:  Hold'em No Limit ($0.10/$0.25) - 2012/08/05 13:22:16 JST [2012/08/05 0:22:16 ET]
Table 'Whirlpool' 9-max Seat #1 is the button
Seat 1: wtu1986 ($24.75 in chips) 
Seat 2: BlOnDhOlIc ($25.02 in chips) 
Seat 3: puffy5533 ($15.43 in chips) 
Seat 4: chiyuki ($37.96 in chips) 
Seat 5: nice.franki ($11.10 in chips) 
Seat 6: Loholov ($15 in chips) 
Seat 7: fwani ($25.35 in chips) 
Seat 8: Lasutchik ($27.18 in chips) 
Seat 9: silvno31 ($29.04 in chips) 
BlOnDhOlIc: posts small blind $0.10
puffy5533: posts big blind $0.25
*** HOLE CARDS ***
Dealt to chiyuki [As 2h]
chiyuki: folds 
nice.franki: folds 
Loholov: folds 
fwani: raises $0.35 to $0.60
Lasutchik: folds 
silvno31: folds 
wtu1986: folds 
BlOnDhOlIc: calls $0.50
puffy5533: folds 
*** FLOP *** [Qs Jc Ts]
BlOnDhOlIc: checks 
fwani: bets $1
BlOnDhOlIc: folds 
Uncalled bet ($1) returned to fwani
fwani collected $1.38 from pot
fwani: doesn't show hand 
*** SUMMARY ***
Total pot $1.45 | Rake $0.07 
Board [Qs Jc Ts]
Seat 1: wtu1986 (button) folded before Flop (didn't bet)
Seat 2: BlOnDhOlIc (small blind) folded on the Flop
Seat 3: puffy5533 (big blind) folded before Flop
Seat 4: chiyuki folded before Flop (didn't bet)
Seat 5: nice.franki folded before Flop (didn't bet)
Seat 6: Loholov folded before Flop (didn't bet)
Seat 7: fwani collected ($1.38)
Seat 8: Lasutchik folded before Flop (didn't bet)
Seat 9: silvno31 folded before Flop (didn't bet)



PokerStars Zoom Hand #84298575994:  Hold'em No Limit ($0.10/$0.25) - 2012/08/05 13:22:23 JST [2012/08/05 0:22:23 ET]
Table 'Whirlpool' 9-max Seat #1 is the button
Seat 1: Zugrug ($36.76 in chips) 
Seat 2: agurio ($25 in chips) 
Seat 3: BlackZafiro ($25.25 in chips) 
Seat 4: PetitAlejo ($26.76 in chips) 
Seat 5: softdesign ($55.66 in chips) 
Seat 6: ryanjp2323 ($34.53 in chips) 
Seat 7: chiyuki ($37.86 in chips) 
Seat 8: Suhoff76 ($25.04 in chips) 
Seat 9: BlOnDhOlIc ($26.95 in chips) 
agurio: posts small blind $0.10
BlackZafiro: posts big blind $0.25
*** HOLE CARDS ***
Dealt to chiyuki [Qh 2d]
PetitAlejo: folds 
softdesign: folds 
ryanjp2323: folds 
chiyuki: folds 
Suhoff76: raises $0.50 to $0.75
BlOnDhOlIc: folds 
Zugrug: folds 
agurio: folds 
BlackZafiro: calls $0.50
*** FLOP *** [3h 7s 9h]
BlackZafiro: checks 
Suhoff76: checks 
*** TURN *** [3h 7s 9h] [8c]
BlackZafiro: bets $1.14
Suhoff76: folds 
Uncalled bet ($1.14) returned to BlackZafiro
BlackZafiro collected $1.53 from pot
BlackZafiro: doesn't show hand 
*** SUMMARY ***
Total pot $1.60 | Rake $0.07 
Board [3h 7s 9h 8c]
Seat 1: Zugrug (button) folded before Flop (didn't bet)
Seat 2: agurio (small blind) folded before Flop
Seat 3: BlackZafiro (big blind) collected ($1.53)
Seat 4: PetitAlejo folded before Flop (didn't bet)
Seat 5: softdesign folded before Flop (didn't bet)
Seat 6: ryanjp2323 folded before Flop (didn't bet)
Seat 7: chiyuki folded before Flop (didn't bet)
Seat 8: Suhoff76 folded on the Turn
Seat 9: BlOnDhOlIc folded before Flop (didn't bet)



PokerStars Zoom Hand #84298577712:  Hold'em No Limit ($0.10/$0.25) - 2012/08/05 13:22:29 JST [2012/08/05 0:22:29 ET]
Table 'Whirlpool' 9-max Seat #1 is the button
Seat 1: Loholov ($20.94 in chips) 
Seat 2: Jippyflip ($19.30 in chips) 
Seat 3: chiyuki ($37.86 in chips) 
Seat 4: softdesign ($55.66 in chips) 
Seat 5: Th3Fog ($28.62 in chips) 
Seat 6: seula i ($54.72 in chips) 
Seat 7: 5zzzz33 ($16.64 in chips) 
Seat 8: ryanjp2323 ($34.53 in chips) 
Seat 9: Medic8681 ($14.43 in chips) 
Jippyflip: posts small blind $0.10
chiyuki: posts big blind $0.25
*** HOLE CARDS ***
Dealt to chiyuki [4c 9s]
softdesign: calls $0.25
Th3Fog: folds 
seula i: folds 
5zzzz33: folds 
ryanjp2323: folds 
Medic8681: folds 
Loholov: folds 
Jippyflip: calls $0.15
chiyuki: checks 
*** FLOP *** [2h Kc 9c]
Jippyflip: checks 
chiyuki: checks 
softdesign: bets $1
Jippyflip: folds 
chiyuki: folds 
Uncalled bet ($1) returned to softdesign
softdesign collected $0.72 from pot
softdesign: doesn't show hand 
*** SUMMARY ***
Total pot $0.75 | Rake $0.03 
Board [2h Kc 9c]
Seat 1: Loholov (button) folded before Flop (didn't bet)
Seat 2: Jippyflip (small blind) folded on the Flop
Seat 3: chiyuki (big blind) folded on the Flop
Seat 4: softdesign collected ($0.72)
Seat 5: Th3Fog folded before Flop (didn't bet)
Seat 6: seula i folded before Flop (didn't bet)
Seat 7: 5zzzz33 folded before Flop (didn't bet)
Seat 8: ryanjp2323 folded before Flop (didn't bet)
Seat 9: Medic8681 folded before Flop (didn't bet)



PokerStars Zoom Hand #84298588305:  Hold'em No Limit ($0.10/$0.25) - 2012/08/05 13:23:08 JST [2012/08/05 0:23:08 ET]
Table 'Whirlpool' 9-max Seat #1 is the button
Seat 1: 4ydo yogurt ($11.30 in chips) 
Seat 2: MATT361 ($6.43 in chips) 
Seat 3: DooMSDaY1337 ($29.47 in chips) 
Seat 4: agurio ($25.35 in chips) 
Seat 5: Alvinpe85 ($28.56 in chips) 
Seat 6: chiyuki ($37.61 in chips) 
Seat 7: puffy5533 ($15.18 in chips) 
Seat 8: wtu1986 ($24.73 in chips) 
Seat 9: Jene4kaBest ($13.18 in chips) 
MATT361: posts small blind $0.10
DooMSDaY1337: posts big blind $0.25
*** HOLE CARDS ***
Dealt to chiyuki [2c 6d]
agurio: folds 
Alvinpe85: folds 
chiyuki: folds 
puffy5533: folds 
wtu1986: folds 
Jene4kaBest: raises $0.50 to $0.75
4ydo yogurt: calls $0.75
MATT361: folds 
DooMSDaY1337: folds 
*** FLOP *** [Ks Jh 6h]
Jene4kaBest: bets $1.23
4ydo yogurt: calls $1.23
*** TURN *** [Ks Jh 6h] [4c]
Jene4kaBest: checks 
4ydo yogurt: checks 
*** RIVER *** [Ks Jh 6h 4c] [2h]
Jene4kaBest: bets $1.64
4ydo yogurt: calls $1.64
*** SHOW DOWN ***
Jene4kaBest: shows [Jd As] (a pair of Jacks)
4ydo yogurt: mucks hand 
Jene4kaBest collected $7.25 from pot
*** SUMMARY ***
Total pot $7.59 | Rake $0.34 
Board [Ks Jh 6h 4c 2h]
Seat 1: 4ydo yogurt (button) mucked [7c Jc]
Seat 2: MATT361 (small blind) folded before Flop
Seat 3: DooMSDaY1337 (big blind) folded before Flop
Seat 4: agurio folded before Flop (didn't bet)
Seat 5: Alvinpe85 folded before Flop (didn't bet)
Seat 6: chiyuki folded before Flop (didn't bet)
Seat 7: puffy5533 folded before Flop (didn't bet)
Seat 8: wtu1986 folded before Flop (didn't bet)
Seat 9: Jene4kaBest showed [Jd As] and won ($7.25) with a pair of Jacks



PokerStars Zoom Hand #84298586589:  Hold'em No Limit ($0.10/$0.25) - 2012/08/05 13:23:02 JST [2012/08/05 0:23:02 ET]
Table 'Whirlpool' 9-max Seat #1 is the button
Seat 1: Jene4kaBest ($13.18 in chips) 
Seat 2: Th3Fog ($56.48 in chips) 
Seat 3: ShockLaMuc ($22.83 in chips) 
Seat 4: Medic8681 ($14.43 in chips) 
Seat 5: Suhoff76 ($25 in chips) 
Seat 6: hirozo ($25 in chips) 
Seat 7: DooMSDaY1337 ($29.47 in chips) 
Seat 8: chiyuki ($37.61 in chips) 
Seat 9: PetitAlejo ($26.70 in chips) 
Th3Fog: posts small blind $0.10
ShockLaMuc: posts big blind $0.25
*** HOLE CARDS ***
Dealt to chiyuki [8d 4s]
Medic8681: folds 
Suhoff76: folds 
hirozo: folds 
DooMSDaY1337: folds 
chiyuki: folds 
PetitAlejo: folds 
Jene4kaBest: folds 
Th3Fog: raises $0.35 to $0.60
ShockLaMuc: calls $0.35
*** FLOP *** [9d As 8c]
Th3Fog: bets $0.67
ShockLaMuc: calls $0.67
*** TURN *** [9d As 8c] [9h]
Th3Fog: checks 
ShockLaMuc: bets $1.25
Th3Fog: folds 
Uncalled bet ($1.25) returned to ShockLaMuc
ShockLaMuc collected $2.43 from pot
ShockLaMuc: doesn't show hand 
*** SUMMARY ***
Total pot $2.54 | Rake $0.11 
Board [9d As 8c 9h]
Seat 1: Jene4kaBest (button) folded before Flop (didn't bet)
Seat 2: Th3Fog (small blind) folded on the Turn
Seat 3: ShockLaMuc (big blind) collected ($2.43)
Seat 4: Medic8681 folded before Flop (didn't bet)
Seat 5: Suhoff76 folded before Flop (didn't bet)
Seat 6: hirozo folded before Flop (didn't bet)
Seat 7: DooMSDaY1337 folded before Flop (didn't bet)
Seat 8: chiyuki folded before Flop (didn't bet)
Seat 9: PetitAlejo folded before Flop (didn't bet)



PokerStars Zoom Hand #84298589156:  Hold'em No Limit ($0.10/$0.25) - 2012/08/05 13:23:11 JST [2012/08/05 0:23:11 ET]
Table 'Whirlpool' 9-max Seat #1 is the button
Seat 1: chiyuki ($37.61 in chips) 
Seat 2: SlimeyGash ($22.76 in chips) 
Seat 3: goldstone ($26.21 in chips) 
Seat 4: fwani ($26.13 in chips) 
Seat 5: munky3 ($5.86 in chips) 
Seat 6: Suhoff76 ($30.98 in chips) 
Seat 7: Th3Fog ($69.36 in chips) 
Seat 8: PetitAlejo ($25 in chips) 
Seat 9: masterkoolb ($12.50 in chips) 
SlimeyGash: posts small blind $0.10
goldstone: posts big blind $0.25
*** HOLE CARDS ***
Dealt to chiyuki [Th 7h]
fwani: folds 
munky3: folds 
Suhoff76: raises $0.50 to $0.75
Th3Fog: folds 
PetitAlejo: folds 
masterkoolb: calls $0.75
chiyuki: folds 
SlimeyGash: folds 
goldstone: calls $0.50
*** FLOP *** [Js Kh 3d]
goldstone: checks 
Suhoff76: bets $1.47
masterkoolb: folds 
goldstone: folds 
Uncalled bet ($1.47) returned to Suhoff76
Suhoff76 collected $2.24 from pot
Suhoff76: doesn't show hand 
*** SUMMARY ***
Total pot $2.35 | Rake $0.11 
Board [Js Kh 3d]
Seat 1: chiyuki (button) folded before Flop (didn't bet)
Seat 2: SlimeyGash (small blind) folded before Flop
Seat 3: goldstone (big blind) folded on the Flop
Seat 4: fwani folded before Flop (didn't bet)
Seat 5: munky3 folded before Flop (didn't bet)
Seat 6: Suhoff76 collected ($2.24)
Seat 7: Th3Fog folded before Flop (didn't bet)
Seat 8: PetitAlejo folded before Flop (didn't bet)
Seat 9: masterkoolb folded on the Flop



PokerStars Zoom Hand #84298593646:  Hold'em No Limit ($0.10/$0.25) - 2012/08/05 13:23:27 JST [2012/08/05 0:23:27 ET]
Table 'Whirlpool' 9-max Seat #1 is the button
Seat 1: polk11 ($20.25 in chips) 
Seat 2: Medic8681 ($14.18 in chips) 
Seat 3: RomarioJa ($8.82 in chips) 
Seat 4: chiyuki ($37.61 in chips) 
Seat 5: cR!Ma*aRm ($13.25 in chips) 
Seat 6: seula i ($25 in chips) 
Seat 7: Zugrug ($34.26 in chips) 
Seat 8: SlimeyGash ($22.66 in chips) 
Seat 9: Suhoff76 ($25 in chips) 
Medic8681: posts small blind $0.10
RomarioJa: posts big blind $0.25
*** HOLE CARDS ***
Dealt to chiyuki [5d 4d]
chiyuki: folds 
cR!Ma*aRm: folds 
seula i: folds 
Zugrug: folds 
SlimeyGash: folds 
Suhoff76: folds 
polk11: raises $0.25 to $0.50
Medic8681: folds 
RomarioJa: folds 
Uncalled bet ($0.25) returned to polk11
polk11 collected $0.60 from pot
polk11: doesn't show hand 
*** SUMMARY ***
Total pot $0.60 | Rake $0 
Seat 1: polk11 (button) collected ($0.60)
Seat 2: Medic8681 (small blind) folded before Flop
Seat 3: RomarioJa (big blind) folded before Flop
Seat 4: chiyuki folded before Flop (didn't bet)
Seat 5: cR!Ma*aRm folded before Flop (didn't bet)
Seat 6: seula i folded before Flop (didn't bet)
Seat 7: Zugrug folded before Flop (didn't bet)
Seat 8: SlimeyGash folded before Flop (didn't bet)
Seat 9: Suhoff76 folded before Flop (didn't bet)



PokerStars Zoom Hand #84298600277:  Hold'em No Limit ($0.10/$0.25) - 2012/08/05 13:23:51 JST [2012/08/05 0:23:51 ET]
Table 'Whirlpool' 9-max Seat #1 is the button
Seat 1: Lasutchik ($27.28 in chips) 
Seat 2: fwani ($27.82 in chips) 
Seat 3: PetitAlejo ($25 in chips) 
Seat 4: KeLevro0 ($40.38 in chips) 
Seat 5: Loholov ($15 in chips) 
Seat 6: Alvinpe85 ($28.83 in chips) 
Seat 7: Zugrug ($39.91 in chips) 
Seat 8: chiyuki ($37.51 in chips) 
Seat 9: softdesign ($55.26 in chips) 
fwani: posts small blind $0.10
PetitAlejo: posts big blind $0.25
*** HOLE CARDS ***
Dealt to chiyuki [6s Jh]
KeLevro0: folds 
Loholov: folds 
Alvinpe85: folds 
Zugrug: folds 
chiyuki: folds 
softdesign: folds 
Lasutchik: folds 
fwani: raises $0.35 to $0.60
PetitAlejo: folds 
Uncalled bet ($0.35) returned to fwani
fwani collected $0.50 from pot
fwani: doesn't show hand 
*** SUMMARY ***
Total pot $0.50 | Rake $0 
Seat 1: Lasutchik (button) folded before Flop (didn't bet)
Seat 2: fwani (small blind) collected ($0.50)
Seat 3: PetitAlejo (big blind) folded before Flop
Seat 4: KeLevro0 folded before Flop (didn't bet)
Seat 5: Loholov folded before Flop (didn't bet)
Seat 6: Alvinpe85 folded before Flop (didn't bet)
Seat 7: Zugrug folded before Flop (didn't bet)
Seat 8: chiyuki folded before Flop (didn't bet)
Seat 9: softdesign folded before Flop (didn't bet)



PokerStars Zoom Hand #84298594732:  Hold'em No Limit ($0.10/$0.25) - 2012/08/05 13:23:31 JST [2012/08/05 0:23:31 ET]
Table 'Whirlpool' 9-max Seat #1 is the button
Seat 1: TraderYao ($27.27 in chips) 
Seat 2: slickthis ($35.33 in chips) 
Seat 3: Alvinpe85 ($28.56 in chips) 
Seat 4: Loholov ($15 in chips) 
Seat 5: cR!Ma*aRm ($13.25 in chips) 
Seat 6: Zugrug ($34.26 in chips) 
Seat 7: Suhoff76 ($25 in chips) 
Seat 8: KeLevro0 ($13.07 in chips) 
Seat 9: chiyuki ($37.61 in chips) 
slickthis: posts small blind $0.10
Alvinpe85: posts big blind $0.25
*** HOLE CARDS ***
Dealt to chiyuki [3d Kc]
Loholov said, "ebuchiy room"
Loholov said, "FUCCKK DONKEY SITE"
Loholov: folds 
cR!Ma*aRm: folds 
Zugrug: folds 
Suhoff76: folds 
KeLevro0: folds 
chiyuki: folds 
TraderYao: raises $0.37 to $0.62
slickthis: calls $0.52
Alvinpe85: folds 
*** FLOP *** [Kd 7s 4h]
slickthis: checks 
TraderYao: bets $0.88
slickthis: folds 
Uncalled bet ($0.88) returned to TraderYao
TraderYao collected $1.42 from pot
TraderYao: doesn't show hand 
*** SUMMARY ***
Total pot $1.49 | Rake $0.07 
Board [Kd 7s 4h]
Seat 1: TraderYao (button) collected ($1.42)
Seat 2: slickthis (small blind) folded on the Flop
Seat 3: Alvinpe85 (big blind) folded before Flop
Seat 4: Loholov folded before Flop (didn't bet)
Seat 5: cR!Ma*aRm folded before Flop (didn't bet)
Seat 6: Zugrug folded before Flop (didn't bet)
Seat 7: Suhoff76 folded before Flop (didn't bet)
Seat 8: KeLevro0 folded before Flop (didn't bet)
Seat 9: chiyuki folded before Flop (didn't bet)



PokerStars Zoom Hand #84298599476:  Hold'em No Limit ($0.10/$0.25) - 2012/08/05 13:23:48 JST [2012/08/05 0:23:48 ET]
Table 'Whirlpool' 9-max Seat #1 is the button
Seat 1: Medic8681 ($13.01 in chips) 
Seat 2: nice.franki ($13.17 in chips) 
Seat 3: MibNe ($23.92 in chips) 
Seat 4: hirozo ($27.67 in chips) 
Seat 5: chiyuki ($37.51 in chips) 
Seat 6: Jene4kaBest ($16.81 in chips) 
Seat 7: RomarioJa ($7.26 in chips) 
Seat 8: deadmoneykid ($26.55 in chips) 
Seat 9: Suhoff76 ($25.97 in chips) 
nice.franki: posts small blind $0.10
MibNe: posts big blind $0.25
*** HOLE CARDS ***
Dealt to chiyuki [2h As]
hirozo: folds 
chiyuki: folds 
Jene4kaBest: folds 
RomarioJa: folds 
deadmoneykid: folds 
Suhoff76: folds 
Medic8681: raises $0.50 to $0.75
nice.franki: folds 
MibNe: folds 
Uncalled bet ($0.50) returned to Medic8681
Medic8681 collected $0.60 from pot
Medic8681: doesn't show hand 
*** SUMMARY ***
Total pot $0.60 | Rake $0 
Seat 1: Medic8681 (button) collected ($0.60)
Seat 2: nice.franki (small blind) folded before Flop
Seat 3: MibNe (big blind) folded before Flop
Seat 4: hirozo folded before Flop (didn't bet)
Seat 5: chiyuki folded before Flop (didn't bet)
Seat 6: Jene4kaBest folded before Flop (didn't bet)
Seat 7: RomarioJa folded before Flop (didn't bet)
Seat 8: deadmoneykid folded before Flop (didn't bet)
Seat 9: Suhoff76 folded before Flop (didn't bet)



PokerStars Zoom Hand #84298595491:  Hold'em No Limit ($0.10/$0.25) - 2012/08/05 13:23:34 JST [2012/08/05 0:23:34 ET]
Table 'Whirlpool' 9-max Seat #1 is the button
Seat 1: gedavaca ($36.11 in chips) 
Seat 2: DT_Jesus ($13.14 in chips) 
Seat 3: deadmoneykid ($25 in chips) 
Seat 4: Lasutchik ($7.71 in chips) 
Seat 5: chiyuki ($37.61 in chips) 
Seat 6: PetitAlejo ($25 in chips) 
Seat 7: wtu1986 ($26.15 in chips) 
Seat 8: NastyMcNast ($25 in chips) 
Seat 9: petersmiths ($32.78 in chips) 
DT_Jesus: posts small blind $0.10
deadmoneykid: posts big blind $0.25
*** HOLE CARDS ***
Dealt to chiyuki [2c 2s]
Lasutchik: folds 
chiyuki: folds 
PetitAlejo: raises $0.50 to $0.75
wtu1986: folds 
NastyMcNast: folds 
petersmiths: calls $0.75
gedavaca: folds 
DT_Jesus: calls $0.65
deadmoneykid: calls $0.50
*** FLOP *** [5s Ts Tc]
DT_Jesus: bets $2.86
deadmoneykid: raises $3.64 to $6.50
PetitAlejo: folds 
petersmiths: folds 
DT_Jesus: calls $3.64
*** TURN *** [5s Ts Tc] [5c]
DT_Jesus: bets $5.89 and is all-in
deadmoneykid: calls $5.89
*** RIVER *** [5s Ts Tc 5c] [Jh]
*** SHOW DOWN ***
DT_Jesus: shows [As 9s] (two pair, Tens and Fives)
deadmoneykid: shows [Td 8s] (a full house, Tens full of Fives)
deadmoneykid collected $26.53 from pot
*** SUMMARY ***
Total pot $27.78 | Rake $1.25 
Board [5s Ts Tc 5c Jh]
Seat 1: gedavaca (button) folded before Flop (didn't bet)
Seat 2: DT_Jesus (small blind) showed [As 9s] and lost with two pair, Tens and Fives
Seat 3: deadmoneykid (big blind) showed [Td 8s] and won ($26.53) with a full house, Tens full of Fives
Seat 4: Lasutchik folded before Flop (didn't bet)
Seat 5: chiyuki folded before Flop (didn't bet)
Seat 6: PetitAlejo folded on the Flop
Seat 7: wtu1986 folded before Flop (didn't bet)
Seat 8: NastyMcNast folded before Flop (didn't bet)
Seat 9: petersmiths folded on the Flop



PokerStars Zoom Hand #84298601117:  Hold'em No Limit ($0.10/$0.25) - 2012/08/05 13:23:54 JST [2012/08/05 0:23:54 ET]
Table 'Whirlpool' 9-max Seat #1 is the button
Seat 1: Medic8681 ($14.08 in chips) 
Seat 2: hirozo ($25 in chips) 
Seat 3: chiyuki ($37.51 in chips) 
Seat 4: RomarioJa ($7.26 in chips) 
Seat 5: nice.franki ($6.42 in chips) 
Seat 6: Zugrug ($34.57 in chips) 
Seat 7: 5zzzz33 ($14.74 in chips) 
Seat 8: 4ydo yogurt ($8.03 in chips) 
Seat 9: MATT361 ($5.46 in chips) 
hirozo: posts small blind $0.10
chiyuki: posts big blind $0.25
*** HOLE CARDS ***
Dealt to chiyuki [2d Ac]
RomarioJa: folds 
nice.franki: folds 
Zugrug: folds 
5zzzz33: folds 
4ydo yogurt: folds 
MATT361: folds 
Medic8681: folds 
hirozo: raises $0.25 to $0.50
chiyuki: calls $0.25
*** FLOP *** [5s Jd 4d]
hirozo: checks 
chiyuki: checks 
*** TURN *** [5s Jd 4d] [9d]
hirozo: checks 
chiyuki: checks 
*** RIVER *** [5s Jd 4d 9d] [Ah]
hirozo: bets $0.64
chiyuki: calls $0.64
*** SHOW DOWN ***
hirozo: shows [5d 9s] (two pair, Nines and Fives)
chiyuki: mucks hand 
hirozo collected $2.18 from pot
*** SUMMARY ***
Total pot $2.28 | Rake $0.10 
Board [5s Jd 4d 9d Ah]
Seat 1: Medic8681 (button) folded before Flop (didn't bet)
Seat 2: hirozo (small blind) showed [5d 9s] and won ($2.18) with two pair, Nines and Fives
Seat 3: chiyuki (big blind) mucked [2d Ac]
Seat 4: RomarioJa folded before Flop (didn't bet)
Seat 5: nice.franki folded before Flop (didn't bet)
Seat 6: Zugrug folded before Flop (didn't bet)
Seat 7: 5zzzz33 folded before Flop (didn't bet)
Seat 8: 4ydo yogurt folded before Flop (didn't bet)
Seat 9: MATT361 folded before Flop (didn't bet)



PokerStars Zoom Hand #84298596598:  Hold'em No Limit ($0.10/$0.25) - 2012/08/05 13:23:38 JST [2012/08/05 0:23:38 ET]
Table 'Whirlpool' 9-max Seat #1 is the button
Seat 1: hirozo ($25 in chips) 
Seat 2: chiyuki ($37.61 in chips) 
Seat 3: DooMSDaY1337 ($25 in chips) 
Seat 4: Medic8681 ($13.74 in chips) 
Seat 5: puffy5533 ($15.08 in chips) 
Seat 6: Th3Fog ($55.21 in chips) 
Seat 7: NastyMcNast ($25 in chips) 
Seat 8: BlackZafiro ($26.59 in chips) 
Seat 9: RomarioJa ($9.05 in chips) 
chiyuki: posts small blind $0.10
DooMSDaY1337: posts big blind $0.25
*** HOLE CARDS ***
Dealt to chiyuki [7d 3s]
Medic8681: folds 
puffy5533: folds 
Th3Fog: raises $0.35 to $0.60
NastyMcNast: calls $0.60
BlackZafiro: folds 
RomarioJa: folds 
hirozo: folds 
chiyuki: folds 
DooMSDaY1337: calls $0.35
*** FLOP *** [Jd 9h 7s]
DooMSDaY1337: checks 
Th3Fog: bets $1.06
NastyMcNast: calls $1.06
DooMSDaY1337: calls $1.06
*** TURN *** [Jd 9h 7s] [9s]
DooMSDaY1337: checks 
Th3Fog: checks 
NastyMcNast: bets $3.39
DooMSDaY1337: folds 
Th3Fog: calls $3.39
*** RIVER *** [Jd 9h 7s 9s] [2c]
Th3Fog: checks 
NastyMcNast: bets $7.93
Th3Fog: calls $7.93
*** SHOW DOWN ***
NastyMcNast: shows [9d Td] (three of a kind, Nines)
Th3Fog: mucks hand 
NastyMcNast collected $26.47 from pot
*** SUMMARY ***
Total pot $27.72 | Rake $1.25 
Board [Jd 9h 7s 9s 2c]
Seat 1: hirozo (button) folded before Flop (didn't bet)
Seat 2: chiyuki (small blind) folded before Flop
Seat 3: DooMSDaY1337 (big blind) folded on the Turn
Seat 4: Medic8681 folded before Flop (didn't bet)
Seat 5: puffy5533 folded before Flop (didn't bet)
Seat 6: Th3Fog mucked [Js Ah]
Seat 7: NastyMcNast showed [9d Td] and won ($26.47) with three of a kind, Nines
Seat 8: BlackZafiro folded before Flop (didn't bet)
Seat 9: RomarioJa folded before Flop (didn't bet)



PokerStars Zoom Hand #84298616285:  Hold'em No Limit ($0.10/$0.25) - 2012/08/05 13:24:50 JST [2012/08/05 0:24:50 ET]
Table 'Whirlpool' 9-max Seat #1 is the button
Seat 1: jtedecaliss ($146.04 in chips) 
Seat 2: Suhoff76 ($26.07 in chips) 
Seat 3: TErr18 ($28.55 in chips) 
Seat 4: TraderYao ($27.82 in chips) 
Seat 5: BlackZafiro ($25 in chips) 
Seat 6: DooMSDaY1337 ($95.11 in chips) 
Seat 7: chiyuki ($36.37 in chips) 
Seat 8: PetitAlejo ($25.92 in chips) 
Seat 9: Lasutchik ($27.18 in chips) 
Suhoff76: posts small blind $0.10
TErr18: posts big blind $0.25
*** HOLE CARDS ***
Dealt to chiyuki [2d 3d]
TraderYao: folds 
BlackZafiro: folds 
DooMSDaY1337: folds 
chiyuki: folds 
PetitAlejo: folds 
Lasutchik: folds 
jtedecaliss: folds 
Suhoff76: folds 
Uncalled bet ($0.15) returned to TErr18
TErr18 collected $0.20 from pot
TErr18: doesn't show hand 
*** SUMMARY ***
Total pot $0.20 | Rake $0 
Seat 1: jtedecaliss (button) folded before Flop (didn't bet)
Seat 2: Suhoff76 (small blind) folded before Flop
Seat 3: TErr18 (big blind) collected ($0.20)
Seat 4: TraderYao folded before Flop (didn't bet)
Seat 5: BlackZafiro folded before Flop (didn't bet)
Seat 6: DooMSDaY1337 folded before Flop (didn't bet)
Seat 7: chiyuki folded before Flop (didn't bet)
Seat 8: PetitAlejo folded before Flop (didn't bet)
Seat 9: Lasutchik folded before Flop (didn't bet)



PokerStars Zoom Hand #84298623292:  Hold'em No Limit ($0.10/$0.25) - 2012/08/05 13:25:15 JST [2012/08/05 0:25:15 ET]
Table 'Whirlpool' 9-max Seat #1 is the button
Seat 1: BlOnDhOlIc ($30.13 in chips) 
Seat 2: TraderYao ($31.34 in chips) 
Seat 3: 5zzzz33 ($14.64 in chips) 
Seat 4: Zugrug ($39.06 in chips) 
Seat 5: vit 111 ($37.12 in chips) 
Seat 6: MATT361 ($4.36 in chips) 
Seat 7: TErr18 ($28.55 in chips) 
Seat 8: Loholov ($15 in chips) 
Seat 9: chiyuki ($36.37 in chips) 
TraderYao: posts small blind $0.10
5zzzz33: posts big blind $0.25
*** HOLE CARDS ***
Dealt to chiyuki [Qh Jh]
Zugrug: folds 
vit 111: folds 
MATT361: folds 
TErr18: folds 
Loholov: folds 
chiyuki: raises $0.50 to $0.75
BlOnDhOlIc: folds 
TraderYao: folds 
5zzzz33: folds 
Uncalled bet ($0.50) returned to chiyuki
chiyuki collected $0.60 from pot
chiyuki: doesn't show hand 
*** SUMMARY ***
Total pot $0.60 | Rake $0 
Seat 1: BlOnDhOlIc (button) folded before Flop (didn't bet)
Seat 2: TraderYao (small blind) folded before Flop
Seat 3: 5zzzz33 (big blind) folded before Flop
Seat 4: Zugrug folded before Flop (didn't bet)
Seat 5: vit 111 folded before Flop (didn't bet)
Seat 6: MATT361 folded before Flop (didn't bet)
Seat 7: TErr18 folded before Flop (didn't bet)
Seat 8: Loholov folded before Flop (didn't bet)
Seat 9: chiyuki collected ($0.60)



PokerStars Zoom Hand #84298621310:  Hold'em No Limit ($0.10/$0.25) - 2012/08/05 13:25:08 JST [2012/08/05 0:25:08 ET]
Table 'Whirlpool' 9-max Seat #1 is the button
Seat 1: chiyuki ($36.37 in chips) 
Seat 2: polk11 ($20.70 in chips) 
Seat 3: Roglus ($17 in chips) 
Seat 4: jtedecaliss ($146.04 in chips) 
Seat 5: Lasutchik ($7.11 in chips) 
Seat 6: RomarioJa ($6.91 in chips) 
Seat 7: TraderYao ($25 in chips) 
Seat 8: D@vidMed ($40.53 in chips) 
Seat 9: SlimeyGash ($22.63 in chips) 
polk11: posts small blind $0.10
Roglus: posts big blind $0.25
*** HOLE CARDS ***
Dealt to chiyuki [7h Ks]
jtedecaliss: folds 
Lasutchik: folds 
RomarioJa: raises $0.37 to $0.62
TraderYao: folds 
D@vidMed: folds 
SlimeyGash: folds 
chiyuki: folds 
polk11: folds 
Roglus: folds 
Uncalled bet ($0.37) returned to RomarioJa
RomarioJa collected $0.60 from pot
RomarioJa: doesn't show hand 
*** SUMMARY ***
Total pot $0.60 | Rake $0 
Seat 1: chiyuki (button) folded before Flop (didn't bet)
Seat 2: polk11 (small blind) folded before Flop
Seat 3: Roglus (big blind) folded before Flop
Seat 4: jtedecaliss folded before Flop (didn't bet)
Seat 5: Lasutchik folded before Flop (didn't bet)
Seat 6: RomarioJa collected ($0.60)
Seat 7: TraderYao folded before Flop (didn't bet)
Seat 8: D@vidMed folded before Flop (didn't bet)
Seat 9: SlimeyGash folded before Flop (didn't bet)



PokerStars Zoom Hand #84298617408:  Hold'em No Limit ($0.10/$0.25) - 2012/08/05 13:24:54 JST [2012/08/05 0:24:54 ET]
Table 'Whirlpool' 9-max Seat #1 is the button
Seat 1: D@vidMed ($40.53 in chips) 
Seat 2: Medic8681 ($14.08 in chips) 
Seat 3: masterkoolb ($12.50 in chips) 
Seat 4: fwani ($25.78 in chips) 
Seat 5: leo2095 ($16.25 in chips) 
Seat 6: chiyuki ($36.37 in chips) 
Seat 7: PetitAlejo ($25.92 in chips) 
Seat 8: hirozo ($25 in chips) 
Seat 9: BlOnDhOlIc ($32.24 in chips) 
Medic8681: posts small blind $0.10
masterkoolb: posts big blind $0.25
*** HOLE CARDS ***
Dealt to chiyuki [2h 9s]
fwani: folds 
leo2095: calls $0.25
chiyuki: folds 
PetitAlejo: folds 
hirozo: folds 
BlOnDhOlIc: folds 
D@vidMed: folds 
Medic8681: raises $0.75 to $1
masterkoolb: raises $2.25 to $3.25
leo2095: folds 
Medic8681: calls $2.25
*** FLOP *** [2c As 7s]
Medic8681: bets $4.25
masterkoolb: folds 
Uncalled bet ($4.25) returned to Medic8681
Medic8681 collected $6.45 from pot
Medic8681: doesn't show hand 
*** SUMMARY ***
Total pot $6.75 | Rake $0.30 
Board [2c As 7s]
Seat 1: D@vidMed (button) folded before Flop (didn't bet)
Seat 2: Medic8681 (small blind) collected ($6.45)
Seat 3: masterkoolb (big blind) folded on the Flop
Seat 4: fwani folded before Flop (didn't bet)
Seat 5: leo2095 folded before Flop
Seat 6: chiyuki folded before Flop (didn't bet)
Seat 7: PetitAlejo folded before Flop (didn't bet)
Seat 8: hirozo folded before Flop (didn't bet)
Seat 9: BlOnDhOlIc folded before Flop (didn't bet)



PokerStars Zoom Hand #84298626862:  Hold'em No Limit ($0.10/$0.25) - 2012/08/05 13:25:29 JST [2012/08/05 0:25:29 ET]
Table 'Whirlpool' 9-max Seat #1 is the button
Seat 1: Loholov ($16.62 in chips) 
Seat 2: Roglus ($16.75 in chips) 
Seat 3: Landybob ($25 in chips) 
Seat 4: NastyMcNast ($47.21 in chips) 
Seat 5: agurio ($25 in chips) 
Seat 6: chiyuki ($36.72 in chips) 
Seat 7: leo2095 ($16.10 in chips) 
Seat 8: DooMSDaY1337 ($94.26 in chips) 
Seat 9: Th3Fog ($27.32 in chips) 
Roglus: posts small blind $0.10
Landybob: posts big blind $0.25
*** HOLE CARDS ***
Dealt to chiyuki [8h 8s]
NastyMcNast: folds 
agurio: folds 
chiyuki: raises $0.50 to $0.75
leo2095: folds 
DooMSDaY1337: folds 
Th3Fog: folds 
Loholov: calls $0.75
Roglus: folds 
Landybob: folds 
*** FLOP *** [6h Qh Jd]
chiyuki: checks 
Loholov: checks 
*** TURN *** [6h Qh Jd] [4h]
chiyuki: checks 
Loholov: checks 
*** RIVER *** [6h Qh Jd 4h] [Ts]
chiyuki: checks 
Loholov: checks 
*** SHOW DOWN ***
chiyuki: shows [8h 8s] (a pair of Eights)
Loholov: shows [Jc Tc] (two pair, Jacks and Tens)
Loholov collected $1.77 from pot
*** SUMMARY ***
Total pot $1.85 | Rake $0.08 
Board [6h Qh Jd 4h Ts]
Seat 1: Loholov (button) showed [Jc Tc] and won ($1.77) with two pair, Jacks and Tens
Seat 2: Roglus (small blind) folded before Flop
Seat 3: Landybob (big blind) folded before Flop
Seat 4: NastyMcNast folded before Flop (didn't bet)
Seat 5: agurio folded before Flop (didn't bet)
Seat 6: chiyuki showed [8h 8s] and lost with a pair of Eights
Seat 7: leo2095 folded before Flop (didn't bet)
Seat 8: DooMSDaY1337 folded before Flop (didn't bet)
Seat 9: Th3Fog folded before Flop (didn't bet)



PokerStars Zoom Hand #84298638367:  Hold'em No Limit ($0.10/$0.25) - 2012/08/05 13:26:11 JST [2012/08/05 0:26:11 ET]
Table 'Whirlpool' 9-max Seat #1 is the button
Seat 1: simonzez ($63.77 in chips) 
Seat 2: chiyuki ($35.97 in chips) 
Seat 3: Th3Fog ($43.57 in chips) 
Seat 4: RomarioJa ($7.71 in chips) 
Seat 5: Suhoff76 ($31.82 in chips) 
Seat 6: BlackZafiro ($25 in chips) 
Seat 7: Alvinpe85 ($29.75 in chips) 
Seat 8: 5zzzz33 ($14.29 in chips) 
Seat 9: gunbowler ($97.45 in chips) 
chiyuki: posts small blind $0.10
Th3Fog: posts big blind $0.25
*** HOLE CARDS ***
Dealt to chiyuki [5d Kh]
RomarioJa: folds 
Suhoff76: folds 
BlackZafiro: folds 
Alvinpe85: raises $0.50 to $0.75
5zzzz33: folds 
gunbowler: folds 
simonzez: folds 
chiyuki: folds 
Th3Fog: folds 
Uncalled bet ($0.50) returned to Alvinpe85
Alvinpe85 collected $0.60 from pot
Alvinpe85: doesn't show hand 
*** SUMMARY ***
Total pot $0.60 | Rake $0 
Seat 1: simonzez (button) folded before Flop (didn't bet)
Seat 2: chiyuki (small blind) folded before Flop
Seat 3: Th3Fog (big blind) folded before Flop
Seat 4: RomarioJa folded before Flop (didn't bet)
Seat 5: Suhoff76 folded before Flop (didn't bet)
Seat 6: BlackZafiro folded before Flop (didn't bet)
Seat 7: Alvinpe85 collected ($0.60)
Seat 8: 5zzzz33 folded before Flop (didn't bet)
Seat 9: gunbowler folded before Flop (didn't bet)



PokerStars Zoom Hand #84298640571:  Hold'em No Limit ($0.10/$0.25) - 2012/08/05 13:26:19 JST [2012/08/05 0:26:19 ET]
Table 'Whirlpool' 9-max Seat #1 is the button
Seat 1: RomarioJa ($7.71 in chips) 
Seat 2: Lasutchik ($25.61 in chips) 
Seat 3: chiyuki ($35.87 in chips) 
Seat 4: fwani ($35.15 in chips) 
Seat 5: ShockLaMuc ($36.60 in chips) 
Seat 6: KeLevro0 ($9.99 in chips) 
Seat 7: Jippyflip ($18.10 in chips) 
Seat 8: TErr18 ($28.20 in chips) 
Seat 9: Loholov ($15 in chips) 
Lasutchik: posts small blind $0.10
chiyuki: posts big blind $0.25
*** HOLE CARDS ***
Dealt to chiyuki [3d 5h]
fwani: folds 
ShockLaMuc: folds 
KeLevro0: folds 
Jippyflip: folds 
TErr18: folds 
Loholov: folds 
RomarioJa: raises $0.37 to $0.62
Lasutchik: folds 
chiyuki: folds 
Uncalled bet ($0.37) returned to RomarioJa
RomarioJa collected $0.60 from pot
RomarioJa: doesn't show hand 
*** SUMMARY ***
Total pot $0.60 | Rake $0 
Seat 1: RomarioJa (button) collected ($0.60)
Seat 2: Lasutchik (small blind) folded before Flop
Seat 3: chiyuki (big blind) folded before Flop
Seat 4: fwani folded before Flop (didn't bet)
Seat 5: ShockLaMuc folded before Flop (didn't bet)
Seat 6: KeLevro0 folded before Flop (didn't bet)
Seat 7: Jippyflip folded before Flop (didn't bet)
Seat 8: TErr18 folded before Flop (didn't bet)
Seat 9: Loholov folded before Flop (didn't bet)



PokerStars Zoom Hand #84298636458:  Hold'em No Limit ($0.10/$0.25) - 2012/08/05 13:26:04 JST [2012/08/05 0:26:04 ET]
Table 'Whirlpool' 9-max Seat #1 is the button
Seat 1: 4ydo yogurt ($8.18 in chips) 
Seat 2: Zugrug ($39.16 in chips) 
Seat 3: Medic8681 ($17.63 in chips) 
Seat 4: RomarioJa ($8.60 in chips) 
Seat 5: Loholov ($17.64 in chips) 
Seat 6: BlOnDhOlIc ($28.13 in chips) 
Seat 7: NastyMcNast ($37.75 in chips) 
Seat 8: chiyuki ($35.97 in chips) 
Seat 9: nice.franki ($3.82 in chips) 
Zugrug: posts small blind $0.10
Medic8681: posts big blind $0.25
*** HOLE CARDS ***
Dealt to chiyuki [Qs 4d]
RomarioJa: folds 
Loholov: raises $0.50 to $0.75
BlOnDhOlIc: folds 
NastyMcNast: folds 
chiyuki: folds 
nice.franki: folds 
4ydo yogurt: calls $0.75
Zugrug: folds 
Medic8681: folds 
*** FLOP *** [Ad Jd 3s]
Loholov: bets $1.50
4ydo yogurt: calls $1.50
*** TURN *** [Ad Jd 3s] [Th]
Loholov: bets $6.50
4ydo yogurt: folds 
Uncalled bet ($6.50) returned to Loholov
Loholov collected $4.63 from pot
Loholov: doesn't show hand 
*** SUMMARY ***
Total pot $4.85 | Rake $0.22 
Board [Ad Jd 3s Th]
Seat 1: 4ydo yogurt (button) folded on the Turn
Seat 2: Zugrug (small blind) folded before Flop
Seat 3: Medic8681 (big blind) folded before Flop
Seat 4: RomarioJa folded before Flop (didn't bet)
Seat 5: Loholov collected ($4.63)
Seat 6: BlOnDhOlIc folded before Flop (didn't bet)
Seat 7: NastyMcNast folded before Flop (didn't bet)
Seat 8: chiyuki folded before Flop (didn't bet)
Seat 9: nice.franki folded before Flop (didn't bet)



PokerStars Zoom Hand #84298645482:  Hold'em No Limit ($0.10/$0.25) - 2012/08/05 13:26:38 JST [2012/08/05 0:26:38 ET]
Table 'Whirlpool' 9-max Seat #1 is the button
Seat 1: MATT361 ($4.95 in chips) 
Seat 2: BlOnDhOlIc ($54.96 in chips) 
Seat 3: nice.franki ($12.72 in chips) 
Seat 4: KeLevro0 ($8.63 in chips) 
Seat 5: chiyuki ($35.62 in chips) 
Seat 6: leo2095 ($17.02 in chips) 
Seat 7: polk11 ($20.25 in chips) 
Seat 8: D@vidMed ($40.53 in chips) 
Seat 9: Loholov ($15 in chips) 
BlOnDhOlIc: posts small blind $0.10
nice.franki: posts big blind $0.25
*** HOLE CARDS ***
Dealt to chiyuki [4s 8h]
KeLevro0: folds 
chiyuki: folds 
leo2095: raises $0.25 to $0.50
polk11: folds 
D@vidMed: calls $0.50
Loholov: folds 
MATT361: folds 
BlOnDhOlIc: folds 
nice.franki: folds 
*** FLOP *** [Ac 6c 3c]
leo2095: checks 
D@vidMed: checks 
*** TURN *** [Ac 6c 3c] [8d]
leo2095: checks 
D@vidMed: checks 
*** RIVER *** [Ac 6c 3c 8d] [Tc]
leo2095: checks 
D@vidMed: bets $0.82
leo2095: folds 
Uncalled bet ($0.82) returned to D@vidMed
D@vidMed collected $1.29 from pot
D@vidMed: doesn't show hand 
*** SUMMARY ***
Total pot $1.35 | Rake $0.06 
Board [Ac 6c 3c 8d Tc]
Seat 1: MATT361 (button) folded before Flop (didn't bet)
Seat 2: BlOnDhOlIc (small blind) folded before Flop
Seat 3: nice.franki (big blind) folded before Flop
Seat 4: KeLevro0 folded before Flop (didn't bet)
Seat 5: chiyuki folded before Flop (didn't bet)
Seat 6: leo2095 folded on the River
Seat 7: polk11 folded before Flop (didn't bet)
Seat 8: D@vidMed collected ($1.29)
Seat 9: Loholov folded before Flop (didn't bet)



PokerStars Zoom Hand #84298639736:  Hold'em No Limit ($0.10/$0.25) - 2012/08/05 13:26:16 JST [2012/08/05 0:26:16 ET]
Table 'Whirlpool' 9-max Seat #1 is the button
Seat 1: deadmoneykid ($26.49 in chips) 
Seat 2: DooMSDaY1337 ($94.76 in chips) 
Seat 3: PetitAlejo ($25.60 in chips) 
Seat 4: NastyMcNast ($37.75 in chips) 
Seat 5: chiyuki ($35.87 in chips) 
Seat 6: BlackZafiro ($25.49 in chips) 
Seat 7: agurio ($30.01 in chips) 
Seat 8: gunbowler ($97.45 in chips) 
Seat 9: kamikkaze ($48.93 in chips) 
DooMSDaY1337: posts small blind $0.10
PetitAlejo: posts big blind $0.25
*** HOLE CARDS ***
Dealt to chiyuki [Th Qh]
NastyMcNast: folds 
chiyuki: folds 
BlackZafiro: raises $0.50 to $0.75
agurio: folds 
gunbowler: folds 
kamikkaze: folds 
deadmoneykid: calls $0.75
DooMSDaY1337: folds 
PetitAlejo: folds 
*** FLOP *** [7s 9s 7c]
BlackZafiro: checks 
deadmoneykid: bets $0.75
BlackZafiro: calls $0.75
*** TURN *** [7s 9s 7c] [Js]
BlackZafiro: checks 
deadmoneykid: bets $1.75
BlackZafiro: folds 
Uncalled bet ($1.75) returned to deadmoneykid
deadmoneykid collected $3.20 from pot
deadmoneykid: doesn't show hand 
*** SUMMARY ***
Total pot $3.35 | Rake $0.15 
Board [7s 9s 7c Js]
Seat 1: deadmoneykid (button) collected ($3.20)
Seat 2: DooMSDaY1337 (small blind) folded before Flop
Seat 3: PetitAlejo (big blind) folded before Flop
Seat 4: NastyMcNast folded before Flop (didn't bet)
Seat 5: chiyuki folded before Flop (didn't bet)
Seat 6: BlackZafiro folded on the Turn
Seat 7: agurio folded before Flop (didn't bet)
Seat 8: gunbowler folded before Flop (didn't bet)
Seat 9: kamikkaze folded before Flop (didn't bet)



PokerStars Zoom Hand #84298646941:  Hold'em No Limit ($0.10/$0.25) - 2012/08/05 13:26:43 JST [2012/08/05 0:26:43 ET]
Table 'Whirlpool' 9-max Seat #1 is the button
Seat 1: chiyuki ($35.62 in chips) 
Seat 2: RomarioJa ($4.74 in chips) 
Seat 3: BlOnDhOlIc ($54.86 in chips) 
Seat 4: polk11 ($20.25 in chips) 
Seat 5: MATT361 ($4.95 in chips) 
Seat 6: fwani ($25 in chips) 
Seat 7: BlackZafiro ($26.95 in chips) 
Seat 8: NastyMcNast ($37.75 in chips) 
Seat 9: 5zzzz33 ($14.29 in chips) 
RomarioJa: posts small blind $0.10
BlOnDhOlIc: posts big blind $0.25
*** HOLE CARDS ***
Dealt to chiyuki [6c Qs]
polk11: folds 
MATT361: folds 
fwani: folds 
BlackZafiro: folds 
NastyMcNast: raises $0.50 to $0.75
5zzzz33: folds 
chiyuki: folds 
RomarioJa: raises $3.99 to $4.74 and is all-in
BlOnDhOlIc: folds 
NastyMcNast: folds 
Uncalled bet ($3.99) returned to RomarioJa
RomarioJa collected $1.75 from pot
RomarioJa: doesn't show hand 
*** SUMMARY ***
Total pot $1.75 | Rake $0 
Seat 1: chiyuki (button) folded before Flop (didn't bet)
Seat 2: RomarioJa (small blind) collected ($1.75)
Seat 3: BlOnDhOlIc (big blind) folded before Flop
Seat 4: polk11 folded before Flop (didn't bet)
Seat 5: MATT361 folded before Flop (didn't bet)
Seat 6: fwani folded before Flop (didn't bet)
Seat 7: BlackZafiro folded before Flop (didn't bet)
Seat 8: NastyMcNast folded before Flop
Seat 9: 5zzzz33 folded before Flop (didn't bet)



PokerStars Zoom Hand #84298653610:  Hold'em No Limit ($0.10/$0.25) - 2012/08/05 13:27:08 JST [2012/08/05 0:27:08 ET]
Table 'Whirlpool' 9-max Seat #1 is the button
Seat 1: KeLevro0 ($12.15 in chips) 
Seat 2: TErr18 ($27.95 in chips) 
Seat 3: hirozo ($27.75 in chips) 
Seat 4: Alvinpe85 ($54.80 in chips) 
Seat 5: nice.franki ($3.57 in chips) 
Seat 6: Th3Fog ($26.97 in chips) 
Seat 7: chiyuki ($35.62 in chips) 
Seat 8: BlackZafiro ($26.95 in chips) 
Seat 9: BlOnDhOlIc ($35.13 in chips) 
TErr18: posts small blind $0.10
hirozo: posts big blind $0.25
*** HOLE CARDS ***
Dealt to chiyuki [4s 3c]
Alvinpe85: raises $0.50 to $0.75
nice.franki: folds 
Th3Fog: calls $0.75
chiyuki: folds 
BlackZafiro: folds 
BlOnDhOlIc: calls $0.75
KeLevro0: folds 
TErr18: folds 
hirozo: folds 
*** FLOP *** [7h 7d As]
Alvinpe85: bets $1.48
Th3Fog: folds 
BlOnDhOlIc: folds 
Uncalled bet ($1.48) returned to Alvinpe85
Alvinpe85 collected $2.48 from pot
Alvinpe85: doesn't show hand 
*** SUMMARY ***
Total pot $2.60 | Rake $0.12 
Board [7h 7d As]
Seat 1: KeLevro0 (button) folded before Flop (didn't bet)
Seat 2: TErr18 (small blind) folded before Flop
Seat 3: hirozo (big blind) folded before Flop
Seat 4: Alvinpe85 collected ($2.48)
Seat 5: nice.franki folded before Flop (didn't bet)
Seat 6: Th3Fog folded on the Flop
Seat 7: chiyuki folded before Flop (didn't bet)
Seat 8: BlackZafiro folded before Flop (didn't bet)
Seat 9: BlOnDhOlIc folded on the Flop



PokerStars Zoom Hand #84298655751:  Hold'em No Limit ($0.10/$0.25) - 2012/08/05 13:27:16 JST [2012/08/05 0:27:16 ET]
Table 'Whirlpool' 9-max Seat #1 is the button
Seat 1: seula i ($51.38 in chips) 
Seat 2: fwani ($30.13 in chips) 
Seat 3: Dejacob ($25 in chips) 
Seat 4: KeLevro0 ($11.80 in chips) 
Seat 5: gunbowler ($98.20 in chips) 
Seat 6: ShockLaMuc ($36.50 in chips) 
Seat 7: deadmoneykid ($28.26 in chips) 
Seat 8: KINGKILERACE ($22.79 in chips) 
Seat 9: chiyuki ($35.62 in chips) 
fwani: posts small blind $0.10
Dejacob: posts big blind $0.25
*** HOLE CARDS ***
Dealt to chiyuki [9h 7s]
KeLevro0: folds 
gunbowler: folds 
ShockLaMuc: folds 
deadmoneykid: folds 
KINGKILERACE: folds 
chiyuki: folds 
seula i: folds 
fwani: raises $0.35 to $0.60
Dejacob: folds 
Uncalled bet ($0.35) returned to fwani
fwani collected $0.50 from pot
fwani: doesn't show hand 
*** SUMMARY ***
Total pot $0.50 | Rake $0 
Seat 1: seula i (button) folded before Flop (didn't bet)
Seat 2: fwani (small blind) collected ($0.50)
Seat 3: Dejacob (big blind) folded before Flop
Seat 4: KeLevro0 folded before Flop (didn't bet)
Seat 5: gunbowler folded before Flop (didn't bet)
Seat 6: ShockLaMuc folded before Flop (didn't bet)
Seat 7: deadmoneykid folded before Flop (didn't bet)
Seat 8: KINGKILERACE folded before Flop (didn't bet)
Seat 9: chiyuki folded before Flop (didn't bet)



PokerStars Zoom Hand #84298657118:  Hold'em No Limit ($0.10/$0.25) - 2012/08/05 13:27:21 JST [2012/08/05 0:27:21 ET]
Table 'Whirlpool' 9-max Seat #1 is the button
Seat 1: gunbowler ($98.20 in chips) 
Seat 2: chiyuki ($35.62 in chips) 
Seat 3: diez007 ($24 in chips) 
Seat 4: kamikkaze ($48.30 in chips) 
Seat 5: hirozo ($25 in chips) 
Seat 6: TraderYao ($27.03 in chips) 
Seat 7: KINGKILERACE ($22.79 in chips) 
Seat 8: KeLevro0 ($12.15 in chips) 
Seat 9: Zugrug ($34.58 in chips) 
chiyuki: posts small blind $0.10
diez007: posts big blind $0.25
*** HOLE CARDS ***
Dealt to chiyuki [Ks Ah]
kamikkaze: folds 
hirozo: folds 
TraderYao: folds 
KINGKILERACE: folds 
KeLevro0: folds 
Zugrug: raises $0.37 to $0.62
gunbowler: calls $0.62
chiyuki: raises $1.62 to $2.24
diez007: folds 
Zugrug: folds 
gunbowler: calls $1.62
*** FLOP *** [9h 5h 2c]
chiyuki: bets $4
gunbowler: folds 
Uncalled bet ($4) returned to chiyuki
chiyuki collected $5.11 from pot
chiyuki: doesn't show hand 
*** SUMMARY ***
Total pot $5.35 | Rake $0.24 
Board [9h 5h 2c]
Seat 1: gunbowler (button) folded on the Flop
Seat 2: chiyuki (small blind) collected ($5.11)
Seat 3: diez007 (big blind) folded before Flop
Seat 4: kamikkaze folded before Flop (didn't bet)
Seat 5: hirozo folded before Flop (didn't bet)
Seat 6: TraderYao folded before Flop (didn't bet)
Seat 7: KINGKILERACE folded before Flop (didn't bet)
Seat 8: KeLevro0 folded before Flop (didn't bet)
Seat 9: Zugrug folded before Flop



PokerStars Zoom Hand #84298667794:  Hold'em No Limit ($0.10/$0.25) - 2012/08/05 13:28:01 JST [2012/08/05 0:28:01 ET]
Table 'Whirlpool' 9-max Seat #1 is the button
Seat 1: Dejacob ($25.25 in chips) 
Seat 2: wtu1986 ($25.35 in chips) 
Seat 3: Medic8681 ($15.53 in chips) 
Seat 4: masterkoolb ($13.72 in chips) 
Seat 5: KeLevro0 ($11.75 in chips) 
Seat 6: RomarioJa ($8.76 in chips) 
Seat 7: chiyuki ($38.49 in chips) 
Seat 8: deadmoneykid ($28.19 in chips) 
Seat 9: DooMSDaY1337 ($95.36 in chips) 
wtu1986: posts small blind $0.10
Medic8681: posts big blind $0.25
*** HOLE CARDS ***
Dealt to chiyuki [Js 2c]
masterkoolb: folds 
KeLevro0: folds 
RomarioJa: folds 
chiyuki: folds 
deadmoneykid: folds 
DooMSDaY1337: raises $0.50 to $0.75
Dejacob: folds 
wtu1986: folds 
Medic8681: folds 
Uncalled bet ($0.50) returned to DooMSDaY1337
DooMSDaY1337 collected $0.60 from pot
DooMSDaY1337: doesn't show hand 
*** SUMMARY ***
Total pot $0.60 | Rake $0 
Seat 1: Dejacob (button) folded before Flop (didn't bet)
Seat 2: wtu1986 (small blind) folded before Flop
Seat 3: Medic8681 (big blind) folded before Flop
Seat 4: masterkoolb folded before Flop (didn't bet)
Seat 5: KeLevro0 folded before Flop (didn't bet)
Seat 6: RomarioJa folded before Flop (didn't bet)
Seat 7: chiyuki folded before Flop (didn't bet)
Seat 8: deadmoneykid folded before Flop (didn't bet)
Seat 9: DooMSDaY1337 collected ($0.60)



PokerStars Zoom Hand #84298669977:  Hold'em No Limit ($0.10/$0.25) - 2012/08/05 13:28:09 JST [2012/08/05 0:28:09 ET]
Table 'Whirlpool' 9-max Seat #1 is the button
Seat 1: Suhoff76 ($30.37 in chips) 
Seat 2: Ellen1947 ($24.75 in chips) 
Seat 3: Th3Fog ($53.66 in chips) 
Seat 4: KeLevro0 ($11.75 in chips) 
Seat 5: gedavaca ($39.82 in chips) 
Seat 6: chiyuki ($38.49 in chips) 
Seat 7: wtu1986 ($24.65 in chips) 
Seat 8: Jippyflip ($17.50 in chips) 
Seat 9: fwani ($28.12 in chips) 
Ellen1947: posts small blind $0.10
Th3Fog: posts big blind $0.25
*** HOLE CARDS ***
Dealt to chiyuki [Tc Jh]
KeLevro0: folds 
gedavaca: folds 
chiyuki: folds 
wtu1986: folds 
Jippyflip: folds 
fwani: folds 
Suhoff76: folds 
Ellen1947: folds 
Uncalled bet ($0.15) returned to Th3Fog
Th3Fog collected $0.20 from pot
Th3Fog: doesn't show hand 
*** SUMMARY ***
Total pot $0.20 | Rake $0 
Seat 1: Suhoff76 (button) folded before Flop (didn't bet)
Seat 2: Ellen1947 (small blind) folded before Flop
Seat 3: Th3Fog (big blind) collected ($0.20)
Seat 4: KeLevro0 folded before Flop (didn't bet)
Seat 5: gedavaca folded before Flop (didn't bet)
Seat 6: chiyuki folded before Flop (didn't bet)
Seat 7: wtu1986 folded before Flop (didn't bet)
Seat 8: Jippyflip folded before Flop (didn't bet)
Seat 9: fwani folded before Flop (didn't bet)



PokerStars Zoom Hand #84298674583:  Hold'em No Limit ($0.10/$0.25) - 2012/08/05 13:28:26 JST [2012/08/05 0:28:26 ET]
Table 'Whirlpool' 9-max Seat #1 is the button
Seat 1: chiyuki ($38.49 in chips) 
Seat 2: RomarioJa ($8.49 in chips) 
Seat 3: DooMSDaY1337 ($62.91 in chips) 
Seat 4: seula i ($25 in chips) 
Seat 5: Roglus ($17.76 in chips) 
Seat 6: Jippyflip ($17.50 in chips) 
Seat 7: hirozo ($36.39 in chips) 
Seat 8: wtu1986 ($24.65 in chips) 
Seat 9: silvno31 ($29.67 in chips) 
RomarioJa: posts small blind $0.10
DooMSDaY1337: posts big blind $0.25
*** HOLE CARDS ***
Dealt to chiyuki [7h 8s]
seula i: folds 
Roglus: folds 
Jippyflip: folds 
hirozo: folds 
wtu1986: folds 
silvno31: folds 
chiyuki: folds 
RomarioJa: folds 
Uncalled bet ($0.15) returned to DooMSDaY1337
DooMSDaY1337 collected $0.20 from pot
DooMSDaY1337: doesn't show hand 
*** SUMMARY ***
Total pot $0.20 | Rake $0 
Seat 1: chiyuki (button) folded before Flop (didn't bet)
Seat 2: RomarioJa (small blind) folded before Flop
Seat 3: DooMSDaY1337 (big blind) collected ($0.20)
Seat 4: seula i folded before Flop (didn't bet)
Seat 5: Roglus folded before Flop (didn't bet)
Seat 6: Jippyflip folded before Flop (didn't bet)
Seat 7: hirozo folded before Flop (didn't bet)
Seat 8: wtu1986 folded before Flop (didn't bet)
Seat 9: silvno31 folded before Flop (didn't bet)



PokerStars Zoom Hand #84298672428:  Hold'em No Limit ($0.10/$0.25) - 2012/08/05 13:28:18 JST [2012/08/05 0:28:18 ET]
Table 'Whirlpool' 9-max Seat #1 is the button
Seat 1: Ellen1947 ($24.65 in chips) 
Seat 2: NastyMcNast ($36.75 in chips) 
Seat 3: Suhoff76 ($25 in chips) 
Seat 4: 5zzzz33 ($13.34 in chips) 
Seat 5: nice.franki ($8.55 in chips) 
Seat 6: gedavaca ($39.72 in chips) 
Seat 7: DooMSDaY1337 ($49.59 in chips) 
Seat 8: chiyuki ($38.49 in chips) 
Seat 9: deadmoneykid ($24.92 in chips) 
NastyMcNast: posts small blind $0.10
Suhoff76: posts big blind $0.25
*** HOLE CARDS ***
Dealt to chiyuki [6c 6d]
5zzzz33: folds 
nice.franki: folds 
gedavaca: raises $0.35 to $0.60
DooMSDaY1337: folds 
chiyuki: folds 
deadmoneykid: folds 
Ellen1947: folds 
NastyMcNast: calls $0.50
Suhoff76: calls $0.35
*** FLOP *** [Jd 5c 5s]
NastyMcNast: bets $1.20
Suhoff76: folds 
gedavaca: folds 
Uncalled bet ($1.20) returned to NastyMcNast
NastyMcNast collected $1.72 from pot
NastyMcNast: doesn't show hand 
*** SUMMARY ***
Total pot $1.80 | Rake $0.08 
Board [Jd 5c 5s]
Seat 1: Ellen1947 (button) folded before Flop (didn't bet)
Seat 2: NastyMcNast (small blind) collected ($1.72)
Seat 3: Suhoff76 (big blind) folded on the Flop
Seat 4: 5zzzz33 folded before Flop (didn't bet)
Seat 5: nice.franki folded before Flop (didn't bet)
Seat 6: gedavaca folded on the Flop
Seat 7: DooMSDaY1337 folded before Flop (didn't bet)
Seat 8: chiyuki folded before Flop (didn't bet)
Seat 9: deadmoneykid folded before Flop (didn't bet)



PokerStars Zoom Hand #84298676788:  Hold'em No Limit ($0.10/$0.25) - 2012/08/05 13:28:34 JST [2012/08/05 0:28:34 ET]
Table 'Whirlpool' 9-max Seat #1 is the button
Seat 1: kamikkaze ($47.95 in chips) 
Seat 2: de harlekijn ($14.54 in chips) 
Seat 3: chiyuki ($38.49 in chips) 
Seat 4: agurio ($27.62 in chips) 
Seat 5: Suhoff76 ($26.45 in chips) 
Seat 6: ll_LaMeR_ll ($26.67 in chips) 
Seat 7: hirozo ($27.75 in chips) 
Seat 8: cR!Ma*aRm ($14.17 in chips) 
Seat 9: carlosrbr ($11.65 in chips) 
de harlekijn: posts small blind $0.10
chiyuki: posts big blind $0.25
*** HOLE CARDS ***
Dealt to chiyuki [3c 9s]
agurio: folds 
Suhoff76: folds 
ll_LaMeR_ll: folds 
hirozo: folds 
cR!Ma*aRm: folds 
carlosrbr: folds 
kamikkaze: folds 
de harlekijn: raises $0.50 to $0.75
chiyuki: folds 
Uncalled bet ($0.50) returned to de harlekijn
de harlekijn collected $0.50 from pot
de harlekijn: doesn't show hand 
*** SUMMARY ***
Total pot $0.50 | Rake $0 
Seat 1: kamikkaze (button) folded before Flop (didn't bet)
Seat 2: de harlekijn (small blind) collected ($0.50)
Seat 3: chiyuki (big blind) folded before Flop
Seat 4: agurio folded before Flop (didn't bet)
Seat 5: Suhoff76 folded before Flop (didn't bet)
Seat 6: ll_LaMeR_ll folded before Flop (didn't bet)
Seat 7: hirozo folded before Flop (didn't bet)
Seat 8: cR!Ma*aRm folded before Flop (didn't bet)
Seat 9: carlosrbr folded before Flop (didn't bet)



PokerStars Zoom Hand #84298686563:  Hold'em No Limit ($0.10/$0.25) - 2012/08/05 13:29:11 JST [2012/08/05 0:29:11 ET]
Table 'Whirlpool' 9-max Seat #1 is the button
Seat 1: munky3 ($18.34 in chips) 
Seat 2: Suhoff76 ($26.20 in chips) 
Seat 3: BlackZafiro ($25 in chips) 
Seat 4: BlOnDhOlIc ($26.72 in chips) 
Seat 5: carlosrbr ($12 in chips) 
Seat 6: NastyMcNast ($55.66 in chips) 
Seat 7: luyifei ($22.67 in chips) 
Seat 8: TraderYao ($25.75 in chips) 
Seat 9: chiyuki ($38.24 in chips) 
Suhoff76: posts small blind $0.10
BlackZafiro: posts big blind $0.25
*** HOLE CARDS ***
Dealt to chiyuki [Jh 5c]
BlOnDhOlIc: folds 
carlosrbr: folds 
NastyMcNast: folds 
luyifei: folds 
TraderYao: folds 
chiyuki: folds 
munky3: folds 
Suhoff76: folds 
Uncalled bet ($0.15) returned to BlackZafiro
BlackZafiro collected $0.20 from pot
BlackZafiro: doesn't show hand 
*** SUMMARY ***
Total pot $0.20 | Rake $0 
Seat 1: munky3 (button) folded before Flop (didn't bet)
Seat 2: Suhoff76 (small blind) folded before Flop
Seat 3: BlackZafiro (big blind) collected ($0.20)
Seat 4: BlOnDhOlIc folded before Flop (didn't bet)
Seat 5: carlosrbr folded before Flop (didn't bet)
Seat 6: NastyMcNast folded before Flop (didn't bet)
Seat 7: luyifei folded before Flop (didn't bet)
Seat 8: TraderYao folded before Flop (didn't bet)
Seat 9: chiyuki folded before Flop (didn't bet)



PokerStars Zoom Hand #84298690267:  Hold'em No Limit ($0.10/$0.25) - 2012/08/05 13:29:25 JST [2012/08/05 0:29:25 ET]
Table 'Whirlpool' 9-max Seat #1 is the button
Seat 1: Dejacob ($26.72 in chips) 
Seat 2: chiyuki ($38.24 in chips) 
Seat 3: PetitAlejo ($28.64 in chips) 
Seat 4: deadmoneykid ($29.12 in chips) 
Seat 5: NastyMcNast ($27.92 in chips) 
Seat 6: BlackZafiro ($25.10 in chips) 
Seat 7: Nerkit ($12.50 in chips) 
Seat 8: Paranoix1990 ($25.13 in chips) 
Seat 9: hirozo ($25 in chips) 
chiyuki: posts small blind $0.10
PetitAlejo: posts big blind $0.25
*** HOLE CARDS ***
Dealt to chiyuki [Jh 8s]
deadmoneykid: folds 
NastyMcNast: folds 
BlackZafiro: folds 
Nerkit: folds 
Paranoix1990: folds 
hirozo: folds 
Dejacob: folds 
chiyuki: folds 
Uncalled bet ($0.15) returned to PetitAlejo
PetitAlejo collected $0.20 from pot
PetitAlejo: doesn't show hand 
*** SUMMARY ***
Total pot $0.20 | Rake $0 
Seat 1: Dejacob (button) folded before Flop (didn't bet)
Seat 2: chiyuki (small blind) folded before Flop
Seat 3: PetitAlejo (big blind) collected ($0.20)
Seat 4: deadmoneykid folded before Flop (didn't bet)
Seat 5: NastyMcNast folded before Flop (didn't bet)
Seat 6: BlackZafiro folded before Flop (didn't bet)
Seat 7: Nerkit folded before Flop (didn't bet)
Seat 8: Paranoix1990 folded before Flop (didn't bet)
Seat 9: hirozo folded before Flop (didn't bet)



PokerStars Zoom Hand #84298689218:  Hold'em No Limit ($0.10/$0.25) - 2012/08/05 13:29:21 JST [2012/08/05 0:29:21 ET]
Table 'Whirlpool' 9-max Seat #1 is the button
Seat 1: Dejacob ($25 in chips) 
Seat 2: Jippyflip ($17.25 in chips) 
Seat 3: kamikkaze ($47.95 in chips) 
Seat 4: 4ydo yogurt ($5.35 in chips) 
Seat 5: chiyuki ($38.24 in chips) 
Seat 6: TraderYao ($29.14 in chips) 
Seat 7: DooMSDaY1337 ($63.01 in chips) 
Seat 8: RomarioJa ($6.58 in chips) 
Seat 9: gunbowler ($95.21 in chips) 
Jippyflip: posts small blind $0.10
kamikkaze: posts big blind $0.25
*** HOLE CARDS ***
Dealt to chiyuki [4s 3d]
4ydo yogurt: folds 
chiyuki: folds 
TraderYao: folds 
DooMSDaY1337: folds 
RomarioJa: raises $0.37 to $0.62
gunbowler: folds 
Dejacob: raises $1.13 to $1.75
Jippyflip: folds 
kamikkaze: folds 
RomarioJa: folds 
Uncalled bet ($1.13) returned to Dejacob
Dejacob collected $1.59 from pot
Dejacob: doesn't show hand 
*** SUMMARY ***
Total pot $1.59 | Rake $0 
Seat 1: Dejacob (button) collected ($1.59)
Seat 2: Jippyflip (small blind) folded before Flop
Seat 3: kamikkaze (big blind) folded before Flop
Seat 4: 4ydo yogurt folded before Flop (didn't bet)
Seat 5: chiyuki folded before Flop (didn't bet)
Seat 6: TraderYao folded before Flop (didn't bet)
Seat 7: DooMSDaY1337 folded before Flop (didn't bet)
Seat 8: RomarioJa folded before Flop
Seat 9: gunbowler folded before Flop (didn't bet)



PokerStars Zoom Hand #84298694865:  Hold'em No Limit ($0.10/$0.25) - 2012/08/05 13:29:42 JST [2012/08/05 0:29:42 ET]
Table 'Whirlpool' 9-max Seat #1 is the button
Seat 1: Suhoff76 ($29.27 in chips) 
Seat 2: fwani ($31.26 in chips) 
Seat 3: NastyMcNast ($34.98 in chips) 
Seat 4: chiyuki ($38.14 in chips) 
Seat 5: deadmoneykid ($25 in chips) 
Seat 6: Dejacob ($25 in chips) 
Seat 7: MATT361 ($7.90 in chips) 
Seat 8: Alvinpe85 ($27.54 in chips) 
Seat 9: Jippyflip ($17.15 in chips) 
fwani: posts small blind $0.10
NastyMcNast: posts big blind $0.25
*** HOLE CARDS ***
Dealt to chiyuki [5d 3h]
chiyuki: folds 
deadmoneykid: folds 
Dejacob: folds 
MATT361: folds 
Alvinpe85: folds 
Jippyflip: folds 
Suhoff76: folds 
fwani: raises $0.35 to $0.60
NastyMcNast: folds 
Uncalled bet ($0.35) returned to fwani
fwani collected $0.50 from pot
fwani: doesn't show hand 
*** SUMMARY ***
Total pot $0.50 | Rake $0 
Seat 1: Suhoff76 (button) folded before Flop (didn't bet)
Seat 2: fwani (small blind) collected ($0.50)
Seat 3: NastyMcNast (big blind) folded before Flop
Seat 4: chiyuki folded before Flop (didn't bet)
Seat 5: deadmoneykid folded before Flop (didn't bet)
Seat 6: Dejacob folded before Flop (didn't bet)
Seat 7: MATT361 folded before Flop (didn't bet)
Seat 8: Alvinpe85 folded before Flop (didn't bet)
Seat 9: Jippyflip folded before Flop (didn't bet)



PokerStars Zoom Hand #84298693800:  Hold'em No Limit ($0.10/$0.25) - 2012/08/05 13:29:38 JST [2012/08/05 0:29:38 ET]
Table 'Whirlpool' 9-max Seat #1 is the button
Seat 1: Nerkit ($12.50 in chips) 
Seat 2: deadmoneykid ($24.67 in chips) 
Seat 3: TraderYao ($31.59 in chips) 
Seat 4: chiyuki ($38.14 in chips) 
Seat 5: wtu1986 ($26.50 in chips) 
Seat 6: gunbowler ($95.21 in chips) 
Seat 7: RomarioJa ($8.14 in chips) 
Seat 8: Suhoff76 ($26.10 in chips) 
Seat 9: seula i ($61.93 in chips) 
deadmoneykid: posts small blind $0.10
TraderYao: posts big blind $0.25
*** HOLE CARDS ***
Dealt to chiyuki [6d 5s]
chiyuki: folds 
wtu1986: raises $0.50 to $0.75
gunbowler: folds 
RomarioJa: folds 
Suhoff76: folds 
seula i: folds 
Nerkit: folds 
deadmoneykid: folds 
TraderYao: folds 
Uncalled bet ($0.50) returned to wtu1986
wtu1986 collected $0.60 from pot
wtu1986: doesn't show hand 
*** SUMMARY ***
Total pot $0.60 | Rake $0 
Seat 1: Nerkit (button) folded before Flop (didn't bet)
Seat 2: deadmoneykid (small blind) folded before Flop
Seat 3: TraderYao (big blind) folded before Flop
Seat 4: chiyuki folded before Flop (didn't bet)
Seat 5: wtu1986 collected ($0.60)
Seat 6: gunbowler folded before Flop (didn't bet)
Seat 7: RomarioJa folded before Flop (didn't bet)
Seat 8: Suhoff76 folded before Flop (didn't bet)
Seat 9: seula i folded before Flop (didn't bet)



PokerStars Zoom Hand #84298697497:  Hold'em No Limit ($0.10/$0.25) - 2012/08/05 13:29:51 JST [2012/08/05 0:29:51 ET]
Table 'Whirlpool' 9-max Seat #1 is the button
Seat 1: ll_LaMeR_ll ($30.55 in chips) 
Seat 2: gedavaca ($41.14 in chips) 
Seat 3: chiyuki ($38.14 in chips) 
Seat 4: petersmiths ($19.35 in chips) 
Seat 5: PetitAlejo ($28.74 in chips) 
Seat 6: RomarioJa ($5.49 in chips) 
Seat 7: Jippyflip ($17.15 in chips) 
Seat 8: hirozo ($45.80 in chips) 
Seat 9: KeLevro0 ($15.06 in chips) 
gedavaca: posts small blind $0.10
chiyuki: posts big blind $0.25
*** HOLE CARDS ***
Dealt to chiyuki [4d Ks]
petersmiths: raises $0.25 to $0.50
PetitAlejo: folds 
RomarioJa: folds 
Jippyflip: folds 
hirozo: folds 
KeLevro0: raises $2 to $2.50
ll_LaMeR_ll: folds 
gedavaca: folds 
chiyuki: folds 
petersmiths: folds 
Uncalled bet ($2) returned to KeLevro0
KeLevro0 collected $1.35 from pot
KeLevro0: doesn't show hand 
*** SUMMARY ***
Total pot $1.35 | Rake $0 
Seat 1: ll_LaMeR_ll (button) folded before Flop (didn't bet)
Seat 2: gedavaca (small blind) folded before Flop
Seat 3: chiyuki (big blind) folded before Flop
Seat 4: petersmiths folded before Flop
Seat 5: PetitAlejo folded before Flop (didn't bet)
Seat 6: RomarioJa folded before Flop (didn't bet)
Seat 7: Jippyflip folded before Flop (didn't bet)
Seat 8: hirozo folded before Flop (didn't bet)
Seat 9: KeLevro0 collected ($1.35)



PokerStars Zoom Hand #84298704844:  Hold'em No Limit ($0.10/$0.25) - 2012/08/05 13:30:19 JST [2012/08/05 0:30:19 ET]
Table 'Whirlpool' 9-max Seat #1 is the button
Seat 1: BlackZafiro ($25 in chips) 
Seat 2: PetitAlejo ($28.74 in chips) 
Seat 3: Suhoff76 ($26.01 in chips) 
Seat 4: Jippyflip ($17.15 in chips) 
Seat 5: masterkoolb ($12.97 in chips) 
Seat 6: slapshot2011 ($44.61 in chips) 
Seat 7: RomarioJa ($8.95 in chips) 
Seat 8: Th3Fog ($54.42 in chips) 
Seat 9: chiyuki ($37.89 in chips) 
PetitAlejo: posts small blind $0.10
Suhoff76: posts big blind $0.25
*** HOLE CARDS ***
Dealt to chiyuki [2h 3s]
Jippyflip: folds 
masterkoolb: folds 
slapshot2011: folds 
RomarioJa: folds 
Th3Fog: folds 
chiyuki: folds 
BlackZafiro: raises $0.37 to $0.62
PetitAlejo: folds 
Suhoff76: folds 
Uncalled bet ($0.37) returned to BlackZafiro
BlackZafiro collected $0.60 from pot
BlackZafiro: doesn't show hand 
*** SUMMARY ***
Total pot $0.60 | Rake $0 
Seat 1: BlackZafiro (button) collected ($0.60)
Seat 2: PetitAlejo (small blind) folded before Flop
Seat 3: Suhoff76 (big blind) folded before Flop
Seat 4: Jippyflip folded before Flop (didn't bet)
Seat 5: masterkoolb folded before Flop (didn't bet)
Seat 6: slapshot2011 folded before Flop (didn't bet)
Seat 7: RomarioJa folded before Flop (didn't bet)
Seat 8: Th3Fog folded before Flop (didn't bet)
Seat 9: chiyuki folded before Flop (didn't bet)



PokerStars Zoom Hand #84298695986:  Hold'em No Limit ($0.10/$0.25) - 2012/08/05 13:29:46 JST [2012/08/05 0:29:46 ET]
Table 'Whirlpool' 9-max Seat #1 is the button
Seat 1: Suhoff76 ($25.54 in chips) 
Seat 2: seula i ($25.35 in chips) 
Seat 3: Ellen1947 ($25 in chips) 
Seat 4: PetitAlejo ($35.08 in chips) 
Seat 5: Dejacob ($26.72 in chips) 
Seat 6: 5zzzz33 ($12.99 in chips) 
Seat 7: deadmoneykid ($23.65 in chips) 
Seat 8: chiyuki ($38.14 in chips) 
Seat 9: ShockLaMuc ($20.14 in chips) 
seula i: posts small blind $0.10
Ellen1947: posts big blind $0.25
*** HOLE CARDS ***
Dealt to chiyuki [Jc 5d]
PetitAlejo: folds 
Dejacob: folds 
5zzzz33: folds 
deadmoneykid: folds 
chiyuki: folds 
ShockLaMuc: folds 
Suhoff76: raises $0.32 to $0.57
seula i: folds 
Ellen1947: calls $0.32
*** FLOP *** [Ad 8d 3s]
Ellen1947: checks 
Suhoff76: checks 
*** TURN *** [Ad 8d 3s] [As]
Ellen1947: checks 
Suhoff76: bets $0.77
Ellen1947: raises $1.36 to $2.13
Suhoff76: calls $1.36
*** RIVER *** [Ad 8d 3s As] [Kd]
Ellen1947: bets $3.93
Suhoff76: folds 
Uncalled bet ($3.93) returned to Ellen1947
Ellen1947 collected $5.25 from pot
Ellen1947: doesn't show hand 
*** SUMMARY ***
Total pot $5.50 | Rake $0.25 
Board [Ad 8d 3s As Kd]
Seat 1: Suhoff76 (button) folded on the River
Seat 2: seula i (small blind) folded before Flop
Seat 3: Ellen1947 (big blind) collected ($5.25)
Seat 4: PetitAlejo folded before Flop (didn't bet)
Seat 5: Dejacob folded before Flop (didn't bet)
Seat 6: 5zzzz33 folded before Flop (didn't bet)
Seat 7: deadmoneykid folded before Flop (didn't bet)
Seat 8: chiyuki folded before Flop (didn't bet)
Seat 9: ShockLaMuc folded before Flop (didn't bet)



PokerStars Zoom Hand #84298702047:  Hold'em No Limit ($0.10/$0.25) - 2012/08/05 13:30:09 JST [2012/08/05 0:30:09 ET]
Table 'Whirlpool' 9-max Seat #1 is the button
Seat 1: Alvinpe85 ($27.54 in chips) 
Seat 2: TErr18 ($26.50 in chips) 
Seat 3: DooMSDaY1337 ($93.21 in chips) 
Seat 4: seula i ($61.68 in chips) 
Seat 5: taksist889 ($24.46 in chips) 
Seat 6: chiyuki ($37.89 in chips) 
Seat 7: KeLevro0 ($11.45 in chips) 
Seat 8: vit 111 ($34.62 in chips) 
Seat 9: Medic8681 ($16.08 in chips) 
TErr18: posts small blind $0.10
DooMSDaY1337: posts big blind $0.25
*** HOLE CARDS ***
Dealt to chiyuki [Jh Kc]
seula i: folds 
taksist889: folds 
chiyuki: folds 
KeLevro0: folds 
vit 111: raises $0.25 to $0.50
Medic8681: folds 
Alvinpe85: folds 
TErr18: calls $0.40
DooMSDaY1337: folds 
*** FLOP *** [3s 9d 5d]
TErr18: checks 
vit 111: bets $0.50
TErr18: folds 
Uncalled bet ($0.50) returned to vit 111
vit 111 collected $1.19 from pot
vit 111: doesn't show hand 
*** SUMMARY ***
Total pot $1.25 | Rake $0.06 
Board [3s 9d 5d]
Seat 1: Alvinpe85 (button) folded before Flop (didn't bet)
Seat 2: TErr18 (small blind) folded on the Flop
Seat 3: DooMSDaY1337 (big blind) folded before Flop
Seat 4: seula i folded before Flop (didn't bet)
Seat 5: taksist889 folded before Flop (didn't bet)
Seat 6: chiyuki folded before Flop (didn't bet)
Seat 7: KeLevro0 folded before Flop (didn't bet)
Seat 8: vit 111 collected ($1.19)
Seat 9: Medic8681 folded before Flop (didn't bet)



PokerStars Zoom Hand #84298708094:  Hold'em No Limit ($0.10/$0.25) - 2012/08/05 13:30:31 JST [2012/08/05 0:30:31 ET]
Table 'Whirlpool' 9-max Seat #1 is the button
Seat 1: chiyuki ($37.89 in chips) 
Seat 2: fwani ($25.60 in chips) 
Seat 3: RomarioJa ($5.86 in chips) 
Seat 4: silvno31 ($29.38 in chips) 
Seat 5: ShockLaMuc ($20.04 in chips) 
Seat 6: DooMSDaY1337 ($95.26 in chips) 
Seat 7: Roglus ($46.39 in chips) 
Seat 8: goldstone ($36.38 in chips) 
Seat 9: Suhoff76 ($29.02 in chips) 
fwani: posts small blind $0.10
RomarioJa: posts big blind $0.25
*** HOLE CARDS ***
Dealt to chiyuki [Qh Kh]
silvno31: folds 
ShockLaMuc: folds 
DooMSDaY1337: folds 
Roglus: raises $0.50 to $0.75
goldstone: folds 
Suhoff76: calls $0.75
chiyuki: raises $2 to $2.75
fwani: folds 
RomarioJa: folds 
Roglus: folds 
Suhoff76: folds 
Uncalled bet ($2) returned to chiyuki
chiyuki collected $2.60 from pot
chiyuki: doesn't show hand 
*** SUMMARY ***
Total pot $2.60 | Rake $0 
Seat 1: chiyuki (button) collected ($2.60)
Seat 2: fwani (small blind) folded before Flop
Seat 3: RomarioJa (big blind) folded before Flop
Seat 4: silvno31 folded before Flop (didn't bet)
Seat 5: ShockLaMuc folded before Flop (didn't bet)
Seat 6: DooMSDaY1337 folded before Flop (didn't bet)
Seat 7: Roglus folded before Flop
Seat 8: goldstone folded before Flop (didn't bet)
Seat 9: Suhoff76 folded before Flop



PokerStars Zoom Hand #84298706442:  Hold'em No Limit ($0.10/$0.25) - 2012/08/05 13:30:25 JST [2012/08/05 0:30:25 ET]
Table 'Whirlpool' 9-max Seat #1 is the button
Seat 1: seula i ($25.25 in chips) 
Seat 2: slapshot2011 ($44.61 in chips) 
Seat 3: PetitAlejo ($25 in chips) 
Seat 4: Dejacob ($25.97 in chips) 
Seat 5: eagie20 ($126.55 in chips) 
Seat 6: Lasutchik ($8.34 in chips) 
Seat 7: chiyuki ($37.89 in chips) 
Seat 8: peng2astic ($9.65 in chips) 
Seat 9: Roglus ($46.39 in chips) 
slapshot2011: posts small blind $0.10
PetitAlejo: posts big blind $0.25
*** HOLE CARDS ***
Dealt to chiyuki [Kh 3s]
Dejacob: folds 
eagie20: folds 
Lasutchik: folds 
chiyuki: folds 
peng2astic: folds 
Roglus: folds 
seula i: folds 
slapshot2011: calls $0.15
PetitAlejo: raises $0.73 to $0.98
slapshot2011: calls $0.73
*** FLOP *** [Ad 8c 6d]
slapshot2011: checks 
PetitAlejo: bets $1.25
slapshot2011: calls $1.25
*** TURN *** [Ad 8c 6d] [Td]
slapshot2011: checks 
PetitAlejo: checks 
*** RIVER *** [Ad 8c 6d Td] [7h]
slapshot2011: checks 
PetitAlejo: checks 
*** SHOW DOWN ***
slapshot2011: shows [Kc 6c] (a pair of Sixes)
PetitAlejo: mucks hand 
slapshot2011 collected $4.26 from pot
*** SUMMARY ***
Total pot $4.46 | Rake $0.20 
Board [Ad 8c 6d Td 7h]
Seat 1: seula i (button) folded before Flop (didn't bet)
Seat 2: slapshot2011 (small blind) showed [Kc 6c] and won ($4.26) with a pair of Sixes
Seat 3: PetitAlejo (big blind) mucked [Qc 6s]
Seat 4: Dejacob folded before Flop (didn't bet)
Seat 5: eagie20 folded before Flop (didn't bet)
Seat 6: Lasutchik folded before Flop (didn't bet)
Seat 7: chiyuki folded before Flop (didn't bet)
Seat 8: peng2astic folded before Flop (didn't bet)
Seat 9: Roglus folded before Flop (didn't bet)



PokerStars Zoom Hand #84298716367:  Hold'em No Limit ($0.10/$0.25) - 2012/08/05 13:31:01 JST [2012/08/05 0:31:01 ET]
Table 'Whirlpool' 9-max Seat #1 is the button
Seat 1: TraderYao ($29.24 in chips) 
Seat 2: Lasutchik ($8.09 in chips) 
Seat 3: hirozo ($36.34 in chips) 
Seat 4: chiyuki ($39.74 in chips) 
Seat 5: ShockLaMuc ($37.52 in chips) 
Seat 6: Medic8681 ($45.21 in chips) 
Seat 7: de harlekijn ($17.54 in chips) 
Seat 8: gunbowler ($93.11 in chips) 
Seat 9: Loholov ($22.10 in chips) 
Lasutchik: posts small blind $0.10
hirozo: posts big blind $0.25
*** HOLE CARDS ***
Dealt to chiyuki [6c 8h]
chiyuki: folds 
ShockLaMuc: folds 
Medic8681: folds 
de harlekijn: folds 
gunbowler: folds 
Loholov: raises $0.50 to $0.75
TraderYao: folds 
Lasutchik: folds 
hirozo: folds 
Uncalled bet ($0.50) returned to Loholov
Loholov collected $0.60 from pot
Loholov: doesn't show hand 
*** SUMMARY ***
Total pot $0.60 | Rake $0 
Seat 1: TraderYao (button) folded before Flop (didn't bet)
Seat 2: Lasutchik (small blind) folded before Flop
Seat 3: hirozo (big blind) folded before Flop
Seat 4: chiyuki folded before Flop (didn't bet)
Seat 5: ShockLaMuc folded before Flop (didn't bet)
Seat 6: Medic8681 folded before Flop (didn't bet)
Seat 7: de harlekijn folded before Flop (didn't bet)
Seat 8: gunbowler folded before Flop (didn't bet)
Seat 9: Loholov collected ($0.60)



PokerStars Zoom Hand #84298721785:  Hold'em No Limit ($0.10/$0.25) - 2012/08/05 13:31:22 JST [2012/08/05 0:31:22 ET]
Table 'Whirlpool' 9-max Seat #1 is the button
Seat 1: deadmoneykid ($23.97 in chips) 
Seat 2: seula i ($59.43 in chips) 
Seat 3: ygoegoe ($25 in chips) 
Seat 4: gunbowler ($93.11 in chips) 
Seat 5: TraderYao ($28.79 in chips) 
Seat 6: Nerkit ($11.40 in chips) 
Seat 7: Th3Fog ($54.07 in chips) 
Seat 8: chiyuki ($39.64 in chips) 
Seat 9: wtu1986 ($26.50 in chips) 
seula i: posts small blind $0.10
ygoegoe: posts big blind $0.25
*** HOLE CARDS ***
Dealt to chiyuki [9h Qd]
gunbowler: folds 
TraderYao: folds 
Nerkit: folds 
Th3Fog: folds 
chiyuki: folds 
wtu1986: folds 
deadmoneykid: folds 
seula i: folds 
Uncalled bet ($0.15) returned to ygoegoe
ygoegoe collected $0.20 from pot
ygoegoe: doesn't show hand 
*** SUMMARY ***
Total pot $0.20 | Rake $0 
Seat 1: deadmoneykid (button) folded before Flop (didn't bet)
Seat 2: seula i (small blind) folded before Flop
Seat 3: ygoegoe (big blind) collected ($0.20)
Seat 4: gunbowler folded before Flop (didn't bet)
Seat 5: TraderYao folded before Flop (didn't bet)
Seat 6: Nerkit folded before Flop (didn't bet)
Seat 7: Th3Fog folded before Flop (didn't bet)
Seat 8: chiyuki folded before Flop (didn't bet)
Seat 9: wtu1986 folded before Flop (didn't bet)



PokerStars Zoom Hand #84298724783:  Hold'em No Limit ($0.10/$0.25) - 2012/08/05 13:31:33 JST [2012/08/05 0:31:33 ET]
Table 'Whirlpool' 9-max Seat #1 is the button
Seat 1: TraderYao ($31.19 in chips) 
Seat 2: Anafim ($12.50 in chips) 
Seat 3: chiyuki ($39.64 in chips) 
Seat 4: PetitAlejo ($34.48 in chips) 
Seat 5: NastyMcNast ($55.81 in chips) 
Seat 6: seula i ($59.33 in chips) 
Seat 7: wtu1986 ($26.50 in chips) 
Seat 8: RomarioJa ($5.51 in chips) 
Seat 9: Catrban ($37.64 in chips) 
Anafim: posts small blind $0.10
chiyuki: posts big blind $0.25
*** HOLE CARDS ***
Dealt to chiyuki [Qd Ks]
PetitAlejo: folds 
NastyMcNast: folds 
seula i: folds 
wtu1986: folds 
RomarioJa: folds 
Catrban: folds 
TraderYao: folds 
Anafim: folds 
Uncalled bet ($0.15) returned to chiyuki
chiyuki collected $0.20 from pot
chiyuki: doesn't show hand 
*** SUMMARY ***
Total pot $0.20 | Rake $0 
Seat 1: TraderYao (button) folded before Flop (didn't bet)
Seat 2: Anafim (small blind) folded before Flop
Seat 3: chiyuki (big blind) collected ($0.20)
Seat 4: PetitAlejo folded before Flop (didn't bet)
Seat 5: NastyMcNast folded before Flop (didn't bet)
Seat 6: seula i folded before Flop (didn't bet)
Seat 7: wtu1986 folded before Flop (didn't bet)
Seat 8: RomarioJa folded before Flop (didn't bet)
Seat 9: Catrban folded before Flop (didn't bet)



PokerStars Zoom Hand #84298723410:  Hold'em No Limit ($0.10/$0.25) - 2012/08/05 13:31:28 JST [2012/08/05 0:31:28 ET]
Table 'Whirlpool' 9-max Seat #1 is the button
Seat 1: Alvinpe85 ($27.64 in chips) 
Seat 2: BlOnDhOlIc ($26.94 in chips) 
Seat 3: deadmoneykid ($23.97 in chips) 
Seat 4: fwani ($34.60 in chips) 
Seat 5: luyifei ($23.32 in chips) 
Seat 6: wtu1986 ($26.50 in chips) 
Seat 7: chiyuki ($39.64 in chips) 
Seat 8: Th3Fog ($54.07 in chips) 
Seat 9: Dejacob ($25.72 in chips) 
BlOnDhOlIc: posts small blind $0.10
deadmoneykid: posts big blind $0.25
*** HOLE CARDS ***
Dealt to chiyuki [3h 4s]
fwani: folds 
luyifei: raises $0.50 to $0.75
wtu1986: folds 
chiyuki: folds 
Th3Fog: folds 
Dejacob: folds 
Alvinpe85: folds 
BlOnDhOlIc: folds 
deadmoneykid: folds 
Uncalled bet ($0.50) returned to luyifei
luyifei collected $0.60 from pot
luyifei: doesn't show hand 
*** SUMMARY ***
Total pot $0.60 | Rake $0 
Seat 1: Alvinpe85 (button) folded before Flop (didn't bet)
Seat 2: BlOnDhOlIc (small blind) folded before Flop
Seat 3: deadmoneykid (big blind) folded before Flop
Seat 4: fwani folded before Flop (didn't bet)
Seat 5: luyifei collected ($0.60)
Seat 6: wtu1986 folded before Flop (didn't bet)
Seat 7: chiyuki folded before Flop (didn't bet)
Seat 8: Th3Fog folded before Flop (didn't bet)
Seat 9: Dejacob folded before Flop (didn't bet)



PokerStars Zoom Hand #84298720657:  Hold'em No Limit ($0.10/$0.25) - 2012/08/05 13:31:17 JST [2012/08/05 0:31:17 ET]
Table 'Whirlpool' 9-max Seat #1 is the button
Seat 1: Suhoff76 ($28.17 in chips) 
Seat 2: fwani ($34.70 in chips) 
Seat 3: TraderYao ($28.27 in chips) 
Seat 4: chiyuki ($39.64 in chips) 
Seat 5: wtu1986 ($26.53 in chips) 
Seat 6: agurio ($32.05 in chips) 
Seat 7: seula i ($45.67 in chips) 
Seat 8: ladymadon107 ($23.08 in chips) 
Seat 9: RomarioJa ($7.24 in chips) 
fwani: posts small blind $0.10
TraderYao: posts big blind $0.25
*** HOLE CARDS ***
Dealt to chiyuki [6h 5d]
chiyuki: folds 
wtu1986: folds 
agurio: folds 
seula i: raises $0.50 to $0.75
ladymadon107: calls $0.75
RomarioJa: folds 
Suhoff76: folds 
fwani: folds 
TraderYao: folds 
*** FLOP *** [2h Kh 6c]
seula i: bets $1.25
ladymadon107: folds 
Uncalled bet ($1.25) returned to seula i
seula i collected $1.77 from pot
seula i: doesn't show hand 
*** SUMMARY ***
Total pot $1.85 | Rake $0.08 
Board [2h Kh 6c]
Seat 1: Suhoff76 (button) folded before Flop (didn't bet)
Seat 2: fwani (small blind) folded before Flop
Seat 3: TraderYao (big blind) folded before Flop
Seat 4: chiyuki folded before Flop (didn't bet)
Seat 5: wtu1986 folded before Flop (didn't bet)
Seat 6: agurio folded before Flop (didn't bet)
Seat 7: seula i collected ($1.77)
Seat 8: ladymadon107 folded on the Flop
Seat 9: RomarioJa folded before Flop (didn't bet)



PokerStars Zoom Hand #84298717512:  Hold'em No Limit ($0.10/$0.25) - 2012/08/05 13:31:05 JST [2012/08/05 0:31:05 ET]
Table 'Whirlpool' 9-max Seat #1 is the button
Seat 1: DooMSDaY1337 ($92.86 in chips) 
Seat 2: chiyuki ($39.74 in chips) 
Seat 3: 5zzzz33 ($12.24 in chips) 
Seat 4: Lasutchik ($25.53 in chips) 
Seat 5: polk11 ($16.02 in chips) 
Seat 6: NastyMcNast ($32.40 in chips) 
Seat 7: wtu1986 ($26.53 in chips) 
Seat 8: BlOnDhOlIc ($26.94 in chips) 
Seat 9: Alvinpe85 ($27.64 in chips) 
chiyuki: posts small blind $0.10
5zzzz33: posts big blind $0.25
*** HOLE CARDS ***
Dealt to chiyuki [8c 6h]
Lasutchik: folds 
polk11: folds 
NastyMcNast: raises $0.50 to $0.75
wtu1986: folds 
BlOnDhOlIc: folds 
Alvinpe85: folds 
DooMSDaY1337: calls $0.75
chiyuki: folds 
5zzzz33: folds 
*** FLOP *** [Jh 5d 2d]
NastyMcNast: bets $0.25
DooMSDaY1337: raises $1 to $1.25
NastyMcNast: folds 
Uncalled bet ($1) returned to DooMSDaY1337
DooMSDaY1337 collected $2.24 from pot
DooMSDaY1337: doesn't show hand 
*** SUMMARY ***
Total pot $2.35 | Rake $0.11 
Board [Jh 5d 2d]
Seat 1: DooMSDaY1337 (button) collected ($2.24)
Seat 2: chiyuki (small blind) folded before Flop
Seat 3: 5zzzz33 (big blind) folded before Flop
Seat 4: Lasutchik folded before Flop (didn't bet)
Seat 5: polk11 folded before Flop (didn't bet)
Seat 6: NastyMcNast folded on the Flop
Seat 7: wtu1986 folded before Flop (didn't bet)
Seat 8: BlOnDhOlIc folded before Flop (didn't bet)
Seat 9: Alvinpe85 folded before Flop (didn't bet)



PokerStars Zoom Hand #84298719121:  Hold'em No Limit ($0.10/$0.25) - 2012/08/05 13:31:11 JST [2012/08/05 0:31:11 ET]
Table 'Whirlpool' 9-max Seat #1 is the button
Seat 1: Lasutchik ($7.99 in chips) 
Seat 2: softdesign ($54.11 in chips) 
Seat 3: Nerkit ($11.65 in chips) 
Seat 4: chiyuki ($39.64 in chips) 
Seat 5: TErr18 ($26 in chips) 
Seat 6: de harlekijn ($17.54 in chips) 
Seat 7: BlackZafiro ($25.35 in chips) 
Seat 8: fwani ($31.26 in chips) 
Seat 9: Th3Fog ($54.07 in chips) 
softdesign: posts small blind $0.10
Nerkit: posts big blind $0.25
*** HOLE CARDS ***
Dealt to chiyuki [Th 5s]
chiyuki: folds 
TErr18: folds 
de harlekijn: raises $0.25 to $0.50
BlackZafiro: folds 
fwani: folds 
Th3Fog: folds 
Lasutchik: raises $0.75 to $1.25
softdesign: folds 
Nerkit: folds 
de harlekijn: calls $0.75
*** FLOP *** [5h 6h Qs]
de harlekijn: checks 
Lasutchik: bets $1.38
de harlekijn: raises $14.91 to $16.29 and is all-in
Lasutchik: calls $5.36 and is all-in
Uncalled bet ($9.55) returned to de harlekijn
*** TURN *** [5h 6h Qs] [Qc]
*** RIVER *** [5h 6h Qs Qc] [Kc]
*** SHOW DOWN ***
de harlekijn: shows [9h 7h] (a pair of Queens)
Lasutchik: shows [Ac Ah] (two pair, Aces and Queens)
Lasutchik collected $15.60 from pot
*** SUMMARY ***
Total pot $16.33 | Rake $0.73 
Board [5h 6h Qs Qc Kc]
Seat 1: Lasutchik (button) showed [Ac Ah] and won ($15.60) with two pair, Aces and Queens
Seat 2: softdesign (small blind) folded before Flop
Seat 3: Nerkit (big blind) folded before Flop
Seat 4: chiyuki folded before Flop (didn't bet)
Seat 5: TErr18 folded before Flop (didn't bet)
Seat 6: de harlekijn showed [9h 7h] and lost with a pair of Queens
Seat 7: BlackZafiro folded before Flop (didn't bet)
Seat 8: fwani folded before Flop (didn't bet)
Seat 9: Th3Fog folded before Flop (didn't bet)



PokerStars Zoom Hand #84298727431:  Hold'em No Limit ($0.10/$0.25) - 2012/08/05 13:31:43 JST [2012/08/05 0:31:43 ET]
Table 'Whirlpool' 9-max Seat #1 is the button
Seat 1: KeLevro0 ($10.48 in chips) 
Seat 2: Alvinpe85 ($27.64 in chips) 
Seat 3: agurio ($32.05 in chips) 
Seat 4: NastyMcNast ($40.25 in chips) 
Seat 5: chiyuki ($39.74 in chips) 
Seat 6: 4ydo yogurt ($8.67 in chips) 
Seat 7: TraderYao ($28.02 in chips) 
Seat 8: DooMSDaY1337 ($51.89 in chips) 
Seat 9: RomarioJa ($7.79 in chips) 
Alvinpe85: posts small blind $0.10
agurio: posts big blind $0.25
*** HOLE CARDS ***
Dealt to chiyuki [Qh 8c]
NastyMcNast: raises $0.50 to $0.75
chiyuki: folds 
4ydo yogurt: folds 
TraderYao: folds 
DooMSDaY1337: raises $1.75 to $2.50
RomarioJa: folds 
KeLevro0: folds 
Alvinpe85: folds 
agurio: folds 
NastyMcNast: folds 
Uncalled bet ($1.75) returned to DooMSDaY1337
DooMSDaY1337 collected $1.85 from pot
DooMSDaY1337: doesn't show hand 
*** SUMMARY ***
Total pot $1.85 | Rake $0 
Seat 1: KeLevro0 (button) folded before Flop (didn't bet)
Seat 2: Alvinpe85 (small blind) folded before Flop
Seat 3: agurio (big blind) folded before Flop
Seat 4: NastyMcNast folded before Flop
Seat 5: chiyuki folded before Flop (didn't bet)
Seat 6: 4ydo yogurt folded before Flop (didn't bet)
Seat 7: TraderYao folded before Flop (didn't bet)
Seat 8: DooMSDaY1337 collected ($1.85)
Seat 9: RomarioJa folded before Flop (didn't bet)



PokerStars Zoom Hand #84298735478:  Hold'em No Limit ($0.10/$0.25) - 2012/08/05 13:32:13 JST [2012/08/05 0:32:13 ET]
Table 'Whirlpool' 9-max Seat #1 is the button
Seat 1: Nerkit ($11.65 in chips) 
Seat 2: chiyuki ($39.74 in chips) 
Seat 3: Alvinpe85 ($27.54 in chips) 
Seat 4: masterkoolb ($12.50 in chips) 
Seat 5: munky3 ($34.91 in chips) 
Seat 6: deadmoneykid ($23.62 in chips) 
Seat 7: Anafim ($12.50 in chips) 
Seat 8: KeLevro0 ($12.15 in chips) 
Seat 9: fwani ($32.84 in chips) 
chiyuki: posts small blind $0.10
Alvinpe85: posts big blind $0.25
*** HOLE CARDS ***
Dealt to chiyuki [6c Jd]
masterkoolb: folds 
munky3: folds 
deadmoneykid: folds 
Anafim: folds 
KeLevro0: folds 
fwani: folds 
Nerkit: folds 
chiyuki: folds 
Uncalled bet ($0.15) returned to Alvinpe85
Alvinpe85 collected $0.20 from pot
Alvinpe85: doesn't show hand 
*** SUMMARY ***
Total pot $0.20 | Rake $0 
Seat 1: Nerkit (button) folded before Flop (didn't bet)
Seat 2: chiyuki (small blind) folded before Flop
Seat 3: Alvinpe85 (big blind) collected ($0.20)
Seat 4: masterkoolb folded before Flop (didn't bet)
Seat 5: munky3 folded before Flop (didn't bet)
Seat 6: deadmoneykid folded before Flop (didn't bet)
Seat 7: Anafim folded before Flop (didn't bet)
Seat 8: KeLevro0 folded before Flop (didn't bet)
Seat 9: fwani folded before Flop (didn't bet)



PokerStars Zoom Hand #84298731166:  Hold'em No Limit ($0.10/$0.25) - 2012/08/05 13:31:57 JST [2012/08/05 0:31:57 ET]
Table 'Whirlpool' 9-max Seat #1 is the button
Seat 1: fwani ($31.16 in chips) 
Seat 2: NastyMcNast ($31.40 in chips) 
Seat 3: diez007 ($16.16 in chips) 
Seat 4: wtu1986 ($26.25 in chips) 
Seat 5: Dejacob ($25.54 in chips) 
Seat 6: masterkoolb ($12.50 in chips) 
Seat 7: deadmoneykid ($25.96 in chips) 
Seat 8: luyifei ($23.67 in chips) 
Seat 9: chiyuki ($39.74 in chips) 
NastyMcNast: posts small blind $0.10
diez007: posts big blind $0.25
*** HOLE CARDS ***
Dealt to chiyuki [4c Ks]
wtu1986: folds 
Dejacob: folds 
masterkoolb: folds 
deadmoneykid: folds 
luyifei: calls $0.25
chiyuki: folds 
fwani: folds 
NastyMcNast: folds 
diez007: checks 
*** FLOP *** [Jc 2h 4d]
diez007: bets $0.50
luyifei: raises $0.50 to $1
diez007: calls $0.50
*** TURN *** [Jc 2h 4d] [Tc]
diez007: checks 
luyifei: checks 
*** RIVER *** [Jc 2h 4d Tc] [As]
diez007: checks 
luyifei: bets $0.75
diez007: calls $0.75
*** SHOW DOWN ***
luyifei: shows [Ad 6d] (a pair of Aces)
diez007: mucks hand 
luyifei collected $3.92 from pot
*** SUMMARY ***
Total pot $4.10 | Rake $0.18 
Board [Jc 2h 4d Tc As]
Seat 1: fwani (button) folded before Flop (didn't bet)
Seat 2: NastyMcNast (small blind) folded before Flop
Seat 3: diez007 (big blind) mucked [Qd Js]
Seat 4: wtu1986 folded before Flop (didn't bet)
Seat 5: Dejacob folded before Flop (didn't bet)
Seat 6: masterkoolb folded before Flop (didn't bet)
Seat 7: deadmoneykid folded before Flop (didn't bet)
Seat 8: luyifei showed [Ad 6d] and won ($3.92) with a pair of Aces
Seat 9: chiyuki folded before Flop (didn't bet)



PokerStars Zoom Hand #84298739849:  Hold'em No Limit ($0.10/$0.25) - 2012/08/05 13:32:29 JST [2012/08/05 0:32:29 ET]
Table 'Whirlpool' 9-max Seat #1 is the button
Seat 1: chiyuki ($39.64 in chips) 
Seat 2: peng2astic ($9.33 in chips) 
Seat 3: deadmoneykid ($25.96 in chips) 
Seat 4: PetitAlejo ($27.89 in chips) 
Seat 5: carlosrbr ($12.50 in chips) 
Seat 6: ygoegoe ($25 in chips) 
Seat 7: 4ydo yogurt ($6.04 in chips) 
Seat 8: 5zzzz33 ($14 in chips) 
Seat 9: vit 111 ($32.07 in chips) 
peng2astic: posts small blind $0.10
deadmoneykid: posts big blind $0.25
*** HOLE CARDS ***
Dealt to chiyuki [Kd Qh]
PetitAlejo: folds 
carlosrbr: folds 
ygoegoe: folds 
4ydo yogurt: raises $0.50 to $0.75
5zzzz33: calls $0.75
vit 111: calls $0.75
chiyuki: folds 
peng2astic: folds 
deadmoneykid: folds 
*** FLOP *** [2c 7d 3s]
4ydo yogurt: checks 
5zzzz33: checks 
vit 111: bets $3.25
4ydo yogurt: folds 
5zzzz33: folds 
Uncalled bet ($3.25) returned to vit 111
vit 111 collected $2.48 from pot
vit 111: doesn't show hand 
*** SUMMARY ***
Total pot $2.60 | Rake $0.12 
Board [2c 7d 3s]
Seat 1: chiyuki (button) folded before Flop (didn't bet)
Seat 2: peng2astic (small blind) folded before Flop
Seat 3: deadmoneykid (big blind) folded before Flop
Seat 4: PetitAlejo folded before Flop (didn't bet)
Seat 5: carlosrbr folded before Flop (didn't bet)
Seat 6: ygoegoe folded before Flop (didn't bet)
Seat 7: 4ydo yogurt folded on the Flop
Seat 8: 5zzzz33 folded on the Flop
Seat 9: vit 111 collected ($2.48)



PokerStars Zoom Hand #84298745706:  Hold'em No Limit ($0.10/$0.25) - 2012/08/05 13:32:52 JST [2012/08/05 0:32:52 ET]
Table 'Whirlpool' 9-max Seat #1 is the button
Seat 1: ShockLaMuc ($33.52 in chips) 
Seat 2: Catrban ($37.14 in chips) 
Seat 3: RomarioJa ($7.69 in chips) 
Seat 4: gedavaca ($44.96 in chips) 
Seat 5: gunbowler ($91.36 in chips) 
Seat 6: seula i ($25 in chips) 
Seat 7: chiyuki ($39.64 in chips) 
Seat 8: a_tasmanian ($78.82 in chips) 
Seat 9: SlimeyGash ($4.21 in chips) 
Catrban: posts small blind $0.10
RomarioJa: posts big blind $0.25
*** HOLE CARDS ***
Dealt to chiyuki [Kd Kc]
gedavaca: folds 
gunbowler: folds 
seula i: folds 
chiyuki: raises $0.50 to $0.75
a_tasmanian: calls $0.75
SlimeyGash: folds 
ShockLaMuc: folds 
Catrban: folds 
RomarioJa: folds 
*** FLOP *** [Ad 2d 4d]
chiyuki: bets $0.88
a_tasmanian: calls $0.88
*** TURN *** [Ad 2d 4d] [Ac]
chiyuki: checks 
a_tasmanian: checks 
*** RIVER *** [Ad 2d 4d Ac] [Qs]
chiyuki: checks 
a_tasmanian: bets $1.25
chiyuki: calls $1.25
*** SHOW DOWN ***
a_tasmanian: shows [4c 4s] (a full house, Fours full of Aces)
chiyuki: mucks hand 
a_tasmanian collected $5.84 from pot
*** SUMMARY ***
Total pot $6.11 | Rake $0.27 
Board [Ad 2d 4d Ac Qs]
Seat 1: ShockLaMuc (button) folded before Flop (didn't bet)
Seat 2: Catrban (small blind) folded before Flop
Seat 3: RomarioJa (big blind) folded before Flop
Seat 4: gedavaca folded before Flop (didn't bet)
Seat 5: gunbowler folded before Flop (didn't bet)
Seat 6: seula i folded before Flop (didn't bet)
Seat 7: chiyuki mucked [Kd Kc]
Seat 8: a_tasmanian showed [4c 4s] and won ($5.84) with a full house, Fours full of Aces
Seat 9: SlimeyGash folded before Flop (didn't bet)



PokerStars Zoom Hand #84298744345:  Hold'em No Limit ($0.10/$0.25) - 2012/08/05 13:32:47 JST [2012/08/05 0:32:47 ET]
Table 'Whirlpool' 9-max Seat #1 is the button
Seat 1: Catrban ($37.14 in chips) 
Seat 2: huepink ($25.10 in chips) 
Seat 3: Th3Fog ($66.80 in chips) 
Seat 4: a_tasmanian ($78.82 in chips) 
Seat 5: NastyMcNast ($53.31 in chips) 
Seat 6: chiyuki ($39.64 in chips) 
Seat 7: BlackZafiro ($25 in chips) 
Seat 8: DooMSDaY1337 ($92.91 in chips) 
Seat 9: diez007 ($14.16 in chips) 
huepink: posts small blind $0.10
Th3Fog: posts big blind $0.25
*** HOLE CARDS ***
Dealt to chiyuki [Td Ac]
a_tasmanian: folds 
NastyMcNast: raises $0.50 to $0.75
chiyuki: folds 
BlackZafiro: folds 
DooMSDaY1337: raises $1.50 to $2.25
diez007: folds 
Catrban: folds 
huepink: folds 
Th3Fog: folds 
NastyMcNast: raises $2.85 to $5.10
DooMSDaY1337: calls $2.85
*** FLOP *** [Jc 6c Ah]
NastyMcNast: checks 
DooMSDaY1337: bets $5.04
NastyMcNast: calls $5.04
*** TURN *** [Jc 6c Ah] [Jd]
NastyMcNast: checks 
DooMSDaY1337: checks 
*** RIVER *** [Jc 6c Ah Jd] [4h]
NastyMcNast: bets $7.88
DooMSDaY1337: folds 
Uncalled bet ($7.88) returned to NastyMcNast
NastyMcNast collected $19.70 from pot
NastyMcNast: doesn't show hand 
*** SUMMARY ***
Total pot $20.63 | Rake $0.93 
Board [Jc 6c Ah Jd 4h]
Seat 1: Catrban (button) folded before Flop (didn't bet)
Seat 2: huepink (small blind) folded before Flop
Seat 3: Th3Fog (big blind) folded before Flop
Seat 4: a_tasmanian folded before Flop (didn't bet)
Seat 5: NastyMcNast collected ($19.70)
Seat 6: chiyuki folded before Flop (didn't bet)
Seat 7: BlackZafiro folded before Flop (didn't bet)
Seat 8: DooMSDaY1337 folded on the River
Seat 9: diez007 folded before Flop (didn't bet)



PokerStars Zoom Hand #84298761269:  Hold'em No Limit ($0.10/$0.25) - 2012/08/05 13:33:51 JST [2012/08/05 0:33:51 ET]
Table 'Whirlpool' 9-max Seat #1 is the button
Seat 1: chiyuki ($36.76 in chips) 
Seat 2: Jippyflip ($18.60 in chips) 
Seat 3: DooMSDaY1337 ($60.01 in chips) 
Seat 4: carlosrbr ($12.50 in chips) 
Seat 5: taksist889 ($24.11 in chips) 
Seat 6: eduvazsilva ($14.80 in chips) 
Seat 7: a_tasmanian ($81.78 in chips) 
Seat 8: SlimeyGash ($2.46 in chips) 
Seat 9: Landybob ($31.99 in chips) 
Jippyflip: posts small blind $0.10
DooMSDaY1337: posts big blind $0.25
*** HOLE CARDS ***
Dealt to chiyuki [Qc 9s]
carlosrbr: raises $0.50 to $0.75
taksist889 has timed out
taksist889: folds 
eduvazsilva: folds 
a_tasmanian: folds 
SlimeyGash: folds 
Landybob: folds 
chiyuki: folds 
Jippyflip: folds 
DooMSDaY1337: folds 
Uncalled bet ($0.50) returned to carlosrbr
carlosrbr collected $0.60 from pot
carlosrbr: doesn't show hand 
*** SUMMARY ***
Total pot $0.60 | Rake $0 
Seat 1: chiyuki (button) folded before Flop (didn't bet)
Seat 2: Jippyflip (small blind) folded before Flop
Seat 3: DooMSDaY1337 (big blind) folded before Flop
Seat 4: carlosrbr collected ($0.60)
Seat 5: taksist889 folded before Flop (didn't bet)
Seat 6: eduvazsilva folded before Flop (didn't bet)
Seat 7: a_tasmanian folded before Flop (didn't bet)
Seat 8: SlimeyGash folded before Flop (didn't bet)
Seat 9: Landybob folded before Flop (didn't bet)



PokerStars Zoom Hand #84298762064:  Hold'em No Limit ($0.10/$0.25) - 2012/08/05 13:33:54 JST [2012/08/05 0:33:54 ET]
Table 'Whirlpool' 9-max Seat #1 is the button
Seat 1: Alvinpe85 ($27.29 in chips) 
Seat 2: hirozo ($36.09 in chips) 
Seat 3: chiyuki ($36.76 in chips) 
Seat 4: fwani ($32.84 in chips) 
Seat 5: Th3Fog ($66.30 in chips) 
Seat 6: slapshot2011 ($44.31 in chips) 
Seat 7: wtu1986 ($25.53 in chips) 
Seat 8: ygoegoe ($27.20 in chips) 
Seat 9: Lasutchik ($31.22 in chips) 
hirozo: posts small blind $0.10
chiyuki: posts big blind $0.25
*** HOLE CARDS ***
Dealt to chiyuki [Ts 4h]
fwani: folds 
Th3Fog: folds 
slapshot2011: calls $0.25
wtu1986: folds 
ygoegoe: folds 
Lasutchik: folds 
Alvinpe85: folds 
hirozo: folds 
chiyuki: checks 
*** FLOP *** [Ad Td 6h]
chiyuki: checks 
slapshot2011: bets $0.50
chiyuki: folds 
Uncalled bet ($0.50) returned to slapshot2011
slapshot2011 collected $0.57 from pot
slapshot2011: doesn't show hand 
*** SUMMARY ***
Total pot $0.60 | Rake $0.03 
Board [Ad Td 6h]
Seat 1: Alvinpe85 (button) folded before Flop (didn't bet)
Seat 2: hirozo (small blind) folded before Flop
Seat 3: chiyuki (big blind) folded on the Flop
Seat 4: fwani folded before Flop (didn't bet)
Seat 5: Th3Fog folded before Flop (didn't bet)
Seat 6: slapshot2011 collected ($0.57)
Seat 7: wtu1986 folded before Flop (didn't bet)
Seat 8: ygoegoe folded before Flop (didn't bet)
Seat 9: Lasutchik folded before Flop (didn't bet)



PokerStars Zoom Hand #84298771730:  Hold'em No Limit ($0.10/$0.25) - 2012/08/05 13:34:30 JST [2012/08/05 0:34:30 ET]
Table 'Whirlpool' 9-max Seat #1 is the button
Seat 1: PetitAlejo ($29.64 in chips) 
Seat 2: NastyMcNast ($33.25 in chips) 
Seat 3: ShockLaMuc ($39.49 in chips) 
Seat 4: deadmoneykid ($23.27 in chips) 
Seat 5: chiyuki ($36.51 in chips) 
Seat 6: leo2095 ($15.17 in chips) 
Seat 7: BlackZafiro ($25.10 in chips) 
Seat 8: Dejacob ($25 in chips) 
Seat 9: trusbi_na_go ($10.39 in chips) 
NastyMcNast: posts small blind $0.10
ShockLaMuc: posts big blind $0.25
*** HOLE CARDS ***
Dealt to chiyuki [Qc Ks]
deadmoneykid: folds 
chiyuki: folds 
leo2095: folds 
BlackZafiro: folds 
Dejacob: folds 
trusbi_na_go: folds 
PetitAlejo: folds 
NastyMcNast: folds 
Uncalled bet ($0.15) returned to ShockLaMuc
ShockLaMuc collected $0.20 from pot
ShockLaMuc: doesn't show hand 
*** SUMMARY ***
Total pot $0.20 | Rake $0 
Seat 1: PetitAlejo (button) folded before Flop (didn't bet)
Seat 2: NastyMcNast (small blind) folded before Flop
Seat 3: ShockLaMuc (big blind) collected ($0.20)
Seat 4: deadmoneykid folded before Flop (didn't bet)
Seat 5: chiyuki folded before Flop (didn't bet)
Seat 6: leo2095 folded before Flop (didn't bet)
Seat 7: BlackZafiro folded before Flop (didn't bet)
Seat 8: Dejacob folded before Flop (didn't bet)
Seat 9: trusbi_na_go folded before Flop (didn't bet)



PokerStars Zoom Hand #84298770139:  Hold'em No Limit ($0.10/$0.25) - 2012/08/05 13:34:24 JST [2012/08/05 0:34:24 ET]
Table 'Whirlpool' 9-max Seat #1 is the button
Seat 1: jethaz ($28.89 in chips) 
Seat 2: BlOnDhOlIc ($33.67 in chips) 
Seat 3: TraderYao ($26.50 in chips) 
Seat 4: leo2095 ($15.17 in chips) 
Seat 5: Loholov ($15 in chips) 
Seat 6: seula i ($36.08 in chips) 
Seat 7: Th3Fog ($66.30 in chips) 
Seat 8: chiyuki ($36.51 in chips) 
Seat 9: Nerkit ($11.65 in chips) 
BlOnDhOlIc: posts small blind $0.10
TraderYao: posts big blind $0.25
*** HOLE CARDS ***
Dealt to chiyuki [5s Th]
leo2095: folds 
Loholov: folds 
seula i: raises $0.50 to $0.75
Th3Fog: folds 
chiyuki: folds 
Nerkit: folds 
jethaz: folds 
BlOnDhOlIc: calls $0.65
TraderYao: folds 
*** FLOP *** [4d 2s Kc]
BlOnDhOlIc: checks 
seula i: bets $1.25
BlOnDhOlIc: raises $2 to $3.25
seula i: folds 
Uncalled bet ($2) returned to BlOnDhOlIc
BlOnDhOlIc collected $4.06 from pot
BlOnDhOlIc: doesn't show hand 
*** SUMMARY ***
Total pot $4.25 | Rake $0.19 
Board [4d 2s Kc]
Seat 1: jethaz (button) folded before Flop (didn't bet)
Seat 2: BlOnDhOlIc (small blind) collected ($4.06)
Seat 3: TraderYao (big blind) folded before Flop
Seat 4: leo2095 folded before Flop (didn't bet)
Seat 5: Loholov folded before Flop (didn't bet)
Seat 6: seula i folded on the Flop
Seat 7: Th3Fog folded before Flop (didn't bet)
Seat 8: chiyuki folded before Flop (didn't bet)
Seat 9: Nerkit folded before Flop (didn't bet)



PokerStars Zoom Hand #84298777632:  Hold'em No Limit ($0.10/$0.25) - 2012/08/05 13:34:53 JST [2012/08/05 0:34:53 ET]
Table 'Whirlpool' 9-max Seat #1 is the button
Seat 1: peng2astic ($9.78 in chips) 
Seat 2: NastyMcNast ($45.81 in chips) 
Seat 3: ygoegoe ($27.12 in chips) 
Seat 4: slapshot2011 ($44.28 in chips) 
Seat 5: Anafim ($12.50 in chips) 
Seat 6: Th3Fog ($55.10 in chips) 
Seat 7: TErr18 ($25.30 in chips) 
Seat 8: TamiKarpen13 ($16.51 in chips) 
Seat 9: chiyuki ($36.41 in chips) 
NastyMcNast: posts small blind $0.10
ygoegoe: posts big blind $0.25
*** HOLE CARDS ***
Dealt to chiyuki [Kc Qs]
slapshot2011: folds 
Anafim: folds 
Th3Fog: folds 
TErr18: folds 
TamiKarpen13: folds 
chiyuki: raises $0.50 to $0.75
peng2astic: folds 
NastyMcNast: raises $1.55 to $2.30
ygoegoe: folds 
chiyuki: folds 
Uncalled bet ($1.55) returned to NastyMcNast
NastyMcNast collected $1.75 from pot
NastyMcNast: doesn't show hand 
*** SUMMARY ***
Total pot $1.75 | Rake $0 
Seat 1: peng2astic (button) folded before Flop (didn't bet)
Seat 2: NastyMcNast (small blind) collected ($1.75)
Seat 3: ygoegoe (big blind) folded before Flop
Seat 4: slapshot2011 folded before Flop (didn't bet)
Seat 5: Anafim folded before Flop (didn't bet)
Seat 6: Th3Fog folded before Flop (didn't bet)
Seat 7: TErr18 folded before Flop (didn't bet)
Seat 8: TamiKarpen13 folded before Flop (didn't bet)
Seat 9: chiyuki folded before Flop



PokerStars Zoom Hand #84298785155:  Hold'em No Limit ($0.10/$0.25) - 2012/08/05 13:35:22 JST [2012/08/05 0:35:22 ET]
Table 'Whirlpool' 9-max Seat #1 is the button
Seat 1: Landybob ($32.34 in chips) 
Seat 2: goldstone ($27.43 in chips) 
Seat 3: seula i ($47.27 in chips) 
Seat 4: PetitAlejo ($30.34 in chips) 
Seat 5: ShockLaMuc ($17.91 in chips) 
Seat 6: chiyuki ($35.66 in chips) 
Seat 7: wtu1986 ($25.53 in chips) 
Seat 8: agurio ($30.05 in chips) 
Seat 9: carlosrbr ($12.85 in chips) 
goldstone: posts small blind $0.10
seula i: posts big blind $0.25
*** HOLE CARDS ***
Dealt to chiyuki [2c 3h]
PetitAlejo: folds 
ShockLaMuc: folds 
chiyuki: folds 
wtu1986: folds 
agurio: folds 
carlosrbr: folds 
Landybob: folds 
goldstone: raises $0.30 to $0.55
seula i: folds 
Uncalled bet ($0.30) returned to goldstone
goldstone collected $0.50 from pot
goldstone: doesn't show hand 
*** SUMMARY ***
Total pot $0.50 | Rake $0 
Seat 1: Landybob (button) folded before Flop (didn't bet)
Seat 2: goldstone (small blind) collected ($0.50)
Seat 3: seula i (big blind) folded before Flop
Seat 4: PetitAlejo folded before Flop (didn't bet)
Seat 5: ShockLaMuc folded before Flop (didn't bet)
Seat 6: chiyuki folded before Flop (didn't bet)
Seat 7: wtu1986 folded before Flop (didn't bet)
Seat 8: agurio folded before Flop (didn't bet)
Seat 9: carlosrbr folded before Flop (didn't bet)



PokerStars Zoom Hand #84298773076:  Hold'em No Limit ($0.10/$0.25) - 2012/08/05 13:34:35 JST [2012/08/05 0:34:35 ET]
Table 'Whirlpool' 9-max Seat #1 is the button
Seat 1: ShockLaMuc ($16.43 in chips) 
Seat 2: chiyuki ($36.51 in chips) 
Seat 3: Jippyflip ($18.15 in chips) 
Seat 4: KeLevro0 ($12.15 in chips) 
Seat 5: seula i ($25.70 in chips) 
Seat 6: NastyMcNast ($33.15 in chips) 
Seat 7: Dejacob ($25 in chips) 
Seat 8: Alvinpe85 ($26.94 in chips) 
Seat 9: diez007 ($14.06 in chips) 
chiyuki: posts small blind $0.10
Jippyflip: posts big blind $0.25
*** HOLE CARDS ***
Dealt to chiyuki [6d 5d]
KeLevro0: raises $0.42 to $0.67
seula i: folds 
NastyMcNast: calls $0.67
Dejacob: folds 
Alvinpe85: folds 
diez007: folds 
ShockLaMuc: folds 
chiyuki: folds 
Jippyflip: folds 
*** FLOP *** [9c 9s Js]
KeLevro0: bets $0.90
NastyMcNast: calls $0.90
*** TURN *** [9c 9s Js] [Td]
KeLevro0: bets $1.25
NastyMcNast: calls $1.25
*** RIVER *** [9c 9s Js Td] [Kh]
KeLevro0: checks 
NastyMcNast: bets $2.28
KeLevro0: folds 
Uncalled bet ($2.28) returned to NastyMcNast
NastyMcNast collected $5.72 from pot
NastyMcNast: doesn't show hand 
*** SUMMARY ***
Total pot $5.99 | Rake $0.27 
Board [9c 9s Js Td Kh]
Seat 1: ShockLaMuc (button) folded before Flop (didn't bet)
Seat 2: chiyuki (small blind) folded before Flop
Seat 3: Jippyflip (big blind) folded before Flop
Seat 4: KeLevro0 folded on the River
Seat 5: seula i folded before Flop (didn't bet)
Seat 6: NastyMcNast collected ($5.72)
Seat 7: Dejacob folded before Flop (didn't bet)
Seat 8: Alvinpe85 folded before Flop (didn't bet)
Seat 9: diez007 folded before Flop (didn't bet)



PokerStars Zoom Hand #84298789119:  Hold'em No Limit ($0.10/$0.25) - 2012/08/05 13:35:37 JST [2012/08/05 0:35:37 ET]
Table 'Whirlpool' 9-max Seat #1 is the button
Seat 1: jtedecaliss ($136.65 in chips) 
Seat 2: Anafim ($14.09 in chips) 
Seat 3: gedavaca ($44.78 in chips) 
Seat 4: cR!Ma*aRm ($30.41 in chips) 
Seat 5: chiyuki ($35.66 in chips) 
Seat 6: munky3 ($34.40 in chips) 
Seat 7: wtu1986 ($25 in chips) 
Seat 8: TamiKarpen13 ($16.16 in chips) 
Seat 9: Alvinpe85 ($26.84 in chips) 
Anafim: posts small blind $0.10
gedavaca: posts big blind $0.25
*** HOLE CARDS ***
Dealt to chiyuki [Qd 3d]
cR!Ma*aRm: raises $0.25 to $0.50
chiyuki: folds 
munky3: folds 
wtu1986: folds 
TamiKarpen13: folds 
Alvinpe85: folds 
jtedecaliss: folds 
Anafim: folds 
gedavaca: calls $0.25
*** FLOP *** [Td 4s 9d]
gedavaca: checks 
cR!Ma*aRm: bets $0.50
gedavaca: calls $0.50
*** TURN *** [Td 4s 9d] [Qs]
gedavaca: checks 
cR!Ma*aRm: bets $1
gedavaca: folds 
Uncalled bet ($1) returned to cR!Ma*aRm
cR!Ma*aRm collected $2.01 from pot
cR!Ma*aRm: doesn't show hand 
*** SUMMARY ***
Total pot $2.10 | Rake $0.09 
Board [Td 4s 9d Qs]
Seat 1: jtedecaliss (button) folded before Flop (didn't bet)
Seat 2: Anafim (small blind) folded before Flop
Seat 3: gedavaca (big blind) folded on the Turn
Seat 4: cR!Ma*aRm collected ($2.01)
Seat 5: chiyuki folded before Flop (didn't bet)
Seat 6: munky3 folded before Flop (didn't bet)
Seat 7: wtu1986 folded before Flop (didn't bet)
Seat 8: TamiKarpen13 folded before Flop (didn't bet)
Seat 9: Alvinpe85 folded before Flop (didn't bet)



PokerStars Zoom Hand #84298790699:  Hold'em No Limit ($0.10/$0.25) - 2012/08/05 13:35:43 JST [2012/08/05 0:35:43 ET]
Table 'Whirlpool' 9-max Seat #1 is the button
Seat 1: BlackZafiro ($25.10 in chips) 
Seat 2: goldstone ($37.52 in chips) 
Seat 3: Suhoff76 ($25 in chips) 
Seat 4: Alvinpe85 ($26.84 in chips) 
Seat 5: taiali ($16.62 in chips) 
Seat 6: vit 111 ($34.66 in chips) 
Seat 7: KeLevro0 ($12.50 in chips) 
Seat 8: chiyuki ($35.66 in chips) 
Seat 9: Loholov ($15 in chips) 
goldstone: posts small blind $0.10
Suhoff76: posts big blind $0.25
*** HOLE CARDS ***
Dealt to chiyuki [Jh 7c]
Alvinpe85: folds 
taiali: folds 
vit 111: folds 
KeLevro0: folds 
chiyuki: folds 
Loholov: folds 
BlackZafiro: folds 
goldstone: raises $0.50 to $0.75
Suhoff76: folds 
Uncalled bet ($0.50) returned to goldstone
goldstone collected $0.50 from pot
goldstone: doesn't show hand 
*** SUMMARY ***
Total pot $0.50 | Rake $0 
Seat 1: BlackZafiro (button) folded before Flop (didn't bet)
Seat 2: goldstone (small blind) collected ($0.50)
Seat 3: Suhoff76 (big blind) folded before Flop
Seat 4: Alvinpe85 folded before Flop (didn't bet)
Seat 5: taiali folded before Flop (didn't bet)
Seat 6: vit 111 folded before Flop (didn't bet)
Seat 7: KeLevro0 folded before Flop (didn't bet)
Seat 8: chiyuki folded before Flop (didn't bet)
Seat 9: Loholov folded before Flop (didn't bet)



PokerStars Zoom Hand #84298793073:  Hold'em No Limit ($0.10/$0.25) - 2012/08/05 13:35:52 JST [2012/08/05 0:35:52 ET]
Table 'Whirlpool' 9-max Seat #1 is the button
Seat 1: Ellen1947 ($26.60 in chips) 
Seat 2: Suhoff76 ($25 in chips) 
Seat 3: Th3Fog ($24.69 in chips) 
Seat 4: jtedecaliss ($136.65 in chips) 
Seat 5: chiyuki ($35.66 in chips) 
Seat 6: wtu1986 ($25.53 in chips) 
Seat 7: Catrban ($36.71 in chips) 
Seat 8: agurio ($25 in chips) 
Seat 9: Dejacob ($25.92 in chips) 
Suhoff76: posts small blind $0.10
Th3Fog: posts big blind $0.25
*** HOLE CARDS ***
Dealt to chiyuki [Js 5h]
jtedecaliss: folds 
chiyuki: folds 
wtu1986: folds 
Catrban: folds 
agurio: folds 
Dejacob: raises $0.50 to $0.75
Ellen1947: folds 
Suhoff76: folds 
Th3Fog: folds 
Uncalled bet ($0.50) returned to Dejacob
Dejacob collected $0.60 from pot
Dejacob: doesn't show hand 
*** SUMMARY ***
Total pot $0.60 | Rake $0 
Seat 1: Ellen1947 (button) folded before Flop (didn't bet)
Seat 2: Suhoff76 (small blind) folded before Flop
Seat 3: Th3Fog (big blind) folded before Flop
Seat 4: jtedecaliss folded before Flop (didn't bet)
Seat 5: chiyuki folded before Flop (didn't bet)
Seat 6: wtu1986 folded before Flop (didn't bet)
Seat 7: Catrban folded before Flop (didn't bet)
Seat 8: agurio folded before Flop (didn't bet)
Seat 9: Dejacob collected ($0.60)



PokerStars Zoom Hand #84298787514:  Hold'em No Limit ($0.10/$0.25) - 2012/08/05 13:35:31 JST [2012/08/05 0:35:31 ET]
Table 'Whirlpool' 9-max Seat #1 is the button
Seat 1: TamiKarpen13 ($16.16 in chips) 
Seat 2: BlOnDhOlIc ($34.36 in chips) 
Seat 3: SlimeyGash ($2.81 in chips) 
Seat 4: chiyuki ($35.66 in chips) 
Seat 5: agurio ($30.05 in chips) 
Seat 6: leo2095 ($14.57 in chips) 
Seat 7: KINGKILERACE ($6.25 in chips) 
Seat 8: ShockLaMuc ($39.04 in chips) 
Seat 9: kkbruins0408 ($12.18 in chips) 
BlOnDhOlIc: posts small blind $0.10
SlimeyGash: posts big blind $0.25
*** HOLE CARDS ***
Dealt to chiyuki [3h 3s]
chiyuki: folds 
agurio: folds 
leo2095: folds 
KINGKILERACE: folds 
ShockLaMuc: folds 
kkbruins0408: folds 
TamiKarpen13: folds 
BlOnDhOlIc: raises $0.25 to $0.50
SlimeyGash: raises $2.31 to $2.81 and is all-in
BlOnDhOlIc: calls $2.31
*** FLOP *** [8h Ac Qd]
*** TURN *** [8h Ac Qd] [Qc]
*** RIVER *** [8h Ac Qd Qc] [4d]
*** SHOW DOWN ***
BlOnDhOlIc: shows [2s 2c] (two pair, Queens and Deuces)
SlimeyGash: shows [7c 7s] (two pair, Queens and Sevens)
SlimeyGash collected $5.37 from pot
*** SUMMARY ***
Total pot $5.62 | Rake $0.25 
Board [8h Ac Qd Qc 4d]
Seat 1: TamiKarpen13 (button) folded before Flop (didn't bet)
Seat 2: BlOnDhOlIc (small blind) showed [2s 2c] and lost with two pair, Queens and Deuces
Seat 3: SlimeyGash (big blind) showed [7c 7s] and won ($5.37) with two pair, Queens and Sevens
Seat 4: chiyuki folded before Flop (didn't bet)
Seat 5: agurio folded before Flop (didn't bet)
Seat 6: leo2095 folded before Flop (didn't bet)
Seat 7: KINGKILERACE folded before Flop (didn't bet)
Seat 8: ShockLaMuc folded before Flop (didn't bet)
Seat 9: kkbruins0408 folded before Flop (didn't bet)



PokerStars Zoom Hand #84298791471:  Hold'em No Limit ($0.10/$0.25) - 2012/08/05 13:35:46 JST [2012/08/05 0:35:46 ET]
Table 'Whirlpool' 9-max Seat #1 is the button
Seat 1: DooMSDaY1337 ($95.58 in chips) 
Seat 2: diez007 ($18.35 in chips) 
Seat 3: deadmoneykid ($22.67 in chips) 
Seat 4: wtu1986 ($25.53 in chips) 
Seat 5: seula i ($47.02 in chips) 
Seat 6: a_tasmanian ($82.81 in chips) 
Seat 7: chiyuki ($35.66 in chips) 
Seat 8: jethaz ($53.15 in chips) 
Seat 9: TamiKarpen13 ($16.16 in chips) 
diez007: posts small blind $0.10
deadmoneykid: posts big blind $0.25
*** HOLE CARDS ***
Dealt to chiyuki [3h 6s]
wtu1986: folds 
seula i: folds 
a_tasmanian: folds 
chiyuki: folds 
jethaz: folds 
TamiKarpen13: calls $0.25
DooMSDaY1337: raises $0.75 to $1
diez007: folds 
deadmoneykid: folds 
TamiKarpen13: calls $0.75
*** FLOP *** [5d Jd 6d]
TamiKarpen13: checks 
DooMSDaY1337: checks 
*** TURN *** [5d Jd 6d] [4c]
TamiKarpen13: checks 
DooMSDaY1337: checks 
*** RIVER *** [5d Jd 6d 4c] [7s]
TamiKarpen13: checks 
DooMSDaY1337: checks 
*** SHOW DOWN ***
TamiKarpen13: shows [Qc 6c] (a pair of Sixes)
DooMSDaY1337: mucks hand 
TamiKarpen13 collected $2.24 from pot
*** SUMMARY ***
Total pot $2.35 | Rake $0.11 
Board [5d Jd 6d 4c 7s]
Seat 1: DooMSDaY1337 (button) mucked [Ad Tc]
Seat 2: diez007 (small blind) folded before Flop
Seat 3: deadmoneykid (big blind) folded before Flop
Seat 4: wtu1986 folded before Flop (didn't bet)
Seat 5: seula i folded before Flop (didn't bet)
Seat 6: a_tasmanian folded before Flop (didn't bet)
Seat 7: chiyuki folded before Flop (didn't bet)
Seat 8: jethaz folded before Flop (didn't bet)
Seat 9: TamiKarpen13 showed [Qc 6c] and won ($2.24) with a pair of Sixes



PokerStars Zoom Hand #84298792290:  Hold'em No Limit ($0.10/$0.25) - 2012/08/05 13:35:49 JST [2012/08/05 0:35:49 ET]
Table 'Whirlpool' 9-max Seat #1 is the button
Seat 1: goldstone ($27.68 in chips) 
Seat 2: D@vidMed ($12.45 in chips) 
Seat 3: Anafim ($13.99 in chips) 
Seat 4: chiyuki ($35.66 in chips) 
Seat 5: BlOnDhOlIc ($25.95 in chips) 
Seat 6: KeLevro0 ($12.50 in chips) 
Seat 7: taiali ($16.62 in chips) 
Seat 8: Lasutchik ($31.68 in chips) 
Seat 9: Loholov ($24.46 in chips) 
D@vidMed: posts small blind $0.10
Anafim: posts big blind $0.25
*** HOLE CARDS ***
Dealt to chiyuki [4d Qh]
chiyuki: folds 
BlOnDhOlIc: raises $0.37 to $0.62
KeLevro0: raises $1.63 to $2.25
taiali: folds 
Lasutchik: folds 
Loholov: folds 
goldstone: calls $2.25
D@vidMed: folds 
Anafim: folds 
BlOnDhOlIc: folds 
*** FLOP *** [5d Kh Ts]
KeLevro0: bets $2.92
goldstone: calls $2.92
*** TURN *** [5d Kh Ts] [Qc]
KeLevro0: bets $7.33 and is all-in
goldstone: folds 
Uncalled bet ($7.33) returned to KeLevro0
KeLevro0 collected $10.80 from pot
KeLevro0: doesn't show hand 
*** SUMMARY ***
Total pot $11.31 | Rake $0.51 
Board [5d Kh Ts Qc]
Seat 1: goldstone (button) folded on the Turn
Seat 2: D@vidMed (small blind) folded before Flop
Seat 3: Anafim (big blind) folded before Flop
Seat 4: chiyuki folded before Flop (didn't bet)
Seat 5: BlOnDhOlIc folded before Flop
Seat 6: KeLevro0 collected ($10.80)
Seat 7: taiali folded before Flop (didn't bet)
Seat 8: Lasutchik folded before Flop (didn't bet)
Seat 9: Loholov folded before Flop (didn't bet)



PokerStars Zoom Hand #84298794875:  Hold'em No Limit ($0.10/$0.25) - 2012/08/05 13:35:59 JST [2012/08/05 0:35:59 ET]
Table 'Whirlpool' 9-max Seat #1 is the button
Seat 1: PetitAlejo ($37.36 in chips) 
Seat 2: wtu1986 ($25 in chips) 
Seat 3: chiyuki ($35.66 in chips) 
Seat 4: eduvazsilva ($14.10 in chips) 
Seat 5: Th3Fog ($65.95 in chips) 
Seat 6: Anafim ($14.81 in chips) 
Seat 7: ZSIDD ($19.31 in chips) 
Seat 8: macr11111111 ($12.15 in chips) 
Seat 9: BlackZafiro ($25.10 in chips) 
wtu1986: posts small blind $0.10
chiyuki: posts big blind $0.25
*** HOLE CARDS ***
Dealt to chiyuki [6c 6d]
eduvazsilva: folds 
Th3Fog: folds 
Anafim: folds 
ZSIDD: calls $0.25
macr11111111: calls $0.25
BlackZafiro: folds 
PetitAlejo: folds 
wtu1986: folds 
chiyuki: checks 
*** FLOP *** [6h Ad Js]
chiyuki: bets $0.75
ZSIDD: calls $0.75
macr11111111: folds 
*** TURN *** [6h Ad Js] [Jc]
chiyuki: checks 
ZSIDD: bets $1.70
chiyuki: raises $3.30 to $5
ZSIDD: calls $3.30
*** RIVER *** [6h Ad Js Jc] [Kc]
chiyuki: bets $18.75
ZSIDD: calls $13.31 and is all-in
Uncalled bet ($5.44) returned to chiyuki
*** SHOW DOWN ***
chiyuki: shows [6c 6d] (a full house, Sixes full of Jacks)
ZSIDD: shows [Jh Kd] (a full house, Jacks full of Kings)
ZSIDD collected $37.22 from pot
*** SUMMARY ***
Total pot $38.97 | Rake $1.75 
Board [6h Ad Js Jc Kc]
Seat 1: PetitAlejo (button) folded before Flop (didn't bet)
Seat 2: wtu1986 (small blind) folded before Flop
Seat 3: chiyuki (big blind) showed [6c 6d] and lost with a full house, Sixes full of Jacks
Seat 4: eduvazsilva folded before Flop (didn't bet)
Seat 5: Th3Fog folded before Flop (didn't bet)
Seat 6: Anafim folded before Flop (didn't bet)
Seat 7: ZSIDD showed [Jh Kd] and won ($37.22) with a full house, Jacks full of Kings
Seat 8: macr11111111 folded on the Flop
Seat 9: BlackZafiro folded before Flop (didn't bet)



PokerStars Zoom Hand #84298816865:  Hold'em No Limit ($0.10/$0.25) - 2012/08/05 13:37:23 JST [2012/08/05 0:37:23 ET]
Table 'Whirlpool' 9-max Seat #1 is the button
Seat 1: chiyuki ($25 in chips) 
Seat 2: PetitAlejo ($25 in chips) 
Seat 3: ShockLaMuc ($14.67 in chips) 
Seat 4: wtu1986 ($24.65 in chips) 
Seat 5: Suhoff76 ($25 in chips) 
Seat 6: Paranoix1990 ($20.87 in chips) 
Seat 7: jethaz ($64.52 in chips) 
Seat 8: DooMSDaY1337 ($49.49 in chips) 
Seat 9: Roglus ($11.13 in chips) 
PetitAlejo: posts small blind $0.10
ShockLaMuc: posts big blind $0.25
*** HOLE CARDS ***
Dealt to chiyuki [Ah Kc]
wtu1986: folds 
Suhoff76: folds 
Paranoix1990: folds 
jethaz: folds 
DooMSDaY1337: folds 
Roglus: folds 
chiyuki: raises $0.50 to $0.75
PetitAlejo: folds 
ShockLaMuc: folds 
Uncalled bet ($0.50) returned to chiyuki
chiyuki collected $0.60 from pot
chiyuki: doesn't show hand 
*** SUMMARY ***
Total pot $0.60 | Rake $0 
Seat 1: chiyuki (button) collected ($0.60)
Seat 2: PetitAlejo (small blind) folded before Flop
Seat 3: ShockLaMuc (big blind) folded before Flop
Seat 4: wtu1986 folded before Flop (didn't bet)
Seat 5: Suhoff76 folded before Flop (didn't bet)
Seat 6: Paranoix1990 folded before Flop (didn't bet)
Seat 7: jethaz folded before Flop (didn't bet)
Seat 8: DooMSDaY1337 folded before Flop (didn't bet)
Seat 9: Roglus folded before Flop (didn't bet)



PokerStars Zoom Hand #84298822153:  Hold'em No Limit ($0.10/$0.25) - 2012/08/05 13:37:43 JST [2012/08/05 0:37:43 ET]
Table 'Whirlpool' 9-max Seat #1 is the button
Seat 1: Dejacob ($36.86 in chips) 
Seat 2: ygoegoe ($26.25 in chips) 
Seat 3: KeLevro0 ($8.24 in chips) 
Seat 4: Lasutchik ($31.33 in chips) 
Seat 5: jethaz ($64.52 in chips) 
Seat 6: BlackValaR ($12.50 in chips) 
Seat 7: ll_LaMeR_ll ($36.04 in chips) 
Seat 8: puffy5533 ($24.15 in chips) 
Seat 9: chiyuki ($25.25 in chips) 
ygoegoe: posts small blind $0.10
KeLevro0: posts big blind $0.25
*** HOLE CARDS ***
Dealt to chiyuki [Qd 6h]
Lasutchik: folds 
jethaz: folds 
BlackValaR: raises $0.25 to $0.50
ll_LaMeR_ll: folds 
puffy5533: folds 
chiyuki: folds 
Dejacob: folds 
ygoegoe: folds 
KeLevro0: folds 
Uncalled bet ($0.25) returned to BlackValaR
BlackValaR collected $0.60 from pot
BlackValaR: doesn't show hand 
*** SUMMARY ***
Total pot $0.60 | Rake $0 
Seat 1: Dejacob (button) folded before Flop (didn't bet)
Seat 2: ygoegoe (small blind) folded before Flop
Seat 3: KeLevro0 (big blind) folded before Flop
Seat 4: Lasutchik folded before Flop (didn't bet)
Seat 5: jethaz folded before Flop (didn't bet)
Seat 6: BlackValaR collected ($0.60)
Seat 7: ll_LaMeR_ll folded before Flop (didn't bet)
Seat 8: puffy5533 folded before Flop (didn't bet)
Seat 9: chiyuki folded before Flop (didn't bet)



PokerStars Zoom Hand #84298824017:  Hold'em No Limit ($0.10/$0.25) - 2012/08/05 13:37:50 JST [2012/08/05 0:37:50 ET]
Table 'Whirlpool' 9-max Seat #1 is the button
Seat 1: jethaz ($47.50 in chips) 
Seat 2: KeLevro0 ($17.88 in chips) 
Seat 3: mayathebee83 ($12.50 in chips) 
Seat 4: timburonps ($25 in chips) 
Seat 5: kkbruins0408 ($11.28 in chips) 
Seat 6: kamikkaze ($55.07 in chips) 
Seat 7: seula i ($52.59 in chips) 
Seat 8: chiyuki ($25.25 in chips) 
Seat 9: TraderYao ($25.05 in chips) 
KeLevro0: posts small blind $0.10
mayathebee83: posts big blind $0.25
*** HOLE CARDS ***
Dealt to chiyuki [5h Qc]
timburonps: folds 
kkbruins0408: folds 
kamikkaze: folds 
seula i: folds 
chiyuki: folds 
TraderYao: folds 
jethaz: folds 
KeLevro0: folds 
Uncalled bet ($0.15) returned to mayathebee83
mayathebee83 collected $0.20 from pot
mayathebee83: doesn't show hand 
*** SUMMARY ***
Total pot $0.20 | Rake $0 
Seat 1: jethaz (button) folded before Flop (didn't bet)
Seat 2: KeLevro0 (small blind) folded before Flop
Seat 3: mayathebee83 (big blind) collected ($0.20)
Seat 4: timburonps folded before Flop (didn't bet)
Seat 5: kkbruins0408 folded before Flop (didn't bet)
Seat 6: kamikkaze folded before Flop (didn't bet)
Seat 7: seula i folded before Flop (didn't bet)
Seat 8: chiyuki folded before Flop (didn't bet)
Seat 9: TraderYao folded before Flop (didn't bet)



PokerStars Zoom Hand #84298821087:  Hold'em No Limit ($0.10/$0.25) - 2012/08/05 13:37:39 JST [2012/08/05 0:37:39 ET]
Table 'Whirlpool' 9-max Seat #1 is the button
Seat 1: timburonps ($31.60 in chips) 
Seat 2: chiyuki ($25.35 in chips) 
Seat 3: PetitAlejo ($25 in chips) 
Seat 4: wtu1986 ($26.32 in chips) 
Seat 5: ShockLaMuc ($17.56 in chips) 
Seat 6: ladymadon107 ($25.03 in chips) 
Seat 7: jethaz ($64.52 in chips) 
Seat 8: TraderYao ($24.90 in chips) 
Seat 9: gunbowler ($137.88 in chips) 
chiyuki: posts small blind $0.10
PetitAlejo: posts big blind $0.25
*** HOLE CARDS ***
Dealt to chiyuki [5h 7d]
wtu1986: folds 
ShockLaMuc: folds 
ladymadon107: raises $0.25 to $0.50
jethaz: folds 
TraderYao: folds 
gunbowler: folds 
timburonps: folds 
chiyuki: folds 
PetitAlejo: folds 
Uncalled bet ($0.25) returned to ladymadon107
ladymadon107 collected $0.60 from pot
ladymadon107: doesn't show hand 
*** SUMMARY ***
Total pot $0.60 | Rake $0 
Seat 1: timburonps (button) folded before Flop (didn't bet)
Seat 2: chiyuki (small blind) folded before Flop
Seat 3: PetitAlejo (big blind) folded before Flop
Seat 4: wtu1986 folded before Flop (didn't bet)
Seat 5: ShockLaMuc folded before Flop (didn't bet)
Seat 6: ladymadon107 collected ($0.60)
Seat 7: jethaz folded before Flop (didn't bet)
Seat 8: TraderYao folded before Flop (didn't bet)
Seat 9: gunbowler folded before Flop (didn't bet)



PokerStars Zoom Hand #84298826283:  Hold'em No Limit ($0.10/$0.25) - 2012/08/05 13:37:59 JST [2012/08/05 0:37:59 ET]
Table 'Whirlpool' 9-max Seat #1 is the button
Seat 1: kamikkaze ($54.97 in chips) 
Seat 2: hirozo ($27 in chips) 
Seat 3: puffy5533 ($24.15 in chips) 
Seat 4: Loholov ($24.71 in chips) 
Seat 5: DooMSDaY1337 ($99.83 in chips) 
Seat 6: chiyuki ($25.25 in chips) 
Seat 7: agurio ($25.78 in chips) 
Seat 8: carlosrbr ($14.80 in chips) 
Seat 9: solawind ($24.65 in chips) 
hirozo: posts small blind $0.10
puffy5533: posts big blind $0.25
*** HOLE CARDS ***
Dealt to chiyuki [3h 6h]
Loholov: folds 
DooMSDaY1337: folds 
chiyuki: folds 
agurio: folds 
carlosrbr: raises $0.50 to $0.75
solawind: folds 
kamikkaze: folds 
hirozo: folds 
puffy5533: folds 
Uncalled bet ($0.50) returned to carlosrbr
carlosrbr collected $0.60 from pot
carlosrbr: doesn't show hand 
*** SUMMARY ***
Total pot $0.60 | Rake $0 
Seat 1: kamikkaze (button) folded before Flop (didn't bet)
Seat 2: hirozo (small blind) folded before Flop
Seat 3: puffy5533 (big blind) folded before Flop
Seat 4: Loholov folded before Flop (didn't bet)
Seat 5: DooMSDaY1337 folded before Flop (didn't bet)
Seat 6: chiyuki folded before Flop (didn't bet)
Seat 7: agurio folded before Flop (didn't bet)
Seat 8: carlosrbr collected ($0.60)
Seat 9: solawind folded before Flop (didn't bet)



PokerStars Zoom Hand #84298825000:  Hold'em No Limit ($0.10/$0.25) - 2012/08/05 13:37:54 JST [2012/08/05 0:37:54 ET]
Table 'Whirlpool' 9-max Seat #1 is the button
Seat 1: solawind ($24.65 in chips) 
Seat 2: kamikkaze ($55.07 in chips) 
Seat 3: jethaz ($64.42 in chips) 
Seat 4: hirozo ($27.54 in chips) 
Seat 5: Jippyflip ($16.45 in chips) 
Seat 6: Pkdave ($41.35 in chips) 
Seat 7: chiyuki ($25.25 in chips) 
Seat 8: goldstone ($23.36 in chips) 
Seat 9: petersmiths ($25.15 in chips) 
kamikkaze: posts small blind $0.10
jethaz: posts big blind $0.25
*** HOLE CARDS ***
Dealt to chiyuki [5d Ts]
hirozo: folds 
Jippyflip: folds 
Pkdave: calls $0.25
chiyuki: folds 
goldstone: folds 
petersmiths: raises $0.25 to $0.50
solawind: folds 
kamikkaze: folds 
jethaz: folds 
Pkdave: calls $0.25
*** FLOP *** [Qc Ah 7s]
Pkdave: bets $0.50
petersmiths: raises $0.50 to $1
Pkdave: calls $0.50
*** TURN *** [Qc Ah 7s] [8d]
Pkdave: checks 
petersmiths: bets $3.20
Pkdave: calls $3.20
*** RIVER *** [Qc Ah 7s 8d] [Ks]
Pkdave: checks 
petersmiths: checks 
*** SHOW DOWN ***
Pkdave: shows [As Td] (a pair of Aces)
petersmiths: shows [Qh 8s] (two pair, Queens and Eights)
petersmiths collected $9.31 from pot
*** SUMMARY ***
Total pot $9.75 | Rake $0.44 
Board [Qc Ah 7s 8d Ks]
Seat 1: solawind (button) folded before Flop (didn't bet)
Seat 2: kamikkaze (small blind) folded before Flop
Seat 3: jethaz (big blind) folded before Flop
Seat 4: hirozo folded before Flop (didn't bet)
Seat 5: Jippyflip folded before Flop (didn't bet)
Seat 6: Pkdave showed [As Td] and lost with a pair of Aces
Seat 7: chiyuki folded before Flop (didn't bet)
Seat 8: goldstone folded before Flop (didn't bet)
Seat 9: petersmiths showed [Qh 8s] and won ($9.31) with two pair, Queens and Eights



PokerStars Zoom Hand #84298828587:  Hold'em No Limit ($0.10/$0.25) - 2012/08/05 13:38:08 JST [2012/08/05 0:38:08 ET]
Table 'Whirlpool' 9-max Seat #1 is the button
Seat 1: ShockLaMuc ($43.77 in chips) 
Seat 2: KeLevro0 ($7.45 in chips) 
Seat 3: eduvazsilva ($13.25 in chips) 
Seat 4: chiyuki ($25.25 in chips) 
Seat 5: leo2095 ($13.72 in chips) 
Seat 6: cR!Ma*aRm ($32.10 in chips) 
Seat 7: seula i ($60.84 in chips) 
Seat 8: timburonps ($25.60 in chips) 
Seat 9: Lasutchik ($31.33 in chips) 
KeLevro0: posts small blind $0.10
eduvazsilva: posts big blind $0.25
*** HOLE CARDS ***
Dealt to chiyuki [Kd Qh]
chiyuki: folds 
leo2095: folds 
cR!Ma*aRm: folds 
seula i: folds 
timburonps: folds 
Lasutchik: raises $0.50 to $0.75
ShockLaMuc: raises $2.50 to $3.25
KeLevro0: folds 
eduvazsilva: folds 
Lasutchik: folds 
Uncalled bet ($2.50) returned to ShockLaMuc
ShockLaMuc collected $1.85 from pot
ShockLaMuc: doesn't show hand 
*** SUMMARY ***
Total pot $1.85 | Rake $0 
Seat 1: ShockLaMuc (button) collected ($1.85)
Seat 2: KeLevro0 (small blind) folded before Flop
Seat 3: eduvazsilva (big blind) folded before Flop
Seat 4: chiyuki folded before Flop (didn't bet)
Seat 5: leo2095 folded before Flop (didn't bet)
Seat 6: cR!Ma*aRm folded before Flop (didn't bet)
Seat 7: seula i folded before Flop (didn't bet)
Seat 8: timburonps folded before Flop (didn't bet)
Seat 9: Lasutchik folded before Flop



PokerStars Zoom Hand #84298829680:  Hold'em No Limit ($0.10/$0.25) - 2012/08/05 13:38:12 JST [2012/08/05 0:38:12 ET]
Table 'Whirlpool' 9-max Seat #1 is the button
Seat 1: trusbi_na_go ($15.88 in chips) 
Seat 2: cr0lox ($24.75 in chips) 
Seat 3: stankfist420 ($12.56 in chips) 
Seat 4: chiyuki ($25.25 in chips) 
Seat 5: a_tasmanian ($100.10 in chips) 
Seat 6: goldstone ($23.36 in chips) 
Seat 7: Loholov ($15 in chips) 
Seat 8: deadmoneykid ($20.92 in chips) 
Seat 9: BlOnDhOlIc ($35.96 in chips) 
cr0lox: posts small blind $0.10
stankfist420: posts big blind $0.25
*** HOLE CARDS ***
Dealt to chiyuki [Ah Kh]
chiyuki: raises $0.50 to $0.75
a_tasmanian: raises $1.75 to $2.50
goldstone: folds 
Loholov: folds 
deadmoneykid: folds 
BlOnDhOlIc: folds 
trusbi_na_go: folds 
cr0lox: folds 
stankfist420: folds 
chiyuki: calls $1.75
*** FLOP *** [Kd 7d 3d]
chiyuki: checks 
a_tasmanian: bets $3
chiyuki: calls $3
*** TURN *** [Kd 7d 3d] [6s]
chiyuki: checks 
a_tasmanian: checks 
*** RIVER *** [Kd 7d 3d 6s] [Jc]
chiyuki: checks 
a_tasmanian: checks 
*** SHOW DOWN ***
chiyuki: shows [Ah Kh] (a pair of Kings)
a_tasmanian: shows [Ad Ac] (a pair of Aces)
a_tasmanian collected $10.84 from pot
*** SUMMARY ***
Total pot $11.35 | Rake $0.51 
Board [Kd 7d 3d 6s Jc]
Seat 1: trusbi_na_go (button) folded before Flop (didn't bet)
Seat 2: cr0lox (small blind) folded before Flop
Seat 3: stankfist420 (big blind) folded before Flop
Seat 4: chiyuki showed [Ah Kh] and lost with a pair of Kings
Seat 5: a_tasmanian showed [Ad Ac] and won ($10.84) with a pair of Aces
Seat 6: goldstone folded before Flop (didn't bet)
Seat 7: Loholov folded before Flop (didn't bet)
Seat 8: deadmoneykid folded before Flop (didn't bet)
Seat 9: BlOnDhOlIc folded before Flop (didn't bet)



PokerStars Zoom Hand #84298850482:  Hold'em No Limit ($0.10/$0.25) - 2012/08/05 13:39:33 JST [2012/08/05 0:39:33 ET]
Table 'Whirlpool' 9-max Seat #1 is the button
Seat 1: chiyuki ($25 in chips) 
Seat 2: fwani ($26.10 in chips) 
Seat 3: KeLevro0 ($12.50 in chips) 
Seat 4: BlackZafiro ($28.56 in chips) 
Seat 5: ygoegoe ($26.77 in chips) 
Seat 6: taiali ($15 in chips) 
Seat 7: solawind ($24.30 in chips) 
Seat 8: timburonps ($48.35 in chips) 
Seat 9: PetitAlejo ($25 in chips) 
fwani: posts small blind $0.10
KeLevro0: posts big blind $0.25
*** HOLE CARDS ***
Dealt to chiyuki [5h 4c]
BlackZafiro: folds 
ygoegoe: folds 
taiali: folds 
solawind: folds 
timburonps: folds 
PetitAlejo: folds 
chiyuki: folds 
fwani: folds 
Uncalled bet ($0.15) returned to KeLevro0
KeLevro0 collected $0.20 from pot
KeLevro0: doesn't show hand 
*** SUMMARY ***
Total pot $0.20 | Rake $0 
Seat 1: chiyuki (button) folded before Flop (didn't bet)
Seat 2: fwani (small blind) folded before Flop
Seat 3: KeLevro0 (big blind) collected ($0.20)
Seat 4: BlackZafiro folded before Flop (didn't bet)
Seat 5: ygoegoe folded before Flop (didn't bet)
Seat 6: taiali folded before Flop (didn't bet)
Seat 7: solawind folded before Flop (didn't bet)
Seat 8: timburonps folded before Flop (didn't bet)
Seat 9: PetitAlejo folded before Flop (didn't bet)



PokerStars Zoom Hand #84298851492:  Hold'em No Limit ($0.10/$0.25) - 2012/08/05 13:39:37 JST [2012/08/05 0:39:37 ET]
Table 'Whirlpool' 9-max Seat #1 is the button
Seat 1: goldstone ($23.81 in chips) 
Seat 2: wtu1986 ($24.57 in chips) 
Seat 3: chiyuki ($25 in chips) 
Seat 4: ZSIDD ($36.12 in chips) 
Seat 5: timburonps ($48.35 in chips) 
Seat 6: Roglus ($68.48 in chips) 
Seat 7: jethaz ($73.34 in chips) 
Seat 8: seula i ($60.59 in chips) 
Seat 9: taiali ($15 in chips) 
wtu1986: posts small blind $0.10
chiyuki: posts big blind $0.25
*** HOLE CARDS ***
Dealt to chiyuki [2s Jd]
ZSIDD: folds 
timburonps: folds 
Roglus: folds 
jethaz: folds 
seula i: folds 
taiali: raises $0.37 to $0.62
goldstone: folds 
wtu1986: folds 
chiyuki: folds 
Uncalled bet ($0.37) returned to taiali
taiali collected $0.60 from pot
taiali: doesn't show hand 
*** SUMMARY ***
Total pot $0.60 | Rake $0 
Seat 1: goldstone (button) folded before Flop (didn't bet)
Seat 2: wtu1986 (small blind) folded before Flop
Seat 3: chiyuki (big blind) folded before Flop
Seat 4: ZSIDD folded before Flop (didn't bet)
Seat 5: timburonps folded before Flop (didn't bet)
Seat 6: Roglus folded before Flop (didn't bet)
Seat 7: jethaz folded before Flop (didn't bet)
Seat 8: seula i folded before Flop (didn't bet)
Seat 9: taiali collected ($0.60)



PokerStars Zoom Hand #84298859985:  Hold'em No Limit ($0.10/$0.25) - 2012/08/05 13:40:11 JST [2012/08/05 0:40:11 ET]
Table 'Whirlpool' 9-max Seat #1 is the button
Seat 1: KeLevro0 ($13.25 in chips) 
Seat 2: fwani ($25.35 in chips) 
Seat 3: TraderYao ($27.72 in chips) 
Seat 4: BlOnDhOlIc ($26.45 in chips) 
Seat 5: Dejacob ($25.35 in chips) 
Seat 6: chiyuki ($24.75 in chips) 
Seat 7: softdesign ($72.59 in chips) 
Seat 8: Loholov ($21.03 in chips) 
Seat 9: wtu1986 ($25 in chips) 
fwani: posts small blind $0.10
TraderYao: posts big blind $0.25
*** HOLE CARDS ***
Dealt to chiyuki [8h 5s]
BlOnDhOlIc: folds 
Dejacob: folds 
chiyuki: folds 
softdesign: raises $0.75 to $1
Loholov: folds 
wtu1986: calls $1
KeLevro0: calls $1
fwani: folds 
TraderYao: folds 
*** FLOP *** [As 9h 7h]
softdesign: bets $0.25
wtu1986: raises $2.35 to $2.60
KeLevro0: folds 
softdesign: folds 
Uncalled bet ($2.35) returned to wtu1986
wtu1986 collected $3.68 from pot
wtu1986: doesn't show hand 
*** SUMMARY ***
Total pot $3.85 | Rake $0.17 
Board [As 9h 7h]
Seat 1: KeLevro0 (button) folded on the Flop
Seat 2: fwani (small blind) folded before Flop
Seat 3: TraderYao (big blind) folded before Flop
Seat 4: BlOnDhOlIc folded before Flop (didn't bet)
Seat 5: Dejacob folded before Flop (didn't bet)
Seat 6: chiyuki folded before Flop (didn't bet)
Seat 7: softdesign folded on the Flop
Seat 8: Loholov folded before Flop (didn't bet)
Seat 9: wtu1986 collected ($3.68)



PokerStars Zoom Hand #84298861214:  Hold'em No Limit ($0.10/$0.25) - 2012/08/05 13:40:16 JST [2012/08/05 0:40:16 ET]
Table 'Whirlpool' 9-max Seat #1 is the button
Seat 1: DooMSDaY1337 ($76.93 in chips) 
Seat 2: gunbowler ($138.41 in chips) 
Seat 3: Suhoff76 ($36.63 in chips) 
Seat 4: solawind ($24.55 in chips) 
Seat 5: Roglus ($20.48 in chips) 
Seat 6: goldstone ($23.71 in chips) 
Seat 7: deadmoneykid ($35.04 in chips) 
Seat 8: timburonps ($48.10 in chips) 
Seat 9: chiyuki ($24.75 in chips) 
gunbowler: posts small blind $0.10
Suhoff76: posts big blind $0.25
*** HOLE CARDS ***
Dealt to chiyuki [Tc Kc]
solawind: folds 
Roglus: folds 
goldstone: folds 
deadmoneykid: folds 
timburonps: folds 
chiyuki: raises $0.50 to $0.75
DooMSDaY1337: calls $0.75
gunbowler: folds 
Suhoff76: folds 
*** FLOP *** [Ks 5d 8d]
chiyuki: bets $1
DooMSDaY1337: raises $1.75 to $2.75
chiyuki: raises $3.25 to $6
DooMSDaY1337: folds 
Uncalled bet ($3.25) returned to chiyuki
chiyuki collected $7.02 from pot
chiyuki: doesn't show hand 
*** SUMMARY ***
Total pot $7.35 | Rake $0.33 
Board [Ks 5d 8d]
Seat 1: DooMSDaY1337 (button) folded on the Flop
Seat 2: gunbowler (small blind) folded before Flop
Seat 3: Suhoff76 (big blind) folded before Flop
Seat 4: solawind folded before Flop (didn't bet)
Seat 5: Roglus folded before Flop (didn't bet)
Seat 6: goldstone folded before Flop (didn't bet)
Seat 7: deadmoneykid folded before Flop (didn't bet)
Seat 8: timburonps folded before Flop (didn't bet)
Seat 9: chiyuki collected ($7.02)



PokerStars Zoom Hand #84298881995:  Hold'em No Limit ($0.10/$0.25) - 2012/08/05 13:41:38 JST [2012/08/05 0:41:38 ET]
Table 'Whirlpool' 9-max Seat #1 is the button
Seat 1: Dejacob ($29.31 in chips) 
Seat 2: chiyuki ($28.27 in chips) 
Seat 3: NastyMcNast ($31.05 in chips) 
Seat 4: cr0lox ($27.13 in chips) 
Seat 5: fwani ($25.10 in chips) 
Seat 6: hirozo ($27.40 in chips) 
Seat 7: BlOnDhOlIc ($35.48 in chips) 
Seat 8: DooMSDaY1337 ($73.43 in chips) 
Seat 9: lovinlife5 ($24.15 in chips) 
chiyuki: posts small blind $0.10
NastyMcNast: posts big blind $0.25
*** HOLE CARDS ***
Dealt to chiyuki [Qh 9d]
cr0lox: folds 
fwani: raises $0.35 to $0.60
hirozo: raises $1.30 to $1.90
BlOnDhOlIc: folds 
DooMSDaY1337: folds 
lovinlife5: folds 
Dejacob: folds 
chiyuki: folds 
NastyMcNast: folds 
fwani: folds 
Uncalled bet ($1.30) returned to hirozo
hirozo collected $1.55 from pot
hirozo: doesn't show hand 
*** SUMMARY ***
Total pot $1.55 | Rake $0 
Seat 1: Dejacob (button) folded before Flop (didn't bet)
Seat 2: chiyuki (small blind) folded before Flop
Seat 3: NastyMcNast (big blind) folded before Flop
Seat 4: cr0lox folded before Flop (didn't bet)
Seat 5: fwani folded before Flop
Seat 6: hirozo collected ($1.55)
Seat 7: BlOnDhOlIc folded before Flop (didn't bet)
Seat 8: DooMSDaY1337 folded before Flop (didn't bet)
Seat 9: lovinlife5 folded before Flop (didn't bet)



PokerStars Zoom Hand #84298885428:  Hold'em No Limit ($0.10/$0.25) - 2012/08/05 13:41:51 JST [2012/08/05 0:41:51 ET]
Table 'Whirlpool' 9-max Seat #1 is the button
Seat 1: deadmoneykid ($35.04 in chips) 
Seat 2: Loholov ($23.49 in chips) 
Seat 3: Tom1999 ($14.91 in chips) 
Seat 4: Landybob ($35.22 in chips) 
Seat 5: BlOnDhOlIc ($35.48 in chips) 
Seat 6: seula i ($34.72 in chips) 
Seat 7: chiyuki ($28.17 in chips) 
Seat 8: BlackZafiro ($25 in chips) 
Seat 9: Jippyflip ($19.76 in chips) 
Loholov: posts small blind $0.10
Tom1999: posts big blind $0.25
*** HOLE CARDS ***
Dealt to chiyuki [Qs Qh]
Landybob: folds 
BlOnDhOlIc: folds 
seula i: folds 
chiyuki: raises $0.50 to $0.75
BlackZafiro: folds 
Jippyflip: folds 
deadmoneykid: folds 
Loholov: folds 
Tom1999: folds 
Uncalled bet ($0.50) returned to chiyuki
chiyuki collected $0.60 from pot
chiyuki: doesn't show hand 
*** SUMMARY ***
Total pot $0.60 | Rake $0 
Seat 1: deadmoneykid (button) folded before Flop (didn't bet)
Seat 2: Loholov (small blind) folded before Flop
Seat 3: Tom1999 (big blind) folded before Flop
Seat 4: Landybob folded before Flop (didn't bet)
Seat 5: BlOnDhOlIc folded before Flop (didn't bet)
Seat 6: seula i folded before Flop (didn't bet)
Seat 7: chiyuki collected ($0.60)
Seat 8: BlackZafiro folded before Flop (didn't bet)
Seat 9: Jippyflip folded before Flop (didn't bet)



PokerStars Zoom Hand #84298883441:  Hold'em No Limit ($0.10/$0.25) - 2012/08/05 13:41:43 JST [2012/08/05 0:41:43 ET]
Table 'Whirlpool' 9-max Seat #1 is the button
Seat 1: jethaz ($48.33 in chips) 
Seat 2: cr0lox ($27.13 in chips) 
Seat 3: timburonps ($48.25 in chips) 
Seat 4: Suhoff76 ($36.99 in chips) 
Seat 5: KeLevro0 ($12.70 in chips) 
Seat 6: Th3Fog ($22.26 in chips) 
Seat 7: DooMSDaY1337 ($73.43 in chips) 
Seat 8: chiyuki ($28.17 in chips) 
Seat 9: agurio ($25.35 in chips) 
cr0lox: posts small blind $0.10
timburonps: posts big blind $0.25
*** HOLE CARDS ***
Dealt to chiyuki [As Js]
Suhoff76: folds 
KeLevro0: folds 
Th3Fog: folds 
DooMSDaY1337: raises $0.50 to $0.75
chiyuki: folds 
agurio: folds 
jethaz: folds 
cr0lox: calls $0.65
timburonps: folds 
*** FLOP *** [Jc 9d Ac]
cr0lox: checks 
DooMSDaY1337: checks 
*** TURN *** [Jc 9d Ac] [4d]
cr0lox: checks 
DooMSDaY1337: checks 
*** RIVER *** [Jc 9d Ac 4d] [5d]
cr0lox: checks 
DooMSDaY1337: checks 
*** SHOW DOWN ***
cr0lox: shows [6c 6h] (a pair of Sixes)
DooMSDaY1337: shows [6s 6d] (a pair of Sixes)
cr0lox collected $0.84 from pot
DooMSDaY1337 collected $0.83 from pot
*** SUMMARY ***
Total pot $1.75 | Rake $0.08 
Board [Jc 9d Ac 4d 5d]
Seat 1: jethaz (button) folded before Flop (didn't bet)
Seat 2: cr0lox (small blind) showed [6c 6h] and won ($0.84) with a pair of Sixes
Seat 3: timburonps (big blind) folded before Flop
Seat 4: Suhoff76 folded before Flop (didn't bet)
Seat 5: KeLevro0 folded before Flop (didn't bet)
Seat 6: Th3Fog folded before Flop (didn't bet)
Seat 7: DooMSDaY1337 showed [6s 6d] and won ($0.83) with a pair of Sixes
Seat 8: chiyuki folded before Flop (didn't bet)
Seat 9: agurio folded before Flop (didn't bet)



PokerStars Zoom Hand #84298889734:  Hold'em No Limit ($0.10/$0.25) - 2012/08/05 13:42:07 JST [2012/08/05 0:42:07 ET]
Table 'Whirlpool' 9-max Seat #1 is the button
Seat 1: chiyuki ($28.52 in chips) 
Seat 2: ShockLaMuc ($28 in chips) 
Seat 3: TraderYao ($24.90 in chips) 
Seat 4: ygoegoe ($26.47 in chips) 
Seat 5: fwani ($26.68 in chips) 
Seat 6: leo2095 ($13.22 in chips) 
Seat 7: BlOnDhOlIc ($36.15 in chips) 
Seat 8: NastyMcNast ($25.10 in chips) 
Seat 9: eduvazsilva ($10.70 in chips) 
ShockLaMuc: posts small blind $0.10
TraderYao: posts big blind $0.25
*** HOLE CARDS ***
Dealt to chiyuki [Jd Td]
ygoegoe: folds 
fwani: folds 
leo2095: folds 
BlOnDhOlIc: folds 
NastyMcNast: raises $0.50 to $0.75
eduvazsilva: folds 
chiyuki: folds 
ShockLaMuc: folds 
TraderYao: folds 
Uncalled bet ($0.50) returned to NastyMcNast
NastyMcNast collected $0.60 from pot
NastyMcNast: doesn't show hand 
*** SUMMARY ***
Total pot $0.60 | Rake $0 
Seat 1: chiyuki (button) folded before Flop (didn't bet)
Seat 2: ShockLaMuc (small blind) folded before Flop
Seat 3: TraderYao (big blind) folded before Flop
Seat 4: ygoegoe folded before Flop (didn't bet)
Seat 5: fwani folded before Flop (didn't bet)
Seat 6: leo2095 folded before Flop (didn't bet)
Seat 7: BlOnDhOlIc folded before Flop (didn't bet)
Seat 8: NastyMcNast collected ($0.60)
Seat 9: eduvazsilva folded before Flop (didn't bet)



PokerStars Zoom Hand #84298895255:  Hold'em No Limit ($0.10/$0.25) - 2012/08/05 13:42:29 JST [2012/08/05 0:42:29 ET]
Table 'Whirlpool' 9-max Seat #1 is the button
Seat 1: KeLevro0 ($7.40 in chips) 
Seat 2: Dejacob ($43.30 in chips) 
Seat 3: chiyuki ($28.52 in chips) 
Seat 4: taiali ($20.25 in chips) 
Seat 5: deadmoneykid ($35.04 in chips) 
Seat 6: timburonps ($28.65 in chips) 
Seat 7: Suhoff76 ($31.70 in chips) 
Seat 8: seula i ($52.24 in chips) 
Seat 9: ShockLaMuc ($24.40 in chips) 
Dejacob: posts small blind $0.10
chiyuki: posts big blind $0.25
*** HOLE CARDS ***
Dealt to chiyuki [9c 6h]
taiali: folds 
deadmoneykid: folds 
timburonps: folds 
Suhoff76: folds 
seula i: folds 
ShockLaMuc: folds 
KeLevro0: folds 
Dejacob: folds 
Uncalled bet ($0.15) returned to chiyuki
chiyuki collected $0.20 from pot
chiyuki: doesn't show hand 
*** SUMMARY ***
Total pot $0.20 | Rake $0 
Seat 1: KeLevro0 (button) folded before Flop (didn't bet)
Seat 2: Dejacob (small blind) folded before Flop
Seat 3: chiyuki (big blind) collected ($0.20)
Seat 4: taiali folded before Flop (didn't bet)
Seat 5: deadmoneykid folded before Flop (didn't bet)
Seat 6: timburonps folded before Flop (didn't bet)
Seat 7: Suhoff76 folded before Flop (didn't bet)
Seat 8: seula i folded before Flop (didn't bet)
Seat 9: ShockLaMuc folded before Flop (didn't bet)



PokerStars Zoom Hand #84298898349:  Hold'em No Limit ($0.10/$0.25) - 2012/08/05 13:42:41 JST [2012/08/05 0:42:41 ET]
Table 'Whirlpool' 9-max Seat #1 is the button
Seat 1: TraderYao ($25 in chips) 
Seat 2: BlackZafiro ($25 in chips) 
Seat 3: Tuan0109 ($15 in chips) 
Seat 4: BlOnDhOlIc ($36.05 in chips) 
Seat 5: Tom1999 ($14.56 in chips) 
Seat 6: chiyuki ($28.62 in chips) 
Seat 7: Lasutchik ($8.99 in chips) 
Seat 8: timburonps ($25.18 in chips) 
Seat 9: Rsonal ($10.40 in chips) 
BlackZafiro: posts small blind $0.10
Tuan0109: posts big blind $0.25
*** HOLE CARDS ***
Dealt to chiyuki [3c 5c]
BlOnDhOlIc: folds 
Tom1999: folds 
chiyuki: folds 
Lasutchik: folds 
timburonps: folds 
Rsonal: folds 
TraderYao: folds 
BlackZafiro: folds 
Uncalled bet ($0.15) returned to Tuan0109
Tuan0109 collected $0.20 from pot
Tuan0109: doesn't show hand 
*** SUMMARY ***
Total pot $0.20 | Rake $0 
Seat 1: TraderYao (button) folded before Flop (didn't bet)
Seat 2: BlackZafiro (small blind) folded before Flop
Seat 3: Tuan0109 (big blind) collected ($0.20)
Seat 4: BlOnDhOlIc folded before Flop (didn't bet)
Seat 5: Tom1999 folded before Flop (didn't bet)
Seat 6: chiyuki folded before Flop (didn't bet)
Seat 7: Lasutchik folded before Flop (didn't bet)
Seat 8: timburonps folded before Flop (didn't bet)
Seat 9: Rsonal folded before Flop (didn't bet)



PokerStars Zoom Hand #84298900461:  Hold'em No Limit ($0.10/$0.25) - 2012/08/05 13:42:49 JST [2012/08/05 0:42:49 ET]
Table 'Whirlpool' 9-max Seat #1 is the button
Seat 1: a_tasmanian ($105.27 in chips) 
Seat 2: chiyuki ($28.62 in chips) 
Seat 3: TErr18 ($13.36 in chips) 
Seat 4: kamikkaze ($15.56 in chips) 
Seat 5: jethaz ($73.04 in chips) 
Seat 6: Suhoff76 ($36.64 in chips) 
Seat 7: timburonps ($47.25 in chips) 
Seat 8: cr0lox ($26.47 in chips) 
Seat 9: petersmiths ($40.73 in chips) 
chiyuki: posts small blind $0.10
TErr18: posts big blind $0.25
*** HOLE CARDS ***
Dealt to chiyuki [Td 2s]
kamikkaze: folds 
jethaz: folds 
Suhoff76: folds 
timburonps: folds 
cr0lox: folds 
petersmiths: folds 
a_tasmanian: folds 
chiyuki: folds 
Uncalled bet ($0.15) returned to TErr18
TErr18 collected $0.20 from pot
TErr18: doesn't show hand 
*** SUMMARY ***
Total pot $0.20 | Rake $0 
Seat 1: a_tasmanian (button) folded before Flop (didn't bet)
Seat 2: chiyuki (small blind) folded before Flop
Seat 3: TErr18 (big blind) collected ($0.20)
Seat 4: kamikkaze folded before Flop (didn't bet)
Seat 5: jethaz folded before Flop (didn't bet)
Seat 6: Suhoff76 folded before Flop (didn't bet)
Seat 7: timburonps folded before Flop (didn't bet)
Seat 8: cr0lox folded before Flop (didn't bet)
Seat 9: petersmiths folded before Flop (didn't bet)



PokerStars Zoom Hand #84298901759:  Hold'em No Limit ($0.10/$0.25) - 2012/08/05 13:42:54 JST [2012/08/05 0:42:54 ET]
Table 'Whirlpool' 9-max Seat #1 is the button
Seat 1: Ellen1947 ($27.22 in chips) 
Seat 2: Suhoff76 ($36.64 in chips) 
Seat 3: agurio ($33.31 in chips) 
Seat 4: jethaz ($73.04 in chips) 
Seat 5: Loholov ($16.02 in chips) 
Seat 6: cr0lox ($26.47 in chips) 
Seat 7: Dejacob ($25 in chips) 
Seat 8: BlOnDhOlIc ($36.05 in chips) 
Seat 9: chiyuki ($28.52 in chips) 
Suhoff76: posts small blind $0.10
agurio: posts big blind $0.25
*** HOLE CARDS ***
Dealt to chiyuki [5h 7s]
jethaz: folds 
Loholov: folds 
cr0lox: folds 
Dejacob: folds 
BlOnDhOlIc: folds 
chiyuki: folds 
Ellen1947: raises $0.50 to $0.75
Suhoff76: calls $0.65
agurio: folds 
*** FLOP *** [6c Kc As]
Suhoff76: checks 
Ellen1947: bets $0.83
Suhoff76: calls $0.83
*** TURN *** [6c Kc As] [2h]
Suhoff76: bets $0.80
Ellen1947: folds 
Uncalled bet ($0.80) returned to Suhoff76
Suhoff76 collected $3.26 from pot
Suhoff76: doesn't show hand 
*** SUMMARY ***
Total pot $3.41 | Rake $0.15 
Board [6c Kc As 2h]
Seat 1: Ellen1947 (button) folded on the Turn
Seat 2: Suhoff76 (small blind) collected ($3.26)
Seat 3: agurio (big blind) folded before Flop
Seat 4: jethaz folded before Flop (didn't bet)
Seat 5: Loholov folded before Flop (didn't bet)
Seat 6: cr0lox folded before Flop (didn't bet)
Seat 7: Dejacob folded before Flop (didn't bet)
Seat 8: BlOnDhOlIc folded before Flop (didn't bet)
Seat 9: chiyuki folded before Flop (didn't bet)



PokerStars Zoom Hand #84298904579:  Hold'em No Limit ($0.10/$0.25) - 2012/08/05 13:43:05 JST [2012/08/05 0:43:05 ET]
Table 'Whirlpool' 9-max Seat #1 is the button
Seat 1: Tuan0109 ($15 in chips) 
Seat 2: Loholov ($23.14 in chips) 
Seat 3: jethaz ($72.94 in chips) 
Seat 4: hirozo ($28.60 in chips) 
Seat 5: Nerkit ($13.17 in chips) 
Seat 6: fwani ($28.79 in chips) 
Seat 7: Th3Fog ($22.26 in chips) 
Seat 8: chiyuki ($28.52 in chips) 
Seat 9: PetitAlejo ($28.39 in chips) 
Loholov: posts small blind $0.10
jethaz: posts big blind $0.25
*** HOLE CARDS ***
Dealt to chiyuki [Qc Kd]
hirozo: folds 
Nerkit: folds 
fwani: folds 
Th3Fog: folds 
chiyuki: raises $0.50 to $0.75
PetitAlejo: folds 
Tuan0109: folds 
Loholov: folds 
jethaz: folds 
Uncalled bet ($0.50) returned to chiyuki
chiyuki collected $0.60 from pot
chiyuki: doesn't show hand 
*** SUMMARY ***
Total pot $0.60 | Rake $0 
Seat 1: Tuan0109 (button) folded before Flop (didn't bet)
Seat 2: Loholov (small blind) folded before Flop
Seat 3: jethaz (big blind) folded before Flop
Seat 4: hirozo folded before Flop (didn't bet)
Seat 5: Nerkit folded before Flop (didn't bet)
Seat 6: fwani folded before Flop (didn't bet)
Seat 7: Th3Fog folded before Flop (didn't bet)
Seat 8: chiyuki collected ($0.60)
Seat 9: PetitAlejo folded before Flop (didn't bet)



PokerStars Zoom Hand #84298913725:  Hold'em No Limit ($0.10/$0.25) - 2012/08/05 13:43:41 JST [2012/08/05 0:43:41 ET]
Table 'Whirlpool' 9-max Seat #1 is the button
Seat 1: agurio ($32.96 in chips) 
Seat 2: Roglus ($22.26 in chips) 
Seat 3: slapshot2011 ($44.54 in chips) 
Seat 4: jethaz ($49.70 in chips) 
Seat 5: chiyuki ($28.87 in chips) 
Seat 6: Dejacob ($42.95 in chips) 
Seat 7: Alvinpe85 ($50.10 in chips) 
Seat 8: leo2095 ($14.46 in chips) 
Seat 9: Loholov ($15.67 in chips) 
Roglus: posts small blind $0.10
slapshot2011: posts big blind $0.25
*** HOLE CARDS ***
Dealt to chiyuki [5c 9s]
jethaz: folds 
chiyuki: folds 
Dejacob: folds 
Alvinpe85: folds 
leo2095: folds 
Loholov: folds 
agurio: folds 
Roglus: raises $0.50 to $0.75
slapshot2011: calls $0.50
*** FLOP *** [6h 5s Td]
Roglus: bets $0.75
slapshot2011: calls $0.75
*** TURN *** [6h 5s Td] [Qs]
Roglus: checks 
slapshot2011: bets $1.25
Roglus: folds 
Uncalled bet ($1.25) returned to slapshot2011
slapshot2011 collected $2.86 from pot
slapshot2011: doesn't show hand 
*** SUMMARY ***
Total pot $3 | Rake $0.14 
Board [6h 5s Td Qs]
Seat 1: agurio (button) folded before Flop (didn't bet)
Seat 2: Roglus (small blind) folded on the Turn
Seat 3: slapshot2011 (big blind) collected ($2.86)
Seat 4: jethaz folded before Flop (didn't bet)
Seat 5: chiyuki folded before Flop (didn't bet)
Seat 6: Dejacob folded before Flop (didn't bet)
Seat 7: Alvinpe85 folded before Flop (didn't bet)
Seat 8: leo2095 folded before Flop (didn't bet)
Seat 9: Loholov folded before Flop (didn't bet)



PokerStars Zoom Hand #84298920454:  Hold'em No Limit ($0.10/$0.25) - 2012/08/05 13:44:07 JST [2012/08/05 0:44:07 ET]
Table 'Whirlpool' 9-max Seat #1 is the button
Seat 1: chiyuki ($28.87 in chips) 
Seat 2: Rudolf ($25 in chips) 
Seat 3: timburonps ($25 in chips) 
Seat 4: ChrisCDee ($26.65 in chips) 
Seat 5: Roglus ($20.76 in chips) 
Seat 6: Alvinpe85 ($50.10 in chips) 
Seat 7: Anafim ($15.78 in chips) 
Seat 8: wtu1986 ($26.46 in chips) 
Seat 9: BlackZafiro ($40.74 in chips) 
Rudolf: posts small blind $0.10
timburonps: posts big blind $0.25
*** HOLE CARDS ***
Dealt to chiyuki [7s 2c]
ChrisCDee: folds 
Roglus: folds 
Alvinpe85: folds 
Anafim: folds 
wtu1986: folds 
BlackZafiro: folds 
chiyuki: folds 
Rudolf: folds 
Uncalled bet ($0.15) returned to timburonps
timburonps collected $0.20 from pot
timburonps: doesn't show hand 
*** SUMMARY ***
Total pot $0.20 | Rake $0 
Seat 1: chiyuki (button) folded before Flop (didn't bet)
Seat 2: Rudolf (small blind) folded before Flop
Seat 3: timburonps (big blind) collected ($0.20)
Seat 4: ChrisCDee folded before Flop (didn't bet)
Seat 5: Roglus folded before Flop (didn't bet)
Seat 6: Alvinpe85 folded before Flop (didn't bet)
Seat 7: Anafim folded before Flop (didn't bet)
Seat 8: wtu1986 folded before Flop (didn't bet)
Seat 9: BlackZafiro folded before Flop (didn't bet)



PokerStars Zoom Hand #84298923314:  Hold'em No Limit ($0.10/$0.25) - 2012/08/05 13:44:18 JST [2012/08/05 0:44:18 ET]
Table 'Whirlpool' 9-max Seat #1 is the button
Seat 1: goldstone ($23.42 in chips) 
Seat 2: ygoegoe ($26.31 in chips) 
Seat 3: chiyuki ($28.87 in chips) 
Seat 4: slapshot2011 ($45.80 in chips) 
Seat 5: KAKamiro ($22.75 in chips) 
Seat 6: leo2095 ($14.36 in chips) 
Seat 7: jeff0923 ($25.92 in chips) 
Seat 8: PetitAlejo ($25.67 in chips) 
Seat 9: NastyMcNast ($29.70 in chips) 
ygoegoe: posts small blind $0.10
chiyuki: posts big blind $0.25
*** HOLE CARDS ***
Dealt to chiyuki [2h Qh]
slapshot2011: folds 
KAKamiro: folds 
leo2095: folds 
jeff0923: folds 
PetitAlejo: folds 
NastyMcNast: folds 
goldstone: folds 
ygoegoe: folds 
Uncalled bet ($0.15) returned to chiyuki
chiyuki collected $0.20 from pot
chiyuki: doesn't show hand 
*** SUMMARY ***
Total pot $0.20 | Rake $0 
Seat 1: goldstone (button) folded before Flop (didn't bet)
Seat 2: ygoegoe (small blind) folded before Flop
Seat 3: chiyuki (big blind) collected ($0.20)
Seat 4: slapshot2011 folded before Flop (didn't bet)
Seat 5: KAKamiro folded before Flop (didn't bet)
Seat 6: leo2095 folded before Flop (didn't bet)
Seat 7: jeff0923 folded before Flop (didn't bet)
Seat 8: PetitAlejo folded before Flop (didn't bet)
Seat 9: NastyMcNast folded before Flop (didn't bet)



PokerStars Zoom Hand #84298922022:  Hold'em No Limit ($0.10/$0.25) - 2012/08/05 13:44:13 JST [2012/08/05 0:44:13 ET]
Table 'Whirlpool' 9-max Seat #1 is the button
Seat 1: Tom1999 ($13.86 in chips) 
Seat 2: Th3Fog ($22.61 in chips) 
Seat 3: Lasutchik ($36.87 in chips) 
Seat 4: Suhoff76 ($38.42 in chips) 
Seat 5: chiyuki ($28.87 in chips) 
Seat 6: deadmoneykid ($35.04 in chips) 
Seat 7: goldstone ($39.88 in chips) 
Seat 8: jethaz ($56.20 in chips) 
Seat 9: NastyMcNast ($32.40 in chips) 
Th3Fog: posts small blind $0.10
Lasutchik: posts big blind $0.25
*** HOLE CARDS ***
Dealt to chiyuki [9c 4c]
Suhoff76: folds 
chiyuki: folds 
deadmoneykid: folds 
goldstone: folds 
jethaz: folds 
NastyMcNast: folds 
Tom1999: folds 
Th3Fog: raises $0.47 to $0.72
Lasutchik: folds 
Uncalled bet ($0.47) returned to Th3Fog
Th3Fog collected $0.50 from pot
Th3Fog: doesn't show hand 
*** SUMMARY ***
Total pot $0.50 | Rake $0 
Seat 1: Tom1999 (button) folded before Flop (didn't bet)
Seat 2: Th3Fog (small blind) collected ($0.50)
Seat 3: Lasutchik (big blind) folded before Flop
Seat 4: Suhoff76 folded before Flop (didn't bet)
Seat 5: chiyuki folded before Flop (didn't bet)
Seat 6: deadmoneykid folded before Flop (didn't bet)
Seat 7: goldstone folded before Flop (didn't bet)
Seat 8: jethaz folded before Flop (didn't bet)
Seat 9: NastyMcNast folded before Flop (didn't bet)



PokerStars Zoom Hand #84298916074:  Hold'em No Limit ($0.10/$0.25) - 2012/08/05 13:43:50 JST [2012/08/05 0:43:50 ET]
Table 'Whirlpool' 9-max Seat #1 is the button
Seat 1: softdesign ($76.89 in chips) 
Seat 2: KeLevro0 ($11.63 in chips) 
Seat 3: timburonps ($25.08 in chips) 
Seat 4: ladymadon107 ($21.74 in chips) 
Seat 5: wtu1986 ($27.48 in chips) 
Seat 6: Th3Fog ($64.80 in chips) 
Seat 7: chiyuki ($28.87 in chips) 
Seat 8: lovinlife5 ($22.24 in chips) 
Seat 9: deadmoneykid ($21.17 in chips) 
KeLevro0: posts small blind $0.10
timburonps: posts big blind $0.25
*** HOLE CARDS ***
Dealt to chiyuki [Js Ts]
ladymadon107: folds 
wtu1986: folds 
Th3Fog: folds 
chiyuki: folds 
lovinlife5: raises $0.50 to $0.75
deadmoneykid: folds 
softdesign: folds 
KeLevro0: calls $0.65
timburonps: folds 
*** FLOP *** [7s 5d Td]
KeLevro0: checks 
lovinlife5: bets $1.16
KeLevro0: folds 
Uncalled bet ($1.16) returned to lovinlife5
lovinlife5 collected $1.67 from pot
lovinlife5: doesn't show hand 
*** SUMMARY ***
Total pot $1.75 | Rake $0.08 
Board [7s 5d Td]
Seat 1: softdesign (button) folded before Flop (didn't bet)
Seat 2: KeLevro0 (small blind) folded on the Flop
Seat 3: timburonps (big blind) folded before Flop
Seat 4: ladymadon107 folded before Flop (didn't bet)
Seat 5: wtu1986 folded before Flop (didn't bet)
Seat 6: Th3Fog folded before Flop (didn't bet)
Seat 7: chiyuki folded before Flop (didn't bet)
Seat 8: lovinlife5 collected ($1.67)
Seat 9: deadmoneykid folded before Flop (didn't bet)



PokerStars Zoom Hand #84298927241:  Hold'em No Limit ($0.10/$0.25) - 2012/08/05 13:44:33 JST [2012/08/05 0:44:33 ET]
Table 'Whirlpool' 9-max Seat #1 is the button
Seat 1: timburonps ($25 in chips) 
Seat 2: seula i ($25.14 in chips) 
Seat 3: wtu1986 ($26.46 in chips) 
Seat 4: munky3 ($45.83 in chips) 
Seat 5: mariuka1 ($11.05 in chips) 
Seat 6: cr0lox ($26.72 in chips) 
Seat 7: jethaz ($67.37 in chips) 
Seat 8: chiyuki ($28.97 in chips) 
Seat 9: fwani ($28.89 in chips) 
seula i: posts small blind $0.10
wtu1986: posts big blind $0.25
*** HOLE CARDS ***
Dealt to chiyuki [7s 8c]
munky3: calls $0.25
mariuka1: raises $0.45 to $0.70
cr0lox: folds 
jethaz: folds 
chiyuki: folds 
fwani: folds 
timburonps: folds 
seula i: folds 
wtu1986: folds 
munky3: calls $0.45
*** FLOP *** [6s 6c Jd]
munky3: checks 
mariuka1: bets $0.25
munky3: calls $0.25
*** TURN *** [6s 6c Jd] [Ad]
munky3: checks 
mariuka1: bets $0.25
munky3: folds 
Uncalled bet ($0.25) returned to mariuka1
mariuka1 collected $2.15 from pot
mariuka1: doesn't show hand 
*** SUMMARY ***
Total pot $2.25 | Rake $0.10 
Board [6s 6c Jd Ad]
Seat 1: timburonps (button) folded before Flop (didn't bet)
Seat 2: seula i (small blind) folded before Flop
Seat 3: wtu1986 (big blind) folded before Flop
Seat 4: munky3 folded on the Turn
Seat 5: mariuka1 collected ($2.15)
Seat 6: cr0lox folded before Flop (didn't bet)
Seat 7: jethaz folded before Flop (didn't bet)
Seat 8: chiyuki folded before Flop (didn't bet)
Seat 9: fwani folded before Flop (didn't bet)



PokerStars Zoom Hand #84298931722:  Hold'em No Limit ($0.10/$0.25) - 2012/08/05 13:44:51 JST [2012/08/05 0:44:51 ET]
Table 'Whirlpool' 9-max Seat #1 is the button
Seat 1: BlackZafiro ($40.74 in chips) 
Seat 2: NastyMcNast ($25 in chips) 
Seat 3: Suhoff76 ($30.58 in chips) 
Seat 4: BlOnDhOlIc ($34.68 in chips) 
Seat 5: chiyuki ($28.97 in chips) 
Seat 6: Landybob ($36.10 in chips) 
Seat 7: jethaz ($56.65 in chips) 
Seat 8: Nerkit ($13.92 in chips) 
Seat 9: wildy29 ($13.09 in chips) 
NastyMcNast: posts small blind $0.10
Suhoff76: posts big blind $0.25
*** HOLE CARDS ***
Dealt to chiyuki [9h 2h]
BlOnDhOlIc: folds 
chiyuki: folds 
Landybob: folds 
jethaz: folds 
Nerkit: folds 
wildy29: folds 
BlackZafiro: raises $0.37 to $0.62
NastyMcNast: folds 
Suhoff76: raises $1.18 to $1.80
BlackZafiro: folds 
Uncalled bet ($1.18) returned to Suhoff76
Suhoff76 collected $1.34 from pot
Suhoff76: doesn't show hand 
*** SUMMARY ***
Total pot $1.34 | Rake $0 
Seat 1: BlackZafiro (button) folded before Flop
Seat 2: NastyMcNast (small blind) folded before Flop
Seat 3: Suhoff76 (big blind) collected ($1.34)
Seat 4: BlOnDhOlIc folded before Flop (didn't bet)
Seat 5: chiyuki folded before Flop (didn't bet)
Seat 6: Landybob folded before Flop (didn't bet)
Seat 7: jethaz folded before Flop (didn't bet)
Seat 8: Nerkit folded before Flop (didn't bet)
Seat 9: wildy29 folded before Flop (didn't bet)



PokerStars Zoom Hand #84298926493:  Hold'em No Limit ($0.10/$0.25) - 2012/08/05 13:44:31 JST [2012/08/05 0:44:31 ET]
Table 'Whirlpool' 9-max Seat #1 is the button
Seat 1: KeLevro0 ($13.41 in chips) 
Seat 2: BlackZafiro ($25.10 in chips) 
Seat 3: TraderYao ($25.35 in chips) 
Seat 4: Loholov ($15 in chips) 
Seat 5: softdesign ($77.24 in chips) 
Seat 6: chiyuki ($28.97 in chips) 
Seat 7: Jippyflip ($10.66 in chips) 
Seat 8: Alvinpe85 ($50.20 in chips) 
Seat 9: ShockLaMuc ($23.65 in chips) 
BlackZafiro: posts small blind $0.10
TraderYao: posts big blind $0.25
*** HOLE CARDS ***
Dealt to chiyuki [2c Tc]
Loholov: folds 
softdesign: folds 
chiyuki: folds 
Jippyflip: calls $0.25
Alvinpe85: folds 
ShockLaMuc: folds 
KeLevro0: folds 
BlackZafiro: folds 
TraderYao: checks 
*** FLOP *** [7d Js 7c]
TraderYao: checks 
Jippyflip: checks 
*** TURN *** [7d Js 7c] [5s]
TraderYao: checks 
Jippyflip: checks 
*** RIVER *** [7d Js 7c 5s] [Qh]
TraderYao: checks 
Jippyflip: checks 
*** SHOW DOWN ***
TraderYao: shows [3h 8c] (a pair of Sevens)
Jippyflip: shows [Th As] (a pair of Sevens - Ace kicker)
Jippyflip collected $0.57 from pot
*** SUMMARY ***
Total pot $0.60 | Rake $0.03 
Board [7d Js 7c 5s Qh]
Seat 1: KeLevro0 (button) folded before Flop (didn't bet)
Seat 2: BlackZafiro (small blind) folded before Flop
Seat 3: TraderYao (big blind) showed [3h 8c] and lost with a pair of Sevens
Seat 4: Loholov folded before Flop (didn't bet)
Seat 5: softdesign folded before Flop (didn't bet)
Seat 6: chiyuki folded before Flop (didn't bet)
Seat 7: Jippyflip showed [Th As] and won ($0.57) with a pair of Sevens
Seat 8: Alvinpe85 folded before Flop (didn't bet)
Seat 9: ShockLaMuc folded before Flop (didn't bet)



PokerStars Zoom Hand #84298933038:  Hold'em No Limit ($0.10/$0.25) - 2012/08/05 13:44:56 JST [2012/08/05 0:44:56 ET]
Table 'Whirlpool' 9-max Seat #1 is the button
Seat 1: TraderYao ($29.28 in chips) 
Seat 2: deadmoneykid ($29.46 in chips) 
Seat 3: Loholov ($15 in chips) 
Seat 4: solawind ($16.85 in chips) 
Seat 5: wtu1986 ($26.21 in chips) 
Seat 6: Nerkit ($13.92 in chips) 
Seat 7: chiyuki ($28.97 in chips) 
Seat 8: wildy29 ($13.09 in chips) 
Seat 9: BlOnDhOlIc ($43.80 in chips) 
deadmoneykid: posts small blind $0.10
Loholov: posts big blind $0.25
*** HOLE CARDS ***
Dealt to chiyuki [Kd Ks]
solawind: folds 
wtu1986: folds 
Nerkit: folds 
chiyuki: raises $0.50 to $0.75
wildy29: calls $0.75
BlOnDhOlIc: folds 
TraderYao: calls $0.75
deadmoneykid: folds 
Loholov: folds 
*** FLOP *** [6h Qd 8c]
chiyuki: bets $1.75
wildy29: folds 
TraderYao: folds 
Uncalled bet ($1.75) returned to chiyuki
chiyuki collected $2.48 from pot
chiyuki: doesn't show hand 
*** SUMMARY ***
Total pot $2.60 | Rake $0.12 
Board [6h Qd 8c]
Seat 1: TraderYao (button) folded on the Flop
Seat 2: deadmoneykid (small blind) folded before Flop
Seat 3: Loholov (big blind) folded before Flop
Seat 4: solawind folded before Flop (didn't bet)
Seat 5: wtu1986 folded before Flop (didn't bet)
Seat 6: Nerkit folded before Flop (didn't bet)
Seat 7: chiyuki collected ($2.48)
Seat 8: wildy29 folded on the Flop
Seat 9: BlOnDhOlIc folded before Flop (didn't bet)



PokerStars Zoom Hand #84298928816:  Hold'em No Limit ($0.10/$0.25) - 2012/08/05 13:44:40 JST [2012/08/05 0:44:40 ET]
Table 'Whirlpool' 9-max Seat #1 is the button
Seat 1: stankfist420 ($23.26 in chips) 
Seat 2: fwani ($28.89 in chips) 
Seat 3: Th3Fog ($22.86 in chips) 
Seat 4: Suhoff76 ($30.58 in chips) 
Seat 5: KAKamiro ($34.51 in chips) 
Seat 6: KeLevro0 ($12.50 in chips) 
Seat 7: jethaz ($67.37 in chips) 
Seat 8: deadmoneykid ($35.14 in chips) 
Seat 9: chiyuki ($28.97 in chips) 
fwani: posts small blind $0.10
Th3Fog: posts big blind $0.25
*** HOLE CARDS ***
Dealt to chiyuki [Ts 8c]
Suhoff76: folds 
KAKamiro: folds 
KeLevro0: folds 
jethaz: folds 
deadmoneykid: raises $0.50 to $0.75
chiyuki: folds 
stankfist420: raises $1.25 to $2
fwani: folds 
Th3Fog: folds 
deadmoneykid: calls $1.25
*** FLOP *** [Th Ks 9h]
deadmoneykid: checks 
stankfist420: bets $2.75
deadmoneykid: raises $5.75 to $8.50
stankfist420: folds 
Uncalled bet ($5.75) returned to deadmoneykid
deadmoneykid collected $9.41 from pot
deadmoneykid: doesn't show hand 
*** SUMMARY ***
Total pot $9.85 | Rake $0.44 
Board [Th Ks 9h]
Seat 1: stankfist420 (button) folded on the Flop
Seat 2: fwani (small blind) folded before Flop
Seat 3: Th3Fog (big blind) folded before Flop
Seat 4: Suhoff76 folded before Flop (didn't bet)
Seat 5: KAKamiro folded before Flop (didn't bet)
Seat 6: KeLevro0 folded before Flop (didn't bet)
Seat 7: jethaz folded before Flop (didn't bet)
Seat 8: deadmoneykid collected ($9.41)
Seat 9: chiyuki folded before Flop (didn't bet)



PokerStars Zoom Hand #84298943996:  Hold'em No Limit ($0.10/$0.25) - 2012/08/05 13:45:38 JST [2012/08/05 0:45:38 ET]
Table 'Whirlpool' 9-max Seat #1 is the button
Seat 1: Wilcox76607 ($19.50 in chips) 
Seat 2: chiyuki ($30.70 in chips) 
Seat 3: TErr18 ($13.46 in chips) 
Seat 4: deadmoneykid ($29.36 in chips) 
Seat 5: mariuka1 ($12 in chips) 
Seat 6: Th3Fog ($55.29 in chips) 
Seat 7: Tom1999 ($26.77 in chips) 
Seat 8: jethaz ($50.95 in chips) 
Seat 9: wtu1986 ($26.49 in chips) 
chiyuki: posts small blind $0.10
TErr18: posts big blind $0.25
*** HOLE CARDS ***
Dealt to chiyuki [Qh 8d]
deadmoneykid: folds 
mariuka1: folds 
Th3Fog: folds 
Tom1999: folds 
jethaz: folds 
wtu1986: raises $0.37 to $0.62
Wilcox76607: folds 
chiyuki: folds 
TErr18: folds 
Uncalled bet ($0.37) returned to wtu1986
wtu1986 collected $0.60 from pot
wtu1986: doesn't show hand 
*** SUMMARY ***
Total pot $0.60 | Rake $0 
Seat 1: Wilcox76607 (button) folded before Flop (didn't bet)
Seat 2: chiyuki (small blind) folded before Flop
Seat 3: TErr18 (big blind) folded before Flop
Seat 4: deadmoneykid folded before Flop (didn't bet)
Seat 5: mariuka1 folded before Flop (didn't bet)
Seat 6: Th3Fog folded before Flop (didn't bet)
Seat 7: Tom1999 folded before Flop (didn't bet)
Seat 8: jethaz folded before Flop (didn't bet)
Seat 9: wtu1986 collected ($0.60)



PokerStars Zoom Hand #84298946300:  Hold'em No Limit ($0.10/$0.25) - 2012/08/05 13:45:48 JST [2012/08/05 0:45:48 ET]
Table 'Whirlpool' 9-max Seat #1 is the button
Seat 1: chiyuki ($30.60 in chips) 
Seat 2: TraderYao ($27.47 in chips) 
Seat 3: KeLevro0 ($13.41 in chips) 
Seat 4: mariuka1 ($12 in chips) 
Seat 5: petersmiths ($45.05 in chips) 
Seat 6: fwani ($29.75 in chips) 
Seat 7: Lasutchik ($9.40 in chips) 
Seat 8: Suhoff76 ($39.13 in chips) 
Seat 9: Th3Fog ($85.65 in chips) 
TraderYao: posts small blind $0.10
KeLevro0: posts big blind $0.25
*** HOLE CARDS ***
Dealt to chiyuki [5s 2d]
mariuka1: folds 
petersmiths: folds 
fwani: raises $0.35 to $0.60
Lasutchik: folds 
Suhoff76: folds 
Th3Fog: folds 
chiyuki: folds 
TraderYao: folds 
KeLevro0: folds 
Uncalled bet ($0.35) returned to fwani
fwani collected $0.60 from pot
fwani: doesn't show hand 
*** SUMMARY ***
Total pot $0.60 | Rake $0 
Seat 1: chiyuki (button) folded before Flop (didn't bet)
Seat 2: TraderYao (small blind) folded before Flop
Seat 3: KeLevro0 (big blind) folded before Flop
Seat 4: mariuka1 folded before Flop (didn't bet)
Seat 5: petersmiths folded before Flop (didn't bet)
Seat 6: fwani collected ($0.60)
Seat 7: Lasutchik folded before Flop (didn't bet)
Seat 8: Suhoff76 folded before Flop (didn't bet)
Seat 9: Th3Fog folded before Flop (didn't bet)



PokerStars Zoom Hand #84298945330:  Hold'em No Limit ($0.10/$0.25) - 2012/08/05 13:45:44 JST [2012/08/05 0:45:44 ET]
Table 'Whirlpool' 9-max Seat #1 is the button
Seat 1: BlackZafiro ($25 in chips) 
Seat 2: PetitAlejo ($25.10 in chips) 
Seat 3: slapshot2011 ($46.02 in chips) 
Seat 4: jethaz ($61.89 in chips) 
Seat 5: chiyuki ($30.60 in chips) 
Seat 6: Tom1999 ($26.77 in chips) 
Seat 7: TamiKarpen13 ($15.96 in chips) 
Seat 8: Lasutchik ($9.40 in chips) 
Seat 9: NastyMcNast ($32.40 in chips) 
PetitAlejo: posts small blind $0.10
slapshot2011: posts big blind $0.25
*** HOLE CARDS ***
Dealt to chiyuki [Jh Td]
jethaz: folds 
chiyuki: folds 
Tom1999: folds 
TamiKarpen13: folds 
Lasutchik: folds 
NastyMcNast: raises $0.50 to $0.75
BlackZafiro: folds 
PetitAlejo: raises $1.50 to $2.25
slapshot2011: folds 
NastyMcNast: folds 
Uncalled bet ($1.50) returned to PetitAlejo
PetitAlejo collected $1.75 from pot
PetitAlejo: doesn't show hand 
*** SUMMARY ***
Total pot $1.75 | Rake $0 
Seat 1: BlackZafiro (button) folded before Flop (didn't bet)
Seat 2: PetitAlejo (small blind) collected ($1.75)
Seat 3: slapshot2011 (big blind) folded before Flop
Seat 4: jethaz folded before Flop (didn't bet)
Seat 5: chiyuki folded before Flop (didn't bet)
Seat 6: Tom1999 folded before Flop (didn't bet)
Seat 7: TamiKarpen13 folded before Flop (didn't bet)
Seat 8: Lasutchik folded before Flop (didn't bet)
Seat 9: NastyMcNast folded before Flop



PokerStars Zoom Hand #84298950413:  Hold'em No Limit ($0.10/$0.25) - 2012/08/05 13:46:04 JST [2012/08/05 0:46:04 ET]
Table 'Whirlpool' 9-max Seat #1 is the button
Seat 1: carlosrbr ($15.63 in chips) 
Seat 2: ygoegoe ($26.21 in chips) 
Seat 3: chiyuki ($30.60 in chips) 
Seat 4: Lasutchik ($9.40 in chips) 
Seat 5: fwani ($26.71 in chips) 
Seat 6: TraderYao ($24.90 in chips) 
Seat 7: Suhoff76 ($30.45 in chips) 
Seat 8: wtu1986 ($24.90 in chips) 
Seat 9: KeLevro0 ($13.16 in chips) 
ygoegoe: posts small blind $0.10
chiyuki: posts big blind $0.25
*** HOLE CARDS ***
Dealt to chiyuki [7s Qd]
Lasutchik: folds 
fwani: folds 
TraderYao: folds 
Suhoff76: raises $0.32 to $0.57
wtu1986: folds 
KeLevro0: folds 
carlosrbr: folds 
ygoegoe: folds 
chiyuki: calls $0.32
*** FLOP *** [Td As 2c]
chiyuki: checks 
Suhoff76: checks 
*** TURN *** [Td As 2c] [6h]
chiyuki: bets $0.75
Suhoff76: folds 
Uncalled bet ($0.75) returned to chiyuki
chiyuki collected $1.18 from pot
chiyuki: doesn't show hand 
*** SUMMARY ***
Total pot $1.24 | Rake $0.06 
Board [Td As 2c 6h]
Seat 1: carlosrbr (button) folded before Flop (didn't bet)
Seat 2: ygoegoe (small blind) folded before Flop
Seat 3: chiyuki (big blind) collected ($1.18)
Seat 4: Lasutchik folded before Flop (didn't bet)
Seat 5: fwani folded before Flop (didn't bet)
Seat 6: TraderYao folded before Flop (didn't bet)
Seat 7: Suhoff76 folded on the Turn
Seat 8: wtu1986 folded before Flop (didn't bet)
Seat 9: KeLevro0 folded before Flop (didn't bet)



PokerStars Zoom Hand #84298947049:  Hold'em No Limit ($0.10/$0.25) - 2012/08/05 13:45:51 JST [2012/08/05 0:45:51 ET]
Table 'Whirlpool' 9-max Seat #1 is the button
Seat 1: silvno31 ($40.12 in chips) 
Seat 2: hirozo ($25 in chips) 
Seat 3: deadmoneykid ($20.82 in chips) 
Seat 4: chiyuki ($30.60 in chips) 
Seat 5: Alvinpe85 ($27.66 in chips) 
Seat 6: DjJooni ($12 in chips) 
Seat 7: cR!Ma*aRm ($39.31 in chips) 
Seat 8: BlackValaR ($6.58 in chips) 
Seat 9: stankfist420 ($18.51 in chips) 
hirozo: posts small blind $0.10
deadmoneykid: posts big blind $0.25
*** HOLE CARDS ***
Dealt to chiyuki [7c As]
chiyuki: folds 
Alvinpe85: folds 
DjJooni: folds 
cR!Ma*aRm: calls $0.25
BlackValaR: folds 
stankfist420: raises $1 to $1.25
silvno31: folds 
hirozo: calls $1.15
deadmoneykid: folds 
cR!Ma*aRm: calls $1
*** FLOP *** [Ah Ts 5s]
hirozo: checks 
cR!Ma*aRm: bets $0.25
stankfist420: raises $2 to $2.25
hirozo: folds 
cR!Ma*aRm: folds 
Uncalled bet ($2) returned to stankfist420
stankfist420 collected $4.30 from pot
stankfist420: doesn't show hand 
*** SUMMARY ***
Total pot $4.50 | Rake $0.20 
Board [Ah Ts 5s]
Seat 1: silvno31 (button) folded before Flop (didn't bet)
Seat 2: hirozo (small blind) folded on the Flop
Seat 3: deadmoneykid (big blind) folded before Flop
Seat 4: chiyuki folded before Flop (didn't bet)
Seat 5: Alvinpe85 folded before Flop (didn't bet)
Seat 6: DjJooni folded before Flop (didn't bet)
Seat 7: cR!Ma*aRm folded on the Flop
Seat 8: BlackValaR folded before Flop (didn't bet)
Seat 9: stankfist420 collected ($4.30)



PokerStars Zoom Hand #84298948617:  Hold'em No Limit ($0.10/$0.25) - 2012/08/05 13:45:57 JST [2012/08/05 0:45:57 ET]
Table 'Whirlpool' 9-max Seat #1 is the button
Seat 1: KeLevro0 ($13.16 in chips) 
Seat 2: Th3Fog ($85.65 in chips) 
Seat 3: Anafim ($18.63 in chips) 
Seat 4: timburonps ($25.10 in chips) 
Seat 5: lovinlife5 ($21.15 in chips) 
Seat 6: leo2095 ($14.43 in chips) 
Seat 7: Roglus ($65.01 in chips) 
Seat 8: chiyuki ($30.60 in chips) 
Seat 9: wtu1986 ($24.90 in chips) 
Th3Fog: posts small blind $0.10
Anafim: posts big blind $0.25
*** HOLE CARDS ***
Dealt to chiyuki [9c Ad]
timburonps: folds 
lovinlife5: folds 
leo2095: folds 
Roglus: folds 
chiyuki: folds 
wtu1986: folds 
KeLevro0: folds 
Th3Fog: raises $0.35 to $0.60
Anafim: calls $0.35
*** FLOP *** [Jh 6d 4s]
Th3Fog: bets $0.67
Anafim: calls $0.67
*** TURN *** [Jh 6d 4s] [9s]
Th3Fog: bets $1.06
Anafim: raises $1.06 to $2.12
Th3Fog: calls $1.06
*** RIVER *** [Jh 6d 4s 9s] [Kc]
Th3Fog: checks 
Anafim: checks 
*** SHOW DOWN ***
Th3Fog: shows [As 6s] (a pair of Sixes)
Anafim: shows [Js Qc] (a pair of Jacks)
Anafim collected $6.47 from pot
*** SUMMARY ***
Total pot $6.78 | Rake $0.31 
Board [Jh 6d 4s 9s Kc]
Seat 1: KeLevro0 (button) folded before Flop (didn't bet)
Seat 2: Th3Fog (small blind) showed [As 6s] and lost with a pair of Sixes
Seat 3: Anafim (big blind) showed [Js Qc] and won ($6.47) with a pair of Jacks
Seat 4: timburonps folded before Flop (didn't bet)
Seat 5: lovinlife5 folded before Flop (didn't bet)
Seat 6: leo2095 folded before Flop (didn't bet)
Seat 7: Roglus folded before Flop (didn't bet)
Seat 8: chiyuki folded before Flop (didn't bet)
Seat 9: wtu1986 folded before Flop (didn't bet)



PokerStars Zoom Hand #84298961955:  Hold'em No Limit ($0.10/$0.25) - 2012/08/05 13:46:49 JST [2012/08/05 0:46:49 ET]
Table 'Whirlpool' 9-max Seat #1 is the button
Seat 1: Th3Fog ($55.52 in chips) 
Seat 2: wtu1986 ($26.33 in chips) 
Seat 3: agurio ($31.36 in chips) 
Seat 4: KeLevro0 ($13.06 in chips) 
Seat 5: Landybob ($35 in chips) 
Seat 6: chiyuki ($31.21 in chips) 
Seat 7: Suhoff76 ($39.13 in chips) 
Seat 8: ShockLaMuc ($27.96 in chips) 
Seat 9: TErr18 ($12.96 in chips) 
wtu1986: posts small blind $0.10
agurio: posts big blind $0.25
*** HOLE CARDS ***
Dealt to chiyuki [Qd 4c]
KeLevro0: folds 
Landybob: folds 
chiyuki: folds 
Suhoff76: folds 
ShockLaMuc: folds 
TErr18: folds 
Th3Fog: folds 
wtu1986: folds 
Uncalled bet ($0.15) returned to agurio
agurio collected $0.20 from pot
agurio: doesn't show hand 
*** SUMMARY ***
Total pot $0.20 | Rake $0 
Seat 1: Th3Fog (button) folded before Flop (didn't bet)
Seat 2: wtu1986 (small blind) folded before Flop
Seat 3: agurio (big blind) collected ($0.20)
Seat 4: KeLevro0 folded before Flop (didn't bet)
Seat 5: Landybob folded before Flop (didn't bet)
Seat 6: chiyuki folded before Flop (didn't bet)
Seat 7: Suhoff76 folded before Flop (didn't bet)
Seat 8: ShockLaMuc folded before Flop (didn't bet)
Seat 9: TErr18 folded before Flop (didn't bet)



PokerStars Zoom Hand #84298965066:  Hold'em No Limit ($0.10/$0.25) - 2012/08/05 13:47:02 JST [2012/08/05 0:47:02 ET]
Table 'Whirlpool' 9-max Seat #1 is the button
Seat 1: ll_LaMeR_ll ($61.53 in chips) 
Seat 2: chiyuki ($31.21 in chips) 
Seat 3: ShockLaMuc ($27.96 in chips) 
Seat 4: roksmokndonk ($37.87 in chips) 
Seat 5: timburonps ($25 in chips) 
Seat 6: Dejacob ($33.21 in chips) 
Seat 7: KeLevro0 ($9.65 in chips) 
Seat 8: flyinprits ($26.90 in chips) 
Seat 9: wtu1986 ($24.65 in chips) 
chiyuki: posts small blind $0.10
ShockLaMuc: posts big blind $0.25
*** HOLE CARDS ***
Dealt to chiyuki [6h Js]
roksmokndonk: folds 
timburonps: folds 
Dejacob: folds 
KeLevro0: folds 
flyinprits: folds 
wtu1986: raises $0.50 to $0.75
ll_LaMeR_ll: folds 
chiyuki: folds 
ShockLaMuc: folds 
Uncalled bet ($0.50) returned to wtu1986
wtu1986 collected $0.60 from pot
wtu1986: doesn't show hand 
*** SUMMARY ***
Total pot $0.60 | Rake $0 
Seat 1: ll_LaMeR_ll (button) folded before Flop (didn't bet)
Seat 2: chiyuki (small blind) folded before Flop
Seat 3: ShockLaMuc (big blind) folded before Flop
Seat 4: roksmokndonk folded before Flop (didn't bet)
Seat 5: timburonps folded before Flop (didn't bet)
Seat 6: Dejacob folded before Flop (didn't bet)
Seat 7: KeLevro0 folded before Flop (didn't bet)
Seat 8: flyinprits folded before Flop (didn't bet)
Seat 9: wtu1986 collected ($0.60)



PokerStars Zoom Hand #84298968975:  Hold'em No Limit ($0.10/$0.25) - 2012/08/05 13:47:17 JST [2012/08/05 0:47:17 ET]
Table 'Whirlpool' 9-max Seat #1 is the button
Seat 1: fwani ($26.01 in chips) 
Seat 2: cR!Ma*aRm ($38.26 in chips) 
Seat 3: RomarioJa ($4.73 in chips) 
Seat 4: chiyuki ($31.11 in chips) 
Seat 5: PetitAlejo ($25 in chips) 
Seat 6: TErr18 ($12.96 in chips) 
Seat 7: NastyMcNast ($25 in chips) 
Seat 8: BlOnDhOlIc ($33.33 in chips) 
Seat 9: deadmoneykid ($29.01 in chips) 
cR!Ma*aRm: posts small blind $0.10
RomarioJa: posts big blind $0.25
*** HOLE CARDS ***
Dealt to chiyuki [9c 3c]
chiyuki: folds 
PetitAlejo: folds 
TErr18: folds 
NastyMcNast: folds 
BlOnDhOlIc: folds 
deadmoneykid: folds 
fwani: folds 
cR!Ma*aRm: raises $0.50 to $0.75
RomarioJa: folds 
Uncalled bet ($0.50) returned to cR!Ma*aRm
cR!Ma*aRm collected $0.50 from pot
cR!Ma*aRm: doesn't show hand 
*** SUMMARY ***
Total pot $0.50 | Rake $0 
Seat 1: fwani (button) folded before Flop (didn't bet)
Seat 2: cR!Ma*aRm (small blind) collected ($0.50)
Seat 3: RomarioJa (big blind) folded before Flop
Seat 4: chiyuki folded before Flop (didn't bet)
Seat 5: PetitAlejo folded before Flop (didn't bet)
Seat 6: TErr18 folded before Flop (didn't bet)
Seat 7: NastyMcNast folded before Flop (didn't bet)
Seat 8: BlOnDhOlIc folded before Flop (didn't bet)
Seat 9: deadmoneykid folded before Flop (didn't bet)



PokerStars Zoom Hand #84298970470:  Hold'em No Limit ($0.10/$0.25) - 2012/08/05 13:47:23 JST [2012/08/05 0:47:23 ET]
Table 'Whirlpool' 9-max Seat #1 is the button
Seat 1: Suhoff76 ($29.63 in chips) 
Seat 2: Ellen1947 ($34.15 in chips) 
Seat 3: agurio ($30.90 in chips) 
Seat 4: ShockLaMuc ($27.71 in chips) 
Seat 5: Roglus ($16.04 in chips) 
Seat 6: PetitAlejo ($26.10 in chips) 
Seat 7: puffy5533 ($23.30 in chips) 
Seat 8: Th3Fog ($82.01 in chips) 
Seat 9: chiyuki ($31.11 in chips) 
Ellen1947: posts small blind $0.10
agurio: posts big blind $0.25
*** HOLE CARDS ***
Dealt to chiyuki [Ts Qh]
ShockLaMuc: folds 
Roglus: folds 
PetitAlejo: folds 
puffy5533: folds 
Th3Fog: folds 
chiyuki: raises $0.50 to $0.75
Suhoff76: folds 
Ellen1947: folds 
agurio: folds 
Uncalled bet ($0.50) returned to chiyuki
chiyuki collected $0.60 from pot
chiyuki: doesn't show hand 
*** SUMMARY ***
Total pot $0.60 | Rake $0 
Seat 1: Suhoff76 (button) folded before Flop (didn't bet)
Seat 2: Ellen1947 (small blind) folded before Flop
Seat 3: agurio (big blind) folded before Flop
Seat 4: ShockLaMuc folded before Flop (didn't bet)
Seat 5: Roglus folded before Flop (didn't bet)
Seat 6: PetitAlejo folded before Flop (didn't bet)
Seat 7: puffy5533 folded before Flop (didn't bet)
Seat 8: Th3Fog folded before Flop (didn't bet)
Seat 9: chiyuki collected ($0.60)



PokerStars Zoom Hand #84298959849:  Hold'em No Limit ($0.10/$0.25) - 2012/08/05 13:46:41 JST [2012/08/05 0:46:41 ET]
Table 'Whirlpool' 9-max Seat #1 is the button
Seat 1: solawind ($12.37 in chips) 
Seat 2: PetitAlejo ($26.02 in chips) 
Seat 3: Tom1999 ($15 in chips) 
Seat 4: Loholov ($18.83 in chips) 
Seat 5: cr0lox ($24.25 in chips) 
Seat 6: fwani ($38.90 in chips) 
Seat 7: ChrisCDee ($25 in chips) 
Seat 8: BlOnDhOlIc ($33.08 in chips) 
Seat 9: chiyuki ($31.21 in chips) 
PetitAlejo: posts small blind $0.10
Tom1999: posts big blind $0.25
*** HOLE CARDS ***
Dealt to chiyuki [Tc 4s]
Loholov: folds 
cr0lox: calls $0.25
fwani: folds 
ChrisCDee: folds 
BlOnDhOlIc: folds 
chiyuki: folds 
solawind: folds 
PetitAlejo: raises $0.88 to $1.13
Tom1999: calls $0.88
cr0lox: calls $0.88
*** FLOP *** [Ah 5h 5c]
PetitAlejo: bets $1.62
Tom1999: calls $1.62
cr0lox: folds 
*** TURN *** [Ah 5h 5c] [Qh]
PetitAlejo: checks 
Tom1999: bets $1.50
PetitAlejo: calls $1.50
*** RIVER *** [Ah 5h 5c Qh] [9h]
PetitAlejo: bets $1
Tom1999: calls $1
*** SHOW DOWN ***
PetitAlejo: shows [Kd Ad] (two pair, Aces and Fives)
Tom1999: shows [8h 8c] (a flush, Ace high)
Tom1999 collected $11.11 from pot
*** SUMMARY ***
Total pot $11.63 | Rake $0.52 
Board [Ah 5h 5c Qh 9h]
Seat 1: solawind (button) folded before Flop (didn't bet)
Seat 2: PetitAlejo (small blind) showed [Kd Ad] and lost with two pair, Aces and Fives
Seat 3: Tom1999 (big blind) showed [8h 8c] and won ($11.11) with a flush, Ace high
Seat 4: Loholov folded before Flop (didn't bet)
Seat 5: cr0lox folded on the Flop
Seat 6: fwani folded before Flop (didn't bet)
Seat 7: ChrisCDee folded before Flop (didn't bet)
Seat 8: BlOnDhOlIc folded before Flop (didn't bet)
Seat 9: chiyuki folded before Flop (didn't bet)



PokerStars Zoom Hand #84298963235:  Hold'em No Limit ($0.10/$0.25) - 2012/08/05 13:46:54 JST [2012/08/05 0:46:54 ET]
Table 'Whirlpool' 9-max Seat #1 is the button
Seat 1: Landybob ($35 in chips) 
Seat 2: ladymadon107 ($22.44 in chips) 
Seat 3: TraderYao ($25 in chips) 
Seat 4: chiyuki ($31.21 in chips) 
Seat 5: jethaz ($66.02 in chips) 
Seat 6: ShockLaMuc ($27.96 in chips) 
Seat 7: Dejacob ($31.36 in chips) 
Seat 8: wtu1986 ($24.65 in chips) 
Seat 9: timburonps ($25 in chips) 
ladymadon107: posts small blind $0.10
TraderYao: posts big blind $0.25
*** HOLE CARDS ***
Dealt to chiyuki [Ah Jc]
chiyuki: folds 
jethaz: raises $0.50 to $0.75
ShockLaMuc: folds 
Dejacob: folds 
wtu1986: folds 
timburonps: folds 
Landybob: folds 
ladymadon107: calls $0.65
TraderYao: calls $0.50
*** FLOP *** [9d 7d 3c]
ladymadon107: bets $0.50
TraderYao: calls $0.50
jethaz: folds 
*** TURN *** [9d 7d 3c] [Qh]
ladymadon107: bets $0.50
TraderYao: calls $0.50
*** RIVER *** [9d 7d 3c Qh] [5s]
ladymadon107: checks 
TraderYao: bets $2.51
ladymadon107: folds 
Uncalled bet ($2.51) returned to TraderYao
TraderYao collected $4.06 from pot
TraderYao: doesn't show hand 
*** SUMMARY ***
Total pot $4.25 | Rake $0.19 
Board [9d 7d 3c Qh 5s]
Seat 1: Landybob (button) folded before Flop (didn't bet)
Seat 2: ladymadon107 (small blind) folded on the River
Seat 3: TraderYao (big blind) collected ($4.06)
Seat 4: chiyuki folded before Flop (didn't bet)
Seat 5: jethaz folded on the Flop
Seat 6: ShockLaMuc folded before Flop (didn't bet)
Seat 7: Dejacob folded before Flop (didn't bet)
Seat 8: wtu1986 folded before Flop (didn't bet)
Seat 9: timburonps folded before Flop (didn't bet)



PokerStars Zoom Hand #84298966072:  Hold'em No Limit ($0.10/$0.25) - 2012/08/05 13:47:06 JST [2012/08/05 0:47:06 ET]
Table 'Whirlpool' 9-max Seat #1 is the button
Seat 1: TamiKarpen13 ($6.66 in chips) 
Seat 2: KeLevro0 ($9.65 in chips) 
Seat 3: solawind ($12.37 in chips) 
Seat 4: roksmokndonk ($37.87 in chips) 
Seat 5: Tuan0109 ($10.51 in chips) 
Seat 6: ChrisCDee ($25 in chips) 
Seat 7: chiyuki ($31.11 in chips) 
Seat 8: KAKamiro ($35.36 in chips) 
Seat 9: ll_LaMeR_ll ($61.53 in chips) 
KeLevro0: posts small blind $0.10
solawind: posts big blind $0.25
*** HOLE CARDS ***
Dealt to chiyuki [3d Tc]
roksmokndonk: folds 
Tuan0109: calls $0.25
ChrisCDee: folds 
chiyuki: folds 
KAKamiro: folds 
ll_LaMeR_ll: folds 
TamiKarpen13: folds 
KeLevro0: raises $0.42 to $0.67
solawind: raises $0.83 to $1.50
Tuan0109: calls $1.25
KeLevro0: calls $0.83
*** FLOP *** [Td Ts 6h]
KeLevro0: checks 
solawind: checks 
Tuan0109: checks 
*** TURN *** [Td Ts 6h] [Kh]
KeLevro0: checks 
solawind: checks 
Tuan0109: checks 
*** RIVER *** [Td Ts 6h Kh] [6c]
KeLevro0: checks 
solawind: bets $1.29
Tuan0109: folds 
KeLevro0: folds 
Uncalled bet ($1.29) returned to solawind
solawind collected $4.30 from pot
solawind: doesn't show hand 
*** SUMMARY ***
Total pot $4.50 | Rake $0.20 
Board [Td Ts 6h Kh 6c]
Seat 1: TamiKarpen13 (button) folded before Flop (didn't bet)
Seat 2: KeLevro0 (small blind) folded on the River
Seat 3: solawind (big blind) collected ($4.30)
Seat 4: roksmokndonk folded before Flop (didn't bet)
Seat 5: Tuan0109 folded on the River
Seat 6: ChrisCDee folded before Flop (didn't bet)
Seat 7: chiyuki folded before Flop (didn't bet)
Seat 8: KAKamiro folded before Flop (didn't bet)
Seat 9: ll_LaMeR_ll folded before Flop (didn't bet)



PokerStars Zoom Hand #84298977332:  Hold'em No Limit ($0.10/$0.25) - 2012/08/05 13:47:50 JST [2012/08/05 0:47:50 ET]
Table 'Whirlpool' 9-max Seat #1 is the button
Seat 1: chiyuki ($31.46 in chips) 
Seat 2: BlOnDhOlIc ($62.92 in chips) 
Seat 3: deadmoneykid ($29.01 in chips) 
Seat 4: ShockLaMuc ($25.19 in chips) 
Seat 5: seula i ($40.50 in chips) 
Seat 6: KeLevro0 ($13.06 in chips) 
Seat 7: NastyMcNast ($31.63 in chips) 
Seat 8: PetitAlejo ($35.24 in chips) 
Seat 9: BlackZafiro ($25 in chips) 
BlOnDhOlIc: posts small blind $0.10
deadmoneykid: posts big blind $0.25
*** HOLE CARDS ***
Dealt to chiyuki [8s 8d]
ShockLaMuc: folds 
seula i: folds 
KeLevro0: folds 
NastyMcNast: raises $0.50 to $0.75
PetitAlejo: folds 
BlackZafiro: folds 
chiyuki: calls $0.75
BlOnDhOlIc: folds 
deadmoneykid: folds 
*** FLOP *** [Qc 8c Jc]
NastyMcNast: checks 
chiyuki: bets $1.77
NastyMcNast: folds 
Uncalled bet ($1.77) returned to chiyuki
chiyuki collected $1.77 from pot
chiyuki: doesn't show hand 
*** SUMMARY ***
Total pot $1.85 | Rake $0.08 
Board [Qc 8c Jc]
Seat 1: chiyuki (button) collected ($1.77)
Seat 2: BlOnDhOlIc (small blind) folded before Flop
Seat 3: deadmoneykid (big blind) folded before Flop
Seat 4: ShockLaMuc folded before Flop (didn't bet)
Seat 5: seula i folded before Flop (didn't bet)
Seat 6: KeLevro0 folded before Flop (didn't bet)
Seat 7: NastyMcNast folded on the Flop
Seat 8: PetitAlejo folded before Flop (didn't bet)
Seat 9: BlackZafiro folded before Flop (didn't bet)



PokerStars Zoom Hand #84298987069:  Hold'em No Limit ($0.10/$0.25) - 2012/08/05 13:48:29 JST [2012/08/05 0:48:29 ET]
Table 'Whirlpool' 9-max Seat #1 is the button
Seat 1: Suhoff76 ($29.28 in chips) 
Seat 2: Loholov ($15.10 in chips) 
Seat 3: chiyuki ($32.48 in chips) 
Seat 4: Th3Fog ($55.17 in chips) 
Seat 5: Ellen1947 ($32.76 in chips) 
Seat 6: stankfist420 ($22.44 in chips) 
Seat 7: timburonps ($28.08 in chips) 
Seat 8: hirozo ($25.48 in chips) 
Seat 9: RikkStroken ($14.65 in chips) 
Loholov: posts small blind $0.10
chiyuki: posts big blind $0.25
*** HOLE CARDS ***
Dealt to chiyuki [Qc 3c]
Th3Fog: folds 
Ellen1947: folds 
stankfist420: folds 
timburonps: folds 
hirozo: folds 
RikkStroken: folds 
Suhoff76: folds 
Loholov: folds 
Uncalled bet ($0.15) returned to chiyuki
chiyuki collected $0.20 from pot
chiyuki: doesn't show hand 
*** SUMMARY ***
Total pot $0.20 | Rake $0 
Seat 1: Suhoff76 (button) folded before Flop (didn't bet)
Seat 2: Loholov (small blind) folded before Flop
Seat 3: chiyuki (big blind) collected ($0.20)
Seat 4: Th3Fog folded before Flop (didn't bet)
Seat 5: Ellen1947 folded before Flop (didn't bet)
Seat 6: stankfist420 folded before Flop (didn't bet)
Seat 7: timburonps folded before Flop (didn't bet)
Seat 8: hirozo folded before Flop (didn't bet)
Seat 9: RikkStroken folded before Flop (didn't bet)



PokerStars Zoom Hand #84298991988:  Hold'em No Limit ($0.10/$0.25) - 2012/08/05 13:48:48 JST [2012/08/05 0:48:48 ET]
Table 'Whirlpool' 9-max Seat #1 is the button
Seat 1: TraderYao ($26.48 in chips) 
Seat 2: NastyMcNast ($63.35 in chips) 
Seat 3: BlOnDhOlIc ($62.82 in chips) 
Seat 4: KAKamiro ($38.82 in chips) 
Seat 5: jethaz ($64.52 in chips) 
Seat 6: TErr18 ($13.39 in chips) 
Seat 7: chiyuki ($32.58 in chips) 
Seat 8: Suhoff76 ($29.18 in chips) 
Seat 9: solawind ($15.07 in chips) 
NastyMcNast: posts small blind $0.10
BlOnDhOlIc: posts big blind $0.25
*** HOLE CARDS ***
Dealt to chiyuki [Jd 7s]
KAKamiro: folds 
jethaz: folds 
TErr18: folds 
chiyuki: folds 
Suhoff76: raises $0.32 to $0.57
solawind: folds 
TraderYao: folds 
NastyMcNast: folds 
BlOnDhOlIc: folds 
Uncalled bet ($0.32) returned to Suhoff76
Suhoff76 collected $0.60 from pot
Suhoff76: doesn't show hand 
*** SUMMARY ***
Total pot $0.60 | Rake $0 
Seat 1: TraderYao (button) folded before Flop (didn't bet)
Seat 2: NastyMcNast (small blind) folded before Flop
Seat 3: BlOnDhOlIc (big blind) folded before Flop
Seat 4: KAKamiro folded before Flop (didn't bet)
Seat 5: jethaz folded before Flop (didn't bet)
Seat 6: TErr18 folded before Flop (didn't bet)
Seat 7: chiyuki folded before Flop (didn't bet)
Seat 8: Suhoff76 collected ($0.60)
Seat 9: solawind folded before Flop (didn't bet)



PokerStars Zoom Hand #84298992772:  Hold'em No Limit ($0.10/$0.25) - 2012/08/05 13:48:51 JST [2012/08/05 0:48:51 ET]
Table 'Whirlpool' 9-max Seat #1 is the button
Seat 1: hirozo ($25 in chips) 
Seat 2: Anafim ($15.46 in chips) 
Seat 3: ygoegoe ($29.72 in chips) 
Seat 4: TErr18 ($13.39 in chips) 
Seat 5: chiyuki ($32.58 in chips) 
Seat 6: KeLevro0 ($12.55 in chips) 
Seat 7: ShockLaMuc ($27.36 in chips) 
Seat 8: taksist889 ($18.77 in chips) 
Seat 9: PetitAlejo ($26.10 in chips) 
Anafim: posts small blind $0.10
ygoegoe: posts big blind $0.25
*** HOLE CARDS ***
Dealt to chiyuki [4h 8s]
TErr18: folds 
chiyuki: folds 
KeLevro0: folds 
ShockLaMuc: folds 
taksist889: folds 
PetitAlejo: raises $0.50 to $0.75
hirozo: raises $1.60 to $2.35
Anafim: folds 
ygoegoe: folds 
PetitAlejo: folds 
Uncalled bet ($1.60) returned to hirozo
hirozo collected $1.85 from pot
hirozo: doesn't show hand 
*** SUMMARY ***
Total pot $1.85 | Rake $0 
Seat 1: hirozo (button) collected ($1.85)
Seat 2: Anafim (small blind) folded before Flop
Seat 3: ygoegoe (big blind) folded before Flop
Seat 4: TErr18 folded before Flop (didn't bet)
Seat 5: chiyuki folded before Flop (didn't bet)
Seat 6: KeLevro0 folded before Flop (didn't bet)
Seat 7: ShockLaMuc folded before Flop (didn't bet)
Seat 8: taksist889 folded before Flop (didn't bet)
Seat 9: PetitAlejo folded before Flop



PokerStars Zoom Hand #84298995075:  Hold'em No Limit ($0.10/$0.25) - 2012/08/05 13:49:00 JST [2012/08/05 0:49:00 ET]
Table 'Whirlpool' 9-max Seat #1 is the button
Seat 1: slapshot2011 ($43.64 in chips) 
Seat 2: Suhoff76 ($34.88 in chips) 
Seat 3: munky3 ($35.22 in chips) 
Seat 4: PetitAlejo ($32.24 in chips) 
Seat 5: agurio ($30.65 in chips) 
Seat 6: Loholov ($20.23 in chips) 
Seat 7: Ellen1947 ($33.80 in chips) 
Seat 8: chiyuki ($32.48 in chips) 
Seat 9: Th3Fog ($22.46 in chips) 
Suhoff76: posts small blind $0.10
munky3: posts big blind $0.25
*** HOLE CARDS ***
Dealt to chiyuki [Jd 6h]
PetitAlejo: folds 
agurio: folds 
Loholov: folds 
Ellen1947: raises $0.50 to $0.75
chiyuki: folds 
Th3Fog: folds 
slapshot2011: folds 
Suhoff76: folds 
munky3: folds 
Uncalled bet ($0.50) returned to Ellen1947
Ellen1947 collected $0.60 from pot
Ellen1947: doesn't show hand 
*** SUMMARY ***
Total pot $0.60 | Rake $0 
Seat 1: slapshot2011 (button) folded before Flop (didn't bet)
Seat 2: Suhoff76 (small blind) folded before Flop
Seat 3: munky3 (big blind) folded before Flop
Seat 4: PetitAlejo folded before Flop (didn't bet)
Seat 5: agurio folded before Flop (didn't bet)
Seat 6: Loholov folded before Flop (didn't bet)
Seat 7: Ellen1947 collected ($0.60)
Seat 8: chiyuki folded before Flop (didn't bet)
Seat 9: Th3Fog folded before Flop (didn't bet)



PokerStars Zoom Hand #84298996890:  Hold'em No Limit ($0.10/$0.25) - 2012/08/05 13:49:07 JST [2012/08/05 0:49:07 ET]
Table 'Whirlpool' 9-max Seat #1 is the button
Seat 1: RikkStroken ($15 in chips) 
Seat 2: softdesign ($78.12 in chips) 
Seat 3: TErr18 ($13.39 in chips) 
Seat 4: solawind ($15.07 in chips) 
Seat 5: BlackZafiro ($25 in chips) 
Seat 6: chiyuki ($32.48 in chips) 
Seat 7: timburonps ($33.11 in chips) 
Seat 8: NastyMcNast ($63.25 in chips) 
Seat 9: deadmoneykid ($28.66 in chips) 
softdesign: posts small blind $0.10
TErr18: posts big blind $0.25
*** HOLE CARDS ***
Dealt to chiyuki [9c Qs]
solawind: folds 
BlackZafiro: folds 
chiyuki: folds 
timburonps: folds 
NastyMcNast: folds 
deadmoneykid: folds 
RikkStroken: raises $0.25 to $0.50
softdesign: folds 
TErr18: folds 
Uncalled bet ($0.25) returned to RikkStroken
RikkStroken collected $0.60 from pot
RikkStroken: doesn't show hand 
*** SUMMARY ***
Total pot $0.60 | Rake $0 
Seat 1: RikkStroken (button) collected ($0.60)
Seat 2: softdesign (small blind) folded before Flop
Seat 3: TErr18 (big blind) folded before Flop
Seat 4: solawind folded before Flop (didn't bet)
Seat 5: BlackZafiro folded before Flop (didn't bet)
Seat 6: chiyuki folded before Flop (didn't bet)
Seat 7: timburonps folded before Flop (didn't bet)
Seat 8: NastyMcNast folded before Flop (didn't bet)
Seat 9: deadmoneykid folded before Flop (didn't bet)



PokerStars Zoom Hand #84298993812:  Hold'em No Limit ($0.10/$0.25) - 2012/08/05 13:48:55 JST [2012/08/05 0:48:55 ET]
Table 'Whirlpool' 9-max Seat #1 is the button
Seat 1: ChrisCDee ($25 in chips) 
Seat 2: chiyuki ($32.58 in chips) 
Seat 3: hirozo ($28 in chips) 
Seat 4: NastyMcNast ($63.25 in chips) 
Seat 5: BlackZafiro ($25 in chips) 
Seat 6: PetitAlejo ($32.24 in chips) 
Seat 7: slapshot2011 ($43.64 in chips) 
Seat 8: seula i ($60.60 in chips) 
Seat 9: Ellen1947 ($33.80 in chips) 
chiyuki: posts small blind $0.10
hirozo: posts big blind $0.25
*** HOLE CARDS ***
Dealt to chiyuki [2h 7s]
NastyMcNast: folds 
BlackZafiro: folds 
PetitAlejo: folds 
slapshot2011: folds 
seula i: folds 
Ellen1947: folds 
ChrisCDee: raises $0.50 to $0.75
chiyuki: folds 
hirozo: calls $0.50
*** FLOP *** [Ac 4c Kc]
hirozo: checks 
ChrisCDee: bets $0.91
hirozo: folds 
Uncalled bet ($0.91) returned to ChrisCDee
ChrisCDee collected $1.53 from pot
ChrisCDee: doesn't show hand 
*** SUMMARY ***
Total pot $1.60 | Rake $0.07 
Board [Ac 4c Kc]
Seat 1: ChrisCDee (button) collected ($1.53)
Seat 2: chiyuki (small blind) folded before Flop
Seat 3: hirozo (big blind) folded on the Flop
Seat 4: NastyMcNast folded before Flop (didn't bet)
Seat 5: BlackZafiro folded before Flop (didn't bet)
Seat 6: PetitAlejo folded before Flop (didn't bet)
Seat 7: slapshot2011 folded before Flop (didn't bet)
Seat 8: seula i folded before Flop (didn't bet)
Seat 9: Ellen1947 folded before Flop (didn't bet)



PokerStars Zoom Hand #84298999143:  Hold'em No Limit ($0.10/$0.25) - 2012/08/05 13:49:16 JST [2012/08/05 0:49:16 ET]
Table 'Whirlpool' 9-max Seat #1 is the button
Seat 1: chiyuki ($32.48 in chips) 
Seat 2: seula i ($60.35 in chips) 
Seat 3: wtu1986 ($25.13 in chips) 
Seat 4: jethaz ($45.39 in chips) 
Seat 5: Dejacob ($32.03 in chips) 
Seat 6: Tom1999 ($17.51 in chips) 
Seat 7: BlackZafiro ($25.70 in chips) 
Seat 8: ShockLaMuc ($25.19 in chips) 
Seat 9: Jippyflip ($9.68 in chips) 
seula i: posts small blind $0.10
wtu1986: posts big blind $0.25
*** HOLE CARDS ***
Dealt to chiyuki [6h 9c]
jethaz: folds 
Dejacob: folds 
Tom1999: folds 
BlackZafiro: folds 
ShockLaMuc: folds 
Jippyflip: folds 
chiyuki: folds 
seula i: raises $0.50 to $0.75
wtu1986: folds 
Uncalled bet ($0.50) returned to seula i
seula i collected $0.50 from pot
seula i: doesn't show hand 
*** SUMMARY ***
Total pot $0.50 | Rake $0 
Seat 1: chiyuki (button) folded before Flop (didn't bet)
Seat 2: seula i (small blind) collected ($0.50)
Seat 3: wtu1986 (big blind) folded before Flop
Seat 4: jethaz folded before Flop (didn't bet)
Seat 5: Dejacob folded before Flop (didn't bet)
Seat 6: Tom1999 folded before Flop (didn't bet)
Seat 7: BlackZafiro folded before Flop (didn't bet)
Seat 8: ShockLaMuc folded before Flop (didn't bet)
Seat 9: Jippyflip folded before Flop (didn't bet)



PokerStars Zoom Hand #84298999888:  Hold'em No Limit ($0.10/$0.25) - 2012/08/05 13:49:20 JST [2012/08/05 0:49:20 ET]
Table 'Whirlpool' 9-max Seat #1 is the button
Seat 1: hirozo ($25 in chips) 
Seat 2: ChrisCDee ($25.10 in chips) 
Seat 3: agurio ($30.55 in chips) 
Seat 4: chiyuki ($32.48 in chips) 
Seat 5: Tom1999 ($17.51 in chips) 
Seat 6: Roglus ($17.73 in chips) 
Seat 7: munky3 ($34.97 in chips) 
Seat 8: ygoegoe ($25.26 in chips) 
Seat 9: timburonps ($33.11 in chips) 
ChrisCDee: posts small blind $0.10
agurio: posts big blind $0.25
*** HOLE CARDS ***
Dealt to chiyuki [Qs Qc]
chiyuki: raises $0.50 to $0.75
Tom1999: folds 
Roglus: folds 
munky3: calls $0.75
ygoegoe: folds 
timburonps: raises $1.50 to $2.25
hirozo: folds 
ChrisCDee: folds 
agurio: folds 
chiyuki: calls $1.50
munky3: calls $1.50
*** FLOP *** [4d Jh 2h]
chiyuki: checks 
munky3: checks 
timburonps: bets $4
chiyuki: folds 
munky3: calls $4
*** TURN *** [4d Jh 2h] [9c]
munky3: checks 
timburonps: checks 
*** RIVER *** [4d Jh 2h 9c] [Th]
munky3: checks 
timburonps: checks 
*** SHOW DOWN ***
munky3: shows [6s 6h] (a pair of Sixes)
timburonps: shows [Ks Kh] (a pair of Kings)
timburonps collected $14.42 from pot
*** SUMMARY ***
Total pot $15.10 | Rake $0.68 
Board [4d Jh 2h 9c Th]
Seat 1: hirozo (button) folded before Flop (didn't bet)
Seat 2: ChrisCDee (small blind) folded before Flop
Seat 3: agurio (big blind) folded before Flop
Seat 4: chiyuki folded on the Flop
Seat 5: Tom1999 folded before Flop (didn't bet)
Seat 6: Roglus folded before Flop (didn't bet)
Seat 7: munky3 showed [6s 6h] and lost with a pair of Sixes
Seat 8: ygoegoe folded before Flop (didn't bet)
Seat 9: timburonps showed [Ks Kh] and won ($14.42) with a pair of Kings



PokerStars Zoom Hand #84299012708:  Hold'em No Limit ($0.10/$0.25) - 2012/08/05 13:50:11 JST [2012/08/05 0:50:11 ET]
Table 'Whirlpool' 9-max Seat #1 is the button
Seat 1: KeLevro0 ($12.25 in chips) 
Seat 2: fwani ($38.72 in chips) 
Seat 3: chiyuki ($30.23 in chips) 
Seat 4: RomarioJa ($8.82 in chips) 
Seat 5: Suhoff76 ($28.23 in chips) 
Seat 6: Nerkit ($11.14 in chips) 
Seat 7: Dafleche ($20.23 in chips) 
Seat 8: timburonps ($41.28 in chips) 
Seat 9: Anafim ($15.46 in chips) 
fwani: posts small blind $0.10
chiyuki: posts big blind $0.25
*** HOLE CARDS ***
Dealt to chiyuki [6d Kd]
RomarioJa: folds 
Suhoff76: folds 
Nerkit: folds 
Dafleche: folds 
timburonps: folds 
Anafim: folds 
KeLevro0: folds 
fwani: folds 
Uncalled bet ($0.15) returned to chiyuki
chiyuki collected $0.20 from pot
chiyuki: doesn't show hand 
*** SUMMARY ***
Total pot $0.20 | Rake $0 
Seat 1: KeLevro0 (button) folded before Flop (didn't bet)
Seat 2: fwani (small blind) folded before Flop
Seat 3: chiyuki (big blind) collected ($0.20)
Seat 4: RomarioJa folded before Flop (didn't bet)
Seat 5: Suhoff76 folded before Flop (didn't bet)
Seat 6: Nerkit folded before Flop (didn't bet)
Seat 7: Dafleche folded before Flop (didn't bet)
Seat 8: timburonps folded before Flop (didn't bet)
Seat 9: Anafim folded before Flop (didn't bet)



PokerStars Zoom Hand #84299015404:  Hold'em No Limit ($0.10/$0.25) - 2012/08/05 13:50:22 JST [2012/08/05 0:50:22 ET]
Table 'Whirlpool' 9-max Seat #1 is the button
Seat 1: cr0lox ($23.40 in chips) 
Seat 2: jeff0923 ($25.73 in chips) 
Seat 3: TErr18 ($14.77 in chips) 
Seat 4: solawind ($13.97 in chips) 
Seat 5: hirozo ($26.85 in chips) 
Seat 6: RikkStroken ($12.75 in chips) 
Seat 7: BlOnDhOlIc ($63.37 in chips) 
Seat 8: deadmoneykid ($40.22 in chips) 
Seat 9: chiyuki ($30.33 in chips) 
jeff0923: posts small blind $0.10
TErr18: posts big blind $0.25
*** HOLE CARDS ***
Dealt to chiyuki [8d Ah]
solawind: folds 
hirozo: folds 
RikkStroken: folds 
BlOnDhOlIc: folds 
deadmoneykid: folds 
chiyuki: raises $0.50 to $0.75
cr0lox: folds 
jeff0923: folds 
TErr18: folds 
Uncalled bet ($0.50) returned to chiyuki
chiyuki collected $0.60 from pot
chiyuki: doesn't show hand 
*** SUMMARY ***
Total pot $0.60 | Rake $0 
Seat 1: cr0lox (button) folded before Flop (didn't bet)
Seat 2: jeff0923 (small blind) folded before Flop
Seat 3: TErr18 (big blind) folded before Flop
Seat 4: solawind folded before Flop (didn't bet)
Seat 5: hirozo folded before Flop (didn't bet)
Seat 6: RikkStroken folded before Flop (didn't bet)
Seat 7: BlOnDhOlIc folded before Flop (didn't bet)
Seat 8: deadmoneykid folded before Flop (didn't bet)
Seat 9: chiyuki collected ($0.60)



PokerStars Zoom Hand #84299023236:  Hold'em No Limit ($0.10/$0.25) - 2012/08/05 13:50:54 JST [2012/08/05 0:50:54 ET]
Table 'Whirlpool' 9-max Seat #1 is the button
Seat 1: Dafleche ($19.98 in chips) 
Seat 2: Ellen1947 ($34.89 in chips) 
Seat 3: Nerkit ($13.57 in chips) 
Seat 4: silvno31 ($40.89 in chips) 
Seat 5: chiyuki ($30.68 in chips) 
Seat 6: ygoegoe ($31.29 in chips) 
Seat 7: Lasutchik ($11.08 in chips) 
Seat 8: taksist889 ($17.67 in chips) 
Seat 9: Wilcox76607 ($17.20 in chips) 
Ellen1947: posts small blind $0.10
Nerkit: posts big blind $0.25
*** HOLE CARDS ***
Dealt to chiyuki [4s Ks]
silvno31: folds 
chiyuki: folds 
ygoegoe: folds 
Lasutchik: folds 
taksist889: folds 
Wilcox76607: folds 
Dafleche: folds 
Ellen1947: folds 
Uncalled bet ($0.15) returned to Nerkit
Nerkit collected $0.20 from pot
Nerkit: doesn't show hand 
*** SUMMARY ***
Total pot $0.20 | Rake $0 
Seat 1: Dafleche (button) folded before Flop (didn't bet)
Seat 2: Ellen1947 (small blind) folded before Flop
Seat 3: Nerkit (big blind) collected ($0.20)
Seat 4: silvno31 folded before Flop (didn't bet)
Seat 5: chiyuki folded before Flop (didn't bet)
Seat 6: ygoegoe folded before Flop (didn't bet)
Seat 7: Lasutchik folded before Flop (didn't bet)
Seat 8: taksist889 folded before Flop (didn't bet)
Seat 9: Wilcox76607 folded before Flop (didn't bet)



PokerStars Zoom Hand #84299022449:  Hold'em No Limit ($0.10/$0.25) - 2012/08/05 13:50:51 JST [2012/08/05 0:50:51 ET]
Table 'Whirlpool' 9-max Seat #1 is the button
Seat 1: Nerkit ($13.57 in chips) 
Seat 2: Jippyflip ($9.33 in chips) 
Seat 3: KeLevro0 ($12.50 in chips) 
Seat 4: Loholov ($17.98 in chips) 
Seat 5: Th3Fog ($53.07 in chips) 
Seat 6: hirozo ($25.75 in chips) 
Seat 7: chiyuki ($30.68 in chips) 
Seat 8: RomarioJa ($8.72 in chips) 
Seat 9: 2997qwer ($12.15 in chips) 
Jippyflip: posts small blind $0.10
KeLevro0: posts big blind $0.25
*** HOLE CARDS ***
Dealt to chiyuki [3h 9d]
Loholov: folds 
Th3Fog: folds 
hirozo: folds 
chiyuki: folds 
RomarioJa: folds 
2997qwer: raises $0.50 to $0.75
Nerkit: folds 
Jippyflip: folds 
KeLevro0: raises $1.75 to $2.50
2997qwer: folds 
Uncalled bet ($1.75) returned to KeLevro0
KeLevro0 collected $1.60 from pot
KeLevro0: doesn't show hand 
*** SUMMARY ***
Total pot $1.60 | Rake $0 
Seat 1: Nerkit (button) folded before Flop (didn't bet)
Seat 2: Jippyflip (small blind) folded before Flop
Seat 3: KeLevro0 (big blind) collected ($1.60)
Seat 4: Loholov folded before Flop (didn't bet)
Seat 5: Th3Fog folded before Flop (didn't bet)
Seat 6: hirozo folded before Flop (didn't bet)
Seat 7: chiyuki folded before Flop (didn't bet)
Seat 8: RomarioJa folded before Flop (didn't bet)
Seat 9: 2997qwer folded before Flop



PokerStars Zoom Hand #84299024242:  Hold'em No Limit ($0.10/$0.25) - 2012/08/05 13:50:58 JST [2012/08/05 0:50:58 ET]
Table 'Whirlpool' 9-max Seat #1 is the button
Seat 1: PetitAlejo ($25 in chips) 
Seat 2: silvno31 ($40.89 in chips) 
Seat 3: Suhoff76 ($34.43 in chips) 
Seat 4: taksist889 ($17.67 in chips) 
Seat 5: TErr18 ($14.52 in chips) 
Seat 6: fwani ($38.60 in chips) 
Seat 7: Dejacob ($25 in chips) 
Seat 8: chiyuki ($30.68 in chips) 
Seat 9: KeLevro0 ($13.06 in chips) 
silvno31: posts small blind $0.10
Suhoff76: posts big blind $0.25
*** HOLE CARDS ***
Dealt to chiyuki [Ts 4s]
taksist889: folds 
TErr18: folds 
fwani: folds 
Dejacob: folds 
chiyuki: folds 
KeLevro0: folds 
PetitAlejo: raises $0.50 to $0.75
silvno31: folds 
Suhoff76: raises $1.65 to $2.40
PetitAlejo: raises $3.95 to $6.35
Suhoff76: raises $28.08 to $34.43 and is all-in
PetitAlejo: folds 
Uncalled bet ($28.08) returned to Suhoff76
Suhoff76 collected $12.80 from pot
Suhoff76: doesn't show hand 
*** SUMMARY ***
Total pot $12.80 | Rake $0 
Seat 1: PetitAlejo (button) folded before Flop
Seat 2: silvno31 (small blind) folded before Flop
Seat 3: Suhoff76 (big blind) collected ($12.80)
Seat 4: taksist889 folded before Flop (didn't bet)
Seat 5: TErr18 folded before Flop (didn't bet)
Seat 6: fwani folded before Flop (didn't bet)
Seat 7: Dejacob folded before Flop (didn't bet)
Seat 8: chiyuki folded before Flop (didn't bet)
Seat 9: KeLevro0 folded before Flop (didn't bet)



PokerStars Zoom Hand #84299028728:  Hold'em No Limit ($0.10/$0.25) - 2012/08/05 13:51:16 JST [2012/08/05 0:51:16 ET]
Table 'Whirlpool' 9-max Seat #1 is the button
Seat 1: timburonps ($41.38 in chips) 
Seat 2: chiyuki ($30.68 in chips) 
Seat 3: RikkStroken ($12.75 in chips) 
Seat 4: Jippyflip ($9.23 in chips) 
Seat 5: Loholov ($18.80 in chips) 
Seat 6: KeLevro0 ($12.90 in chips) 
Seat 7: BlackZafiro ($42.78 in chips) 
Seat 8: Ellen1947 ($34.79 in chips) 
Seat 9: Dejacob ($25 in chips) 
chiyuki: posts small blind $0.10
RikkStroken: posts big blind $0.25
*** HOLE CARDS ***
Dealt to chiyuki [2s 5c]
Jippyflip: folds 
Loholov: folds 
KeLevro0: folds 
BlackZafiro: folds 
Ellen1947: folds 
Dejacob: folds 
timburonps: raises $0.50 to $0.75
chiyuki: folds 
RikkStroken: raises $1.50 to $2.25
timburonps: folds 
Uncalled bet ($1.50) returned to RikkStroken
RikkStroken collected $1.60 from pot
RikkStroken: doesn't show hand 
*** SUMMARY ***
Total pot $1.60 | Rake $0 
Seat 1: timburonps (button) folded before Flop
Seat 2: chiyuki (small blind) folded before Flop
Seat 3: RikkStroken (big blind) collected ($1.60)
Seat 4: Jippyflip folded before Flop (didn't bet)
Seat 5: Loholov folded before Flop (didn't bet)
Seat 6: KeLevro0 folded before Flop (didn't bet)
Seat 7: BlackZafiro folded before Flop (didn't bet)
Seat 8: Ellen1947 folded before Flop (didn't bet)
Seat 9: Dejacob folded before Flop (didn't bet)



PokerStars Zoom Hand #84299032541:  Hold'em No Limit ($0.10/$0.25) - 2012/08/05 13:51:31 JST [2012/08/05 0:51:31 ET]
Table 'Whirlpool' 9-max Seat #1 is the button
Seat 1: Loholov ($17.88 in chips) 
Seat 2: cr0lox ($24.74 in chips) 
Seat 3: chiyuki ($30.58 in chips) 
Seat 4: gunbowler ($154.38 in chips) 
Seat 5: timburonps ($28.40 in chips) 
Seat 6: hirozo ($26.50 in chips) 
Seat 7: 2997qwer ($10.75 in chips) 
Seat 8: ladymadon107 ($17.32 in chips) 
Seat 9: KeLevro0 ($13.25 in chips) 
cr0lox: posts small blind $0.10
chiyuki: posts big blind $0.25
*** HOLE CARDS ***
Dealt to chiyuki [7h 8c]
gunbowler: folds 
timburonps: folds 
hirozo: folds 
2997qwer: raises $0.50 to $0.75
ladymadon107: folds 
KeLevro0: folds 
Loholov: raises $1 to $1.75
cr0lox: folds 
chiyuki: folds 
2997qwer: folds 
Uncalled bet ($1) returned to Loholov
Loholov collected $1.85 from pot
Loholov: doesn't show hand 
*** SUMMARY ***
Total pot $1.85 | Rake $0 
Seat 1: Loholov (button) collected ($1.85)
Seat 2: cr0lox (small blind) folded before Flop
Seat 3: chiyuki (big blind) folded before Flop
Seat 4: gunbowler folded before Flop (didn't bet)
Seat 5: timburonps folded before Flop (didn't bet)
Seat 6: hirozo folded before Flop (didn't bet)
Seat 7: 2997qwer folded before Flop
Seat 8: ladymadon107 folded before Flop (didn't bet)
Seat 9: KeLevro0 folded before Flop (didn't bet)



PokerStars Zoom Hand #84299026712:  Hold'em No Limit ($0.10/$0.25) - 2012/08/05 13:51:08 JST [2012/08/05 0:51:08 ET]
Table 'Whirlpool' 9-max Seat #1 is the button
Seat 1: chiyuki ($30.68 in chips) 
Seat 2: fwani ($38.60 in chips) 
Seat 3: ChrisCDee ($25 in chips) 
Seat 4: KeLevro0 ($13.06 in chips) 
Seat 5: Lasutchik ($32.78 in chips) 
Seat 6: RomarioJa ($6.64 in chips) 
Seat 7: Suhoff76 ($27.88 in chips) 
Seat 8: Dafleche ($19.88 in chips) 
Seat 9: TErr18 ($14.42 in chips) 
fwani: posts small blind $0.10
ChrisCDee: posts big blind $0.25
*** HOLE CARDS ***
Dealt to chiyuki [8c 4s]
KeLevro0: folds 
Lasutchik: folds 
RomarioJa: raises $0.37 to $0.62
Suhoff76: folds 
Dafleche: folds 
TErr18: calls $0.62
chiyuki: folds 
fwani: folds 
ChrisCDee: folds 
*** FLOP *** [7d 8h 9c]
RomarioJa: bets $1
TErr18: calls $1
*** TURN *** [7d 8h 9c] [9d]
RomarioJa: bets $2.26
TErr18: folds 
Uncalled bet ($2.26) returned to RomarioJa
RomarioJa collected $3.43 from pot
RomarioJa: doesn't show hand 
*** SUMMARY ***
Total pot $3.59 | Rake $0.16 
Board [7d 8h 9c 9d]
Seat 1: chiyuki (button) folded before Flop (didn't bet)
Seat 2: fwani (small blind) folded before Flop
Seat 3: ChrisCDee (big blind) folded before Flop
Seat 4: KeLevro0 folded before Flop (didn't bet)
Seat 5: Lasutchik folded before Flop (didn't bet)
Seat 6: RomarioJa collected ($3.43)
Seat 7: Suhoff76 folded before Flop (didn't bet)
Seat 8: Dafleche folded before Flop (didn't bet)
Seat 9: TErr18 folded on the Turn



PokerStars Zoom Hand #84299029994:  Hold'em No Limit ($0.10/$0.25) - 2012/08/05 13:51:21 JST [2012/08/05 0:51:21 ET]
Table 'Whirlpool' 9-max Seat #1 is the button
Seat 1: BlOnDhOlIc ($42.23 in chips) 
Seat 2: deadmoneykid ($29.78 in chips) 
Seat 3: PetitAlejo ($29.99 in chips) 
Seat 4: KAKamiro ($38.77 in chips) 
Seat 5: Ellen1947 ($34.79 in chips) 
Seat 6: chiyuki ($30.58 in chips) 
Seat 7: NastyMcNast ($39.92 in chips) 
Seat 8: 123progress ($43.96 in chips) 
Seat 9: Paranoix1990 ($22.92 in chips) 
deadmoneykid: posts small blind $0.10
PetitAlejo: posts big blind $0.25
*** HOLE CARDS ***
Dealt to chiyuki [5d 7c]
KAKamiro: calls $0.25
Ellen1947: folds 
chiyuki: folds 
NastyMcNast: raises $0.75 to $1
123progress: folds 
Paranoix1990: folds 
BlOnDhOlIc: raises $2 to $3
deadmoneykid: folds 
PetitAlejo: folds 
KAKamiro: folds 
NastyMcNast: calls $2
*** FLOP *** [Kd 4c 8s]
NastyMcNast: checks 
BlOnDhOlIc: bets $3.75
NastyMcNast: folds 
Uncalled bet ($3.75) returned to BlOnDhOlIc
BlOnDhOlIc collected $6.30 from pot
BlOnDhOlIc: doesn't show hand 
*** SUMMARY ***
Total pot $6.60 | Rake $0.30 
Board [Kd 4c 8s]
Seat 1: BlOnDhOlIc (button) collected ($6.30)
Seat 2: deadmoneykid (small blind) folded before Flop
Seat 3: PetitAlejo (big blind) folded before Flop
Seat 4: KAKamiro folded before Flop
Seat 5: Ellen1947 folded before Flop (didn't bet)
Seat 6: chiyuki folded before Flop (didn't bet)
Seat 7: NastyMcNast folded on the Flop
Seat 8: 123progress folded before Flop (didn't bet)
Seat 9: Paranoix1990 folded before Flop (didn't bet)



PokerStars Zoom Hand #84299036665:  Hold'em No Limit ($0.10/$0.25) - 2012/08/05 13:51:47 JST [2012/08/05 0:51:47 ET]
Table 'Whirlpool' 9-max Seat #1 is the button
Seat 1: Rsonal ($3.57 in chips) 
Seat 2: hirozo ($27.27 in chips) 
Seat 3: PetitAlejo ($25.35 in chips) 
Seat 4: chiyuki ($30.33 in chips) 
Seat 5: Jippyflip ($8.98 in chips) 
Seat 6: Suhoff76 ($40.88 in chips) 
Seat 7: RikkStroken ($13.90 in chips) 
Seat 8: slapshot2011 ($26.39 in chips) 
Seat 9: Nerkit ($11.91 in chips) 
hirozo: posts small blind $0.10
PetitAlejo: posts big blind $0.25
*** HOLE CARDS ***
Dealt to chiyuki [9c 8c]
chiyuki: folds 
Jippyflip: folds 
Suhoff76: folds 
RikkStroken: folds 
slapshot2011: folds 
Nerkit: folds 
Rsonal: folds 
hirozo: raises $0.25 to $0.50
PetitAlejo: raises $1 to $1.50
hirozo: folds 
Uncalled bet ($1) returned to PetitAlejo
PetitAlejo collected $1 from pot
PetitAlejo: doesn't show hand 
*** SUMMARY ***
Total pot $1 | Rake $0 
Seat 1: Rsonal (button) folded before Flop (didn't bet)
Seat 2: hirozo (small blind) folded before Flop
Seat 3: PetitAlejo (big blind) collected ($1)
Seat 4: chiyuki folded before Flop (didn't bet)
Seat 5: Jippyflip folded before Flop (didn't bet)
Seat 6: Suhoff76 folded before Flop (didn't bet)
Seat 7: RikkStroken folded before Flop (didn't bet)
Seat 8: slapshot2011 folded before Flop (didn't bet)
Seat 9: Nerkit folded before Flop (didn't bet)



PokerStars Zoom Hand #84299037902:  Hold'em No Limit ($0.10/$0.25) - 2012/08/05 13:51:53 JST [2012/08/05 0:51:53 ET]
Table 'Whirlpool' 9-max Seat #1 is the button
Seat 1: Nerkit ($11.91 in chips) 
Seat 2: Dejacob ($30.68 in chips) 
Seat 3: Roglus ($17.33 in chips) 
Seat 4: Th3Fog ($80.16 in chips) 
Seat 5: Vahe50 ($15.70 in chips) 
Seat 6: petersmiths ($48.62 in chips) 
Seat 7: wtu1986 ($25.39 in chips) 
Seat 8: Ellen1947 ($34.36 in chips) 
Seat 9: chiyuki ($30.33 in chips) 
Dejacob: posts small blind $0.10
Roglus: posts big blind $0.25
*** HOLE CARDS ***
Dealt to chiyuki [Td Qd]
Th3Fog: folds 
Vahe50: folds 
petersmiths: raises $0.25 to $0.50
wtu1986: folds 
Ellen1947: folds 
chiyuki: folds 
Nerkit: folds 
Dejacob: folds 
Roglus: calls $0.25
*** FLOP *** [9h 2d Ks]
Roglus: checks 
petersmiths: bets $0.42
Roglus: folds 
Uncalled bet ($0.42) returned to petersmiths
petersmiths collected $1.05 from pot
petersmiths: doesn't show hand 
*** SUMMARY ***
Total pot $1.10 | Rake $0.05 
Board [9h 2d Ks]
Seat 1: Nerkit (button) folded before Flop (didn't bet)
Seat 2: Dejacob (small blind) folded before Flop
Seat 3: Roglus (big blind) folded on the Flop
Seat 4: Th3Fog folded before Flop (didn't bet)
Seat 5: Vahe50 folded before Flop (didn't bet)
Seat 6: petersmiths collected ($1.05)
Seat 7: wtu1986 folded before Flop (didn't bet)
Seat 8: Ellen1947 folded before Flop (didn't bet)
Seat 9: chiyuki folded before Flop (didn't bet)



PokerStars Zoom Hand #84299041504:  Hold'em No Limit ($0.10/$0.25) - 2012/08/05 13:52:07 JST [2012/08/05 0:52:07 ET]
Table 'Whirlpool' 9-max Seat #1 is the button
Seat 1: Vahe50 ($27.82 in chips) 
Seat 2: hirozo ($25 in chips) 
Seat 3: BlOnDhOlIc ($26.75 in chips) 
Seat 4: Ellen1947 ($34.36 in chips) 
Seat 5: chiyuki ($30.33 in chips) 
Seat 6: RikkStroken ($13.90 in chips) 
Seat 7: Paranoix1990 ($22.92 in chips) 
Seat 8: Loholov ($15 in chips) 
Seat 9: timburonps ($27.38 in chips) 
hirozo: posts small blind $0.10
BlOnDhOlIc: posts big blind $0.25
*** HOLE CARDS ***
Dealt to chiyuki [4s 6c]
Ellen1947: folds 
chiyuki: folds 
RikkStroken: folds 
Paranoix1990: raises $0.25 to $0.50
Loholov: folds 
timburonps: folds 
Vahe50: folds 
hirozo: folds 
BlOnDhOlIc: folds 
Uncalled bet ($0.25) returned to Paranoix1990
Paranoix1990 collected $0.60 from pot
Paranoix1990: doesn't show hand 
*** SUMMARY ***
Total pot $0.60 | Rake $0 
Seat 1: Vahe50 (button) folded before Flop (didn't bet)
Seat 2: hirozo (small blind) folded before Flop
Seat 3: BlOnDhOlIc (big blind) folded before Flop
Seat 4: Ellen1947 folded before Flop (didn't bet)
Seat 5: chiyuki folded before Flop (didn't bet)
Seat 6: RikkStroken folded before Flop (didn't bet)
Seat 7: Paranoix1990 collected ($0.60)
Seat 8: Loholov folded before Flop (didn't bet)
Seat 9: timburonps folded before Flop (didn't bet)



PokerStars Zoom Hand #84299044506:  Hold'em No Limit ($0.10/$0.25) - 2012/08/05 13:52:19 JST [2012/08/05 0:52:19 ET]
Table 'Whirlpool' 9-max Seat #1 is the button
Seat 1: Suhoff76 ($27.53 in chips) 
Seat 2: PetitAlejo ($25.85 in chips) 
Seat 3: Ellen1947 ($34.36 in chips) 
Seat 4: D@vidMed ($24.50 in chips) 
Seat 5: deadmoneykid ($27.74 in chips) 
Seat 6: 123progress ($25 in chips) 
Seat 7: chiyuki ($30.33 in chips) 
Seat 8: hirozo ($26.50 in chips) 
Seat 9: ygoegoe ($27.80 in chips) 
PetitAlejo: posts small blind $0.10
Ellen1947: posts big blind $0.25
*** HOLE CARDS ***
Dealt to chiyuki [6s 2h]
D@vidMed: folds 
deadmoneykid: folds 
123progress: folds 
chiyuki: folds 
hirozo: folds 
ygoegoe: folds 
Suhoff76: folds 
PetitAlejo: folds 
Uncalled bet ($0.15) returned to Ellen1947
Ellen1947 collected $0.20 from pot
Ellen1947: doesn't show hand 
*** SUMMARY ***
Total pot $0.20 | Rake $0 
Seat 1: Suhoff76 (button) folded before Flop (didn't bet)
Seat 2: PetitAlejo (small blind) folded before Flop
Seat 3: Ellen1947 (big blind) collected ($0.20)
Seat 4: D@vidMed folded before Flop (didn't bet)
Seat 5: deadmoneykid folded before Flop (didn't bet)
Seat 6: 123progress folded before Flop (didn't bet)
Seat 7: chiyuki folded before Flop (didn't bet)
Seat 8: hirozo folded before Flop (didn't bet)
Seat 9: ygoegoe folded before Flop (didn't bet)



PokerStars Zoom Hand #84299047335:  Hold'em No Limit ($0.10/$0.25) - 2012/08/05 13:52:30 JST [2012/08/05 0:52:30 ET]
Table 'Whirlpool' 9-max Seat #1 is the button
Seat 1: ygoegoe ($32.59 in chips) 
Seat 2: deadmoneykid ($39.87 in chips) 
Seat 3: PetitAlejo ($25 in chips) 
Seat 4: chiyuki ($30.33 in chips) 
Seat 5: ChrisCDee ($25 in chips) 
Seat 6: kamikkaze ($12.50 in chips) 
Seat 7: ladymadon107 ($17.07 in chips) 
Seat 8: KeLevro0 ($13 in chips) 
Seat 9: NastyMcNast ($25 in chips) 
deadmoneykid: posts small blind $0.10
PetitAlejo: posts big blind $0.25
*** HOLE CARDS ***
Dealt to chiyuki [Jc 6h]
chiyuki: folds 
ChrisCDee: folds 
kamikkaze: folds 
ladymadon107: folds 
KeLevro0: folds 
NastyMcNast: folds 
ygoegoe: folds 
deadmoneykid: folds 
Uncalled bet ($0.15) returned to PetitAlejo
PetitAlejo collected $0.20 from pot
PetitAlejo: doesn't show hand 
*** SUMMARY ***
Total pot $0.20 | Rake $0 
Seat 1: ygoegoe (button) folded before Flop (didn't bet)
Seat 2: deadmoneykid (small blind) folded before Flop
Seat 3: PetitAlejo (big blind) collected ($0.20)
Seat 4: chiyuki folded before Flop (didn't bet)
Seat 5: ChrisCDee folded before Flop (didn't bet)
Seat 6: kamikkaze folded before Flop (didn't bet)
Seat 7: ladymadon107 folded before Flop (didn't bet)
Seat 8: KeLevro0 folded before Flop (didn't bet)
Seat 9: NastyMcNast folded before Flop (didn't bet)



PokerStars Zoom Hand #84299046290:  Hold'em No Limit ($0.10/$0.25) - 2012/08/05 13:52:26 JST [2012/08/05 0:52:26 ET]
Table 'Whirlpool' 9-max Seat #1 is the button
Seat 1: ll_LaMeR_ll ($66.42 in chips) 
Seat 2: carlosrbr ($22.56 in chips) 
Seat 3: 123progress ($43.69 in chips) 
Seat 4: Paranoix1990 ($23.27 in chips) 
Seat 5: PetitAlejo ($25 in chips) 
Seat 6: goldstone ($33.82 in chips) 
Seat 7: solawind ($14.07 in chips) 
Seat 8: chiyuki ($30.33 in chips) 
Seat 9: Anafim ($15.11 in chips) 
carlosrbr: posts small blind $0.10
123progress: posts big blind $0.25
*** HOLE CARDS ***
Dealt to chiyuki [6s Ac]
Paranoix1990: calls $0.25
PetitAlejo: folds 
goldstone: folds 
solawind: folds 
chiyuki: folds 
Anafim: folds 
ll_LaMeR_ll: raises $0.75 to $1
carlosrbr: folds 
123progress: raises $2.25 to $3.25
Paranoix1990: folds 
ll_LaMeR_ll: folds 
Uncalled bet ($2.25) returned to 123progress
123progress collected $2.35 from pot
123progress: doesn't show hand 
*** SUMMARY ***
Total pot $2.35 | Rake $0 
Seat 1: ll_LaMeR_ll (button) folded before Flop
Seat 2: carlosrbr (small blind) folded before Flop
Seat 3: 123progress (big blind) collected ($2.35)
Seat 4: Paranoix1990 folded before Flop
Seat 5: PetitAlejo folded before Flop (didn't bet)
Seat 6: goldstone folded before Flop (didn't bet)
Seat 7: solawind folded before Flop (didn't bet)
Seat 8: chiyuki folded before Flop (didn't bet)
Seat 9: Anafim folded before Flop (didn't bet)



PokerStars Zoom Hand #84299048553:  Hold'em No Limit ($0.10/$0.25) - 2012/08/05 13:52:35 JST [2012/08/05 0:52:35 ET]
Table 'Whirlpool' 9-max Seat #1 is the button
Seat 1: goldstone ($33.82 in chips) 
Seat 2: chiyuki ($30.33 in chips) 
Seat 3: RomarioJa ($8.45 in chips) 
Seat 4: jeff0923 ($24.63 in chips) 
Seat 5: timburonps ($42.49 in chips) 
Seat 6: ladymadon107 ($17.07 in chips) 
Seat 7: 2997qwer ($14.53 in chips) 
Seat 8: BlackZafiro ($42.06 in chips) 
Seat 9: BlOnDhOlIc ($59.43 in chips) 
chiyuki: posts small blind $0.10
RomarioJa: posts big blind $0.25
*** HOLE CARDS ***
Dealt to chiyuki [8d Js]
jeff0923: calls $0.25
timburonps: folds 
ladymadon107: folds 
2997qwer: folds 
BlackZafiro: folds 
BlOnDhOlIc: folds 
goldstone: folds 
chiyuki: folds 
RomarioJa: checks 
*** FLOP *** [3d 6h Qd]
RomarioJa: checks 
jeff0923: checks 
*** TURN *** [3d 6h Qd] [3s]
RomarioJa: checks 
jeff0923: checks 
*** RIVER *** [3d 6h Qd 3s] [9h]
RomarioJa: checks 
jeff0923: checks 
*** SHOW DOWN ***
RomarioJa: shows [2c 4s] (a pair of Threes)
jeff0923: shows [Th Ac] (a pair of Threes - Ace kicker)
jeff0923 collected $0.57 from pot
*** SUMMARY ***
Total pot $0.60 | Rake $0.03 
Board [3d 6h Qd 3s 9h]
Seat 1: goldstone (button) folded before Flop (didn't bet)
Seat 2: chiyuki (small blind) folded before Flop
Seat 3: RomarioJa (big blind) showed [2c 4s] and lost with a pair of Threes
Seat 4: jeff0923 showed [Th Ac] and won ($0.57) with a pair of Threes
Seat 5: timburonps folded before Flop (didn't bet)
Seat 6: ladymadon107 folded before Flop (didn't bet)
Seat 7: 2997qwer folded before Flop (didn't bet)
Seat 8: BlackZafiro folded before Flop (didn't bet)
Seat 9: BlOnDhOlIc folded before Flop (didn't bet)



PokerStars Zoom Hand #84299050578:  Hold'em No Limit ($0.10/$0.25) - 2012/08/05 13:52:43 JST [2012/08/05 0:52:43 ET]
Table 'Whirlpool' 9-max Seat #1 is the button
Seat 1: PetitAlejo ($25 in chips) 
Seat 2: GoldNutter ($15.23 in chips) 
Seat 3: Jippyflip ($8.88 in chips) 
Seat 4: Dejacob ($30.58 in chips) 
Seat 5: agurio ($33.55 in chips) 
Seat 6: chiyuki ($30.23 in chips) 
Seat 7: NastyMcNast ($25 in chips) 
Seat 8: Rudolf ($48.09 in chips) 
Seat 9: RikkStroken ($8.90 in chips) 
GoldNutter: posts small blind $0.10
Jippyflip: posts big blind $0.25
*** HOLE CARDS ***
Dealt to chiyuki [5c Kh]
Dejacob: folds 
agurio: folds 
chiyuki: folds 
NastyMcNast: folds 
Rudolf: folds 
RikkStroken: folds 
PetitAlejo: folds 
GoldNutter: calls $0.15
Jippyflip: checks 
*** FLOP *** [7s Qd 4c]
GoldNutter: bets $0.50
Jippyflip: calls $0.50
*** TURN *** [7s Qd 4c] [5d]
GoldNutter: checks 
Jippyflip: checks 
*** RIVER *** [7s Qd 4c 5d] [6d]
GoldNutter: bets $0.75
Jippyflip: calls $0.75
*** SHOW DOWN ***
GoldNutter: shows [6s 4h] (two pair, Sixes and Fours)
Jippyflip: mucks hand 
GoldNutter collected $2.86 from pot
*** SUMMARY ***
Total pot $3 | Rake $0.14 
Board [7s Qd 4c 5d 6d]
Seat 1: PetitAlejo (button) folded before Flop (didn't bet)
Seat 2: GoldNutter (small blind) showed [6s 4h] and won ($2.86) with two pair, Sixes and Fours
Seat 3: Jippyflip (big blind) mucked [Jc Jd]
Seat 4: Dejacob folded before Flop (didn't bet)
Seat 5: agurio folded before Flop (didn't bet)
Seat 6: chiyuki folded before Flop (didn't bet)
Seat 7: NastyMcNast folded before Flop (didn't bet)
Seat 8: Rudolf folded before Flop (didn't bet)
Seat 9: RikkStroken folded before Flop (didn't bet)



PokerStars Zoom Hand #84299056351:  Hold'em No Limit ($0.10/$0.25) - 2012/08/05 13:53:07 JST [2012/08/05 0:53:07 ET]
Table 'Whirlpool' 9-max Seat #1 is the button
Seat 1: Th3Fog ($22.09 in chips) 
Seat 2: Alvinpe85 ($48.56 in chips) 
Seat 3: Paranoix1990 ($22.92 in chips) 
Seat 4: Anafim ($15.90 in chips) 
Seat 5: Suhoff76 ($56.01 in chips) 
Seat 6: fwani ($38.91 in chips) 
Seat 7: chiyuki ($30.23 in chips) 
Seat 8: cr0lox ($20.33 in chips) 
Seat 9: timburonps ($40.28 in chips) 
Alvinpe85: posts small blind $0.10
Paranoix1990: posts big blind $0.25
*** HOLE CARDS ***
Dealt to chiyuki [4d 9h]
Anafim: folds 
Suhoff76: folds 
fwani: folds 
chiyuki: folds 
cr0lox: folds 
timburonps: folds 
Th3Fog: folds 
Alvinpe85: raises $0.50 to $0.75
Paranoix1990: calls $0.50
*** FLOP *** [Jd 9d 4c]
Alvinpe85: bets $0.85
Paranoix1990: folds 
Uncalled bet ($0.85) returned to Alvinpe85
Alvinpe85 collected $1.43 from pot
Alvinpe85: doesn't show hand 
*** SUMMARY ***
Total pot $1.50 | Rake $0.07 
Board [Jd 9d 4c]
Seat 1: Th3Fog (button) folded before Flop (didn't bet)
Seat 2: Alvinpe85 (small blind) collected ($1.43)
Seat 3: Paranoix1990 (big blind) folded on the Flop
Seat 4: Anafim folded before Flop (didn't bet)
Seat 5: Suhoff76 folded before Flop (didn't bet)
Seat 6: fwani folded before Flop (didn't bet)
Seat 7: chiyuki folded before Flop (didn't bet)
Seat 8: cr0lox folded before Flop (didn't bet)
Seat 9: timburonps folded before Flop (didn't bet)



PokerStars Zoom Hand #84299051815:  Hold'em No Limit ($0.10/$0.25) - 2012/08/05 13:52:48 JST [2012/08/05 0:52:48 ET]
Table 'Whirlpool' 9-max Seat #1 is the button
Seat 1: chiyuki ($30.23 in chips) 
Seat 2: Loholov ($15 in chips) 
Seat 3: kkbruins0408 ($12.52 in chips) 
Seat 4: timburonps ($40.28 in chips) 
Seat 5: Suhoff76 ($27.53 in chips) 
Seat 6: Dejacob ($30.58 in chips) 
Seat 7: deadmoneykid ($29.68 in chips) 
Seat 8: Nerkit ($14.45 in chips) 
Seat 9: BlackZafiro ($27.42 in chips) 
Loholov: posts small blind $0.10
kkbruins0408: posts big blind $0.25
*** HOLE CARDS ***
Dealt to chiyuki [Ts 3h]
timburonps: folds 
Suhoff76: folds 
Dejacob: folds 
deadmoneykid: folds 
Nerkit: raises $0.50 to $0.75
BlackZafiro: folds 
chiyuki: folds 
Loholov: calls $0.65
kkbruins0408: calls $0.50
*** FLOP *** [Kd 2h Jd]
Loholov: checks 
kkbruins0408: checks 
Nerkit: checks 
*** TURN *** [Kd 2h Jd] [5h]
Loholov: checks 
kkbruins0408: checks 
Nerkit: checks 
*** RIVER *** [Kd 2h Jd 5h] [Jh]
Loholov: checks 
kkbruins0408: checks 
Nerkit: checks 
*** SHOW DOWN ***
Loholov: shows [6s 7s] (a pair of Jacks)
kkbruins0408: shows [As 4c] (a pair of Jacks - Ace kicker)
Nerkit: shows [8c 8s] (two pair, Jacks and Eights)
Nerkit collected $2.15 from pot
*** SUMMARY ***
Total pot $2.25 | Rake $0.10 
Board [Kd 2h Jd 5h Jh]
Seat 1: chiyuki (button) folded before Flop (didn't bet)
Seat 2: Loholov (small blind) showed [6s 7s] and lost with a pair of Jacks
Seat 3: kkbruins0408 (big blind) showed [As 4c] and lost with a pair of Jacks
Seat 4: timburonps folded before Flop (didn't bet)
Seat 5: Suhoff76 folded before Flop (didn't bet)
Seat 6: Dejacob folded before Flop (didn't bet)
Seat 7: deadmoneykid folded before Flop (didn't bet)
Seat 8: Nerkit showed [8c 8s] and won ($2.15) with two pair, Jacks and Eights
Seat 9: BlackZafiro folded before Flop (didn't bet)



PokerStars Zoom Hand #84299053885:  Hold'em No Limit ($0.10/$0.25) - 2012/08/05 13:52:56 JST [2012/08/05 0:52:56 ET]
Table 'Whirlpool' 9-max Seat #1 is the button
Seat 1: deadmoneykid ($39.77 in chips) 
Seat 2: petersmiths ($48.92 in chips) 
Seat 3: NastyMcNast ($36.92 in chips) 
Seat 4: Suhoff76 ($56.01 in chips) 
Seat 5: Alvinpe85 ($48.56 in chips) 
Seat 6: timburonps ($40.28 in chips) 
Seat 7: leo2095 ($16.96 in chips) 
Seat 8: Paranoix1990 ($23.02 in chips) 
Seat 9: chiyuki ($30.23 in chips) 
petersmiths: posts small blind $0.10
NastyMcNast: posts big blind $0.25
*** HOLE CARDS ***
Dealt to chiyuki [2d Js]
Suhoff76: folds 
Alvinpe85: folds 
timburonps: folds 
leo2095: folds 
Paranoix1990: folds 
chiyuki: folds 
deadmoneykid: folds 
petersmiths: raises $0.25 to $0.50
NastyMcNast: calls $0.25
*** FLOP *** [7s 3h 8c]
petersmiths: checks 
NastyMcNast: bets $0.67
petersmiths: calls $0.67
*** TURN *** [7s 3h 8c] [Qd]
petersmiths: checks 
NastyMcNast: checks 
*** RIVER *** [7s 3h 8c Qd] [6s]
petersmiths: checks 
NastyMcNast: checks 
*** SHOW DOWN ***
petersmiths: shows [Ac 9s] (high card Ace)
NastyMcNast: mucks hand 
petersmiths collected $2.23 from pot
*** SUMMARY ***
Total pot $2.34 | Rake $0.11 
Board [7s 3h 8c Qd 6s]
Seat 1: deadmoneykid (button) folded before Flop (didn't bet)
Seat 2: petersmiths (small blind) showed [Ac 9s] and won ($2.23) with high card Ace
Seat 3: NastyMcNast (big blind) mucked [Jh Ts]
Seat 4: Suhoff76 folded before Flop (didn't bet)
Seat 5: Alvinpe85 folded before Flop (didn't bet)
Seat 6: timburonps folded before Flop (didn't bet)
Seat 7: leo2095 folded before Flop (didn't bet)
Seat 8: Paranoix1990 folded before Flop (didn't bet)
Seat 9: chiyuki folded before Flop (didn't bet)



PokerStars Zoom Hand #84299067484:  Hold'em No Limit ($0.10/$0.25) - 2012/08/05 13:53:51 JST [2012/08/05 0:53:51 ET]
Table 'Whirlpool' 9-max Seat #1 is the button
Seat 1: roksmokndonk ($37.46 in chips) 
Seat 2: chiyuki ($29.98 in chips) 
Seat 3: fwani ($30.19 in chips) 
Seat 4: Alvinpe85 ($36.38 in chips) 
Seat 5: petersmiths ($49.98 in chips) 
Seat 6: leo2095 ($16.61 in chips) 
Seat 7: KeLevro0 ($8.68 in chips) 
Seat 8: Anafim ($15.55 in chips) 
Seat 9: NastyMcNast ($25 in chips) 
chiyuki: posts small blind $0.10
fwani: posts big blind $0.25
*** HOLE CARDS ***
Dealt to chiyuki [6h Ts]
Alvinpe85: folds 
petersmiths: folds 
leo2095: folds 
KeLevro0: raises $0.42 to $0.67
Anafim: folds 
NastyMcNast: folds 
roksmokndonk: folds 
chiyuki: folds 
fwani: folds 
Uncalled bet ($0.42) returned to KeLevro0
KeLevro0 collected $0.60 from pot
KeLevro0: doesn't show hand 
*** SUMMARY ***
Total pot $0.60 | Rake $0 
Seat 1: roksmokndonk (button) folded before Flop (didn't bet)
Seat 2: chiyuki (small blind) folded before Flop
Seat 3: fwani (big blind) folded before Flop
Seat 4: Alvinpe85 folded before Flop (didn't bet)
Seat 5: petersmiths folded before Flop (didn't bet)
Seat 6: leo2095 folded before Flop (didn't bet)
Seat 7: KeLevro0 collected ($0.60)
Seat 8: Anafim folded before Flop (didn't bet)
Seat 9: NastyMcNast folded before Flop (didn't bet)



PokerStars Zoom Hand #84299062412:  Hold'em No Limit ($0.10/$0.25) - 2012/08/05 13:53:31 JST [2012/08/05 0:53:31 ET]
Table 'Whirlpool' 9-max Seat #1 is the button
Seat 1: GoldNutter ($16.59 in chips) 
Seat 2: Suhoff76 ($55.76 in chips) 
Seat 3: timburonps ($40.18 in chips) 
Seat 4: hirozo ($27.56 in chips) 
Seat 5: mariuka1 ($10.46 in chips) 
Seat 6: Jippyflip ($7.38 in chips) 
Seat 7: NastyMcNast ($26.68 in chips) 
Seat 8: chiyuki ($29.98 in chips) 
Seat 9: Alvinpe85 ($49.24 in chips) 
Suhoff76: posts small blind $0.10
timburonps: posts big blind $0.25
*** HOLE CARDS ***
Dealt to chiyuki [Ad 3h]
hirozo: folds 
mariuka1: folds 
Jippyflip: calls $0.25
NastyMcNast: folds 
chiyuki: folds 
Alvinpe85: folds 
GoldNutter: folds 
Suhoff76: folds 
timburonps: checks 
*** FLOP *** [7h Jc Th]
timburonps: checks 
Jippyflip: checks 
*** TURN *** [7h Jc Th] [Qh]
timburonps: checks 
Jippyflip: bets $0.50
timburonps: folds 
Uncalled bet ($0.50) returned to Jippyflip
Jippyflip collected $0.57 from pot
Jippyflip: doesn't show hand 
*** SUMMARY ***
Total pot $0.60 | Rake $0.03 
Board [7h Jc Th Qh]
Seat 1: GoldNutter (button) folded before Flop (didn't bet)
Seat 2: Suhoff76 (small blind) folded before Flop
Seat 3: timburonps (big blind) folded on the Turn
Seat 4: hirozo folded before Flop (didn't bet)
Seat 5: mariuka1 folded before Flop (didn't bet)
Seat 6: Jippyflip collected ($0.57)
Seat 7: NastyMcNast folded before Flop (didn't bet)
Seat 8: chiyuki folded before Flop (didn't bet)
Seat 9: Alvinpe85 folded before Flop (didn't bet)



PokerStars Zoom Hand #84299061679:  Hold'em No Limit ($0.10/$0.25) - 2012/08/05 13:53:28 JST [2012/08/05 0:53:28 ET]
Table 'Whirlpool' 9-max Seat #1 is the button
Seat 1: Anafim ($14.83 in chips) 
Seat 2: cR!Ma*aRm ($36.73 in chips) 
Seat 3: KeLevro0 ($8.93 in chips) 
Seat 4: agurio ($33.71 in chips) 
Seat 5: DjJooni ($35.56 in chips) 
Seat 6: chiyuki ($29.98 in chips) 
Seat 7: Lasutchik ($31.93 in chips) 
Seat 8: wildy29 ($19.73 in chips) 
Seat 9: 2997qwer ($14.87 in chips) 
cR!Ma*aRm: posts small blind $0.10
KeLevro0: posts big blind $0.25
*** HOLE CARDS ***
Dealt to chiyuki [Qs 6s]
agurio: folds 
DjJooni: calls $0.25
chiyuki: folds 
Lasutchik: folds 
wildy29: folds 
2997qwer: folds 
Anafim: folds 
cR!Ma*aRm: calls $0.15
KeLevro0: checks 
*** FLOP *** [Ts Qd 9s]
cR!Ma*aRm: bets $0.50
KeLevro0: folds 
DjJooni: calls $0.50
*** TURN *** [Ts Qd 9s] [Qh]
cR!Ma*aRm: bets $1
DjJooni: calls $1
*** RIVER *** [Ts Qd 9s Qh] [7d]
cR!Ma*aRm: bets $1
DjJooni: raises $1 to $2
cR!Ma*aRm: folds 
Uncalled bet ($1) returned to DjJooni
DjJooni collected $5.49 from pot
DjJooni: doesn't show hand 
*** SUMMARY ***
Total pot $5.75 | Rake $0.26 
Board [Ts Qd 9s Qh 7d]
Seat 1: Anafim (button) folded before Flop (didn't bet)
Seat 2: cR!Ma*aRm (small blind) folded on the River
Seat 3: KeLevro0 (big blind) folded on the Flop
Seat 4: agurio folded before Flop (didn't bet)
Seat 5: DjJooni collected ($5.49)
Seat 6: chiyuki folded before Flop (didn't bet)
Seat 7: Lasutchik folded before Flop (didn't bet)
Seat 8: wildy29 folded before Flop (didn't bet)
Seat 9: 2997qwer folded before Flop (didn't bet)



PokerStars Zoom Hand #84299068507:  Hold'em No Limit ($0.10/$0.25) - 2012/08/05 13:53:55 JST [2012/08/05 0:53:55 ET]
Table 'Whirlpool' 9-max Seat #1 is the button
Seat 1: giorgos_k ($14.65 in chips) 
Seat 2: Alvinpe85 ($36.38 in chips) 
Seat 3: flyinprits ($52.96 in chips) 
Seat 4: chiyuki ($29.88 in chips) 
Seat 5: RikkStroken ($13.15 in chips) 
Seat 6: NastyMcNast ($25 in chips) 
Seat 7: leo2095 ($16.61 in chips) 
Seat 8: BlackZafiro ($25 in chips) 
Seat 9: roksmokndonk ($37.46 in chips) 
Alvinpe85: posts small blind $0.10
flyinprits: posts big blind $0.25
*** HOLE CARDS ***
Dealt to chiyuki [6c 6d]
chiyuki: folds 
RikkStroken: folds 
NastyMcNast: folds 
leo2095: raises $1 to $1.25
BlackZafiro: folds 
roksmokndonk: folds 
giorgos_k: folds 
Alvinpe85: folds 
flyinprits: folds 
Uncalled bet ($1) returned to leo2095
leo2095 collected $0.60 from pot
leo2095: doesn't show hand 
*** SUMMARY ***
Total pot $0.60 | Rake $0 
Seat 1: giorgos_k (button) folded before Flop (didn't bet)
Seat 2: Alvinpe85 (small blind) folded before Flop
Seat 3: flyinprits (big blind) folded before Flop
Seat 4: chiyuki folded before Flop (didn't bet)
Seat 5: RikkStroken folded before Flop (didn't bet)
Seat 6: NastyMcNast folded before Flop (didn't bet)
Seat 7: leo2095 collected ($0.60)
Seat 8: BlackZafiro folded before Flop (didn't bet)
Seat 9: roksmokndonk folded before Flop (didn't bet)



PokerStars Zoom Hand #84299057915:  Hold'em No Limit ($0.10/$0.25) - 2012/08/05 13:53:13 JST [2012/08/05 0:53:13 ET]
Table 'Whirlpool' 9-max Seat #1 is the button
Seat 1: leo2095 ($16.71 in chips) 
Seat 2: timburonps ($40.28 in chips) 
Seat 3: chiyuki ($30.23 in chips) 
Seat 4: Rudolf ($48.09 in chips) 
Seat 5: taksist889 ($13.37 in chips) 
Seat 6: roksmokndonk ($37.81 in chips) 
Seat 7: Th3Fog ($22.09 in chips) 
Seat 8: Suhoff76 ($56.01 in chips) 
Seat 9: ygoegoe ($30.34 in chips) 
timburonps: posts small blind $0.10
chiyuki: posts big blind $0.25
*** HOLE CARDS ***
Dealt to chiyuki [Th Jd]
Rudolf: raises $0.50 to $0.75
taksist889: calls $0.75
roksmokndonk: folds 
Th3Fog: folds 
Suhoff76: folds 
ygoegoe: folds 
leo2095: folds 
timburonps: folds 
chiyuki: folds 
*** FLOP *** [Ah 3c 6c]
Rudolf: bets $0.50
taksist889: raises $1 to $1.50
Rudolf: calls $1
*** TURN *** [Ah 3c 6c] [5c]
Rudolf: checks 
taksist889: bets $2.75
Rudolf: calls $2.75
*** RIVER *** [Ah 3c 6c 5c] [8c]
Rudolf: bets $19.75
taksist889: folds 
Uncalled bet ($19.75) returned to Rudolf
Rudolf collected $9.88 from pot
Rudolf: doesn't show hand 
*** SUMMARY ***
Total pot $10.35 | Rake $0.47 
Board [Ah 3c 6c 5c 8c]
Seat 1: leo2095 (button) folded before Flop (didn't bet)
Seat 2: timburonps (small blind) folded before Flop
Seat 3: chiyuki (big blind) folded before Flop
Seat 4: Rudolf collected ($9.88)
Seat 5: taksist889 folded on the River
Seat 6: roksmokndonk folded before Flop (didn't bet)
Seat 7: Th3Fog folded before Flop (didn't bet)
Seat 8: Suhoff76 folded before Flop (didn't bet)
Seat 9: ygoegoe folded before Flop (didn't bet)



PokerStars Zoom Hand #84299069769:  Hold'em No Limit ($0.10/$0.25) - 2012/08/05 13:54:00 JST [2012/08/05 0:54:00 ET]
Table 'Whirlpool' 9-max Seat #1 is the button
Seat 1: wtu1986 ($25.15 in chips) 
Seat 2: fwani ($25 in chips) 
Seat 3: chiyuki ($29.88 in chips) 
Seat 4: roksmokndonk ($37.46 in chips) 
Seat 5: goldstone ($34.07 in chips) 
Seat 6: BlackZafiro ($27.42 in chips) 
Seat 7: Vahe50 ($30.10 in chips) 
Seat 8: BlOnDhOlIc ($44.78 in chips) 
Seat 9: Suhoff76 ($27.53 in chips) 
fwani: posts small blind $0.10
chiyuki: posts big blind $0.25
*** HOLE CARDS ***
Dealt to chiyuki [4d 4s]
roksmokndonk: folds 
goldstone: folds 
BlackZafiro: folds 
Vahe50: folds 
BlOnDhOlIc: folds 
Suhoff76: folds 
wtu1986: folds 
fwani: raises $0.35 to $0.60
chiyuki: calls $0.35
*** FLOP *** [5h 6d Th]
fwani: bets $0.90
chiyuki: folds 
Uncalled bet ($0.90) returned to fwani
fwani collected $1.15 from pot
fwani: doesn't show hand 
*** SUMMARY ***
Total pot $1.20 | Rake $0.05 
Board [5h 6d Th]
Seat 1: wtu1986 (button) folded before Flop (didn't bet)
Seat 2: fwani (small blind) collected ($1.15)
Seat 3: chiyuki (big blind) folded on the Flop
Seat 4: roksmokndonk folded before Flop (didn't bet)
Seat 5: goldstone folded before Flop (didn't bet)
Seat 6: BlackZafiro folded before Flop (didn't bet)
Seat 7: Vahe50 folded before Flop (didn't bet)
Seat 8: BlOnDhOlIc folded before Flop (didn't bet)
Seat 9: Suhoff76 folded before Flop (didn't bet)



PokerStars Zoom Hand #84299063960:  Hold'em No Limit ($0.10/$0.25) - 2012/08/05 13:53:37 JST [2012/08/05 0:53:37 ET]
Table 'Whirlpool' 9-max Seat #1 is the button
Seat 1: Suhoff76 ($55.66 in chips) 
Seat 2: mariuka1 ($10.46 in chips) 
Seat 3: KeLevro0 ($12.90 in chips) 
Seat 4: hirozo ($25 in chips) 
Seat 5: chiyuki ($29.98 in chips) 
Seat 6: Anafim ($14.83 in chips) 
Seat 7: kamikkaze ($12.75 in chips) 
Seat 8: Nerkit ($11.56 in chips) 
Seat 9: kkbruins0408 ($11.77 in chips) 
mariuka1: posts small blind $0.10
KeLevro0: posts big blind $0.25
*** HOLE CARDS ***
Dealt to chiyuki [9s 3h]
hirozo: folds 
chiyuki: folds 
Anafim: raises $0.25 to $0.50
kamikkaze: folds 
Nerkit: folds 
kkbruins0408: folds 
Suhoff76: folds 
mariuka1: calls $0.40
KeLevro0: folds 
*** FLOP *** [As 2c Jh]
mariuka1: checks 
Anafim: checks 
*** TURN *** [As 2c Jh] [7s]
mariuka1: bets $0.50
Anafim: calls $0.50
*** RIVER *** [As 2c Jh 7s] [6d]
mariuka1: checks 
Anafim: bets $1.50
mariuka1: calls $1.50
*** SHOW DOWN ***
Anafim: shows [Kd Qd] (high card Ace)
mariuka1: shows [Qh Ah] (a pair of Aces)
mariuka1 collected $5.01 from pot
*** SUMMARY ***
Total pot $5.25 | Rake $0.24 
Board [As 2c Jh 7s 6d]
Seat 1: Suhoff76 (button) folded before Flop (didn't bet)
Seat 2: mariuka1 (small blind) showed [Qh Ah] and won ($5.01) with a pair of Aces
Seat 3: KeLevro0 (big blind) folded before Flop
Seat 4: hirozo folded before Flop (didn't bet)
Seat 5: chiyuki folded before Flop (didn't bet)
Seat 6: Anafim showed [Kd Qd] and lost with high card Ace
Seat 7: kamikkaze folded before Flop (didn't bet)
Seat 8: Nerkit folded before Flop (didn't bet)
Seat 9: kkbruins0408 folded before Flop (didn't bet)



PokerStars Zoom Hand #84299078328:  Hold'em No Limit ($0.10/$0.25) - 2012/08/05 13:54:35 JST [2012/08/05 0:54:35 ET]
Table 'Whirlpool' 9-max Seat #1 is the button
Seat 1: chiyuki ($29.28 in chips) 
Seat 2: ygoegoe ($30.09 in chips) 
Seat 3: 2997qwer ($12.50 in chips) 
Seat 4: Loholov ($15 in chips) 
Seat 5: PetitAlejo ($25.40 in chips) 
Seat 6: slapshot2011 ($22.97 in chips) 
Seat 7: Nerkit ($12.65 in chips) 
Seat 8: Jippyflip ($7.60 in chips) 
Seat 9: RikkStroken ($8.05 in chips) 
ygoegoe: posts small blind $0.10
2997qwer: posts big blind $0.25
*** HOLE CARDS ***
Dealt to chiyuki [Tc 9c]
Loholov: folds 
PetitAlejo: folds 
slapshot2011: folds 
Nerkit: folds 
Jippyflip: folds 
RikkStroken: raises $0.50 to $0.75
chiyuki: folds 
ygoegoe: folds 
2997qwer: folds 
Uncalled bet ($0.50) returned to RikkStroken
RikkStroken collected $0.60 from pot
RikkStroken: doesn't show hand 
*** SUMMARY ***
Total pot $0.60 | Rake $0 
Seat 1: chiyuki (button) folded before Flop (didn't bet)
Seat 2: ygoegoe (small blind) folded before Flop
Seat 3: 2997qwer (big blind) folded before Flop
Seat 4: Loholov folded before Flop (didn't bet)
Seat 5: PetitAlejo folded before Flop (didn't bet)
Seat 6: slapshot2011 folded before Flop (didn't bet)
Seat 7: Nerkit folded before Flop (didn't bet)
Seat 8: Jippyflip folded before Flop (didn't bet)
Seat 9: RikkStroken collected ($0.60)



PokerStars Zoom Hand #84299086097:  Hold'em No Limit ($0.10/$0.25) - 2012/08/05 13:55:06 JST [2012/08/05 0:55:06 ET]
Table 'Whirlpool' 9-max Seat #1 is the button
Seat 1: BlackZafiro ($25.25 in chips) 
Seat 2: KAKamiro ($40.66 in chips) 
Seat 3: KeLevro0 ($13.72 in chips) 
Seat 4: Nerkit ($12.65 in chips) 
Seat 5: Dejacob ($49.58 in chips) 
Seat 6: Alvinpe85 ($50.09 in chips) 
Seat 7: chiyuki ($29.28 in chips) 
Seat 8: 2997qwer ($9.95 in chips) 
Seat 9: Anafim ($12.50 in chips) 
KAKamiro: posts small blind $0.10
KeLevro0: posts big blind $0.25
*** HOLE CARDS ***
Dealt to chiyuki [Kc Jd]
Nerkit: folds 
Dejacob: folds 
Alvinpe85: folds 
chiyuki: folds 
2997qwer: folds 
Anafim: folds 
BlackZafiro: raises $0.37 to $0.62
KAKamiro: folds 
KeLevro0: folds 
Uncalled bet ($0.37) returned to BlackZafiro
BlackZafiro collected $0.60 from pot
BlackZafiro: doesn't show hand 
*** SUMMARY ***
Total pot $0.60 | Rake $0 
Seat 1: BlackZafiro (button) collected ($0.60)
Seat 2: KAKamiro (small blind) folded before Flop
Seat 3: KeLevro0 (big blind) folded before Flop
Seat 4: Nerkit folded before Flop (didn't bet)
Seat 5: Dejacob folded before Flop (didn't bet)
Seat 6: Alvinpe85 folded before Flop (didn't bet)
Seat 7: chiyuki folded before Flop (didn't bet)
Seat 8: 2997qwer folded before Flop (didn't bet)
Seat 9: Anafim folded before Flop (didn't bet)



PokerStars Zoom Hand #84299066197:  Hold'em No Limit ($0.10/$0.25) - 2012/08/05 13:53:46 JST [2012/08/05 0:53:46 ET]
Table 'Whirlpool' 9-max Seat #1 is the button
Seat 1: BlackZafiro ($41.71 in chips) 
Seat 2: kkbruins0408 ($11.77 in chips) 
Seat 3: Suhoff76 ($40.88 in chips) 
Seat 4: chiyuki ($29.98 in chips) 
Seat 5: Loholov ($15 in chips) 
Seat 6: petersmiths ($49.98 in chips) 
Seat 7: NastyMcNast ($35.75 in chips) 
Seat 8: roksmokndonk ($37.46 in chips) 
Seat 9: Faraz ($24.42 in chips) 
kkbruins0408: posts small blind $0.10
Suhoff76: posts big blind $0.25
*** HOLE CARDS ***
Dealt to chiyuki [Kh 5h]
chiyuki: folds 
Loholov: folds 
petersmiths: folds 
NastyMcNast: folds 
roksmokndonk: folds 
Faraz: raises $0.25 to $0.50
BlackZafiro: folds 
kkbruins0408: calls $0.40
Suhoff76: calls $0.25
*** FLOP *** [9c Qs Qd]
kkbruins0408: checks 
Suhoff76: checks 
Faraz: bets $0.75
kkbruins0408: calls $0.75
Suhoff76: calls $0.75
*** TURN *** [9c Qs Qd] [As]
kkbruins0408: checks 
Suhoff76: checks 
Faraz: bets $2.75
kkbruins0408: calls $2.75
Suhoff76: folds 
*** RIVER *** [9c Qs Qd As] [7c]
kkbruins0408: checks 
Faraz: bets $6.50
kkbruins0408: folds 
Uncalled bet ($6.50) returned to Faraz
Faraz collected $8.83 from pot
Faraz: doesn't show hand 
*** SUMMARY ***
Total pot $9.25 | Rake $0.42 
Board [9c Qs Qd As 7c]
Seat 1: BlackZafiro (button) folded before Flop (didn't bet)
Seat 2: kkbruins0408 (small blind) folded on the River
Seat 3: Suhoff76 (big blind) folded on the Turn
Seat 4: chiyuki folded before Flop (didn't bet)
Seat 5: Loholov folded before Flop (didn't bet)
Seat 6: petersmiths folded before Flop (didn't bet)
Seat 7: NastyMcNast folded before Flop (didn't bet)
Seat 8: roksmokndonk folded before Flop (didn't bet)
Seat 9: Faraz collected ($8.83)



PokerStars Zoom Hand #84299087101:  Hold'em No Limit ($0.10/$0.25) - 2012/08/05 13:55:10 JST [2012/08/05 0:55:10 ET]
Table 'Whirlpool' 9-max Seat #1 is the button
Seat 1: petersmiths ($48.63 in chips) 
Seat 2: agurio ($25.10 in chips) 
Seat 3: ChrisCDee ($28.32 in chips) 
Seat 4: kamikkaze ($12.25 in chips) 
Seat 5: RomarioJa ($14.64 in chips) 
Seat 6: chiyuki ($29.28 in chips) 
Seat 7: cR!Ma*aRm ($32.10 in chips) 
Seat 8: NastyMcNast ($25 in chips) 
Seat 9: seula i ($59.50 in chips) 
agurio: posts small blind $0.10
ChrisCDee: posts big blind $0.25
*** HOLE CARDS ***
Dealt to chiyuki [9h 6d]
kamikkaze: folds 
RomarioJa: folds 
chiyuki: folds 
cR!Ma*aRm: folds 
NastyMcNast: folds 
seula i: raises $0.50 to $0.75
petersmiths: folds 
agurio: folds 
ChrisCDee: folds 
Uncalled bet ($0.50) returned to seula i
seula i collected $0.60 from pot
seula i: doesn't show hand 
*** SUMMARY ***
Total pot $0.60 | Rake $0 
Seat 1: petersmiths (button) folded before Flop (didn't bet)
Seat 2: agurio (small blind) folded before Flop
Seat 3: ChrisCDee (big blind) folded before Flop
Seat 4: kamikkaze folded before Flop (didn't bet)
Seat 5: RomarioJa folded before Flop (didn't bet)
Seat 6: chiyuki folded before Flop (didn't bet)
Seat 7: cR!Ma*aRm folded before Flop (didn't bet)
Seat 8: NastyMcNast folded before Flop (didn't bet)
Seat 9: seula i collected ($0.60)



PokerStars Zoom Hand #84299083871:  Hold'em No Limit ($0.10/$0.25) - 2012/08/05 13:54:57 JST [2012/08/05 0:54:57 ET]
Table 'Whirlpool' 9-max Seat #1 is the button
Seat 1: PetitAlejo ($26.58 in chips) 
Seat 2: Suhoff76 ($27.28 in chips) 
Seat 3: seula i ($25 in chips) 
Seat 4: DjJooni ($37.68 in chips) 
Seat 5: fwani ($25.55 in chips) 
Seat 6: wtu1986 ($26.73 in chips) 
Seat 7: RikkStroken ($12.80 in chips) 
Seat 8: KeLevro0 ($10.98 in chips) 
Seat 9: chiyuki ($29.28 in chips) 
Suhoff76: posts small blind $0.10
seula i: posts big blind $0.25
*** HOLE CARDS ***
Dealt to chiyuki [5c Th]
DjJooni: calls $0.25
fwani: folds 
wtu1986: folds 
RikkStroken: calls $0.25
KeLevro0: folds 
chiyuki: folds 
PetitAlejo: folds 
Suhoff76: calls $0.15
seula i: checks 
*** FLOP *** [Qh Qd 4h]
Suhoff76: checks 
seula i: checks 
DjJooni: checks 
RikkStroken: bets $0.75
Suhoff76: folds 
seula i: folds 
DjJooni: folds 
Uncalled bet ($0.75) returned to RikkStroken
RikkStroken collected $0.96 from pot
RikkStroken: doesn't show hand 
*** SUMMARY ***
Total pot $1 | Rake $0.04 
Board [Qh Qd 4h]
Seat 1: PetitAlejo (button) folded before Flop (didn't bet)
Seat 2: Suhoff76 (small blind) folded on the Flop
Seat 3: seula i (big blind) folded on the Flop
Seat 4: DjJooni folded on the Flop
Seat 5: fwani folded before Flop (didn't bet)
Seat 6: wtu1986 folded before Flop (didn't bet)
Seat 7: RikkStroken collected ($0.96)
Seat 8: KeLevro0 folded before Flop (didn't bet)
Seat 9: chiyuki folded before Flop (didn't bet)



PokerStars Zoom Hand #84299084609:  Hold'em No Limit ($0.10/$0.25) - 2012/08/05 13:55:00 JST [2012/08/05 0:55:00 ET]
Table 'Whirlpool' 9-max Seat #1 is the button
Seat 1: agurio ($25 in chips) 
Seat 2: Roglus ($66.44 in chips) 
Seat 3: RomarioJa ($8.10 in chips) 
Seat 4: 123progress ($24.65 in chips) 
Seat 5: petersmiths ($48.73 in chips) 
Seat 6: Th3Fog ($80.06 in chips) 
Seat 7: timburonps ($39.18 in chips) 
Seat 8: chiyuki ($29.28 in chips) 
Seat 9: ygoegoe ($29.99 in chips) 
Roglus: posts small blind $0.10
RomarioJa: posts big blind $0.25
*** HOLE CARDS ***
Dealt to chiyuki [Qh 6c]
123progress: raises $0.50 to $0.75
petersmiths: folds 
Th3Fog: folds 
timburonps: folds 
chiyuki: folds 
ygoegoe: folds 
agurio: folds 
Roglus: calls $0.65
RomarioJa: folds 
*** FLOP *** [6h 9d 8h]
Roglus: checks 
123progress: bets $1.25
Roglus: calls $1.25
*** TURN *** [6h 9d 8h] [2d]
Roglus: bets $1.42
123progress: raises $3.33 to $4.75
Roglus: folds 
Uncalled bet ($3.33) returned to 123progress
123progress collected $6.77 from pot
123progress: doesn't show hand 
*** SUMMARY ***
Total pot $7.09 | Rake $0.32 
Board [6h 9d 8h 2d]
Seat 1: agurio (button) folded before Flop (didn't bet)
Seat 2: Roglus (small blind) folded on the Turn
Seat 3: RomarioJa (big blind) folded before Flop
Seat 4: 123progress collected ($6.77)
Seat 5: petersmiths folded before Flop (didn't bet)
Seat 6: Th3Fog folded before Flop (didn't bet)
Seat 7: timburonps folded before Flop (didn't bet)
Seat 8: chiyuki folded before Flop (didn't bet)
Seat 9: ygoegoe folded before Flop (didn't bet)



PokerStars Zoom Hand #84299091656:  Hold'em No Limit ($0.10/$0.25) - 2012/08/05 13:55:32 JST [2012/08/05 0:55:32 ET]
Table 'Whirlpool' 9-max Seat #1 is the button
Seat 1: Suhoff76 ($27.03 in chips) 
Seat 2: chiyuki ($29.28 in chips) 
Seat 3: BlOnDhOlIc ($57.80 in chips) 
Seat 4: RikkStroken ($15 in chips) 
Seat 5: Wilcox76607 ($20.76 in chips) 
Seat 6: mariuka1 ($12.72 in chips) 
Seat 7: flyinprits ($44.37 in chips) 
Seat 8: agurio ($25 in chips) 
Seat 9: BlackZafiro ($27.07 in chips) 
chiyuki: posts small blind $0.10
BlOnDhOlIc: posts big blind $0.25
*** HOLE CARDS ***
Dealt to chiyuki [Jd 8s]
RikkStroken: folds 
Wilcox76607: raises $0.50 to $0.75
mariuka1: folds 
flyinprits: folds 
agurio: folds 
BlackZafiro: folds 
Suhoff76: folds 
chiyuki: folds 
BlOnDhOlIc: folds 
Uncalled bet ($0.50) returned to Wilcox76607
Wilcox76607 collected $0.60 from pot
Wilcox76607: doesn't show hand 
*** SUMMARY ***
Total pot $0.60 | Rake $0 
Seat 1: Suhoff76 (button) folded before Flop (didn't bet)
Seat 2: chiyuki (small blind) folded before Flop
Seat 3: BlOnDhOlIc (big blind) folded before Flop
Seat 4: RikkStroken folded before Flop (didn't bet)
Seat 5: Wilcox76607 collected ($0.60)
Seat 6: mariuka1 folded before Flop (didn't bet)
Seat 7: flyinprits folded before Flop (didn't bet)
Seat 8: agurio folded before Flop (didn't bet)
Seat 9: BlackZafiro folded before Flop (didn't bet)



PokerStars Zoom Hand #84299088342:  Hold'em No Limit ($0.10/$0.25) - 2012/08/05 13:55:15 JST [2012/08/05 0:55:15 ET]
Table 'Whirlpool' 9-max Seat #1 is the button
Seat 1: Th3Fog ($21.74 in chips) 
Seat 2: kamikkaze ($12.25 in chips) 
Seat 3: Loholov ($17.90 in chips) 
Seat 4: Nerkit ($19.78 in chips) 
Seat 5: chiyuki ($29.28 in chips) 
Seat 6: RomarioJa ($7.85 in chips) 
Seat 7: petersmiths ($48.63 in chips) 
Seat 8: munky3 ($29.61 in chips) 
Seat 9: BlOnDhOlIc ($47.23 in chips) 
kamikkaze: posts small blind $0.10
Loholov: posts big blind $0.25
*** HOLE CARDS ***
Dealt to chiyuki [2h 5d]
Nerkit: folds 
chiyuki: folds 
RomarioJa: folds 
petersmiths: raises $0.25 to $0.50
munky3: calls $0.50
BlOnDhOlIc: raises $1.75 to $2.25
Th3Fog: folds 
kamikkaze: folds 
Loholov: folds 
petersmiths: raises $2.75 to $5
munky3: folds 
BlOnDhOlIc: calls $2.75
*** FLOP *** [Qh 8d Ad]
petersmiths: bets $10.36
BlOnDhOlIc: raises $31.87 to $42.23 and is all-in
petersmiths: folds 
Uncalled bet ($31.87) returned to BlOnDhOlIc
BlOnDhOlIc collected $30.15 from pot
BlOnDhOlIc: doesn't show hand 
*** SUMMARY ***
Total pot $31.57 | Rake $1.42 
Board [Qh 8d Ad]
Seat 1: Th3Fog (button) folded before Flop (didn't bet)
Seat 2: kamikkaze (small blind) folded before Flop
Seat 3: Loholov (big blind) folded before Flop
Seat 4: Nerkit folded before Flop (didn't bet)
Seat 5: chiyuki folded before Flop (didn't bet)
Seat 6: RomarioJa folded before Flop (didn't bet)
Seat 7: petersmiths folded on the Flop
Seat 8: munky3 folded before Flop
Seat 9: BlOnDhOlIc collected ($30.15)



PokerStars Zoom Hand #84299098793:  Hold'em No Limit ($0.10/$0.25) - 2012/08/05 13:56:07 JST [2012/08/05 0:56:07 ET]
Table 'Whirlpool' 9-max Seat #1 is the button
Seat 1: carlosrbr ($16.51 in chips) 
Seat 2: GoldNutter ($15.30 in chips) 
Seat 3: chiyuki ($29.18 in chips) 
Seat 4: deadmoneykid ($27.04 in chips) 
Seat 5: Dejacob ($32.15 in chips) 
Seat 6: RikkStroken ($13.86 in chips) 
Seat 7: hirozo ($26.17 in chips) 
Seat 8: agurio ($25 in chips) 
Seat 9: TErr18 ($16.50 in chips) 
GoldNutter: posts small blind $0.10
chiyuki: posts big blind $0.25
*** HOLE CARDS ***
Dealt to chiyuki [6h 5h]
deadmoneykid: folds 
Dejacob: folds 
RikkStroken: folds 
hirozo: raises $0.50 to $0.75
agurio: folds 
TErr18: folds 
carlosrbr: folds 
GoldNutter: folds 
chiyuki: folds 
Uncalled bet ($0.50) returned to hirozo
hirozo collected $0.60 from pot
hirozo: doesn't show hand 
*** SUMMARY ***
Total pot $0.60 | Rake $0 
Seat 1: carlosrbr (button) folded before Flop (didn't bet)
Seat 2: GoldNutter (small blind) folded before Flop
Seat 3: chiyuki (big blind) folded before Flop
Seat 4: deadmoneykid folded before Flop (didn't bet)
Seat 5: Dejacob folded before Flop (didn't bet)
Seat 6: RikkStroken folded before Flop (didn't bet)
Seat 7: hirozo collected ($0.60)
Seat 8: agurio folded before Flop (didn't bet)
Seat 9: TErr18 folded before Flop (didn't bet)



PokerStars Zoom Hand #84299096319:  Hold'em No Limit ($0.10/$0.25) - 2012/08/05 13:55:55 JST [2012/08/05 0:55:55 ET]
Table 'Whirlpool' 9-max Seat #1 is the button
Seat 1: chiyuki ($29.18 in chips) 
Seat 2: slapshot2011 ($21.30 in chips) 
Seat 3: agurio ($25 in chips) 
Seat 4: carlosrbr ($16.61 in chips) 
Seat 5: Vahe50 ($15.70 in chips) 
Seat 6: Suhoff76 ($38.88 in chips) 
Seat 7: NastyMcNast ($25 in chips) 
Seat 8: solawind ($12.62 in chips) 
Seat 9: timburonps ($39.18 in chips) 
slapshot2011: posts small blind $0.10
agurio: posts big blind $0.25
*** HOLE CARDS ***
Dealt to chiyuki [Kh 7d]
carlosrbr: folds 
Vahe50: folds 
Suhoff76: raises $0.32 to $0.57
NastyMcNast: folds 
solawind: calls $0.57
timburonps: folds 
chiyuki: folds 
slapshot2011: calls $0.47
agurio: folds 
*** FLOP *** [Ts Jc 4c]
slapshot2011: checks 
Suhoff76: checks 
solawind: bets $1.12
slapshot2011: folds 
Suhoff76: folds 
Uncalled bet ($1.12) returned to solawind
solawind collected $1.87 from pot
solawind: doesn't show hand 
*** SUMMARY ***
Total pot $1.96 | Rake $0.09 
Board [Ts Jc 4c]
Seat 1: chiyuki (button) folded before Flop (didn't bet)
Seat 2: slapshot2011 (small blind) folded on the Flop
Seat 3: agurio (big blind) folded before Flop
Seat 4: carlosrbr folded before Flop (didn't bet)
Seat 5: Vahe50 folded before Flop (didn't bet)
Seat 6: Suhoff76 folded on the Flop
Seat 7: NastyMcNast folded before Flop (didn't bet)
Seat 8: solawind collected ($1.87)
Seat 9: timburonps folded before Flop (didn't bet)



PokerStars Zoom Hand #84299096915:  Hold'em No Limit ($0.10/$0.25) - 2012/08/05 13:55:58 JST [2012/08/05 0:55:58 ET]
Table 'Whirlpool' 9-max Seat #1 is the button
Seat 1: Csabee21 ($27.78 in chips) 
Seat 2: silvno31 ($45.69 in chips) 
Seat 3: Curtis1436 ($25 in chips) 
Seat 4: BlackZafiro ($25.60 in chips) 
Seat 5: ygoegoe ($34.54 in chips) 
Seat 6: roksmokndonk ($36.71 in chips) 
Seat 7: Dejacob ($32.15 in chips) 
Seat 8: PetitAlejo ($28.69 in chips) 
Seat 9: chiyuki ($29.18 in chips) 
silvno31: posts small blind $0.10
Curtis1436: posts big blind $0.25
*** HOLE CARDS ***
Dealt to chiyuki [Qh 2s]
BlackZafiro: folds 
ygoegoe: folds 
roksmokndonk: folds 
Dejacob: folds 
PetitAlejo: folds 
chiyuki: folds 
Csabee21: raises $0.50 to $0.75
silvno31: folds 
Curtis1436: calls $0.50
*** FLOP *** [Kd 3d 5d]
Curtis1436: checks 
Csabee21: bets $1
Curtis1436: calls $1
*** TURN *** [Kd 3d 5d] [7s]
Curtis1436: bets $4
Csabee21: folds 
Uncalled bet ($4) returned to Curtis1436
Curtis1436 collected $3.44 from pot
Curtis1436: doesn't show hand 
*** SUMMARY ***
Total pot $3.60 | Rake $0.16 
Board [Kd 3d 5d 7s]
Seat 1: Csabee21 (button) folded on the Turn
Seat 2: silvno31 (small blind) folded before Flop
Seat 3: Curtis1436 (big blind) collected ($3.44)
Seat 4: BlackZafiro folded before Flop (didn't bet)
Seat 5: ygoegoe folded before Flop (didn't bet)
Seat 6: roksmokndonk folded before Flop (didn't bet)
Seat 7: Dejacob folded before Flop (didn't bet)
Seat 8: PetitAlejo folded before Flop (didn't bet)
Seat 9: chiyuki folded before Flop (didn't bet)



PokerStars Zoom Hand #84299102263:  Hold'em No Limit ($0.10/$0.25) - 2012/08/05 13:56:24 JST [2012/08/05 0:56:24 ET]
Table 'Whirlpool' 9-max Seat #1 is the button
Seat 1: agurio ($25 in chips) 
Seat 2: BlackZafiro ($47.54 in chips) 
Seat 3: timburonps ($27.06 in chips) 
Seat 4: Vahe50 ($30.10 in chips) 
Seat 5: KeLevro0 ($14.22 in chips) 
Seat 6: chiyuki ($28.93 in chips) 
Seat 7: Noviekid ($24.98 in chips) 
Seat 8: TErr18 ($16.50 in chips) 
Seat 9: KAKamiro ($39.06 in chips) 
BlackZafiro: posts small blind $0.10
timburonps: posts big blind $0.25
*** HOLE CARDS ***
Dealt to chiyuki [6d 3d]
Vahe50: folds 
KeLevro0: folds 
chiyuki: folds 
Noviekid: raises $0.25 to $0.50
TErr18: folds 
KAKamiro: folds 
agurio: folds 
BlackZafiro: folds 
timburonps: folds 
Uncalled bet ($0.25) returned to Noviekid
Noviekid collected $0.60 from pot
Noviekid: doesn't show hand 
*** SUMMARY ***
Total pot $0.60 | Rake $0 
Seat 1: agurio (button) folded before Flop (didn't bet)
Seat 2: BlackZafiro (small blind) folded before Flop
Seat 3: timburonps (big blind) folded before Flop
Seat 4: Vahe50 folded before Flop (didn't bet)
Seat 5: KeLevro0 folded before Flop (didn't bet)
Seat 6: chiyuki folded before Flop (didn't bet)
Seat 7: Noviekid collected ($0.60)
Seat 8: TErr18 folded before Flop (didn't bet)
Seat 9: KAKamiro folded before Flop (didn't bet)



PokerStars Zoom Hand #84299105179:  Hold'em No Limit ($0.10/$0.25) - 2012/08/05 13:56:39 JST [2012/08/05 0:56:39 ET]
Table 'Whirlpool' 9-max Seat #1 is the button
Seat 1: TErr18 ($16.50 in chips) 
Seat 2: BlOnDhOlIc ($57.55 in chips) 
Seat 3: Loholov ($15.35 in chips) 
Seat 4: KeLevro0 ($12.15 in chips) 
Seat 5: chiyuki ($28.93 in chips) 
Seat 6: BlackZafiro ($27.42 in chips) 
Seat 7: Anafim ($12.50 in chips) 
Seat 8: Suhoff76 ($26.78 in chips) 
Seat 9: PetitAlejo ($25 in chips) 
BlOnDhOlIc: posts small blind $0.10
Loholov: posts big blind $0.25
*** HOLE CARDS ***
Dealt to chiyuki [Jd 4c]
KeLevro0: folds 
chiyuki: folds 
BlackZafiro: folds 
Anafim: folds 
Suhoff76: folds 
PetitAlejo: raises $0.50 to $0.75
TErr18: folds 
BlOnDhOlIc: folds 
Loholov: folds 
Uncalled bet ($0.50) returned to PetitAlejo
PetitAlejo collected $0.60 from pot
PetitAlejo: doesn't show hand 
*** SUMMARY ***
Total pot $0.60 | Rake $0 
Seat 1: TErr18 (button) folded before Flop (didn't bet)
Seat 2: BlOnDhOlIc (small blind) folded before Flop
Seat 3: Loholov (big blind) folded before Flop
Seat 4: KeLevro0 folded before Flop (didn't bet)
Seat 5: chiyuki folded before Flop (didn't bet)
Seat 6: BlackZafiro folded before Flop (didn't bet)
Seat 7: Anafim folded before Flop (didn't bet)
Seat 8: Suhoff76 folded before Flop (didn't bet)
Seat 9: PetitAlejo collected ($0.60)



PokerStars Zoom Hand #84299104537:  Hold'em No Limit ($0.10/$0.25) - 2012/08/05 13:56:35 JST [2012/08/05 0:56:35 ET]
Table 'Whirlpool' 9-max Seat #1 is the button
Seat 1: Th3Fog ($77.62 in chips) 
Seat 2: kamikkaze ($14.75 in chips) 
Seat 3: Ellen1947 ($30.18 in chips) 
Seat 4: chiyuki ($28.93 in chips) 
Seat 5: deadmoneykid ($39.77 in chips) 
Seat 6: Loholov ($19.15 in chips) 
Seat 7: DjJooni ($41.73 in chips) 
Seat 8: silvno31 ($45.69 in chips) 
Seat 9: 123progress ($37.22 in chips) 
kamikkaze: posts small blind $0.10
Ellen1947: posts big blind $0.25
*** HOLE CARDS ***
Dealt to chiyuki [Jc 7s]
chiyuki: folds 
deadmoneykid: folds 
Loholov: folds 
DjJooni: folds 
silvno31: folds 
123progress: folds 
Th3Fog: raises $0.35 to $0.60
kamikkaze: calls $0.50
Ellen1947: calls $0.35
*** FLOP *** [Jh 5s 7h]
kamikkaze: checks 
Ellen1947: bets $0.90
Th3Fog: folds 
kamikkaze: folds 
Uncalled bet ($0.90) returned to Ellen1947
Ellen1947 collected $1.72 from pot
Ellen1947: doesn't show hand 
*** SUMMARY ***
Total pot $1.80 | Rake $0.08 
Board [Jh 5s 7h]
Seat 1: Th3Fog (button) folded on the Flop
Seat 2: kamikkaze (small blind) folded on the Flop
Seat 3: Ellen1947 (big blind) collected ($1.72)
Seat 4: chiyuki folded before Flop (didn't bet)
Seat 5: deadmoneykid folded before Flop (didn't bet)
Seat 6: Loholov folded before Flop (didn't bet)
Seat 7: DjJooni folded before Flop (didn't bet)
Seat 8: silvno31 folded before Flop (didn't bet)
Seat 9: 123progress folded before Flop (didn't bet)



PokerStars Zoom Hand #84299108111:  Hold'em No Limit ($0.10/$0.25) - 2012/08/05 13:56:53 JST [2012/08/05 0:56:53 ET]
Table 'Whirlpool' 9-max Seat #1 is the button
Seat 1: hirozo ($29.37 in chips) 
Seat 2: RikkStroken ($13.61 in chips) 
Seat 3: RomarioJa ($14.30 in chips) 
Seat 4: flyinprits ($35.66 in chips) 
Seat 5: chiyuki ($28.93 in chips) 
Seat 6: PetitAlejo ($25.35 in chips) 
Seat 7: Landybob ($35 in chips) 
Seat 8: Th3Fog ($20.94 in chips) 
Seat 9: Suhoff76 ($26.78 in chips) 
RikkStroken: posts small blind $0.10
RomarioJa: posts big blind $0.25
*** HOLE CARDS ***
Dealt to chiyuki [Jc 2c]
flyinprits: folds 
chiyuki: folds 
PetitAlejo: folds 
Landybob: folds 
Th3Fog: folds 
Suhoff76: folds 
hirozo: folds 
RikkStroken: raises $0.50 to $0.75
RomarioJa: folds 
Uncalled bet ($0.50) returned to RikkStroken
RikkStroken collected $0.50 from pot
RikkStroken: doesn't show hand 
*** SUMMARY ***
Total pot $0.50 | Rake $0 
Seat 1: hirozo (button) folded before Flop (didn't bet)
Seat 2: RikkStroken (small blind) collected ($0.50)
Seat 3: RomarioJa (big blind) folded before Flop
Seat 4: flyinprits folded before Flop (didn't bet)
Seat 5: chiyuki folded before Flop (didn't bet)
Seat 6: PetitAlejo folded before Flop (didn't bet)
Seat 7: Landybob folded before Flop (didn't bet)
Seat 8: Th3Fog folded before Flop (didn't bet)
Seat 9: Suhoff76 folded before Flop (didn't bet)



PokerStars Zoom Hand #84299108912:  Hold'em No Limit ($0.10/$0.25) - 2012/08/05 13:56:57 JST [2012/08/05 0:56:57 ET]
Table 'Whirlpool' 9-max Seat #1 is the button
Seat 1: softdesign ($75.43 in chips) 
Seat 2: chiyuki ($28.93 in chips) 
Seat 3: giorgos_k ($16.26 in chips) 
Seat 4: fwani ($32.23 in chips) 
Seat 5: wtu1986 ($25.90 in chips) 
Seat 6: ladymadon107 ($14.95 in chips) 
Seat 7: Th3Fog ($20.94 in chips) 
Seat 8: D@vidMed ($52.44 in chips) 
Seat 9: agurio ($25 in chips) 
chiyuki: posts small blind $0.10
giorgos_k: posts big blind $0.25
*** HOLE CARDS ***
Dealt to chiyuki [9s 3s]
fwani: folds 
wtu1986: folds 
ladymadon107: folds 
Th3Fog: folds 
D@vidMed: folds 
agurio: folds 
softdesign: raises $0.50 to $0.75
chiyuki: folds 
giorgos_k: folds 
Uncalled bet ($0.50) returned to softdesign
softdesign collected $0.60 from pot
softdesign: doesn't show hand 
*** SUMMARY ***
Total pot $0.60 | Rake $0 
Seat 1: softdesign (button) collected ($0.60)
Seat 2: chiyuki (small blind) folded before Flop
Seat 3: giorgos_k (big blind) folded before Flop
Seat 4: fwani folded before Flop (didn't bet)
Seat 5: wtu1986 folded before Flop (didn't bet)
Seat 6: ladymadon107 folded before Flop (didn't bet)
Seat 7: Th3Fog folded before Flop (didn't bet)
Seat 8: D@vidMed folded before Flop (didn't bet)
Seat 9: agurio folded before Flop (didn't bet)



PokerStars Zoom Hand #84299103074:  Hold'em No Limit ($0.10/$0.25) - 2012/08/05 13:56:28 JST [2012/08/05 0:56:28 ET]
Table 'Whirlpool' 9-max Seat #1 is the button
Seat 1: jeff0923 ($22.60 in chips) 
Seat 2: hirozo ($26.52 in chips) 
Seat 3: seula i ($59.10 in chips) 
Seat 4: Suhoff76 ($54.96 in chips) 
Seat 5: carlosrbr ($16.51 in chips) 
Seat 6: flyinprits ($44.82 in chips) 
Seat 7: RikkStroken ($14.65 in chips) 
Seat 8: chiyuki ($28.93 in chips) 
Seat 9: leo2095 ($14.61 in chips) 
hirozo: posts small blind $0.10
seula i: posts big blind $0.25
*** HOLE CARDS ***
Dealt to chiyuki [3c 3d]
Suhoff76: raises $0.50 to $0.75
carlosrbr: folds 
flyinprits: folds 
RikkStroken: folds 
chiyuki: folds 
leo2095: folds 
jeff0923: calls $0.75
hirozo: folds 
seula i: calls $0.50
*** FLOP *** [8c 7d Qc]
seula i: checks 
Suhoff76: bets $1.72
jeff0923: calls $1.72
seula i: calls $1.72
*** TURN *** [8c 7d Qc] [6c]
seula i: checks 
Suhoff76: checks 
jeff0923: checks 
*** RIVER *** [8c 7d Qc 6c] [5h]
seula i: bets $2
Suhoff76: folds 
jeff0923: calls $2
*** SHOW DOWN ***
seula i: shows [6s 5s] (two pair, Sixes and Fives)
jeff0923: mucks hand 
seula i collected $10.99 from pot
*** SUMMARY ***
Total pot $11.51 | Rake $0.52 
Board [8c 7d Qc 6c 5h]
Seat 1: jeff0923 (button) mucked [Jh Jd]
Seat 2: hirozo (small blind) folded before Flop
Seat 3: seula i (big blind) showed [6s 5s] and won ($10.99) with two pair, Sixes and Fives
Seat 4: Suhoff76 folded on the River
Seat 5: carlosrbr folded before Flop (didn't bet)
Seat 6: flyinprits folded before Flop (didn't bet)
Seat 7: RikkStroken folded before Flop (didn't bet)
Seat 8: chiyuki folded before Flop (didn't bet)
Seat 9: leo2095 folded before Flop (didn't bet)



PokerStars Zoom Hand #84299112189:  Hold'em No Limit ($0.10/$0.25) - 2012/08/05 13:57:13 JST [2012/08/05 0:57:13 ET]
Table 'Whirlpool' 9-max Seat #1 is the button
Seat 1: RikkStroken ($13.86 in chips) 
Seat 2: fwani ($31.44 in chips) 
Seat 3: chiyuki ($28.83 in chips) 
Seat 4: BlackZafiro ($25.10 in chips) 
Seat 5: NastyMcNast ($36 in chips) 
Seat 6: RomarioJa ($15.07 in chips) 
Seat 7: timburonps ($28.47 in chips) 
Seat 8: flyinprits ($44.57 in chips) 
Seat 9: Tom1999 ($15.35 in chips) 
fwani: posts small blind $0.10
chiyuki: posts big blind $0.25
*** HOLE CARDS ***
Dealt to chiyuki [5c 8h]
BlackZafiro: folds 
NastyMcNast: folds 
RomarioJa: folds 
timburonps: folds 
flyinprits: raises $0.50 to $0.75
Tom1999: folds 
RikkStroken: folds 
fwani: folds 
chiyuki: folds 
Uncalled bet ($0.50) returned to flyinprits
flyinprits collected $0.60 from pot
flyinprits: doesn't show hand 
*** SUMMARY ***
Total pot $0.60 | Rake $0 
Seat 1: RikkStroken (button) folded before Flop (didn't bet)
Seat 2: fwani (small blind) folded before Flop
Seat 3: chiyuki (big blind) folded before Flop
Seat 4: BlackZafiro folded before Flop (didn't bet)
Seat 5: NastyMcNast folded before Flop (didn't bet)
Seat 6: RomarioJa folded before Flop (didn't bet)
Seat 7: timburonps folded before Flop (didn't bet)
Seat 8: flyinprits collected ($0.60)
Seat 9: Tom1999 folded before Flop (didn't bet)



PokerStars Zoom Hand #84299105809:  Hold'em No Limit ($0.10/$0.25) - 2012/08/05 13:56:42 JST [2012/08/05 0:56:42 ET]
Table 'Whirlpool' 9-max Seat #1 is the button
Seat 1: Roglus ($63.72 in chips) 
Seat 2: ygoegoe ($28.99 in chips) 
Seat 3: slapshot2011 ($19.98 in chips) 
Seat 4: kamikkaze ($14.75 in chips) 
Seat 5: Rudolf ($54.87 in chips) 
Seat 6: cr0lox ($24.75 in chips) 
Seat 7: chiyuki ($28.93 in chips) 
Seat 8: BlOnDhOlIc ($25 in chips) 
Seat 9: BlackZafiro ($47.44 in chips) 
ygoegoe: posts small blind $0.10
slapshot2011: posts big blind $0.25
*** HOLE CARDS ***
Dealt to chiyuki [Ks 4s]
kamikkaze: folds 
Rudolf: folds 
cr0lox: raises $0.50 to $0.75
chiyuki: folds 
BlOnDhOlIc: folds 
BlackZafiro: folds 
Roglus: calls $0.75
ygoegoe: folds 
slapshot2011: calls $0.50
*** FLOP *** [3d 8h Tc]
slapshot2011: checks 
cr0lox: bets $1.12
Roglus: calls $1.12
slapshot2011: folds 
*** TURN *** [3d 8h Tc] [6s]
cr0lox: checks 
Roglus: checks 
*** RIVER *** [3d 8h Tc 6s] [5h]
cr0lox: bets $3.88
Roglus: raises $3.88 to $7.76
cr0lox: calls $3.88
*** SHOW DOWN ***
Roglus: shows [5s 5c] (three of a kind, Fives)
cr0lox: mucks hand 
Roglus collected $19.21 from pot
*** SUMMARY ***
Total pot $20.11 | Rake $0.90 
Board [3d 8h Tc 6s 5h]
Seat 1: Roglus (button) showed [5s 5c] and won ($19.21) with three of a kind, Fives
Seat 2: ygoegoe (small blind) folded before Flop
Seat 3: slapshot2011 (big blind) folded on the Flop
Seat 4: kamikkaze folded before Flop (didn't bet)
Seat 5: Rudolf folded before Flop (didn't bet)
Seat 6: cr0lox mucked [Ac Ad]
Seat 7: chiyuki folded before Flop (didn't bet)
Seat 8: BlOnDhOlIc folded before Flop (didn't bet)
Seat 9: BlackZafiro folded before Flop (didn't bet)



PokerStars Zoom Hand #84299110517:  Hold'em No Limit ($0.10/$0.25) - 2012/08/05 13:57:05 JST [2012/08/05 0:57:05 ET]
Table 'Whirlpool' 9-max Seat #1 is the button
Seat 1: kamikkaze ($14.15 in chips) 
Seat 2: RomarioJa ($4.73 in chips) 
Seat 3: cR!Ma*aRm ($31.45 in chips) 
Seat 4: chiyuki ($28.83 in chips) 
Seat 5: mariuka1 ($11.62 in chips) 
Seat 6: agurio ($25 in chips) 
Seat 7: Curtis1436 ($26.59 in chips) 
Seat 8: NastyMcNast ($36 in chips) 
Seat 9: hirozo ($26 in chips) 
RomarioJa: posts small blind $0.10
cR!Ma*aRm: posts big blind $0.25
*** HOLE CARDS ***
Dealt to chiyuki [Th 2d]
chiyuki: folds 
mariuka1: folds 
agurio: folds 
Curtis1436: folds 
NastyMcNast: folds 
hirozo: raises $0.50 to $0.75
kamikkaze: folds 
RomarioJa: raises $3.98 to $4.73 and is all-in
cR!Ma*aRm: folds 
hirozo: folds 
Uncalled bet ($3.98) returned to RomarioJa
RomarioJa collected $1.75 from pot
RomarioJa: doesn't show hand 
*** SUMMARY ***
Total pot $1.75 | Rake $0 
Seat 1: kamikkaze (button) folded before Flop (didn't bet)
Seat 2: RomarioJa (small blind) collected ($1.75)
Seat 3: cR!Ma*aRm (big blind) folded before Flop
Seat 4: chiyuki folded before Flop (didn't bet)
Seat 5: mariuka1 folded before Flop (didn't bet)
Seat 6: agurio folded before Flop (didn't bet)
Seat 7: Curtis1436 folded before Flop (didn't bet)
Seat 8: NastyMcNast folded before Flop (didn't bet)
Seat 9: hirozo folded before Flop



PokerStars Zoom Hand #84299115140:  Hold'em No Limit ($0.10/$0.25) - 2012/08/05 13:57:27 JST [2012/08/05 0:57:27 ET]
Table 'Whirlpool' 9-max Seat #1 is the button
Seat 1: chiyuki ($28.58 in chips) 
Seat 2: Alvinpe85 ($37.58 in chips) 
Seat 3: agurio ($25 in chips) 
Seat 4: solawind ($13.92 in chips) 
Seat 5: softdesign ($75.78 in chips) 
Seat 6: kamikkaze ($14.15 in chips) 
Seat 7: Dejacob ($41.39 in chips) 
Seat 8: 2997qwer ($11.80 in chips) 
Seat 9: Loholov ($18.80 in chips) 
Alvinpe85: posts small blind $0.10
agurio: posts big blind $0.25
*** HOLE CARDS ***
Dealt to chiyuki [7h Ac]
solawind: folds 
softdesign: calls $0.25
kamikkaze: calls $0.25
Dejacob: folds 
2997qwer: folds 
Loholov: folds 
chiyuki: folds 
Alvinpe85: folds 
agurio: checks 
*** FLOP *** [5c 6d Js]
agurio: bets $0.56
softdesign: folds 
kamikkaze: folds 
Uncalled bet ($0.56) returned to agurio
agurio collected $0.81 from pot
agurio: doesn't show hand 
*** SUMMARY ***
Total pot $0.85 | Rake $0.04 
Board [5c 6d Js]
Seat 1: chiyuki (button) folded before Flop (didn't bet)
Seat 2: Alvinpe85 (small blind) folded before Flop
Seat 3: agurio (big blind) collected ($0.81)
Seat 4: solawind folded before Flop (didn't bet)
Seat 5: softdesign folded on the Flop
Seat 6: kamikkaze folded on the Flop
Seat 7: Dejacob folded before Flop (didn't bet)
Seat 8: 2997qwer folded before Flop (didn't bet)
Seat 9: Loholov folded before Flop (didn't bet)



PokerStars Zoom Hand #84299121534:  Hold'em No Limit ($0.10/$0.25) - 2012/08/05 13:57:59 JST [2012/08/05 0:57:59 ET]
Table 'Whirlpool' 9-max Seat #1 is the button
Seat 1: leo2095 ($13.86 in chips) 
Seat 2: ll_LaMeR_ll ($73.64 in chips) 
Seat 3: carlosrbr ($16.86 in chips) 
Seat 4: flyinprits ($44.82 in chips) 
Seat 5: solawind ($13.82 in chips) 
Seat 6: chiyuki ($28.58 in chips) 
Seat 7: Nerkit ($12.15 in chips) 
Seat 8: Loholov ($19.20 in chips) 
Seat 9: Suhoff76 ($41.73 in chips) 
ll_LaMeR_ll: posts small blind $0.10
carlosrbr: posts big blind $0.25
*** HOLE CARDS ***
Dealt to chiyuki [Tc Jd]
flyinprits: folds 
solawind: folds 
chiyuki: folds 
Nerkit: raises $0.50 to $0.75
Loholov: folds 
Suhoff76: folds 
leo2095: folds 
ll_LaMeR_ll: calls $0.65
carlosrbr: folds 
*** FLOP *** [Ks 9d 8c]
ll_LaMeR_ll: bets $1
Nerkit: folds 
Uncalled bet ($1) returned to ll_LaMeR_ll
ll_LaMeR_ll collected $1.67 from pot
ll_LaMeR_ll: doesn't show hand 
*** SUMMARY ***
Total pot $1.75 | Rake $0.08 
Board [Ks 9d 8c]
Seat 1: leo2095 (button) folded before Flop (didn't bet)
Seat 2: ll_LaMeR_ll (small blind) collected ($1.67)
Seat 3: carlosrbr (big blind) folded before Flop
Seat 4: flyinprits folded before Flop (didn't bet)
Seat 5: solawind folded before Flop (didn't bet)
Seat 6: chiyuki folded before Flop (didn't bet)
Seat 7: Nerkit folded on the Flop
Seat 8: Loholov folded before Flop (didn't bet)
Seat 9: Suhoff76 folded before Flop (didn't bet)



PokerStars Zoom Hand #84299118667:  Hold'em No Limit ($0.10/$0.25) - 2012/08/05 13:57:44 JST [2012/08/05 0:57:44 ET]
Table 'Whirlpool' 9-max Seat #1 is the button
Seat 1: NastyMcNast ($28.15 in chips) 
Seat 2: seula i ($26 in chips) 
Seat 3: KeLevro0 ($13.78 in chips) 
Seat 4: PetitAlejo ($30.37 in chips) 
Seat 5: RikkStroken ($8.74 in chips) 
Seat 6: 2997qwer ($11.80 in chips) 
Seat 7: deadmoneykid ($35.25 in chips) 
Seat 8: hirozo ($25.25 in chips) 
Seat 9: chiyuki ($28.58 in chips) 
seula i: posts small blind $0.10
KeLevro0: posts big blind $0.25
*** HOLE CARDS ***
Dealt to chiyuki [5s 3s]
PetitAlejo: folds 
RikkStroken: raises $0.50 to $0.75
2997qwer: folds 
deadmoneykid: calls $0.75
hirozo: folds 
chiyuki: folds 
NastyMcNast: folds 
seula i: folds 
KeLevro0: folds 
*** FLOP *** [2c Th 8c]
RikkStroken: bets $1
deadmoneykid: folds 
Uncalled bet ($1) returned to RikkStroken
RikkStroken collected $1.77 from pot
RikkStroken: doesn't show hand 
*** SUMMARY ***
Total pot $1.85 | Rake $0.08 
Board [2c Th 8c]
Seat 1: NastyMcNast (button) folded before Flop (didn't bet)
Seat 2: seula i (small blind) folded before Flop
Seat 3: KeLevro0 (big blind) folded before Flop
Seat 4: PetitAlejo folded before Flop (didn't bet)
Seat 5: RikkStroken collected ($1.77)
Seat 6: 2997qwer folded before Flop (didn't bet)
Seat 7: deadmoneykid folded on the Flop
Seat 8: hirozo folded before Flop (didn't bet)
Seat 9: chiyuki folded before Flop (didn't bet)



PokerStars Zoom Hand #84299119724:  Hold'em No Limit ($0.10/$0.25) - 2012/08/05 13:57:49 JST [2012/08/05 0:57:49 ET]
Table 'Whirlpool' 9-max Seat #1 is the button
Seat 1: Loholov ($19.20 in chips) 
Seat 2: PetitAlejo ($30.37 in chips) 
Seat 3: KAKamiro ($41.38 in chips) 
Seat 4: wtu1986 ($24.90 in chips) 
Seat 5: D@vidMed ($52.09 in chips) 
Seat 6: hirozo ($30.90 in chips) 
Seat 7: timburonps ($44.36 in chips) 
Seat 8: chiyuki ($28.58 in chips) 
Seat 9: seula i ($25.90 in chips) 
PetitAlejo: posts small blind $0.10
KAKamiro: posts big blind $0.25
*** HOLE CARDS ***
Dealt to chiyuki [9s Ks]
wtu1986: folds 
D@vidMed: folds 
hirozo: folds 
timburonps: folds 
chiyuki: folds 
seula i: folds 
Loholov: folds 
PetitAlejo: raises $0.50 to $0.75
KAKamiro: calls $0.50
*** FLOP *** [7h 4s 7d]
PetitAlejo: checks 
KAKamiro: checks 
*** TURN *** [7h 4s 7d] [Kc]
PetitAlejo: bets $1
KAKamiro: calls $1
*** RIVER *** [7h 4s 7d Kc] [8h]
PetitAlejo: checks 
KAKamiro: bets $1
PetitAlejo: folds 
Uncalled bet ($1) returned to KAKamiro
KAKamiro collected $3.34 from pot
KAKamiro: doesn't show hand 
*** SUMMARY ***
Total pot $3.50 | Rake $0.16 
Board [7h 4s 7d Kc 8h]
Seat 1: Loholov (button) folded before Flop (didn't bet)
Seat 2: PetitAlejo (small blind) folded on the River
Seat 3: KAKamiro (big blind) collected ($3.34)
Seat 4: wtu1986 folded before Flop (didn't bet)
Seat 5: D@vidMed folded before Flop (didn't bet)
Seat 6: hirozo folded before Flop (didn't bet)
Seat 7: timburonps folded before Flop (didn't bet)
Seat 8: chiyuki folded before Flop (didn't bet)
Seat 9: seula i folded before Flop (didn't bet)



PokerStars Zoom Hand #84299126234:  Hold'em No Limit ($0.10/$0.25) - 2012/08/05 13:58:22 JST [2012/08/05 0:58:22 ET]
Table 'Whirlpool' 9-max Seat #1 is the button
Seat 1: Anafim ($12.50 in chips) 
Seat 2: kamikkaze ($13.65 in chips) 
Seat 3: KeLevro0 ($9.43 in chips) 
Seat 4: chiyuki ($28.48 in chips) 
Seat 5: Wilcox76607 ($25.72 in chips) 
Seat 6: timburonps ($25 in chips) 
Seat 7: ll_LaMeR_ll ($74.56 in chips) 
Seat 8: agurio ($25.46 in chips) 
Seat 9: 123progress ($30.60 in chips) 
kamikkaze: posts small blind $0.10
KeLevro0: posts big blind $0.25
*** HOLE CARDS ***
Dealt to chiyuki [2s 5h]
chiyuki: folds 
Wilcox76607: folds 
timburonps: folds 
ll_LaMeR_ll: folds 
agurio: folds 
123progress: folds 
Anafim: folds 
kamikkaze: folds 
Uncalled bet ($0.15) returned to KeLevro0
KeLevro0 collected $0.20 from pot
KeLevro0: doesn't show hand 
*** SUMMARY ***
Total pot $0.20 | Rake $0 
Seat 1: Anafim (button) folded before Flop (didn't bet)
Seat 2: kamikkaze (small blind) folded before Flop
Seat 3: KeLevro0 (big blind) collected ($0.20)
Seat 4: chiyuki folded before Flop (didn't bet)
Seat 5: Wilcox76607 folded before Flop (didn't bet)
Seat 6: timburonps folded before Flop (didn't bet)
Seat 7: ll_LaMeR_ll folded before Flop (didn't bet)
Seat 8: agurio folded before Flop (didn't bet)
Seat 9: 123progress folded before Flop (didn't bet)



PokerStars Zoom Hand #84299124017:  Hold'em No Limit ($0.10/$0.25) - 2012/08/05 13:58:11 JST [2012/08/05 0:58:11 ET]
Table 'Whirlpool' 9-max Seat #1 is the button
Seat 1: NastyMcNast ($26.10 in chips) 
Seat 2: chiyuki ($28.58 in chips) 
Seat 3: softdesign ($75.53 in chips) 
Seat 4: timburonps ($28.37 in chips) 
Seat 5: fwani ($35.83 in chips) 
Seat 6: kamikkaze ($17.96 in chips) 
Seat 7: Loholov ($19.20 in chips) 
Seat 8: Roglus ($19 in chips) 
Seat 9: silvno31 ($44.59 in chips) 
chiyuki: posts small blind $0.10
softdesign: posts big blind $0.25
*** HOLE CARDS ***
Dealt to chiyuki [5h 7c]
timburonps: folds 
fwani: folds 
kamikkaze: folds 
Loholov: folds 
Roglus: raises $0.50 to $0.75
silvno31: folds 
NastyMcNast: folds 
chiyuki: folds 
softdesign: calls $0.50
*** FLOP *** [5s Tc 4c]
softdesign: checks 
Roglus: bets $0.75
softdesign: folds 
Uncalled bet ($0.75) returned to Roglus
Roglus collected $1.53 from pot
Roglus: doesn't show hand 
*** SUMMARY ***
Total pot $1.60 | Rake $0.07 
Board [5s Tc 4c]
Seat 1: NastyMcNast (button) folded before Flop (didn't bet)
Seat 2: chiyuki (small blind) folded before Flop
Seat 3: softdesign (big blind) folded on the Flop
Seat 4: timburonps folded before Flop (didn't bet)
Seat 5: fwani folded before Flop (didn't bet)
Seat 6: kamikkaze folded before Flop (didn't bet)
Seat 7: Loholov folded before Flop (didn't bet)
Seat 8: Roglus collected ($1.53)
Seat 9: silvno31 folded before Flop (didn't bet)



PokerStars Zoom Hand #84299127065:  Hold'em No Limit ($0.10/$0.25) - 2012/08/05 13:58:26 JST [2012/08/05 0:58:26 ET]
Table 'Whirlpool' 9-max Seat #1 is the button
Seat 1: chiyuki ($28.48 in chips) 
Seat 2: BlackZafiro ($25.09 in chips) 
Seat 3: Loholov ($20.65 in chips) 
Seat 4: ll_LaMeR_ll ($74.56 in chips) 
Seat 5: timburonps ($25 in chips) 
Seat 6: Suhoff76 ($41.73 in chips) 
Seat 7: 2997qwer ($10.65 in chips) 
Seat 8: wtu1986 ($25 in chips) 
Seat 9: kamikkaze ($13.55 in chips) 
BlackZafiro: posts small blind $0.10
Loholov: posts big blind $0.25
*** HOLE CARDS ***
Dealt to chiyuki [7s 9s]
ll_LaMeR_ll: folds 
timburonps: folds 
Suhoff76: folds 
2997qwer: folds 
wtu1986: folds 
kamikkaze: folds 
chiyuki: raises $0.50 to $0.75
BlackZafiro: folds 
Loholov: folds 
Uncalled bet ($0.50) returned to chiyuki
chiyuki collected $0.60 from pot
chiyuki: doesn't show hand 
*** SUMMARY ***
Total pot $0.60 | Rake $0 
Seat 1: chiyuki (button) collected ($0.60)
Seat 2: BlackZafiro (small blind) folded before Flop
Seat 3: Loholov (big blind) folded before Flop
Seat 4: ll_LaMeR_ll folded before Flop (didn't bet)
Seat 5: timburonps folded before Flop (didn't bet)
Seat 6: Suhoff76 folded before Flop (didn't bet)
Seat 7: 2997qwer folded before Flop (didn't bet)
Seat 8: wtu1986 folded before Flop (didn't bet)
Seat 9: kamikkaze folded before Flop (didn't bet)



PokerStars Zoom Hand #84299122764:  Hold'em No Limit ($0.10/$0.25) - 2012/08/05 13:58:05 JST [2012/08/05 0:58:05 ET]
Table 'Whirlpool' 9-max Seat #1 is the button
Seat 1: Vahe50 ($15.58 in chips) 
Seat 2: BlOnDhOlIc ($62.37 in chips) 
Seat 3: Tom1999 ($14.90 in chips) 
Seat 4: Loholov ($20.65 in chips) 
Seat 5: Nerkit ($11.95 in chips) 
Seat 6: BlackZafiro ($46.44 in chips) 
Seat 7: chiyuki ($28.58 in chips) 
Seat 8: hirozo ($26.17 in chips) 
Seat 9: KeLevro0 ($12.15 in chips) 
BlOnDhOlIc: posts small blind $0.10
Tom1999: posts big blind $0.25
*** HOLE CARDS ***
Dealt to chiyuki [4h Jc]
Loholov: folds 
Nerkit: folds 
BlackZafiro: folds 
chiyuki: folds 
hirozo: raises $0.50 to $0.75
KeLevro0: folds 
Vahe50: raises $1.75 to $2.50
BlOnDhOlIc: folds 
Tom1999: folds 
hirozo: raises $3.55 to $6.05
Vahe50: folds 
Uncalled bet ($3.55) returned to hirozo
hirozo collected $5.35 from pot
hirozo: doesn't show hand 
*** SUMMARY ***
Total pot $5.35 | Rake $0 
Seat 1: Vahe50 (button) folded before Flop
Seat 2: BlOnDhOlIc (small blind) folded before Flop
Seat 3: Tom1999 (big blind) folded before Flop
Seat 4: Loholov folded before Flop (didn't bet)
Seat 5: Nerkit folded before Flop (didn't bet)
Seat 6: BlackZafiro folded before Flop (didn't bet)
Seat 7: chiyuki folded before Flop (didn't bet)
Seat 8: hirozo collected ($5.35)
Seat 9: KeLevro0 folded before Flop (didn't bet)



PokerStars Zoom Hand #84299124804:  Hold'em No Limit ($0.10/$0.25) - 2012/08/05 13:58:15 JST [2012/08/05 0:58:15 ET]
Table 'Whirlpool' 9-max Seat #1 is the button
Seat 1: peng2astic ($13.54 in chips) 
Seat 2: Vahe50 ($15.10 in chips) 
Seat 3: kamikkaze ($17.96 in chips) 
Seat 4: chiyuki ($28.48 in chips) 
Seat 5: Tom1999 ($15.35 in chips) 
Seat 6: seula i ($41.70 in chips) 
Seat 7: Curtis1436 ($24.99 in chips) 
Seat 8: Th3Fog ($21.29 in chips) 
Seat 9: KeLevro0 ($13.53 in chips) 
Vahe50: posts small blind $0.10
kamikkaze: posts big blind $0.25
*** HOLE CARDS ***
Dealt to chiyuki [Qs Jh]
chiyuki: folds 
Tom1999: folds 
seula i: raises $0.75 to $1
Curtis1436: folds 
Th3Fog: folds 
KeLevro0: folds 
peng2astic: calls $1
Vahe50: folds 
kamikkaze: folds 
*** FLOP *** [Qd Th 4c]
seula i: bets $1.25
peng2astic: calls $1.25
*** TURN *** [Qd Th 4c] [7c]
seula i: checks 
peng2astic: bets $4.25
seula i: folds 
Uncalled bet ($4.25) returned to peng2astic
peng2astic collected $4.63 from pot
peng2astic: doesn't show hand 
*** SUMMARY ***
Total pot $4.85 | Rake $0.22 
Board [Qd Th 4c 7c]
Seat 1: peng2astic (button) collected ($4.63)
Seat 2: Vahe50 (small blind) folded before Flop
Seat 3: kamikkaze (big blind) folded before Flop
Seat 4: chiyuki folded before Flop (didn't bet)
Seat 5: Tom1999 folded before Flop (didn't bet)
Seat 6: seula i folded on the Turn
Seat 7: Curtis1436 folded before Flop (didn't bet)
Seat 8: Th3Fog folded before Flop (didn't bet)
Seat 9: KeLevro0 folded before Flop (didn't bet)



PokerStars Zoom Hand #84299131446:  Hold'em No Limit ($0.10/$0.25) - 2012/08/05 13:58:48 JST [2012/08/05 0:58:48 ET]
Table 'Whirlpool' 9-max Seat #1 is the button
Seat 1: Loholov ($20.40 in chips) 
Seat 2: BlackZafiro ($46.54 in chips) 
Seat 3: chiyuki ($28.83 in chips) 
Seat 4: flyinprits ($23.92 in chips) 
Seat 5: Roglus ($73.30 in chips) 
Seat 6: ygoegoe ($28.89 in chips) 
Seat 7: Suhoff76 ($41.48 in chips) 
Seat 8: Déculotter69 ($20.02 in chips) 
Seat 9: Rudolf ($54.37 in chips) 
BlackZafiro: posts small blind $0.10
chiyuki: posts big blind $0.25
*** HOLE CARDS ***
Dealt to chiyuki [7h 4d]
flyinprits: raises $0.50 to $0.75
Roglus: folds 
ygoegoe: folds 
Suhoff76: folds 
Déculotter69: folds 
Rudolf: folds 
Loholov: folds 
BlackZafiro: folds 
chiyuki: folds 
Uncalled bet ($0.50) returned to flyinprits
flyinprits collected $0.60 from pot
flyinprits: doesn't show hand 
*** SUMMARY ***
Total pot $0.60 | Rake $0 
Seat 1: Loholov (button) folded before Flop (didn't bet)
Seat 2: BlackZafiro (small blind) folded before Flop
Seat 3: chiyuki (big blind) folded before Flop
Seat 4: flyinprits collected ($0.60)
Seat 5: Roglus folded before Flop (didn't bet)
Seat 6: ygoegoe folded before Flop (didn't bet)
Seat 7: Suhoff76 folded before Flop (didn't bet)
Seat 8: Déculotter69 folded before Flop (didn't bet)
Seat 9: Rudolf folded before Flop (didn't bet)



PokerStars Zoom Hand #84299135278:  Hold'em No Limit ($0.10/$0.25) - 2012/08/05 13:59:07 JST [2012/08/05 0:59:07 ET]
Table 'Whirlpool' 9-max Seat #1 is the button
Seat 1: Suhoff76 ($40.30 in chips) 
Seat 2: Lasutchik ($7.73 in chips) 
Seat 3: fwani ($30.99 in chips) 
Seat 4: ygoegoe ($28.89 in chips) 
Seat 5: NastyMcNast ($26.14 in chips) 
Seat 6: chiyuki ($28.58 in chips) 
Seat 7: PetitAlejo ($27.47 in chips) 
Seat 8: BlOnDhOlIc ($26.06 in chips) 
Seat 9: Vahe50 ($15 in chips) 
Lasutchik: posts small blind $0.10
fwani: posts big blind $0.25
*** HOLE CARDS ***
Dealt to chiyuki [5h Ac]
ygoegoe: folds 
NastyMcNast: folds 
chiyuki: folds 
PetitAlejo: folds 
BlOnDhOlIc: folds 
Vahe50: folds 
Suhoff76: folds 
Lasutchik: folds 
Uncalled bet ($0.15) returned to fwani
fwani collected $0.20 from pot
fwani: doesn't show hand 
*** SUMMARY ***
Total pot $0.20 | Rake $0 
Seat 1: Suhoff76 (button) folded before Flop (didn't bet)
Seat 2: Lasutchik (small blind) folded before Flop
Seat 3: fwani (big blind) collected ($0.20)
Seat 4: ygoegoe folded before Flop (didn't bet)
Seat 5: NastyMcNast folded before Flop (didn't bet)
Seat 6: chiyuki folded before Flop (didn't bet)
Seat 7: PetitAlejo folded before Flop (didn't bet)
Seat 8: BlOnDhOlIc folded before Flop (didn't bet)
Seat 9: Vahe50 folded before Flop (didn't bet)



PokerStars Zoom Hand #84299138130:  Hold'em No Limit ($0.10/$0.25) - 2012/08/05 13:59:21 JST [2012/08/05 0:59:21 ET]
Table 'Whirlpool' 9-max Seat #1 is the button
Seat 1: deadmoneykid ($20.60 in chips) 
Seat 2: ygoegoe ($28.89 in chips) 
Seat 3: Alvinpe85 ($61.02 in chips) 
Seat 4: silvno31 ($44.69 in chips) 
Seat 5: Dejacob ($47.78 in chips) 
Seat 6: seula i ($39.45 in chips) 
Seat 7: chiyuki ($28.48 in chips) 
Seat 8: zaffaroots ($18.34 in chips) 
Seat 9: BlOnDhOlIc ($62.02 in chips) 
ygoegoe: posts small blind $0.10
Alvinpe85: posts big blind $0.25
*** HOLE CARDS ***
Dealt to chiyuki [As 3c]
silvno31: folds 
Dejacob: folds 
seula i: folds 
chiyuki: folds 
zaffaroots: raises $0.50 to $0.75
BlOnDhOlIc: folds 
deadmoneykid: folds 
ygoegoe: folds 
Alvinpe85: folds 
Uncalled bet ($0.50) returned to zaffaroots
zaffaroots collected $0.60 from pot
zaffaroots: doesn't show hand 
*** SUMMARY ***
Total pot $0.60 | Rake $0 
Seat 1: deadmoneykid (button) folded before Flop (didn't bet)
Seat 2: ygoegoe (small blind) folded before Flop
Seat 3: Alvinpe85 (big blind) folded before Flop
Seat 4: silvno31 folded before Flop (didn't bet)
Seat 5: Dejacob folded before Flop (didn't bet)
Seat 6: seula i folded before Flop (didn't bet)
Seat 7: chiyuki folded before Flop (didn't bet)
Seat 8: zaffaroots collected ($0.60)
Seat 9: BlOnDhOlIc folded before Flop (didn't bet)



PokerStars Zoom Hand #84299137301:  Hold'em No Limit ($0.10/$0.25) - 2012/08/05 13:59:17 JST [2012/08/05 0:59:17 ET]
Table 'Whirlpool' 9-max Seat #1 is the button
Seat 1: kamikkaze ($13.20 in chips) 
Seat 2: Suhoff76 ($40.30 in chips) 
Seat 3: Roglus ($19.68 in chips) 
Seat 4: Alvinpe85 ($61.02 in chips) 
Seat 5: Loholov ($15 in chips) 
Seat 6: Dejacob ($47.78 in chips) 
Seat 7: peng2astic ($15.92 in chips) 
Seat 8: chiyuki ($28.48 in chips) 
Seat 9: RikkStroken ($16.40 in chips) 
Suhoff76: posts small blind $0.10
Roglus: posts big blind $0.25
*** HOLE CARDS ***
Dealt to chiyuki [7s 9h]
Alvinpe85: folds 
Loholov: folds 
Dejacob: folds 
peng2astic: folds 
chiyuki: folds 
RikkStroken: folds 
kamikkaze: folds 
Suhoff76: raises $0.35 to $0.60
Roglus: calls $0.35
*** FLOP *** [4s 8c 8h]
Suhoff76: checks 
Roglus: checks 
*** TURN *** [4s 8c 8h] [8d]
Suhoff76: bets $0.75
Roglus: folds 
Uncalled bet ($0.75) returned to Suhoff76
Suhoff76 collected $1.15 from pot
Suhoff76: doesn't show hand 
*** SUMMARY ***
Total pot $1.20 | Rake $0.05 
Board [4s 8c 8h 8d]
Seat 1: kamikkaze (button) folded before Flop (didn't bet)
Seat 2: Suhoff76 (small blind) collected ($1.15)
Seat 3: Roglus (big blind) folded on the Turn
Seat 4: Alvinpe85 folded before Flop (didn't bet)
Seat 5: Loholov folded before Flop (didn't bet)
Seat 6: Dejacob folded before Flop (didn't bet)
Seat 7: peng2astic folded before Flop (didn't bet)
Seat 8: chiyuki folded before Flop (didn't bet)
Seat 9: RikkStroken folded before Flop (didn't bet)



PokerStars Zoom Hand #84299133460:  Hold'em No Limit ($0.10/$0.25) - 2012/08/05 13:58:57 JST [2012/08/05 0:58:57 ET]
Table 'Whirlpool' 9-max Seat #1 is the button
Seat 1: Dafleche ($14.94 in chips) 
Seat 2: Paranoix1990 ($17.06 in chips) 
Seat 3: Dejacob ($42.31 in chips) 
Seat 4: KeLevro0 ($12.15 in chips) 
Seat 5: giorgos_k ($20.76 in chips) 
Seat 6: solawind ($13.47 in chips) 
Seat 7: Landybob ($35 in chips) 
Seat 8: carlosrbr ($11.61 in chips) 
Seat 9: chiyuki ($28.58 in chips) 
Paranoix1990: posts small blind $0.10
Dejacob: posts big blind $0.25
*** HOLE CARDS ***
Dealt to chiyuki [6s Jd]
KeLevro0: raises $0.42 to $0.67
giorgos_k: folds 
solawind: folds 
Landybob: calls $0.67
carlosrbr: folds 
chiyuki: folds 
Dafleche: folds 
Paranoix1990: calls $0.57
Dejacob: calls $0.42
*** FLOP *** [2d 9d Kh]
Paranoix1990: checks 
Dejacob: checks 
KeLevro0: checks 
Landybob: bets $1.53
Paranoix1990: folds 
Dejacob: folds 
KeLevro0: folds 
Uncalled bet ($1.53) returned to Landybob
Landybob collected $2.56 from pot
Landybob: doesn't show hand 
*** SUMMARY ***
Total pot $2.68 | Rake $0.12 
Board [2d 9d Kh]
Seat 1: Dafleche (button) folded before Flop (didn't bet)
Seat 2: Paranoix1990 (small blind) folded on the Flop
Seat 3: Dejacob (big blind) folded on the Flop
Seat 4: KeLevro0 folded on the Flop
Seat 5: giorgos_k folded before Flop (didn't bet)
Seat 6: solawind folded before Flop (didn't bet)
Seat 7: Landybob collected ($2.56)
Seat 8: carlosrbr folded before Flop (didn't bet)
Seat 9: chiyuki folded before Flop (didn't bet)



PokerStars Zoom Hand #84299139999:  Hold'em No Limit ($0.10/$0.25) - 2012/08/05 13:59:30 JST [2012/08/05 0:59:30 ET]
Table 'Whirlpool' 9-max Seat #1 is the button
Seat 1: chiyuki ($28.48 in chips) 
Seat 2: KeLevro0 ($13.60 in chips) 
Seat 3: Suhoff76 ($25 in chips) 
Seat 4: NastyMcNast ($54.10 in chips) 
Seat 5: RomarioJa ($13.06 in chips) 
Seat 6: Vahe50 ($15 in chips) 
Seat 7: PetitAlejo ($27.37 in chips) 
Seat 8: carlosrbr ($11.51 in chips) 
Seat 9: Tom1999 ($10.25 in chips) 
KeLevro0: posts small blind $0.10
Suhoff76: posts big blind $0.25
*** HOLE CARDS ***
Dealt to chiyuki [9s 4s]
NastyMcNast: folds 
RomarioJa: folds 
Vahe50: folds 
PetitAlejo: folds 
carlosrbr: folds 
Tom1999: folds 
chiyuki: folds 
KeLevro0: folds 
Uncalled bet ($0.15) returned to Suhoff76
Suhoff76 collected $0.20 from pot
Suhoff76: doesn't show hand 
*** SUMMARY ***
Total pot $0.20 | Rake $0 
Seat 1: chiyuki (button) folded before Flop (didn't bet)
Seat 2: KeLevro0 (small blind) folded before Flop
Seat 3: Suhoff76 (big blind) collected ($0.20)
Seat 4: NastyMcNast folded before Flop (didn't bet)
Seat 5: RomarioJa folded before Flop (didn't bet)
Seat 6: Vahe50 folded before Flop (didn't bet)
Seat 7: PetitAlejo folded before Flop (didn't bet)
Seat 8: carlosrbr folded before Flop (didn't bet)
Seat 9: Tom1999 folded before Flop (didn't bet)



PokerStars Zoom Hand #84299136052:  Hold'em No Limit ($0.10/$0.25) - 2012/08/05 13:59:11 JST [2012/08/05 0:59:11 ET]
Table 'Whirlpool' 9-max Seat #1 is the button
Seat 1: seula i ($25 in chips) 
Seat 2: chiyuki ($28.58 in chips) 
Seat 3: ladymadon107 ($9.76 in chips) 
Seat 4: Anafim ($15.20 in chips) 
Seat 5: 2997qwer ($11.45 in chips) 
Seat 6: BlackZafiro ($25 in chips) 
Seat 7: wtu1986 ($24.90 in chips) 
Seat 8: Suhoff76 ($40.30 in chips) 
Seat 9: Dejacob ($47.78 in chips) 
chiyuki: posts small blind $0.10
ladymadon107: posts big blind $0.25
*** HOLE CARDS ***
Dealt to chiyuki [2s Jc]
Anafim: folds 
2997qwer: raises $0.50 to $0.75
BlackZafiro: folds 
wtu1986: folds 
Suhoff76: folds 
Dejacob: folds 
seula i: folds 
chiyuki: folds 
ladymadon107: calls $0.50
*** FLOP *** [6c 3s 3d]
ladymadon107: bets $0.50
2997qwer: raises $1 to $1.50
ladymadon107: calls $1
*** TURN *** [6c 3s 3d] [9s]
ladymadon107: checks 
2997qwer: bets $3
ladymadon107: folds 
Uncalled bet ($3) returned to 2997qwer
2997qwer collected $4.39 from pot
2997qwer: doesn't show hand 
*** SUMMARY ***
Total pot $4.60 | Rake $0.21 
Board [6c 3s 3d 9s]
Seat 1: seula i (button) folded before Flop (didn't bet)
Seat 2: chiyuki (small blind) folded before Flop
Seat 3: ladymadon107 (big blind) folded on the Turn
Seat 4: Anafim folded before Flop (didn't bet)
Seat 5: 2997qwer collected ($4.39)
Seat 6: BlackZafiro folded before Flop (didn't bet)
Seat 7: wtu1986 folded before Flop (didn't bet)
Seat 8: Suhoff76 folded before Flop (didn't bet)
Seat 9: Dejacob folded before Flop (didn't bet)



PokerStars Zoom Hand #84299144359:  Hold'em No Limit ($0.10/$0.25) - 2012/08/05 13:59:48 JST [2012/08/05 0:59:48 ET]
Table 'Whirlpool' 9-max Seat #1 is the button
Seat 1: Dejacob ($41.54 in chips) 
Seat 2: 2997qwer ($10.40 in chips) 
Seat 3: Landybob ($36.79 in chips) 
Seat 4: ChrisCDee ($25.54 in chips) 
Seat 5: chiyuki ($28.48 in chips) 
Seat 6: BlOnDhOlIc ($25.81 in chips) 
Seat 7: munky3 ($33.52 in chips) 
Seat 8: puffy5533 ($21.60 in chips) 
Seat 9: RikkStroken ($15 in chips) 
2997qwer: posts small blind $0.10
Landybob: posts big blind $0.25
*** HOLE CARDS ***
Dealt to chiyuki [Qc Tc]
ChrisCDee: folds 
chiyuki: folds 
BlOnDhOlIc: folds 
munky3: folds 
puffy5533: folds 
RikkStroken: folds 
Dejacob: raises $0.50 to $0.75
2997qwer: folds 
Landybob: folds 
Uncalled bet ($0.50) returned to Dejacob
Dejacob collected $0.60 from pot
Dejacob: doesn't show hand 
*** SUMMARY ***
Total pot $0.60 | Rake $0 
Seat 1: Dejacob (button) collected ($0.60)
Seat 2: 2997qwer (small blind) folded before Flop
Seat 3: Landybob (big blind) folded before Flop
Seat 4: ChrisCDee folded before Flop (didn't bet)
Seat 5: chiyuki folded before Flop (didn't bet)
Seat 6: BlOnDhOlIc folded before Flop (didn't bet)
Seat 7: munky3 folded before Flop (didn't bet)
Seat 8: puffy5533 folded before Flop (didn't bet)
Seat 9: RikkStroken folded before Flop (didn't bet)



PokerStars Zoom Hand #84299142573:  Hold'em No Limit ($0.10/$0.25) - 2012/08/05 13:59:43 JST [2012/08/05 0:59:43 ET]
Table 'Whirlpool' 9-max Seat #1 is the button
Seat 1: BlOnDhOlIc ($25.81 in chips) 
Seat 2: roksmokndonk ($36.18 in chips) 
Seat 3: Rudolf ($52.12 in chips) 
Seat 4: BlackZafiro ($25.10 in chips) 
Seat 5: PetitAlejo ($27.37 in chips) 
Seat 6: chiyuki ($28.48 in chips) 
Seat 7: softdesign ($75.03 in chips) 
Seat 8: munky3 ($33.52 in chips) 
Seat 9: Paranoix1990 ($16.39 in chips) 
roksmokndonk: posts small blind $0.10
Rudolf: posts big blind $0.25
*** HOLE CARDS ***
Dealt to chiyuki [Kh 3h]
BlackZafiro: folds 
PetitAlejo: folds 
chiyuki: folds 
softdesign: calls $0.25
munky3: folds 
Paranoix1990: folds 
BlOnDhOlIc: folds 
roksmokndonk: folds 
Rudolf: checks 
*** FLOP *** [9c 5h Qd]
Rudolf: checks 
softdesign: bets $0.75
Rudolf: calls $0.75
*** TURN *** [9c 5h Qd] [9d]
Rudolf: checks 
softdesign: bets $3
Rudolf: folds 
Uncalled bet ($3) returned to softdesign
softdesign collected $2.01 from pot
softdesign: doesn't show hand 
*** SUMMARY ***
Total pot $2.10 | Rake $0.09 
Board [9c 5h Qd 9d]
Seat 1: BlOnDhOlIc (button) folded before Flop (didn't bet)
Seat 2: roksmokndonk (small blind) folded before Flop
Seat 3: Rudolf (big blind) folded on the Turn
Seat 4: BlackZafiro folded before Flop (didn't bet)
Seat 5: PetitAlejo folded before Flop (didn't bet)
Seat 6: chiyuki folded before Flop (didn't bet)
Seat 7: softdesign collected ($2.01)
Seat 8: munky3 folded before Flop (didn't bet)
Seat 9: Paranoix1990 folded before Flop (didn't bet)



PokerStars Zoom Hand #84299146949:  Hold'em No Limit ($0.10/$0.25) - 2012/08/05 14:00:00 JST [2012/08/05 1:00:00 ET]
Table 'Whirlpool' 9-max Seat #1 is the button
Seat 1: deadmoneykid ($28.14 in chips) 
Seat 2: kamikkaze ($19.55 in chips) 
Seat 3: chiyuki ($28.48 in chips) 
Seat 4: timburonps ($25 in chips) 
Seat 5: Th3Fog ($66.36 in chips) 
Seat 6: BlackZafiro ($25 in chips) 
Seat 7: Paranoix1990 ($16.39 in chips) 
Seat 8: 2997qwer ($10.30 in chips) 
Seat 9: hirozo ($26.20 in chips) 
kamikkaze: posts small blind $0.10
chiyuki: posts big blind $0.25
*** HOLE CARDS ***
Dealt to chiyuki [Js 9d]
timburonps: folds 
Th3Fog: folds 
BlackZafiro: folds 
Paranoix1990: folds 
2997qwer: folds 
hirozo: folds 
deadmoneykid: folds 
kamikkaze: folds 
Uncalled bet ($0.15) returned to chiyuki
chiyuki collected $0.20 from pot
chiyuki: doesn't show hand 
*** SUMMARY ***
Total pot $0.20 | Rake $0 
Seat 1: deadmoneykid (button) folded before Flop (didn't bet)
Seat 2: kamikkaze (small blind) folded before Flop
Seat 3: chiyuki (big blind) collected ($0.20)
Seat 4: timburonps folded before Flop (didn't bet)
Seat 5: Th3Fog folded before Flop (didn't bet)
Seat 6: BlackZafiro folded before Flop (didn't bet)
Seat 7: Paranoix1990 folded before Flop (didn't bet)
Seat 8: 2997qwer folded before Flop (didn't bet)
Seat 9: hirozo folded before Flop (didn't bet)



PokerStars Zoom Hand #84299152452:  Hold'em No Limit ($0.10/$0.25) - 2012/08/05 14:00:26 JST [2012/08/05 1:00:26 ET]
Table 'Whirlpool' 9-max Seat #1 is the button
Seat 1: flyinprits ($46.70 in chips) 
Seat 2: chiyuki ($28.58 in chips) 
Seat 3: wildy29 ($30.66 in chips) 
Seat 4: BlOnDhOlIc ($25.71 in chips) 
Seat 5: Alvinpe85 ($60.67 in chips) 
Seat 6: giorgos_k ($41.75 in chips) 
Seat 7: DanielWhyte ($22.78 in chips) 
Seat 8: seula i ($65.02 in chips) 
Seat 9: Tom1999 ($10.25 in chips) 
chiyuki: posts small blind $0.10
wildy29: posts big blind $0.25
*** HOLE CARDS ***
Dealt to chiyuki [Ac 6c]
BlOnDhOlIc: folds 
Alvinpe85: folds 
giorgos_k: folds 
DanielWhyte: folds 
seula i: folds 
Tom1999: folds 
flyinprits: folds 
chiyuki: raises $0.50 to $0.75
wildy29: calls $0.50
*** FLOP *** [9h Qs 9c]
chiyuki: checks 
wildy29: bets $0.25
chiyuki: calls $0.25
*** TURN *** [9h Qs 9c] [Ah]
chiyuki: checks 
wildy29: bets $0.50
chiyuki: raises $1 to $1.50
wildy29: folds 
Uncalled bet ($1) returned to chiyuki
chiyuki collected $2.86 from pot
chiyuki: doesn't show hand 
*** SUMMARY ***
Total pot $3 | Rake $0.14 
Board [9h Qs 9c Ah]
Seat 1: flyinprits (button) folded before Flop (didn't bet)
Seat 2: chiyuki (small blind) collected ($2.86)
Seat 3: wildy29 (big blind) folded on the Turn
Seat 4: BlOnDhOlIc folded before Flop (didn't bet)
Seat 5: Alvinpe85 folded before Flop (didn't bet)
Seat 6: giorgos_k folded before Flop (didn't bet)
Seat 7: DanielWhyte folded before Flop (didn't bet)
Seat 8: seula i folded before Flop (didn't bet)
Seat 9: Tom1999 folded before Flop (didn't bet)



PokerStars Zoom Hand #84299151152:  Hold'em No Limit ($0.10/$0.25) - 2012/08/05 14:00:20 JST [2012/08/05 1:00:20 ET]
Table 'Whirlpool' 9-max Seat #1 is the button
Seat 1: Anafim ($14.45 in chips) 
Seat 2: Th3Fog ($20.54 in chips) 
Seat 3: 2997qwer ($12.50 in chips) 
Seat 4: ygoegoe ($28.29 in chips) 
Seat 5: puffy5533 ($21.60 in chips) 
Seat 6: Dafleche ($15.62 in chips) 
Seat 7: ChrisCDee ($31.73 in chips) 
Seat 8: BlackZafiro ($25 in chips) 
Seat 9: chiyuki ($28.58 in chips) 
Th3Fog: posts small blind $0.10
2997qwer: posts big blind $0.25
*** HOLE CARDS ***
Dealt to chiyuki [3h 5s]
ygoegoe: folds 
puffy5533: folds 
Dafleche: raises $0.25 to $0.50
ChrisCDee: folds 
BlackZafiro: folds 
chiyuki: folds 
Anafim: folds 
Th3Fog: calls $0.40
2997qwer: folds 
*** FLOP *** [8h Ac Tc]
Th3Fog: checks 
Dafleche: bets $0.25
Th3Fog: calls $0.25
*** TURN *** [8h Ac Tc] [Kd]
Th3Fog: checks 
Dafleche: bets $0.50
Th3Fog: calls $0.50
*** RIVER *** [8h Ac Tc Kd] [Ah]
Th3Fog: bets $1.15
Dafleche: raises $2.60 to $3.75
Th3Fog: folds 
Uncalled bet ($2.60) returned to Dafleche
Dafleche collected $4.82 from pot
Dafleche: doesn't show hand 
*** SUMMARY ***
Total pot $5.05 | Rake $0.23 
Board [8h Ac Tc Kd Ah]
Seat 1: Anafim (button) folded before Flop (didn't bet)
Seat 2: Th3Fog (small blind) folded on the River
Seat 3: 2997qwer (big blind) folded before Flop
Seat 4: ygoegoe folded before Flop (didn't bet)
Seat 5: puffy5533 folded before Flop (didn't bet)
Seat 6: Dafleche collected ($4.82)
Seat 7: ChrisCDee folded before Flop (didn't bet)
Seat 8: BlackZafiro folded before Flop (didn't bet)
Seat 9: chiyuki folded before Flop (didn't bet)



PokerStars Zoom Hand #84299169721:  Hold'em No Limit ($0.10/$0.25) - 2012/08/05 14:01:39 JST [2012/08/05 1:01:39 ET]
Table 'Whirlpool' 9-max Seat #1 is the button
Seat 1: Dejacob ($41.64 in chips) 
Seat 2: ll_LaMeR_ll ($69.48 in chips) 
Seat 3: Perstenev ($12.55 in chips) 
Seat 4: Noviekid ($29.54 in chips) 
Seat 5: fezman ($14.43 in chips) 
Seat 6: hirozo ($29.27 in chips) 
Seat 7: KeLevro0 ($13.01 in chips) 
Seat 8: chiyuki ($29.94 in chips) 
Seat 9: BlackZafiro ($45.34 in chips) 
ll_LaMeR_ll: posts small blind $0.10
Perstenev: posts big blind $0.25
*** HOLE CARDS ***
Dealt to chiyuki [3c As]
Noviekid: folds 
fezman: raises $0.50 to $0.75
hirozo: folds 
KeLevro0: folds 
chiyuki: folds 
BlackZafiro: folds 
Dejacob: folds 
ll_LaMeR_ll: folds 
Perstenev: folds 
Uncalled bet ($0.50) returned to fezman
fezman collected $0.60 from pot
fezman: doesn't show hand 
*** SUMMARY ***
Total pot $0.60 | Rake $0 
Seat 1: Dejacob (button) folded before Flop (didn't bet)
Seat 2: ll_LaMeR_ll (small blind) folded before Flop
Seat 3: Perstenev (big blind) folded before Flop
Seat 4: Noviekid folded before Flop (didn't bet)
Seat 5: fezman collected ($0.60)
Seat 6: hirozo folded before Flop (didn't bet)
Seat 7: KeLevro0 folded before Flop (didn't bet)
Seat 8: chiyuki folded before Flop (didn't bet)
Seat 9: BlackZafiro folded before Flop (didn't bet)



PokerStars Zoom Hand #84299168220:  Hold'em No Limit ($0.10/$0.25) - 2012/08/05 14:01:33 JST [2012/08/05 1:01:33 ET]
Table 'Whirlpool' 9-max Seat #1 is the button
Seat 1: Anafim ($14.10 in chips) 
Seat 2: flyinprits ($47.05 in chips) 
Seat 3: Scruf13 ($12.50 in chips) 
Seat 4: Tom1999 ($9.50 in chips) 
Seat 5: PetitAlejo ($28.02 in chips) 
Seat 6: Suhoff76 ($40.39 in chips) 
Seat 7: chiyuki ($29.94 in chips) 
Seat 8: Perstenev ($12.65 in chips) 
Seat 9: Leftymouse ($25 in chips) 
flyinprits: posts small blind $0.10
Scruf13: posts big blind $0.25
*** HOLE CARDS ***
Dealt to chiyuki [Qs 3c]
Tom1999: raises $0.50 to $0.75
PetitAlejo: folds 
Suhoff76: folds 
chiyuki: folds 
Perstenev: folds 
Leftymouse: folds 
Anafim: folds 
flyinprits: calls $0.65
Scruf13: folds 
*** FLOP *** [8d 9c Jd]
flyinprits: checks 
Tom1999: bets $1.25
flyinprits: folds 
Uncalled bet ($1.25) returned to Tom1999
Tom1999 collected $1.67 from pot
Tom1999: doesn't show hand 
*** SUMMARY ***
Total pot $1.75 | Rake $0.08 
Board [8d 9c Jd]
Seat 1: Anafim (button) folded before Flop (didn't bet)
Seat 2: flyinprits (small blind) folded on the Flop
Seat 3: Scruf13 (big blind) folded before Flop
Seat 4: Tom1999 collected ($1.67)
Seat 5: PetitAlejo folded before Flop (didn't bet)
Seat 6: Suhoff76 folded before Flop (didn't bet)
Seat 7: chiyuki folded before Flop (didn't bet)
Seat 8: Perstenev folded before Flop (didn't bet)
Seat 9: Leftymouse folded before Flop (didn't bet)



PokerStars Zoom Hand #84299173383:  Hold'em No Limit ($0.10/$0.25) - 2012/08/05 14:01:53 JST [2012/08/05 1:01:53 ET]
Table 'Whirlpool' 9-max Seat #1 is the button
Seat 1: Leftymouse ($24.75 in chips) 
Seat 2: RikkStroken ($24.25 in chips) 
Seat 3: 123progress ($39.63 in chips) 
Seat 4: fezman ($14.78 in chips) 
Seat 5: BlOnDhOlIc ($63.57 in chips) 
Seat 6: chiyuki ($29.94 in chips) 
Seat 7: hirozo ($30.57 in chips) 
Seat 8: BlackZafiro ($26.01 in chips) 
Seat 9: RomarioJa ($6.15 in chips) 
RikkStroken: posts small blind $0.10
123progress: posts big blind $0.25
*** HOLE CARDS ***
Dealt to chiyuki [Th Ac]
fezman: folds 
BlOnDhOlIc: folds 
chiyuki: folds 
hirozo: raises $0.50 to $0.75
BlackZafiro: folds 
RomarioJa: folds 
Leftymouse: folds 
RikkStroken: folds 
123progress: folds 
Uncalled bet ($0.50) returned to hirozo
hirozo collected $0.60 from pot
hirozo: doesn't show hand 
*** SUMMARY ***
Total pot $0.60 | Rake $0 
Seat 1: Leftymouse (button) folded before Flop (didn't bet)
Seat 2: RikkStroken (small blind) folded before Flop
Seat 3: 123progress (big blind) folded before Flop
Seat 4: fezman folded before Flop (didn't bet)
Seat 5: BlOnDhOlIc folded before Flop (didn't bet)
Seat 6: chiyuki folded before Flop (didn't bet)
Seat 7: hirozo collected ($0.60)
Seat 8: BlackZafiro folded before Flop (didn't bet)
Seat 9: RomarioJa folded before Flop (didn't bet)



PokerStars Zoom Hand #84299171366:  Hold'em No Limit ($0.10/$0.25) - 2012/08/05 14:01:45 JST [2012/08/05 1:01:45 ET]
Table 'Whirlpool' 9-max Seat #1 is the button
Seat 1: chiyuki ($29.94 in chips) 
Seat 2: slapshot2011 ($17.19 in chips) 
Seat 3: cR!Ma*aRm ($11.44 in chips) 
Seat 4: 123progress ($28.23 in chips) 
Seat 5: 2997qwer ($13.25 in chips) 
Seat 6: cr0lox ($18.71 in chips) 
Seat 7: wtu1986 ($25 in chips) 
Seat 8: ll_LaMeR_ll ($69.38 in chips) 
Seat 9: Wilcox76607 ($22.64 in chips) 
slapshot2011: posts small blind $0.10
cR!Ma*aRm: posts big blind $0.25
*** HOLE CARDS ***
Dealt to chiyuki [8d 2h]
123progress: folds 
2997qwer: folds 
cr0lox: calls $0.25
wtu1986: folds 
ll_LaMeR_ll: folds 
Wilcox76607: calls $0.25
chiyuki: folds 
slapshot2011: folds 
cR!Ma*aRm: checks 
*** FLOP *** [5h Js 9c]
cR!Ma*aRm: bets $0.50
cr0lox: folds 
Wilcox76607: calls $0.50
*** TURN *** [5h Js 9c] [Kh]
cR!Ma*aRm: bets $0.50
Wilcox76607: calls $0.50
*** RIVER *** [5h Js 9c Kh] [Ac]
cR!Ma*aRm: bets $0.75
Wilcox76607: folds 
Uncalled bet ($0.75) returned to cR!Ma*aRm
cR!Ma*aRm collected $2.72 from pot
cR!Ma*aRm: doesn't show hand 
*** SUMMARY ***
Total pot $2.85 | Rake $0.13 
Board [5h Js 9c Kh Ac]
Seat 1: chiyuki (button) folded before Flop (didn't bet)
Seat 2: slapshot2011 (small blind) folded before Flop
Seat 3: cR!Ma*aRm (big blind) collected ($2.72)
Seat 4: 123progress folded before Flop (didn't bet)
Seat 5: 2997qwer folded before Flop (didn't bet)
Seat 6: cr0lox folded on the Flop
Seat 7: wtu1986 folded before Flop (didn't bet)
Seat 8: ll_LaMeR_ll folded before Flop (didn't bet)
Seat 9: Wilcox76607 folded on the River



PokerStars Zoom Hand #84299174612:  Hold'em No Limit ($0.10/$0.25) - 2012/08/05 14:01:58 JST [2012/08/05 1:01:58 ET]
Table 'Whirlpool' 9-max Seat #1 is the button
Seat 1: agurio ($25 in chips) 
Seat 2: kkbruins0408 ($14.43 in chips) 
Seat 3: BlackZafiro ($26.01 in chips) 
Seat 4: fezman ($14.78 in chips) 
Seat 5: chiyuki ($29.94 in chips) 
Seat 6: Ellen1947 ($31.90 in chips) 
Seat 7: Rudolf ($46.77 in chips) 
Seat 8: Déculotter69 ($15.47 in chips) 
Seat 9: KeLevro0 ($12.48 in chips) 
kkbruins0408: posts small blind $0.10
BlackZafiro: posts big blind $0.25
*** HOLE CARDS ***
Dealt to chiyuki [6c Ad]
fezman: folds 
chiyuki: folds 
Ellen1947: raises $0.35 to $0.60
Rudolf: folds 
Déculotter69: folds 
KeLevro0: folds 
agurio: raises $1.40 to $2
kkbruins0408: folds 
BlackZafiro: folds 
Ellen1947: calls $1.40
*** FLOP *** [Jd Th Ts]
Ellen1947: checks 
agurio: bets $2.50
Ellen1947: folds 
Uncalled bet ($2.50) returned to agurio
agurio collected $4.15 from pot
agurio: doesn't show hand 
*** SUMMARY ***
Total pot $4.35 | Rake $0.20 
Board [Jd Th Ts]
Seat 1: agurio (button) collected ($4.15)
Seat 2: kkbruins0408 (small blind) folded before Flop
Seat 3: BlackZafiro (big blind) folded before Flop
Seat 4: fezman folded before Flop (didn't bet)
Seat 5: chiyuki folded before Flop (didn't bet)
Seat 6: Ellen1947 folded on the Flop
Seat 7: Rudolf folded before Flop (didn't bet)
Seat 8: Déculotter69 folded before Flop (didn't bet)
Seat 9: KeLevro0 folded before Flop (didn't bet)



PokerStars Zoom Hand #84299176598:  Hold'em No Limit ($0.10/$0.25) - 2012/08/05 14:02:05 JST [2012/08/05 1:02:05 ET]
Table 'Whirlpool' 9-max Seat #1 is the button
Seat 1: Scruf13 ($12.15 in chips) 
Seat 2: RomarioJa ($12.25 in chips) 
Seat 3: 2997qwer ($13.25 in chips) 
Seat 4: Anafim ($13.98 in chips) 
Seat 5: kamikkaze ($18.58 in chips) 
Seat 6: KeLevro0 ($12.76 in chips) 
Seat 7: chiyuki ($29.94 in chips) 
Seat 8: D@vidMed ($51.69 in chips) 
Seat 9: seula i ($25 in chips) 
RomarioJa: posts small blind $0.10
2997qwer: posts big blind $0.25
*** HOLE CARDS ***
Dealt to chiyuki [3d 5d]
Anafim: folds 
kamikkaze: folds 
KeLevro0: folds 
chiyuki: folds 
D@vidMed: folds 
seula i: folds 
Scruf13: raises $0.25 to $0.50
RomarioJa: folds 
2997qwer: folds 
Uncalled bet ($0.25) returned to Scruf13
Scruf13 collected $0.60 from pot
Scruf13: doesn't show hand 
*** SUMMARY ***
Total pot $0.60 | Rake $0 
Seat 1: Scruf13 (button) collected ($0.60)
Seat 2: RomarioJa (small blind) folded before Flop
Seat 3: 2997qwer (big blind) folded before Flop
Seat 4: Anafim folded before Flop (didn't bet)
Seat 5: kamikkaze folded before Flop (didn't bet)
Seat 6: KeLevro0 folded before Flop (didn't bet)
Seat 7: chiyuki folded before Flop (didn't bet)
Seat 8: D@vidMed folded before Flop (didn't bet)
Seat 9: seula i folded before Flop (didn't bet)



PokerStars Zoom Hand #84299177670:  Hold'em No Limit ($0.10/$0.25) - 2012/08/05 14:02:09 JST [2012/08/05 1:02:09 ET]
Table 'Whirlpool' 9-max Seat #1 is the button
Seat 1: Suhoff76 ($25 in chips) 
Seat 2: Faraz ($29.57 in chips) 
Seat 3: Perstenev ($12.65 in chips) 
Seat 4: jeff0923 ($23.80 in chips) 
Seat 5: chiyuki ($29.94 in chips) 
Seat 6: ChrisCDee ($31.38 in chips) 
Seat 7: Leftymouse ($25 in chips) 
Seat 8: BlackZafiro ($25 in chips) 
Seat 9: Dan Royal ($24.65 in chips) 
Faraz: posts small blind $0.10
Perstenev: posts big blind $0.25
*** HOLE CARDS ***
Dealt to chiyuki [4h Ks]
jeff0923: folds 
chiyuki: folds 
ChrisCDee: folds 
Leftymouse: folds 
BlackZafiro: folds 
Dan Royal: folds 
Suhoff76: raises $0.62 to $0.87
Faraz: calls $0.77
Perstenev: folds 
*** FLOP *** [3s Td 8s]
Faraz: checks 
Suhoff76: bets $1.67
Faraz: folds 
Uncalled bet ($1.67) returned to Suhoff76
Suhoff76 collected $1.90 from pot
Suhoff76: doesn't show hand 
*** SUMMARY ***
Total pot $1.99 | Rake $0.09 
Board [3s Td 8s]
Seat 1: Suhoff76 (button) collected ($1.90)
Seat 2: Faraz (small blind) folded on the Flop
Seat 3: Perstenev (big blind) folded before Flop
Seat 4: jeff0923 folded before Flop (didn't bet)
Seat 5: chiyuki folded before Flop (didn't bet)
Seat 6: ChrisCDee folded before Flop (didn't bet)
Seat 7: Leftymouse folded before Flop (didn't bet)
Seat 8: BlackZafiro folded before Flop (didn't bet)
Seat 9: Dan Royal folded before Flop (didn't bet)



PokerStars Zoom Hand #84299179393:  Hold'em No Limit ($0.10/$0.25) - 2012/08/05 14:02:16 JST [2012/08/05 1:02:16 ET]
Table 'Whirlpool' 9-max Seat #1 is the button
Seat 1: zaffaroots ($18.06 in chips) 
Seat 2: BlackZafiro ($25.76 in chips) 
Seat 3: chiyuki ($29.94 in chips) 
Seat 4: KeLevro0 ($12.76 in chips) 
Seat 5: silvno31 ($46.79 in chips) 
Seat 6: Dan Royal ($24.65 in chips) 
Seat 7: Loholov ($23.86 in chips) 
Seat 8: seula i ($25.35 in chips) 
Seat 9: ChrisCDee ($31.38 in chips) 
BlackZafiro: posts small blind $0.10
chiyuki: posts big blind $0.25
*** HOLE CARDS ***
Dealt to chiyuki [5c Ac]
KeLevro0: folds 
silvno31: folds 
Dan Royal: folds 
Loholov: folds 
seula i: raises $0.75 to $1
ChrisCDee: calls $1
zaffaroots: folds 
BlackZafiro: folds 
chiyuki: folds 
*** FLOP *** [8s 9c 7d]
seula i: bets $1.50
ChrisCDee: calls $1.50
*** TURN *** [8s 9c 7d] [3d]
seula i: bets $3.75
ChrisCDee: folds 
Uncalled bet ($3.75) returned to seula i
seula i collected $5.11 from pot
seula i: doesn't show hand 
*** SUMMARY ***
Total pot $5.35 | Rake $0.24 
Board [8s 9c 7d 3d]
Seat 1: zaffaroots (button) folded before Flop (didn't bet)
Seat 2: BlackZafiro (small blind) folded before Flop
Seat 3: chiyuki (big blind) folded before Flop
Seat 4: KeLevro0 folded before Flop (didn't bet)
Seat 5: silvno31 folded before Flop (didn't bet)
Seat 6: Dan Royal folded before Flop (didn't bet)
Seat 7: Loholov folded before Flop (didn't bet)
Seat 8: seula i collected ($5.11)
Seat 9: ChrisCDee folded on the Turn



PokerStars Zoom Hand #84299187594:  Hold'em No Limit ($0.10/$0.25) - 2012/08/05 14:02:49 JST [2012/08/05 1:02:49 ET]
Table 'Whirlpool' 9-max Seat #1 is the button
Seat 1: Rudolf ($46.77 in chips) 
Seat 2: chiyuki ($29.69 in chips) 
Seat 3: hirozo ($30.40 in chips) 
Seat 4: puffy5533 ($23.05 in chips) 
Seat 5: Nerkit ($12.87 in chips) 
Seat 6: giorgos_k ($39.41 in chips) 
Seat 7: wtu1986 ($24.65 in chips) 
Seat 8: kamikkaze ($13 in chips) 
Seat 9: PetitAlejo ($26.67 in chips) 
chiyuki: posts small blind $0.10
hirozo: posts big blind $0.25
*** HOLE CARDS ***
Dealt to chiyuki [6d 3s]
puffy5533: folds 
Nerkit: folds 
giorgos_k: folds 
wtu1986: folds 
kamikkaze: folds 
PetitAlejo: folds 
Rudolf: folds 
chiyuki: folds 
Uncalled bet ($0.15) returned to hirozo
hirozo collected $0.20 from pot
hirozo: doesn't show hand 
*** SUMMARY ***
Total pot $0.20 | Rake $0 
Seat 1: Rudolf (button) folded before Flop (didn't bet)
Seat 2: chiyuki (small blind) folded before Flop
Seat 3: hirozo (big blind) collected ($0.20)
Seat 4: puffy5533 folded before Flop (didn't bet)
Seat 5: Nerkit folded before Flop (didn't bet)
Seat 6: giorgos_k folded before Flop (didn't bet)
Seat 7: wtu1986 folded before Flop (didn't bet)
Seat 8: kamikkaze folded before Flop (didn't bet)
Seat 9: PetitAlejo folded before Flop (didn't bet)



PokerStars Zoom Hand #84299182726:  Hold'em No Limit ($0.10/$0.25) - 2012/08/05 14:02:29 JST [2012/08/05 1:02:29 ET]
Table 'Whirlpool' 9-max Seat #1 is the button
Seat 1: hirozo ($28.22 in chips) 
Seat 2: leo2095 ($14.25 in chips) 
Seat 3: giorgos_k ($13.77 in chips) 
Seat 4: ll_LaMeR_ll ($69.73 in chips) 
Seat 5: agurio ($26.85 in chips) 
Seat 6: kkbruins0408 ($14.33 in chips) 
Seat 7: RomarioJa ($12.15 in chips) 
Seat 8: Roglus ($97.09 in chips) 
Seat 9: chiyuki ($29.69 in chips) 
leo2095: posts small blind $0.10
giorgos_k: posts big blind $0.25
*** HOLE CARDS ***
Dealt to chiyuki [Ad Th]
ll_LaMeR_ll: folds 
agurio: folds 
kkbruins0408: folds 
RomarioJa: folds 
Roglus: raises $0.50 to $0.75
chiyuki: folds 
hirozo: folds 
leo2095: folds 
giorgos_k: calls $0.50
*** FLOP *** [6d 8h 4c]
giorgos_k: checks 
Roglus: bets $1.04
giorgos_k: calls $1.04
*** TURN *** [6d 8h 4c] [Kh]
giorgos_k: checks 
Roglus: checks 
*** RIVER *** [6d 8h 4c Kh] [3c]
giorgos_k: bets $1.25
Roglus: calls $1.25
*** SHOW DOWN ***
giorgos_k: shows [5c 8c] (a pair of Eights)
Roglus: shows [Jh Jc] (a pair of Jacks)
Roglus collected $5.90 from pot
*** SUMMARY ***
Total pot $6.18 | Rake $0.28 
Board [6d 8h 4c Kh 3c]
Seat 1: hirozo (button) folded before Flop (didn't bet)
Seat 2: leo2095 (small blind) folded before Flop
Seat 3: giorgos_k (big blind) showed [5c 8c] and lost with a pair of Eights
Seat 4: ll_LaMeR_ll folded before Flop (didn't bet)
Seat 5: agurio folded before Flop (didn't bet)
Seat 6: kkbruins0408 folded before Flop (didn't bet)
Seat 7: RomarioJa folded before Flop (didn't bet)
Seat 8: Roglus showed [Jh Jc] and won ($5.90) with a pair of Jacks
Seat 9: chiyuki folded before Flop (didn't bet)



PokerStars Zoom Hand #84299190220:  Hold'em No Limit ($0.10/$0.25) - 2012/08/05 14:02:59 JST [2012/08/05 1:02:59 ET]
Table 'Whirlpool' 9-max Seat #1 is the button
Seat 1: chiyuki ($29.59 in chips) 
Seat 2: hirozo ($30.50 in chips) 
Seat 3: KeLevro0 ($12.66 in chips) 
Seat 4: roksmokndonk ($36.21 in chips) 
Seat 5: RomarioJa ($6.05 in chips) 
Seat 6: Tom1999 ($15.80 in chips) 
Seat 7: 2997qwer ($12.90 in chips) 
Seat 8: kamikkaze ($14.65 in chips) 
Seat 9: agurio ($27.05 in chips) 
hirozo: posts small blind $0.10
KeLevro0: posts big blind $0.25
*** HOLE CARDS ***
Dealt to chiyuki [Ac Ad]
roksmokndonk: folds 
RomarioJa: folds 
Tom1999: folds 
2997qwer: folds 
kamikkaze: folds 
agurio: folds 
chiyuki: raises $0.50 to $0.75
hirozo: folds 
KeLevro0: folds 
Uncalled bet ($0.50) returned to chiyuki
chiyuki collected $0.60 from pot
chiyuki: doesn't show hand 
*** SUMMARY ***
Total pot $0.60 | Rake $0 
Seat 1: chiyuki (button) collected ($0.60)
Seat 2: hirozo (small blind) folded before Flop
Seat 3: KeLevro0 (big blind) folded before Flop
Seat 4: roksmokndonk folded before Flop (didn't bet)
Seat 5: RomarioJa folded before Flop (didn't bet)
Seat 6: Tom1999 folded before Flop (didn't bet)
Seat 7: 2997qwer folded before Flop (didn't bet)
Seat 8: kamikkaze folded before Flop (didn't bet)
Seat 9: agurio folded before Flop (didn't bet)



PokerStars Zoom Hand #84299186794:  Hold'em No Limit ($0.10/$0.25) - 2012/08/05 14:02:46 JST [2012/08/05 1:02:46 ET]
Table 'Whirlpool' 9-max Seat #1 is the button
Seat 1: ChrisCDee ($37.79 in chips) 
Seat 2: Leftymouse ($24.75 in chips) 
Seat 3: Th3Fog ($65.64 in chips) 
Seat 4: chiyuki ($29.69 in chips) 
Seat 5: roksmokndonk ($36.21 in chips) 
Seat 6: 2997qwer ($12.90 in chips) 
Seat 7: taksist889 ($14.45 in chips) 
Seat 8: Tom1999 ($15.80 in chips) 
Seat 9: KeLevro0 ($12.66 in chips) 
Leftymouse: posts small blind $0.10
Th3Fog: posts big blind $0.25
*** HOLE CARDS ***
Dealt to chiyuki [9s Jh]
chiyuki: folds 
roksmokndonk: folds 
2997qwer: folds 
taksist889: folds 
Tom1999: folds 
KeLevro0: folds 
ChrisCDee: raises $0.50 to $0.75
Leftymouse: folds 
Th3Fog: raises $1 to $1.75
ChrisCDee: calls $1
*** FLOP *** [7h 7c Qc]
Th3Fog: bets $2.02
ChrisCDee: calls $2.02
*** TURN *** [7h 7c Qc] [Ac]
Th3Fog: bets $3.21
ChrisCDee: calls $3.21
*** RIVER *** [7h 7c Qc Ac] [4d]
Th3Fog: bets $5.90
ChrisCDee: calls $5.90
*** SHOW DOWN ***
Th3Fog: shows [Jc Ad] (two pair, Aces and Sevens)
ChrisCDee: shows [Ah Kh] (two pair, Aces and Sevens - King kicker)
ChrisCDee collected $24.70 from pot
*** SUMMARY ***
Total pot $25.86 | Rake $1.16 
Board [7h 7c Qc Ac 4d]
Seat 1: ChrisCDee (button) showed [Ah Kh] and won ($24.70) with two pair, Aces and Sevens
Seat 2: Leftymouse (small blind) folded before Flop
Seat 3: Th3Fog (big blind) showed [Jc Ad] and lost with two pair, Aces and Sevens
Seat 4: chiyuki folded before Flop (didn't bet)
Seat 5: roksmokndonk folded before Flop (didn't bet)
Seat 6: 2997qwer folded before Flop (didn't bet)
Seat 7: taksist889 folded before Flop (didn't bet)
Seat 8: Tom1999 folded before Flop (didn't bet)
Seat 9: KeLevro0 folded before Flop (didn't bet)



PokerStars Zoom Hand #84299188920:  Hold'em No Limit ($0.10/$0.25) - 2012/08/05 14:02:54 JST [2012/08/05 1:02:54 ET]
Table 'Whirlpool' 9-max Seat #1 is the button
Seat 1: GoldNutter ($16.09 in chips) 
Seat 2: puffy5533 ($23.05 in chips) 
Seat 3: Rudolf ($46.77 in chips) 
Seat 4: giorgos_k ($39.41 in chips) 
Seat 5: wtu1986 ($24.65 in chips) 
Seat 6: zaffaroots ($19.08 in chips) 
Seat 7: BlOnDhOlIc ($62.07 in chips) 
Seat 8: chiyuki ($29.59 in chips) 
Seat 9: 2997qwer ($12.90 in chips) 
puffy5533: posts small blind $0.10
Rudolf: posts big blind $0.25
*** HOLE CARDS ***
Dealt to chiyuki [Tc 8c]
giorgos_k: folds 
wtu1986: folds 
zaffaroots: calls $0.25
BlOnDhOlIc: folds 
chiyuki: folds 
2997qwer: folds 
GoldNutter: folds 
puffy5533: folds 
Rudolf: checks 
*** FLOP *** [6s Ad 6d]
Rudolf: bets $0.50
zaffaroots: calls $0.50
*** TURN *** [6s Ad 6d] [5d]
Rudolf: checks 
zaffaroots: bets $1.75
Rudolf: folds 
Uncalled bet ($1.75) returned to zaffaroots
zaffaroots collected $1.53 from pot
zaffaroots: doesn't show hand 
*** SUMMARY ***
Total pot $1.60 | Rake $0.07 
Board [6s Ad 6d 5d]
Seat 1: GoldNutter (button) folded before Flop (didn't bet)
Seat 2: puffy5533 (small blind) folded before Flop
Seat 3: Rudolf (big blind) folded on the Turn
Seat 4: giorgos_k folded before Flop (didn't bet)
Seat 5: wtu1986 folded before Flop (didn't bet)
Seat 6: zaffaroots collected ($1.53)
Seat 7: BlOnDhOlIc folded before Flop (didn't bet)
Seat 8: chiyuki folded before Flop (didn't bet)
Seat 9: 2997qwer folded before Flop (didn't bet)



PokerStars Zoom Hand #84299195991:  Hold'em No Limit ($0.10/$0.25) - 2012/08/05 14:03:21 JST [2012/08/05 1:03:21 ET]
Table 'Whirlpool' 9-max Seat #1 is the button
Seat 1: Suhoff76 ($42.42 in chips) 
Seat 2: BlackZafiro ($25.41 in chips) 
Seat 3: Perstenev ($12.62 in chips) 
Seat 4: chiyuki ($29.94 in chips) 
Seat 5: seula i ($27.96 in chips) 
Seat 6: RomarioJa ($11.40 in chips) 
Seat 7: kamikkaze ($18.58 in chips) 
Seat 8: RikkStroken ($23.80 in chips) 
Seat 9: Loholov ($15 in chips) 
BlackZafiro: posts small blind $0.10
Perstenev: posts big blind $0.25
*** HOLE CARDS ***
Dealt to chiyuki [6h Ad]
chiyuki: folds 
seula i: folds 
RomarioJa: folds 
kamikkaze: folds 
RikkStroken: raises $0.50 to $0.75
Loholov: folds 
Suhoff76: folds 
BlackZafiro: folds 
Perstenev: folds 
Uncalled bet ($0.50) returned to RikkStroken
RikkStroken collected $0.60 from pot
RikkStroken: doesn't show hand 
*** SUMMARY ***
Total pot $0.60 | Rake $0 
Seat 1: Suhoff76 (button) folded before Flop (didn't bet)
Seat 2: BlackZafiro (small blind) folded before Flop
Seat 3: Perstenev (big blind) folded before Flop
Seat 4: chiyuki folded before Flop (didn't bet)
Seat 5: seula i folded before Flop (didn't bet)
Seat 6: RomarioJa folded before Flop (didn't bet)
Seat 7: kamikkaze folded before Flop (didn't bet)
Seat 8: RikkStroken collected ($0.60)
Seat 9: Loholov folded before Flop (didn't bet)



PokerStars Zoom Hand #84299199385:  Hold'em No Limit ($0.10/$0.25) - 2012/08/05 14:03:34 JST [2012/08/05 1:03:34 ET]
Table 'Whirlpool' 9-max Seat #1 is the button
Seat 1: kamikkaze ($15.46 in chips) 
Seat 2: slapshot2011 ($26.97 in chips) 
Seat 3: chiyuki ($29.94 in chips) 
Seat 4: wtu1986 ($25.35 in chips) 
Seat 5: PetitAlejo ($34.52 in chips) 
Seat 6: jeff0923 ($26.06 in chips) 
Seat 7: 2997qwer ($9.20 in chips) 
Seat 8: Th3Fog ($77.12 in chips) 
Seat 9: seula i ($65.80 in chips) 
slapshot2011: posts small blind $0.10
chiyuki: posts big blind $0.25
*** HOLE CARDS ***
Dealt to chiyuki [8s 5s]
wtu1986: folds 
PetitAlejo: folds 
jeff0923: folds 
2997qwer: folds 
Th3Fog: raises $0.47 to $0.72
seula i: folds 
kamikkaze: folds 
slapshot2011: calls $0.62
chiyuki: folds 
*** FLOP *** [2c Js Ah]
slapshot2011: checks 
Th3Fog: bets $0.94
slapshot2011: calls $0.94
*** TURN *** [2c Js Ah] [2d]
slapshot2011: checks 
Th3Fog: checks 
*** RIVER *** [2c Js Ah 2d] [7s]
slapshot2011: bets $1
Th3Fog: calls $1
*** SHOW DOWN ***
slapshot2011: shows [Ac 7d] (two pair, Aces and Sevens)
Th3Fog: mucks hand 
slapshot2011 collected $5.32 from pot
*** SUMMARY ***
Total pot $5.57 | Rake $0.25 
Board [2c Js Ah 2d 7s]
Seat 1: kamikkaze (button) folded before Flop (didn't bet)
Seat 2: slapshot2011 (small blind) showed [Ac 7d] and won ($5.32) with two pair, Aces and Sevens
Seat 3: chiyuki (big blind) folded before Flop
Seat 4: wtu1986 folded before Flop (didn't bet)
Seat 5: PetitAlejo folded before Flop (didn't bet)
Seat 6: jeff0923 folded before Flop (didn't bet)
Seat 7: 2997qwer folded before Flop (didn't bet)
Seat 8: Th3Fog mucked [Kh Ks]
Seat 9: seula i folded before Flop (didn't bet)



PokerStars Zoom Hand #84299205203:  Hold'em No Limit ($0.10/$0.25) - 2012/08/05 14:03:57 JST [2012/08/05 1:03:57 ET]
Table 'Whirlpool' 9-max Seat #1 is the button
Seat 1: hirozo ($26.17 in chips) 
Seat 2: Perstenev ($12.67 in chips) 
Seat 3: PetitAlejo ($30.88 in chips) 
Seat 4: silvno31 ($42.39 in chips) 
Seat 5: solawind ($16.66 in chips) 
Seat 6: chiyuki ($29.69 in chips) 
Seat 7: deadmoneykid ($24.65 in chips) 
Seat 8: kamikkaze ($15.36 in chips) 
Seat 9: roksmokndonk ($35.31 in chips) 
Perstenev: posts small blind $0.10
PetitAlejo: posts big blind $0.25
*** HOLE CARDS ***
Dealt to chiyuki [8s 3c]
silvno31: raises $1 to $1.25
solawind: folds 
chiyuki: folds 
deadmoneykid: folds 
kamikkaze: folds 
roksmokndonk: folds 
hirozo: folds 
Perstenev: folds 
PetitAlejo: folds 
Uncalled bet ($1) returned to silvno31
silvno31 collected $0.60 from pot
silvno31: doesn't show hand 
*** SUMMARY ***
Total pot $0.60 | Rake $0 
Seat 1: hirozo (button) folded before Flop (didn't bet)
Seat 2: Perstenev (small blind) folded before Flop
Seat 3: PetitAlejo (big blind) folded before Flop
Seat 4: silvno31 collected ($0.60)
Seat 5: solawind folded before Flop (didn't bet)
Seat 6: chiyuki folded before Flop (didn't bet)
Seat 7: deadmoneykid folded before Flop (didn't bet)
Seat 8: kamikkaze folded before Flop (didn't bet)
Seat 9: roksmokndonk folded before Flop (didn't bet)



PokerStars Zoom Hand #84299207304:  Hold'em No Limit ($0.10/$0.25) - 2012/08/05 14:04:05 JST [2012/08/05 1:04:05 ET]
Table 'Whirlpool' 9-max Seat #1 is the button
Seat 1: PetitAlejo ($35.81 in chips) 
Seat 2: solawind ($16.66 in chips) 
Seat 3: RomarioJa ($11.96 in chips) 
Seat 4: chiyuki ($29.69 in chips) 
Seat 5: Dejacob ($49.90 in chips) 
Seat 6: simonzez ($38.78 in chips) 
Seat 7: Leftymouse ($11.15 in chips) 
Seat 8: giorgos_k ($11.65 in chips) 
Seat 9: Faraz ($26.30 in chips) 
solawind: posts small blind $0.10
RomarioJa: posts big blind $0.25
*** HOLE CARDS ***
Dealt to chiyuki [Jh 8s]
chiyuki: folds 
Dejacob: folds 
simonzez: folds 
Leftymouse: folds 
giorgos_k: folds 
Faraz: folds 
PetitAlejo: raises $0.50 to $0.75
solawind: folds 
RomarioJa: folds 
Uncalled bet ($0.50) returned to PetitAlejo
PetitAlejo collected $0.60 from pot
PetitAlejo: doesn't show hand 
*** SUMMARY ***
Total pot $0.60 | Rake $0 
Seat 1: PetitAlejo (button) collected ($0.60)
Seat 2: solawind (small blind) folded before Flop
Seat 3: RomarioJa (big blind) folded before Flop
Seat 4: chiyuki folded before Flop (didn't bet)
Seat 5: Dejacob folded before Flop (didn't bet)
Seat 6: simonzez folded before Flop (didn't bet)
Seat 7: Leftymouse folded before Flop (didn't bet)
Seat 8: giorgos_k folded before Flop (didn't bet)
Seat 9: Faraz folded before Flop (didn't bet)



PokerStars Zoom Hand #84299197034:  Hold'em No Limit ($0.10/$0.25) - 2012/08/05 14:03:25 JST [2012/08/05 1:03:25 ET]
Table 'Whirlpool' 9-max Seat #1 is the button
Seat 1: Nerkit ($11.36 in chips) 
Seat 2: Dejacob ($50 in chips) 
Seat 3: RomarioJa ($11.40 in chips) 
Seat 4: Suhoff76 ($26.03 in chips) 
Seat 5: 2997qwer ($12.90 in chips) 
Seat 6: cr0lox ($20.86 in chips) 
Seat 7: chiyuki ($29.94 in chips) 
Seat 8: ChrisCDee ($26.46 in chips) 
Seat 9: 123progress ($39.38 in chips) 
Dejacob: posts small blind $0.10
RomarioJa: posts big blind $0.25
*** HOLE CARDS ***
Dealt to chiyuki [5c Ks]
Suhoff76: folds 
2997qwer: folds 
cr0lox: raises $0.50 to $0.75
chiyuki: folds 
ChrisCDee: folds 
123progress: folds 
Nerkit: calls $0.75
Dejacob: folds 
RomarioJa: calls $0.50
*** FLOP *** [Jd Jh 9s]
RomarioJa: checks 
cr0lox: bets $0.56
Nerkit: folds 
RomarioJa: folds 
Uncalled bet ($0.56) returned to cr0lox
cr0lox collected $2.24 from pot
cr0lox: doesn't show hand 
*** SUMMARY ***
Total pot $2.35 | Rake $0.11 
Board [Jd Jh 9s]
Seat 1: Nerkit (button) folded on the Flop
Seat 2: Dejacob (small blind) folded before Flop
Seat 3: RomarioJa (big blind) folded on the Flop
Seat 4: Suhoff76 folded before Flop (didn't bet)
Seat 5: 2997qwer folded before Flop (didn't bet)
Seat 6: cr0lox collected ($2.24)
Seat 7: chiyuki folded before Flop (didn't bet)
Seat 8: ChrisCDee folded before Flop (didn't bet)
Seat 9: 123progress folded before Flop (didn't bet)



PokerStars Zoom Hand #84299204179:  Hold'em No Limit ($0.10/$0.25) - 2012/08/05 14:03:53 JST [2012/08/05 1:03:53 ET]
Table 'Whirlpool' 9-max Seat #1 is the button
Seat 1: Déculotter69 ($16.22 in chips) 
Seat 2: wtu1986 ($25 in chips) 
Seat 3: Tom1999 ($14.42 in chips) 
Seat 4: PetitAlejo ($26.77 in chips) 
Seat 5: RikkStroken ($33.30 in chips) 
Seat 6: ygoegoe ($34.71 in chips) 
Seat 7: BlOnDhOlIc ($61.72 in chips) 
Seat 8: Perstenev ($12.67 in chips) 
Seat 9: chiyuki ($29.69 in chips) 
wtu1986: posts small blind $0.10
Tom1999: posts big blind $0.25
*** HOLE CARDS ***
Dealt to chiyuki [6s 2h]
PetitAlejo: folds 
RikkStroken: folds 
ygoegoe: folds 
BlOnDhOlIc: folds 
Perstenev: folds 
chiyuki: folds 
Déculotter69: raises $0.50 to $0.75
wtu1986: folds 
Tom1999: calls $0.50
*** FLOP *** [4c 2c 3c]
Tom1999: checks 
Déculotter69: bets $1
Tom1999: calls $1
*** TURN *** [4c 2c 3c] [9s]
Tom1999: checks 
Déculotter69: bets $2
Tom1999: calls $2
*** RIVER *** [4c 2c 3c 9s] [5s]
Tom1999: checks 
Déculotter69: bets $4
Tom1999: calls $4
*** SHOW DOWN ***
Déculotter69: shows [Ac 2s] (a straight, Ace to Five)
Tom1999: shows [Qc As] (a straight, Ace to Five)
Tom1999 collected $7.45 from pot
Déculotter69 collected $7.45 from pot
*** SUMMARY ***
Total pot $15.60 | Rake $0.70 
Board [4c 2c 3c 9s 5s]
Seat 1: Déculotter69 (button) showed [Ac 2s] and won ($7.45) with a straight, Ace to Five
Seat 2: wtu1986 (small blind) folded before Flop
Seat 3: Tom1999 (big blind) showed [Qc As] and won ($7.45) with a straight, Ace to Five
Seat 4: PetitAlejo folded before Flop (didn't bet)
Seat 5: RikkStroken folded before Flop (didn't bet)
Seat 6: ygoegoe folded before Flop (didn't bet)
Seat 7: BlOnDhOlIc folded before Flop (didn't bet)
Seat 8: Perstenev folded before Flop (didn't bet)
Seat 9: chiyuki folded before Flop (didn't bet)



PokerStars Zoom Hand #84299208607:  Hold'em No Limit ($0.10/$0.25) - 2012/08/05 14:04:10 JST [2012/08/05 1:04:10 ET]
Table 'Whirlpool' 9-max Seat #1 is the button
Seat 1: agurio ($25 in chips) 
Seat 2: Dejacob ($29.58 in chips) 
Seat 3: slapshot2011 ($29.63 in chips) 
Seat 4: wtu1986 ($24.90 in chips) 
Seat 5: D@vidMed ($57.60 in chips) 
Seat 6: Leftymouse ($21.50 in chips) 
Seat 7: BlOnDhOlIc ($61.72 in chips) 
Seat 8: chiyuki ($29.69 in chips) 
Seat 9: giorgos_k ($38.81 in chips) 
Dejacob: posts small blind $0.10
slapshot2011: posts big blind $0.25
*** HOLE CARDS ***
Dealt to chiyuki [Ah Th]
wtu1986: folds 
D@vidMed: folds 
Leftymouse: folds 
BlOnDhOlIc: folds 
chiyuki: raises $0.50 to $0.75
giorgos_k: folds 
agurio: folds 
Dejacob: calls $0.65
slapshot2011: calls $0.50
*** FLOP *** [Ac 5s Jh]
Dejacob: checks 
slapshot2011: checks 
chiyuki: bets $1.25
Dejacob: calls $1.25
slapshot2011: folds 
*** TURN *** [Ac 5s Jh] [6d]
Dejacob: checks 
chiyuki: checks 
*** RIVER *** [Ac 5s Jh 6d] [Jc]
Dejacob: bets $2.50
chiyuki: calls $2.50
*** SHOW DOWN ***
Dejacob: shows [Ad 9d] (two pair, Aces and Jacks)
chiyuki: shows [Ah Th] (two pair, Aces and Jacks - Ten kicker)
chiyuki collected $9.31 from pot
*** SUMMARY ***
Total pot $9.75 | Rake $0.44 
Board [Ac 5s Jh 6d Jc]
Seat 1: agurio (button) folded before Flop (didn't bet)
Seat 2: Dejacob (small blind) showed [Ad 9d] and lost with two pair, Aces and Jacks
Seat 3: slapshot2011 (big blind) folded on the Flop
Seat 4: wtu1986 folded before Flop (didn't bet)
Seat 5: D@vidMed folded before Flop (didn't bet)
Seat 6: Leftymouse folded before Flop (didn't bet)
Seat 7: BlOnDhOlIc folded before Flop (didn't bet)
Seat 8: chiyuki showed [Ah Th] and won ($9.31) with two pair, Aces and Jacks
Seat 9: giorgos_k folded before Flop (didn't bet)



PokerStars Zoom Hand #84299225102:  Hold'em No Limit ($0.10/$0.25) - 2012/08/05 14:05:14 JST [2012/08/05 1:05:14 ET]
Table 'Whirlpool' 9-max Seat #1 is the button
Seat 1: chiyuki ($34.40 in chips) 
Seat 2: giorgos_k ($14.68 in chips) 
Seat 3: Tom1999 ($14.02 in chips) 
Seat 4: roksmokndonk ($32.31 in chips) 
Seat 5: Roglus ($11.77 in chips) 
Seat 6: RomarioJa ($5.80 in chips) 
Seat 7: 2997qwer ($8.50 in chips) 
Seat 8: Vahe50 ($10.87 in chips) 
Seat 9: seula i ($65.45 in chips) 
giorgos_k: posts small blind $0.10
Tom1999: posts big blind $0.25
*** HOLE CARDS ***
Dealt to chiyuki [6d Ts]
roksmokndonk: folds 
Roglus: folds 
RomarioJa: folds 
2997qwer: folds 
Vahe50: folds 
seula i: folds 
chiyuki: folds 
giorgos_k: folds 
Uncalled bet ($0.15) returned to Tom1999
Tom1999 collected $0.20 from pot
Tom1999: doesn't show hand 
*** SUMMARY ***
Total pot $0.20 | Rake $0 
Seat 1: chiyuki (button) folded before Flop (didn't bet)
Seat 2: giorgos_k (small blind) folded before Flop
Seat 3: Tom1999 (big blind) collected ($0.20)
Seat 4: roksmokndonk folded before Flop (didn't bet)
Seat 5: Roglus folded before Flop (didn't bet)
Seat 6: RomarioJa folded before Flop (didn't bet)
Seat 7: 2997qwer folded before Flop (didn't bet)
Seat 8: Vahe50 folded before Flop (didn't bet)
Seat 9: seula i folded before Flop (didn't bet)



PokerStars Zoom Hand #84299223316:  Hold'em No Limit ($0.10/$0.25) - 2012/08/05 14:05:07 JST [2012/08/05 1:05:07 ET]
Table 'Whirlpool' 9-max Seat #1 is the button
Seat 1: ll_LaMeR_ll ($61.44 in chips) 
Seat 2: mariuka1 ($8.24 in chips) 
Seat 3: Déculotter69 ($15.92 in chips) 
Seat 4: KeLevro0 ($11.81 in chips) 
Seat 5: Tom1999 ($14.02 in chips) 
Seat 6: chiyuki ($34.40 in chips) 
Seat 7: RomarioJa ($12.50 in chips) 
Seat 8: BlOnDhOlIc ($61.37 in chips) 
Seat 9: Scruf13 ($12.66 in chips) 
mariuka1: posts small blind $0.10
Déculotter69: posts big blind $0.25
*** HOLE CARDS ***
Dealt to chiyuki [8c 3h]
KeLevro0: folds 
Tom1999: folds 
chiyuki: folds 
RomarioJa: raises $0.37 to $0.62
BlOnDhOlIc: folds 
Scruf13: folds 
ll_LaMeR_ll: folds 
mariuka1: folds 
Déculotter69: calls $0.37
*** FLOP *** [Jc 5d 9d]
Déculotter69: checks 
RomarioJa: bets $0.64
Déculotter69: raises $1.36 to $2
RomarioJa: folds 
Uncalled bet ($1.36) returned to Déculotter69
Déculotter69 collected $2.50 from pot
Déculotter69: doesn't show hand 
*** SUMMARY ***
Total pot $2.62 | Rake $0.12 
Board [Jc 5d 9d]
Seat 1: ll_LaMeR_ll (button) folded before Flop (didn't bet)
Seat 2: mariuka1 (small blind) folded before Flop
Seat 3: Déculotter69 (big blind) collected ($2.50)
Seat 4: KeLevro0 folded before Flop (didn't bet)
Seat 5: Tom1999 folded before Flop (didn't bet)
Seat 6: chiyuki folded before Flop (didn't bet)
Seat 7: RomarioJa folded on the Flop
Seat 8: BlOnDhOlIc folded before Flop (didn't bet)
Seat 9: Scruf13 folded before Flop (didn't bet)



PokerStars Zoom Hand #84299229888:  Hold'em No Limit ($0.10/$0.25) - 2012/08/05 14:05:32 JST [2012/08/05 1:05:32 ET]
Table 'Whirlpool' 9-max Seat #1 is the button
Seat 1: Suhoff76 ($28.82 in chips) 
Seat 2: Loholov ($16.73 in chips) 
Seat 3: chiyuki ($34.40 in chips) 
Seat 4: hirozo ($30.27 in chips) 
Seat 5: silvno31 ($41.89 in chips) 
Seat 6: Perstenev ($14.44 in chips) 
Seat 7: 2997qwer ($8.85 in chips) 
Seat 8: jallu435 ($25.10 in chips) 
Seat 9: PetitAlejo ($35.61 in chips) 
Loholov: posts small blind $0.10
chiyuki: posts big blind $0.25
*** HOLE CARDS ***
Dealt to chiyuki [2c Jd]
hirozo: folds 
silvno31: folds 
Perstenev: folds 
2997qwer: folds 
jallu435: folds 
PetitAlejo: folds 
Suhoff76: folds 
Loholov: raises $0.50 to $0.75
chiyuki: folds 
Uncalled bet ($0.50) returned to Loholov
Loholov collected $0.50 from pot
Loholov: doesn't show hand 
*** SUMMARY ***
Total pot $0.50 | Rake $0 
Seat 1: Suhoff76 (button) folded before Flop (didn't bet)
Seat 2: Loholov (small blind) collected ($0.50)
Seat 3: chiyuki (big blind) folded before Flop
Seat 4: hirozo folded before Flop (didn't bet)
Seat 5: silvno31 folded before Flop (didn't bet)
Seat 6: Perstenev folded before Flop (didn't bet)
Seat 7: 2997qwer folded before Flop (didn't bet)
Seat 8: jallu435 folded before Flop (didn't bet)
Seat 9: PetitAlejo folded before Flop (didn't bet)



PokerStars Zoom Hand #84299221962:  Hold'em No Limit ($0.10/$0.25) - 2012/08/05 14:05:02 JST [2012/08/05 1:05:02 ET]
Table 'Whirlpool' 9-max Seat #1 is the button
Seat 1: seula i ($65.55 in chips) 
Seat 2: chiyuki ($34.50 in chips) 
Seat 3: RikkStroken ($24.15 in chips) 
Seat 4: hirozo ($30.27 in chips) 
Seat 5: RomarioJa ($12.50 in chips) 
Seat 6: deadmoneykid ($25.67 in chips) 
Seat 7: kamikkaze ($10.71 in chips) 
Seat 8: Roglus ($97.53 in chips) 
Seat 9: Anafim ($12.50 in chips) 
chiyuki: posts small blind $0.10
RikkStroken: posts big blind $0.25
*** HOLE CARDS ***
Dealt to chiyuki [3h Qc]
hirozo: folds 
RomarioJa: folds 
deadmoneykid: calls $0.25
kamikkaze: folds 
Roglus: folds 
Anafim: folds 
seula i: folds 
chiyuki: folds 
RikkStroken: checks 
*** FLOP *** [6s 6d As]
RikkStroken: checks 
deadmoneykid: checks 
*** TURN *** [6s 6d As] [5c]
RikkStroken: bets $0.75
deadmoneykid: folds 
Uncalled bet ($0.75) returned to RikkStroken
RikkStroken collected $0.57 from pot
RikkStroken: doesn't show hand 
*** SUMMARY ***
Total pot $0.60 | Rake $0.03 
Board [6s 6d As 5c]
Seat 1: seula i (button) folded before Flop (didn't bet)
Seat 2: chiyuki (small blind) folded before Flop
Seat 3: RikkStroken (big blind) collected ($0.57)
Seat 4: hirozo folded before Flop (didn't bet)
Seat 5: RomarioJa folded before Flop (didn't bet)
Seat 6: deadmoneykid folded on the Turn
Seat 7: kamikkaze folded before Flop (didn't bet)
Seat 8: Roglus folded before Flop (didn't bet)
Seat 9: Anafim folded before Flop (didn't bet)



PokerStars Zoom Hand #84299228817:  Hold'em No Limit ($0.10/$0.25) - 2012/08/05 14:05:28 JST [2012/08/05 1:05:28 ET]
Table 'Whirlpool' 9-max Seat #1 is the button
Seat 1: BlOnDhOlIc ($25.55 in chips) 
Seat 2: Rudolf ($45.17 in chips) 
Seat 3: ygoegoe ($35.74 in chips) 
Seat 4: Loholov ($16.73 in chips) 
Seat 5: mariuka1 ($8.14 in chips) 
Seat 6: fima00000007 ($9.40 in chips) 
Seat 7: chiyuki ($34.40 in chips) 
Seat 8: PetitAlejo ($35.61 in chips) 
Seat 9: RikkStroken ($25.13 in chips) 
Rudolf: posts small blind $0.10
ygoegoe: posts big blind $0.25
*** HOLE CARDS ***
Dealt to chiyuki [Ts 2s]
Loholov: folds 
mariuka1: folds 
fima00000007: folds 
chiyuki: folds 
PetitAlejo: folds 
RikkStroken: folds 
BlOnDhOlIc: raises $0.25 to $0.50
Rudolf: folds 
ygoegoe: folds 
Uncalled bet ($0.25) returned to BlOnDhOlIc
BlOnDhOlIc collected $0.60 from pot
BlOnDhOlIc: doesn't show hand 
*** SUMMARY ***
Total pot $0.60 | Rake $0 
Seat 1: BlOnDhOlIc (button) collected ($0.60)
Seat 2: Rudolf (small blind) folded before Flop
Seat 3: ygoegoe (big blind) folded before Flop
Seat 4: Loholov folded before Flop (didn't bet)
Seat 5: mariuka1 folded before Flop (didn't bet)
Seat 6: fima00000007 folded before Flop (didn't bet)
Seat 7: chiyuki folded before Flop (didn't bet)
Seat 8: PetitAlejo folded before Flop (didn't bet)
Seat 9: RikkStroken folded before Flop (didn't bet)



PokerStars Zoom Hand #84299226681:  Hold'em No Limit ($0.10/$0.25) - 2012/08/05 14:05:20 JST [2012/08/05 1:05:20 ET]
Table 'Whirlpool' 9-max Seat #1 is the button
Seat 1: PetitAlejo ($35.61 in chips) 
Seat 2: simonzez ($39.33 in chips) 
Seat 3: zaffaroots ($20.39 in chips) 
Seat 4: chiyuki ($34.40 in chips) 
Seat 5: ladymadon107 ($6.01 in chips) 
Seat 6: Dafleche ($17.01 in chips) 
Seat 7: roksmokndonk ($32.31 in chips) 
Seat 8: mariuka1 ($8.14 in chips) 
Seat 9: solawind ($16.56 in chips) 
simonzez: posts small blind $0.10
zaffaroots: posts big blind $0.25
*** HOLE CARDS ***
Dealt to chiyuki [Jh 2s]
chiyuki: folds 
ladymadon107: raises $0.25 to $0.50
Dafleche: folds 
roksmokndonk: folds 
mariuka1: folds 
solawind: folds 
PetitAlejo: folds 
simonzez: calls $0.40
zaffaroots: calls $0.25
*** FLOP *** [7c Ks 9c]
simonzez: checks 
zaffaroots: bets $1
ladymadon107: folds 
simonzez: folds 
Uncalled bet ($1) returned to zaffaroots
zaffaroots collected $1.43 from pot
zaffaroots: doesn't show hand 
*** SUMMARY ***
Total pot $1.50 | Rake $0.07 
Board [7c Ks 9c]
Seat 1: PetitAlejo (button) folded before Flop (didn't bet)
Seat 2: simonzez (small blind) folded on the Flop
Seat 3: zaffaroots (big blind) collected ($1.43)
Seat 4: chiyuki folded before Flop (didn't bet)
Seat 5: ladymadon107 folded on the Flop
Seat 6: Dafleche folded before Flop (didn't bet)
Seat 7: roksmokndonk folded before Flop (didn't bet)
Seat 8: mariuka1 folded before Flop (didn't bet)
Seat 9: solawind folded before Flop (didn't bet)



PokerStars Zoom Hand #84299236968:  Hold'em No Limit ($0.10/$0.25) - 2012/08/05 14:05:59 JST [2012/08/05 1:05:59 ET]
Table 'Whirlpool' 9-max Seat #1 is the button
Seat 1: RomarioJa ($5.70 in chips) 
Seat 2: BlackZafiro ($46.46 in chips) 
Seat 3: 2997qwer ($8.85 in chips) 
Seat 4: puffy5533 ($21.20 in chips) 
Seat 5: ll_LaMeR_ll ($61.79 in chips) 
Seat 6: chiyuki ($34.15 in chips) 
Seat 7: Roglus ($98.44 in chips) 
Seat 8: Csabee21 ($25.29 in chips) 
Seat 9: KeLevro0 ($12.15 in chips) 
BlackZafiro: posts small blind $0.10
2997qwer: posts big blind $0.25
*** HOLE CARDS ***
Dealt to chiyuki [3c Ks]
puffy5533: folds 
ll_LaMeR_ll: folds 
chiyuki: folds 
Roglus: folds 
Csabee21: folds 
KeLevro0: folds 
RomarioJa: folds 
BlackZafiro: folds 
Uncalled bet ($0.15) returned to 2997qwer
2997qwer collected $0.20 from pot
2997qwer: doesn't show hand 
*** SUMMARY ***
Total pot $0.20 | Rake $0 
Seat 1: RomarioJa (button) folded before Flop (didn't bet)
Seat 2: BlackZafiro (small blind) folded before Flop
Seat 3: 2997qwer (big blind) collected ($0.20)
Seat 4: puffy5533 folded before Flop (didn't bet)
Seat 5: ll_LaMeR_ll folded before Flop (didn't bet)
Seat 6: chiyuki folded before Flop (didn't bet)
Seat 7: Roglus folded before Flop (didn't bet)
Seat 8: Csabee21 folded before Flop (didn't bet)
Seat 9: KeLevro0 folded before Flop (didn't bet)



PokerStars Zoom Hand #84299232746:  Hold'em No Limit ($0.10/$0.25) - 2012/08/05 14:05:43 JST [2012/08/05 1:05:43 ET]
Table 'Whirlpool' 9-max Seat #1 is the button
Seat 1: seula i ($27.61 in chips) 
Seat 2: Dejacob ($52.74 in chips) 
Seat 3: BlOnDhOlIc ($62.31 in chips) 
Seat 4: mariuka1 ($8.14 in chips) 
Seat 5: 2997qwer ($8.50 in chips) 
Seat 6: RomarioJa ($11.24 in chips) 
Seat 7: Suhoff76 ($25.68 in chips) 
Seat 8: PetitAlejo ($35.81 in chips) 
Seat 9: chiyuki ($34.15 in chips) 
Dejacob: posts small blind $0.10
BlOnDhOlIc: posts big blind $0.25
*** HOLE CARDS ***
Dealt to chiyuki [5h 2d]
mariuka1: folds 
2997qwer: folds 
RomarioJa: raises $0.50 to $0.75
Suhoff76: folds 
PetitAlejo: folds 
chiyuki: folds 
seula i: folds 
Dejacob: calls $0.65
BlOnDhOlIc: folds 
*** FLOP *** [6c 6d 9s]
Dejacob: bets $1
RomarioJa: folds 
Uncalled bet ($1) returned to Dejacob
Dejacob collected $1.67 from pot
Dejacob: doesn't show hand 
*** SUMMARY ***
Total pot $1.75 | Rake $0.08 
Board [6c 6d 9s]
Seat 1: seula i (button) folded before Flop (didn't bet)
Seat 2: Dejacob (small blind) collected ($1.67)
Seat 3: BlOnDhOlIc (big blind) folded before Flop
Seat 4: mariuka1 folded before Flop (didn't bet)
Seat 5: 2997qwer folded before Flop (didn't bet)
Seat 6: RomarioJa folded on the Flop
Seat 7: Suhoff76 folded before Flop (didn't bet)
Seat 8: PetitAlejo folded before Flop (didn't bet)
Seat 9: chiyuki folded before Flop (didn't bet)



PokerStars Zoom Hand #84299241922:  Hold'em No Limit ($0.10/$0.25) - 2012/08/05 14:06:19 JST [2012/08/05 1:06:19 ET]
Table 'Whirlpool' 9-max Seat #1 is the button
Seat 1: Nerkit ($11.65 in chips) 
Seat 2: chiyuki ($34.15 in chips) 
Seat 3: Loholov ($15 in chips) 
Seat 4: Th3Fog ($49.06 in chips) 
Seat 5: Vahe50 ($14.50 in chips) 
Seat 6: sparky5224 ($23.35 in chips) 
Seat 7: solawind ($16.31 in chips) 
Seat 8: BlOnDhOlIc ($25.80 in chips) 
Seat 9: Ellen1947 ($36.86 in chips) 
chiyuki: posts small blind $0.10
Loholov: posts big blind $0.25
*** HOLE CARDS ***
Dealt to chiyuki [2s 2d]
Th3Fog: folds 
Vahe50: folds 
sparky5224: folds 
solawind: folds 
BlOnDhOlIc: folds 
Ellen1947: folds 
Nerkit: folds 
chiyuki: raises $0.50 to $0.75
Loholov: calls $0.50
*** FLOP *** [As 3c Ah]
chiyuki: checks 
Loholov: bets $1.25
chiyuki: folds 
Uncalled bet ($1.25) returned to Loholov
Loholov collected $1.43 from pot
Loholov: doesn't show hand 
*** SUMMARY ***
Total pot $1.50 | Rake $0.07 
Board [As 3c Ah]
Seat 1: Nerkit (button) folded before Flop (didn't bet)
Seat 2: chiyuki (small blind) folded on the Flop
Seat 3: Loholov (big blind) collected ($1.43)
Seat 4: Th3Fog folded before Flop (didn't bet)
Seat 5: Vahe50 folded before Flop (didn't bet)
Seat 6: sparky5224 folded before Flop (didn't bet)
Seat 7: solawind folded before Flop (didn't bet)
Seat 8: BlOnDhOlIc folded before Flop (didn't bet)
Seat 9: Ellen1947 folded before Flop (didn't bet)



PokerStars Zoom Hand #84299235379:  Hold'em No Limit ($0.10/$0.25) - 2012/08/05 14:05:53 JST [2012/08/05 1:05:53 ET]
Table 'Whirlpool' 9-max Seat #1 is the button
Seat 1: softdesign ($72.11 in chips) 
Seat 2: Déculotter69 ($17.16 in chips) 
Seat 3: seula i ($27.61 in chips) 
Seat 4: RikkStroken ($24.47 in chips) 
Seat 5: Perstenev ($12.40 in chips) 
Seat 6: Vahe50 ($14.50 in chips) 
Seat 7: deadmoneykid ($21.05 in chips) 
Seat 8: chiyuki ($34.15 in chips) 
Seat 9: Anafim ($13.03 in chips) 
Déculotter69: posts small blind $0.10
seula i: posts big blind $0.25
*** HOLE CARDS ***
Dealt to chiyuki [Jd 6c]
RikkStroken: raises $0.25 to $0.50
Perstenev: folds 
Vahe50: folds 
deadmoneykid: folds 
chiyuki: folds 
Anafim: raises $0.25 to $0.75
softdesign: calls $0.75
Déculotter69: folds 
seula i: folds 
RikkStroken: calls $0.25
*** FLOP *** [9c 2d Ts]
RikkStroken: checks 
Anafim: checks 
softdesign: bets $2.50
RikkStroken: folds 
Anafim: folds 
Uncalled bet ($2.50) returned to softdesign
softdesign collected $2.48 from pot
softdesign: doesn't show hand 
*** SUMMARY ***
Total pot $2.60 | Rake $0.12 
Board [9c 2d Ts]
Seat 1: softdesign (button) collected ($2.48)
Seat 2: Déculotter69 (small blind) folded before Flop
Seat 3: seula i (big blind) folded before Flop
Seat 4: RikkStroken folded on the Flop
Seat 5: Perstenev folded before Flop (didn't bet)
Seat 6: Vahe50 folded before Flop (didn't bet)
Seat 7: deadmoneykid folded before Flop (didn't bet)
Seat 8: chiyuki folded before Flop (didn't bet)
Seat 9: Anafim folded on the Flop



PokerStars Zoom Hand #84299251206:  Hold'em No Limit ($0.10/$0.25) - 2012/08/05 14:06:54 JST [2012/08/05 1:06:54 ET]
Table 'Whirlpool' 9-max Seat #1 is the button
Seat 1: RomarioJa ($5.45 in chips) 
Seat 2: troms20 ($25.10 in chips) 
Seat 3: Dejacob ($53.66 in chips) 
Seat 4: Loholov ($15.60 in chips) 
Seat 5: chiyuki ($33.40 in chips) 
Seat 6: Paranoix1990 ($11.68 in chips) 
Seat 7: Landybob ($35.78 in chips) 
Seat 8: Th3Fog ($49.06 in chips) 
Seat 9: seula i ($66.12 in chips) 
troms20: posts small blind $0.10
Dejacob: posts big blind $0.25
*** HOLE CARDS ***
Dealt to chiyuki [2d Kc]
Loholov: folds 
chiyuki: folds 
Paranoix1990: folds 
Landybob: folds 
Th3Fog: folds 
seula i: folds 
RomarioJa: folds 
troms20: folds 
Uncalled bet ($0.15) returned to Dejacob
Dejacob collected $0.20 from pot
Dejacob: doesn't show hand 
*** SUMMARY ***
Total pot $0.20 | Rake $0 
Seat 1: RomarioJa (button) folded before Flop (didn't bet)
Seat 2: troms20 (small blind) folded before Flop
Seat 3: Dejacob (big blind) collected ($0.20)
Seat 4: Loholov folded before Flop (didn't bet)
Seat 5: chiyuki folded before Flop (didn't bet)
Seat 6: Paranoix1990 folded before Flop (didn't bet)
Seat 7: Landybob folded before Flop (didn't bet)
Seat 8: Th3Fog folded before Flop (didn't bet)
Seat 9: seula i folded before Flop (didn't bet)



PokerStars Zoom Hand #84299253102:  Hold'em No Limit ($0.10/$0.25) - 2012/08/05 14:07:01 JST [2012/08/05 1:07:01 ET]
Table 'Whirlpool' 9-max Seat #1 is the button
Seat 1: deadmoneykid ($24.32 in chips) 
Seat 2: roksmokndonk ($32.31 in chips) 
Seat 3: BlackZafiro ($25 in chips) 
Seat 4: seula i ($27.61 in chips) 
Seat 5: RikkStroken ($19.43 in chips) 
Seat 6: jeff0923 ($24.68 in chips) 
Seat 7: KeLevro0 ($14.92 in chips) 
Seat 8: solawind ($11.21 in chips) 
Seat 9: chiyuki ($33.40 in chips) 
roksmokndonk: posts small blind $0.10
BlackZafiro: posts big blind $0.25
*** HOLE CARDS ***
Dealt to chiyuki [3c Ts]
seula i: folds 
RikkStroken: folds 
jeff0923: folds 
KeLevro0: folds 
solawind: folds 
chiyuki: folds 
deadmoneykid: folds 
roksmokndonk: folds 
Uncalled bet ($0.15) returned to BlackZafiro
BlackZafiro collected $0.20 from pot
BlackZafiro: doesn't show hand 
*** SUMMARY ***
Total pot $0.20 | Rake $0 
Seat 1: deadmoneykid (button) folded before Flop (didn't bet)
Seat 2: roksmokndonk (small blind) folded before Flop
Seat 3: BlackZafiro (big blind) collected ($0.20)
Seat 4: seula i folded before Flop (didn't bet)
Seat 5: RikkStroken folded before Flop (didn't bet)
Seat 6: jeff0923 folded before Flop (didn't bet)
Seat 7: KeLevro0 folded before Flop (didn't bet)
Seat 8: solawind folded before Flop (didn't bet)
Seat 9: chiyuki folded before Flop (didn't bet)



PokerStars Zoom Hand #84299238024:  Hold'em No Limit ($0.10/$0.25) - 2012/08/05 14:06:03 JST [2012/08/05 1:06:03 ET]
Table 'Whirlpool' 9-max Seat #1 is the button
Seat 1: chiyuki ($34.15 in chips) 
Seat 2: zaffaroots ($21.32 in chips) 
Seat 3: taksist889 ($16.88 in chips) 
Seat 4: fima00000007 ($9.30 in chips) 
Seat 5: jallu435 ($25 in chips) 
Seat 6: Roglus ($98.44 in chips) 
Seat 7: PakisR ($12.15 in chips) 
Seat 8: Déculotter69 ($17.06 in chips) 
Seat 9: Vahe50 ($14.50 in chips) 
zaffaroots: posts small blind $0.10
taksist889: posts big blind $0.25
*** HOLE CARDS ***
Dealt to chiyuki [8h As]
fima00000007: raises $0.50 to $0.75
jallu435: calls $0.75
Roglus: calls $0.75
PakisR: folds 
Déculotter69: folds 
Vahe50: folds 
chiyuki: folds 
zaffaroots: calls $0.65
taksist889: calls $0.50
*** FLOP *** [Ts 8c Ks]
zaffaroots: checks 
taksist889: bets $2.75
fima00000007: folds 
jallu435: folds 
Roglus: calls $2.75
zaffaroots: folds 
*** TURN *** [Ts 8c Ks] [9h]
taksist889: bets $13.38 and is all-in
Roglus: calls $13.38
*** RIVER *** [Ts 8c Ks 9h] [3c]
*** SHOW DOWN ***
taksist889: shows [Kd Tc] (two pair, Kings and Tens)
Roglus: shows [9s 8s] (two pair, Nines and Eights)
taksist889 collected $34.39 from pot
*** SUMMARY ***
Total pot $36.01 | Rake $1.62 
Board [Ts 8c Ks 9h 3c]
Seat 1: chiyuki (button) folded before Flop (didn't bet)
Seat 2: zaffaroots (small blind) folded on the Flop
Seat 3: taksist889 (big blind) showed [Kd Tc] and won ($34.39) with two pair, Kings and Tens
Seat 4: fima00000007 folded on the Flop
Seat 5: jallu435 folded on the Flop
Seat 6: Roglus showed [9s 8s] and lost with two pair, Nines and Eights
Seat 7: PakisR folded before Flop (didn't bet)
Seat 8: Déculotter69 folded before Flop (didn't bet)
Seat 9: Vahe50 folded before Flop (didn't bet)



PokerStars Zoom Hand #84299255903:  Hold'em No Limit ($0.10/$0.25) - 2012/08/05 14:07:12 JST [2012/08/05 1:07:12 ET]
Table 'Whirlpool' 9-max Seat #1 is the button
Seat 1: RomarioJa ($10.14 in chips) 
Seat 2: fezman ($15.54 in chips) 
Seat 3: chiyuki ($33.40 in chips) 
Seat 4: Faraz ($23.17 in chips) 
Seat 5: 123progress ($25.26 in chips) 
Seat 6: 2997qwer ($8.85 in chips) 
Seat 7: PetitAlejo ($31.58 in chips) 
Seat 8: seula i ($27.61 in chips) 
Seat 9: Th3Fog ($48.96 in chips) 
fezman: posts small blind $0.10
chiyuki: posts big blind $0.25
*** HOLE CARDS ***
Dealt to chiyuki [8d Kc]
Faraz: folds 
123progress: folds 
2997qwer: folds 
PetitAlejo: folds 
seula i: folds 
Th3Fog: folds 
RomarioJa: folds 
fezman: folds 
Uncalled bet ($0.15) returned to chiyuki
chiyuki collected $0.20 from pot
chiyuki: doesn't show hand 
*** SUMMARY ***
Total pot $0.20 | Rake $0 
Seat 1: RomarioJa (button) folded before Flop (didn't bet)
Seat 2: fezman (small blind) folded before Flop
Seat 3: chiyuki (big blind) collected ($0.20)
Seat 4: Faraz folded before Flop (didn't bet)
Seat 5: 123progress folded before Flop (didn't bet)
Seat 6: 2997qwer folded before Flop (didn't bet)
Seat 7: PetitAlejo folded before Flop (didn't bet)
Seat 8: seula i folded before Flop (didn't bet)
Seat 9: Th3Fog folded before Flop (didn't bet)



PokerStars Zoom Hand #84299254906:  Hold'em No Limit ($0.10/$0.25) - 2012/08/05 14:07:08 JST [2012/08/05 1:07:08 ET]
Table 'Whirlpool' 9-max Seat #1 is the button
Seat 1: BlOnDhOlIc ($45.22 in chips) 
Seat 2: hirozo ($29.32 in chips) 
Seat 3: Lasutchik ($12.50 in chips) 
Seat 4: kamikkaze ($12.42 in chips) 
Seat 5: 123progress ($25.26 in chips) 
Seat 6: Ellen1947 ($36.86 in chips) 
Seat 7: chiyuki ($33.40 in chips) 
Seat 8: fezman ($15.54 in chips) 
Seat 9: troms20 ($25 in chips) 
hirozo: posts small blind $0.10
Lasutchik: posts big blind $0.25
*** HOLE CARDS ***
Dealt to chiyuki [7c 4s]
kamikkaze: folds 
123progress: folds 
Ellen1947: folds 
chiyuki: folds 
fezman: folds 
troms20: folds 
BlOnDhOlIc: raises $0.37 to $0.62
hirozo: folds 
Lasutchik: folds 
Uncalled bet ($0.37) returned to BlOnDhOlIc
BlOnDhOlIc collected $0.60 from pot
BlOnDhOlIc: doesn't show hand 
*** SUMMARY ***
Total pot $0.60 | Rake $0 
Seat 1: BlOnDhOlIc (button) collected ($0.60)
Seat 2: hirozo (small blind) folded before Flop
Seat 3: Lasutchik (big blind) folded before Flop
Seat 4: kamikkaze folded before Flop (didn't bet)
Seat 5: 123progress folded before Flop (didn't bet)
Seat 6: Ellen1947 folded before Flop (didn't bet)
Seat 7: chiyuki folded before Flop (didn't bet)
Seat 8: fezman folded before Flop (didn't bet)
Seat 9: troms20 folded before Flop (didn't bet)



PokerStars Zoom Hand #84299252251:  Hold'em No Limit ($0.10/$0.25) - 2012/08/05 14:06:58 JST [2012/08/05 1:06:58 ET]
Table 'Whirlpool' 9-max Seat #1 is the button
Seat 1: Dejacob ($25 in chips) 
Seat 2: flyinprits ($44.04 in chips) 
Seat 3: Loholov ($15.60 in chips) 
Seat 4: wtu1986 ($28.13 in chips) 
Seat 5: BlOnDhOlIc ($62.31 in chips) 
Seat 6: 2997qwer ($12.15 in chips) 
Seat 7: Anafim ($12.50 in chips) 
Seat 8: chiyuki ($33.40 in chips) 
Seat 9: kamikkaze ($36.15 in chips) 
flyinprits: posts small blind $0.10
Loholov: posts big blind $0.25
*** HOLE CARDS ***
Dealt to chiyuki [9c 5d]
wtu1986: folds 
BlOnDhOlIc: folds 
2997qwer: folds 
Anafim: folds 
chiyuki: folds 
kamikkaze: folds 
Dejacob: raises $0.50 to $0.75
flyinprits: folds 
Loholov: calls $0.50
*** FLOP *** [Td 4h Qs]
Loholov: checks 
Dejacob: bets $1
Loholov: calls $1
*** TURN *** [Td 4h Qs] [6h]
Loholov: checks 
Dejacob: bets $2.25
Loholov: calls $2.25
*** RIVER *** [Td 4h Qs 6h] [4c]
Loholov: checks 
Dejacob: checks 
*** SHOW DOWN ***
Loholov: shows [Js Ts] (two pair, Tens and Fours)
Dejacob: mucks hand 
Loholov collected $7.74 from pot
*** SUMMARY ***
Total pot $8.10 | Rake $0.36 
Board [Td 4h Qs 6h 4c]
Seat 1: Dejacob (button) mucked [5h Ah]
Seat 2: flyinprits (small blind) folded before Flop
Seat 3: Loholov (big blind) showed [Js Ts] and won ($7.74) with two pair, Tens and Fours
Seat 4: wtu1986 folded before Flop (didn't bet)
Seat 5: BlOnDhOlIc folded before Flop (didn't bet)
Seat 6: 2997qwer folded before Flop (didn't bet)
Seat 7: Anafim folded before Flop (didn't bet)
Seat 8: chiyuki folded before Flop (didn't bet)
Seat 9: kamikkaze folded before Flop (didn't bet)



PokerStars Zoom Hand #84299250185:  Hold'em No Limit ($0.10/$0.25) - 2012/08/05 14:06:50 JST [2012/08/05 1:06:50 ET]
Table 'Whirlpool' 9-max Seat #1 is the button
Seat 1: Anafim ($12.50 in chips) 
Seat 2: troms20 ($24.75 in chips) 
Seat 3: kkbruins0408 ($14.55 in chips) 
Seat 4: Tom1999 ($22.26 in chips) 
Seat 5: chiyuki ($33.40 in chips) 
Seat 6: carlosrbr ($18.64 in chips) 
Seat 7: Roglus ($15.03 in chips) 
Seat 8: puffy5533 ($20.85 in chips) 
Seat 9: seula i ($27.61 in chips) 
troms20: posts small blind $0.10
kkbruins0408: posts big blind $0.25
*** HOLE CARDS ***
Dealt to chiyuki [6h 9d]
Tom1999: folds 
chiyuki: folds 
carlosrbr: raises $0.50 to $0.75
Roglus: folds 
puffy5533: folds 
seula i: folds 
Anafim: folds 
troms20: folds 
kkbruins0408: calls $0.50
*** FLOP *** [7s Qs 6d]
kkbruins0408: checks 
carlosrbr: bets $0.75
kkbruins0408: calls $0.75
*** TURN *** [7s Qs 6d] [2c]
kkbruins0408: checks 
carlosrbr: bets $2
kkbruins0408: calls $2
*** RIVER *** [7s Qs 6d 2c] [4s]
kkbruins0408: checks 
carlosrbr: checks 
*** SHOW DOWN ***
kkbruins0408: shows [7c 5c] (a pair of Sevens)
carlosrbr: shows [Th Qh] (a pair of Queens)
carlosrbr collected $6.78 from pot
*** SUMMARY ***
Total pot $7.10 | Rake $0.32 
Board [7s Qs 6d 2c 4s]
Seat 1: Anafim (button) folded before Flop (didn't bet)
Seat 2: troms20 (small blind) folded before Flop
Seat 3: kkbruins0408 (big blind) showed [7c 5c] and lost with a pair of Sevens
Seat 4: Tom1999 folded before Flop (didn't bet)
Seat 5: chiyuki folded before Flop (didn't bet)
Seat 6: carlosrbr showed [Th Qh] and won ($6.78) with a pair of Queens
Seat 7: Roglus folded before Flop (didn't bet)
Seat 8: puffy5533 folded before Flop (didn't bet)
Seat 9: seula i folded before Flop (didn't bet)



PokerStars Zoom Hand #84299264000:  Hold'em No Limit ($0.10/$0.25) - 2012/08/05 14:07:44 JST [2012/08/05 1:07:44 ET]
Table 'Whirlpool' 9-max Seat #1 is the button
Seat 1: chiyuki ($33.40 in chips) 
Seat 2: 2997qwer ($12.72 in chips) 
Seat 3: giorgos_k ($38.96 in chips) 
Seat 4: carlosrbr ($21.92 in chips) 
Seat 5: cr0lox ($20.90 in chips) 
Seat 6: deadmoneykid ($21.63 in chips) 
Seat 7: munky3 ($38.44 in chips) 
Seat 8: ygoegoe ($35.14 in chips) 
Seat 9: KeLevro0 ($12.15 in chips) 
2997qwer: posts small blind $0.10
giorgos_k: posts big blind $0.25
*** HOLE CARDS ***
Dealt to chiyuki [Qd 5s]
carlosrbr: folds 
cr0lox: folds 
deadmoneykid: folds 
munky3: folds 
ygoegoe: folds 
KeLevro0: raises $0.42 to $0.67
chiyuki: folds 
2997qwer: folds 
giorgos_k: folds 
Uncalled bet ($0.42) returned to KeLevro0
KeLevro0 collected $0.60 from pot
KeLevro0: doesn't show hand 
*** SUMMARY ***
Total pot $0.60 | Rake $0 
Seat 1: chiyuki (button) folded before Flop (didn't bet)
Seat 2: 2997qwer (small blind) folded before Flop
Seat 3: giorgos_k (big blind) folded before Flop
Seat 4: carlosrbr folded before Flop (didn't bet)
Seat 5: cr0lox folded before Flop (didn't bet)
Seat 6: deadmoneykid folded before Flop (didn't bet)
Seat 7: munky3 folded before Flop (didn't bet)
Seat 8: ygoegoe folded before Flop (didn't bet)
Seat 9: KeLevro0 collected ($0.60)



PokerStars Zoom Hand #84299267827:  Hold'em No Limit ($0.10/$0.25) - 2012/08/05 14:07:59 JST [2012/08/05 1:07:59 ET]
Table 'Whirlpool' 9-max Seat #1 is the button
Seat 1: RikkStroken ($31.18 in chips) 
Seat 2: Nec Arg ($40.96 in chips) 
Seat 3: Perstenev ($13.44 in chips) 
Seat 4: BlackZafiro ($45.36 in chips) 
Seat 5: seula i ($27.26 in chips) 
Seat 6: slapshot2011 ($31.75 in chips) 
Seat 7: chiyuki ($33.40 in chips) 
Seat 8: BlOnDhOlIc ($25 in chips) 
Seat 9: giorgos_k ($38.61 in chips) 
Nec Arg: posts small blind $0.10
Perstenev: posts big blind $0.25
*** HOLE CARDS ***
Dealt to chiyuki [6h 2c]
BlackZafiro: folds 
seula i: folds 
slapshot2011: folds 
chiyuki: folds 
BlOnDhOlIc: folds 
giorgos_k: folds 
RikkStroken: raises $0.25 to $0.50
Nec Arg: folds 
Perstenev: folds 
Uncalled bet ($0.25) returned to RikkStroken
RikkStroken collected $0.60 from pot
RikkStroken: doesn't show hand 
*** SUMMARY ***
Total pot $0.60 | Rake $0 
Seat 1: RikkStroken (button) collected ($0.60)
Seat 2: Nec Arg (small blind) folded before Flop
Seat 3: Perstenev (big blind) folded before Flop
Seat 4: BlackZafiro folded before Flop (didn't bet)
Seat 5: seula i folded before Flop (didn't bet)
Seat 6: slapshot2011 folded before Flop (didn't bet)
Seat 7: chiyuki folded before Flop (didn't bet)
Seat 8: BlOnDhOlIc folded before Flop (didn't bet)
Seat 9: giorgos_k folded before Flop (didn't bet)



PokerStars Zoom Hand #84299261938:  Hold'em No Limit ($0.10/$0.25) - 2012/08/05 14:07:36 JST [2012/08/05 1:07:36 ET]
Table 'Whirlpool' 9-max Seat #1 is the button
Seat 1: RomarioJa ($9.85 in chips) 
Seat 2: chiyuki ($33.50 in chips) 
Seat 3: BlOnDhOlIc ($58.20 in chips) 
Seat 4: Nec Arg ($40.86 in chips) 
Seat 5: troms20 ($25 in chips) 
Seat 6: Tom1999 ($9.28 in chips) 
Seat 7: PetitAlejo ($35.46 in chips) 
Seat 8: Nerkit ($15.80 in chips) 
Seat 9: Loholov ($15.58 in chips) 
chiyuki: posts small blind $0.10
BlOnDhOlIc: posts big blind $0.25
*** HOLE CARDS ***
Dealt to chiyuki [6d Jd]
Nec Arg: folds 
troms20: folds 
Tom1999: raises $0.50 to $0.75
PetitAlejo: folds 
Nerkit: folds 
Loholov: folds 
RomarioJa: calls $0.75
chiyuki: folds 
BlOnDhOlIc: folds 
*** FLOP *** [3d 7s 6s]
Tom1999: checks 
RomarioJa: bets $1.20
Tom1999: folds 
Uncalled bet ($1.20) returned to RomarioJa
RomarioJa collected $1.77 from pot
RomarioJa: doesn't show hand 
*** SUMMARY ***
Total pot $1.85 | Rake $0.08 
Board [3d 7s 6s]
Seat 1: RomarioJa (button) collected ($1.77)
Seat 2: chiyuki (small blind) folded before Flop
Seat 3: BlOnDhOlIc (big blind) folded before Flop
Seat 4: Nec Arg folded before Flop (didn't bet)
Seat 5: troms20 folded before Flop (didn't bet)
Seat 6: Tom1999 folded on the Flop
Seat 7: PetitAlejo folded before Flop (didn't bet)
Seat 8: Nerkit folded before Flop (didn't bet)
Seat 9: Loholov folded before Flop (didn't bet)



PokerStars Zoom Hand #84299260882:  Hold'em No Limit ($0.10/$0.25) - 2012/08/05 14:07:32 JST [2012/08/05 1:07:32 ET]
Table 'Whirlpool' 9-max Seat #1 is the button
Seat 1: wtu1986 ($24.65 in chips) 
Seat 2: 123progress ($25.01 in chips) 
Seat 3: fima00000007 ($8.55 in chips) 
Seat 4: chiyuki ($33.50 in chips) 
Seat 5: RikkStroken ($21.22 in chips) 
Seat 6: Dejacob ($25.50 in chips) 
Seat 7: troms20 ($25 in chips) 
Seat 8: Tom1999 ($9.28 in chips) 
Seat 9: 2997qwer ($12.25 in chips) 
123progress: posts small blind $0.10
fima00000007: posts big blind $0.25
*** HOLE CARDS ***
Dealt to chiyuki [9s 2c]
chiyuki: folds 
RikkStroken: folds 
Dejacob: folds 
troms20: folds 
Tom1999: folds 
2997qwer: folds 
wtu1986: raises $0.50 to $0.75
123progress: folds 
fima00000007: calls $0.50
*** FLOP *** [Jc 3c Ac]
fima00000007: checks 
wtu1986: checks 
*** TURN *** [Jc 3c Ac] [Qs]
fima00000007: bets $0.50
wtu1986: calls $0.50
*** RIVER *** [Jc 3c Ac Qs] [Kd]
fima00000007: checks 
wtu1986: checks 
*** SHOW DOWN ***
fima00000007: shows [Jh 6h] (a pair of Jacks)
wtu1986: shows [Kh Qd] (two pair, Kings and Queens)
wtu1986 collected $2.48 from pot
*** SUMMARY ***
Total pot $2.60 | Rake $0.12 
Board [Jc 3c Ac Qs Kd]
Seat 1: wtu1986 (button) showed [Kh Qd] and won ($2.48) with two pair, Kings and Queens
Seat 2: 123progress (small blind) folded before Flop
Seat 3: fima00000007 (big blind) showed [Jh 6h] and lost with a pair of Jacks
Seat 4: chiyuki folded before Flop (didn't bet)
Seat 5: RikkStroken folded before Flop (didn't bet)
Seat 6: Dejacob folded before Flop (didn't bet)
Seat 7: troms20 folded before Flop (didn't bet)
Seat 8: Tom1999 folded before Flop (didn't bet)
Seat 9: 2997qwer folded before Flop (didn't bet)



PokerStars Zoom Hand #84299266523:  Hold'em No Limit ($0.10/$0.25) - 2012/08/05 14:07:54 JST [2012/08/05 1:07:54 ET]
Table 'Whirlpool' 9-max Seat #1 is the button
Seat 1: 123progress ($39.55 in chips) 
Seat 2: Dejacob ($28.44 in chips) 
Seat 3: troms20 ($24.65 in chips) 
Seat 4: BlOnDhOlIc ($57.95 in chips) 
Seat 5: jeff0923 ($23.75 in chips) 
Seat 6: PetitAlejo ($25.64 in chips) 
Seat 7: BlackZafiro ($25 in chips) 
Seat 8: chiyuki ($33.40 in chips) 
Seat 9: Nerkit ($12.50 in chips) 
Dejacob: posts small blind $0.10
troms20: posts big blind $0.25
*** HOLE CARDS ***
Dealt to chiyuki [Ts 7s]
BlOnDhOlIc: folds 
jeff0923: folds 
PetitAlejo: folds 
BlackZafiro: folds 
chiyuki: folds 
Nerkit: folds 
123progress: folds 
Dejacob: folds 
Uncalled bet ($0.15) returned to troms20
troms20 collected $0.20 from pot
troms20: doesn't show hand 
*** SUMMARY ***
Total pot $0.20 | Rake $0 
Seat 1: 123progress (button) folded before Flop (didn't bet)
Seat 2: Dejacob (small blind) folded before Flop
Seat 3: troms20 (big blind) collected ($0.20)
Seat 4: BlOnDhOlIc folded before Flop (didn't bet)
Seat 5: jeff0923 folded before Flop (didn't bet)
Seat 6: PetitAlejo folded before Flop (didn't bet)
Seat 7: BlackZafiro folded before Flop (didn't bet)
Seat 8: chiyuki folded before Flop (didn't bet)
Seat 9: Nerkit folded before Flop (didn't bet)



PokerStars Zoom Hand #84299259818:  Hold'em No Limit ($0.10/$0.25) - 2012/08/05 14:07:28 JST [2012/08/05 1:07:28 ET]
Table 'Whirlpool' 9-max Seat #1 is the button
Seat 1: Ellen1947 ($36.86 in chips) 
Seat 2: Nerkit ($15.90 in chips) 
Seat 3: ChrisCDee ($34.28 in chips) 
Seat 4: chiyuki ($33.50 in chips) 
Seat 5: Déculotter69 ($18.55 in chips) 
Seat 6: GoldNutter ($24.77 in chips) 
Seat 7: Tom1999 ($9.28 in chips) 
Seat 8: Dan Royal ($29.71 in chips) 
Seat 9: softdesign ($74.86 in chips) 
Nerkit: posts small blind $0.10
ChrisCDee: posts big blind $0.25
*** HOLE CARDS ***
Dealt to chiyuki [9c Qd]
chiyuki: folds 
Déculotter69: folds 
GoldNutter: raises $0.25 to $0.50
Tom1999: folds 
Dan Royal: folds 
softdesign: calls $0.50
Ellen1947: calls $0.50
Nerkit: folds 
ChrisCDee: calls $0.25
*** FLOP *** [8s Kc Kd]
ChrisCDee: checks 
GoldNutter: bets $1
softdesign: folds 
Ellen1947: folds 
ChrisCDee: calls $1
*** TURN *** [8s Kc Kd] [4h]
ChrisCDee: checks 
GoldNutter: bets $2
ChrisCDee: folds 
Uncalled bet ($2) returned to GoldNutter
GoldNutter collected $3.92 from pot
GoldNutter: doesn't show hand 
*** SUMMARY ***
Total pot $4.10 | Rake $0.18 
Board [8s Kc Kd 4h]
Seat 1: Ellen1947 (button) folded on the Flop
Seat 2: Nerkit (small blind) folded before Flop
Seat 3: ChrisCDee (big blind) folded on the Turn
Seat 4: chiyuki folded before Flop (didn't bet)
Seat 5: Déculotter69 folded before Flop (didn't bet)
Seat 6: GoldNutter collected ($3.92)
Seat 7: Tom1999 folded before Flop (didn't bet)
Seat 8: Dan Royal folded before Flop (didn't bet)
Seat 9: softdesign folded on the Flop



PokerStars Zoom Hand #84299272923:  Hold'em No Limit ($0.10/$0.25) - 2012/08/05 14:08:19 JST [2012/08/05 1:08:19 ET]
Table 'Whirlpool' 9-max Seat #1 is the button
Seat 1: Th3Fog ($48.71 in chips) 
Seat 2: Tom1999 ($21.16 in chips) 
Seat 3: chiyuki ($33.40 in chips) 
Seat 4: 2997qwer ($12.15 in chips) 
Seat 5: fima00000007 ($7.30 in chips) 
Seat 6: agurio ($25 in chips) 
Seat 7: PakisR ($11.65 in chips) 
Seat 8: puffy5533 ($21.77 in chips) 
Seat 9: RikkStroken ($21.22 in chips) 
Tom1999: posts small blind $0.10
chiyuki: posts big blind $0.25
*** HOLE CARDS ***
Dealt to chiyuki [5d 3c]
2997qwer: folds 
fima00000007: folds 
agurio: folds 
PakisR: folds 
puffy5533: raises $0.50 to $0.75
RikkStroken: folds 
Th3Fog: folds 
Tom1999: folds 
chiyuki: folds 
Uncalled bet ($0.50) returned to puffy5533
puffy5533 collected $0.60 from pot
puffy5533: doesn't show hand 
*** SUMMARY ***
Total pot $0.60 | Rake $0 
Seat 1: Th3Fog (button) folded before Flop (didn't bet)
Seat 2: Tom1999 (small blind) folded before Flop
Seat 3: chiyuki (big blind) folded before Flop
Seat 4: 2997qwer folded before Flop (didn't bet)
Seat 5: fima00000007 folded before Flop (didn't bet)
Seat 6: agurio folded before Flop (didn't bet)
Seat 7: PakisR folded before Flop (didn't bet)
Seat 8: puffy5533 collected ($0.60)
Seat 9: RikkStroken folded before Flop (didn't bet)



PokerStars Zoom Hand #84299270647:  Hold'em No Limit ($0.10/$0.25) - 2012/08/05 14:08:10 JST [2012/08/05 1:08:10 ET]
Table 'Whirlpool' 9-max Seat #1 is the button
Seat 1: Dan Royal ($29.36 in chips) 
Seat 2: kamikkaze ($18.13 in chips) 
Seat 3: KeLevro0 ($12.50 in chips) 
Seat 4: flyinprits ($43.69 in chips) 
Seat 5: Loholov ($15.58 in chips) 
Seat 6: BlOnDhOlIc ($25 in chips) 
Seat 7: Th3Fog ($48.71 in chips) 
Seat 8: troms20 ($22.65 in chips) 
Seat 9: chiyuki ($33.40 in chips) 
kamikkaze: posts small blind $0.10
KeLevro0: posts big blind $0.25
*** HOLE CARDS ***
Dealt to chiyuki [9c 4d]
flyinprits: raises $0.50 to $0.75
Loholov: raises $1.75 to $2.50
BlOnDhOlIc: folds 
Th3Fog: folds 
troms20: folds 
chiyuki: folds 
Dan Royal: folds 
kamikkaze: folds 
KeLevro0: folds 
flyinprits: calls $1.75
*** FLOP *** [2h 2s Jc]
flyinprits: checks 
Loholov: bets $3.75
flyinprits: folds 
Uncalled bet ($3.75) returned to Loholov
Loholov collected $5.11 from pot
Loholov: doesn't show hand 
*** SUMMARY ***
Total pot $5.35 | Rake $0.24 
Board [2h 2s Jc]
Seat 1: Dan Royal (button) folded before Flop (didn't bet)
Seat 2: kamikkaze (small blind) folded before Flop
Seat 3: KeLevro0 (big blind) folded before Flop
Seat 4: flyinprits folded on the Flop
Seat 5: Loholov collected ($5.11)
Seat 6: BlOnDhOlIc folded before Flop (didn't bet)
Seat 7: Th3Fog folded before Flop (didn't bet)
Seat 8: troms20 folded before Flop (didn't bet)
Seat 9: chiyuki folded before Flop (didn't bet)



PokerStars Zoom Hand #84299268867:  Hold'em No Limit ($0.10/$0.25) - 2012/08/05 14:08:03 JST [2012/08/05 1:08:03 ET]
Table 'Whirlpool' 9-max Seat #1 is the button
Seat 1: Spartacus675 ($24.65 in chips) 
Seat 2: Ellen1947 ($29.90 in chips) 
Seat 3: eyesJeJa ($25 in chips) 
Seat 4: kamikkaze ($35.05 in chips) 
Seat 5: troms20 ($22.65 in chips) 
Seat 6: chiyuki ($33.40 in chips) 
Seat 7: BlOnDhOlIc ($25 in chips) 
Seat 8: sparky5224 ($23 in chips) 
Seat 9: Wilcox76607 ($15.09 in chips) 
Ellen1947: posts small blind $0.10
eyesJeJa: posts big blind $0.25
*** HOLE CARDS ***
Dealt to chiyuki [Qc 8h]
kamikkaze: folds 
troms20: folds 
chiyuki: folds 
BlOnDhOlIc: folds 
sparky5224: calls $0.25
Wilcox76607: raises $0.50 to $0.75
Spartacus675: folds 
Ellen1947: raises $2.55 to $3.30
eyesJeJa: folds 
sparky5224: folds 
Wilcox76607: folds 
Uncalled bet ($2.55) returned to Ellen1947
Ellen1947 collected $2 from pot
Ellen1947: doesn't show hand 
*** SUMMARY ***
Total pot $2 | Rake $0 
Seat 1: Spartacus675 (button) folded before Flop (didn't bet)
Seat 2: Ellen1947 (small blind) collected ($2)
Seat 3: eyesJeJa (big blind) folded before Flop
Seat 4: kamikkaze folded before Flop (didn't bet)
Seat 5: troms20 folded before Flop (didn't bet)
Seat 6: chiyuki folded before Flop (didn't bet)
Seat 7: BlOnDhOlIc folded before Flop (didn't bet)
Seat 8: sparky5224 folded before Flop
Seat 9: Wilcox76607 folded before Flop



PokerStars Zoom Hand #84299278135:  Hold'em No Limit ($0.10/$0.25) - 2012/08/05 14:08:40 JST [2012/08/05 1:08:40 ET]
Table 'Whirlpool' 9-max Seat #1 is the button
Seat 1: Nerkit ($8.75 in chips) 
Seat 2: chiyuki ($33.15 in chips) 
Seat 3: agurio ($27.17 in chips) 
Seat 4: troms20 ($25 in chips) 
Seat 5: Perstenev ($11.87 in chips) 
Seat 6: ChrisCDee ($55.22 in chips) 
Seat 7: kamikkaze ($18.03 in chips) 
Seat 8: kkbruins0408 ($10.30 in chips) 
Seat 9: Loholov ($17.76 in chips) 
chiyuki: posts small blind $0.10
agurio: posts big blind $0.25
*** HOLE CARDS ***
Dealt to chiyuki [Jc 2d]
troms20: folds 
Perstenev: folds 
ChrisCDee: folds 
kamikkaze: folds 
kkbruins0408: folds 
Loholov: folds 
Nerkit: folds 
chiyuki: folds 
Uncalled bet ($0.15) returned to agurio
agurio collected $0.20 from pot
agurio: doesn't show hand 
*** SUMMARY ***
Total pot $0.20 | Rake $0 
Seat 1: Nerkit (button) folded before Flop (didn't bet)
Seat 2: chiyuki (small blind) folded before Flop
Seat 3: agurio (big blind) collected ($0.20)
Seat 4: troms20 folded before Flop (didn't bet)
Seat 5: Perstenev folded before Flop (didn't bet)
Seat 6: ChrisCDee folded before Flop (didn't bet)
Seat 7: kamikkaze folded before Flop (didn't bet)
Seat 8: kkbruins0408 folded before Flop (didn't bet)
Seat 9: Loholov folded before Flop (didn't bet)



PokerStars Zoom Hand #84299283597:  Hold'em No Limit ($0.10/$0.25) - 2012/08/05 14:09:01 JST [2012/08/05 1:09:01 ET]
Table 'Whirlpool' 9-max Seat #1 is the button
Seat 1: chiyuki ($33.05 in chips) 
Seat 2: Tom1999 ($7.38 in chips) 
Seat 3: puffy5533 ($22.02 in chips) 
Seat 4: Loholov ($18.19 in chips) 
Seat 5: RomarioJa ($10.87 in chips) 
Seat 6: Landybob ($37.16 in chips) 
Seat 7: BlackZafiro ($45.26 in chips) 
Seat 8: ll_LaMeR_ll ($65.16 in chips) 
Seat 9: PetitAlejo ($34.51 in chips) 
Tom1999: posts small blind $0.10
puffy5533: posts big blind $0.25
*** HOLE CARDS ***
Dealt to chiyuki [3c 4s]
Loholov: folds 
RomarioJa: folds 
Landybob: folds 
BlackZafiro: folds 
ll_LaMeR_ll: folds 
PetitAlejo: folds 
chiyuki: folds 
Tom1999: folds 
Uncalled bet ($0.15) returned to puffy5533
puffy5533 collected $0.20 from pot
puffy5533: doesn't show hand 
*** SUMMARY ***
Total pot $0.20 | Rake $0 
Seat 1: chiyuki (button) folded before Flop (didn't bet)
Seat 2: Tom1999 (small blind) folded before Flop
Seat 3: puffy5533 (big blind) collected ($0.20)
Seat 4: Loholov folded before Flop (didn't bet)
Seat 5: RomarioJa folded before Flop (didn't bet)
Seat 6: Landybob folded before Flop (didn't bet)
Seat 7: BlackZafiro folded before Flop (didn't bet)
Seat 8: ll_LaMeR_ll folded before Flop (didn't bet)
Seat 9: PetitAlejo folded before Flop (didn't bet)



PokerStars Zoom Hand #84299285932:  Hold'em No Limit ($0.10/$0.25) - 2012/08/05 14:09:10 JST [2012/08/05 1:09:10 ET]
Table 'Whirlpool' 9-max Seat #1 is the button
Seat 1: simonzez ($51.35 in chips) 
Seat 2: troms20 ($24.75 in chips) 
Seat 3: Csabee21 ($22.04 in chips) 
Seat 4: 2997qwer ($12.90 in chips) 
Seat 5: KeLevro0 ($15.83 in chips) 
Seat 6: chiyuki ($33.05 in chips) 
Seat 7: Perstenev ($11.50 in chips) 
Seat 8: agurio ($27.27 in chips) 
Seat 9: kamikkaze ($17.40 in chips) 
troms20: posts small blind $0.10
Csabee21: posts big blind $0.25
*** HOLE CARDS ***
Dealt to chiyuki [Tc 8s]
2997qwer: folds 
KeLevro0: folds 
chiyuki: folds 
Perstenev: folds 
agurio: raises $0.75 to $1
kamikkaze: folds 
simonzez: folds 
troms20: folds 
Csabee21: folds 
Uncalled bet ($0.75) returned to agurio
agurio collected $0.60 from pot
agurio: doesn't show hand 
*** SUMMARY ***
Total pot $0.60 | Rake $0 
Seat 1: simonzez (button) folded before Flop (didn't bet)
Seat 2: troms20 (small blind) folded before Flop
Seat 3: Csabee21 (big blind) folded before Flop
Seat 4: 2997qwer folded before Flop (didn't bet)
Seat 5: KeLevro0 folded before Flop (didn't bet)
Seat 6: chiyuki folded before Flop (didn't bet)
Seat 7: Perstenev folded before Flop (didn't bet)
Seat 8: agurio collected ($0.60)
Seat 9: kamikkaze folded before Flop (didn't bet)



PokerStars Zoom Hand #84299287578:  Hold'em No Limit ($0.10/$0.25) - 2012/08/05 14:09:16 JST [2012/08/05 1:09:16 ET]
Table 'Whirlpool' 9-max Seat #1 is the button
Seat 1: troms20 ($22.30 in chips) 
Seat 2: fezman ($16.76 in chips) 
Seat 3: Spartacus675 ($25.57 in chips) 
Seat 4: GoldNutter ($26.44 in chips) 
Seat 5: roksmokndonk ($31.83 in chips) 
Seat 6: Anafim ($12.50 in chips) 
Seat 7: chiyuki ($33.05 in chips) 
Seat 8: 2997qwer ($8.25 in chips) 
Seat 9: eyesJeJa ($25 in chips) 
fezman: posts small blind $0.10
Spartacus675: posts big blind $0.25
*** HOLE CARDS ***
Dealt to chiyuki [2d 9d]
GoldNutter: folds 
roksmokndonk: folds 
Anafim: folds 
chiyuki: folds 
2997qwer: folds 
eyesJeJa: folds 
troms20: folds 
fezman: raises $0.50 to $0.75
Spartacus675: folds 
Uncalled bet ($0.50) returned to fezman
fezman collected $0.50 from pot
fezman: doesn't show hand 
*** SUMMARY ***
Total pot $0.50 | Rake $0 
Seat 1: troms20 (button) folded before Flop (didn't bet)
Seat 2: fezman (small blind) collected ($0.50)
Seat 3: Spartacus675 (big blind) folded before Flop
Seat 4: GoldNutter folded before Flop (didn't bet)
Seat 5: roksmokndonk folded before Flop (didn't bet)
Seat 6: Anafim folded before Flop (didn't bet)
Seat 7: chiyuki folded before Flop (didn't bet)
Seat 8: 2997qwer folded before Flop (didn't bet)
Seat 9: eyesJeJa folded before Flop (didn't bet)



PokerStars Zoom Hand #84299288615:  Hold'em No Limit ($0.10/$0.25) - 2012/08/05 14:09:20 JST [2012/08/05 1:09:20 ET]
Table 'Whirlpool' 9-max Seat #1 is the button
Seat 1: puffy5533 ($22.12 in chips) 
Seat 2: 2997qwer ($8.25 in chips) 
Seat 3: KeLevro0 ($12.50 in chips) 
Seat 4: roksmokndonk ($31.83 in chips) 
Seat 5: Loholov ($17.94 in chips) 
Seat 6: seula i ($26.26 in chips) 
Seat 7: troms20 ($22.30 in chips) 
Seat 8: RomarioJa ($9.37 in chips) 
Seat 9: chiyuki ($33.05 in chips) 
2997qwer: posts small blind $0.10
KeLevro0: posts big blind $0.25
*** HOLE CARDS ***
Dealt to chiyuki [7d Jd]
roksmokndonk: folds 
Loholov: folds 
seula i: folds 
troms20: folds 
RomarioJa: folds 
chiyuki: folds 
puffy5533: raises $0.50 to $0.75
2997qwer: folds 
KeLevro0: folds 
Uncalled bet ($0.50) returned to puffy5533
puffy5533 collected $0.60 from pot
puffy5533: doesn't show hand 
*** SUMMARY ***
Total pot $0.60 | Rake $0 
Seat 1: puffy5533 (button) collected ($0.60)
Seat 2: 2997qwer (small blind) folded before Flop
Seat 3: KeLevro0 (big blind) folded before Flop
Seat 4: roksmokndonk folded before Flop (didn't bet)
Seat 5: Loholov folded before Flop (didn't bet)
Seat 6: seula i folded before Flop (didn't bet)
Seat 7: troms20 folded before Flop (didn't bet)
Seat 8: RomarioJa folded before Flop (didn't bet)
Seat 9: chiyuki folded before Flop (didn't bet)



PokerStars Zoom Hand #84299289657:  Hold'em No Limit ($0.10/$0.25) - 2012/08/05 14:09:24 JST [2012/08/05 1:09:24 ET]
Table 'Whirlpool' 9-max Seat #1 is the button
Seat 1: PetitAlejo ($35.46 in chips) 
Seat 2: flyinprits ($36.59 in chips) 
Seat 3: Lasutchik ($34.11 in chips) 
Seat 4: Vahe50 ($9.95 in chips) 
Seat 5: chiyuki ($33.05 in chips) 
Seat 6: roksmokndonk ($31.83 in chips) 
Seat 7: RomarioJa ($9.37 in chips) 
Seat 8: Th3Fog ($23.50 in chips) 
Seat 9: kamikkaze ($14.82 in chips) 
flyinprits: posts small blind $0.10
Lasutchik: posts big blind $0.25
*** HOLE CARDS ***
Dealt to chiyuki [Kh 9d]
Vahe50: folds 
chiyuki: folds 
roksmokndonk: folds 
RomarioJa: folds 
Th3Fog: raises $0.47 to $0.72
kamikkaze: raises $14.10 to $14.82 and is all-in
PetitAlejo: folds 
flyinprits: folds 
Lasutchik: folds 
Th3Fog: folds 
Uncalled bet ($14.10) returned to kamikkaze
kamikkaze collected $1.79 from pot
kamikkaze: doesn't show hand 
*** SUMMARY ***
Total pot $1.79 | Rake $0 
Seat 1: PetitAlejo (button) folded before Flop (didn't bet)
Seat 2: flyinprits (small blind) folded before Flop
Seat 3: Lasutchik (big blind) folded before Flop
Seat 4: Vahe50 folded before Flop (didn't bet)
Seat 5: chiyuki folded before Flop (didn't bet)
Seat 6: roksmokndonk folded before Flop (didn't bet)
Seat 7: RomarioJa folded before Flop (didn't bet)
Seat 8: Th3Fog folded before Flop
Seat 9: kamikkaze collected ($1.79)



PokerStars Zoom Hand #84299292503:  Hold'em No Limit ($0.10/$0.25) - 2012/08/05 14:09:35 JST [2012/08/05 1:09:35 ET]
Table 'Whirlpool' 9-max Seat #1 is the button
Seat 1: deadmoneykid ($25 in chips) 
Seat 2: Dan Royal ($31.41 in chips) 
Seat 3: seula i ($31.90 in chips) 
Seat 4: roksmokndonk ($31.83 in chips) 
Seat 5: giorgos_k ($38.43 in chips) 
Seat 6: RomarioJa ($11.96 in chips) 
Seat 7: wtu1986 ($29.08 in chips) 
Seat 8: chiyuki ($33.05 in chips) 
Seat 9: BlOnDhOlIc ($26.24 in chips) 
Dan Royal: posts small blind $0.10
seula i: posts big blind $0.25
*** HOLE CARDS ***
Dealt to chiyuki [Jd Ad]
roksmokndonk: folds 
giorgos_k: folds 
RomarioJa: folds 
wtu1986: folds 
chiyuki: raises $0.50 to $0.75
BlOnDhOlIc: calls $0.75
deadmoneykid: folds 
Dan Royal: folds 
seula i: folds 
*** FLOP *** [Js 2d Qd]
chiyuki: bets $1
BlOnDhOlIc: raises $1.50 to $2.50
chiyuki: raises $4 to $6.50
BlOnDhOlIc: folds 
Uncalled bet ($4) returned to chiyuki
chiyuki collected $6.54 from pot
chiyuki: doesn't show hand 
*** SUMMARY ***
Total pot $6.85 | Rake $0.31 
Board [Js 2d Qd]
Seat 1: deadmoneykid (button) folded before Flop (didn't bet)
Seat 2: Dan Royal (small blind) folded before Flop
Seat 3: seula i (big blind) folded before Flop
Seat 4: roksmokndonk folded before Flop (didn't bet)
Seat 5: giorgos_k folded before Flop (didn't bet)
Seat 6: RomarioJa folded before Flop (didn't bet)
Seat 7: wtu1986 folded before Flop (didn't bet)
Seat 8: chiyuki collected ($6.54)
Seat 9: BlOnDhOlIc folded on the Flop



PokerStars Zoom Hand #84299291188:  Hold'em No Limit ($0.10/$0.25) - 2012/08/05 14:09:30 JST [2012/08/05 1:09:30 ET]
Table 'Whirlpool' 9-max Seat #1 is the button
Seat 1: 2997qwer ($8.15 in chips) 
Seat 2: slapshot2011 ($31.77 in chips) 
Seat 3: Vahe50 ($9.95 in chips) 
Seat 4: flyinprits ($36.49 in chips) 
Seat 5: chiyuki ($33.05 in chips) 
Seat 6: ygoegoe ($28.21 in chips) 
Seat 7: roksmokndonk ($31.83 in chips) 
Seat 8: BlOnDhOlIc ($45.91 in chips) 
Seat 9: hirozo ($29.57 in chips) 
slapshot2011: posts small blind $0.10
Vahe50: posts big blind $0.25
*** HOLE CARDS ***
Dealt to chiyuki [Th 5c]
flyinprits: raises $0.75 to $1
chiyuki: folds 
ygoegoe: folds 
roksmokndonk: folds 
BlOnDhOlIc: folds 
hirozo: folds 
2997qwer: folds 
slapshot2011: calls $0.90
Vahe50: folds 
*** FLOP *** [6c 6s 4d]
slapshot2011: checks 
flyinprits: checks 
*** TURN *** [6c 6s 4d] [2d]
slapshot2011: bets $1
flyinprits: folds 
Uncalled bet ($1) returned to slapshot2011
slapshot2011 collected $2.15 from pot
slapshot2011: doesn't show hand 
*** SUMMARY ***
Total pot $2.25 | Rake $0.10 
Board [6c 6s 4d 2d]
Seat 1: 2997qwer (button) folded before Flop (didn't bet)
Seat 2: slapshot2011 (small blind) collected ($2.15)
Seat 3: Vahe50 (big blind) folded before Flop
Seat 4: flyinprits folded on the Turn
Seat 5: chiyuki folded before Flop (didn't bet)
Seat 6: ygoegoe folded before Flop (didn't bet)
Seat 7: roksmokndonk folded before Flop (didn't bet)
Seat 8: BlOnDhOlIc folded before Flop (didn't bet)
Seat 9: hirozo folded before Flop (didn't bet)



PokerStars Zoom Hand #84299303142:  Hold'em No Limit ($0.10/$0.25) - 2012/08/05 14:10:17 JST [2012/08/05 1:10:17 ET]
Table 'Whirlpool' 9-max Seat #1 is the button
Seat 1: 123progress ($25.01 in chips) 
Seat 2: ygoegoe ($38.89 in chips) 
Seat 3: Nerkit ($12.21 in chips) 
Seat 4: chiyuki ($36.34 in chips) 
Seat 5: ladymadon107 ($6.58 in chips) 
Seat 6: RomarioJa ($12.50 in chips) 
Seat 7: Th3Fog ($47.14 in chips) 
Seat 8: ChrisCDee ($55.97 in chips) 
Seat 9: Noviekid ($40.51 in chips) 
ygoegoe: posts small blind $0.10
Nerkit: posts big blind $0.25
*** HOLE CARDS ***
Dealt to chiyuki [Kh Kd]
chiyuki: raises $0.50 to $0.75
ladymadon107: folds 
RomarioJa: folds 
Th3Fog: folds 
ChrisCDee: calls $0.75
Noviekid: folds 
123progress: folds 
ygoegoe: folds 
Nerkit: folds 
*** FLOP *** [5c 9d Ah]
chiyuki: checks 
ChrisCDee: bets $1.06
chiyuki: folds 
Uncalled bet ($1.06) returned to ChrisCDee
ChrisCDee collected $1.77 from pot
ChrisCDee: doesn't show hand 
*** SUMMARY ***
Total pot $1.85 | Rake $0.08 
Board [5c 9d Ah]
Seat 1: 123progress (button) folded before Flop (didn't bet)
Seat 2: ygoegoe (small blind) folded before Flop
Seat 3: Nerkit (big blind) folded before Flop
Seat 4: chiyuki folded on the Flop
Seat 5: ladymadon107 folded before Flop (didn't bet)
Seat 6: RomarioJa folded before Flop (didn't bet)
Seat 7: Th3Fog folded before Flop (didn't bet)
Seat 8: ChrisCDee collected ($1.77)
Seat 9: Noviekid folded before Flop (didn't bet)



PokerStars Zoom Hand #84299315531:  Hold'em No Limit ($0.10/$0.25) - 2012/08/05 14:11:07 JST [2012/08/05 1:11:07 ET]
Table 'Whirlpool' 9-max Seat #1 is the button
Seat 1: KeLevro0 ($9.95 in chips) 
Seat 2: acamrash ($14.64 in chips) 
Seat 3: chiyuki ($35.59 in chips) 
Seat 4: Tom1999 ($21.33 in chips) 
Seat 5: PetitAlejo ($35.46 in chips) 
Seat 6: Déculotter69 ($15.32 in chips) 
Seat 7: ladymadon107 ($5.83 in chips) 
Seat 8: smartrisk15 ($5.96 in chips) 
Seat 9: 2997qwer ($12.27 in chips) 
acamrash: posts small blind $0.10
chiyuki: posts big blind $0.25
*** HOLE CARDS ***
Dealt to chiyuki [5s 3d]
Tom1999: folds 
PetitAlejo: folds 
Déculotter69: folds 
ladymadon107: folds 
smartrisk15: folds 
2997qwer: folds 
KeLevro0: folds 
acamrash: folds 
Uncalled bet ($0.15) returned to chiyuki
chiyuki collected $0.20 from pot
chiyuki: doesn't show hand 
*** SUMMARY ***
Total pot $0.20 | Rake $0 
Seat 1: KeLevro0 (button) folded before Flop (didn't bet)
Seat 2: acamrash (small blind) folded before Flop
Seat 3: chiyuki (big blind) collected ($0.20)
Seat 4: Tom1999 folded before Flop (didn't bet)
Seat 5: PetitAlejo folded before Flop (didn't bet)
Seat 6: Déculotter69 folded before Flop (didn't bet)
Seat 7: ladymadon107 folded before Flop (didn't bet)
Seat 8: smartrisk15 folded before Flop (didn't bet)
Seat 9: 2997qwer folded before Flop (didn't bet)



PokerStars Zoom Hand #84299320108:  Hold'em No Limit ($0.10/$0.25) - 2012/08/05 14:11:25 JST [2012/08/05 1:11:25 ET]
Table 'Whirlpool' 9-max Seat #1 is the button
Seat 1: 2997qwer ($12.27 in chips) 
Seat 2: chiyuki ($35.69 in chips) 
Seat 3: wildy29 ($32.72 in chips) 
Seat 4: eyesJeJa ($26.80 in chips) 
Seat 5: softdesign ($75.14 in chips) 
Seat 6: KeLevro0 ($9.95 in chips) 
Seat 7: silvno31 ($34.72 in chips) 
Seat 8: PetitAlejo ($33.66 in chips) 
Seat 9: acamrash ($14.35 in chips) 
chiyuki: posts small blind $0.10
wildy29: posts big blind $0.25
*** HOLE CARDS ***
Dealt to chiyuki [8d Js]
eyesJeJa: folds 
softdesign: folds 
KeLevro0: raises $0.42 to $0.67
silvno31: folds 
PetitAlejo: folds 
acamrash: folds 
2997qwer: folds 
chiyuki: folds 
wildy29: calls $0.42
*** FLOP *** [Jh 9d 6c]
wildy29: bets $0.25
KeLevro0: raises $1 to $1.25
wildy29: folds 
Uncalled bet ($1) returned to KeLevro0
KeLevro0 collected $1.85 from pot
KeLevro0: doesn't show hand 
*** SUMMARY ***
Total pot $1.94 | Rake $0.09 
Board [Jh 9d 6c]
Seat 1: 2997qwer (button) folded before Flop (didn't bet)
Seat 2: chiyuki (small blind) folded before Flop
Seat 3: wildy29 (big blind) folded on the Flop
Seat 4: eyesJeJa folded before Flop (didn't bet)
Seat 5: softdesign folded before Flop (didn't bet)
Seat 6: KeLevro0 collected ($1.85)
Seat 7: silvno31 folded before Flop (didn't bet)
Seat 8: PetitAlejo folded before Flop (didn't bet)
Seat 9: acamrash folded before Flop (didn't bet)



PokerStars Zoom Hand #84299325226:  Hold'em No Limit ($0.10/$0.25) - 2012/08/05 14:11:45 JST [2012/08/05 1:11:45 ET]
Table 'Whirlpool' 9-max Seat #1 is the button
Seat 1: BlOnDhOlIc ($51.25 in chips) 
Seat 2: RomarioJa ($9.65 in chips) 
Seat 3: KeLevro0 ($11.80 in chips) 
Seat 4: deadmoneykid ($23.05 in chips) 
Seat 5: ChrisCDee ($30.43 in chips) 
Seat 6: chiyuki ($35.59 in chips) 
Seat 7: troms20 ($24.65 in chips) 
Seat 8: Paranoix1990 ($23.18 in chips) 
Seat 9: 4ydo yogurt ($23.84 in chips) 
RomarioJa: posts small blind $0.10
KeLevro0: posts big blind $0.25
*** HOLE CARDS ***
Dealt to chiyuki [Qc 7c]
deadmoneykid has timed out
deadmoneykid: folds 
ChrisCDee: folds 
chiyuki: folds 
troms20: folds 
Paranoix1990: folds 
4ydo yogurt: folds 
BlOnDhOlIc: raises $0.25 to $0.50
RomarioJa: folds 
KeLevro0: folds 
Uncalled bet ($0.25) returned to BlOnDhOlIc
BlOnDhOlIc collected $0.60 from pot
BlOnDhOlIc: doesn't show hand 
*** SUMMARY ***
Total pot $0.60 | Rake $0 
Seat 1: BlOnDhOlIc (button) collected ($0.60)
Seat 2: RomarioJa (small blind) folded before Flop
Seat 3: KeLevro0 (big blind) folded before Flop
Seat 4: deadmoneykid folded before Flop (didn't bet)
Seat 5: ChrisCDee folded before Flop (didn't bet)
Seat 6: chiyuki folded before Flop (didn't bet)
Seat 7: troms20 folded before Flop (didn't bet)
Seat 8: Paranoix1990 folded before Flop (didn't bet)
Seat 9: 4ydo yogurt folded before Flop (didn't bet)



PokerStars Zoom Hand #84299326479:  Hold'em No Limit ($0.10/$0.25) - 2012/08/05 14:11:50 JST [2012/08/05 1:11:50 ET]
Table 'Whirlpool' 9-max Seat #1 is the button
Seat 1: chiyuki ($35.59 in chips) 
Seat 2: wtu1986 ($29.08 in chips) 
Seat 3: acamrash ($14.35 in chips) 
Seat 4: seula i ($31.30 in chips) 
Seat 5: Perstenev ($21.42 in chips) 
Seat 6: Roglus ($29.63 in chips) 
Seat 7: Spartacus675 ($25.42 in chips) 
Seat 8: phate-1up ($25 in chips) 
Seat 9: Paranoix1990 ($23.18 in chips) 
wtu1986: posts small blind $0.10
acamrash: posts big blind $0.25
*** HOLE CARDS ***
Dealt to chiyuki [Qs Kd]
seula i: folds 
Perstenev: folds 
Roglus: folds 
Spartacus675: folds 
phate-1up: folds 
Paranoix1990: folds 
chiyuki: raises $0.50 to $0.75
wtu1986: folds 
acamrash: folds 
Uncalled bet ($0.50) returned to chiyuki
chiyuki collected $0.60 from pot
chiyuki: doesn't show hand 
*** SUMMARY ***
Total pot $0.60 | Rake $0 
Seat 1: chiyuki (button) collected ($0.60)
Seat 2: wtu1986 (small blind) folded before Flop
Seat 3: acamrash (big blind) folded before Flop
Seat 4: seula i folded before Flop (didn't bet)
Seat 5: Perstenev folded before Flop (didn't bet)
Seat 6: Roglus folded before Flop (didn't bet)
Seat 7: Spartacus675 folded before Flop (didn't bet)
Seat 8: phate-1up folded before Flop (didn't bet)
Seat 9: Paranoix1990 folded before Flop (didn't bet)



PokerStars Zoom Hand #84299332910:  Hold'em No Limit ($0.10/$0.25) - 2012/08/05 14:12:15 JST [2012/08/05 1:12:15 ET]
Table 'Whirlpool' 9-max Seat #1 is the button
Seat 1: Roglus ($81 in chips) 
Seat 2: leo2095 ($13.72 in chips) 
Seat 3: KeLevro0 ($10.88 in chips) 
Seat 4: Th3Fog ($16.77 in chips) 
Seat 5: eyesJeJa ($25 in chips) 
Seat 6: silvno31 ($44.92 in chips) 
Seat 7: chiyuki ($35.94 in chips) 
Seat 8: RomarioJa ($9.55 in chips) 
Seat 9: kamikkaze ($14.85 in chips) 
leo2095: posts small blind $0.10
KeLevro0: posts big blind $0.25
*** HOLE CARDS ***
Dealt to chiyuki [7s Ah]
Th3Fog: folds 
eyesJeJa: raises $0.50 to $0.75
silvno31: folds 
chiyuki: folds 
RomarioJa: folds 
kamikkaze: folds 
Roglus: folds 
leo2095: folds 
KeLevro0: folds 
Uncalled bet ($0.50) returned to eyesJeJa
eyesJeJa collected $0.60 from pot
eyesJeJa: doesn't show hand 
*** SUMMARY ***
Total pot $0.60 | Rake $0 
Seat 1: Roglus (button) folded before Flop (didn't bet)
Seat 2: leo2095 (small blind) folded before Flop
Seat 3: KeLevro0 (big blind) folded before Flop
Seat 4: Th3Fog folded before Flop (didn't bet)
Seat 5: eyesJeJa collected ($0.60)
Seat 6: silvno31 folded before Flop (didn't bet)
Seat 7: chiyuki folded before Flop (didn't bet)
Seat 8: RomarioJa folded before Flop (didn't bet)
Seat 9: kamikkaze folded before Flop (didn't bet)



PokerStars Zoom Hand #84299333937:  Hold'em No Limit ($0.10/$0.25) - 2012/08/05 14:12:20 JST [2012/08/05 1:12:20 ET]
Table 'Whirlpool' 9-max Seat #1 is the button
Seat 1: silvno31 ($44.92 in chips) 
Seat 2: wtu1986 ($31.62 in chips) 
Seat 3: taksist889 ($38.81 in chips) 
Seat 4: kamikkaze ($14.85 in chips) 
Seat 5: chiyuki ($35.94 in chips) 
Seat 6: BlOnDhOlIc ($51.60 in chips) 
Seat 7: leo2095 ($13.62 in chips) 
Seat 8: Tom1999 ($11.98 in chips) 
Seat 9: RomarioJa ($11.61 in chips) 
wtu1986: posts small blind $0.10
taksist889: posts big blind $0.25
*** HOLE CARDS ***
Dealt to chiyuki [2h Th]
kamikkaze: folds 
chiyuki: folds 
BlOnDhOlIc: folds 
leo2095: folds 
Tom1999: folds 
RomarioJa: folds 
silvno31: folds 
wtu1986: folds 
Uncalled bet ($0.15) returned to taksist889
taksist889 collected $0.20 from pot
taksist889: doesn't show hand 
*** SUMMARY ***
Total pot $0.20 | Rake $0 
Seat 1: silvno31 (button) folded before Flop (didn't bet)
Seat 2: wtu1986 (small blind) folded before Flop
Seat 3: taksist889 (big blind) collected ($0.20)
Seat 4: kamikkaze folded before Flop (didn't bet)
Seat 5: chiyuki folded before Flop (didn't bet)
Seat 6: BlOnDhOlIc folded before Flop (didn't bet)
Seat 7: leo2095 folded before Flop (didn't bet)
Seat 8: Tom1999 folded before Flop (didn't bet)
Seat 9: RomarioJa folded before Flop (didn't bet)



PokerStars Zoom Hand #84299335477:  Hold'em No Limit ($0.10/$0.25) - 2012/08/05 14:12:26 JST [2012/08/05 1:12:26 ET]
Table 'Whirlpool' 9-max Seat #1 is the button
Seat 1: Dejacob ($25 in chips) 
Seat 2: softdesign ($74.67 in chips) 
Seat 3: Perstenev ($18.11 in chips) 
Seat 4: ChrisCDee ($30.43 in chips) 
Seat 5: jeff0923 ($25 in chips) 
Seat 6: agurio ($28.96 in chips) 
Seat 7: Tom1999 ($11.98 in chips) 
Seat 8: Dan Royal ($32.24 in chips) 
Seat 9: chiyuki ($35.94 in chips) 
softdesign: posts small blind $0.10
Perstenev: posts big blind $0.25
*** HOLE CARDS ***
Dealt to chiyuki [Ah 2d]
ChrisCDee: folds 
jeff0923: folds 
agurio: folds 
Tom1999: folds 
Dan Royal: folds 
chiyuki: folds 
Dejacob: folds 
softdesign: folds 
Uncalled bet ($0.15) returned to Perstenev
Perstenev collected $0.20 from pot
Perstenev: doesn't show hand 
*** SUMMARY ***
Total pot $0.20 | Rake $0 
Seat 1: Dejacob (button) folded before Flop (didn't bet)
Seat 2: softdesign (small blind) folded before Flop
Seat 3: Perstenev (big blind) collected ($0.20)
Seat 4: ChrisCDee folded before Flop (didn't bet)
Seat 5: jeff0923 folded before Flop (didn't bet)
Seat 6: agurio folded before Flop (didn't bet)
Seat 7: Tom1999 folded before Flop (didn't bet)
Seat 8: Dan Royal folded before Flop (didn't bet)
Seat 9: chiyuki folded before Flop (didn't bet)



PokerStars Zoom Hand #84299336218:  Hold'em No Limit ($0.10/$0.25) - 2012/08/05 14:12:29 JST [2012/08/05 1:12:29 ET]
Table 'Whirlpool' 9-max Seat #1 is the button
Seat 1: chiyuki ($35.94 in chips) 
Seat 2: 4thepeople ($19.55 in chips) 
Seat 3: hirozo ($25 in chips) 
Seat 4: wtu1986 ($31.52 in chips) 
Seat 5: kamikkaze ($15.37 in chips) 
Seat 6: RomarioJa ($12.50 in chips) 
Seat 7: DONK1967 ($24.63 in chips) 
Seat 8: Anafim ($12.50 in chips) 
Seat 9: eyesJeJa ($25.25 in chips) 
4thepeople: posts small blind $0.10
hirozo: posts big blind $0.25
*** HOLE CARDS ***
Dealt to chiyuki [7h 5s]
wtu1986: folds 
kamikkaze: folds 
RomarioJa: folds 
DONK1967: folds 
Anafim: folds 
eyesJeJa: folds 
chiyuki: folds 
4thepeople: calls $0.15
hirozo: checks 
*** FLOP *** [8s 8h 3d]
4thepeople: checks 
hirozo: bets $0.25
4thepeople: folds 
Uncalled bet ($0.25) returned to hirozo
hirozo collected $0.48 from pot
hirozo: doesn't show hand 
*** SUMMARY ***
Total pot $0.50 | Rake $0.02 
Board [8s 8h 3d]
Seat 1: chiyuki (button) folded before Flop (didn't bet)
Seat 2: 4thepeople (small blind) folded on the Flop
Seat 3: hirozo (big blind) collected ($0.48)
Seat 4: wtu1986 folded before Flop (didn't bet)
Seat 5: kamikkaze folded before Flop (didn't bet)
Seat 6: RomarioJa folded before Flop (didn't bet)
Seat 7: DONK1967 folded before Flop (didn't bet)
Seat 8: Anafim folded before Flop (didn't bet)
Seat 9: eyesJeJa folded before Flop (didn't bet)



PokerStars Zoom Hand #84299349974:  Hold'em No Limit ($0.10/$0.25) - 2012/08/05 14:13:24 JST [2012/08/05 1:13:24 ET]
Table 'Whirlpool' 9-max Seat #1 is the button
Seat 1: seula i ($25 in chips) 
Seat 2: DONK1967 ($24.38 in chips) 
Seat 3: Lasutchik ($11.53 in chips) 
Seat 4: johnbaco1209 ($23.65 in chips) 
Seat 5: ChrisCDee ($57.34 in chips) 
Seat 6: troms20 ($20.60 in chips) 
Seat 7: kamikkaze ($13.97 in chips) 
Seat 8: chiyuki ($35.69 in chips) 
Seat 9: Landybob ($38.61 in chips) 
DONK1967: posts small blind $0.10
Lasutchik: posts big blind $0.25
*** HOLE CARDS ***
Dealt to chiyuki [9h Js]
johnbaco1209: folds 
ChrisCDee: folds 
troms20: folds 
kamikkaze: raises $0.25 to $0.50
chiyuki: folds 
Landybob: folds 
seula i: folds 
DONK1967: folds 
Lasutchik: folds 
Uncalled bet ($0.25) returned to kamikkaze
kamikkaze collected $0.60 from pot
kamikkaze: doesn't show hand 
*** SUMMARY ***
Total pot $0.60 | Rake $0 
Seat 1: seula i (button) folded before Flop (didn't bet)
Seat 2: DONK1967 (small blind) folded before Flop
Seat 3: Lasutchik (big blind) folded before Flop
Seat 4: johnbaco1209 folded before Flop (didn't bet)
Seat 5: ChrisCDee folded before Flop (didn't bet)
Seat 6: troms20 folded before Flop (didn't bet)
Seat 7: kamikkaze collected ($0.60)
Seat 8: chiyuki folded before Flop (didn't bet)
Seat 9: Landybob folded before Flop (didn't bet)



PokerStars Zoom Hand #84299351511:  Hold'em No Limit ($0.10/$0.25) - 2012/08/05 14:13:31 JST [2012/08/05 1:13:31 ET]
Table 'Whirlpool' 9-max Seat #1 is the button
Seat 1: flyinprits ($33.49 in chips) 
Seat 2: troms20 ($20.60 in chips) 
Seat 3: Loholov ($17.11 in chips) 
Seat 4: Robchie ($12.85 in chips) 
Seat 5: Rudolf ($41.87 in chips) 
Seat 6: chiyuki ($35.69 in chips) 
Seat 7: ygoegoe ($28.31 in chips) 
Seat 8: Dejacob ($26.39 in chips) 
Seat 9: 4ydo yogurt ($23.67 in chips) 
troms20: posts small blind $0.10
Loholov: posts big blind $0.25
*** HOLE CARDS ***
Dealt to chiyuki [3c Qd]
Robchie: raises $0.25 to $0.50
Rudolf: folds 
chiyuki: folds 
ygoegoe: folds 
Dejacob: folds 
4ydo yogurt: folds 
flyinprits: folds 
troms20: folds 
Loholov: calls $0.25
*** FLOP *** [Qh Ah Ks]
Loholov: checks 
Robchie: bets $0.50
Loholov: folds 
Uncalled bet ($0.50) returned to Robchie
Robchie collected $1.05 from pot
Robchie: doesn't show hand 
*** SUMMARY ***
Total pot $1.10 | Rake $0.05 
Board [Qh Ah Ks]
Seat 1: flyinprits (button) folded before Flop (didn't bet)
Seat 2: troms20 (small blind) folded before Flop
Seat 3: Loholov (big blind) folded on the Flop
Seat 4: Robchie collected ($1.05)
Seat 5: Rudolf folded before Flop (didn't bet)
Seat 6: chiyuki folded before Flop (didn't bet)
Seat 7: ygoegoe folded before Flop (didn't bet)
Seat 8: Dejacob folded before Flop (didn't bet)
Seat 9: 4ydo yogurt folded before Flop (didn't bet)



PokerStars Zoom Hand #84299338140:  Hold'em No Limit ($0.10/$0.25) - 2012/08/05 14:12:37 JST [2012/08/05 1:12:37 ET]
Table 'Whirlpool' 9-max Seat #1 is the button
Seat 1: ChrisCDee ($57.34 in chips) 
Seat 2: eyesJeJa ($26.55 in chips) 
Seat 3: chiyuki ($35.94 in chips) 
Seat 4: 2997qwer ($10.80 in chips) 
Seat 5: kamikkaze ($15.37 in chips) 
Seat 6: Perstenev ($18.21 in chips) 
Seat 7: GoldNutter ($24.22 in chips) 
Seat 8: wtu1986 ($31.52 in chips) 
Seat 9: Loholov ($18.91 in chips) 
eyesJeJa: posts small blind $0.10
chiyuki: posts big blind $0.25
*** HOLE CARDS ***
Dealt to chiyuki [9h Tc]
2997qwer: folds 
kamikkaze: raises $0.25 to $0.50
Perstenev: folds 
GoldNutter: folds 
wtu1986: raises $1 to $1.50
Loholov: folds 
ChrisCDee: folds 
eyesJeJa: folds 
chiyuki: folds 
kamikkaze: calls $1
*** FLOP *** [8s 7h 9d]
kamikkaze: checks 
wtu1986: bets $2
kamikkaze: folds 
Uncalled bet ($2) returned to wtu1986
wtu1986 collected $3.20 from pot
wtu1986: doesn't show hand 
*** SUMMARY ***
Total pot $3.35 | Rake $0.15 
Board [8s 7h 9d]
Seat 1: ChrisCDee (button) folded before Flop (didn't bet)
Seat 2: eyesJeJa (small blind) folded before Flop
Seat 3: chiyuki (big blind) folded before Flop
Seat 4: 2997qwer folded before Flop (didn't bet)
Seat 5: kamikkaze folded on the Flop
Seat 6: Perstenev folded before Flop (didn't bet)
Seat 7: GoldNutter folded before Flop (didn't bet)
Seat 8: wtu1986 collected ($3.20)
Seat 9: Loholov folded before Flop (didn't bet)



PokerStars Zoom Hand #84299353755:  Hold'em No Limit ($0.10/$0.25) - 2012/08/05 14:13:40 JST [2012/08/05 1:13:40 ET]
Table 'Whirlpool' 9-max Seat #1 is the button
Seat 1: craden500 ($22.87 in chips) 
Seat 2: chiyuki ($35.69 in chips) 
Seat 3: flyinprits ($31.64 in chips) 
Seat 4: kamikkaze ($14.85 in chips) 
Seat 5: RikkStroken ($24.58 in chips) 
Seat 6: troms20 ($29.34 in chips) 
Seat 7: acamrash ($14.54 in chips) 
Seat 8: hirozo ($29.61 in chips) 
Seat 9: Tom1999 ($23.22 in chips) 
chiyuki: posts small blind $0.10
flyinprits: posts big blind $0.25
*** HOLE CARDS ***
Dealt to chiyuki [Jd 7d]
kamikkaze: folds 
RikkStroken: folds 
troms20: folds 
acamrash: folds 
hirozo: folds 
Tom1999: folds 
craden500: folds 
chiyuki: raises $0.50 to $0.75
flyinprits: folds 
Uncalled bet ($0.50) returned to chiyuki
chiyuki collected $0.50 from pot
chiyuki: doesn't show hand 
*** SUMMARY ***
Total pot $0.50 | Rake $0 
Seat 1: craden500 (button) folded before Flop (didn't bet)
Seat 2: chiyuki (small blind) collected ($0.50)
Seat 3: flyinprits (big blind) folded before Flop
Seat 4: kamikkaze folded before Flop (didn't bet)
Seat 5: RikkStroken folded before Flop (didn't bet)
Seat 6: troms20 folded before Flop (didn't bet)
Seat 7: acamrash folded before Flop (didn't bet)
Seat 8: hirozo folded before Flop (didn't bet)
Seat 9: Tom1999 folded before Flop (didn't bet)



PokerStars Zoom Hand #84299352514:  Hold'em No Limit ($0.10/$0.25) - 2012/08/05 14:13:35 JST [2012/08/05 1:13:35 ET]
Table 'Whirlpool' 9-max Seat #1 is the button
Seat 1: giorgos_k ($15.73 in chips) 
Seat 2: JLajoie ($24.50 in chips) 
Seat 3: acamrash ($12.40 in chips) 
Seat 4: chiyuki ($35.69 in chips) 
Seat 5: johnbaco1209 ($23.65 in chips) 
Seat 6: Dejacob ($26.39 in chips) 
Seat 7: Nerkit ($11.45 in chips) 
Seat 8: Rudolf ($41.87 in chips) 
Seat 9: RomarioJa ($11.61 in chips) 
JLajoie: posts small blind $0.10
acamrash: posts big blind $0.25
*** HOLE CARDS ***
Dealt to chiyuki [Ad 7c]
chiyuki: folds 
johnbaco1209: folds 
Dejacob: folds 
Nerkit: folds 
Rudolf: folds 
RomarioJa: folds 
giorgos_k: folds 
JLajoie: folds 
Uncalled bet ($0.15) returned to acamrash
acamrash collected $0.20 from pot
acamrash: doesn't show hand 
*** SUMMARY ***
Total pot $0.20 | Rake $0 
Seat 1: giorgos_k (button) folded before Flop (didn't bet)
Seat 2: JLajoie (small blind) folded before Flop
Seat 3: acamrash (big blind) collected ($0.20)
Seat 4: chiyuki folded before Flop (didn't bet)
Seat 5: johnbaco1209 folded before Flop (didn't bet)
Seat 6: Dejacob folded before Flop (didn't bet)
Seat 7: Nerkit folded before Flop (didn't bet)
Seat 8: Rudolf folded before Flop (didn't bet)
Seat 9: RomarioJa folded before Flop (didn't bet)



PokerStars Zoom Hand #84299357782:  Hold'em No Limit ($0.10/$0.25) - 2012/08/05 14:13:56 JST [2012/08/05 1:13:56 ET]
Table 'Whirlpool' 9-max Seat #1 is the button
Seat 1: phate-1up ($25 in chips) 
Seat 2: PetitAlejo ($35.61 in chips) 
Seat 3: wtu1986 ($25.50 in chips) 
Seat 4: chiyuki ($35.94 in chips) 
Seat 5: cr0lox ($20.22 in chips) 
Seat 6: JLajoie ($24.65 in chips) 
Seat 7: luriks27 ($23.37 in chips) 
Seat 8: gunbowler ($153.10 in chips) 
Seat 9: eyesJeJa ($25.20 in chips) 
PetitAlejo: posts small blind $0.10
wtu1986: posts big blind $0.25
*** HOLE CARDS ***
Dealt to chiyuki [5h 6h]
chiyuki: folds 
cr0lox: folds 
JLajoie: raises $0.75 to $1
luriks27: folds 
gunbowler: folds 
eyesJeJa: folds 
phate-1up: folds 
PetitAlejo: folds 
wtu1986: folds 
Uncalled bet ($0.75) returned to JLajoie
JLajoie collected $0.60 from pot
JLajoie: doesn't show hand 
*** SUMMARY ***
Total pot $0.60 | Rake $0 
Seat 1: phate-1up (button) folded before Flop (didn't bet)
Seat 2: PetitAlejo (small blind) folded before Flop
Seat 3: wtu1986 (big blind) folded before Flop
Seat 4: chiyuki folded before Flop (didn't bet)
Seat 5: cr0lox folded before Flop (didn't bet)
Seat 6: JLajoie collected ($0.60)
Seat 7: luriks27 folded before Flop (didn't bet)
Seat 8: gunbowler folded before Flop (didn't bet)
Seat 9: eyesJeJa folded before Flop (didn't bet)



PokerStars Zoom Hand #84299358566:  Hold'em No Limit ($0.10/$0.25) - 2012/08/05 14:13:59 JST [2012/08/05 1:13:59 ET]
Table 'Whirlpool' 9-max Seat #1 is the button
Seat 1: eyesJeJa ($25.47 in chips) 
Seat 2: PetitAlejo ($31.32 in chips) 
Seat 3: Loholov ($18.25 in chips) 
Seat 4: RikkStroken ($24.33 in chips) 
Seat 5: Th3Fog ($46.11 in chips) 
Seat 6: Nerkit ($10.59 in chips) 
Seat 7: wtu1986 ($25.23 in chips) 
Seat 8: kamikkaze ($14.85 in chips) 
Seat 9: chiyuki ($35.94 in chips) 
PetitAlejo: posts small blind $0.10
Loholov: posts big blind $0.25
*** HOLE CARDS ***
Dealt to chiyuki [Ad 7d]
RikkStroken: raises $0.25 to $0.50
Th3Fog: folds 
Nerkit: folds 
wtu1986: calls $0.50
kamikkaze: folds 
chiyuki: folds 
eyesJeJa: raises $1.50 to $2
PetitAlejo: folds 
Loholov: folds 
RikkStroken: folds 
wtu1986: folds 
Uncalled bet ($1.50) returned to eyesJeJa
eyesJeJa collected $1.85 from pot
eyesJeJa: doesn't show hand 
*** SUMMARY ***
Total pot $1.85 | Rake $0 
Seat 1: eyesJeJa (button) collected ($1.85)
Seat 2: PetitAlejo (small blind) folded before Flop
Seat 3: Loholov (big blind) folded before Flop
Seat 4: RikkStroken folded before Flop
Seat 5: Th3Fog folded before Flop (didn't bet)
Seat 6: Nerkit folded before Flop (didn't bet)
Seat 7: wtu1986 folded before Flop
Seat 8: kamikkaze folded before Flop (didn't bet)
Seat 9: chiyuki folded before Flop (didn't bet)



PokerStars Zoom Hand #84299361811:  Hold'em No Limit ($0.10/$0.25) - 2012/08/05 14:14:12 JST [2012/08/05 1:14:12 ET]
Table 'Whirlpool' 9-max Seat #1 is the button
Seat 1: el pore 5 ($16.59 in chips) 
Seat 2: Tom1999 ($5.17 in chips) 
Seat 3: Th3Fog ($14.67 in chips) 
Seat 4: 2997qwer ($11.05 in chips) 
Seat 5: Dejacob ($25.93 in chips) 
Seat 6: kamikkaze ($30.34 in chips) 
Seat 7: ygoegoe ($28.21 in chips) 
Seat 8: chiyuki ($35.94 in chips) 
Seat 9: troms20 ($26.05 in chips) 
Tom1999: posts small blind $0.10
Th3Fog: posts big blind $0.25
*** HOLE CARDS ***
Dealt to chiyuki [7d Qs]
2997qwer: folds 
Dejacob: folds 
kamikkaze: folds 
ygoegoe: folds 
chiyuki: folds 
troms20: folds 
el pore 5: folds 
Tom1999: folds 
Uncalled bet ($0.15) returned to Th3Fog
Th3Fog collected $0.20 from pot
Th3Fog: doesn't show hand 
*** SUMMARY ***
Total pot $0.20 | Rake $0 
Seat 1: el pore 5 (button) folded before Flop (didn't bet)
Seat 2: Tom1999 (small blind) folded before Flop
Seat 3: Th3Fog (big blind) collected ($0.20)
Seat 4: 2997qwer folded before Flop (didn't bet)
Seat 5: Dejacob folded before Flop (didn't bet)
Seat 6: kamikkaze folded before Flop (didn't bet)
Seat 7: ygoegoe folded before Flop (didn't bet)
Seat 8: chiyuki folded before Flop (didn't bet)
Seat 9: troms20 folded before Flop (didn't bet)



PokerStars Zoom Hand #84299370376:  Hold'em No Limit ($0.10/$0.25) - 2012/08/05 14:14:47 JST [2012/08/05 1:14:47 ET]
Table 'Whirlpool' 9-max Seat #1 is the button
Seat 1: seula i ($30.10 in chips) 
Seat 2: chiyuki ($35.69 in chips) 
Seat 3: RomarioJa ($12.50 in chips) 
Seat 4: Suhoff76 ($25 in chips) 
Seat 5: eyesJeJa ($26.82 in chips) 
Seat 6: fezman ($16.83 in chips) 
Seat 7: phate-1up ($27.05 in chips) 
Seat 8: wtu1986 ($29.33 in chips) 
Seat 9: KeLevro0 ($11.80 in chips) 
chiyuki: posts small blind $0.10
RomarioJa: posts big blind $0.25
*** HOLE CARDS ***
Dealt to chiyuki [3c 2h]
Suhoff76: folds 
eyesJeJa: folds 
fezman: folds 
phate-1up: folds 
wtu1986: folds 
KeLevro0: folds 
seula i: folds 
chiyuki: folds 
Uncalled bet ($0.15) returned to RomarioJa
RomarioJa collected $0.20 from pot
RomarioJa: doesn't show hand 
*** SUMMARY ***
Total pot $0.20 | Rake $0 
Seat 1: seula i (button) folded before Flop (didn't bet)
Seat 2: chiyuki (small blind) folded before Flop
Seat 3: RomarioJa (big blind) collected ($0.20)
Seat 4: Suhoff76 folded before Flop (didn't bet)
Seat 5: eyesJeJa folded before Flop (didn't bet)
Seat 6: fezman folded before Flop (didn't bet)
Seat 7: phate-1up folded before Flop (didn't bet)
Seat 8: wtu1986 folded before Flop (didn't bet)
Seat 9: KeLevro0 folded before Flop (didn't bet)



PokerStars Zoom Hand #84299362809:  Hold'em No Limit ($0.10/$0.25) - 2012/08/05 14:14:16 JST [2012/08/05 1:14:16 ET]
Table 'Whirlpool' 9-max Seat #1 is the button
Seat 1: dushvan ($30.67 in chips) 
Seat 2: KCDOGG10 ($12.60 in chips) 
Seat 3: chiyuki ($35.94 in chips) 
Seat 4: Spartacus675 ($29.17 in chips) 
Seat 5: Tom1999 ($23.47 in chips) 
Seat 6: KeLevro0 ($11.45 in chips) 
Seat 7: phate-1up ($25 in chips) 
Seat 8: eyesJeJa ($29.09 in chips) 
Seat 9: Suhoff76 ($25.50 in chips) 
KCDOGG10: posts small blind $0.10
chiyuki: posts big blind $0.25
*** HOLE CARDS ***
Dealt to chiyuki [7c 5h]
Spartacus675: folds 
Tom1999: raises $0.50 to $0.75
KeLevro0: folds 
phate-1up: folds 
eyesJeJa: folds 
Suhoff76: calls $0.75
dushvan: folds 
KCDOGG10: calls $0.65
chiyuki: folds 
*** FLOP *** [7s Ks 8h]
KCDOGG10: checks 
Tom1999: bets $0.50
Suhoff76: calls $0.50
KCDOGG10: folds 
*** TURN *** [7s Ks 8h] [2d]
Tom1999: bets $1.25
Suhoff76: folds 
Uncalled bet ($1.25) returned to Tom1999
Tom1999 collected $3.34 from pot
Tom1999: doesn't show hand 
*** SUMMARY ***
Total pot $3.50 | Rake $0.16 
Board [7s Ks 8h 2d]
Seat 1: dushvan (button) folded before Flop (didn't bet)
Seat 2: KCDOGG10 (small blind) folded on the Flop
Seat 3: chiyuki (big blind) folded before Flop
Seat 4: Spartacus675 folded before Flop (didn't bet)
Seat 5: Tom1999 collected ($3.34)
Seat 6: KeLevro0 folded before Flop (didn't bet)
Seat 7: phate-1up folded before Flop (didn't bet)
Seat 8: eyesJeJa folded before Flop (didn't bet)
Seat 9: Suhoff76 folded on the Turn



PokerStars Zoom Hand #84299371374:  Hold'em No Limit ($0.10/$0.25) - 2012/08/05 14:14:51 JST [2012/08/05 1:14:51 ET]
Table 'Whirlpool' 9-max Seat #1 is the button
Seat 1: BlOnDhOlIc ($60.21 in chips) 
Seat 2: PetitAlejo ($30.09 in chips) 
Seat 3: deadmoneykid ($24.65 in chips) 
Seat 4: Vahe50 ($32.65 in chips) 
Seat 5: chiyuki ($35.59 in chips) 
Seat 6: dushvan ($30.57 in chips) 
Seat 7: Loholov ($15.35 in chips) 
Seat 8: silvno31 ($39.90 in chips) 
Seat 9: Nerkit ($11.10 in chips) 
PetitAlejo: posts small blind $0.10
deadmoneykid: posts big blind $0.25
*** HOLE CARDS ***
Dealt to chiyuki [4d 9d]
Vahe50: folds 
chiyuki: folds 
dushvan: folds 
Loholov: folds 
silvno31: raises $0.50 to $0.75
Nerkit: folds 
BlOnDhOlIc: folds 
PetitAlejo: folds 
deadmoneykid: folds 
Uncalled bet ($0.50) returned to silvno31
silvno31 collected $0.60 from pot
silvno31: doesn't show hand 
*** SUMMARY ***
Total pot $0.60 | Rake $0 
Seat 1: BlOnDhOlIc (button) folded before Flop (didn't bet)
Seat 2: PetitAlejo (small blind) folded before Flop
Seat 3: deadmoneykid (big blind) folded before Flop
Seat 4: Vahe50 folded before Flop (didn't bet)
Seat 5: chiyuki folded before Flop (didn't bet)
Seat 6: dushvan folded before Flop (didn't bet)
Seat 7: Loholov folded before Flop (didn't bet)
Seat 8: silvno31 collected ($0.60)
Seat 9: Nerkit folded before Flop (didn't bet)



PokerStars Zoom Hand #84299366121:  Hold'em No Limit ($0.10/$0.25) - 2012/08/05 14:14:29 JST [2012/08/05 1:14:29 ET]
Table 'Whirlpool' 9-max Seat #1 is the button
Seat 1: chiyuki ($35.69 in chips) 
Seat 2: eyesJeJa ($25.53 in chips) 
Seat 3: Dejacob ($25.93 in chips) 
Seat 4: seula i ($25 in chips) 
Seat 5: RikkStroken ($15.41 in chips) 
Seat 6: simonzez ($48.13 in chips) 
Seat 7: WARIBANA7777 ($13.45 in chips) 
Seat 8: hirozo ($33.65 in chips) 
Seat 9: troms20 ($25 in chips) 
eyesJeJa: posts small blind $0.10
Dejacob: posts big blind $0.25
*** HOLE CARDS ***
Dealt to chiyuki [Qh Jc]
seula i: folds 
RikkStroken: folds 
simonzez: calls $0.25
WARIBANA7777: folds 
hirozo: folds 
troms20: folds 
chiyuki: folds 
eyesJeJa: folds 
Dejacob: raises $0.50 to $0.75
simonzez: raises $0.50 to $1.25
Dejacob: calls $0.50
*** FLOP *** [9h 5s Td]
Dejacob: checks 
simonzez: bets $1.75
Dejacob: folds 
Uncalled bet ($1.75) returned to simonzez
simonzez collected $2.48 from pot
simonzez: doesn't show hand 
*** SUMMARY ***
Total pot $2.60 | Rake $0.12 
Board [9h 5s Td]
Seat 1: chiyuki (button) folded before Flop (didn't bet)
Seat 2: eyesJeJa (small blind) folded before Flop
Seat 3: Dejacob (big blind) folded on the Flop
Seat 4: seula i folded before Flop (didn't bet)
Seat 5: RikkStroken folded before Flop (didn't bet)
Seat 6: simonzez collected ($2.48)
Seat 7: WARIBANA7777 folded before Flop (didn't bet)
Seat 8: hirozo folded before Flop (didn't bet)
Seat 9: troms20 folded before Flop (didn't bet)



PokerStars Zoom Hand #84299369378:  Hold'em No Limit ($0.10/$0.25) - 2012/08/05 14:14:43 JST [2012/08/05 1:14:43 ET]
Table 'Whirlpool' 9-max Seat #1 is the button
Seat 1: KeLevro0 ($11.57 in chips) 
Seat 2: Loholov ($15.45 in chips) 
Seat 3: taksist889 ($37.91 in chips) 
Seat 4: BlOnDhOlIc ($25 in chips) 
Seat 5: phate-1up ($27.05 in chips) 
Seat 6: PetitAlejo ($31.22 in chips) 
Seat 7: chiyuki ($35.69 in chips) 
Seat 8: eyesJeJa ($26.82 in chips) 
Seat 9: kamikkaze ($14.50 in chips) 
Loholov: posts small blind $0.10
taksist889: posts big blind $0.25
*** HOLE CARDS ***
Dealt to chiyuki [Tc 5h]
BlOnDhOlIc: raises $0.25 to $0.50
phate-1up: folds 
PetitAlejo: calls $0.50
chiyuki: folds 
eyesJeJa: folds 
kamikkaze: folds 
KeLevro0: folds 
Loholov: folds 
taksist889: calls $0.25
*** FLOP *** [Qd 8s 9h]
taksist889: checks 
BlOnDhOlIc: bets $0.75
PetitAlejo: raises $1.51 to $2.26
taksist889: folds 
BlOnDhOlIc: calls $1.51
*** TURN *** [Qd 8s 9h] [6c]
BlOnDhOlIc: checks 
PetitAlejo: bets $3.50
BlOnDhOlIc: folds 
Uncalled bet ($3.50) returned to PetitAlejo
PetitAlejo collected $5.84 from pot
PetitAlejo: doesn't show hand 
*** SUMMARY ***
Total pot $6.12 | Rake $0.28 
Board [Qd 8s 9h 6c]
Seat 1: KeLevro0 (button) folded before Flop (didn't bet)
Seat 2: Loholov (small blind) folded before Flop
Seat 3: taksist889 (big blind) folded on the Flop
Seat 4: BlOnDhOlIc folded on the Turn
Seat 5: phate-1up folded before Flop (didn't bet)
Seat 6: PetitAlejo collected ($5.84)
Seat 7: chiyuki folded before Flop (didn't bet)
Seat 8: eyesJeJa folded before Flop (didn't bet)
Seat 9: kamikkaze folded before Flop (didn't bet)



PokerStars Zoom Hand #84299374911:  Hold'em No Limit ($0.10/$0.25) - 2012/08/05 14:15:05 JST [2012/08/05 1:15:05 ET]
Table 'Whirlpool' 9-max Seat #1 is the button
Seat 1: PetitAlejo ($29.99 in chips) 
Seat 2: taksist889 ($37.41 in chips) 
Seat 3: kamikkaze ($27.54 in chips) 
Seat 4: JLajoie ($24.65 in chips) 
Seat 5: RomarioJa ($11.53 in chips) 
Seat 6: Rudolf ($41.62 in chips) 
Seat 7: 4ydo yogurt ($20.52 in chips) 
Seat 8: Loholov ($17.90 in chips) 
Seat 9: chiyuki ($35.59 in chips) 
taksist889: posts small blind $0.10
kamikkaze: posts big blind $0.25
*** HOLE CARDS ***
Dealt to chiyuki [Kc Qh]
JLajoie: folds 
RomarioJa: folds 
Rudolf: folds 
4ydo yogurt: raises $0.25 to $0.50
Loholov: folds 
chiyuki: folds 
PetitAlejo: folds 
taksist889: calls $0.40
kamikkaze: folds 
*** FLOP *** [6h 2d Qc]
taksist889: bets $0.75
4ydo yogurt: calls $0.75
*** TURN *** [6h 2d Qc] [8c]
taksist889: bets $1.25
4ydo yogurt: calls $1.25
*** RIVER *** [6h 2d Qc 8c] [9d]
taksist889: bets $2
4ydo yogurt: folds 
Uncalled bet ($2) returned to taksist889
taksist889 collected $5.01 from pot
taksist889: doesn't show hand 
*** SUMMARY ***
Total pot $5.25 | Rake $0.24 
Board [6h 2d Qc 8c 9d]
Seat 1: PetitAlejo (button) folded before Flop (didn't bet)
Seat 2: taksist889 (small blind) collected ($5.01)
Seat 3: kamikkaze (big blind) folded before Flop
Seat 4: JLajoie folded before Flop (didn't bet)
Seat 5: RomarioJa folded before Flop (didn't bet)
Seat 6: Rudolf folded before Flop (didn't bet)
Seat 7: 4ydo yogurt folded on the River
Seat 8: Loholov folded before Flop (didn't bet)
Seat 9: chiyuki folded before Flop (didn't bet)



PokerStars Zoom Hand #84299378151:  Hold'em No Limit ($0.10/$0.25) - 2012/08/05 14:15:18 JST [2012/08/05 1:15:18 ET]
Table 'Whirlpool' 9-max Seat #1 is the button
Seat 1: phate-1up ($25 in chips) 
Seat 2: cr0lox ($20.67 in chips) 
Seat 3: Anafim ($12.84 in chips) 
Seat 4: D@vidMed ($70.99 in chips) 
Seat 5: Nerkit ($11.10 in chips) 
Seat 6: Landybob ($38.01 in chips) 
Seat 7: chiyuki ($35.59 in chips) 
Seat 8: flyinprits ($34.86 in chips) 
Seat 9: Tom1999 ($25.56 in chips) 
cr0lox: posts small blind $0.10
Anafim: posts big blind $0.25
*** HOLE CARDS ***
Dealt to chiyuki [Qc Td]
D@vidMed: folds 
Nerkit: folds 
Landybob: folds 
chiyuki: folds 
flyinprits: folds 
Tom1999: folds 
phate-1up: folds 
cr0lox: raises $0.50 to $0.75
Anafim: folds 
Uncalled bet ($0.50) returned to cr0lox
cr0lox collected $0.50 from pot
cr0lox: doesn't show hand 
*** SUMMARY ***
Total pot $0.50 | Rake $0 
Seat 1: phate-1up (button) folded before Flop (didn't bet)
Seat 2: cr0lox (small blind) collected ($0.50)
Seat 3: Anafim (big blind) folded before Flop
Seat 4: D@vidMed folded before Flop (didn't bet)
Seat 5: Nerkit folded before Flop (didn't bet)
Seat 6: Landybob folded before Flop (didn't bet)
Seat 7: chiyuki folded before Flop (didn't bet)
Seat 8: flyinprits folded before Flop (didn't bet)
Seat 9: Tom1999 folded before Flop (didn't bet)



PokerStars Zoom Hand #84299373362:  Hold'em No Limit ($0.10/$0.25) - 2012/08/05 14:14:59 JST [2012/08/05 1:14:59 ET]
Table 'Whirlpool' 9-max Seat #1 is the button
Seat 1: Ellen1947 ($29.10 in chips) 
Seat 2: kamikkaze ($30.09 in chips) 
Seat 3: hirozo ($33.65 in chips) 
Seat 4: eyesJeJa ($26.82 in chips) 
Seat 5: Loholov ($15.35 in chips) 
Seat 6: chiyuki ($35.59 in chips) 
Seat 7: RikkStroken ($11.08 in chips) 
Seat 8: Perstenev ($12.92 in chips) 
Seat 9: Robchie ($31.32 in chips) 
kamikkaze: posts small blind $0.10
hirozo: posts big blind $0.25
*** HOLE CARDS ***
Dealt to chiyuki [Js Qc]
eyesJeJa: folds 
Loholov: folds 
chiyuki: folds 
RikkStroken: folds 
Perstenev: folds 
Robchie: folds 
Ellen1947: raises $0.45 to $0.70
kamikkaze: calls $0.60
hirozo: folds 
*** FLOP *** [8c 5c 7h]
kamikkaze: checks 
Ellen1947: checks 
*** TURN *** [8c 5c 7h] [9s]
kamikkaze: bets $1.02
Ellen1947: folds 
Uncalled bet ($1.02) returned to kamikkaze
kamikkaze collected $1.58 from pot
kamikkaze: doesn't show hand 
*** SUMMARY ***
Total pot $1.65 | Rake $0.07 
Board [8c 5c 7h 9s]
Seat 1: Ellen1947 (button) folded on the Turn
Seat 2: kamikkaze (small blind) collected ($1.58)
Seat 3: hirozo (big blind) folded before Flop
Seat 4: eyesJeJa folded before Flop (didn't bet)
Seat 5: Loholov folded before Flop (didn't bet)
Seat 6: chiyuki folded before Flop (didn't bet)
Seat 7: RikkStroken folded before Flop (didn't bet)
Seat 8: Perstenev folded before Flop (didn't bet)
Seat 9: Robchie folded before Flop (didn't bet)



PokerStars Zoom Hand #84299381868:  Hold'em No Limit ($0.10/$0.25) - 2012/08/05 14:15:33 JST [2012/08/05 1:15:33 ET]
Table 'Whirlpool' 9-max Seat #1 is the button
Seat 1: JLajoie ($24.65 in chips) 
Seat 2: agurio ($26.78 in chips) 
Seat 3: BlOnDhOlIc ($25 in chips) 
Seat 4: acamrash ($16.54 in chips) 
Seat 5: chiyuki ($35.59 in chips) 
Seat 6: Dejacob ($44.30 in chips) 
Seat 7: carlosrbr ($51.97 in chips) 
Seat 8: 4thepeople ($21.59 in chips) 
Seat 9: Suhoff76 ($25.50 in chips) 
agurio: posts small blind $0.10
BlOnDhOlIc: posts big blind $0.25
*** HOLE CARDS ***
Dealt to chiyuki [5d 6s]
acamrash: folds 
chiyuki: folds 
Dejacob: folds 
carlosrbr: folds 
4thepeople: folds 
Suhoff76: folds 
JLajoie: folds 
agurio: folds 
Uncalled bet ($0.15) returned to BlOnDhOlIc
BlOnDhOlIc collected $0.20 from pot
BlOnDhOlIc: doesn't show hand 
*** SUMMARY ***
Total pot $0.20 | Rake $0 
Seat 1: JLajoie (button) folded before Flop (didn't bet)
Seat 2: agurio (small blind) folded before Flop
Seat 3: BlOnDhOlIc (big blind) collected ($0.20)
Seat 4: acamrash folded before Flop (didn't bet)
Seat 5: chiyuki folded before Flop (didn't bet)
Seat 6: Dejacob folded before Flop (didn't bet)
Seat 7: carlosrbr folded before Flop (didn't bet)
Seat 8: 4thepeople folded before Flop (didn't bet)
Seat 9: Suhoff76 folded before Flop (didn't bet)



PokerStars Zoom Hand #84299383637:  Hold'em No Limit ($0.10/$0.25) - 2012/08/05 14:15:40 JST [2012/08/05 1:15:40 ET]
Table 'Whirlpool' 9-max Seat #1 is the button
Seat 1: Suhoff76 ($31.19 in chips) 
Seat 2: Vahe50 ($20.26 in chips) 
Seat 3: hirozo ($25 in chips) 
Seat 4: chiyuki ($35.59 in chips) 
Seat 5: wtu1986 ($25 in chips) 
Seat 6: WARIBANA7777 ($13.10 in chips) 
Seat 7: cr0lox ($20.92 in chips) 
Seat 8: Dejacob ($26.04 in chips) 
Seat 9: Perstenev ($8.55 in chips) 
Vahe50: posts small blind $0.10
hirozo: posts big blind $0.25
*** HOLE CARDS ***
Dealt to chiyuki [Kc Ah]
chiyuki: raises $0.50 to $0.75
wtu1986: folds 
WARIBANA7777: folds 
cr0lox: folds 
Dejacob: folds 
Perstenev: folds 
Suhoff76: folds 
Vahe50: folds 
hirozo: folds 
Uncalled bet ($0.50) returned to chiyuki
chiyuki collected $0.60 from pot
chiyuki: doesn't show hand 
*** SUMMARY ***
Total pot $0.60 | Rake $0 
Seat 1: Suhoff76 (button) folded before Flop (didn't bet)
Seat 2: Vahe50 (small blind) folded before Flop
Seat 3: hirozo (big blind) folded before Flop
Seat 4: chiyuki collected ($0.60)
Seat 5: wtu1986 folded before Flop (didn't bet)
Seat 6: WARIBANA7777 folded before Flop (didn't bet)
Seat 7: cr0lox folded before Flop (didn't bet)
Seat 8: Dejacob folded before Flop (didn't bet)
Seat 9: Perstenev folded before Flop (didn't bet)



PokerStars Zoom Hand #84299379689:  Hold'em No Limit ($0.10/$0.25) - 2012/08/05 14:15:24 JST [2012/08/05 1:15:24 ET]
Table 'Whirlpool' 9-max Seat #1 is the button
Seat 1: Rudolf ($41.52 in chips) 
Seat 2: 2997qwer ($10.85 in chips) 
Seat 3: Tom1999 ($25.56 in chips) 
Seat 4: acamrash ($9.13 in chips) 
Seat 5: DanielWhyte ($28.82 in chips) 
Seat 6: Perstenev ($13 in chips) 
Seat 7: PetitAlejo ($34.30 in chips) 
Seat 8: chiyuki ($35.59 in chips) 
Seat 9: BlOnDhOlIc ($25 in chips) 
2997qwer: posts small blind $0.10
Tom1999: posts big blind $0.25
*** HOLE CARDS ***
Dealt to chiyuki [9c 4s]
acamrash: folds 
DanielWhyte: calls $0.25
Perstenev: folds 
PetitAlejo: folds 
chiyuki: folds 
BlOnDhOlIc: folds 
Rudolf: folds 
2997qwer: raises $0.75 to $1
Tom1999: folds 
DanielWhyte: calls $0.75
*** FLOP *** [7c 3d 5h]
2997qwer: checks 
DanielWhyte: bets $0.50
2997qwer: calls $0.50
*** TURN *** [7c 3d 5h] [Ah]
2997qwer: checks 
DanielWhyte: checks 
*** RIVER *** [7c 3d 5h Ah] [Ts]
2997qwer: checks 
DanielWhyte: checks 
*** SHOW DOWN ***
2997qwer: shows [Kc Tc] (a pair of Tens)
DanielWhyte: mucks hand 
2997qwer collected $3.10 from pot
*** SUMMARY ***
Total pot $3.25 | Rake $0.15 
Board [7c 3d 5h Ah Ts]
Seat 1: Rudolf (button) folded before Flop (didn't bet)
Seat 2: 2997qwer (small blind) showed [Kc Tc] and won ($3.10) with a pair of Tens
Seat 3: Tom1999 (big blind) folded before Flop
Seat 4: acamrash folded before Flop (didn't bet)
Seat 5: DanielWhyte mucked [8c 6c]
Seat 6: Perstenev folded before Flop (didn't bet)
Seat 7: PetitAlejo folded before Flop (didn't bet)
Seat 8: chiyuki folded before Flop (didn't bet)
Seat 9: BlOnDhOlIc folded before Flop (didn't bet)



PokerStars Zoom Hand #84299388851:  Hold'em No Limit ($0.10/$0.25) - 2012/08/05 14:16:02 JST [2012/08/05 1:16:02 ET]
Table 'Whirlpool' 9-max Seat #1 is the button
Seat 1: dushvan ($30.57 in chips) 
Seat 2: wtu1986 ($29.86 in chips) 
Seat 3: chiyuki ($35.94 in chips) 
Seat 4: RikkStroken ($27.31 in chips) 
Seat 5: simonzez ($50.37 in chips) 
Seat 6: Ellen1947 ($28.40 in chips) 
Seat 7: Tom1999 ($25.66 in chips) 
Seat 8: luriks27 ($24.92 in chips) 
Seat 9: johnbaco1209 ($24.33 in chips) 
wtu1986: posts small blind $0.10
chiyuki: posts big blind $0.25
*** HOLE CARDS ***
Dealt to chiyuki [8c 6c]
RikkStroken: folds 
simonzez: folds 
Ellen1947: folds 
Tom1999: folds 
luriks27: folds 
johnbaco1209: folds 
dushvan: raises $0.50 to $0.75
wtu1986: folds 
chiyuki: folds 
Uncalled bet ($0.50) returned to dushvan
dushvan collected $0.60 from pot
dushvan: doesn't show hand 
*** SUMMARY ***
Total pot $0.60 | Rake $0 
Seat 1: dushvan (button) collected ($0.60)
Seat 2: wtu1986 (small blind) folded before Flop
Seat 3: chiyuki (big blind) folded before Flop
Seat 4: RikkStroken folded before Flop (didn't bet)
Seat 5: simonzez folded before Flop (didn't bet)
Seat 6: Ellen1947 folded before Flop (didn't bet)
Seat 7: Tom1999 folded before Flop (didn't bet)
Seat 8: luriks27 folded before Flop (didn't bet)
Seat 9: johnbaco1209 folded before Flop (didn't bet)



PokerStars Zoom Hand #84299399654:  Hold'em No Limit ($0.10/$0.25) - 2012/08/05 14:16:45 JST [2012/08/05 1:16:45 ET]
Table 'Whirlpool' 9-max Seat #1 is the button
Seat 1: phate-1up ($25 in chips) 
Seat 2: chiyuki ($35.69 in chips) 
Seat 3: RikkStroken ($11 in chips) 
Seat 4: Dejacob ($29.61 in chips) 
Seat 5: Spartacus675 ($29.84 in chips) 
Seat 6: PetitAlejo ($49.94 in chips) 
Seat 7: KCDOGG10 ($11.95 in chips) 
Seat 8: Th3Fog ($74.93 in chips) 
Seat 9: troms20 ($26.51 in chips) 
chiyuki: posts small blind $0.10
RikkStroken: posts big blind $0.25
*** HOLE CARDS ***
Dealt to chiyuki [9d 2d]
Dejacob: folds 
Spartacus675: folds 
PetitAlejo: folds 
KCDOGG10: folds 
Th3Fog: folds 
troms20: folds 
phate-1up: folds 
chiyuki: folds 
Uncalled bet ($0.15) returned to RikkStroken
RikkStroken collected $0.20 from pot
RikkStroken: doesn't show hand 
*** SUMMARY ***
Total pot $0.20 | Rake $0 
Seat 1: phate-1up (button) folded before Flop (didn't bet)
Seat 2: chiyuki (small blind) folded before Flop
Seat 3: RikkStroken (big blind) collected ($0.20)
Seat 4: Dejacob folded before Flop (didn't bet)
Seat 5: Spartacus675 folded before Flop (didn't bet)
Seat 6: PetitAlejo folded before Flop (didn't bet)
Seat 7: KCDOGG10 folded before Flop (didn't bet)
Seat 8: Th3Fog folded before Flop (didn't bet)
Seat 9: troms20 folded before Flop (didn't bet)



PokerStars Zoom Hand #84299400376:  Hold'em No Limit ($0.10/$0.25) - 2012/08/05 14:16:48 JST [2012/08/05 1:16:48 ET]
Table 'Whirlpool' 9-max Seat #1 is the button
Seat 1: eyesJeJa ($26.22 in chips) 
Seat 2: Perstenev ($11.30 in chips) 
Seat 3: D@vidMed ($70.54 in chips) 
Seat 4: Faraz ($20.80 in chips) 
Seat 5: chiyuki ($35.59 in chips) 
Seat 6: RomarioJa ($17.68 in chips) 
Seat 7: kkbruins0408 ($12.50 in chips) 
Seat 8: acamrash ($12.15 in chips) 
Seat 9: ladymadon107 ($4.71 in chips) 
Perstenev: posts small blind $0.10
D@vidMed: posts big blind $0.25
*** HOLE CARDS ***
Dealt to chiyuki [Jd Ad]
Faraz: folds 
chiyuki: raises $0.50 to $0.75
RomarioJa: raises $1.55 to $2.30
kkbruins0408: folds 
acamrash: folds 
ladymadon107: folds 
eyesJeJa: folds 
Perstenev: folds 
D@vidMed: folds 
chiyuki: folds 
Uncalled bet ($1.55) returned to RomarioJa
RomarioJa collected $1.85 from pot
RomarioJa: doesn't show hand 
*** SUMMARY ***
Total pot $1.85 | Rake $0 
Seat 1: eyesJeJa (button) folded before Flop (didn't bet)
Seat 2: Perstenev (small blind) folded before Flop
Seat 3: D@vidMed (big blind) folded before Flop
Seat 4: Faraz folded before Flop (didn't bet)
Seat 5: chiyuki folded before Flop
Seat 6: RomarioJa collected ($1.85)
Seat 7: kkbruins0408 folded before Flop (didn't bet)
Seat 8: acamrash folded before Flop (didn't bet)
Seat 9: ladymadon107 folded before Flop (didn't bet)



PokerStars Zoom Hand #84299396552:  Hold'em No Limit ($0.10/$0.25) - 2012/08/05 14:16:33 JST [2012/08/05 1:16:33 ET]
Table 'Whirlpool' 9-max Seat #1 is the button
Seat 1: chiyuki ($35.69 in chips) 
Seat 2: hirozo ($34.82 in chips) 
Seat 3: Suhoff76 ($26.02 in chips) 
Seat 4: RomarioJa ($13.43 in chips) 
Seat 5: phate-1up ($26.70 in chips) 
Seat 6: jeff0923 ($24.64 in chips) 
Seat 7: Dafleche ($15.31 in chips) 
Seat 8: Landybob ($40.80 in chips) 
Seat 9: Roglus ($64.45 in chips) 
hirozo: posts small blind $0.10
Suhoff76: posts big blind $0.25
*** HOLE CARDS ***
Dealt to chiyuki [9c 7d]
RomarioJa: folds 
phate-1up: folds 
jeff0923: folds 
Dafleche: folds 
Landybob: folds 
Roglus: folds 
chiyuki: folds 
hirozo: raises $0.25 to $0.50
Suhoff76: calls $0.25
*** FLOP *** [Qs 4s 2s]
hirozo: checks 
Suhoff76: checks 
*** TURN *** [Qs 4s 2s] [3d]
hirozo: checks 
Suhoff76: checks 
*** RIVER *** [Qs 4s 2s 3d] [6c]
hirozo: checks 
Suhoff76: checks 
*** SHOW DOWN ***
hirozo: shows [9h Ts] (high card Queen)
Suhoff76: shows [Ad 4d] (a pair of Fours)
Suhoff76 collected $0.96 from pot
*** SUMMARY ***
Total pot $1 | Rake $0.04 
Board [Qs 4s 2s 3d 6c]
Seat 1: chiyuki (button) folded before Flop (didn't bet)
Seat 2: hirozo (small blind) showed [9h Ts] and lost with high card Queen
Seat 3: Suhoff76 (big blind) showed [Ad 4d] and won ($0.96) with a pair of Fours
Seat 4: RomarioJa folded before Flop (didn't bet)
Seat 5: phate-1up folded before Flop (didn't bet)
Seat 6: jeff0923 folded before Flop (didn't bet)
Seat 7: Dafleche folded before Flop (didn't bet)
Seat 8: Landybob folded before Flop (didn't bet)
Seat 9: Roglus folded before Flop (didn't bet)



PokerStars Zoom Hand #84299409374:  Hold'em No Limit ($0.10/$0.25) - 2012/08/05 14:17:25 JST [2012/08/05 1:17:25 ET]
Table 'Whirlpool' 9-max Seat #1 is the button
Seat 1: Loholov ($31.33 in chips) 
Seat 2: DanielWhyte ($26.15 in chips) 
Seat 3: ChrisCDee ($68.38 in chips) 
Seat 4: chiyuki ($34.84 in chips) 
Seat 5: Suhoff76 ($30.84 in chips) 
Seat 6: ygoegoe ($31.31 in chips) 
Seat 7: Dejacob ($25 in chips) 
Seat 8: Vahe50 ($19.91 in chips) 
Seat 9: BlOnDhOlIc ($59.96 in chips) 
DanielWhyte: posts small blind $0.10
ChrisCDee: posts big blind $0.25
*** HOLE CARDS ***
Dealt to chiyuki [8s 4h]
chiyuki: folds 
Suhoff76: folds 
ygoegoe: folds 
Dejacob: folds 
Vahe50: folds 
BlOnDhOlIc: folds 
Loholov: folds 
DanielWhyte: folds 
Uncalled bet ($0.15) returned to ChrisCDee
ChrisCDee collected $0.20 from pot
ChrisCDee: doesn't show hand 
*** SUMMARY ***
Total pot $0.20 | Rake $0 
Seat 1: Loholov (button) folded before Flop (didn't bet)
Seat 2: DanielWhyte (small blind) folded before Flop
Seat 3: ChrisCDee (big blind) collected ($0.20)
Seat 4: chiyuki folded before Flop (didn't bet)
Seat 5: Suhoff76 folded before Flop (didn't bet)
Seat 6: ygoegoe folded before Flop (didn't bet)
Seat 7: Dejacob folded before Flop (didn't bet)
Seat 8: Vahe50 folded before Flop (didn't bet)
Seat 9: BlOnDhOlIc folded before Flop (didn't bet)



PokerStars Zoom Hand #84299410126:  Hold'em No Limit ($0.10/$0.25) - 2012/08/05 14:17:28 JST [2012/08/05 1:17:28 ET]
Table 'Whirlpool' 9-max Seat #1 is the button
Seat 1: RikkStroken ($21.31 in chips) 
Seat 2: goddaz116 ($15.05 in chips) 
Seat 3: Ellen1947 ($41.42 in chips) 
Seat 4: RomarioJa ($18.78 in chips) 
Seat 5: BlOnDhOlIc ($25 in chips) 
Seat 6: leo2095 ($12.07 in chips) 
Seat 7: agurio ($28.02 in chips) 
Seat 8: hirozo ($25.95 in chips) 
Seat 9: chiyuki ($34.84 in chips) 
goddaz116: posts small blind $0.10
Ellen1947: posts big blind $0.25
*** HOLE CARDS ***
Dealt to chiyuki [Kc Td]
RomarioJa: folds 
BlOnDhOlIc: folds 
leo2095: raises $0.50 to $0.75
agurio: folds 
hirozo: folds 
chiyuki: folds 
RikkStroken: folds 
goddaz116: folds 
Ellen1947: folds 
Uncalled bet ($0.50) returned to leo2095
leo2095 collected $0.60 from pot
leo2095: doesn't show hand 
*** SUMMARY ***
Total pot $0.60 | Rake $0 
Seat 1: RikkStroken (button) folded before Flop (didn't bet)
Seat 2: goddaz116 (small blind) folded before Flop
Seat 3: Ellen1947 (big blind) folded before Flop
Seat 4: RomarioJa folded before Flop (didn't bet)
Seat 5: BlOnDhOlIc folded before Flop (didn't bet)
Seat 6: leo2095 collected ($0.60)
Seat 7: agurio folded before Flop (didn't bet)
Seat 8: hirozo folded before Flop (didn't bet)
Seat 9: chiyuki folded before Flop (didn't bet)



PokerStars Zoom Hand #84299397822:  Hold'em No Limit ($0.10/$0.25) - 2012/08/05 14:16:38 JST [2012/08/05 1:16:38 ET]
Table 'Whirlpool' 9-max Seat #1 is the button
Seat 1: Loholov ($19.45 in chips) 
Seat 2: Dafleche ($15.31 in chips) 
Seat 3: kamikkaze ($13.57 in chips) 
Seat 4: Roglus ($64.45 in chips) 
Seat 5: RomarioJa ($13.43 in chips) 
Seat 6: chiyuki ($35.69 in chips) 
Seat 7: el pore 5 ($15.26 in chips) 
Seat 8: slapshot2011 ($33.69 in chips) 
Seat 9: seula i ($61.29 in chips) 
Dafleche: posts small blind $0.10
kamikkaze: posts big blind $0.25
*** HOLE CARDS ***
Dealt to chiyuki [5d Ks]
Roglus: folds 
RomarioJa: folds 
chiyuki: folds 
el pore 5: calls $0.25
slapshot2011: folds 
seula i: calls $0.25
Loholov: folds 
Dafleche: folds 
kamikkaze: checks 
*** FLOP *** [Qs Jd 3c]
kamikkaze: checks 
el pore 5: checks 
seula i: checks 
*** TURN *** [Qs Jd 3c] [4h]
kamikkaze: bets $0.52
el pore 5: calls $0.52
seula i: folds 
*** RIVER *** [Qs Jd 3c 4h] [Jc]
kamikkaze: checks 
el pore 5: bets $0.25
kamikkaze: calls $0.25
*** SHOW DOWN ***
el pore 5: shows [4s 4c] (a full house, Fours full of Jacks)
kamikkaze: mucks hand 
el pore 5 collected $2.28 from pot
*** SUMMARY ***
Total pot $2.39 | Rake $0.11 
Board [Qs Jd 3c 4h Jc]
Seat 1: Loholov (button) folded before Flop (didn't bet)
Seat 2: Dafleche (small blind) folded before Flop
Seat 3: kamikkaze (big blind) mucked [Qd 8d]
Seat 4: Roglus folded before Flop (didn't bet)
Seat 5: RomarioJa folded before Flop (didn't bet)
Seat 6: chiyuki folded before Flop (didn't bet)
Seat 7: el pore 5 showed [4s 4c] and won ($2.28) with a full house, Fours full of Jacks
Seat 8: slapshot2011 folded before Flop (didn't bet)
Seat 9: seula i folded on the Turn



PokerStars Zoom Hand #84299411096:  Hold'em No Limit ($0.10/$0.25) - 2012/08/05 14:17:32 JST [2012/08/05 1:17:32 ET]
Table 'Whirlpool' 9-max Seat #1 is the button
Seat 1: flyinprits ($34.86 in chips) 
Seat 2: kamikkaze ($32.66 in chips) 
Seat 3: roksmokndonk ($33.11 in chips) 
Seat 4: Th3Fog ($74.93 in chips) 
Seat 5: eyesJeJa ($25.10 in chips) 
Seat 6: chiyuki ($34.84 in chips) 
Seat 7: troms20 ($50.19 in chips) 
Seat 8: DanielWhyte ($26.05 in chips) 
Seat 9: phate-1up ($25.35 in chips) 
kamikkaze: posts small blind $0.10
roksmokndonk: posts big blind $0.25
*** HOLE CARDS ***
Dealt to chiyuki [Ks Th]
Th3Fog: folds 
eyesJeJa: folds 
chiyuki: folds 
troms20: raises $0.50 to $0.75
DanielWhyte: calls $0.75
phate-1up: folds 
flyinprits: folds 
kamikkaze: folds 
roksmokndonk: folds 
*** FLOP *** [6c 8c Kc]
troms20: bets $1.25
DanielWhyte: calls $1.25
*** TURN *** [6c 8c Kc] [3c]
troms20: checks 
DanielWhyte: checks 
*** RIVER *** [6c 8c Kc 3c] [2s]
troms20: checks 
DanielWhyte: bets $0.75
troms20: calls $0.75
*** SHOW DOWN ***
DanielWhyte: shows [7d 7c] (a flush, King high)
troms20: shows [9s 9c] (a flush, King high - Nine higher)
troms20 collected $5.59 from pot
*** SUMMARY ***
Total pot $5.85 | Rake $0.26 
Board [6c 8c Kc 3c 2s]
Seat 1: flyinprits (button) folded before Flop (didn't bet)
Seat 2: kamikkaze (small blind) folded before Flop
Seat 3: roksmokndonk (big blind) folded before Flop
Seat 4: Th3Fog folded before Flop (didn't bet)
Seat 5: eyesJeJa folded before Flop (didn't bet)
Seat 6: chiyuki folded before Flop (didn't bet)
Seat 7: troms20 showed [9s 9c] and won ($5.59) with a flush, King high
Seat 8: DanielWhyte showed [7d 7c] and lost with a flush, King high
Seat 9: phate-1up folded before Flop (didn't bet)



PokerStars Zoom Hand #84299412134:  Hold'em No Limit ($0.10/$0.25) - 2012/08/05 14:17:36 JST [2012/08/05 1:17:36 ET]
Table 'Whirlpool' 9-max Seat #1 is the button
Seat 1: Spartacus675 ($29.74 in chips) 
Seat 2: PetitAlejo ($34.62 in chips) 
Seat 3: chiyuki ($34.84 in chips) 
Seat 4: Anafim ($12.50 in chips) 
Seat 5: Dejacob ($25 in chips) 
Seat 6: phate-1up ($25.35 in chips) 
Seat 7: eyesJeJa ($29.27 in chips) 
Seat 8: Suhoff76 ($25 in chips) 
Seat 9: D@vidMed ($70.54 in chips) 
PetitAlejo: posts small blind $0.10
chiyuki: posts big blind $0.25
*** HOLE CARDS ***
Dealt to chiyuki [9c Td]
Anafim: folds 
Dejacob: folds 
phate-1up: folds 
eyesJeJa: folds 
Suhoff76: folds 
D@vidMed: folds 
Spartacus675: folds 
PetitAlejo: folds 
Uncalled bet ($0.15) returned to chiyuki
chiyuki collected $0.20 from pot
chiyuki: doesn't show hand 
*** SUMMARY ***
Total pot $0.20 | Rake $0 
Seat 1: Spartacus675 (button) folded before Flop (didn't bet)
Seat 2: PetitAlejo (small blind) folded before Flop
Seat 3: chiyuki (big blind) collected ($0.20)
Seat 4: Anafim folded before Flop (didn't bet)
Seat 5: Dejacob folded before Flop (didn't bet)
Seat 6: phate-1up folded before Flop (didn't bet)
Seat 7: eyesJeJa folded before Flop (didn't bet)
Seat 8: Suhoff76 folded before Flop (didn't bet)
Seat 9: D@vidMed folded before Flop (didn't bet)



PokerStars Zoom Hand #84299423263:  Hold'em No Limit ($0.10/$0.25) - 2012/08/05 14:18:22 JST [2012/08/05 1:18:22 ET]
Table 'Whirlpool' 9-max Seat #1 is the button
Seat 1: dushvan ($30.92 in chips) 
Seat 2: Nerkit ($9.30 in chips) 
Seat 3: hirozo ($33.47 in chips) 
Seat 4: Dan Royal ($41.84 in chips) 
Seat 5: Tom1999 ($5.55 in chips) 
Seat 6: RomarioJa ($12.15 in chips) 
Seat 7: chiyuki ($34.94 in chips) 
Seat 8: kamikkaze ($12.45 in chips) 
Seat 9: Vahe50 ($19.81 in chips) 
Nerkit: posts small blind $0.10
hirozo: posts big blind $0.25
*** HOLE CARDS ***
Dealt to chiyuki [4h 2d]
Dan Royal: folds 
Tom1999: raises $0.50 to $0.75
RomarioJa: folds 
chiyuki: folds 
kamikkaze: folds 
Vahe50: folds 
dushvan: folds 
Nerkit: folds 
hirozo: folds 
Uncalled bet ($0.50) returned to Tom1999
Tom1999 collected $0.60 from pot
Tom1999: doesn't show hand 
*** SUMMARY ***
Total pot $0.60 | Rake $0 
Seat 1: dushvan (button) folded before Flop (didn't bet)
Seat 2: Nerkit (small blind) folded before Flop
Seat 3: hirozo (big blind) folded before Flop
Seat 4: Dan Royal folded before Flop (didn't bet)
Seat 5: Tom1999 collected ($0.60)
Seat 6: RomarioJa folded before Flop (didn't bet)
Seat 7: chiyuki folded before Flop (didn't bet)
Seat 8: kamikkaze folded before Flop (didn't bet)
Seat 9: Vahe50 folded before Flop (didn't bet)



PokerStars Zoom Hand #84299424217:  Hold'em No Limit ($0.10/$0.25) - 2012/08/05 14:18:26 JST [2012/08/05 1:18:26 ET]
Table 'Whirlpool' 9-max Seat #1 is the button
Seat 1: phate-1up ($34.24 in chips) 
Seat 2: chiyuki ($34.94 in chips) 
Seat 3: Perstenev ($13 in chips) 
Seat 4: ygoegoe ($27.56 in chips) 
Seat 5: Dan Royal ($41.84 in chips) 
Seat 6: Loholov ($17.65 in chips) 
Seat 7: Th3Fog ($17.57 in chips) 
Seat 8: deadmoneykid ($30.79 in chips) 
Seat 9: Ellen1947 ($27.70 in chips) 
chiyuki: posts small blind $0.10
Perstenev: posts big blind $0.25
*** HOLE CARDS ***
Dealt to chiyuki [Qh Th]
ygoegoe: folds 
Dan Royal: folds 
Loholov: folds 
Th3Fog: folds 
deadmoneykid: folds 
Ellen1947: folds 
phate-1up: folds 
chiyuki: raises $0.50 to $0.75
Perstenev: folds 
Uncalled bet ($0.50) returned to chiyuki
chiyuki collected $0.50 from pot
chiyuki: doesn't show hand 
*** SUMMARY ***
Total pot $0.50 | Rake $0 
Seat 1: phate-1up (button) folded before Flop (didn't bet)
Seat 2: chiyuki (small blind) collected ($0.50)
Seat 3: Perstenev (big blind) folded before Flop
Seat 4: ygoegoe folded before Flop (didn't bet)
Seat 5: Dan Royal folded before Flop (didn't bet)
Seat 6: Loholov folded before Flop (didn't bet)
Seat 7: Th3Fog folded before Flop (didn't bet)
Seat 8: deadmoneykid folded before Flop (didn't bet)
Seat 9: Ellen1947 folded before Flop (didn't bet)



PokerStars Zoom Hand #84299419253:  Hold'em No Limit ($0.10/$0.25) - 2012/08/05 14:18:05 JST [2012/08/05 1:18:05 ET]
Table 'Whirlpool' 9-max Seat #1 is the button
Seat 1: chiyuki ($34.94 in chips) 
Seat 2: simonzez ($48.16 in chips) 
Seat 3: hirozo ($35.43 in chips) 
Seat 4: Th3Fog ($74.93 in chips) 
Seat 5: kamikkaze ($12.55 in chips) 
Seat 6: eyesJeJa ($25 in chips) 
Seat 7: Vahe50 ($19.81 in chips) 
Seat 8: Perstenev ($13 in chips) 
Seat 9: Ellen1947 ($41.07 in chips) 
simonzez: posts small blind $0.10
hirozo: posts big blind $0.25
*** HOLE CARDS ***
Dealt to chiyuki [7c Th]
Th3Fog: folds 
kamikkaze: folds 
eyesJeJa: folds 
Vahe50: folds 
Perstenev: folds 
Ellen1947: folds 
chiyuki: folds 
simonzez: calls $0.15
hirozo: raises $0.65 to $0.90
simonzez: folds 
Uncalled bet ($0.65) returned to hirozo
hirozo collected $0.50 from pot
hirozo: doesn't show hand 
*** SUMMARY ***
Total pot $0.50 | Rake $0 
Seat 1: chiyuki (button) folded before Flop (didn't bet)
Seat 2: simonzez (small blind) folded before Flop
Seat 3: hirozo (big blind) collected ($0.50)
Seat 4: Th3Fog folded before Flop (didn't bet)
Seat 5: kamikkaze folded before Flop (didn't bet)
Seat 6: eyesJeJa folded before Flop (didn't bet)
Seat 7: Vahe50 folded before Flop (didn't bet)
Seat 8: Perstenev folded before Flop (didn't bet)
Seat 9: Ellen1947 folded before Flop (didn't bet)



PokerStars Zoom Hand #84299427732:  Hold'em No Limit ($0.10/$0.25) - 2012/08/05 14:18:40 JST [2012/08/05 1:18:40 ET]
Table 'Whirlpool' 9-max Seat #1 is the button
Seat 1: Ellen1947 ($41.07 in chips) 
Seat 2: seula i ($27.84 in chips) 
Seat 3: Suhoff76 ($31.45 in chips) 
Seat 4: chiyuki ($35.19 in chips) 
Seat 5: Lasutchik ($58.78 in chips) 
Seat 6: Nerkit ($11.55 in chips) 
Seat 7: kamikkaze ($22.80 in chips) 
Seat 8: fezman ($14.23 in chips) 
Seat 9: PetitAlejo ($35.13 in chips) 
seula i: posts small blind $0.10
Suhoff76: posts big blind $0.25
*** HOLE CARDS ***
Dealt to chiyuki [Ad 3c]
chiyuki: folds 
Lasutchik: folds 
Nerkit: folds 
kamikkaze: raises $0.38 to $0.63
fezman: folds 
PetitAlejo: raises $1.87 to $2.50
Ellen1947: folds 
seula i: folds 
Suhoff76: folds 
kamikkaze: folds 
Uncalled bet ($1.87) returned to PetitAlejo
PetitAlejo collected $1.61 from pot
PetitAlejo: doesn't show hand 
*** SUMMARY ***
Total pot $1.61 | Rake $0 
Seat 1: Ellen1947 (button) folded before Flop (didn't bet)
Seat 2: seula i (small blind) folded before Flop
Seat 3: Suhoff76 (big blind) folded before Flop
Seat 4: chiyuki folded before Flop (didn't bet)
Seat 5: Lasutchik folded before Flop (didn't bet)
Seat 6: Nerkit folded before Flop (didn't bet)
Seat 7: kamikkaze folded before Flop
Seat 8: fezman folded before Flop (didn't bet)
Seat 9: PetitAlejo collected ($1.61)



PokerStars Zoom Hand #84299422275:  Hold'em No Limit ($0.10/$0.25) - 2012/08/05 14:18:18 JST [2012/08/05 1:18:18 ET]
Table 'Whirlpool' 9-max Seat #1 is the button
Seat 1: Tom1999 ($27.49 in chips) 
Seat 2: D@vidMed ($70.29 in chips) 
Seat 3: sparky5224 ($33.72 in chips) 
Seat 4: phate-1up ($34.24 in chips) 
Seat 5: Wilcox76607 ($22.10 in chips) 
Seat 6: Perstenev ($13.44 in chips) 
Seat 7: Lasutchik ($8.66 in chips) 
Seat 8: chiyuki ($34.94 in chips) 
Seat 9: BlOnDhOlIc ($25.10 in chips) 
D@vidMed: posts small blind $0.10
sparky5224: posts big blind $0.25
*** HOLE CARDS ***
Dealt to chiyuki [Ad 2s]
phate-1up: folds 
Wilcox76607: folds 
Perstenev: folds 
Lasutchik: folds 
chiyuki: folds 
BlOnDhOlIc: raises $0.25 to $0.50
Tom1999: folds 
D@vidMed: folds 
sparky5224: calls $0.25
*** FLOP *** [8c 5s Qd]
sparky5224: bets $0.25
BlOnDhOlIc: raises $1 to $1.25
sparky5224: calls $1
*** TURN *** [8c 5s Qd] [7d]
sparky5224: checks 
BlOnDhOlIc: checks 
*** RIVER *** [8c 5s Qd 7d] [Qs]
sparky5224: bets $1
BlOnDhOlIc: folds 
Uncalled bet ($1) returned to sparky5224
sparky5224 collected $3.44 from pot
sparky5224: doesn't show hand 
*** SUMMARY ***
Total pot $3.60 | Rake $0.16 
Board [8c 5s Qd 7d Qs]
Seat 1: Tom1999 (button) folded before Flop (didn't bet)
Seat 2: D@vidMed (small blind) folded before Flop
Seat 3: sparky5224 (big blind) collected ($3.44)
Seat 4: phate-1up folded before Flop (didn't bet)
Seat 5: Wilcox76607 folded before Flop (didn't bet)
Seat 6: Perstenev folded before Flop (didn't bet)
Seat 7: Lasutchik folded before Flop (didn't bet)
Seat 8: chiyuki folded before Flop (didn't bet)
Seat 9: BlOnDhOlIc folded on the River



PokerStars Zoom Hand #84299428724:  Hold'em No Limit ($0.10/$0.25) - 2012/08/05 14:18:44 JST [2012/08/05 1:18:44 ET]
Table 'Whirlpool' 9-max Seat #1 is the button
Seat 1: Th3Fog ($49.23 in chips) 
Seat 2: Loholov ($17.65 in chips) 
Seat 3: Dan Royal ($41.84 in chips) 
Seat 4: DanielWhyte ($23.33 in chips) 
Seat 5: Nerkit ($11.55 in chips) 
Seat 6: chiyuki ($35.19 in chips) 
Seat 7: eyesJeJa ($25.04 in chips) 
Seat 8: RomarioJa ($10.56 in chips) 
Seat 9: KeLevro0 ($12.50 in chips) 
Loholov: posts small blind $0.10
Dan Royal: posts big blind $0.25
*** HOLE CARDS ***
Dealt to chiyuki [Ad 5d]
DanielWhyte: folds 
Nerkit: folds 
chiyuki: folds 
eyesJeJa: folds 
RomarioJa: folds 
KeLevro0: folds 
Th3Fog: raises $0.47 to $0.72
Loholov: folds 
Dan Royal: folds 
Uncalled bet ($0.47) returned to Th3Fog
Th3Fog collected $0.60 from pot
Th3Fog: doesn't show hand 
*** SUMMARY ***
Total pot $0.60 | Rake $0 
Seat 1: Th3Fog (button) collected ($0.60)
Seat 2: Loholov (small blind) folded before Flop
Seat 3: Dan Royal (big blind) folded before Flop
Seat 4: DanielWhyte folded before Flop (didn't bet)
Seat 5: Nerkit folded before Flop (didn't bet)
Seat 6: chiyuki folded before Flop (didn't bet)
Seat 7: eyesJeJa folded before Flop (didn't bet)
Seat 8: RomarioJa folded before Flop (didn't bet)
Seat 9: KeLevro0 folded before Flop (didn't bet)



PokerStars Zoom Hand #84299432336:  Hold'em No Limit ($0.10/$0.25) - 2012/08/05 14:18:58 JST [2012/08/05 1:18:58 ET]
Table 'Whirlpool' 9-max Seat #1 is the button
Seat 1: acamrash ($15.99 in chips) 
Seat 2: troms20 ($27.18 in chips) 
Seat 3: carlosrbr ($50.70 in chips) 
Seat 4: Dejacob ($39.03 in chips) 
Seat 5: chiyuki ($35.19 in chips) 
Seat 6: Suhoff76 ($25 in chips) 
Seat 7: agurio ($26.95 in chips) 
Seat 8: jeff0923 ($26.01 in chips) 
Seat 9: deadmoneykid ($23.02 in chips) 
troms20: posts small blind $0.10
carlosrbr: posts big blind $0.25
*** HOLE CARDS ***
Dealt to chiyuki [5h 7d]
Dejacob: folds 
chiyuki: folds 
Suhoff76: folds 
agurio: folds 
jeff0923: folds 
deadmoneykid: folds 
acamrash: folds 
troms20: folds 
Uncalled bet ($0.15) returned to carlosrbr
carlosrbr collected $0.20 from pot
carlosrbr: doesn't show hand 
*** SUMMARY ***
Total pot $0.20 | Rake $0 
Seat 1: acamrash (button) folded before Flop (didn't bet)
Seat 2: troms20 (small blind) folded before Flop
Seat 3: carlosrbr (big blind) collected ($0.20)
Seat 4: Dejacob folded before Flop (didn't bet)
Seat 5: chiyuki folded before Flop (didn't bet)
Seat 6: Suhoff76 folded before Flop (didn't bet)
Seat 7: agurio folded before Flop (didn't bet)
Seat 8: jeff0923 folded before Flop (didn't bet)
Seat 9: deadmoneykid folded before Flop (didn't bet)



PokerStars Zoom Hand #84299433596:  Hold'em No Limit ($0.10/$0.25) - 2012/08/05 14:19:03 JST [2012/08/05 1:19:03 ET]
Table 'Whirlpool' 9-max Seat #1 is the button
Seat 1: ll_LaMeR_ll ($48.28 in chips) 
Seat 2: taksist889 ($25.60 in chips) 
Seat 3: chiyuki ($35.19 in chips) 
Seat 4: kamikkaze ($12.20 in chips) 
Seat 5: Nerkit ($11.65 in chips) 
Seat 6: Suhoff76 ($26.48 in chips) 
Seat 7: Dejacob ($25.92 in chips) 
Seat 8: BlOnDhOlIc ($25 in chips) 
Seat 9: leo2095 ($11.32 in chips) 
taksist889: posts small blind $0.10
chiyuki: posts big blind $0.25
*** HOLE CARDS ***
Dealt to chiyuki [2d As]
kamikkaze: folds 
Nerkit: folds 
Suhoff76: folds 
Dejacob: folds 
BlOnDhOlIc: folds 
leo2095: folds 
ll_LaMeR_ll: raises $0.50 to $0.75
taksist889: folds 
chiyuki: folds 
Uncalled bet ($0.50) returned to ll_LaMeR_ll
ll_LaMeR_ll collected $0.60 from pot
ll_LaMeR_ll: doesn't show hand 
*** SUMMARY ***
Total pot $0.60 | Rake $0 
Seat 1: ll_LaMeR_ll (button) collected ($0.60)
Seat 2: taksist889 (small blind) folded before Flop
Seat 3: chiyuki (big blind) folded before Flop
Seat 4: kamikkaze folded before Flop (didn't bet)
Seat 5: Nerkit folded before Flop (didn't bet)
Seat 6: Suhoff76 folded before Flop (didn't bet)
Seat 7: Dejacob folded before Flop (didn't bet)
Seat 8: BlOnDhOlIc folded before Flop (didn't bet)
Seat 9: leo2095 folded before Flop (didn't bet)



PokerStars Zoom Hand #84299430823:  Hold'em No Limit ($0.10/$0.25) - 2012/08/05 14:18:52 JST [2012/08/05 1:18:52 ET]
Table 'Whirlpool' 9-max Seat #1 is the button
Seat 1: Perstenev ($12.92 in chips) 
Seat 2: ygoegoe ($30.44 in chips) 
Seat 3: ChrisCDee ($25 in chips) 
Seat 4: DanielWhyte ($23.33 in chips) 
Seat 5: fezman ($14.23 in chips) 
Seat 6: kamikkaze ($12.20 in chips) 
Seat 7: PetitAlejo ($34.87 in chips) 
Seat 8: Suhoff76 ($25 in chips) 
Seat 9: chiyuki ($35.19 in chips) 
ygoegoe: posts small blind $0.10
ChrisCDee: posts big blind $0.25
*** HOLE CARDS ***
Dealt to chiyuki [Js 8c]
DanielWhyte: folds 
fezman: folds 
kamikkaze: folds 
PetitAlejo: folds 
Suhoff76: folds 
chiyuki: folds 
Perstenev: calls $0.25
ygoegoe: calls $0.15
ChrisCDee: checks 
*** FLOP *** [3s 4h As]
ygoegoe: bets $0.39
ChrisCDee: folds 
Perstenev: folds 
Uncalled bet ($0.39) returned to ygoegoe
ygoegoe collected $0.72 from pot
ygoegoe: doesn't show hand 
*** SUMMARY ***
Total pot $0.75 | Rake $0.03 
Board [3s 4h As]
Seat 1: Perstenev (button) folded on the Flop
Seat 2: ygoegoe (small blind) collected ($0.72)
Seat 3: ChrisCDee (big blind) folded on the Flop
Seat 4: DanielWhyte folded before Flop (didn't bet)
Seat 5: fezman folded before Flop (didn't bet)
Seat 6: kamikkaze folded before Flop (didn't bet)
Seat 7: PetitAlejo folded before Flop (didn't bet)
Seat 8: Suhoff76 folded before Flop (didn't bet)
Seat 9: chiyuki folded before Flop (didn't bet)



PokerStars Zoom Hand #84299438292:  Hold'em No Limit ($0.10/$0.25) - 2012/08/05 14:19:22 JST [2012/08/05 1:19:22 ET]
Table 'Whirlpool' 9-max Seat #1 is the button
Seat 1: kamikkaze ($12.10 in chips) 
Seat 2: chiyuki ($34.94 in chips) 
Seat 3: Spartacus675 ($27.09 in chips) 
Seat 4: KeLevro0 ($11.47 in chips) 
Seat 5: Lasutchik ($8.56 in chips) 
Seat 6: acamrash ($15.99 in chips) 
Seat 7: Nerkit ($12.50 in chips) 
Seat 8: roksmokndonk ($33.56 in chips) 
Seat 9: ygoegoe ($30.91 in chips) 
chiyuki: posts small blind $0.10
Spartacus675: posts big blind $0.25
*** HOLE CARDS ***
Dealt to chiyuki [Qd 6d]
KeLevro0: folds 
Lasutchik: folds 
acamrash: folds 
Nerkit: folds 
roksmokndonk: folds 
ygoegoe: raises $0.50 to $0.75
kamikkaze: folds 
chiyuki: folds 
Spartacus675: folds 
Uncalled bet ($0.50) returned to ygoegoe
ygoegoe collected $0.60 from pot
ygoegoe: doesn't show hand 
*** SUMMARY ***
Total pot $0.60 | Rake $0 
Seat 1: kamikkaze (button) folded before Flop (didn't bet)
Seat 2: chiyuki (small blind) folded before Flop
Seat 3: Spartacus675 (big blind) folded before Flop
Seat 4: KeLevro0 folded before Flop (didn't bet)
Seat 5: Lasutchik folded before Flop (didn't bet)
Seat 6: acamrash folded before Flop (didn't bet)
Seat 7: Nerkit folded before Flop (didn't bet)
Seat 8: roksmokndonk folded before Flop (didn't bet)
Seat 9: ygoegoe collected ($0.60)



PokerStars Zoom Hand #84299443814:  Hold'em No Limit ($0.10/$0.25) - 2012/08/05 14:19:45 JST [2012/08/05 1:19:45 ET]
Table 'Whirlpool' 9-max Seat #1 is the button
Seat 1: chiyuki ($34.84 in chips) 
Seat 2: seula i ($28.15 in chips) 
Seat 3: deadmoneykid ($23.38 in chips) 
Seat 4: Jene4kaBest ($12.66 in chips) 
Seat 5: PetitAlejo ($29.52 in chips) 
Seat 6: Roglus ($59.09 in chips) 
Seat 7: Dejacob ($40.27 in chips) 
Seat 8: simonzez ($48.93 in chips) 
Seat 9: Loholov ($21.94 in chips) 
seula i: posts small blind $0.10
deadmoneykid: posts big blind $0.25
*** HOLE CARDS ***
Dealt to chiyuki [3h 9c]
Jene4kaBest: folds 
PetitAlejo: folds 
Roglus: folds 
Dejacob: folds 
simonzez: raises $0.25 to $0.50
Loholov: folds 
chiyuki: folds 
seula i: folds 
deadmoneykid: folds 
Uncalled bet ($0.25) returned to simonzez
simonzez collected $0.60 from pot
simonzez: doesn't show hand 
*** SUMMARY ***
Total pot $0.60 | Rake $0 
Seat 1: chiyuki (button) folded before Flop (didn't bet)
Seat 2: seula i (small blind) folded before Flop
Seat 3: deadmoneykid (big blind) folded before Flop
Seat 4: Jene4kaBest folded before Flop (didn't bet)
Seat 5: PetitAlejo folded before Flop (didn't bet)
Seat 6: Roglus folded before Flop (didn't bet)
Seat 7: Dejacob folded before Flop (didn't bet)
Seat 8: simonzez collected ($0.60)
Seat 9: Loholov folded before Flop (didn't bet)



PokerStars Zoom Hand #84299445555:  Hold'em No Limit ($0.10/$0.25) - 2012/08/05 14:19:52 JST [2012/08/05 1:19:52 ET]
Table 'Whirlpool' 9-max Seat #1 is the button
Seat 1: RikkStroken ($27.21 in chips) 
Seat 2: RomarioJa ($14.11 in chips) 
Seat 3: troms20 ($27.08 in chips) 
Seat 4: hirozo ($35.93 in chips) 
Seat 5: agurio ($25 in chips) 
Seat 6: silvno31 ($34.60 in chips) 
Seat 7: Th3Fog ($49.33 in chips) 
Seat 8: chiyuki ($34.84 in chips) 
Seat 9: Perstenev ($11.49 in chips) 
RomarioJa: posts small blind $0.10
troms20: posts big blind $0.25
*** HOLE CARDS ***
Dealt to chiyuki [3h Qd]
hirozo: folds 
agurio: folds 
silvno31: folds 
Th3Fog: folds 
chiyuki: folds 
Perstenev: folds 
RikkStroken: folds 
RomarioJa: raises $0.37 to $0.62
troms20: folds 
Uncalled bet ($0.37) returned to RomarioJa
RomarioJa collected $0.50 from pot
RomarioJa: doesn't show hand 
*** SUMMARY ***
Total pot $0.50 | Rake $0 
Seat 1: RikkStroken (button) folded before Flop (didn't bet)
Seat 2: RomarioJa (small blind) collected ($0.50)
Seat 3: troms20 (big blind) folded before Flop
Seat 4: hirozo folded before Flop (didn't bet)
Seat 5: agurio folded before Flop (didn't bet)
Seat 6: silvno31 folded before Flop (didn't bet)
Seat 7: Th3Fog folded before Flop (didn't bet)
Seat 8: chiyuki folded before Flop (didn't bet)
Seat 9: Perstenev folded before Flop (didn't bet)



PokerStars Zoom Hand #84299437277:  Hold'em No Limit ($0.10/$0.25) - 2012/08/05 14:19:18 JST [2012/08/05 1:19:18 ET]
Table 'Whirlpool' 9-max Seat #1 is the button
Seat 1: taksist889 ($25.50 in chips) 
Seat 2: Dejacob ($25 in chips) 
Seat 3: phate-1up ($27.32 in chips) 
Seat 4: wtu1986 ($25.35 in chips) 
Seat 5: troms20 ($27.08 in chips) 
Seat 6: roksmokndonk ($33.56 in chips) 
Seat 7: chiyuki ($34.94 in chips) 
Seat 8: acamrash ($15.99 in chips) 
Seat 9: Tom1999 ($27.14 in chips) 
Dejacob: posts small blind $0.10
phate-1up: posts big blind $0.25
*** HOLE CARDS ***
Dealt to chiyuki [9s 7s]
wtu1986: folds 
troms20: folds 
roksmokndonk: folds 
chiyuki: folds 
acamrash: folds 
Tom1999: raises $0.50 to $0.75
taksist889: calls $0.75
Dejacob: folds 
phate-1up: folds 
*** FLOP *** [Ks Ah 3s]
Tom1999: checks 
taksist889: bets $1
Tom1999: calls $1
*** TURN *** [Ks Ah 3s] [Jd]
Tom1999: checks 
taksist889: bets $2
Tom1999: folds 
Uncalled bet ($2) returned to taksist889
taksist889 collected $3.68 from pot
taksist889: doesn't show hand 
*** SUMMARY ***
Total pot $3.85 | Rake $0.17 
Board [Ks Ah 3s Jd]
Seat 1: taksist889 (button) collected ($3.68)
Seat 2: Dejacob (small blind) folded before Flop
Seat 3: phate-1up (big blind) folded before Flop
Seat 4: wtu1986 folded before Flop (didn't bet)
Seat 5: troms20 folded before Flop (didn't bet)
Seat 6: roksmokndonk folded before Flop (didn't bet)
Seat 7: chiyuki folded before Flop (didn't bet)
Seat 8: acamrash folded before Flop (didn't bet)
Seat 9: Tom1999 folded on the Turn



PokerStars Zoom Hand #84299448953:  Hold'em No Limit ($0.10/$0.25) - 2012/08/05 14:20:06 JST [2012/08/05 1:20:06 ET]
Table 'Whirlpool' 9-max Seat #1 is the button
Seat 1: RikkStroken ($13.76 in chips) 
Seat 2: acamrash ($11.45 in chips) 
Seat 3: Landybob ($43.40 in chips) 
Seat 4: chiyuki ($34.84 in chips) 
Seat 5: simonzez ($49.28 in chips) 
Seat 6: hirozo ($33.22 in chips) 
Seat 7: Perstenev ($13.26 in chips) 
Seat 8: leo2095 ($14.21 in chips) 
Seat 9: D@vidMed ($67.84 in chips) 
acamrash: posts small blind $0.10
Landybob: posts big blind $0.25
*** HOLE CARDS ***
Dealt to chiyuki [6h 5s]
chiyuki: folds 
simonzez: folds 
hirozo: folds 
Perstenev: folds 
leo2095: folds 
D@vidMed: folds 
RikkStroken: folds 
acamrash: folds 
Uncalled bet ($0.15) returned to Landybob
Landybob collected $0.20 from pot
Landybob: doesn't show hand 
*** SUMMARY ***
Total pot $0.20 | Rake $0 
Seat 1: RikkStroken (button) folded before Flop (didn't bet)
Seat 2: acamrash (small blind) folded before Flop
Seat 3: Landybob (big blind) collected ($0.20)
Seat 4: chiyuki folded before Flop (didn't bet)
Seat 5: simonzez folded before Flop (didn't bet)
Seat 6: hirozo folded before Flop (didn't bet)
Seat 7: Perstenev folded before Flop (didn't bet)
Seat 8: leo2095 folded before Flop (didn't bet)
Seat 9: D@vidMed folded before Flop (didn't bet)



PokerStars Zoom Hand #84299449653:  Hold'em No Limit ($0.10/$0.25) - 2012/08/05 14:20:09 JST [2012/08/05 1:20:09 ET]
Table 'Whirlpool' 9-max Seat #1 is the button
Seat 1: Suhoff76 ($28.53 in chips) 
Seat 2: seula i ($27.49 in chips) 
Seat 3: KeLevro0 ($12.15 in chips) 
Seat 4: PetitAlejo ($34.87 in chips) 
Seat 5: WARIBANA7777 ($13.99 in chips) 
Seat 6: troms20 ($57.58 in chips) 
Seat 7: Th3Fog ($73.93 in chips) 
Seat 8: Spartacus675 ($27.86 in chips) 
Seat 9: chiyuki ($34.84 in chips) 
seula i: posts small blind $0.10
KeLevro0: posts big blind $0.25
*** HOLE CARDS ***
Dealt to chiyuki [3s 4c]
PetitAlejo: folds 
WARIBANA7777: folds 
troms20: folds 
Th3Fog: folds 
Spartacus675: folds 
chiyuki: folds 
Suhoff76: folds 
seula i: folds 
Uncalled bet ($0.15) returned to KeLevro0
KeLevro0 collected $0.20 from pot
KeLevro0: doesn't show hand 
*** SUMMARY ***
Total pot $0.20 | Rake $0 
Seat 1: Suhoff76 (button) folded before Flop (didn't bet)
Seat 2: seula i (small blind) folded before Flop
Seat 3: KeLevro0 (big blind) collected ($0.20)
Seat 4: PetitAlejo folded before Flop (didn't bet)
Seat 5: WARIBANA7777 folded before Flop (didn't bet)
Seat 6: troms20 folded before Flop (didn't bet)
Seat 7: Th3Fog folded before Flop (didn't bet)
Seat 8: Spartacus675 folded before Flop (didn't bet)
Seat 9: chiyuki folded before Flop (didn't bet)



PokerStars Zoom Hand #84299447494:  Hold'em No Limit ($0.10/$0.25) - 2012/08/05 14:20:00 JST [2012/08/05 1:20:00 ET]
Table 'Whirlpool' 9-max Seat #1 is the button
Seat 1: phate-1up ($25 in chips) 
Seat 2: JLajoie ($26.55 in chips) 
Seat 3: seula i ($25 in chips) 
Seat 4: chiyuki ($34.84 in chips) 
Seat 5: kamikkaze ($31.02 in chips) 
Seat 6: Nerkit ($19.43 in chips) 
Seat 7: RikkStroken ($13.76 in chips) 
Seat 8: Th3Fog ($49.33 in chips) 
Seat 9: Dejacob ($25 in chips) 
JLajoie: posts small blind $0.10
seula i: posts big blind $0.25
*** HOLE CARDS ***
Dealt to chiyuki [5d 2c]
chiyuki: folds 
kamikkaze: folds 
Nerkit: folds 
RikkStroken: folds 
Th3Fog: folds 
Dejacob: folds 
phate-1up: raises $0.50 to $0.75
JLajoie: folds 
seula i: folds 
Uncalled bet ($0.50) returned to phate-1up
phate-1up collected $0.60 from pot
phate-1up: doesn't show hand 
*** SUMMARY ***
Total pot $0.60 | Rake $0 
Seat 1: phate-1up (button) collected ($0.60)
Seat 2: JLajoie (small blind) folded before Flop
Seat 3: seula i (big blind) folded before Flop
Seat 4: chiyuki folded before Flop (didn't bet)
Seat 5: kamikkaze folded before Flop (didn't bet)
Seat 6: Nerkit folded before Flop (didn't bet)
Seat 7: RikkStroken folded before Flop (didn't bet)
Seat 8: Th3Fog folded before Flop (didn't bet)
Seat 9: Dejacob folded before Flop (didn't bet)



PokerStars Zoom Hand #84299451949:  Hold'em No Limit ($0.10/$0.25) - 2012/08/05 14:20:18 JST [2012/08/05 1:20:18 ET]
Table 'Whirlpool' 9-max Seat #1 is the button
Seat 1: seula i ($27.39 in chips) 
Seat 2: RikkStroken ($11.20 in chips) 
Seat 3: chiyuki ($34.84 in chips) 
Seat 4: jeff0923 ($25.51 in chips) 
Seat 5: Ellen1947 ($27.70 in chips) 
Seat 6: Scruf13 ($5.50 in chips) 
Seat 7: Th3Fog ($49.08 in chips) 
Seat 8: JLajoie ($26.45 in chips) 
Seat 9: troms20 ($26.73 in chips) 
RikkStroken: posts small blind $0.10
chiyuki: posts big blind $0.25
*** HOLE CARDS ***
Dealt to chiyuki [8c 4s]
jeff0923: folds 
Ellen1947: folds 
Scruf13: raises $0.25 to $0.50
Th3Fog: folds 
JLajoie: folds 
troms20: folds 
seula i: folds 
RikkStroken: calls $0.40
chiyuki: folds 
*** FLOP *** [4c 3c 6h]
RikkStroken: checks 
Scruf13: bets $5 and is all-in
RikkStroken: calls $5
*** TURN *** [4c 3c 6h] [Qs]
*** RIVER *** [4c 3c 6h Qs] [3h]
*** SHOW DOWN ***
RikkStroken: shows [Ac 5c] (a pair of Threes)
Scruf13: shows [Ad Ks] (a pair of Threes - Ace+King kicker)
Scruf13 collected $10.74 from pot
*** SUMMARY ***
Total pot $11.25 | Rake $0.51 
Board [4c 3c 6h Qs 3h]
Seat 1: seula i (button) folded before Flop (didn't bet)
Seat 2: RikkStroken (small blind) showed [Ac 5c] and lost with a pair of Threes
Seat 3: chiyuki (big blind) folded before Flop
Seat 4: jeff0923 folded before Flop (didn't bet)
Seat 5: Ellen1947 folded before Flop (didn't bet)
Seat 6: Scruf13 showed [Ad Ks] and won ($10.74) with a pair of Threes
Seat 7: Th3Fog folded before Flop (didn't bet)
Seat 8: JLajoie folded before Flop (didn't bet)
Seat 9: troms20 folded before Flop (didn't bet)



PokerStars Zoom Hand #84299456873:  Hold'em No Limit ($0.10/$0.25) - 2012/08/05 14:20:38 JST [2012/08/05 1:20:38 ET]
Table 'Whirlpool' 9-max Seat #1 is the button
Seat 1: mariuka1 ($12.15 in chips) 
Seat 2: roksmokndonk ($31.06 in chips) 
Seat 3: hirozo ($34.17 in chips) 
Seat 4: Lasutchik ($8.31 in chips) 
Seat 5: JLajoie ($26.45 in chips) 
Seat 6: 4ydo yogurt ($25.37 in chips) 
Seat 7: chiyuki ($34.59 in chips) 
Seat 8: Suhoff76 ($25 in chips) 
Seat 9: jeff0923 ($25.41 in chips) 
roksmokndonk: posts small blind $0.10
hirozo: posts big blind $0.25
*** HOLE CARDS ***
Dealt to chiyuki [9h 6s]
Lasutchik: folds 
JLajoie: folds 
4ydo yogurt: folds 
chiyuki: folds 
Suhoff76: folds 
jeff0923: calls $0.25
mariuka1: folds 
roksmokndonk: folds 
hirozo: checks 
*** FLOP *** [Ks 9c Jc]
hirozo: checks 
jeff0923: bets $0.75
hirozo: folds 
Uncalled bet ($0.75) returned to jeff0923
jeff0923 collected $0.57 from pot
jeff0923: doesn't show hand 
*** SUMMARY ***
Total pot $0.60 | Rake $0.03 
Board [Ks 9c Jc]
Seat 1: mariuka1 (button) folded before Flop (didn't bet)
Seat 2: roksmokndonk (small blind) folded before Flop
Seat 3: hirozo (big blind) folded on the Flop
Seat 4: Lasutchik folded before Flop (didn't bet)
Seat 5: JLajoie folded before Flop (didn't bet)
Seat 6: 4ydo yogurt folded before Flop (didn't bet)
Seat 7: chiyuki folded before Flop (didn't bet)
Seat 8: Suhoff76 folded before Flop (didn't bet)
Seat 9: jeff0923 collected ($0.57)



PokerStars Zoom Hand #84299458137:  Hold'em No Limit ($0.10/$0.25) - 2012/08/05 14:20:44 JST [2012/08/05 1:20:44 ET]
Table 'Whirlpool' 9-max Seat #1 is the button
Seat 1: chiyuki ($34.59 in chips) 
Seat 2: Dafleche ($25.43 in chips) 
Seat 3: 4ydo yogurt ($25.37 in chips) 
Seat 4: Perstenev ($13.31 in chips) 
Seat 5: KeLevro0 ($8.11 in chips) 
Seat 6: Suhoff76 ($25 in chips) 
Seat 7: flyinprits ($28.79 in chips) 
Seat 8: mariuka1 ($12.15 in chips) 
Seat 9: Th3Fog ($49.08 in chips) 
Dafleche: posts small blind $0.10
4ydo yogurt: posts big blind $0.25
*** HOLE CARDS ***
Dealt to chiyuki [5h 9d]
Perstenev: folds 
KeLevro0: folds 
Suhoff76: folds 
flyinprits: folds 
mariuka1: folds 
Th3Fog: folds 
chiyuki: folds 
Dafleche: calls $0.15
4ydo yogurt: checks 
*** FLOP *** [Ah Ad 3c]
Dafleche: bets $0.25
4ydo yogurt: calls $0.25
*** TURN *** [Ah Ad 3c] [9c]
Dafleche: checks 
4ydo yogurt: checks 
*** RIVER *** [Ah Ad 3c 9c] [7h]
Dafleche: bets $0.50
4ydo yogurt: calls $0.50
*** SHOW DOWN ***
Dafleche: shows [Jd 7d] (two pair, Aces and Sevens)
4ydo yogurt: mucks hand 
Dafleche collected $1.91 from pot
*** SUMMARY ***
Total pot $2 | Rake $0.09 
Board [Ah Ad 3c 9c 7h]
Seat 1: chiyuki (button) folded before Flop (didn't bet)
Seat 2: Dafleche (small blind) showed [Jd 7d] and won ($1.91) with two pair, Aces and Sevens
Seat 3: 4ydo yogurt (big blind) mucked [3s 6c]
Seat 4: Perstenev folded before Flop (didn't bet)
Seat 5: KeLevro0 folded before Flop (didn't bet)
Seat 6: Suhoff76 folded before Flop (didn't bet)
Seat 7: flyinprits folded before Flop (didn't bet)
Seat 8: mariuka1 folded before Flop (didn't bet)
Seat 9: Th3Fog folded before Flop (didn't bet)



PokerStars Zoom Hand #84299455963:  Hold'em No Limit ($0.10/$0.25) - 2012/08/05 14:20:34 JST [2012/08/05 1:20:34 ET]
Table 'Whirlpool' 9-max Seat #1 is the button
Seat 1: Dejacob ($40.02 in chips) 
Seat 2: phate-1up ($25.35 in chips) 
Seat 3: Perstenev ($11.39 in chips) 
Seat 4: cr0lox ($21.20 in chips) 
Seat 5: ygoegoe ($31.01 in chips) 
Seat 6: ladymadon107 ($3.53 in chips) 
Seat 7: Nerkit ($13.39 in chips) 
Seat 8: chiyuki ($34.59 in chips) 
Seat 9: dushvan ($29.57 in chips) 
phate-1up: posts small blind $0.10
Perstenev: posts big blind $0.25
*** HOLE CARDS ***
Dealt to chiyuki [3s Td]
cr0lox: calls $0.25
ygoegoe: folds 
ladymadon107: folds 
Nerkit: folds 
chiyuki: folds 
dushvan: folds 
Dejacob: raises $1 to $1.25
phate-1up: folds 
Perstenev: folds 
cr0lox: calls $1
*** FLOP *** [2c 6d 6h]
cr0lox: checks 
Dejacob: checks 
*** TURN *** [2c 6d 6h] [Kc]
cr0lox: bets $1.36
Dejacob: calls $1.36
*** RIVER *** [2c 6d 6h Kc] [5c]
cr0lox: bets $3.99
Dejacob: calls $3.99
*** SHOW DOWN ***
cr0lox: shows [Ah 3h] (a pair of Sixes)
Dejacob: shows [Kd Ac] (two pair, Kings and Sixes)
Dejacob collected $12.94 from pot
*** SUMMARY ***
Total pot $13.55 | Rake $0.61 
Board [2c 6d 6h Kc 5c]
Seat 1: Dejacob (button) showed [Kd Ac] and won ($12.94) with two pair, Kings and Sixes
Seat 2: phate-1up (small blind) folded before Flop
Seat 3: Perstenev (big blind) folded before Flop
Seat 4: cr0lox showed [Ah 3h] and lost with a pair of Sixes
Seat 5: ygoegoe folded before Flop (didn't bet)
Seat 6: ladymadon107 folded before Flop (didn't bet)
Seat 7: Nerkit folded before Flop (didn't bet)
Seat 8: chiyuki folded before Flop (didn't bet)
Seat 9: dushvan folded before Flop (didn't bet)



PokerStars Zoom Hand #84299460187:  Hold'em No Limit ($0.10/$0.25) - 2012/08/05 14:20:52 JST [2012/08/05 1:20:52 ET]
Table 'Whirlpool' 9-max Seat #1 is the button
Seat 1: Th3Fog ($49.08 in chips) 
Seat 2: Scruf13 ($10.74 in chips) 
Seat 3: Suhoff76 ($25 in chips) 
Seat 4: JLajoie ($26.20 in chips) 
Seat 5: phate-1up ($36.63 in chips) 
Seat 6: chiyuki ($34.59 in chips) 
Seat 7: roksmokndonk ($30.96 in chips) 
Seat 8: wtu1986 ($32.67 in chips) 
Seat 9: Perstenev ($13.31 in chips) 
Scruf13: posts small blind $0.10
Suhoff76: posts big blind $0.25
*** HOLE CARDS ***
Dealt to chiyuki [Jh Ac]
JLajoie: folds 
phate-1up: folds 
chiyuki: raises $0.50 to $0.75
roksmokndonk: folds 
wtu1986: folds 
Perstenev: folds 
Th3Fog: calls $0.75
Scruf13: folds 
Suhoff76: folds 
*** FLOP *** [4c 6s 2c]
chiyuki: checks 
Th3Fog: bets $1.04
chiyuki: folds 
Uncalled bet ($1.04) returned to Th3Fog
Th3Fog collected $1.77 from pot
Th3Fog: doesn't show hand 
*** SUMMARY ***
Total pot $1.85 | Rake $0.08 
Board [4c 6s 2c]
Seat 1: Th3Fog (button) collected ($1.77)
Seat 2: Scruf13 (small blind) folded before Flop
Seat 3: Suhoff76 (big blind) folded before Flop
Seat 4: JLajoie folded before Flop (didn't bet)
Seat 5: phate-1up folded before Flop (didn't bet)
Seat 6: chiyuki folded on the Flop
Seat 7: roksmokndonk folded before Flop (didn't bet)
Seat 8: wtu1986 folded before Flop (didn't bet)
Seat 9: Perstenev folded before Flop (didn't bet)



PokerStars Zoom Hand #84299473608:  Hold'em No Limit ($0.10/$0.25) - 2012/08/05 14:21:46 JST [2012/08/05 1:21:46 ET]
Table 'Whirlpool' 9-max Seat #1 is the button
Seat 1: taksist889 ($26.43 in chips) 
Seat 2: KeLevro0 ($11.90 in chips) 
Seat 3: hirozo ($36.28 in chips) 
Seat 4: JLajoie ($25.85 in chips) 
Seat 5: Suhoff76 ($28.18 in chips) 
Seat 6: seula i ($27.04 in chips) 
Seat 7: acamrash ($11.75 in chips) 
Seat 8: RomarioJa ($12.71 in chips) 
Seat 9: chiyuki ($33.74 in chips) 
KeLevro0: posts small blind $0.10
hirozo: posts big blind $0.25
*** HOLE CARDS ***
Dealt to chiyuki [4c 9s]
JLajoie: folds 
Suhoff76: folds 
seula i: folds 
acamrash: folds 
RomarioJa: folds 
chiyuki: folds 
taksist889: folds 
KeLevro0: folds 
Uncalled bet ($0.15) returned to hirozo
hirozo collected $0.20 from pot
hirozo: doesn't show hand 
*** SUMMARY ***
Total pot $0.20 | Rake $0 
Seat 1: taksist889 (button) folded before Flop (didn't bet)
Seat 2: KeLevro0 (small blind) folded before Flop
Seat 3: hirozo (big blind) collected ($0.20)
Seat 4: JLajoie folded before Flop (didn't bet)
Seat 5: Suhoff76 folded before Flop (didn't bet)
Seat 6: seula i folded before Flop (didn't bet)
Seat 7: acamrash folded before Flop (didn't bet)
Seat 8: RomarioJa folded before Flop (didn't bet)
Seat 9: chiyuki folded before Flop (didn't bet)



PokerStars Zoom Hand #84299476300:  Hold'em No Limit ($0.10/$0.25) - 2012/08/05 14:21:58 JST [2012/08/05 1:21:58 ET]
Table 'Whirlpool' 9-max Seat #1 is the button
Seat 1: Perstenev ($11.97 in chips) 
Seat 2: acamrash ($11.75 in chips) 
Seat 3: RomarioJa ($10.46 in chips) 
Seat 4: chiyuki ($33.74 in chips) 
Seat 5: troms20 ($21.84 in chips) 
Seat 6: craden500 ($17.70 in chips) 
Seat 7: Roglus ($14.37 in chips) 
Seat 8: Th3Fog ($16.12 in chips) 
Seat 9: phate-1up ($27.63 in chips) 
acamrash: posts small blind $0.10
RomarioJa: posts big blind $0.25
*** HOLE CARDS ***
Dealt to chiyuki [4s Js]
chiyuki: folds 
troms20: folds 
craden500: folds 
Roglus: raises $0.50 to $0.75
Th3Fog: folds 
phate-1up: folds 
Perstenev: folds 
acamrash: folds 
RomarioJa: folds 
Uncalled bet ($0.50) returned to Roglus
Roglus collected $0.60 from pot
Roglus: doesn't show hand 
*** SUMMARY ***
Total pot $0.60 | Rake $0 
Seat 1: Perstenev (button) folded before Flop (didn't bet)
Seat 2: acamrash (small blind) folded before Flop
Seat 3: RomarioJa (big blind) folded before Flop
Seat 4: chiyuki folded before Flop (didn't bet)
Seat 5: troms20 folded before Flop (didn't bet)
Seat 6: craden500 folded before Flop (didn't bet)
Seat 7: Roglus collected ($0.60)
Seat 8: Th3Fog folded before Flop (didn't bet)
Seat 9: phate-1up folded before Flop (didn't bet)



PokerStars Zoom Hand #84299478048:  Hold'em No Limit ($0.10/$0.25) - 2012/08/05 14:22:04 JST [2012/08/05 1:22:04 ET]
Table 'Whirlpool' 9-max Seat #1 is the button
Seat 1: Th3Fog ($73.18 in chips) 
Seat 2: RikkStroken ($24.70 in chips) 
Seat 3: chiyuki ($33.74 in chips) 
Seat 4: wtu1986 ($25 in chips) 
Seat 5: KeLevro0 ($11.80 in chips) 
Seat 6: RomarioJa ($14.71 in chips) 
Seat 7: Ellen1947 ($28.16 in chips) 
Seat 8: seula i ($27.04 in chips) 
Seat 9: dushvan ($29.57 in chips) 
RikkStroken: posts small blind $0.10
chiyuki: posts big blind $0.25
*** HOLE CARDS ***
Dealt to chiyuki [9c 7h]
wtu1986: folds 
KeLevro0: folds 
RomarioJa: folds 
Ellen1947: folds 
seula i: folds 
dushvan: folds 
Th3Fog: folds 
RikkStroken: folds 
Uncalled bet ($0.15) returned to chiyuki
chiyuki collected $0.20 from pot
chiyuki: doesn't show hand 
*** SUMMARY ***
Total pot $0.20 | Rake $0 
Seat 1: Th3Fog (button) folded before Flop (didn't bet)
Seat 2: RikkStroken (small blind) folded before Flop
Seat 3: chiyuki (big blind) collected ($0.20)
Seat 4: wtu1986 folded before Flop (didn't bet)
Seat 5: KeLevro0 folded before Flop (didn't bet)
Seat 6: RomarioJa folded before Flop (didn't bet)
Seat 7: Ellen1947 folded before Flop (didn't bet)
Seat 8: seula i folded before Flop (didn't bet)
Seat 9: dushvan folded before Flop (didn't bet)



PokerStars Zoom Hand #84299477307:  Hold'em No Limit ($0.10/$0.25) - 2012/08/05 14:22:01 JST [2012/08/05 1:22:01 ET]
Table 'Whirlpool' 9-max Seat #1 is the button
Seat 1: kamikkaze ($19.73 in chips) 
Seat 2: hirozo ($33.92 in chips) 
Seat 3: Suhoff76 ($25 in chips) 
Seat 4: leo2095 ($13.54 in chips) 
Seat 5: chiyuki ($33.74 in chips) 
Seat 6: mariuka1 ($11.80 in chips) 
Seat 7: PetitAlejo ($33.51 in chips) 
Seat 8: Roglus ($59.23 in chips) 
Seat 9: taksist889 ($26.43 in chips) 
hirozo: posts small blind $0.10
Suhoff76: posts big blind $0.25
*** HOLE CARDS ***
Dealt to chiyuki [2c Tc]
leo2095: folds 
chiyuki: folds 
mariuka1: calls $0.25
PetitAlejo: folds 
Roglus: raises $0.75 to $1
taksist889: folds 
kamikkaze: folds 
hirozo: folds 
Suhoff76: folds 
mariuka1: calls $0.75
*** FLOP *** [7h 5d Ks]
mariuka1: checks 
Roglus: checks 
*** TURN *** [7h 5d Ks] [Td]
mariuka1: bets $0.25
Roglus: calls $0.25
*** RIVER *** [7h 5d Ks Td] [Js]
mariuka1: bets $0.25
Roglus: calls $0.25
*** SHOW DOWN ***
mariuka1: shows [3h 3d] (a pair of Threes)
Roglus: shows [Ah Jc] (a pair of Jacks)
Roglus collected $3.20 from pot
*** SUMMARY ***
Total pot $3.35 | Rake $0.15 
Board [7h 5d Ks Td Js]
Seat 1: kamikkaze (button) folded before Flop (didn't bet)
Seat 2: hirozo (small blind) folded before Flop
Seat 3: Suhoff76 (big blind) folded before Flop
Seat 4: leo2095 folded before Flop (didn't bet)
Seat 5: chiyuki folded before Flop (didn't bet)
Seat 6: mariuka1 showed [3h 3d] and lost with a pair of Threes
Seat 7: PetitAlejo folded before Flop (didn't bet)
Seat 8: Roglus showed [Ah Jc] and won ($3.20) with a pair of Jacks
Seat 9: taksist889 folded before Flop (didn't bet)



PokerStars Zoom Hand #84299472364:  Hold'em No Limit ($0.10/$0.25) - 2012/08/05 14:21:41 JST [2012/08/05 1:21:41 ET]
Table 'Whirlpool' 9-max Seat #1 is the button
Seat 1: seula i ($68.31 in chips) 
Seat 2: Loholov ($26.66 in chips) 
Seat 3: PetitAlejo ($33.76 in chips) 
Seat 4: RomarioJa ($10.56 in chips) 
Seat 5: chiyuki ($33.74 in chips) 
Seat 6: hirozo ($33.92 in chips) 
Seat 7: sparky5224 ($34.09 in chips) 
Seat 8: ll_LaMeR_ll ($46.27 in chips) 
Seat 9: kamikkaze ($31.37 in chips) 
Loholov: posts small blind $0.10
PetitAlejo: posts big blind $0.25
*** HOLE CARDS ***
Dealt to chiyuki [5h Tc]
RomarioJa: folds 
chiyuki: folds 
hirozo: folds 
sparky5224: folds 
ll_LaMeR_ll: raises $0.50 to $0.75
kamikkaze: folds 
seula i: calls $0.75
Loholov said, "SPARKY - FIIISH!!"
Loholov: folds 
PetitAlejo: folds 
*** FLOP *** [4h 9d Js]
ll_LaMeR_ll: bets $0.83
seula i: calls $0.83
*** TURN *** [4h 9d Js] [Kd]
ll_LaMeR_ll: bets $2.91
seula i: raises $3.59 to $6.50
ll_LaMeR_ll: raises $14.22 to $20.72
seula i: folds 
Uncalled bet ($14.22) returned to ll_LaMeR_ll
ll_LaMeR_ll collected $15.77 from pot
ll_LaMeR_ll: doesn't show hand 
*** SUMMARY ***
Total pot $16.51 | Rake $0.74 
Board [4h 9d Js Kd]
Seat 1: seula i (button) folded on the Turn
Seat 2: Loholov (small blind) folded before Flop
Seat 3: PetitAlejo (big blind) folded before Flop
Seat 4: RomarioJa folded before Flop (didn't bet)
Seat 5: chiyuki folded before Flop (didn't bet)
Seat 6: hirozo folded before Flop (didn't bet)
Seat 7: sparky5224 folded before Flop (didn't bet)
Seat 8: ll_LaMeR_ll collected ($15.77)
Seat 9: kamikkaze folded before Flop (didn't bet)



PokerStars Zoom Hand #84299469577:  Hold'em No Limit ($0.10/$0.25) - 2012/08/05 14:21:30 JST [2012/08/05 1:21:30 ET]
Table 'Whirlpool' 9-max Seat #1 is the button
Seat 1: RomarioJa ($10.56 in chips) 
Seat 2: chiyuki ($33.84 in chips) 
Seat 3: deadmoneykid ($22.67 in chips) 
Seat 4: Dejacob ($25.92 in chips) 
Seat 5: ll_LaMeR_ll ($46.37 in chips) 
Seat 6: seula i ($25 in chips) 
Seat 7: PetitAlejo ($35.46 in chips) 
Seat 8: Suhoff76 ($25 in chips) 
Seat 9: RikkStroken ($6.40 in chips) 
chiyuki: posts small blind $0.10
deadmoneykid: posts big blind $0.25
*** HOLE CARDS ***
Dealt to chiyuki [Ks 4d]
Dejacob: raises $0.50 to $0.75
ll_LaMeR_ll: folds 
seula i: calls $0.75
PetitAlejo: folds 
Suhoff76: folds 
RikkStroken: folds 
RomarioJa: folds 
chiyuki: folds 
deadmoneykid: calls $0.50
*** FLOP *** [Jc 8s Jd]
deadmoneykid: checks 
Dejacob: bets $1.75
seula i: folds 
deadmoneykid: calls $1.75
*** TURN *** [Jc 8s Jd] [Td]
deadmoneykid: checks 
Dejacob: bets $4
deadmoneykid: raises $4 to $8
Dejacob: folds 
Uncalled bet ($4) returned to deadmoneykid
deadmoneykid collected $13.23 from pot
deadmoneykid: doesn't show hand 
*** SUMMARY ***
Total pot $13.85 | Rake $0.62 
Board [Jc 8s Jd Td]
Seat 1: RomarioJa (button) folded before Flop (didn't bet)
Seat 2: chiyuki (small blind) folded before Flop
Seat 3: deadmoneykid (big blind) collected ($13.23)
Seat 4: Dejacob folded on the Turn
Seat 5: ll_LaMeR_ll folded before Flop (didn't bet)
Seat 6: seula i folded on the Flop
Seat 7: PetitAlejo folded before Flop (didn't bet)
Seat 8: Suhoff76 folded before Flop (didn't bet)
Seat 9: RikkStroken folded before Flop (didn't bet)



PokerStars Zoom Hand #84299486529:  Hold'em No Limit ($0.10/$0.25) - 2012/08/05 14:22:38 JST [2012/08/05 1:22:38 ET]
Table 'Whirlpool' 9-max Seat #1 is the button
Seat 1: chiyuki ($33.84 in chips) 
Seat 2: Loholov ($15 in chips) 
Seat 3: hirozo ($33.82 in chips) 
Seat 4: KeLevro0 ($10.02 in chips) 
Seat 5: Nerkit ($13.39 in chips) 
Seat 6: kamikkaze ($18.27 in chips) 
Seat 7: Th3Fog ($73.18 in chips) 
Seat 8: phate-1up ($25 in chips) 
Seat 9: ygoegoe ($30.94 in chips) 
Loholov: posts small blind $0.10
hirozo: posts big blind $0.25
*** HOLE CARDS ***
Dealt to chiyuki [As 6h]
KeLevro0: folds 
Nerkit: folds 
kamikkaze: folds 
Th3Fog: folds 
phate-1up: folds 
ygoegoe: folds 
chiyuki: raises $0.50 to $0.75
Loholov: raises $1.25 to $2
hirozo: folds 
chiyuki: folds 
Uncalled bet ($1.25) returned to Loholov
Loholov collected $1.75 from pot
Loholov: doesn't show hand 
*** SUMMARY ***
Total pot $1.75 | Rake $0 
Seat 1: chiyuki (button) folded before Flop
Seat 2: Loholov (small blind) collected ($1.75)
Seat 3: hirozo (big blind) folded before Flop
Seat 4: KeLevro0 folded before Flop (didn't bet)
Seat 5: Nerkit folded before Flop (didn't bet)
Seat 6: kamikkaze folded before Flop (didn't bet)
Seat 7: Th3Fog folded before Flop (didn't bet)
Seat 8: phate-1up folded before Flop (didn't bet)
Seat 9: ygoegoe folded before Flop (didn't bet)



PokerStars Zoom Hand #84299484552:  Hold'em No Limit ($0.10/$0.25) - 2012/08/05 14:22:30 JST [2012/08/05 1:22:30 ET]
Table 'Whirlpool' 9-max Seat #1 is the button
Seat 1: seula i ($28.89 in chips) 
Seat 2: wtu1986 ($25.10 in chips) 
Seat 3: deadmoneykid ($22.60 in chips) 
Seat 4: KeLevro0 ($10.03 in chips) 
Seat 5: Suhoff76 ($27.49 in chips) 
Seat 6: phate-1up ($37.76 in chips) 
Seat 7: chiyuki ($33.84 in chips) 
Seat 8: Loholov ($26.56 in chips) 
Seat 9: hirozo ($32.52 in chips) 
wtu1986: posts small blind $0.10
deadmoneykid: posts big blind $0.25
*** HOLE CARDS ***
Dealt to chiyuki [4d Qd]
KeLevro0: raises $0.42 to $0.67
Suhoff76: calls $0.67
phate-1up: folds 
chiyuki: folds 
Loholov: folds 
hirozo: folds 
seula i: folds 
wtu1986: calls $0.57
deadmoneykid: calls $0.42
*** FLOP *** [2c 7c 7s]
wtu1986: checks 
deadmoneykid: checks 
KeLevro0: checks 
Suhoff76: checks 
*** TURN *** [2c 7c 7s] [Qc]
wtu1986: checks 
deadmoneykid: checks 
KeLevro0: checks 
Suhoff76: checks 
*** RIVER *** [2c 7c 7s Qc] [Qh]
wtu1986: checks 
deadmoneykid: checks 
KeLevro0: checks 
Suhoff76: folds 
*** SHOW DOWN ***
wtu1986: shows [Ts Js] (two pair, Queens and Sevens)
deadmoneykid: mucks hand 
KeLevro0: shows [Ks Ah] (two pair, Queens and Sevens - Ace kicker)
KeLevro0 collected $2.56 from pot
*** SUMMARY ***
Total pot $2.68 | Rake $0.12 
Board [2c 7c 7s Qc Qh]
Seat 1: seula i (button) folded before Flop (didn't bet)
Seat 2: wtu1986 (small blind) showed [Ts Js] and lost with two pair, Queens and Sevens
Seat 3: deadmoneykid (big blind) mucked [6h 6c]
Seat 4: KeLevro0 showed [Ks Ah] and won ($2.56) with two pair, Queens and Sevens
Seat 5: Suhoff76 folded on the River
Seat 6: phate-1up folded before Flop (didn't bet)
Seat 7: chiyuki folded before Flop (didn't bet)
Seat 8: Loholov folded before Flop (didn't bet)
Seat 9: hirozo folded before Flop (didn't bet)



PokerStars Zoom Hand #84299497433:  Hold'em No Limit ($0.10/$0.25) - 2012/08/05 14:23:23 JST [2012/08/05 1:23:23 ET]
Table 'Whirlpool' 9-max Seat #1 is the button
Seat 1: D@vidMed ($65.17 in chips) 
Seat 2: chiyuki ($33.09 in chips) 
Seat 3: Suhoff76 ($25 in chips) 
Seat 4: softdesign ($67.66 in chips) 
Seat 5: Dafleche ($28.07 in chips) 
Seat 6: hirozo ($36.63 in chips) 
Seat 7: KeLevro0 ($9.20 in chips) 
Seat 8: Loholov ($17.04 in chips) 
Seat 9: Landybob ($42.65 in chips) 
chiyuki: posts small blind $0.10
Suhoff76: posts big blind $0.25
*** HOLE CARDS ***
Dealt to chiyuki [Ah 3s]
softdesign: folds 
Dafleche: calls $0.25
hirozo: folds 
KeLevro0: folds 
Loholov: folds 
Landybob: folds 
D@vidMed: raises $0.57 to $0.82
chiyuki: folds 
Suhoff76: folds 
Dafleche: calls $0.57
*** FLOP *** [7c Jc 6h]
Dafleche: checks 
D@vidMed: bets $1.23
Dafleche: folds 
Uncalled bet ($1.23) returned to D@vidMed
D@vidMed collected $1.90 from pot
D@vidMed: doesn't show hand 
*** SUMMARY ***
Total pot $1.99 | Rake $0.09 
Board [7c Jc 6h]
Seat 1: D@vidMed (button) collected ($1.90)
Seat 2: chiyuki (small blind) folded before Flop
Seat 3: Suhoff76 (big blind) folded before Flop
Seat 4: softdesign folded before Flop (didn't bet)
Seat 5: Dafleche folded on the Flop
Seat 6: hirozo folded before Flop (didn't bet)
Seat 7: KeLevro0 folded before Flop (didn't bet)
Seat 8: Loholov folded before Flop (didn't bet)
Seat 9: Landybob folded before Flop (didn't bet)



PokerStars Zoom Hand #84299501174:  Hold'em No Limit ($0.10/$0.25) - 2012/08/05 14:23:38 JST [2012/08/05 1:23:38 ET]
Table 'Whirlpool' 9-max Seat #1 is the button
Seat 1: 1Karina1 ($25 in chips) 
Seat 2: Roglus ($15.39 in chips) 
Seat 3: Wilcox76607 ($20.17 in chips) 
Seat 4: troms20 ($29.75 in chips) 
Seat 5: Perstenev ($13.38 in chips) 
Seat 6: kamikkaze ($17.57 in chips) 
Seat 7: chiyuki ($32.99 in chips) 
Seat 8: Loholov ($16 in chips) 
Seat 9: Th3Fog ($16.12 in chips) 
Roglus: posts small blind $0.10
Wilcox76607: posts big blind $0.25
*** HOLE CARDS ***
Dealt to chiyuki [Ad Ac]
troms20: folds 
Perstenev: folds 
kamikkaze: folds 
chiyuki: raises $0.50 to $0.75
Loholov: folds 
Th3Fog: folds 
1Karina1: folds 
Roglus: folds 
Wilcox76607: folds 
Uncalled bet ($0.50) returned to chiyuki
chiyuki collected $0.60 from pot
chiyuki: doesn't show hand 
*** SUMMARY ***
Total pot $0.60 | Rake $0 
Seat 1: 1Karina1 (button) folded before Flop (didn't bet)
Seat 2: Roglus (small blind) folded before Flop
Seat 3: Wilcox76607 (big blind) folded before Flop
Seat 4: troms20 folded before Flop (didn't bet)
Seat 5: Perstenev folded before Flop (didn't bet)
Seat 6: kamikkaze folded before Flop (didn't bet)
Seat 7: chiyuki collected ($0.60)
Seat 8: Loholov folded before Flop (didn't bet)
Seat 9: Th3Fog folded before Flop (didn't bet)



PokerStars Zoom Hand #84299499177:  Hold'em No Limit ($0.10/$0.25) - 2012/08/05 14:23:30 JST [2012/08/05 1:23:30 ET]
Table 'Whirlpool' 9-max Seat #1 is the button
Seat 1: 1Karina1 ($25 in chips) 
Seat 2: WARIBANA7777 ($13.04 in chips) 
Seat 3: Vahe50 ($4.70 in chips) 
Seat 4: Perstenev ($12.91 in chips) 
Seat 5: RomarioJa ($30.39 in chips) 
Seat 6: JLajoie ($27.59 in chips) 
Seat 7: Th3Fog ($16.12 in chips) 
Seat 8: chiyuki ($32.99 in chips) 
Seat 9: Dejacob ($47.18 in chips) 
WARIBANA7777: posts small blind $0.10
Vahe50: posts big blind $0.25
*** HOLE CARDS ***
Dealt to chiyuki [2c 5c]
Perstenev: folds 
RomarioJa: folds 
JLajoie: folds 
Th3Fog: folds 
chiyuki: folds 
Dejacob: raises $0.50 to $0.75
1Karina1: folds 
WARIBANA7777: folds 
Vahe50: folds 
Uncalled bet ($0.50) returned to Dejacob
Dejacob collected $0.60 from pot
Dejacob: doesn't show hand 
*** SUMMARY ***
Total pot $0.60 | Rake $0 
Seat 1: 1Karina1 (button) folded before Flop (didn't bet)
Seat 2: WARIBANA7777 (small blind) folded before Flop
Seat 3: Vahe50 (big blind) folded before Flop
Seat 4: Perstenev folded before Flop (didn't bet)
Seat 5: RomarioJa folded before Flop (didn't bet)
Seat 6: JLajoie folded before Flop (didn't bet)
Seat 7: Th3Fog folded before Flop (didn't bet)
Seat 8: chiyuki folded before Flop (didn't bet)
Seat 9: Dejacob collected ($0.60)



PokerStars Zoom Hand #84299508135:  Hold'em No Limit ($0.10/$0.25) - 2012/08/05 14:24:06 JST [2012/08/05 1:24:06 ET]
Table 'Whirlpool' 9-max Seat #1 is the button
Seat 1: Nerkit ($13.61 in chips) 
Seat 2: Loholov ($16.79 in chips) 
Seat 3: deadmoneykid ($29.30 in chips) 
Seat 4: kamikkaze ($32.28 in chips) 
Seat 5: chiyuki ($33.34 in chips) 
Seat 6: Perstenev ($9.67 in chips) 
Seat 7: slapshot2011 ($34.76 in chips) 
Seat 8: seula i ($65.59 in chips) 
Seat 9: Paranoix1990 ($10.23 in chips) 
Loholov: posts small blind $0.10
deadmoneykid: posts big blind $0.25
*** HOLE CARDS ***
Dealt to chiyuki [9d 6d]
kamikkaze: folds 
chiyuki: folds 
Perstenev: folds 
slapshot2011: folds 
seula i: folds 
Paranoix1990: folds 
Nerkit: folds 
Loholov: raises $0.50 to $0.75
deadmoneykid: folds 
Uncalled bet ($0.50) returned to Loholov
Loholov collected $0.50 from pot
Loholov: doesn't show hand 
*** SUMMARY ***
Total pot $0.50 | Rake $0 
Seat 1: Nerkit (button) folded before Flop (didn't bet)
Seat 2: Loholov (small blind) collected ($0.50)
Seat 3: deadmoneykid (big blind) folded before Flop
Seat 4: kamikkaze folded before Flop (didn't bet)
Seat 5: chiyuki folded before Flop (didn't bet)
Seat 6: Perstenev folded before Flop (didn't bet)
Seat 7: slapshot2011 folded before Flop (didn't bet)
Seat 8: seula i folded before Flop (didn't bet)
Seat 9: Paranoix1990 folded before Flop (didn't bet)



PokerStars Zoom Hand #84299507118:  Hold'em No Limit ($0.10/$0.25) - 2012/08/05 14:24:02 JST [2012/08/05 1:24:02 ET]
Table 'Whirlpool' 9-max Seat #1 is the button
Seat 1: RomarioJa ($30.29 in chips) 
Seat 2: Paranoix1990 ($10.33 in chips) 
Seat 3: Suhoff76 ($25 in chips) 
Seat 4: Dan Royal ($41.43 in chips) 
Seat 5: phate-1up ($30.50 in chips) 
Seat 6: PetitAlejo ($34.41 in chips) 
Seat 7: wtu1986 ($33.17 in chips) 
Seat 8: Perstenev ($9.67 in chips) 
Seat 9: chiyuki ($33.34 in chips) 
Paranoix1990: posts small blind $0.10
Suhoff76: posts big blind $0.25
*** HOLE CARDS ***
Dealt to chiyuki [5d 2s]
Dan Royal: folds 
phate-1up: raises $0.50 to $0.75
PetitAlejo: raises $1.50 to $2.25
wtu1986: folds 
Perstenev: folds 
chiyuki: folds 
RomarioJa: folds 
Paranoix1990: folds 
Suhoff76: folds 
phate-1up: raises $3 to $5.25
PetitAlejo: folds 
Uncalled bet ($3) returned to phate-1up
phate-1up collected $4.85 from pot
phate-1up: doesn't show hand 
*** SUMMARY ***
Total pot $4.85 | Rake $0 
Seat 1: RomarioJa (button) folded before Flop (didn't bet)
Seat 2: Paranoix1990 (small blind) folded before Flop
Seat 3: Suhoff76 (big blind) folded before Flop
Seat 4: Dan Royal folded before Flop (didn't bet)
Seat 5: phate-1up collected ($4.85)
Seat 6: PetitAlejo folded before Flop
Seat 7: wtu1986 folded before Flop (didn't bet)
Seat 8: Perstenev folded before Flop (didn't bet)
Seat 9: chiyuki folded before Flop (didn't bet)



PokerStars Zoom Hand #84299506165:  Hold'em No Limit ($0.10/$0.25) - 2012/08/05 14:23:58 JST [2012/08/05 1:23:58 ET]
Table 'Whirlpool' 9-max Seat #1 is the button
Seat 1: Dafleche ($27.15 in chips) 
Seat 2: phate-1up ($37.41 in chips) 
Seat 3: Ellen1947 ($28.06 in chips) 
Seat 4: Perstenev ($9.67 in chips) 
Seat 5: silvno31 ($35.28 in chips) 
Seat 6: chiyuki ($33.34 in chips) 
Seat 7: Nerkit ($13.61 in chips) 
Seat 8: 4thepeople ($21.99 in chips) 
Seat 9: RikkStroken ($25.71 in chips) 
phate-1up: posts small blind $0.10
Ellen1947: posts big blind $0.25
*** HOLE CARDS ***
Dealt to chiyuki [Qs 8d]
Perstenev: folds 
silvno31: folds 
chiyuki: folds 
Nerkit: folds 
4thepeople: calls $0.25
RikkStroken: folds 
Dafleche: raises $0.25 to $0.50
phate-1up: folds 
Ellen1947: folds 
4thepeople: calls $0.25
*** FLOP *** [Jc 5h Ad]
4thepeople: checks 
Dafleche: bets $0.50
4thepeople: calls $0.50
*** TURN *** [Jc 5h Ad] [3h]
4thepeople: checks 
Dafleche: bets $1
4thepeople: calls $1
*** RIVER *** [Jc 5h Ad 3h] [Tc]
4thepeople: bets $5.75
Dafleche: calls $5.75
*** SHOW DOWN ***
4thepeople: shows [3s As] (two pair, Aces and Threes)
Dafleche: mucks hand 
4thepeople collected $15.14 from pot
*** SUMMARY ***
Total pot $15.85 | Rake $0.71 
Board [Jc 5h Ad 3h Tc]
Seat 1: Dafleche (button) mucked [Ac Kd]
Seat 2: phate-1up (small blind) folded before Flop
Seat 3: Ellen1947 (big blind) folded before Flop
Seat 4: Perstenev folded before Flop (didn't bet)
Seat 5: silvno31 folded before Flop (didn't bet)
Seat 6: chiyuki folded before Flop (didn't bet)
Seat 7: Nerkit folded before Flop (didn't bet)
Seat 8: 4thepeople showed [3s As] and won ($15.14) with two pair, Aces and Threes
Seat 9: RikkStroken folded before Flop (didn't bet)



PokerStars Zoom Hand #84299510121:  Hold'em No Limit ($0.10/$0.25) - 2012/08/05 14:24:14 JST [2012/08/05 1:24:14 ET]
Table 'Whirlpool' 9-max Seat #1 is the button
Seat 1: Paranoix1990 ($10.23 in chips) 
Seat 2: Vahe50 ($23 in chips) 
Seat 3: chiyuki ($33.34 in chips) 
Seat 4: acamrash ($12.40 in chips) 
Seat 5: simonzez ($50.04 in chips) 
Seat 6: RikkStroken ($26.96 in chips) 
Seat 7: Nerkit ($12.22 in chips) 
Seat 8: KeLevro0 ($11.49 in chips) 
Seat 9: DanielWhyte ($43.01 in chips) 
Vahe50: posts small blind $0.10
chiyuki: posts big blind $0.25
*** HOLE CARDS ***
Dealt to chiyuki [9c Ah]
acamrash: folds 
simonzez: folds 
RikkStroken: folds 
Nerkit: folds 
KeLevro0: folds 
DanielWhyte: folds 
Paranoix1990: folds 
Vahe50: raises $0.50 to $0.75
chiyuki: raises $1.50 to $2.25
Vahe50: raises $3.50 to $5.75
chiyuki: folds 
Uncalled bet ($3.50) returned to Vahe50
Vahe50 collected $4.50 from pot
Vahe50: doesn't show hand 
*** SUMMARY ***
Total pot $4.50 | Rake $0 
Seat 1: Paranoix1990 (button) folded before Flop (didn't bet)
Seat 2: Vahe50 (small blind) collected ($4.50)
Seat 3: chiyuki (big blind) folded before Flop
Seat 4: acamrash folded before Flop (didn't bet)
Seat 5: simonzez folded before Flop (didn't bet)
Seat 6: RikkStroken folded before Flop (didn't bet)
Seat 7: Nerkit folded before Flop (didn't bet)
Seat 8: KeLevro0 folded before Flop (didn't bet)
Seat 9: DanielWhyte folded before Flop (didn't bet)



PokerStars Zoom Hand #84299528282:  Hold'em No Limit ($0.10/$0.25) - 2012/08/05 14:25:28 JST [2012/08/05 1:25:28 ET]
Table 'Whirlpool' 9-max Seat #1 is the button
Seat 1: Perstenev ($20.22 in chips) 
Seat 2: caro196661cv ($28.32 in chips) 
Seat 3: Dejacob ($25 in chips) 
Seat 4: chiyuki ($31.09 in chips) 
Seat 5: PetitAlejo ($50.46 in chips) 
Seat 6: Dan Royal ($41.33 in chips) 
Seat 7: hirozo ($26.77 in chips) 
Seat 8: Loholov ($17.04 in chips) 
Seat 9: Suhoff76 ($25 in chips) 
caro196661cv: posts small blind $0.10
Dejacob: posts big blind $0.25
*** HOLE CARDS ***
Dealt to chiyuki [7d 2d]
chiyuki: folds 
PetitAlejo: folds 
Dan Royal: folds 
hirozo: folds 
Loholov: folds 
Suhoff76: folds 
Perstenev: folds 
caro196661cv: folds 
Uncalled bet ($0.15) returned to Dejacob
Dejacob collected $0.20 from pot
Dejacob: doesn't show hand 
*** SUMMARY ***
Total pot $0.20 | Rake $0 
Seat 1: Perstenev (button) folded before Flop (didn't bet)
Seat 2: caro196661cv (small blind) folded before Flop
Seat 3: Dejacob (big blind) collected ($0.20)
Seat 4: chiyuki folded before Flop (didn't bet)
Seat 5: PetitAlejo folded before Flop (didn't bet)
Seat 6: Dan Royal folded before Flop (didn't bet)
Seat 7: hirozo folded before Flop (didn't bet)
Seat 8: Loholov folded before Flop (didn't bet)
Seat 9: Suhoff76 folded before Flop (didn't bet)



PokerStars Zoom Hand #84299530317:  Hold'em No Limit ($0.10/$0.25) - 2012/08/05 14:25:37 JST [2012/08/05 1:25:37 ET]
Table 'Whirlpool' 9-max Seat #1 is the button
Seat 1: Alvinpe85 ($60.67 in chips) 
Seat 2: chiyuki ($31.09 in chips) 
Seat 3: Vahe50 ($14.35 in chips) 
Seat 4: Wilcox76607 ($15.31 in chips) 
Seat 5: hirozo ($31.53 in chips) 
Seat 6: Suhoff76 ($29.40 in chips) 
Seat 7: Spartacus675 ($28.66 in chips) 
Seat 8: seula i ($38.56 in chips) 
Seat 9: kamikkaze ($17.84 in chips) 
chiyuki: posts small blind $0.10
Vahe50: posts big blind $0.25
*** HOLE CARDS ***
Dealt to chiyuki [5c Jd]
Wilcox76607: folds 
hirozo: folds 
Suhoff76: folds 
Spartacus675: folds 
seula i: folds 
kamikkaze: folds 
Alvinpe85: raises $0.37 to $0.62
chiyuki: folds 
Vahe50: folds 
Uncalled bet ($0.37) returned to Alvinpe85
Alvinpe85 collected $0.60 from pot
Alvinpe85: doesn't show hand 
*** SUMMARY ***
Total pot $0.60 | Rake $0 
Seat 1: Alvinpe85 (button) collected ($0.60)
Seat 2: chiyuki (small blind) folded before Flop
Seat 3: Vahe50 (big blind) folded before Flop
Seat 4: Wilcox76607 folded before Flop (didn't bet)
Seat 5: hirozo folded before Flop (didn't bet)
Seat 6: Suhoff76 folded before Flop (didn't bet)
Seat 7: Spartacus675 folded before Flop (didn't bet)
Seat 8: seula i folded before Flop (didn't bet)
Seat 9: kamikkaze folded before Flop (didn't bet)



PokerStars Zoom Hand #84299529319:  Hold'em No Limit ($0.10/$0.25) - 2012/08/05 14:25:33 JST [2012/08/05 1:25:33 ET]
Table 'Whirlpool' 9-max Seat #1 is the button
Seat 1: Wilcox76607 ($15.31 in chips) 
Seat 2: sparky5224 ($43.90 in chips) 
Seat 3: RikkStroken ($12.26 in chips) 
Seat 4: chiyuki ($31.09 in chips) 
Seat 5: Dan Royal ($41.33 in chips) 
Seat 6: wtu1986 ($33.77 in chips) 
Seat 7: mariuka1 ($2.82 in chips) 
Seat 8: KeLevro0 ($9.77 in chips) 
Seat 9: Perstenev ($12.56 in chips) 
sparky5224: posts small blind $0.10
RikkStroken: posts big blind $0.25
*** HOLE CARDS ***
Dealt to chiyuki [5c 3s]
chiyuki: folds 
Dan Royal: folds 
wtu1986: folds 
mariuka1: folds 
KeLevro0: folds 
Perstenev: raises $0.50 to $0.75
Wilcox76607: folds 
sparky5224: calls $0.65
RikkStroken: folds 
*** FLOP *** [Th Jc 6s]
sparky5224: bets $0.75
Perstenev: folds 
Uncalled bet ($0.75) returned to sparky5224
sparky5224 collected $1.67 from pot
sparky5224: doesn't show hand 
*** SUMMARY ***
Total pot $1.75 | Rake $0.08 
Board [Th Jc 6s]
Seat 1: Wilcox76607 (button) folded before Flop (didn't bet)
Seat 2: sparky5224 (small blind) collected ($1.67)
Seat 3: RikkStroken (big blind) folded before Flop
Seat 4: chiyuki folded before Flop (didn't bet)
Seat 5: Dan Royal folded before Flop (didn't bet)
Seat 6: wtu1986 folded before Flop (didn't bet)
Seat 7: mariuka1 folded before Flop (didn't bet)
Seat 8: KeLevro0 folded before Flop (didn't bet)
Seat 9: Perstenev folded on the Flop



PokerStars Zoom Hand #84299534048:  Hold'em No Limit ($0.10/$0.25) - 2012/08/05 14:25:52 JST [2012/08/05 1:25:52 ET]
Table 'Whirlpool' 9-max Seat #1 is the button
Seat 1: chiyuki ($30.99 in chips) 
Seat 2: Suhoff76 ($27.17 in chips) 
Seat 3: PetitAlejo ($28.26 in chips) 
Seat 4: kamikkaze ($15 in chips) 
Seat 5: KeLevro0 ($9.77 in chips) 
Seat 6: hirozo ($26.77 in chips) 
Seat 7: mariuka1 ($2.82 in chips) 
Seat 8: Roglus ($66.68 in chips) 
Seat 9: Th3Fog ($15.84 in chips) 
Suhoff76: posts small blind $0.10
PetitAlejo: posts big blind $0.25
*** HOLE CARDS ***
Dealt to chiyuki [5s Ks]
kamikkaze: folds 
KeLevro0: folds 
hirozo: folds 
mariuka1: raises $0.60 to $0.85
Roglus: calls $0.85
Th3Fog: folds 
chiyuki: folds 
Suhoff76: folds 
PetitAlejo: folds 
*** FLOP *** [8d Qc Qh]
mariuka1: bets $1.97 and is all-in
Roglus: calls $1.97
*** TURN *** [8d Qc Qh] [Jh]
*** RIVER *** [8d Qc Qh Jh] [3c]
*** SHOW DOWN ***
mariuka1: shows [Td Ad] (a pair of Queens)
Roglus: shows [Qd Ac] (three of a kind, Queens)
Roglus collected $5.72 from pot
*** SUMMARY ***
Total pot $5.99 | Rake $0.27 
Board [8d Qc Qh Jh 3c]
Seat 1: chiyuki (button) folded before Flop (didn't bet)
Seat 2: Suhoff76 (small blind) folded before Flop
Seat 3: PetitAlejo (big blind) folded before Flop
Seat 4: kamikkaze folded before Flop (didn't bet)
Seat 5: KeLevro0 folded before Flop (didn't bet)
Seat 6: hirozo folded before Flop (didn't bet)
Seat 7: mariuka1 showed [Td Ad] and lost with a pair of Queens
Seat 8: Roglus showed [Qd Ac] and won ($5.72) with three of a kind, Queens
Seat 9: Th3Fog folded before Flop (didn't bet)



PokerStars Zoom Hand #84299540589:  Hold'em No Limit ($0.10/$0.25) - 2012/08/05 14:26:19 JST [2012/08/05 1:26:19 ET]
Table 'Whirlpool' 9-max Seat #1 is the button
Seat 1: Th3Fog ($67.21 in chips) 
Seat 2: wtu1986 ($33.52 in chips) 
Seat 3: seula i ($63.49 in chips) 
Seat 4: Perstenev ($20.57 in chips) 
Seat 5: troms20 ($29.40 in chips) 
Seat 6: Vahe50 ($14.10 in chips) 
Seat 7: kamikkaze ($16.87 in chips) 
Seat 8: phate-1up ($25 in chips) 
Seat 9: chiyuki ($30.99 in chips) 
wtu1986: posts small blind $0.10
seula i: posts big blind $0.25
*** HOLE CARDS ***
Dealt to chiyuki [9d Ah]
Perstenev: folds 
troms20: folds 
Vahe50: folds 
kamikkaze: folds 
phate-1up: folds 
chiyuki: raises $0.50 to $0.75
Th3Fog: folds 
wtu1986: folds 
seula i: folds 
Uncalled bet ($0.50) returned to chiyuki
chiyuki collected $0.60 from pot
chiyuki: doesn't show hand 
*** SUMMARY ***
Total pot $0.60 | Rake $0 
Seat 1: Th3Fog (button) folded before Flop (didn't bet)
Seat 2: wtu1986 (small blind) folded before Flop
Seat 3: seula i (big blind) folded before Flop
Seat 4: Perstenev folded before Flop (didn't bet)
Seat 5: troms20 folded before Flop (didn't bet)
Seat 6: Vahe50 folded before Flop (didn't bet)
Seat 7: kamikkaze folded before Flop (didn't bet)
Seat 8: phate-1up folded before Flop (didn't bet)
Seat 9: chiyuki collected ($0.60)



PokerStars Zoom Hand #84299548449:  Hold'em No Limit ($0.10/$0.25) - 2012/08/05 14:26:52 JST [2012/08/05 1:26:52 ET]
Table 'Whirlpool' 9-max Seat #1 is the button
Seat 1: RikkStroken ($14.80 in chips) 
Seat 2: ChrisCDee ($26.67 in chips) 
Seat 3: 1Karina1 ($25 in chips) 
Seat 4: Loholov ($20.08 in chips) 
Seat 5: D@vidMed ($78.03 in chips) 
Seat 6: KeLevro0 ($11.95 in chips) 
Seat 7: Faraz ($18.49 in chips) 
Seat 8: chiyuki ($31.34 in chips) 
Seat 9: hirozo ($28.08 in chips) 
ChrisCDee: posts small blind $0.10
1Karina1: posts big blind $0.25
*** HOLE CARDS ***
Dealt to chiyuki [5c Tc]
Loholov: raises $0.50 to $0.75
D@vidMed: folds 
KeLevro0: folds 
Faraz: folds 
chiyuki: folds 
hirozo: folds 
RikkStroken: folds 
ChrisCDee: folds 
1Karina1: folds 
Uncalled bet ($0.50) returned to Loholov
Loholov collected $0.60 from pot
Loholov: doesn't show hand 
*** SUMMARY ***
Total pot $0.60 | Rake $0 
Seat 1: RikkStroken (button) folded before Flop (didn't bet)
Seat 2: ChrisCDee (small blind) folded before Flop
Seat 3: 1Karina1 (big blind) folded before Flop
Seat 4: Loholov collected ($0.60)
Seat 5: D@vidMed folded before Flop (didn't bet)
Seat 6: KeLevro0 folded before Flop (didn't bet)
Seat 7: Faraz folded before Flop (didn't bet)
Seat 8: chiyuki folded before Flop (didn't bet)
Seat 9: hirozo folded before Flop (didn't bet)



PokerStars Zoom Hand #84299550181:  Hold'em No Limit ($0.10/$0.25) - 2012/08/05 14:26:59 JST [2012/08/05 1:26:59 ET]
Table 'Whirlpool' 9-max Seat #1 is the button
Seat 1: Suhoff76 ($28.05 in chips) 
Seat 2: RikkStroken ($31.29 in chips) 
Seat 3: Lasutchik ($6.86 in chips) 
Seat 4: hl77777 ($13.70 in chips) 
Seat 5: ll_LaMeR_ll ($54.65 in chips) 
Seat 6: chiyuki ($31.34 in chips) 
Seat 7: Th3Fog ($53.13 in chips) 
Seat 8: hirozo ($26.42 in chips) 
Seat 9: Dejacob ($26.59 in chips) 
RikkStroken: posts small blind $0.10
Lasutchik: posts big blind $0.25
*** HOLE CARDS ***
Dealt to chiyuki [Kd As]
hl77777: folds 
ll_LaMeR_ll: folds 
chiyuki: raises $0.50 to $0.75
Th3Fog: calls $0.75
hirozo: calls $0.75
Dejacob: folds 
Suhoff76: folds 
RikkStroken: folds 
Lasutchik: folds 
*** FLOP *** [Ad Jc 7s]
chiyuki: bets $2
Th3Fog: folds 
hirozo: folds 
Uncalled bet ($2) returned to chiyuki
chiyuki collected $2.48 from pot
chiyuki: doesn't show hand 
*** SUMMARY ***
Total pot $2.60 | Rake $0.12 
Board [Ad Jc 7s]
Seat 1: Suhoff76 (button) folded before Flop (didn't bet)
Seat 2: RikkStroken (small blind) folded before Flop
Seat 3: Lasutchik (big blind) folded before Flop
Seat 4: hl77777 folded before Flop (didn't bet)
Seat 5: ll_LaMeR_ll folded before Flop (didn't bet)
Seat 6: chiyuki collected ($2.48)
Seat 7: Th3Fog folded on the Flop
Seat 8: hirozo folded on the Flop
Seat 9: Dejacob folded before Flop (didn't bet)



PokerStars Zoom Hand #84299560296:  Hold'em No Limit ($0.10/$0.25) - 2012/08/05 14:27:40 JST [2012/08/05 1:27:40 ET]
Table 'Whirlpool' 9-max Seat #1 is the button
Seat 1: ll_LaMeR_ll ($54.30 in chips) 
Seat 2: deadmoneykid ($26.52 in chips) 
Seat 3: phate-1up ($41.44 in chips) 
Seat 4: ZhukOFFskI ($24.25 in chips) 
Seat 5: chiyuki ($33.07 in chips) 
Seat 6: 4thepeople ($29.65 in chips) 
Seat 7: Perstenev ($11.93 in chips) 
Seat 8: RomarioJa ($11.11 in chips) 
Seat 9: Faraz ($19.04 in chips) 
deadmoneykid: posts small blind $0.10
phate-1up: posts big blind $0.25
*** HOLE CARDS ***
Dealt to chiyuki [Kc 9h]
ZhukOFFskI: folds 
chiyuki: folds 
4thepeople: folds 
Perstenev: folds 
RomarioJa: folds 
Faraz: raises $0.50 to $0.75
ll_LaMeR_ll: folds 
deadmoneykid: folds 
phate-1up: folds 
Uncalled bet ($0.50) returned to Faraz
Faraz collected $0.60 from pot
Faraz: doesn't show hand 
*** SUMMARY ***
Total pot $0.60 | Rake $0 
Seat 1: ll_LaMeR_ll (button) folded before Flop (didn't bet)
Seat 2: deadmoneykid (small blind) folded before Flop
Seat 3: phate-1up (big blind) folded before Flop
Seat 4: ZhukOFFskI folded before Flop (didn't bet)
Seat 5: chiyuki folded before Flop (didn't bet)
Seat 6: 4thepeople folded before Flop (didn't bet)
Seat 7: Perstenev folded before Flop (didn't bet)
Seat 8: RomarioJa folded before Flop (didn't bet)
Seat 9: Faraz collected ($0.60)



PokerStars Zoom Hand #84299561991:  Hold'em No Limit ($0.10/$0.25) - 2012/08/05 14:27:47 JST [2012/08/05 1:27:47 ET]
Table 'Whirlpool' 9-max Seat #1 is the button
Seat 1: BlOnDhOlIc ($35.71 in chips) 
Seat 2: hirozo ($25.67 in chips) 
Seat 3: chiyuki ($33.07 in chips) 
Seat 4: Dejacob ($25.84 in chips) 
Seat 5: ladymadon107 ($8.13 in chips) 
Seat 6: bonethugs699 ($15.77 in chips) 
Seat 7: hl77777 ($14.70 in chips) 
Seat 8: timbof7 ($20.48 in chips) 
Seat 9: mariuka1 ($12.15 in chips) 
hirozo: posts small blind $0.10
chiyuki: posts big blind $0.25
*** HOLE CARDS ***
Dealt to chiyuki [Jc 8s]
Dejacob: folds 
ladymadon107: calls $0.25
bonethugs699: calls $0.25
hl77777: folds 
timbof7: folds 
mariuka1: calls $0.25
BlOnDhOlIc: folds 
hirozo: folds 
chiyuki: checks 
*** FLOP *** [Ad Ah 2d]
chiyuki: checks 
ladymadon107: checks 
bonethugs699: folds 
mariuka1: bets $0.78
chiyuki: folds 
ladymadon107: folds 
Uncalled bet ($0.78) returned to mariuka1
mariuka1 collected $1.05 from pot
mariuka1: doesn't show hand 
*** SUMMARY ***
Total pot $1.10 | Rake $0.05 
Board [Ad Ah 2d]
Seat 1: BlOnDhOlIc (button) folded before Flop (didn't bet)
Seat 2: hirozo (small blind) folded before Flop
Seat 3: chiyuki (big blind) folded on the Flop
Seat 4: Dejacob folded before Flop (didn't bet)
Seat 5: ladymadon107 folded on the Flop
Seat 6: bonethugs699 folded on the Flop
Seat 7: hl77777 folded before Flop (didn't bet)
Seat 8: timbof7 folded before Flop (didn't bet)
Seat 9: mariuka1 collected ($1.05)



PokerStars Zoom Hand #84299569087:  Hold'em No Limit ($0.10/$0.25) - 2012/08/05 14:28:17 JST [2012/08/05 1:28:17 ET]
Table 'Whirlpool' 9-max Seat #1 is the button
Seat 1: Alvinpe85 ($39.91 in chips) 
Seat 2: slapshot2011 ($35.76 in chips) 
Seat 3: PetitAlejo ($32.06 in chips) 
Seat 4: kamikkaze ($18.48 in chips) 
Seat 5: acamrash ($10.39 in chips) 
Seat 6: seula i ($25 in chips) 
Seat 7: chiyuki ($32.82 in chips) 
Seat 8: troms20 ($32.74 in chips) 
Seat 9: Ellen1947 ($36.35 in chips) 
slapshot2011: posts small blind $0.10
PetitAlejo: posts big blind $0.25
*** HOLE CARDS ***
Dealt to chiyuki [8d 7h]
kamikkaze: folds 
acamrash: folds 
seula i: folds 
chiyuki: folds 
troms20: folds 
Ellen1947: folds 
Alvinpe85: folds 
slapshot2011: folds 
Uncalled bet ($0.15) returned to PetitAlejo
PetitAlejo collected $0.20 from pot
PetitAlejo: doesn't show hand 
*** SUMMARY ***
Total pot $0.20 | Rake $0 
Seat 1: Alvinpe85 (button) folded before Flop (didn't bet)
Seat 2: slapshot2011 (small blind) folded before Flop
Seat 3: PetitAlejo (big blind) collected ($0.20)
Seat 4: kamikkaze folded before Flop (didn't bet)
Seat 5: acamrash folded before Flop (didn't bet)
Seat 6: seula i folded before Flop (didn't bet)
Seat 7: chiyuki folded before Flop (didn't bet)
Seat 8: troms20 folded before Flop (didn't bet)
Seat 9: Ellen1947 folded before Flop (didn't bet)



PokerStars Zoom Hand #84299572780:  Hold'em No Limit ($0.10/$0.25) - 2012/08/05 14:28:32 JST [2012/08/05 1:28:32 ET]
Table 'Whirlpool' 9-max Seat #1 is the button
Seat 1: Suhoff76 ($28.40 in chips) 
Seat 2: chiyuki ($32.82 in chips) 
Seat 3: deadmoneykid ($22.39 in chips) 
Seat 4: hirozo ($25.32 in chips) 
Seat 5: wtu1986 ($31.14 in chips) 
Seat 6: RikkStroken ($33.31 in chips) 
Seat 7: mariuka1 ($12.70 in chips) 
Seat 8: Dan Royal ($41.33 in chips) 
Seat 9: Loholov ($18.51 in chips) 
chiyuki: posts small blind $0.10
deadmoneykid: posts big blind $0.25
*** HOLE CARDS ***
Dealt to chiyuki [4s 7h]
hirozo: folds 
wtu1986: folds 
RikkStroken: raises $0.75 to $1
mariuka1: folds 
Dan Royal: folds 
Loholov: folds 
Suhoff76: folds 
chiyuki: folds 
deadmoneykid: folds 
Uncalled bet ($0.75) returned to RikkStroken
RikkStroken collected $0.60 from pot
RikkStroken: doesn't show hand 
*** SUMMARY ***
Total pot $0.60 | Rake $0 
Seat 1: Suhoff76 (button) folded before Flop (didn't bet)
Seat 2: chiyuki (small blind) folded before Flop
Seat 3: deadmoneykid (big blind) folded before Flop
Seat 4: hirozo folded before Flop (didn't bet)
Seat 5: wtu1986 folded before Flop (didn't bet)
Seat 6: RikkStroken collected ($0.60)
Seat 7: mariuka1 folded before Flop (didn't bet)
Seat 8: Dan Royal folded before Flop (didn't bet)
Seat 9: Loholov folded before Flop (didn't bet)



PokerStars Zoom Hand #84299570536:  Hold'em No Limit ($0.10/$0.25) - 2012/08/05 14:28:23 JST [2012/08/05 1:28:23 ET]
Table 'Whirlpool' 9-max Seat #1 is the button
Seat 1: Roglus ($10.32 in chips) 
Seat 2: BlOnDhOlIc ($58.18 in chips) 
Seat 3: Faraz ($19.39 in chips) 
Seat 4: chiyuki ($32.82 in chips) 
Seat 5: ZhukOFFskI ($24.15 in chips) 
Seat 6: kamikkaze ($15.90 in chips) 
Seat 7: RikkStroken ($13.70 in chips) 
Seat 8: znake77 ($16.36 in chips) 
Seat 9: 1Karina1 ($26 in chips) 
BlOnDhOlIc: posts small blind $0.10
Faraz: posts big blind $0.25
*** HOLE CARDS ***
Dealt to chiyuki [2d 4s]
chiyuki: folds 
ZhukOFFskI: folds 
kamikkaze: folds 
RikkStroken: folds 
znake77: folds 
1Karina1: folds 
Roglus: folds 
BlOnDhOlIc: raises $0.25 to $0.50
Faraz: calls $0.25
*** FLOP *** [Qh 7d 6s]
BlOnDhOlIc: checks 
Faraz: checks 
*** TURN *** [Qh 7d 6s] [2h]
BlOnDhOlIc: bets $0.48
Faraz: folds 
Uncalled bet ($0.48) returned to BlOnDhOlIc
BlOnDhOlIc collected $0.96 from pot
BlOnDhOlIc: doesn't show hand 
*** SUMMARY ***
Total pot $1 | Rake $0.04 
Board [Qh 7d 6s 2h]
Seat 1: Roglus (button) folded before Flop (didn't bet)
Seat 2: BlOnDhOlIc (small blind) collected ($0.96)
Seat 3: Faraz (big blind) folded on the Turn
Seat 4: chiyuki folded before Flop (didn't bet)
Seat 5: ZhukOFFskI folded before Flop (didn't bet)
Seat 6: kamikkaze folded before Flop (didn't bet)
Seat 7: RikkStroken folded before Flop (didn't bet)
Seat 8: znake77 folded before Flop (didn't bet)
Seat 9: 1Karina1 folded before Flop (didn't bet)



PokerStars Zoom Hand #84299571801:  Hold'em No Limit ($0.10/$0.25) - 2012/08/05 14:28:28 JST [2012/08/05 1:28:28 ET]
Table 'Whirlpool' 9-max Seat #1 is the button
Seat 1: Lasutchik ($6.16 in chips) 
Seat 2: PetitAlejo ($32.16 in chips) 
Seat 3: ZhukOFFskI ($24.15 in chips) 
Seat 4: 1Karina1 ($25 in chips) 
Seat 5: Jene4kaBest ($12.40 in chips) 
Seat 6: BlOnDhOlIc ($38.31 in chips) 
Seat 7: RikkStroken ($33.31 in chips) 
Seat 8: chiyuki ($32.82 in chips) 
Seat 9: kamikkaze ($18.48 in chips) 
PetitAlejo: posts small blind $0.10
ZhukOFFskI: posts big blind $0.25
*** HOLE CARDS ***
Dealt to chiyuki [Js 3c]
1Karina1: folds 
Jene4kaBest: folds 
BlOnDhOlIc: folds 
RikkStroken: folds 
chiyuki: folds 
kamikkaze: folds 
Lasutchik: folds 
PetitAlejo: raises $0.50 to $0.75
ZhukOFFskI: raises $1.75 to $2.50
PetitAlejo: folds 
Uncalled bet ($1.75) returned to ZhukOFFskI
ZhukOFFskI collected $1.50 from pot
ZhukOFFskI: doesn't show hand 
*** SUMMARY ***
Total pot $1.50 | Rake $0 
Seat 1: Lasutchik (button) folded before Flop (didn't bet)
Seat 2: PetitAlejo (small blind) folded before Flop
Seat 3: ZhukOFFskI (big blind) collected ($1.50)
Seat 4: 1Karina1 folded before Flop (didn't bet)
Seat 5: Jene4kaBest folded before Flop (didn't bet)
Seat 6: BlOnDhOlIc folded before Flop (didn't bet)
Seat 7: RikkStroken folded before Flop (didn't bet)
Seat 8: chiyuki folded before Flop (didn't bet)
Seat 9: kamikkaze folded before Flop (didn't bet)



PokerStars Zoom Hand #84299576945:  Hold'em No Limit ($0.10/$0.25) - 2012/08/05 14:28:49 JST [2012/08/05 1:28:49 ET]
Table 'Whirlpool' 9-max Seat #1 is the button
Seat 1: chiyuki ($32.72 in chips) 
Seat 2: Lasutchik ($6.16 in chips) 
Seat 3: D@vidMed ($25 in chips) 
Seat 4: RikkStroken ($11.91 in chips) 
Seat 5: phate-1up ($26.32 in chips) 
Seat 6: DanielWhyte ($39.21 in chips) 
Seat 7: deadmoneykid ($26.42 in chips) 
Seat 8: Feros 99 ($24.15 in chips) 
Seat 9: wtu1986 ($24.75 in chips) 
Lasutchik: posts small blind $0.10
D@vidMed: posts big blind $0.25
*** HOLE CARDS ***
Dealt to chiyuki [8h Jc]
RikkStroken: folds 
phate-1up: folds 
DanielWhyte: folds 
deadmoneykid: folds 
Feros 99: folds 
wtu1986: raises $0.37 to $0.62
chiyuki: folds 
Lasutchik: folds 
D@vidMed: folds 
Uncalled bet ($0.37) returned to wtu1986
wtu1986 collected $0.60 from pot
wtu1986: doesn't show hand 
*** SUMMARY ***
Total pot $0.60 | Rake $0 
Seat 1: chiyuki (button) folded before Flop (didn't bet)
Seat 2: Lasutchik (small blind) folded before Flop
Seat 3: D@vidMed (big blind) folded before Flop
Seat 4: RikkStroken folded before Flop (didn't bet)
Seat 5: phate-1up folded before Flop (didn't bet)
Seat 6: DanielWhyte folded before Flop (didn't bet)
Seat 7: deadmoneykid folded before Flop (didn't bet)
Seat 8: Feros 99 folded before Flop (didn't bet)
Seat 9: wtu1986 collected ($0.60)



PokerStars Zoom Hand #84299577906:  Hold'em No Limit ($0.10/$0.25) - 2012/08/05 14:28:53 JST [2012/08/05 1:28:53 ET]
Table 'Whirlpool' 9-max Seat #1 is the button
Seat 1: Feros 99 ($24.15 in chips) 
Seat 2: Suhoff76 ($32.16 in chips) 
Seat 3: ZhukOFFskI ($25 in chips) 
Seat 4: phate-1up ($25 in chips) 
Seat 5: JLajoie ($26.29 in chips) 
Seat 6: RikkStroken ($11.91 in chips) 
Seat 7: PetitAlejo ($31.41 in chips) 
Seat 8: Lasutchik ($6.06 in chips) 
Seat 9: chiyuki ($32.72 in chips) 
Suhoff76: posts small blind $0.10
ZhukOFFskI: posts big blind $0.25
*** HOLE CARDS ***
Dealt to chiyuki [2h 8d]
phate-1up: folds 
JLajoie: folds 
RikkStroken: folds 
PetitAlejo: folds 
Lasutchik: folds 
chiyuki: folds 
Feros 99: folds 
Suhoff76: raises $0.35 to $0.60
ZhukOFFskI: folds 
Uncalled bet ($0.35) returned to Suhoff76
Suhoff76 collected $0.50 from pot
Suhoff76: doesn't show hand 
*** SUMMARY ***
Total pot $0.50 | Rake $0 
Seat 1: Feros 99 (button) folded before Flop (didn't bet)
Seat 2: Suhoff76 (small blind) collected ($0.50)
Seat 3: ZhukOFFskI (big blind) folded before Flop
Seat 4: phate-1up folded before Flop (didn't bet)
Seat 5: JLajoie folded before Flop (didn't bet)
Seat 6: RikkStroken folded before Flop (didn't bet)
Seat 7: PetitAlejo folded before Flop (didn't bet)
Seat 8: Lasutchik folded before Flop (didn't bet)
Seat 9: chiyuki folded before Flop (didn't bet)



PokerStars Zoom Hand #84299576001:  Hold'em No Limit ($0.10/$0.25) - 2012/08/05 14:28:45 JST [2012/08/05 1:28:45 ET]
Table 'Whirlpool' 9-max Seat #1 is the button
Seat 1: mariuka1 ($12.60 in chips) 
Seat 2: Th3Fog ($65.86 in chips) 
Seat 3: Nerkit ($10.82 in chips) 
Seat 4: Perstenev ($10.71 in chips) 
Seat 5: softdesign ($68.41 in chips) 
Seat 6: chiyuki ($32.72 in chips) 
Seat 7: Lasutchik ($6.16 in chips) 
Seat 8: JLajoie ($37.24 in chips) 
Seat 9: Yogi707 ($13.80 in chips) 
Th3Fog: posts small blind $0.10
Nerkit: posts big blind $0.25
*** HOLE CARDS ***
Dealt to chiyuki [8s Ad]
Perstenev: folds 
softdesign: folds 
chiyuki: folds 
Lasutchik: folds 
JLajoie: folds 
Yogi707: folds 
mariuka1: raises $0.25 to $0.50
Th3Fog: raises $0.75 to $1.25
Nerkit: folds 
mariuka1: calls $0.75
*** FLOP *** [4s 3s 6h]
Th3Fog: bets $1.55
mariuka1: folds 
Uncalled bet ($1.55) returned to Th3Fog
Th3Fog collected $2.63 from pot
Th3Fog: doesn't show hand 
*** SUMMARY ***
Total pot $2.75 | Rake $0.12 
Board [4s 3s 6h]
Seat 1: mariuka1 (button) folded on the Flop
Seat 2: Th3Fog (small blind) collected ($2.63)
Seat 3: Nerkit (big blind) folded before Flop
Seat 4: Perstenev folded before Flop (didn't bet)
Seat 5: softdesign folded before Flop (didn't bet)
Seat 6: chiyuki folded before Flop (didn't bet)
Seat 7: Lasutchik folded before Flop (didn't bet)
Seat 8: JLajoie folded before Flop (didn't bet)
Seat 9: Yogi707 folded before Flop (didn't bet)



PokerStars Zoom Hand #84299578871:  Hold'em No Limit ($0.10/$0.25) - 2012/08/05 14:28:57 JST [2012/08/05 1:28:57 ET]
Table 'Whirlpool' 9-max Seat #1 is the button
Seat 1: Perstenev ($22.52 in chips) 
Seat 2: phate-1up ($25 in chips) 
Seat 3: Ladyteazer ($25 in chips) 
Seat 4: KeLevro0 ($13.52 in chips) 
Seat 5: chiyuki ($32.72 in chips) 
Seat 6: PetitAlejo ($31.41 in chips) 
Seat 7: Feros 99 ($24.15 in chips) 
Seat 8: seula i ($25.10 in chips) 
Seat 9: Nerkit ($14.58 in chips) 
phate-1up: posts small blind $0.10
Ladyteazer: posts big blind $0.25
*** HOLE CARDS ***
Dealt to chiyuki [Kc 6h]
KeLevro0: folds 
chiyuki: folds 
PetitAlejo: folds 
Feros 99: folds 
seula i: folds 
Nerkit: folds 
Perstenev: calls $0.25
phate-1up: folds 
Ladyteazer: checks 
*** FLOP *** [Qd Ks 6d]
Ladyteazer: bets $0.50
Perstenev: folds 
Uncalled bet ($0.50) returned to Ladyteazer
Ladyteazer collected $0.57 from pot
Ladyteazer: doesn't show hand 
*** SUMMARY ***
Total pot $0.60 | Rake $0.03 
Board [Qd Ks 6d]
Seat 1: Perstenev (button) folded on the Flop
Seat 2: phate-1up (small blind) folded before Flop
Seat 3: Ladyteazer (big blind) collected ($0.57)
Seat 4: KeLevro0 folded before Flop (didn't bet)
Seat 5: chiyuki folded before Flop (didn't bet)
Seat 6: PetitAlejo folded before Flop (didn't bet)
Seat 7: Feros 99 folded before Flop (didn't bet)
Seat 8: seula i folded before Flop (didn't bet)
Seat 9: Nerkit folded before Flop (didn't bet)



PokerStars Zoom Hand #84299581101:  Hold'em No Limit ($0.10/$0.25) - 2012/08/05 14:29:06 JST [2012/08/05 1:29:06 ET]
Table 'Whirlpool' 9-max Seat #1 is the button
Seat 1: RomarioJa ($13.81 in chips) 
Seat 2: Nerkit ($14.58 in chips) 
Seat 3: silvno31 ($34.94 in chips) 
Seat 4: chiyuki ($32.72 in chips) 
Seat 5: PetitAlejo ($31.61 in chips) 
Seat 6: wtu1986 ($25.10 in chips) 
Seat 7: Roglus ($9.97 in chips) 
Seat 8: WARIBANA7777 ($14.34 in chips) 
Seat 9: phate-1up ($25 in chips) 
Nerkit: posts small blind $0.10
silvno31: posts big blind $0.25
*** HOLE CARDS ***
Dealt to chiyuki [8d 7c]
chiyuki: folds 
PetitAlejo: folds 
wtu1986: folds 
Roglus: folds 
WARIBANA7777: folds 
phate-1up: folds 
RomarioJa: folds 
Nerkit: folds 
Uncalled bet ($0.15) returned to silvno31
silvno31 collected $0.20 from pot
silvno31: doesn't show hand 
*** SUMMARY ***
Total pot $0.20 | Rake $0 
Seat 1: RomarioJa (button) folded before Flop (didn't bet)
Seat 2: Nerkit (small blind) folded before Flop
Seat 3: silvno31 (big blind) collected ($0.20)
Seat 4: chiyuki folded before Flop (didn't bet)
Seat 5: PetitAlejo folded before Flop (didn't bet)
Seat 6: wtu1986 folded before Flop (didn't bet)
Seat 7: Roglus folded before Flop (didn't bet)
Seat 8: WARIBANA7777 folded before Flop (didn't bet)
Seat 9: phate-1up folded before Flop (didn't bet)



PokerStars Zoom Hand #84299580337:  Hold'em No Limit ($0.10/$0.25) - 2012/08/05 14:29:03 JST [2012/08/05 1:29:03 ET]
Table 'Whirlpool' 9-max Seat #1 is the button
Seat 1: ladymadon107 ($7.63 in chips) 
Seat 2: PillZ86 ($6.45 in chips) 
Seat 3: 1Karina1 ($25.25 in chips) 
Seat 4: Nerkit ($14.58 in chips) 
Seat 5: D@vidMed ($24.75 in chips) 
Seat 6: Dejacob ($49.22 in chips) 
Seat 7: chiyuki ($32.72 in chips) 
Seat 8: slapshot2011 ($34.91 in chips) 
Seat 9: roksmokndonk ($23.63 in chips) 
PillZ86: posts small blind $0.10
1Karina1: posts big blind $0.25
*** HOLE CARDS ***
Dealt to chiyuki [7d 4c]
Nerkit: folds 
D@vidMed: raises $0.57 to $0.82
Dejacob: folds 
chiyuki: folds 
slapshot2011: folds 
roksmokndonk: folds 
ladymadon107: folds 
PillZ86: folds 
1Karina1: folds 
Uncalled bet ($0.57) returned to D@vidMed
D@vidMed collected $0.60 from pot
D@vidMed: doesn't show hand 
*** SUMMARY ***
Total pot $0.60 | Rake $0 
Seat 1: ladymadon107 (button) folded before Flop (didn't bet)
Seat 2: PillZ86 (small blind) folded before Flop
Seat 3: 1Karina1 (big blind) folded before Flop
Seat 4: Nerkit folded before Flop (didn't bet)
Seat 5: D@vidMed collected ($0.60)
Seat 6: Dejacob folded before Flop (didn't bet)
Seat 7: chiyuki folded before Flop (didn't bet)
Seat 8: slapshot2011 folded before Flop (didn't bet)
Seat 9: roksmokndonk folded before Flop (didn't bet)



PokerStars Zoom Hand #84299582769:  Hold'em No Limit ($0.10/$0.25) - 2012/08/05 14:29:14 JST [2012/08/05 1:29:14 ET]
Table 'Whirlpool' 9-max Seat #1 is the button
Seat 1: wtu1986 ($25.10 in chips) 
Seat 2: DanielWhyte ($38.96 in chips) 
Seat 3: chiyuki ($32.72 in chips) 
Seat 4: Yogi707 ($13.80 in chips) 
Seat 5: RikkStroken ($12.70 in chips) 
Seat 6: Suhoff76 ($25.25 in chips) 
Seat 7: 1Karina1 ($25.10 in chips) 
Seat 8: KeLevro0 ($9.43 in chips) 
Seat 9: RomarioJa ($13.81 in chips) 
DanielWhyte: posts small blind $0.10
chiyuki: posts big blind $0.25
*** HOLE CARDS ***
Dealt to chiyuki [4c 4h]
Yogi707: folds 
RikkStroken: raises $0.50 to $0.75
Suhoff76: folds 
1Karina1: folds 
KeLevro0: folds 
RomarioJa: folds 
wtu1986: calls $0.75
DanielWhyte: folds 
chiyuki: calls $0.50
*** FLOP *** [Ts 8h Qh]
chiyuki: checks 
RikkStroken: bets $1.50
wtu1986: calls $1.50
chiyuki: folds 
*** TURN *** [Ts 8h Qh] [4d]
RikkStroken: bets $3.75
wtu1986: calls $3.75
*** RIVER *** [Ts 8h Qh 4d] [Ks]
RikkStroken: bets $6.70 and is all-in
wtu1986: folds 
Uncalled bet ($6.70) returned to RikkStroken
RikkStroken collected $12.27 from pot
RikkStroken: doesn't show hand 
*** SUMMARY ***
Total pot $12.85 | Rake $0.58 
Board [Ts 8h Qh 4d Ks]
Seat 1: wtu1986 (button) folded on the River
Seat 2: DanielWhyte (small blind) folded before Flop
Seat 3: chiyuki (big blind) folded on the Flop
Seat 4: Yogi707 folded before Flop (didn't bet)
Seat 5: RikkStroken collected ($12.27)
Seat 6: Suhoff76 folded before Flop (didn't bet)
Seat 7: 1Karina1 folded before Flop (didn't bet)
Seat 8: KeLevro0 folded before Flop (didn't bet)
Seat 9: RomarioJa folded before Flop (didn't bet)



PokerStars Zoom Hand #84299604109:  Hold'em No Limit ($0.10/$0.25) - 2012/08/05 14:30:41 JST [2012/08/05 1:30:41 ET]
Table 'Whirlpool' 9-max Seat #1 is the button
Seat 1: ladymadon107 ($7.33 in chips) 
Seat 2: chiyuki ($31.97 in chips) 
Seat 3: bonethugs699 ($31.24 in chips) 
Seat 4: acamrash ($16.61 in chips) 
Seat 5: phate-1up ($33.52 in chips) 
Seat 6: Th3Fog ($50.23 in chips) 
Seat 7: Dan Royal ($30.03 in chips) 
Seat 8: Perstenev ($8.46 in chips) 
Seat 9: Alvinpe85 ($50.36 in chips) 
chiyuki: posts small blind $0.10
bonethugs699: posts big blind $0.25
*** HOLE CARDS ***
Dealt to chiyuki [2d 8d]
acamrash: folds 
phate-1up: folds 
Th3Fog: folds 
Dan Royal: folds 
Perstenev: folds 
Alvinpe85: folds 
ladymadon107: raises $0.25 to $0.50
chiyuki: folds 
bonethugs699: raises $0.46 to $0.96
ladymadon107: calls $0.46
*** FLOP *** [9h 4d Qd]
bonethugs699: bets $1.30
ladymadon107: folds 
Uncalled bet ($1.30) returned to bonethugs699
bonethugs699 collected $1.93 from pot
bonethugs699: doesn't show hand 
*** SUMMARY ***
Total pot $2.02 | Rake $0.09 
Board [9h 4d Qd]
Seat 1: ladymadon107 (button) folded on the Flop
Seat 2: chiyuki (small blind) folded before Flop
Seat 3: bonethugs699 (big blind) collected ($1.93)
Seat 4: acamrash folded before Flop (didn't bet)
Seat 5: phate-1up folded before Flop (didn't bet)
Seat 6: Th3Fog folded before Flop (didn't bet)
Seat 7: Dan Royal folded before Flop (didn't bet)
Seat 8: Perstenev folded before Flop (didn't bet)
Seat 9: Alvinpe85 folded before Flop (didn't bet)



PokerStars Zoom Hand #84299602853:  Hold'em No Limit ($0.10/$0.25) - 2012/08/05 14:30:36 JST [2012/08/05 1:30:36 ET]
Table 'Whirlpool' 9-max Seat #1 is the button
Seat 1: KeLevro0 ($12.82 in chips) 
Seat 2: Loholov ($16.95 in chips) 
Seat 3: el pore 5 ($20.91 in chips) 
Seat 4: znake77 ($3.46 in chips) 
Seat 5: RomarioJa ($30.62 in chips) 
Seat 6: bonethugs699 ($31.24 in chips) 
Seat 7: hirozo ($38.28 in chips) 
Seat 8: chiyuki ($31.97 in chips) 
Seat 9: Faraz ($18.54 in chips) 
Loholov: posts small blind $0.10
el pore 5: posts big blind $0.25
*** HOLE CARDS ***
Dealt to chiyuki [Qd Jc]
znake77: folds 
RomarioJa: folds 
bonethugs699: folds 
hirozo: folds 
chiyuki: folds 
Faraz: raises $0.25 to $0.50
KeLevro0: folds 
Loholov: folds 
el pore 5: calls $0.25
*** FLOP *** [3d 8c 6d]
el pore 5: checks 
Faraz: bets $1
el pore 5: calls $1
*** TURN *** [3d 8c 6d] [2h]
el pore 5: bets $0.25
Faraz: raises $0.25 to $0.50
el pore 5: calls $0.25
*** RIVER *** [3d 8c 6d 2h] [As]
el pore 5: bets $1
Faraz: calls $1
*** SHOW DOWN ***
el pore 5: shows [Ts 7d] (high card Ace)
Faraz: shows [6h Qc] (a pair of Sixes)
Faraz collected $5.83 from pot
*** SUMMARY ***
Total pot $6.10 | Rake $0.27 
Board [3d 8c 6d 2h As]
Seat 1: KeLevro0 (button) folded before Flop (didn't bet)
Seat 2: Loholov (small blind) folded before Flop
Seat 3: el pore 5 (big blind) showed [Ts 7d] and lost with high card Ace
Seat 4: znake77 folded before Flop (didn't bet)
Seat 5: RomarioJa folded before Flop (didn't bet)
Seat 6: bonethugs699 folded before Flop (didn't bet)
Seat 7: hirozo folded before Flop (didn't bet)
Seat 8: chiyuki folded before Flop (didn't bet)
Seat 9: Faraz showed [6h Qc] and won ($5.83) with a pair of Sixes



PokerStars Zoom Hand #84299608523:  Hold'em No Limit ($0.10/$0.25) - 2012/08/05 14:30:59 JST [2012/08/05 1:30:59 ET]
Table 'Whirlpool' 9-max Seat #1 is the button
Seat 1: Dejacob ($30.73 in chips) 
Seat 2: Suhoff76 ($25.40 in chips) 
Seat 3: Lasutchik ($70.96 in chips) 
Seat 4: Perstenev ($11.23 in chips) 
Seat 5: kamikkaze ($17.38 in chips) 
Seat 6: chiyuki ($31.87 in chips) 
Seat 7: wtu1986 ($25.70 in chips) 
Seat 8: 1Karina1 ($25 in chips) 
Seat 9: KeLevro0 ($10.49 in chips) 
Suhoff76: posts small blind $0.10
Lasutchik: posts big blind $0.25
*** HOLE CARDS ***
Dealt to chiyuki [Jh 5d]
Perstenev: folds 
kamikkaze: folds 
chiyuki: folds 
wtu1986: folds 
1Karina1: raises $0.50 to $0.75
KeLevro0: folds 
Dejacob: folds 
Suhoff76: folds 
Lasutchik: folds 
Uncalled bet ($0.50) returned to 1Karina1
1Karina1 collected $0.60 from pot
1Karina1: doesn't show hand 
*** SUMMARY ***
Total pot $0.60 | Rake $0 
Seat 1: Dejacob (button) folded before Flop (didn't bet)
Seat 2: Suhoff76 (small blind) folded before Flop
Seat 3: Lasutchik (big blind) folded before Flop
Seat 4: Perstenev folded before Flop (didn't bet)
Seat 5: kamikkaze folded before Flop (didn't bet)
Seat 6: chiyuki folded before Flop (didn't bet)
Seat 7: wtu1986 folded before Flop (didn't bet)
Seat 8: 1Karina1 collected ($0.60)
Seat 9: KeLevro0 folded before Flop (didn't bet)



PokerStars Zoom Hand #84299613220:  Hold'em No Limit ($0.10/$0.25) - 2012/08/05 14:31:18 JST [2012/08/05 1:31:18 ET]
Table 'Whirlpool' 9-max Seat #1 is the button
Seat 1: deadmoneykid ($21.79 in chips) 
Seat 2: 1Karina1 ($25 in chips) 
Seat 3: Jene4kaBest ($12.27 in chips) 
Seat 4: RikkStroken ($12.36 in chips) 
Seat 5: XeriaX ($25 in chips) 
Seat 6: ChrisCDee ($37.92 in chips) 
Seat 7: Dejacob ($48.52 in chips) 
Seat 8: seula i ($35.26 in chips) 
Seat 9: chiyuki ($31.87 in chips) 
1Karina1: posts small blind $0.10
Jene4kaBest: posts big blind $0.25
*** HOLE CARDS ***
Dealt to chiyuki [9d Kd]
RikkStroken: folds 
XeriaX: folds 
ChrisCDee: raises $0.50 to $0.75
Dejacob: folds 
seula i: folds 
chiyuki: folds 
deadmoneykid: folds 
1Karina1: folds 
Jene4kaBest: folds 
Uncalled bet ($0.50) returned to ChrisCDee
ChrisCDee collected $0.60 from pot
ChrisCDee: doesn't show hand 
*** SUMMARY ***
Total pot $0.60 | Rake $0 
Seat 1: deadmoneykid (button) folded before Flop (didn't bet)
Seat 2: 1Karina1 (small blind) folded before Flop
Seat 3: Jene4kaBest (big blind) folded before Flop
Seat 4: RikkStroken folded before Flop (didn't bet)
Seat 5: XeriaX folded before Flop (didn't bet)
Seat 6: ChrisCDee collected ($0.60)
Seat 7: Dejacob folded before Flop (didn't bet)
Seat 8: seula i folded before Flop (didn't bet)
Seat 9: chiyuki folded before Flop (didn't bet)



PokerStars Zoom Hand #84299607516:  Hold'em No Limit ($0.10/$0.25) - 2012/08/05 14:30:55 JST [2012/08/05 1:30:55 ET]
Table 'Whirlpool' 9-max Seat #1 is the button
Seat 1: chiyuki ($31.87 in chips) 
Seat 2: Perstenev ($11.33 in chips) 
Seat 3: ygoegoe ($25 in chips) 
Seat 4: KeLevro0 ($9.08 in chips) 
Seat 5: 1Karina1 ($25 in chips) 
Seat 6: cr0lox ($25.80 in chips) 
Seat 7: KrystalAA ($12.50 in chips) 
Seat 8: seula i ($25 in chips) 
Seat 9: Roglus ($1.30 in chips) 
Perstenev: posts small blind $0.10
ygoegoe: posts big blind $0.25
*** HOLE CARDS ***
Dealt to chiyuki [2s 5s]
KeLevro0: folds 
1Karina1: folds 
cr0lox: calls $0.25
KrystalAA: folds 
seula i: folds 
Roglus: folds 
chiyuki: folds 
Perstenev: folds 
ygoegoe: checks 
*** FLOP *** [Th 8d 5h]
ygoegoe: checks 
cr0lox: checks 
*** TURN *** [Th 8d 5h] [7h]
ygoegoe: checks 
cr0lox: checks 
*** RIVER *** [Th 8d 5h 7h] [Qd]
ygoegoe: checks 
cr0lox: checks 
*** SHOW DOWN ***
ygoegoe: shows [6d Kc] (high card King)
cr0lox: shows [Ad 3d] (high card Ace)
cr0lox collected $0.57 from pot
*** SUMMARY ***
Total pot $0.60 | Rake $0.03 
Board [Th 8d 5h 7h Qd]
Seat 1: chiyuki (button) folded before Flop (didn't bet)
Seat 2: Perstenev (small blind) folded before Flop
Seat 3: ygoegoe (big blind) showed [6d Kc] and lost with high card King
Seat 4: KeLevro0 folded before Flop (didn't bet)
Seat 5: 1Karina1 folded before Flop (didn't bet)
Seat 6: cr0lox showed [Ad 3d] and won ($0.57) with high card Ace
Seat 7: KrystalAA folded before Flop (didn't bet)
Seat 8: seula i folded before Flop (didn't bet)
Seat 9: Roglus folded before Flop (didn't bet)



PokerStars Zoom Hand #84299610041:  Hold'em No Limit ($0.10/$0.25) - 2012/08/05 14:31:05 JST [2012/08/05 1:31:05 ET]
Table 'Whirlpool' 9-max Seat #1 is the button
Seat 1: Vahe50 ($19.94 in chips) 
Seat 2: wtu1986 ($31.37 in chips) 
Seat 3: Spartacus675 ($34.86 in chips) 
Seat 4: Th3Fog ($66.89 in chips) 
Seat 5: Alvinpe85 ($50.26 in chips) 
Seat 6: hirozo ($33.29 in chips) 
Seat 7: chiyuki ($31.87 in chips) 
Seat 8: Feros 99 ($22.70 in chips) 
Seat 9: znake77 ($3.11 in chips) 
wtu1986: posts small blind $0.10
Spartacus675: posts big blind $0.25
*** HOLE CARDS ***
Dealt to chiyuki [Jh Qs]
Th3Fog: folds 
Alvinpe85: raises $0.50 to $0.75
hirozo: folds 
chiyuki: folds 
Feros 99: folds 
znake77: folds 
Vahe50: calls $0.75
wtu1986: folds 
Spartacus675: folds 
*** FLOP *** [3c 7d 2d]
Alvinpe85: checks 
Vahe50: bets $1
Alvinpe85: folds 
Uncalled bet ($1) returned to Vahe50
Vahe50 collected $1.77 from pot
Vahe50: doesn't show hand 
*** SUMMARY ***
Total pot $1.85 | Rake $0.08 
Board [3c 7d 2d]
Seat 1: Vahe50 (button) collected ($1.77)
Seat 2: wtu1986 (small blind) folded before Flop
Seat 3: Spartacus675 (big blind) folded before Flop
Seat 4: Th3Fog folded before Flop (didn't bet)
Seat 5: Alvinpe85 folded on the Flop
Seat 6: hirozo folded before Flop (didn't bet)
Seat 7: chiyuki folded before Flop (didn't bet)
Seat 8: Feros 99 folded before Flop (didn't bet)
Seat 9: znake77 folded before Flop (didn't bet)



PokerStars Zoom Hand #84299617678:  Hold'em No Limit ($0.10/$0.25) - 2012/08/05 14:31:37 JST [2012/08/05 1:31:37 ET]
Table 'Whirlpool' 9-max Seat #1 is the button
Seat 1: cofla tito ($12.30 in chips) 
Seat 2: phate-1up ($34.07 in chips) 
Seat 3: taksist889 ($20.71 in chips) 
Seat 4: KeLevro0 ($10.49 in chips) 
Seat 5: chiyuki ($31.87 in chips) 
Seat 6: ygoegoe ($26.81 in chips) 
Seat 7: RikkStroken ($35.76 in chips) 
Seat 8: Th3Fog ($17.78 in chips) 
Seat 9: Ladyteazer ($24.79 in chips) 
phate-1up: posts small blind $0.10
taksist889: posts big blind $0.25
*** HOLE CARDS ***
Dealt to chiyuki [Th Ks]
KeLevro0: folds 
chiyuki: folds 
ygoegoe: folds 
RikkStroken: folds 
Th3Fog: folds 
Ladyteazer: folds 
cofla tito: folds 
phate-1up: folds 
Uncalled bet ($0.15) returned to taksist889
taksist889 collected $0.20 from pot
taksist889: doesn't show hand 
*** SUMMARY ***
Total pot $0.20 | Rake $0 
Seat 1: cofla tito (button) folded before Flop (didn't bet)
Seat 2: phate-1up (small blind) folded before Flop
Seat 3: taksist889 (big blind) collected ($0.20)
Seat 4: KeLevro0 folded before Flop (didn't bet)
Seat 5: chiyuki folded before Flop (didn't bet)
Seat 6: ygoegoe folded before Flop (didn't bet)
Seat 7: RikkStroken folded before Flop (didn't bet)
Seat 8: Th3Fog folded before Flop (didn't bet)
Seat 9: Ladyteazer folded before Flop (didn't bet)



PokerStars Zoom Hand #84299616200:  Hold'em No Limit ($0.10/$0.25) - 2012/08/05 14:31:30 JST [2012/08/05 1:31:30 ET]
Table 'Whirlpool' 9-max Seat #1 is the button
Seat 1: taksist889 ($20.71 in chips) 
Seat 2: cofla tito ($12.40 in chips) 
Seat 3: 1Karina1 ($25.35 in chips) 
Seat 4: AlfredE525 ($14.55 in chips) 
Seat 5: KCDOGG10 ($25 in chips) 
Seat 6: Dejacob ($48.52 in chips) 
Seat 7: JLajoie ($24.55 in chips) 
Seat 8: chiyuki ($31.87 in chips) 
Seat 9: fuguangps ($25 in chips) 
cofla tito: posts small blind $0.10
1Karina1: posts big blind $0.25
*** HOLE CARDS ***
Dealt to chiyuki [3d 5h]
AlfredE525: folds 
KCDOGG10: folds 
Dejacob: folds 
JLajoie: folds 
chiyuki: folds 
fuguangps: folds 
taksist889: folds 
cofla tito: folds 
Uncalled bet ($0.15) returned to 1Karina1
1Karina1 collected $0.20 from pot
1Karina1: doesn't show hand 
*** SUMMARY ***
Total pot $0.20 | Rake $0 
Seat 1: taksist889 (button) folded before Flop (didn't bet)
Seat 2: cofla tito (small blind) folded before Flop
Seat 3: 1Karina1 (big blind) collected ($0.20)
Seat 4: AlfredE525 folded before Flop (didn't bet)
Seat 5: KCDOGG10 folded before Flop (didn't bet)
Seat 6: Dejacob folded before Flop (didn't bet)
Seat 7: JLajoie folded before Flop (didn't bet)
Seat 8: chiyuki folded before Flop (didn't bet)
Seat 9: fuguangps folded before Flop (didn't bet)



PokerStars Zoom Hand #84299619857:  Hold'em No Limit ($0.10/$0.25) - 2012/08/05 14:31:46 JST [2012/08/05 1:31:46 ET]
Table 'Whirlpool' 9-max Seat #1 is the button
Seat 1: DanielWhyte ($54.22 in chips) 
Seat 2: cofla tito ($11.65 in chips) 
Seat 3: chiyuki ($31.87 in chips) 
Seat 4: wtu1986 ($25 in chips) 
Seat 5: JLajoie ($24.55 in chips) 
Seat 6: simonzez ($54.18 in chips) 
Seat 7: Nerkit ($28.04 in chips) 
Seat 8: Dejacob ($30.48 in chips) 
Seat 9: KrystalAA ($12.35 in chips) 
cofla tito: posts small blind $0.10
chiyuki: posts big blind $0.25
*** HOLE CARDS ***
Dealt to chiyuki [3d 9s]
wtu1986: folds 
JLajoie: folds 
simonzez: folds 
Nerkit: folds 
Dejacob: folds 
KrystalAA: raises $0.46 to $0.71
DanielWhyte: folds 
cofla tito: folds 
chiyuki: folds 
Uncalled bet ($0.46) returned to KrystalAA
KrystalAA collected $0.60 from pot
KrystalAA: doesn't show hand 
*** SUMMARY ***
Total pot $0.60 | Rake $0 
Seat 1: DanielWhyte (button) folded before Flop (didn't bet)
Seat 2: cofla tito (small blind) folded before Flop
Seat 3: chiyuki (big blind) folded before Flop
Seat 4: wtu1986 folded before Flop (didn't bet)
Seat 5: JLajoie folded before Flop (didn't bet)
Seat 6: simonzez folded before Flop (didn't bet)
Seat 7: Nerkit folded before Flop (didn't bet)
Seat 8: Dejacob folded before Flop (didn't bet)
Seat 9: KrystalAA collected ($0.60)



PokerStars Zoom Hand #84299624050:  Hold'em No Limit ($0.10/$0.25) - 2012/08/05 14:32:03 JST [2012/08/05 1:32:03 ET]
Table 'Whirlpool' 9-max Seat #1 is the button
Seat 1: puffy5533 ($24.94 in chips) 
Seat 2: BlOnDhOlIc ($84.58 in chips) 
Seat 3: phate-1up ($33.97 in chips) 
Seat 4: Roglus ($78.45 in chips) 
Seat 5: sparky5224 ($44.04 in chips) 
Seat 6: chiyuki ($31.62 in chips) 
Seat 7: KrystalAA ($12.70 in chips) 
Seat 8: KeLevro0 ($9.75 in chips) 
Seat 9: loca-loca888 ($47.83 in chips) 
BlOnDhOlIc: posts small blind $0.10
phate-1up: posts big blind $0.25
*** HOLE CARDS ***
Dealt to chiyuki [3s 8h]
Roglus: folds 
sparky5224: folds 
chiyuki: folds 
KrystalAA: folds 
KeLevro0: raises $0.42 to $0.67
loca-loca888: folds 
puffy5533: folds 
BlOnDhOlIc: folds 
phate-1up: folds 
Uncalled bet ($0.42) returned to KeLevro0
KeLevro0 collected $0.60 from pot
KeLevro0: doesn't show hand 
*** SUMMARY ***
Total pot $0.60 | Rake $0 
Seat 1: puffy5533 (button) folded before Flop (didn't bet)
Seat 2: BlOnDhOlIc (small blind) folded before Flop
Seat 3: phate-1up (big blind) folded before Flop
Seat 4: Roglus folded before Flop (didn't bet)
Seat 5: sparky5224 folded before Flop (didn't bet)
Seat 6: chiyuki folded before Flop (didn't bet)
Seat 7: KrystalAA folded before Flop (didn't bet)
Seat 8: KeLevro0 collected ($0.60)
Seat 9: loca-loca888 folded before Flop (didn't bet)



PokerStars Zoom Hand #84299628545:  Hold'em No Limit ($0.10/$0.25) - 2012/08/05 14:32:21 JST [2012/08/05 1:32:21 ET]
Table 'Whirlpool' 9-max Seat #1 is the button
Seat 1: chiyuki ($31.52 in chips) 
Seat 2: ChrisCDee ($38.27 in chips) 
Seat 3: ZhukOFFskI ($24.30 in chips) 
Seat 4: znake77 ($2.39 in chips) 
Seat 5: dushvan ($47.21 in chips) 
Seat 6: ll_LaMeR_ll ($72.83 in chips) 
Seat 7: fuguangps ($30.02 in chips) 
Seat 8: Suhoff76 ($26.95 in chips) 
Seat 9: KeLevro0 ($11.97 in chips) 
ChrisCDee: posts small blind $0.10
ZhukOFFskI: posts big blind $0.25
*** HOLE CARDS ***
Dealt to chiyuki [Ah 7s]
znake77: folds 
dushvan: folds 
ll_LaMeR_ll: raises $0.50 to $0.75
fuguangps: folds 
Suhoff76: folds 
KeLevro0: folds 
chiyuki: folds 
ChrisCDee: folds 
ZhukOFFskI: folds 
Uncalled bet ($0.50) returned to ll_LaMeR_ll
ll_LaMeR_ll collected $0.60 from pot
ll_LaMeR_ll: doesn't show hand 
*** SUMMARY ***
Total pot $0.60 | Rake $0 
Seat 1: chiyuki (button) folded before Flop (didn't bet)
Seat 2: ChrisCDee (small blind) folded before Flop
Seat 3: ZhukOFFskI (big blind) folded before Flop
Seat 4: znake77 folded before Flop (didn't bet)
Seat 5: dushvan folded before Flop (didn't bet)
Seat 6: ll_LaMeR_ll collected ($0.60)
Seat 7: fuguangps folded before Flop (didn't bet)
Seat 8: Suhoff76 folded before Flop (didn't bet)
Seat 9: KeLevro0 folded before Flop (didn't bet)



PokerStars Zoom Hand #84299629556:  Hold'em No Limit ($0.10/$0.25) - 2012/08/05 14:32:25 JST [2012/08/05 1:32:25 ET]
Table 'Whirlpool' 9-max Seat #1 is the button
Seat 1: slapshot2011 ($33.01 in chips) 
Seat 2: troms20 ($18.01 in chips) 
Seat 3: dushvan ($47.21 in chips) 
Seat 4: KrystalAA ($12.70 in chips) 
Seat 5: Suhoff76 ($31.81 in chips) 
Seat 6: znake77 ($2.39 in chips) 
Seat 7: chiyuki ($31.52 in chips) 
Seat 8: wtu1986 ($24.90 in chips) 
Seat 9: fuguangps ($30.02 in chips) 
troms20: posts small blind $0.10
dushvan: posts big blind $0.25
*** HOLE CARDS ***
Dealt to chiyuki [7d Qc]
KrystalAA: folds 
Suhoff76: folds 
znake77: folds 
chiyuki: folds 
wtu1986: folds 
fuguangps: folds 
slapshot2011: folds 
troms20: folds 
Uncalled bet ($0.15) returned to dushvan
dushvan collected $0.20 from pot
dushvan: doesn't show hand 
*** SUMMARY ***
Total pot $0.20 | Rake $0 
Seat 1: slapshot2011 (button) folded before Flop (didn't bet)
Seat 2: troms20 (small blind) folded before Flop
Seat 3: dushvan (big blind) collected ($0.20)
Seat 4: KrystalAA folded before Flop (didn't bet)
Seat 5: Suhoff76 folded before Flop (didn't bet)
Seat 6: znake77 folded before Flop (didn't bet)
Seat 7: chiyuki folded before Flop (didn't bet)
Seat 8: wtu1986 folded before Flop (didn't bet)
Seat 9: fuguangps folded before Flop (didn't bet)



PokerStars Zoom Hand #84299625037:  Hold'em No Limit ($0.10/$0.25) - 2012/08/05 14:32:07 JST [2012/08/05 1:32:07 ET]
Table 'Whirlpool' 9-max Seat #1 is the button
Seat 1: seula i ($61.29 in chips) 
Seat 2: chiyuki ($31.62 in chips) 
Seat 3: Perstenev ($11.90 in chips) 
Seat 4: WARIBANA7777 ($17.23 in chips) 
Seat 5: Dafleche ($20.06 in chips) 
Seat 6: Faraz ($21.27 in chips) 
Seat 7: deadmoneykid ($25.43 in chips) 
Seat 8: KCDOGG10 ($24.75 in chips) 
Seat 9: Th3Fog ($66.64 in chips) 
chiyuki: posts small blind $0.10
Perstenev: posts big blind $0.25
*** HOLE CARDS ***
Dealt to chiyuki [Kc 9c]
WARIBANA7777: folds 
Dafleche: folds 
Faraz: raises $0.50 to $0.75
deadmoneykid: folds 
KCDOGG10: calls $0.75
Th3Fog: folds 
seula i: folds 
chiyuki: folds 
Perstenev: folds 
*** FLOP *** [6h 7d Qc]
Faraz: bets $0.75
KCDOGG10: calls $0.75
*** TURN *** [6h 7d Qc] [7c]
Faraz: checks 
KCDOGG10: bets $2
Faraz: folds 
Uncalled bet ($2) returned to KCDOGG10
KCDOGG10 collected $3.20 from pot
KCDOGG10: doesn't show hand 
*** SUMMARY ***
Total pot $3.35 | Rake $0.15 
Board [6h 7d Qc 7c]
Seat 1: seula i (button) folded before Flop (didn't bet)
Seat 2: chiyuki (small blind) folded before Flop
Seat 3: Perstenev (big blind) folded before Flop
Seat 4: WARIBANA7777 folded before Flop (didn't bet)
Seat 5: Dafleche folded before Flop (didn't bet)
Seat 6: Faraz folded on the Turn
Seat 7: deadmoneykid folded before Flop (didn't bet)
Seat 8: KCDOGG10 collected ($3.20)
Seat 9: Th3Fog folded before Flop (didn't bet)



PokerStars Zoom Hand #84299636948:  Hold'em No Limit ($0.10/$0.25) - 2012/08/05 14:32:56 JST [2012/08/05 1:32:56 ET]
Table 'Whirlpool' 9-max Seat #1 is the button
Seat 1: peng2astic ($21.50 in chips) 
Seat 2: mariuka1 ($7.63 in chips) 
Seat 3: chiyuki ($31.52 in chips) 
Seat 4: Vahe50 ($27.16 in chips) 
Seat 5: XeriaX ($27.26 in chips) 
Seat 6: Yogi707 ($14.58 in chips) 
Seat 7: BlOnDhOlIc ($84.23 in chips) 
Seat 8: Th3Fog ($66.54 in chips) 
Seat 9: Nerkit ($10.89 in chips) 
mariuka1: posts small blind $0.10
chiyuki: posts big blind $0.25
*** HOLE CARDS ***
Dealt to chiyuki [2c Ah]
Vahe50: folds 
XeriaX: folds 
Yogi707: folds 
BlOnDhOlIc: folds 
Th3Fog: folds 
Nerkit: raises $0.50 to $0.75
peng2astic: folds 
mariuka1: folds 
chiyuki: folds 
Uncalled bet ($0.50) returned to Nerkit
Nerkit collected $0.60 from pot
Nerkit: doesn't show hand 
*** SUMMARY ***
Total pot $0.60 | Rake $0 
Seat 1: peng2astic (button) folded before Flop (didn't bet)
Seat 2: mariuka1 (small blind) folded before Flop
Seat 3: chiyuki (big blind) folded before Flop
Seat 4: Vahe50 folded before Flop (didn't bet)
Seat 5: XeriaX folded before Flop (didn't bet)
Seat 6: Yogi707 folded before Flop (didn't bet)
Seat 7: BlOnDhOlIc folded before Flop (didn't bet)
Seat 8: Th3Fog folded before Flop (didn't bet)
Seat 9: Nerkit collected ($0.60)



PokerStars Zoom Hand #84299633538:  Hold'em No Limit ($0.10/$0.25) - 2012/08/05 14:32:41 JST [2012/08/05 1:32:41 ET]
Table 'Whirlpool' 9-max Seat #1 is the button
Seat 1: Th3Fog ($66.54 in chips) 
Seat 2: Nerkit ($10.99 in chips) 
Seat 3: puffy5533 ($24.94 in chips) 
Seat 4: troms20 ($25 in chips) 
Seat 5: chiyuki ($31.52 in chips) 
Seat 6: ZhukOFFskI ($25 in chips) 
Seat 7: cr0lox ($26.02 in chips) 
Seat 8: BlOnDhOlIc ($37.08 in chips) 
Seat 9: ladymadon107 ($3.37 in chips) 
Nerkit: posts small blind $0.10
puffy5533: posts big blind $0.25
*** HOLE CARDS ***
Dealt to chiyuki [3c Qc]
troms20: folds 
chiyuki: folds 
ZhukOFFskI: folds 
cr0lox: folds 
BlOnDhOlIc: raises $0.25 to $0.50
ladymadon107: calls $0.50
Th3Fog: folds 
Nerkit: folds 
puffy5533: folds 
*** FLOP *** [Td Kd Ad]
BlOnDhOlIc: checks 
ladymadon107: checks 
*** TURN *** [Td Kd Ad] [Kh]
BlOnDhOlIc: bets $0.64
ladymadon107: folds 
Uncalled bet ($0.64) returned to BlOnDhOlIc
BlOnDhOlIc collected $1.29 from pot
BlOnDhOlIc: doesn't show hand 
*** SUMMARY ***
Total pot $1.35 | Rake $0.06 
Board [Td Kd Ad Kh]
Seat 1: Th3Fog (button) folded before Flop (didn't bet)
Seat 2: Nerkit (small blind) folded before Flop
Seat 3: puffy5533 (big blind) folded before Flop
Seat 4: troms20 folded before Flop (didn't bet)
Seat 5: chiyuki folded before Flop (didn't bet)
Seat 6: ZhukOFFskI folded before Flop (didn't bet)
Seat 7: cr0lox folded before Flop (didn't bet)
Seat 8: BlOnDhOlIc collected ($1.29)
Seat 9: ladymadon107 folded on the Turn



PokerStars Zoom Hand #84299636247:  Hold'em No Limit ($0.10/$0.25) - 2012/08/05 14:32:53 JST [2012/08/05 1:32:53 ET]
Table 'Whirlpool' 9-max Seat #1 is the button
Seat 1: Dejacob ($30.73 in chips) 
Seat 2: KeLevro0 ($10.45 in chips) 
Seat 3: GovGus ($25 in chips) 
Seat 4: chiyuki ($31.52 in chips) 
Seat 5: Suhoff76 ($25 in chips) 
Seat 6: stalkerec ($11.15 in chips) 
Seat 7: ZhukOFFskI ($25 in chips) 
Seat 8: ll_LaMeR_ll ($73.18 in chips) 
Seat 9: KCDOGG10 ($26.45 in chips) 
KeLevro0: posts small blind $0.10
GovGus: posts big blind $0.25
*** HOLE CARDS ***
Dealt to chiyuki [8c 2s]
chiyuki: folds 
Suhoff76: raises $0.62 to $0.87
stalkerec: folds 
ZhukOFFskI: raises $1.38 to $2.25
ll_LaMeR_ll: folds 
KCDOGG10: folds 
Dejacob: folds 
KeLevro0: folds 
GovGus: folds 
Suhoff76: calls $1.38
*** FLOP *** [2c 3c 6s]
Suhoff76: checks 
ZhukOFFskI: bets $3
Suhoff76: folds 
Uncalled bet ($3) returned to ZhukOFFskI
ZhukOFFskI collected $4.63 from pot
ZhukOFFskI: doesn't show hand 
*** SUMMARY ***
Total pot $4.85 | Rake $0.22 
Board [2c 3c 6s]
Seat 1: Dejacob (button) folded before Flop (didn't bet)
Seat 2: KeLevro0 (small blind) folded before Flop
Seat 3: GovGus (big blind) folded before Flop
Seat 4: chiyuki folded before Flop (didn't bet)
Seat 5: Suhoff76 folded on the Flop
Seat 6: stalkerec folded before Flop (didn't bet)
Seat 7: ZhukOFFskI collected ($4.63)
Seat 8: ll_LaMeR_ll folded before Flop (didn't bet)
Seat 9: KCDOGG10 folded before Flop (didn't bet)



PokerStars Zoom Hand #84299634743:  Hold'em No Limit ($0.10/$0.25) - 2012/08/05 14:32:47 JST [2012/08/05 1:32:47 ET]
Table 'Whirlpool' 9-max Seat #1 is the button
Seat 1: RikkStroken ($80.27 in chips) 
Seat 2: fuguangps ($25.35 in chips) 
Seat 3: Walturrr ($25 in chips) 
Seat 4: troms20 ($49.15 in chips) 
Seat 5: deadmoneykid ($25.43 in chips) 
Seat 6: cr0lox ($26.02 in chips) 
Seat 7: Yogi707 ($14.58 in chips) 
Seat 8: chiyuki ($31.52 in chips) 
Seat 9: ZhukOFFskI ($25 in chips) 
fuguangps: posts small blind $0.10
Walturrr: posts big blind $0.25
*** HOLE CARDS ***
Dealt to chiyuki [Js Qd]
troms20: folds 
deadmoneykid: folds 
cr0lox: folds 
Yogi707: folds 
chiyuki: folds 
ZhukOFFskI: folds 
RikkStroken: raises $0.50 to $0.75
fuguangps: folds 
Walturrr: calls $0.50
*** FLOP *** [Tc Kd 2h]
Walturrr: checks 
RikkStroken: bets $1
Walturrr: folds 
Uncalled bet ($1) returned to RikkStroken
RikkStroken collected $1.53 from pot
RikkStroken: doesn't show hand 
*** SUMMARY ***
Total pot $1.60 | Rake $0.07 
Board [Tc Kd 2h]
Seat 1: RikkStroken (button) collected ($1.53)
Seat 2: fuguangps (small blind) folded before Flop
Seat 3: Walturrr (big blind) folded on the Flop
Seat 4: troms20 folded before Flop (didn't bet)
Seat 5: deadmoneykid folded before Flop (didn't bet)
Seat 6: cr0lox folded before Flop (didn't bet)
Seat 7: Yogi707 folded before Flop (didn't bet)
Seat 8: chiyuki folded before Flop (didn't bet)
Seat 9: ZhukOFFskI folded before Flop (didn't bet)



PokerStars Zoom Hand #84299631053:  Hold'em No Limit ($0.10/$0.25) - 2012/08/05 14:32:31 JST [2012/08/05 1:32:31 ET]
Table 'Whirlpool' 9-max Seat #1 is the button
Seat 1: wtu1986 ($24.90 in chips) 
Seat 2: KrystalAA ($12.70 in chips) 
Seat 3: KeLevro0 ($11.97 in chips) 
Seat 4: slapshot2011 ($33.01 in chips) 
Seat 5: znake77 ($2.39 in chips) 
Seat 6: chiyuki ($31.52 in chips) 
Seat 7: 1Karina1 ($26.78 in chips) 
Seat 8: RikkStroken ($14.86 in chips) 
Seat 9: cr0lox ($26.02 in chips) 
KrystalAA: posts small blind $0.10
KeLevro0: posts big blind $0.25
*** HOLE CARDS ***
Dealt to chiyuki [9c 3d]
slapshot2011: calls $0.25
znake77: folds 
chiyuki: folds 
1Karina1: folds 
RikkStroken: folds 
cr0lox: folds 
wtu1986: raises $0.75 to $1
KrystalAA: folds 
KeLevro0: folds 
slapshot2011: calls $0.75
*** FLOP *** [Th 7h Td]
slapshot2011: bets $1.25
wtu1986: folds 
Uncalled bet ($1.25) returned to slapshot2011
slapshot2011 collected $2.24 from pot
slapshot2011: doesn't show hand 
*** SUMMARY ***
Total pot $2.35 | Rake $0.11 
Board [Th 7h Td]
Seat 1: wtu1986 (button) folded on the Flop
Seat 2: KrystalAA (small blind) folded before Flop
Seat 3: KeLevro0 (big blind) folded before Flop
Seat 4: slapshot2011 collected ($2.24)
Seat 5: znake77 folded before Flop (didn't bet)
Seat 6: chiyuki folded before Flop (didn't bet)
Seat 7: 1Karina1 folded before Flop (didn't bet)
Seat 8: RikkStroken folded before Flop (didn't bet)
Seat 9: cr0lox folded before Flop (didn't bet)



PokerStars Zoom Hand #84299619118:  Hold'em No Limit ($0.10/$0.25) - 2012/08/05 14:31:43 JST [2012/08/05 1:31:43 ET]
Table 'Whirlpool' 9-max Seat #1 is the button
Seat 1: RikkStroken ($18.87 in chips) 
Seat 2: cr0lox ($26.12 in chips) 
Seat 3: ygoegoe ($26.81 in chips) 
Seat 4: 4ydo yogurt ($10.36 in chips) 
Seat 5: Th3Fog ($50.33 in chips) 
Seat 6: seula i ($35.26 in chips) 
Seat 7: deadmoneykid ($21.69 in chips) 
Seat 8: Faraz ($21.27 in chips) 
Seat 9: chiyuki ($31.87 in chips) 
cr0lox: posts small blind $0.10
ygoegoe: posts big blind $0.25
*** HOLE CARDS ***
Dealt to chiyuki [3c 7h]
4ydo yogurt: folds 
Th3Fog: folds 
seula i: folds 
deadmoneykid: raises $0.50 to $0.75
Faraz: folds 
chiyuki: folds 
RikkStroken: raises $1.75 to $2.50
cr0lox: folds 
ygoegoe: folds 
deadmoneykid: raises $5 to $7.50
RikkStroken: raises $6.50 to $14
deadmoneykid: raises $7.69 to $21.69 and is all-in
RikkStroken: calls $4.87 and is all-in
Uncalled bet ($2.82) returned to deadmoneykid
*** FLOP *** [Jd 3s 5c]
*** TURN *** [Jd 3s 5c] [Ad]
*** RIVER *** [Jd 3s 5c Ad] [6h]
*** SHOW DOWN ***
deadmoneykid: shows [9h 9d] (a pair of Nines)
RikkStroken: shows [Qh Qs] (a pair of Queens)
RikkStroken collected $36.38 from pot
*** SUMMARY ***
Total pot $38.09 | Rake $1.71 
Board [Jd 3s 5c Ad 6h]
Seat 1: RikkStroken (button) showed [Qh Qs] and won ($36.38) with a pair of Queens
Seat 2: cr0lox (small blind) folded before Flop
Seat 3: ygoegoe (big blind) folded before Flop
Seat 4: 4ydo yogurt folded before Flop (didn't bet)
Seat 5: Th3Fog folded before Flop (didn't bet)
Seat 6: seula i folded before Flop (didn't bet)
Seat 7: deadmoneykid showed [9h 9d] and lost with a pair of Nines
Seat 8: Faraz folded before Flop (didn't bet)
Seat 9: chiyuki folded before Flop (didn't bet)



PokerStars Zoom Hand #84299641693:  Hold'em No Limit ($0.10/$0.25) - 2012/08/05 14:33:15 JST [2012/08/05 1:33:15 ET]
Table 'Whirlpool' 9-max Seat #1 is the button
Seat 1: phate-1up ($27.47 in chips) 
Seat 2: chiyuki ($31.27 in chips) 
Seat 3: Paranoix1990 ($10.25 in chips) 
Seat 4: Loholov ($20.23 in chips) 
Seat 5: Nerkit ($25.04 in chips) 
Seat 6: 1Karina1 ($25 in chips) 
Seat 7: RikkStroken ($15.71 in chips) 
Seat 8: Dejacob ($47.37 in chips) 
Seat 9: DanielWhyte ($53.47 in chips) 
chiyuki: posts small blind $0.10
Paranoix1990: posts big blind $0.25
*** HOLE CARDS ***
Dealt to chiyuki [5c Ah]
Loholov: folds 
Nerkit: folds 
1Karina1: folds 
RikkStroken: folds 
Dejacob: folds 
DanielWhyte: folds 
phate-1up: raises $0.50 to $0.75
chiyuki: folds 
Paranoix1990: calls $0.50
*** FLOP *** [Qh 6d 3s]
Paranoix1990: checks 
phate-1up: bets $1
Paranoix1990: calls $1
*** TURN *** [Qh 6d 3s] [6h]
Paranoix1990: checks 
phate-1up: checks 
*** RIVER *** [Qh 6d 3s 6h] [6c]
Paranoix1990: bets $2.25
phate-1up: calls $2.25
*** SHOW DOWN ***
Paranoix1990: shows [6s Ts] (four of a kind, Sixes)
phate-1up: mucks hand 
Paranoix1990 collected $7.74 from pot
*** SUMMARY ***
Total pot $8.10 | Rake $0.36 
Board [Qh 6d 3s 6h 6c]
Seat 1: phate-1up (button) mucked [Jh Jd]
Seat 2: chiyuki (small blind) folded before Flop
Seat 3: Paranoix1990 (big blind) showed [6s Ts] and won ($7.74) with four of a kind, Sixes
Seat 4: Loholov folded before Flop (didn't bet)
Seat 5: Nerkit folded before Flop (didn't bet)
Seat 6: 1Karina1 folded before Flop (didn't bet)
Seat 7: RikkStroken folded before Flop (didn't bet)
Seat 8: Dejacob folded before Flop (didn't bet)
Seat 9: DanielWhyte folded before Flop (didn't bet)



PokerStars Zoom Hand #84299652004:  Hold'em No Limit ($0.10/$0.25) - 2012/08/05 14:33:57 JST [2012/08/05 1:33:57 ET]
Table 'Whirlpool' 9-max Seat #1 is the button
Seat 1: chiyuki ($31.17 in chips) 
Seat 2: Perstenev ($8.86 in chips) 
Seat 3: Loholov ($15 in chips) 
Seat 4: Nerkit ($11.59 in chips) 
Seat 5: wtu1986 ($25 in chips) 
Seat 6: RikkStroken ($28.51 in chips) 
Seat 7: 1Karina1 ($25 in chips) 
Seat 8: Walturrr ($24.15 in chips) 
Seat 9: Landybob ($41.31 in chips) 
Perstenev: posts small blind $0.10
Loholov: posts big blind $0.25
*** HOLE CARDS ***
Dealt to chiyuki [4d 9h]
Nerkit: folds 
wtu1986: folds 
RikkStroken: folds 
1Karina1: folds 
Walturrr: folds 
Landybob: raises $0.50 to $0.75
chiyuki: folds 
Perstenev: folds 
Loholov: folds 
Uncalled bet ($0.50) returned to Landybob
Landybob collected $0.60 from pot
Landybob: doesn't show hand 
*** SUMMARY ***
Total pot $0.60 | Rake $0 
Seat 1: chiyuki (button) folded before Flop (didn't bet)
Seat 2: Perstenev (small blind) folded before Flop
Seat 3: Loholov (big blind) folded before Flop
Seat 4: Nerkit folded before Flop (didn't bet)
Seat 5: wtu1986 folded before Flop (didn't bet)
Seat 6: RikkStroken folded before Flop (didn't bet)
Seat 7: 1Karina1 folded before Flop (didn't bet)
Seat 8: Walturrr folded before Flop (didn't bet)
Seat 9: Landybob collected ($0.60)



PokerStars Zoom Hand #84299657747:  Hold'em No Limit ($0.10/$0.25) - 2012/08/05 14:34:21 JST [2012/08/05 1:34:21 ET]
Table 'Whirlpool' 9-max Seat #1 is the button
Seat 1: JLajoie ($26.58 in chips) 
Seat 2: 1Karina1 ($25.10 in chips) 
Seat 3: KeLevro0 ($9 in chips) 
Seat 4: chiyuki ($31.17 in chips) 
Seat 5: znake77 ($13.79 in chips) 
Seat 6: Suhoff76 ($28.62 in chips) 
Seat 7: caro196661cv ($32.64 in chips) 
Seat 8: wtu1986 ($25 in chips) 
Seat 9: Loholov ($15 in chips) 
1Karina1: posts small blind $0.10
KeLevro0: posts big blind $0.25
*** HOLE CARDS ***
Dealt to chiyuki [Qd 5d]
chiyuki: folds 
znake77: folds 
Suhoff76: folds 
caro196661cv: folds 
wtu1986: folds 
Loholov: folds 
JLajoie: folds 
1Karina1: folds 
Uncalled bet ($0.15) returned to KeLevro0
KeLevro0 collected $0.20 from pot
KeLevro0: doesn't show hand 
*** SUMMARY ***
Total pot $0.20 | Rake $0 
Seat 1: JLajoie (button) folded before Flop (didn't bet)
Seat 2: 1Karina1 (small blind) folded before Flop
Seat 3: KeLevro0 (big blind) collected ($0.20)
Seat 4: chiyuki folded before Flop (didn't bet)
Seat 5: znake77 folded before Flop (didn't bet)
Seat 6: Suhoff76 folded before Flop (didn't bet)
Seat 7: caro196661cv folded before Flop (didn't bet)
Seat 8: wtu1986 folded before Flop (didn't bet)
Seat 9: Loholov folded before Flop (didn't bet)



PokerStars Zoom Hand #84299653080:  Hold'em No Limit ($0.10/$0.25) - 2012/08/05 14:34:02 JST [2012/08/05 1:34:02 ET]
Table 'Whirlpool' 9-max Seat #1 is the button
Seat 1: 1Karina1 ($25 in chips) 
Seat 2: seula i ($32.04 in chips) 
Seat 3: deadmoneykid ($25.43 in chips) 
Seat 4: RikkStroken ($28.51 in chips) 
Seat 5: phate-1up ($26.71 in chips) 
Seat 6: Alvinpe85 ($49.16 in chips) 
Seat 7: el pore 5 ($18.06 in chips) 
Seat 8: stalkerec ($10.90 in chips) 
Seat 9: chiyuki ($31.17 in chips) 
seula i: posts small blind $0.10
deadmoneykid: posts big blind $0.25
*** HOLE CARDS ***
Dealt to chiyuki [Kc Jc]
RikkStroken: folds 
phate-1up: folds 
Alvinpe85: folds 
el pore 5: calls $0.25
stalkerec: folds 
chiyuki: folds 
1Karina1: folds 
seula i: folds 
deadmoneykid: checks 
*** FLOP *** [2c 7h Th]
deadmoneykid: checks 
el pore 5: bets $0.50
deadmoneykid: folds 
Uncalled bet ($0.50) returned to el pore 5
el pore 5 collected $0.57 from pot
el pore 5: doesn't show hand 
*** SUMMARY ***
Total pot $0.60 | Rake $0.03 
Board [2c 7h Th]
Seat 1: 1Karina1 (button) folded before Flop (didn't bet)
Seat 2: seula i (small blind) folded before Flop
Seat 3: deadmoneykid (big blind) folded on the Flop
Seat 4: RikkStroken folded before Flop (didn't bet)
Seat 5: phate-1up folded before Flop (didn't bet)
Seat 6: Alvinpe85 folded before Flop (didn't bet)
Seat 7: el pore 5 collected ($0.57)
Seat 8: stalkerec folded before Flop (didn't bet)
Seat 9: chiyuki folded before Flop (didn't bet)



PokerStars Zoom Hand #84299658766:  Hold'em No Limit ($0.10/$0.25) - 2012/08/05 14:34:25 JST [2012/08/05 1:34:25 ET]
Table 'Whirlpool' 9-max Seat #1 is the button
Seat 1: GovGus ($25 in chips) 
Seat 2: Ladyteazer ($25.66 in chips) 
Seat 3: Alvinpe85 ($49.16 in chips) 
Seat 4: seula i ($112.03 in chips) 
Seat 5: silvno31 ($27.69 in chips) 
Seat 6: 1Karina1 ($25 in chips) 
Seat 7: ygoegoe ($25.02 in chips) 
Seat 8: chiyuki ($31.17 in chips) 
Seat 9: JLajoie ($26.58 in chips) 
Ladyteazer: posts small blind $0.10
Alvinpe85: posts big blind $0.25
*** HOLE CARDS ***
Dealt to chiyuki [6s 9h]
seula i: folds 
silvno31: folds 
1Karina1: folds 
ygoegoe: folds 
chiyuki: folds 
JLajoie: folds 
GovGus: folds 
Ladyteazer: folds 
Uncalled bet ($0.15) returned to Alvinpe85
Alvinpe85 collected $0.20 from pot
Alvinpe85: doesn't show hand 
*** SUMMARY ***
Total pot $0.20 | Rake $0 
Seat 1: GovGus (button) folded before Flop (didn't bet)
Seat 2: Ladyteazer (small blind) folded before Flop
Seat 3: Alvinpe85 (big blind) collected ($0.20)
Seat 4: seula i folded before Flop (didn't bet)
Seat 5: silvno31 folded before Flop (didn't bet)
Seat 6: 1Karina1 folded before Flop (didn't bet)
Seat 7: ygoegoe folded before Flop (didn't bet)
Seat 8: chiyuki folded before Flop (didn't bet)
Seat 9: JLajoie folded before Flop (didn't bet)



PokerStars Zoom Hand #84299656993:  Hold'em No Limit ($0.10/$0.25) - 2012/08/05 14:34:18 JST [2012/08/05 1:34:18 ET]
Table 'Whirlpool' 9-max Seat #1 is the button
Seat 1: BlOnDhOlIc ($37.62 in chips) 
Seat 2: RikkStroken ($28.26 in chips) 
Seat 3: Walturrr ($24.15 in chips) 
Seat 4: seula i ($112.03 in chips) 
Seat 5: chiyuki ($31.17 in chips) 
Seat 6: fuguangps ($30.52 in chips) 
Seat 7: Perstenev ($12.65 in chips) 
Seat 8: Wilcox76607 ($13.16 in chips) 
Seat 9: 4ydo yogurt ($11.06 in chips) 
RikkStroken: posts small blind $0.10
Walturrr: posts big blind $0.25
*** HOLE CARDS ***
Dealt to chiyuki [3c 8s]
seula i: folds 
chiyuki: folds 
fuguangps: folds 
Perstenev: calls $0.25
Wilcox76607: folds 
4ydo yogurt: folds 
BlOnDhOlIc: folds 
RikkStroken: folds 
Walturrr: checks 
*** FLOP *** [7d 7c 7h]
Walturrr: checks 
Perstenev: checks 
*** TURN *** [7d 7c 7h] [3h]
Walturrr: checks 
Perstenev: checks 
*** RIVER *** [7d 7c 7h 3h] [Td]
Walturrr: checks 
Perstenev: checks 
*** SHOW DOWN ***
Walturrr: shows [6d 4c] (three of a kind, Sevens)
Perstenev: shows [Ac 9c] (three of a kind, Sevens - Ace kicker)
Perstenev collected $0.57 from pot
*** SUMMARY ***
Total pot $0.60 | Rake $0.03 
Board [7d 7c 7h 3h Td]
Seat 1: BlOnDhOlIc (button) folded before Flop (didn't bet)
Seat 2: RikkStroken (small blind) folded before Flop
Seat 3: Walturrr (big blind) showed [6d 4c] and lost with three of a kind, Sevens
Seat 4: seula i folded before Flop (didn't bet)
Seat 5: chiyuki folded before Flop (didn't bet)
Seat 6: fuguangps folded before Flop (didn't bet)
Seat 7: Perstenev showed [Ac 9c] and won ($0.57) with three of a kind, Sevens
Seat 8: Wilcox76607 folded before Flop (didn't bet)
Seat 9: 4ydo yogurt folded before Flop (didn't bet)



PokerStars Zoom Hand #84299664722:  Hold'em No Limit ($0.10/$0.25) - 2012/08/05 14:34:49 JST [2012/08/05 1:34:49 ET]
Table 'Whirlpool' 9-max Seat #1 is the button
Seat 1: chiyuki ($31.17 in chips) 
Seat 2: RikkStroken ($36.48 in chips) 
Seat 3: silvno31 ($27.59 in chips) 
Seat 4: 1Karina1 ($25 in chips) 
Seat 5: laurentzu84 ($26.10 in chips) 
Seat 6: pikhtovnikov ($17.04 in chips) 
Seat 7: Perstenev ($10.72 in chips) 
Seat 8: Nerkit ($11.53 in chips) 
Seat 9: Dafleche ($20.20 in chips) 
RikkStroken: posts small blind $0.10
silvno31: posts big blind $0.25
*** HOLE CARDS ***
Dealt to chiyuki [8d 9h]
1Karina1: folds 
laurentzu84: folds 
pikhtovnikov: folds 
Perstenev: folds 
Nerkit: folds 
Dafleche: folds 
chiyuki: folds 
RikkStroken: folds 
Uncalled bet ($0.15) returned to silvno31
silvno31 collected $0.20 from pot
silvno31: doesn't show hand 
*** SUMMARY ***
Total pot $0.20 | Rake $0 
Seat 1: chiyuki (button) folded before Flop (didn't bet)
Seat 2: RikkStroken (small blind) folded before Flop
Seat 3: silvno31 (big blind) collected ($0.20)
Seat 4: 1Karina1 folded before Flop (didn't bet)
Seat 5: laurentzu84 folded before Flop (didn't bet)
Seat 6: pikhtovnikov folded before Flop (didn't bet)
Seat 7: Perstenev folded before Flop (didn't bet)
Seat 8: Nerkit folded before Flop (didn't bet)
Seat 9: Dafleche folded before Flop (didn't bet)



PokerStars Zoom Hand #84299665676:  Hold'em No Limit ($0.10/$0.25) - 2012/08/05 14:34:53 JST [2012/08/05 1:34:53 ET]
Table 'Whirlpool' 9-max Seat #1 is the button
Seat 1: Dafleche ($20.20 in chips) 
Seat 2: Walturrr ($24.28 in chips) 
Seat 3: chiyuki ($31.17 in chips) 
Seat 4: cr0lox ($23.79 in chips) 
Seat 5: BlOnDhOlIc ($84.35 in chips) 
Seat 6: laurentzu84 ($26.10 in chips) 
Seat 7: pikhtovnikov ($17.04 in chips) 
Seat 8: JLajoie ($26.33 in chips) 
Seat 9: hl77777 ($12.15 in chips) 
Walturrr: posts small blind $0.10
chiyuki: posts big blind $0.25
*** HOLE CARDS ***
Dealt to chiyuki [As 8h]
cr0lox: calls $0.25
BlOnDhOlIc: raises $0.50 to $0.75
laurentzu84: folds 
pikhtovnikov: folds 
JLajoie: folds 
hl77777: folds 
Dafleche: folds 
Walturrr: folds 
chiyuki: folds 
cr0lox: folds 
Uncalled bet ($0.50) returned to BlOnDhOlIc
BlOnDhOlIc collected $0.85 from pot
BlOnDhOlIc: doesn't show hand 
*** SUMMARY ***
Total pot $0.85 | Rake $0 
Seat 1: Dafleche (button) folded before Flop (didn't bet)
Seat 2: Walturrr (small blind) folded before Flop
Seat 3: chiyuki (big blind) folded before Flop
Seat 4: cr0lox folded before Flop
Seat 5: BlOnDhOlIc collected ($0.85)
Seat 6: laurentzu84 folded before Flop (didn't bet)
Seat 7: pikhtovnikov folded before Flop (didn't bet)
Seat 8: JLajoie folded before Flop (didn't bet)
Seat 9: hl77777 folded before Flop (didn't bet)



PokerStars Zoom Hand #84299661235:  Hold'em No Limit ($0.10/$0.25) - 2012/08/05 14:34:35 JST [2012/08/05 1:34:35 ET]
Table 'Whirlpool' 9-max Seat #1 is the button
Seat 1: BlOnDhOlIc ($84.35 in chips) 
Seat 2: deadmoneykid ($25.18 in chips) 
Seat 3: fuguangps ($30.52 in chips) 
Seat 4: seula i ($112.03 in chips) 
Seat 5: troms20 ($24.65 in chips) 
Seat 6: PillZ86 ($11.14 in chips) 
Seat 7: chiyuki ($31.17 in chips) 
Seat 8: Nerkit ($17.61 in chips) 
Seat 9: cofla tito ($11.15 in chips) 
deadmoneykid: posts small blind $0.10
fuguangps: posts big blind $0.25
*** HOLE CARDS ***
Dealt to chiyuki [Ts 3h]
seula i: folds 
troms20: folds 
PillZ86: folds 
chiyuki: folds 
Nerkit: folds 
cofla tito: calls $0.25
BlOnDhOlIc: folds 
deadmoneykid: folds 
fuguangps: checks 
*** FLOP *** [4d 8d 7s]
fuguangps: checks 
cofla tito: checks 
*** TURN *** [4d 8d 7s] [9h]
fuguangps: checks 
cofla tito: bets $0.50
fuguangps: folds 
Uncalled bet ($0.50) returned to cofla tito
cofla tito collected $0.57 from pot
cofla tito: doesn't show hand 
*** SUMMARY ***
Total pot $0.60 | Rake $0.03 
Board [4d 8d 7s 9h]
Seat 1: BlOnDhOlIc (button) folded before Flop (didn't bet)
Seat 2: deadmoneykid (small blind) folded before Flop
Seat 3: fuguangps (big blind) folded on the Turn
Seat 4: seula i folded before Flop (didn't bet)
Seat 5: troms20 folded before Flop (didn't bet)
Seat 6: PillZ86 folded before Flop (didn't bet)
Seat 7: chiyuki folded before Flop (didn't bet)
Seat 8: Nerkit folded before Flop (didn't bet)
Seat 9: cofla tito collected ($0.57)



PokerStars Zoom Hand #84299672606:  Hold'em No Limit ($0.10/$0.25) - 2012/08/05 14:35:22 JST [2012/08/05 1:35:22 ET]
Table 'Whirlpool' 9-max Seat #1 is the button
Seat 1: Yogi707 ($13.58 in chips) 
Seat 2: seula i ($28.63 in chips) 
Seat 3: Dafleche ($20.20 in chips) 
Seat 4: fuguangps ($26.17 in chips) 
Seat 5: chiyuki ($30.82 in chips) 
Seat 6: BlOnDhOlIc ($37.87 in chips) 
Seat 7: Suhoff76 ($25.45 in chips) 
Seat 8: wtu1986 ($24.75 in chips) 
Seat 9: phate-1up ($41.16 in chips) 
seula i: posts small blind $0.10
Dafleche: posts big blind $0.25
*** HOLE CARDS ***
Dealt to chiyuki [3s 5h]
fuguangps: folds 
chiyuki: folds 
BlOnDhOlIc: folds 
Suhoff76: folds 
wtu1986: folds 
phate-1up: folds 
Yogi707: folds 
seula i: raises $0.75 to $1
Dafleche: folds 
Uncalled bet ($0.75) returned to seula i
seula i collected $0.50 from pot
seula i: doesn't show hand 
*** SUMMARY ***
Total pot $0.50 | Rake $0 
Seat 1: Yogi707 (button) folded before Flop (didn't bet)
Seat 2: seula i (small blind) collected ($0.50)
Seat 3: Dafleche (big blind) folded before Flop
Seat 4: fuguangps folded before Flop (didn't bet)
Seat 5: chiyuki folded before Flop (didn't bet)
Seat 6: BlOnDhOlIc folded before Flop (didn't bet)
Seat 7: Suhoff76 folded before Flop (didn't bet)
Seat 8: wtu1986 folded before Flop (didn't bet)
Seat 9: phate-1up folded before Flop (didn't bet)



PokerStars Zoom Hand #84299671659:  Hold'em No Limit ($0.10/$0.25) - 2012/08/05 14:35:18 JST [2012/08/05 1:35:18 ET]
Table 'Whirlpool' 9-max Seat #1 is the button
Seat 1: Perstenev ($12.72 in chips) 
Seat 2: chiyuki ($30.92 in chips) 
Seat 3: ladymadon107 ($1.50 in chips) 
Seat 4: KrystalAA ($11.07 in chips) 
Seat 5: Jene4kaBest ($13.45 in chips) 
Seat 6: taksist889 ($18.74 in chips) 
Seat 7: Suhoff76 ($26.36 in chips) 
Seat 8: RikkStroken ($36.38 in chips) 
Seat 9: JLajoie ($26.23 in chips) 
chiyuki: posts small blind $0.10
ladymadon107: posts big blind $0.25
*** HOLE CARDS ***
Dealt to chiyuki [4d 3c]
KrystalAA: folds 
Jene4kaBest: folds 
taksist889: folds 
Suhoff76: folds 
RikkStroken: raises $0.50 to $0.75
JLajoie: folds 
Perstenev: folds 
chiyuki: folds 
ladymadon107: calls $0.50
*** FLOP *** [9h 9d 7c]
ladymadon107: checks 
RikkStroken: bets $1
ladymadon107: folds 
Uncalled bet ($1) returned to RikkStroken
RikkStroken collected $1.53 from pot
RikkStroken: doesn't show hand 
*** SUMMARY ***
Total pot $1.60 | Rake $0.07 
Board [9h 9d 7c]
Seat 1: Perstenev (button) folded before Flop (didn't bet)
Seat 2: chiyuki (small blind) folded before Flop
Seat 3: ladymadon107 (big blind) folded on the Flop
Seat 4: KrystalAA folded before Flop (didn't bet)
Seat 5: Jene4kaBest folded before Flop (didn't bet)
Seat 6: taksist889 folded before Flop (didn't bet)
Seat 7: Suhoff76 folded before Flop (didn't bet)
Seat 8: RikkStroken collected ($1.53)
Seat 9: JLajoie folded before Flop (didn't bet)



PokerStars Zoom Hand #84299675295:  Hold'em No Limit ($0.10/$0.25) - 2012/08/05 14:35:33 JST [2012/08/05 1:35:33 ET]
Table 'Whirlpool' 9-max Seat #1 is the button
Seat 1: taksist889 ($18.74 in chips) 
Seat 2: troms20 ($62.09 in chips) 
Seat 3: Loholov ($15.35 in chips) 
Seat 4: KeLevro0 ($8.35 in chips) 
Seat 5: Alvinpe85 ($49.61 in chips) 
Seat 6: Nerkit ($12.77 in chips) 
Seat 7: AlfredE525 ($9.40 in chips) 
Seat 8: cofla tito ($11.47 in chips) 
Seat 9: chiyuki ($30.82 in chips) 
troms20: posts small blind $0.10
Loholov: posts big blind $0.25
*** HOLE CARDS ***
Dealt to chiyuki [Qh Kd]
KeLevro0: folds 
Alvinpe85: folds 
Nerkit: folds 
AlfredE525: folds 
cofla tito: folds 
chiyuki: raises $0.50 to $0.75
taksist889: folds 
troms20: folds 
Loholov: folds 
Uncalled bet ($0.50) returned to chiyuki
chiyuki collected $0.60 from pot
chiyuki: doesn't show hand 
*** SUMMARY ***
Total pot $0.60 | Rake $0 
Seat 1: taksist889 (button) folded before Flop (didn't bet)
Seat 2: troms20 (small blind) folded before Flop
Seat 3: Loholov (big blind) folded before Flop
Seat 4: KeLevro0 folded before Flop (didn't bet)
Seat 5: Alvinpe85 folded before Flop (didn't bet)
Seat 6: Nerkit folded before Flop (didn't bet)
Seat 7: AlfredE525 folded before Flop (didn't bet)
Seat 8: cofla tito folded before Flop (didn't bet)
Seat 9: chiyuki collected ($0.60)



PokerStars Zoom Hand #84299674310:  Hold'em No Limit ($0.10/$0.25) - 2012/08/05 14:35:29 JST [2012/08/05 1:35:29 ET]
Table 'Whirlpool' 9-max Seat #1 is the button
Seat 1: phate-1up ($26.84 in chips) 
Seat 2: fuguangps ($26.17 in chips) 
Seat 3: BlOnDhOlIc ($37.87 in chips) 
Seat 4: ZhukOFFskI ($29.23 in chips) 
Seat 5: Dejacob ($35.31 in chips) 
Seat 6: chiyuki ($30.82 in chips) 
Seat 7: Ladyteazer ($25.56 in chips) 
Seat 8: Perstenev ($12.72 in chips) 
Seat 9: craden500 ($11 in chips) 
fuguangps: posts small blind $0.10
BlOnDhOlIc: posts big blind $0.25
*** HOLE CARDS ***
Dealt to chiyuki [2s 8h]
ZhukOFFskI: folds 
Dejacob: folds 
chiyuki: folds 
Ladyteazer: folds 
Perstenev: folds 
craden500: folds 
phate-1up: folds 
fuguangps: raises $0.50 to $0.75
BlOnDhOlIc: calls $0.50
*** FLOP *** [4s 4d Ah]
fuguangps: bets $1
BlOnDhOlIc: raises $1 to $2
fuguangps: folds 
Uncalled bet ($1) returned to BlOnDhOlIc
BlOnDhOlIc collected $3.34 from pot
BlOnDhOlIc: doesn't show hand 
*** SUMMARY ***
Total pot $3.50 | Rake $0.16 
Board [4s 4d Ah]
Seat 1: phate-1up (button) folded before Flop (didn't bet)
Seat 2: fuguangps (small blind) folded on the Flop
Seat 3: BlOnDhOlIc (big blind) collected ($3.34)
Seat 4: ZhukOFFskI folded before Flop (didn't bet)
Seat 5: Dejacob folded before Flop (didn't bet)
Seat 6: chiyuki folded before Flop (didn't bet)
Seat 7: Ladyteazer folded before Flop (didn't bet)
Seat 8: Perstenev folded before Flop (didn't bet)
Seat 9: craden500 folded before Flop (didn't bet)



PokerStars Zoom Hand #84299681287:  Hold'em No Limit ($0.10/$0.25) - 2012/08/05 14:35:57 JST [2012/08/05 1:35:57 ET]
Table 'Whirlpool' 9-max Seat #1 is the button
Seat 1: Yogi707 ($13.58 in chips) 
Seat 2: Loholov ($15.10 in chips) 
Seat 3: KrystalAA ($15.61 in chips) 
Seat 4: PillZ86 ($7.27 in chips) 
Seat 5: troms20 ($61.99 in chips) 
Seat 6: el pore 5 ($16.53 in chips) 
Seat 7: chiyuki ($31.17 in chips) 
Seat 8: znake77 ($7.77 in chips) 
Seat 9: Walturrr ($23.93 in chips) 
Loholov: posts small blind $0.10
KrystalAA: posts big blind $0.25
*** HOLE CARDS ***
Dealt to chiyuki [Kd Qd]
PillZ86: calls $0.25
troms20: folds 
el pore 5: raises $0.75 to $1
chiyuki: folds 
znake77: folds 
Walturrr: folds 
Yogi707: folds 
Loholov: folds 
KrystalAA: folds 
PillZ86: calls $0.75
*** FLOP *** [6s 7h Ks]
PillZ86: checks 
el pore 5: bets $2
PillZ86: folds 
Uncalled bet ($2) returned to el pore 5
el pore 5 collected $2.24 from pot
el pore 5: doesn't show hand 
*** SUMMARY ***
Total pot $2.35 | Rake $0.11 
Board [6s 7h Ks]
Seat 1: Yogi707 (button) folded before Flop (didn't bet)
Seat 2: Loholov (small blind) folded before Flop
Seat 3: KrystalAA (big blind) folded before Flop
Seat 4: PillZ86 folded on the Flop
Seat 5: troms20 folded before Flop (didn't bet)
Seat 6: el pore 5 collected ($2.24)
Seat 7: chiyuki folded before Flop (didn't bet)
Seat 8: znake77 folded before Flop (didn't bet)
Seat 9: Walturrr folded before Flop (didn't bet)



PokerStars Zoom Hand #84299684952:  Hold'em No Limit ($0.10/$0.25) - 2012/08/05 14:36:12 JST [2012/08/05 1:36:12 ET]
Table 'Whirlpool' 9-max Seat #1 is the button
Seat 1: BlOnDhOlIc ($31.76 in chips) 
Seat 2: jacquelinewu ($25 in chips) 
Seat 3: seula i ($118.66 in chips) 
Seat 4: loca-loca888 ($47.31 in chips) 
Seat 5: 4ydo yogurt ($5.44 in chips) 
Seat 6: Dafleche ($19.60 in chips) 
Seat 7: caro196661cv ($40.95 in chips) 
Seat 8: chiyuki ($31.17 in chips) 
Seat 9: Nerkit ($17.50 in chips) 
jacquelinewu: posts small blind $0.10
seula i: posts big blind $0.25
*** HOLE CARDS ***
Dealt to chiyuki [Ac Qs]
loca-loca888: folds 
4ydo yogurt: raises $0.50 to $0.75
Dafleche: folds 
caro196661cv: folds 
chiyuki: raises $1.50 to $2.25
Nerkit: folds 
BlOnDhOlIc: folds 
jacquelinewu: folds 
seula i: folds 
4ydo yogurt: calls $1.50
*** FLOP *** [2d 6c 7c]
4ydo yogurt: bets $3.19 and is all-in
chiyuki: calls $3.19
*** TURN *** [2d 6c 7c] [Td]
*** RIVER *** [2d 6c 7c Td] [4d]
*** SHOW DOWN ***
4ydo yogurt: shows [8h 8s] (a pair of Eights)
chiyuki: mucks hand 
4ydo yogurt collected $10.72 from pot
*** SUMMARY ***
Total pot $11.23 | Rake $0.51 
Board [2d 6c 7c Td 4d]
Seat 1: BlOnDhOlIc (button) folded before Flop (didn't bet)
Seat 2: jacquelinewu (small blind) folded before Flop
Seat 3: seula i (big blind) folded before Flop
Seat 4: loca-loca888 folded before Flop (didn't bet)
Seat 5: 4ydo yogurt showed [8h 8s] and won ($10.72) with a pair of Eights
Seat 6: Dafleche folded before Flop (didn't bet)
Seat 7: caro196661cv folded before Flop (didn't bet)
Seat 8: chiyuki mucked [Ac Qs]
Seat 9: Nerkit folded before Flop (didn't bet)



PokerStars Zoom Hand #84299703224:  Hold'em No Limit ($0.10/$0.25) - 2012/08/05 14:37:28 JST [2012/08/05 1:37:28 ET]
Table 'Whirlpool' 9-max Seat #1 is the button
Seat 1: Landybob ($40.21 in chips) 
Seat 2: Suhoff76 ($26.86 in chips) 
Seat 3: chiyuki ($25.73 in chips) 
Seat 4: silvno31 ($28.34 in chips) 
Seat 5: seula i ($33.71 in chips) 
Seat 6: Alvinpe85 ($50.99 in chips) 
Seat 7: WARIBANA7777 ($15.61 in chips) 
Seat 8: stalkerec ($6.99 in chips) 
Seat 9: znake77 ($6.05 in chips) 
Suhoff76: posts small blind $0.10
chiyuki: posts big blind $0.25
*** HOLE CARDS ***
Dealt to chiyuki [4h Ts]
silvno31: raises $0.50 to $0.75
seula i: folds 
Alvinpe85: folds 
WARIBANA7777: folds 
stalkerec: calls $0.75
znake77: folds 
Landybob: folds 
Suhoff76: folds 
chiyuki: folds 
*** FLOP *** [5c Qh 3d]
silvno31: bets $2
stalkerec: folds 
Uncalled bet ($2) returned to silvno31
silvno31 collected $1.77 from pot
silvno31: doesn't show hand 
*** SUMMARY ***
Total pot $1.85 | Rake $0.08 
Board [5c Qh 3d]
Seat 1: Landybob (button) folded before Flop (didn't bet)
Seat 2: Suhoff76 (small blind) folded before Flop
Seat 3: chiyuki (big blind) folded before Flop
Seat 4: silvno31 collected ($1.77)
Seat 5: seula i folded before Flop (didn't bet)
Seat 6: Alvinpe85 folded before Flop (didn't bet)
Seat 7: WARIBANA7777 folded before Flop (didn't bet)
Seat 8: stalkerec folded on the Flop
Seat 9: znake77 folded before Flop (didn't bet)



PokerStars Zoom Hand #84299709925:  Hold'em No Limit ($0.10/$0.25) - 2012/08/05 14:37:55 JST [2012/08/05 1:37:55 ET]
Table 'Whirlpool' 9-max Seat #1 is the button
Seat 1: KeLevro0 ($9.51 in chips) 
Seat 2: cr0lox ($24.40 in chips) 
Seat 3: Paranoix1990 ($12.96 in chips) 
Seat 4: chiyuki ($25.48 in chips) 
Seat 5: Suhoff76 ($25.14 in chips) 
Seat 6: Loholov ($15 in chips) 
Seat 7: Landybob ($40.21 in chips) 
Seat 8: GovGus ($25 in chips) 
Seat 9: 1Karina1 ($25 in chips) 
cr0lox: posts small blind $0.10
Paranoix1990: posts big blind $0.25
*** HOLE CARDS ***
Dealt to chiyuki [Ts Td]
chiyuki: raises $0.50 to $0.75
Suhoff76: folds 
Loholov: folds 
Landybob: folds 
GovGus: folds 
1Karina1: folds 
KeLevro0: folds 
cr0lox: folds 
Paranoix1990: folds 
Uncalled bet ($0.50) returned to chiyuki
chiyuki collected $0.60 from pot
chiyuki: doesn't show hand 
*** SUMMARY ***
Total pot $0.60 | Rake $0 
Seat 1: KeLevro0 (button) folded before Flop (didn't bet)
Seat 2: cr0lox (small blind) folded before Flop
Seat 3: Paranoix1990 (big blind) folded before Flop
Seat 4: chiyuki collected ($0.60)
Seat 5: Suhoff76 folded before Flop (didn't bet)
Seat 6: Loholov folded before Flop (didn't bet)
Seat 7: Landybob folded before Flop (didn't bet)
Seat 8: GovGus folded before Flop (didn't bet)
Seat 9: 1Karina1 folded before Flop (didn't bet)



PokerStars Zoom Hand #84299714142:  Hold'em No Limit ($0.10/$0.25) - 2012/08/05 14:38:12 JST [2012/08/05 1:38:12 ET]
Table 'Whirlpool' 9-max Seat #1 is the button
Seat 1: Gichboy ($9.90 in chips) 
Seat 2: Loholov ($15 in chips) 
Seat 3: BlOnDhOlIc ($79.16 in chips) 
Seat 4: DanielWhyte ($50.17 in chips) 
Seat 5: Perstenev ($17.21 in chips) 
Seat 6: chiyuki ($25.83 in chips) 
Seat 7: ZhukOFFskI ($22.93 in chips) 
Seat 8: led52 ($12.15 in chips) 
Seat 9: KrystalAA ($15.01 in chips) 
Loholov: posts small blind $0.10
BlOnDhOlIc: posts big blind $0.25
*** HOLE CARDS ***
Dealt to chiyuki [Kh 5d]
DanielWhyte: folds 
Perstenev: folds 
chiyuki: folds 
ZhukOFFskI: folds 
led52: folds 
KrystalAA: folds 
Gichboy: raises $0.25 to $0.50
Loholov: calls $0.40
BlOnDhOlIc: folds 
*** FLOP *** [2h 5c Ts]
Loholov: checks 
Gichboy: bets $0.75
Loholov: raises $1.25 to $2
Gichboy: folds 
Uncalled bet ($1.25) returned to Loholov
Loholov collected $2.63 from pot
Loholov: doesn't show hand 
*** SUMMARY ***
Total pot $2.75 | Rake $0.12 
Board [2h 5c Ts]
Seat 1: Gichboy (button) folded on the Flop
Seat 2: Loholov (small blind) collected ($2.63)
Seat 3: BlOnDhOlIc (big blind) folded before Flop
Seat 4: DanielWhyte folded before Flop (didn't bet)
Seat 5: Perstenev folded before Flop (didn't bet)
Seat 6: chiyuki folded before Flop (didn't bet)
Seat 7: ZhukOFFskI folded before Flop (didn't bet)
Seat 8: led52 folded before Flop (didn't bet)
Seat 9: KrystalAA folded before Flop (didn't bet)



PokerStars Zoom Hand #84299721189:  Hold'em No Limit ($0.10/$0.25) - 2012/08/05 14:38:41 JST [2012/08/05 1:38:41 ET]
Table 'Whirlpool' 9-max Seat #1 is the button
Seat 1: Vahe50 ($12.58 in chips) 
Seat 2: Suhoff76 ($25 in chips) 
Seat 3: Nerkit ($12.50 in chips) 
Seat 4: KimPa39 ($24.65 in chips) 
Seat 5: chiyuki ($25.83 in chips) 
Seat 6: Loholov ($15.25 in chips) 
Seat 7: jacquelinewu ($25 in chips) 
Seat 8: loca-loca888 ($49.21 in chips) 
Seat 9: phate-1up ($56.69 in chips) 
Suhoff76: posts small blind $0.10
Nerkit: posts big blind $0.25
*** HOLE CARDS ***
Dealt to chiyuki [Qd 3s]
KimPa39: folds 
chiyuki: folds 
Loholov: folds 
jacquelinewu: raises $0.50 to $0.75
loca-loca888: folds 
phate-1up: folds 
Vahe50: folds 
Suhoff76: folds 
Nerkit: folds 
Uncalled bet ($0.50) returned to jacquelinewu
jacquelinewu collected $0.60 from pot
jacquelinewu: doesn't show hand 
*** SUMMARY ***
Total pot $0.60 | Rake $0 
Seat 1: Vahe50 (button) folded before Flop (didn't bet)
Seat 2: Suhoff76 (small blind) folded before Flop
Seat 3: Nerkit (big blind) folded before Flop
Seat 4: KimPa39 folded before Flop (didn't bet)
Seat 5: chiyuki folded before Flop (didn't bet)
Seat 6: Loholov folded before Flop (didn't bet)
Seat 7: jacquelinewu collected ($0.60)
Seat 8: loca-loca888 folded before Flop (didn't bet)
Seat 9: phate-1up folded before Flop (didn't bet)



PokerStars Zoom Hand #84299717275:  Hold'em No Limit ($0.10/$0.25) - 2012/08/05 14:38:25 JST [2012/08/05 1:38:25 ET]
Table 'Whirlpool' 9-max Seat #1 is the button
Seat 1: KrystalAA ($15.01 in chips) 
Seat 2: 1Karina1 ($25 in chips) 
Seat 3: hl77777 ($16.95 in chips) 
Seat 4: stalkerec ($6.24 in chips) 
Seat 5: Perstenev ($12.15 in chips) 
Seat 6: cr0lox ($24.30 in chips) 
Seat 7: Alvinpe85 ($64.24 in chips) 
Seat 8: igor*gemert ($23.62 in chips) 
Seat 9: chiyuki ($25.83 in chips) 
1Karina1: posts small blind $0.10
hl77777: posts big blind $0.25
*** HOLE CARDS ***
Dealt to chiyuki [3s 7h]
stalkerec: raises $0.75 to $1
Perstenev: folds 
cr0lox: folds 
Alvinpe85: folds 
igor*gemert: folds 
chiyuki: folds 
KrystalAA: raises $1.80 to $2.80
1Karina1: folds 
hl77777: folds 
stalkerec: calls $1.80
*** FLOP *** [6c 5s 9s]
stalkerec: checks 
KrystalAA: bets $12.21 and is all-in
stalkerec: folds 
Uncalled bet ($12.21) returned to KrystalAA
KrystalAA collected $5.68 from pot
KrystalAA: doesn't show hand 
*** SUMMARY ***
Total pot $5.95 | Rake $0.27 
Board [6c 5s 9s]
Seat 1: KrystalAA (button) collected ($5.68)
Seat 2: 1Karina1 (small blind) folded before Flop
Seat 3: hl77777 (big blind) folded before Flop
Seat 4: stalkerec folded on the Flop
Seat 5: Perstenev folded before Flop (didn't bet)
Seat 6: cr0lox folded before Flop (didn't bet)
Seat 7: Alvinpe85 folded before Flop (didn't bet)
Seat 8: igor*gemert folded before Flop (didn't bet)
Seat 9: chiyuki folded before Flop (didn't bet)



PokerStars Zoom Hand #84299726674:  Hold'em No Limit ($0.10/$0.25) - 2012/08/05 14:39:04 JST [2012/08/05 1:39:04 ET]
Table 'Whirlpool' 9-max Seat #1 is the button
Seat 1: chiyuki ($25.73 in chips) 
Seat 2: Alvinpe85 ($64.24 in chips) 
Seat 3: led52 ($12.15 in chips) 
Seat 4: 4thepeople ($27.94 in chips) 
Seat 5: 4plankton ($27.38 in chips) 
Seat 6: Jene4kaBest ($11.90 in chips) 
Seat 7: Loholov ($16.38 in chips) 
Seat 8: KrystalAA ($12.40 in chips) 
Seat 9: mariuka1 ($6.22 in chips) 
Alvinpe85: posts small blind $0.10
led52: posts big blind $0.25
*** HOLE CARDS ***
Dealt to chiyuki [Ac 3d]
4thepeople: calls $0.25
4plankton: folds 
Jene4kaBest: folds 
Loholov: folds 
KrystalAA: folds 
mariuka1: folds 
chiyuki: folds 
Alvinpe85: folds 
led52: checks 
*** FLOP *** [Kc 7c 3h]
led52: checks 
4thepeople: bets $0.25
led52: folds 
Uncalled bet ($0.25) returned to 4thepeople
4thepeople collected $0.57 from pot
4thepeople: doesn't show hand 
*** SUMMARY ***
Total pot $0.60 | Rake $0.03 
Board [Kc 7c 3h]
Seat 1: chiyuki (button) folded before Flop (didn't bet)
Seat 2: Alvinpe85 (small blind) folded before Flop
Seat 3: led52 (big blind) folded on the Flop
Seat 4: 4thepeople collected ($0.57)
Seat 5: 4plankton folded before Flop (didn't bet)
Seat 6: Jene4kaBest folded before Flop (didn't bet)
Seat 7: Loholov folded before Flop (didn't bet)
Seat 8: KrystalAA folded before Flop (didn't bet)
Seat 9: mariuka1 folded before Flop (didn't bet)



PokerStars Zoom Hand #84299722995:  Hold'em No Limit ($0.10/$0.25) - 2012/08/05 14:38:49 JST [2012/08/05 1:38:49 ET]
Table 'Whirlpool' 9-max Seat #1 is the button
Seat 1: Suhoff76 ($25 in chips) 
Seat 2: chiyuki ($25.83 in chips) 
Seat 3: cr0lox ($24.30 in chips) 
Seat 4: hl77777 ($11.80 in chips) 
Seat 5: 4plankton ($27.38 in chips) 
Seat 6: KAKamiro ($22.21 in chips) 
Seat 7: Perstenev ($12.86 in chips) 
Seat 8: bigred1102 ($23.41 in chips) 
Seat 9: simonzez ($55.96 in chips) 
chiyuki: posts small blind $0.10
cr0lox: posts big blind $0.25
*** HOLE CARDS ***
Dealt to chiyuki [4s Kh]
hl77777: folds 
4plankton: folds 
KAKamiro: folds 
Perstenev: folds 
bigred1102: calls $0.25
simonzez: folds 
Suhoff76: folds 
chiyuki: folds 
cr0lox: checks 
*** FLOP *** [9h Ah 6s]
cr0lox: checks 
bigred1102: bets $0.50
cr0lox: calls $0.50
*** TURN *** [9h Ah 6s] [Qs]
cr0lox: checks 
bigred1102: bets $0.50
cr0lox: calls $0.50
*** RIVER *** [9h Ah 6s Qs] [Kd]
cr0lox: checks 
bigred1102: checks 
*** SHOW DOWN ***
cr0lox: shows [8s 7c] (high card Ace)
bigred1102: shows [5d 9d] (a pair of Nines)
bigred1102 collected $2.48 from pot
*** SUMMARY ***
Total pot $2.60 | Rake $0.12 
Board [9h Ah 6s Qs Kd]
Seat 1: Suhoff76 (button) folded before Flop (didn't bet)
Seat 2: chiyuki (small blind) folded before Flop
Seat 3: cr0lox (big blind) showed [8s 7c] and lost with high card Ace
Seat 4: hl77777 folded before Flop (didn't bet)
Seat 5: 4plankton folded before Flop (didn't bet)
Seat 6: KAKamiro folded before Flop (didn't bet)
Seat 7: Perstenev folded before Flop (didn't bet)
Seat 8: bigred1102 showed [5d 9d] and won ($2.48) with a pair of Nines
Seat 9: simonzez folded before Flop (didn't bet)



PokerStars Zoom Hand #84299716088:  Hold'em No Limit ($0.10/$0.25) - 2012/08/05 14:38:20 JST [2012/08/05 1:38:20 ET]
Table 'Whirlpool' 9-max Seat #1 is the button
Seat 1: chiyuki ($25.83 in chips) 
Seat 2: sparky5224 ($39.09 in chips) 
Seat 3: Suhoff76 ($26.76 in chips) 
Seat 4: BlOnDhOlIc ($33.83 in chips) 
Seat 5: GovGus ($25 in chips) 
Seat 6: Perstenev ($12.15 in chips) 
Seat 7: Loholov ($15.25 in chips) 
Seat 8: snejokCoxx ($12.25 in chips) 
Seat 9: dushvan ($44.54 in chips) 
sparky5224: posts small blind $0.10
Suhoff76: posts big blind $0.25
*** HOLE CARDS ***
Dealt to chiyuki [2h 4d]
BlOnDhOlIc: raises $0.25 to $0.50
GovGus: folds 
Perstenev: folds 
Loholov: folds 
snejokCoxx: folds 
dushvan: calls $0.50
chiyuki: folds 
sparky5224: calls $0.40
Suhoff76: folds 
*** FLOP *** [6s 7h Kc]
sparky5224: checks 
BlOnDhOlIc: bets $0.83
dushvan: folds 
sparky5224: calls $0.83
*** TURN *** [6s 7h Kc] [Ks]
sparky5224: checks 
BlOnDhOlIc: bets $2.25
sparky5224: calls $2.25
*** RIVER *** [6s 7h Kc Ks] [Js]
sparky5224: checks 
BlOnDhOlIc: checks 
*** SHOW DOWN ***
sparky5224: shows [8d 9d] (a pair of Kings)
BlOnDhOlIc: shows [Ac 8c] (a pair of Kings - Ace kicker)
BlOnDhOlIc collected $7.55 from pot
*** SUMMARY ***
Total pot $7.91 | Rake $0.36 
Board [6s 7h Kc Ks Js]
Seat 1: chiyuki (button) folded before Flop (didn't bet)
Seat 2: sparky5224 (small blind) showed [8d 9d] and lost with a pair of Kings
Seat 3: Suhoff76 (big blind) folded before Flop
Seat 4: BlOnDhOlIc showed [Ac 8c] and won ($7.55) with a pair of Kings
Seat 5: GovGus folded before Flop (didn't bet)
Seat 6: Perstenev folded before Flop (didn't bet)
Seat 7: Loholov folded before Flop (didn't bet)
Seat 8: snejokCoxx folded before Flop (didn't bet)
Seat 9: dushvan folded on the Flop



PokerStars Zoom Hand #84299729353:  Hold'em No Limit ($0.10/$0.25) - 2012/08/05 14:39:15 JST [2012/08/05 1:39:15 ET]
Table 'Whirlpool' 9-max Seat #1 is the button
Seat 1: deadmoneykid ($24.30 in chips) 
Seat 2: KeLevro0 ($7.30 in chips) 
Seat 3: stalkerec ($3.44 in chips) 
Seat 4: chiyuki ($25.73 in chips) 
Seat 5: WARIBANA7777 ($24.22 in chips) 
Seat 6: Loholov ($16.38 in chips) 
Seat 7: KrystalAA ($12.40 in chips) 
Seat 8: mariuka1 ($6.22 in chips) 
Seat 9: softdesign ($78.69 in chips) 
KeLevro0: posts small blind $0.10
stalkerec: posts big blind $0.25
*** HOLE CARDS ***
Dealt to chiyuki [5c 9d]
chiyuki: folds 
WARIBANA7777: folds 
Loholov: folds 
KrystalAA: folds 
mariuka1: folds 
softdesign: raises $0.50 to $0.75
deadmoneykid: folds 
KeLevro0: folds 
stalkerec: folds 
Uncalled bet ($0.50) returned to softdesign
softdesign collected $0.60 from pot
softdesign: doesn't show hand 
*** SUMMARY ***
Total pot $0.60 | Rake $0 
Seat 1: deadmoneykid (button) folded before Flop (didn't bet)
Seat 2: KeLevro0 (small blind) folded before Flop
Seat 3: stalkerec (big blind) folded before Flop
Seat 4: chiyuki folded before Flop (didn't bet)
Seat 5: WARIBANA7777 folded before Flop (didn't bet)
Seat 6: Loholov folded before Flop (didn't bet)
Seat 7: KrystalAA folded before Flop (didn't bet)
Seat 8: mariuka1 folded before Flop (didn't bet)
Seat 9: softdesign collected ($0.60)



PokerStars Zoom Hand #84299728336:  Hold'em No Limit ($0.10/$0.25) - 2012/08/05 14:39:11 JST [2012/08/05 1:39:11 ET]
Table 'Whirlpool' 9-max Seat #1 is the button
Seat 1: hl77777 ($17.70 in chips) 
Seat 2: troms20 ($63.21 in chips) 
Seat 3: GovGus ($35.66 in chips) 
Seat 4: DanielWhyte ($49.12 in chips) 
Seat 5: el pore 5 ($29.42 in chips) 
Seat 6: mariuka1 ($6.22 in chips) 
Seat 7: chiyuki ($25.73 in chips) 
Seat 8: BlOnDhOlIc ($39.76 in chips) 
Seat 9: cofla tito ($10.12 in chips) 
troms20: posts small blind $0.10
GovGus: posts big blind $0.25
*** HOLE CARDS ***
Dealt to chiyuki [4s 7d]
DanielWhyte: folds 
el pore 5: raises $0.50 to $0.75
mariuka1: folds 
chiyuki: folds 
BlOnDhOlIc: folds 
cofla tito: folds 
hl77777: folds 
troms20: folds 
GovGus: calls $0.50
*** FLOP *** [2s As 6d]
GovGus: checks 
el pore 5: bets $0.75
GovGus: folds 
Uncalled bet ($0.75) returned to el pore 5
el pore 5 collected $1.53 from pot
el pore 5: doesn't show hand 
*** SUMMARY ***
Total pot $1.60 | Rake $0.07 
Board [2s As 6d]
Seat 1: hl77777 (button) folded before Flop (didn't bet)
Seat 2: troms20 (small blind) folded before Flop
Seat 3: GovGus (big blind) folded on the Flop
Seat 4: DanielWhyte folded before Flop (didn't bet)
Seat 5: el pore 5 collected ($1.53)
Seat 6: mariuka1 folded before Flop (didn't bet)
Seat 7: chiyuki folded before Flop (didn't bet)
Seat 8: BlOnDhOlIc folded before Flop (didn't bet)
Seat 9: cofla tito folded before Flop (didn't bet)



PokerStars Zoom Hand #84299730080:  Hold'em No Limit ($0.10/$0.25) - 2012/08/05 14:39:18 JST [2012/08/05 1:39:18 ET]
Table 'Whirlpool' 9-max Seat #1 is the button
Seat 1: Dejacob ($37.45 in chips) 
Seat 2: KrystalAA ($17.89 in chips) 
Seat 3: chiyuki ($25.73 in chips) 
Seat 4: Loholov ($15 in chips) 
Seat 5: jacquelinewu ($25.79 in chips) 
Seat 6: snejokCoxx ($12.15 in chips) 
Seat 7: troms20 ($31.04 in chips) 
Seat 8: ZhukOFFskI ($34.09 in chips) 
Seat 9: Nerkit ($10.67 in chips) 
KrystalAA: posts small blind $0.10
chiyuki: posts big blind $0.25
*** HOLE CARDS ***
Dealt to chiyuki [9h 8s]
Loholov: raises $0.50 to $0.75
jacquelinewu: folds 
snejokCoxx: folds 
troms20: folds 
ZhukOFFskI: folds 
Nerkit: folds 
Dejacob: calls $0.75
KrystalAA: raises $1.92 to $2.67
chiyuki: folds 
Loholov: calls $1.92
Dejacob: folds 
*** FLOP *** [Td 7s Jh]
KrystalAA: bets $15.22 and is all-in
Loholov: calls $12.33 and is all-in
Uncalled bet ($2.89) returned to KrystalAA
*** TURN *** [Td 7s Jh] [9d]
*** RIVER *** [Td 7s Jh 9d] [Jc]
*** SHOW DOWN ***
KrystalAA: shows [Qc Qd] (two pair, Queens and Jacks)
Loholov: shows [Qs Js] (three of a kind, Jacks)
Loholov collected $29.60 from pot
*** SUMMARY ***
Total pot $31 | Rake $1.40 
Board [Td 7s Jh 9d Jc]
Seat 1: Dejacob (button) folded before Flop
Seat 2: KrystalAA (small blind) showed [Qc Qd] and lost with two pair, Queens and Jacks
Seat 3: chiyuki (big blind) folded before Flop
Seat 4: Loholov showed [Qs Js] and won ($29.60) with three of a kind, Jacks
Seat 5: jacquelinewu folded before Flop (didn't bet)
Seat 6: snejokCoxx folded before Flop (didn't bet)
Seat 7: troms20 folded before Flop (didn't bet)
Seat 8: ZhukOFFskI folded before Flop (didn't bet)
Seat 9: Nerkit folded before Flop (didn't bet)



PokerStars Zoom Hand #84299720221:  Hold'em No Limit ($0.10/$0.25) - 2012/08/05 14:38:37 JST [2012/08/05 1:38:37 ET]
Table 'Whirlpool' 9-max Seat #1 is the button
Seat 1: led52 ($12.15 in chips) 
Seat 2: snejokCoxx ($12.25 in chips) 
Seat 3: GovGus ($34.71 in chips) 
Seat 4: chiyuki ($25.83 in chips) 
Seat 5: phate-1up ($27.19 in chips) 
Seat 6: 1Karina1 ($25 in chips) 
Seat 7: cr0lox ($24.30 in chips) 
Seat 8: Walturrr ($25.69 in chips) 
Seat 9: roksmokndonk ($23.79 in chips) 
snejokCoxx: posts small blind $0.10
GovGus: posts big blind $0.25
*** HOLE CARDS ***
Dealt to chiyuki [As 2s]
chiyuki: folds 
phate-1up: folds 
1Karina1: raises $0.50 to $0.75
cr0lox: folds 
Walturrr: folds 
roksmokndonk: folds 
led52: folds 
snejokCoxx: folds 
GovGus: calls $0.50
*** FLOP *** [Td Qd 4h]
GovGus: checks 
1Karina1: bets $1
GovGus: calls $1
*** TURN *** [Td Qd 4h] [Qs]
GovGus: checks 
1Karina1: bets $2.50
GovGus: calls $2.50
*** RIVER *** [Td Qd 4h Qs] [5d]
GovGus: bets $4.75
1Karina1: folds 
Uncalled bet ($4.75) returned to GovGus
GovGus collected $8.21 from pot
GovGus: doesn't show hand 
*** SUMMARY ***
Total pot $8.60 | Rake $0.39 
Board [Td Qd 4h Qs 5d]
Seat 1: led52 (button) folded before Flop (didn't bet)
Seat 2: snejokCoxx (small blind) folded before Flop
Seat 3: GovGus (big blind) collected ($8.21)
Seat 4: chiyuki folded before Flop (didn't bet)
Seat 5: phate-1up folded before Flop (didn't bet)
Seat 6: 1Karina1 folded on the River
Seat 7: cr0lox folded before Flop (didn't bet)
Seat 8: Walturrr folded before Flop (didn't bet)
Seat 9: roksmokndonk folded before Flop (didn't bet)



PokerStars Zoom Hand #84299736048:  Hold'em No Limit ($0.10/$0.25) - 2012/08/05 14:39:42 JST [2012/08/05 1:39:42 ET]
Table 'Whirlpool' 9-max Seat #1 is the button
Seat 1: JokerJudge ($24.65 in chips) 
Seat 2: troms20 ($46.60 in chips) 
Seat 3: ll_LaMeR_ll ($78.16 in chips) 
Seat 4: WARIBANA7777 ($24.32 in chips) 
Seat 5: Walturrr ($28.26 in chips) 
Seat 6: snejokCoxx ($18.35 in chips) 
Seat 7: Nerkit ($12.15 in chips) 
Seat 8: chiyuki ($25.48 in chips) 
Seat 9: Landybob ($40.21 in chips) 
troms20: posts small blind $0.10
ll_LaMeR_ll: posts big blind $0.25
*** HOLE CARDS ***
Dealt to chiyuki [8d Ac]
WARIBANA7777: folds 
Walturrr: folds 
snejokCoxx: folds 
Nerkit: folds 
chiyuki: raises $0.50 to $0.75
Landybob: folds 
JokerJudge: raises $1.25 to $2
troms20: folds 
ll_LaMeR_ll: folds 
chiyuki: folds 
Uncalled bet ($1.25) returned to JokerJudge
JokerJudge collected $1.85 from pot
JokerJudge: doesn't show hand 
*** SUMMARY ***
Total pot $1.85 | Rake $0 
Seat 1: JokerJudge (button) collected ($1.85)
Seat 2: troms20 (small blind) folded before Flop
Seat 3: ll_LaMeR_ll (big blind) folded before Flop
Seat 4: WARIBANA7777 folded before Flop (didn't bet)
Seat 5: Walturrr folded before Flop (didn't bet)
Seat 6: snejokCoxx folded before Flop (didn't bet)
Seat 7: Nerkit folded before Flop (didn't bet)
Seat 8: chiyuki folded before Flop
Seat 9: Landybob folded before Flop (didn't bet)



PokerStars Zoom Hand #84299734516:  Hold'em No Limit ($0.10/$0.25) - 2012/08/05 14:39:36 JST [2012/08/05 1:39:36 ET]
Table 'Whirlpool' 9-max Seat #1 is the button
Seat 1: Ellen1947 ($24.90 in chips) 
Seat 2: BlOnDhOlIc ($37.80 in chips) 
Seat 3: Loholov ($16.69 in chips) 
Seat 4: Nerkit ($10.67 in chips) 
Seat 5: Walturrr ($25.94 in chips) 
Seat 6: Landybob ($40.21 in chips) 
Seat 7: KeLevro0 ($8.91 in chips) 
Seat 8: chiyuki ($25.48 in chips) 
Seat 9: phate-1up ($35.26 in chips) 
BlOnDhOlIc: posts small blind $0.10
Loholov: posts big blind $0.25
*** HOLE CARDS ***
Dealt to chiyuki [4c 3c]
Nerkit: folds 
Walturrr: folds 
Landybob: folds 
KeLevro0: folds 
chiyuki: folds 
phate-1up: raises $0.50 to $0.75
Ellen1947: raises $1.65 to $2.40
BlOnDhOlIc: folds 
Loholov: folds 
phate-1up: folds 
Uncalled bet ($1.65) returned to Ellen1947
Ellen1947 collected $1.85 from pot
Ellen1947: doesn't show hand 
*** SUMMARY ***
Total pot $1.85 | Rake $0 
Seat 1: Ellen1947 (button) collected ($1.85)
Seat 2: BlOnDhOlIc (small blind) folded before Flop
Seat 3: Loholov (big blind) folded before Flop
Seat 4: Nerkit folded before Flop (didn't bet)
Seat 5: Walturrr folded before Flop (didn't bet)
Seat 6: Landybob folded before Flop (didn't bet)
Seat 7: KeLevro0 folded before Flop (didn't bet)
Seat 8: chiyuki folded before Flop (didn't bet)
Seat 9: phate-1up folded before Flop



PokerStars Zoom Hand #84299733523:  Hold'em No Limit ($0.10/$0.25) - 2012/08/05 14:39:32 JST [2012/08/05 1:39:32 ET]
Table 'Whirlpool' 9-max Seat #1 is the button
Seat 1: KeLevro0 ($8.91 in chips) 
Seat 2: phate-1up ($35.36 in chips) 
Seat 3: igor*gemert ($23.52 in chips) 
Seat 4: Walturrr ($25.94 in chips) 
Seat 5: wildy29 ($14.83 in chips) 
Seat 6: simonzez ($55.21 in chips) 
Seat 7: Nerkit ($10.67 in chips) 
Seat 8: sparky5224 ($35.51 in chips) 
Seat 9: chiyuki ($25.48 in chips) 
phate-1up: posts small blind $0.10
igor*gemert: posts big blind $0.25
*** HOLE CARDS ***
Dealt to chiyuki [8d Qh]
Walturrr: folds 
wildy29: raises $0.25 to $0.50
simonzez: folds 
Nerkit: folds 
sparky5224: calls $0.50
chiyuki: folds 
KeLevro0: folds 
phate-1up: folds 
igor*gemert: calls $0.25
*** FLOP *** [7c 8h 3h]
igor*gemert: checks 
wildy29: bets $0.50
sparky5224: folds 
igor*gemert: folds 
Uncalled bet ($0.50) returned to wildy29
wildy29 collected $1.53 from pot
wildy29: doesn't show hand 
*** SUMMARY ***
Total pot $1.60 | Rake $0.07 
Board [7c 8h 3h]
Seat 1: KeLevro0 (button) folded before Flop (didn't bet)
Seat 2: phate-1up (small blind) folded before Flop
Seat 3: igor*gemert (big blind) folded on the Flop
Seat 4: Walturrr folded before Flop (didn't bet)
Seat 5: wildy29 collected ($1.53)
Seat 6: simonzez folded before Flop (didn't bet)
Seat 7: Nerkit folded before Flop (didn't bet)
Seat 8: sparky5224 folded on the Flop
Seat 9: chiyuki folded before Flop (didn't bet)



PokerStars Zoom Hand #84299740196:  Hold'em No Limit ($0.10/$0.25) - 2012/08/05 14:40:00 JST [2012/08/05 1:40:00 ET]
Table 'Whirlpool' 9-max Seat #1 is the button
Seat 1: Perstenev ($10.80 in chips) 
Seat 2: chiyuki ($24.73 in chips) 
Seat 3: Loholov ($16.38 in chips) 
Seat 4: silvno31 ($31.07 in chips) 
Seat 5: BlOnDhOlIc ($82.39 in chips) 
Seat 6: stalkerec ($3.85 in chips) 
Seat 7: phate-1up ($34.51 in chips) 
Seat 8: ChrisCDee ($74.07 in chips) 
Seat 9: cofla tito ($15.97 in chips) 
chiyuki: posts small blind $0.10
Loholov: posts big blind $0.25
*** HOLE CARDS ***
Dealt to chiyuki [8s Jd]
silvno31: folds 
BlOnDhOlIc: raises $0.25 to $0.50
stalkerec: folds 
phate-1up: folds 
ChrisCDee: folds 
cofla tito: folds 
Perstenev: folds 
chiyuki: folds 
Loholov: folds 
Uncalled bet ($0.25) returned to BlOnDhOlIc
BlOnDhOlIc collected $0.60 from pot
BlOnDhOlIc: doesn't show hand 
*** SUMMARY ***
Total pot $0.60 | Rake $0 
Seat 1: Perstenev (button) folded before Flop (didn't bet)
Seat 2: chiyuki (small blind) folded before Flop
Seat 3: Loholov (big blind) folded before Flop
Seat 4: silvno31 folded before Flop (didn't bet)
Seat 5: BlOnDhOlIc collected ($0.60)
Seat 6: stalkerec folded before Flop (didn't bet)
Seat 7: phate-1up folded before Flop (didn't bet)
Seat 8: ChrisCDee folded before Flop (didn't bet)
Seat 9: cofla tito folded before Flop (didn't bet)



PokerStars Zoom Hand #84299742861:  Hold'em No Limit ($0.10/$0.25) - 2012/08/05 14:40:11 JST [2012/08/05 1:40:11 ET]
Table 'Whirlpool' 9-max Seat #1 is the button
Seat 1: silvno31 ($31.07 in chips) 
Seat 2: azizmimi ($10.27 in chips) 
Seat 3: Phaedrus...3 ($25 in chips) 
Seat 4: 1Karina1 ($27.38 in chips) 
Seat 5: fuguangps ($26.58 in chips) 
Seat 6: hl77777 ($12.02 in chips) 
Seat 7: chiyuki ($24.63 in chips) 
Seat 8: Cyanidoff ($25 in chips) 
Seat 9: Lars111 ($14.65 in chips) 
azizmimi: posts small blind $0.10
Phaedrus...3: posts big blind $0.25
*** HOLE CARDS ***
Dealt to chiyuki [9c 6c]
1Karina1: calls $0.25
fuguangps: folds 
hl77777: folds 
chiyuki: folds 
Cyanidoff: folds 
Lars111: folds 
silvno31: folds 
azizmimi: raises $0.50 to $0.75
Phaedrus...3: folds 
1Karina1: raises $1.75 to $2.50
azizmimi: folds 
Uncalled bet ($1.75) returned to 1Karina1
1Karina1 collected $1.75 from pot
1Karina1: doesn't show hand 
*** SUMMARY ***
Total pot $1.75 | Rake $0 
Seat 1: silvno31 (button) folded before Flop (didn't bet)
Seat 2: azizmimi (small blind) folded before Flop
Seat 3: Phaedrus...3 (big blind) folded before Flop
Seat 4: 1Karina1 collected ($1.75)
Seat 5: fuguangps folded before Flop (didn't bet)
Seat 6: hl77777 folded before Flop (didn't bet)
Seat 7: chiyuki folded before Flop (didn't bet)
Seat 8: Cyanidoff folded before Flop (didn't bet)
Seat 9: Lars111 folded before Flop (didn't bet)



PokerStars Zoom Hand #84299741656:  Hold'em No Limit ($0.10/$0.25) - 2012/08/05 14:40:06 JST [2012/08/05 1:40:06 ET]
Table 'Whirlpool' 9-max Seat #1 is the button
Seat 1: Ladyteazer ($31.52 in chips) 
Seat 2: Lasutchik ($79.30 in chips) 
Seat 3: snejokCoxx ($12.15 in chips) 
Seat 4: led52 ($11.80 in chips) 
Seat 5: hirozo ($33.40 in chips) 
Seat 6: chiyuki ($24.63 in chips) 
Seat 7: stalkerec ($3.85 in chips) 
Seat 8: WARIBANA7777 ($24.22 in chips) 
Seat 9: ZhukOFFskI ($34.09 in chips) 
Lasutchik: posts small blind $0.10
snejokCoxx: posts big blind $0.25
*** HOLE CARDS ***
Dealt to chiyuki [6h Qd]
led52: folds 
hirozo: folds 
chiyuki: folds 
stalkerec: calls $0.25
WARIBANA7777: folds 
ZhukOFFskI: folds 
Ladyteazer: calls $0.25
Lasutchik: folds 
snejokCoxx: checks 
*** FLOP *** [7h Td 5s]
snejokCoxx: checks 
stalkerec: bets $0.75
Ladyteazer: calls $0.75
snejokCoxx: folds 
*** TURN *** [7h Td 5s] [2d]
stalkerec: bets $1.50
Ladyteazer: calls $1.50
*** RIVER *** [7h Td 5s 2d] [Qh]
stalkerec: bets $1.35 and is all-in
Ladyteazer: calls $1.35
*** SHOW DOWN ***
stalkerec: shows [Ah As] (a pair of Aces)
Ladyteazer: shows [5c Ac] (a pair of Fives)
stalkerec collected $7.69 from pot
*** SUMMARY ***
Total pot $8.05 | Rake $0.36 
Board [7h Td 5s 2d Qh]
Seat 1: Ladyteazer (button) showed [5c Ac] and lost with a pair of Fives
Seat 2: Lasutchik (small blind) folded before Flop
Seat 3: snejokCoxx (big blind) folded on the Flop
Seat 4: led52 folded before Flop (didn't bet)
Seat 5: hirozo folded before Flop (didn't bet)
Seat 6: chiyuki folded before Flop (didn't bet)
Seat 7: stalkerec showed [Ah As] and won ($7.69) with a pair of Aces
Seat 8: WARIBANA7777 folded before Flop (didn't bet)
Seat 9: ZhukOFFskI folded before Flop (didn't bet)



PokerStars Zoom Hand #84299746354:  Hold'em No Limit ($0.10/$0.25) - 2012/08/05 14:40:25 JST [2012/08/05 1:40:25 ET]
Table 'Whirlpool' 9-max Seat #1 is the button
Seat 1: chiyuki ($24.63 in chips) 
Seat 2: Yogi707 ($16.12 in chips) 
Seat 3: jacquelinewu ($25.35 in chips) 
Seat 4: Wilcox76607 ($15.03 in chips) 
Seat 5: Dan Royal ($48.75 in chips) 
Seat 6: Ellen1947 ($26 in chips) 
Seat 7: Dejacob ($27.18 in chips) 
Seat 8: igor*gemert ($23.02 in chips) 
Seat 9: Dafleche ($16.57 in chips) 
Yogi707: posts small blind $0.10
jacquelinewu: posts big blind $0.25
*** HOLE CARDS ***
Dealt to chiyuki [4h 3s]
Wilcox76607: folds 
Dan Royal: folds 
Ellen1947: folds 
Dejacob: folds 
igor*gemert: raises $0.25 to $0.50
Dafleche: calls $0.50
chiyuki: folds 
Yogi707: calls $0.40
jacquelinewu: folds 
*** FLOP *** [Qd 5h 7d]
Yogi707: checks 
igor*gemert: bets $1
Dafleche: folds 
Yogi707: calls $1
*** TURN *** [Qd 5h 7d] [9c]
Yogi707: checks 
igor*gemert: bets $1.43
Yogi707: calls $1.43
*** RIVER *** [Qd 5h 7d 9c] [4s]
Yogi707: checks 
igor*gemert: checks 
*** SHOW DOWN ***
Yogi707: shows [8c 8d] (a pair of Eights)
igor*gemert: shows [Ks Kc] (a pair of Kings)
igor*gemert collected $6.31 from pot
*** SUMMARY ***
Total pot $6.61 | Rake $0.30 
Board [Qd 5h 7d 9c 4s]
Seat 1: chiyuki (button) folded before Flop (didn't bet)
Seat 2: Yogi707 (small blind) showed [8c 8d] and lost with a pair of Eights
Seat 3: jacquelinewu (big blind) folded before Flop
Seat 4: Wilcox76607 folded before Flop (didn't bet)
Seat 5: Dan Royal folded before Flop (didn't bet)
Seat 6: Ellen1947 folded before Flop (didn't bet)
Seat 7: Dejacob folded before Flop (didn't bet)
Seat 8: igor*gemert showed [Ks Kc] and won ($6.31) with a pair of Kings
Seat 9: Dafleche folded on the Flop



PokerStars Zoom Hand #84299744850:  Hold'em No Limit ($0.10/$0.25) - 2012/08/05 14:40:19 JST [2012/08/05 1:40:19 ET]
Table 'Whirlpool' 9-max Seat #1 is the button
Seat 1: Perstenev ($12.86 in chips) 
Seat 2: Nerkit ($11.90 in chips) 
Seat 3: ChrisCDee ($74.07 in chips) 
Seat 4: led52 ($11.80 in chips) 
Seat 5: hl77777 ($12.02 in chips) 
Seat 6: Loholov ($15 in chips) 
Seat 7: simonzez ($54.21 in chips) 
Seat 8: KrystalAA ($24.34 in chips) 
Seat 9: chiyuki ($24.63 in chips) 
Nerkit: posts small blind $0.10
ChrisCDee: posts big blind $0.25
*** HOLE CARDS ***
Dealt to chiyuki [2c Js]
led52: folds 
hl77777: folds 
Loholov: folds 
simonzez: folds 
KrystalAA: folds 
chiyuki: folds 
Perstenev: folds 
Nerkit: raises $0.50 to $0.75
ChrisCDee: calls $0.50
*** FLOP *** [8c Td Kc]
Nerkit: bets $1
ChrisCDee: calls $1
*** TURN *** [8c Td Kc] [9d]
Nerkit: bets $1.75
ChrisCDee: folds 
Uncalled bet ($1.75) returned to Nerkit
Nerkit collected $3.34 from pot
Nerkit: doesn't show hand 
*** SUMMARY ***
Total pot $3.50 | Rake $0.16 
Board [8c Td Kc 9d]
Seat 1: Perstenev (button) folded before Flop (didn't bet)
Seat 2: Nerkit (small blind) collected ($3.34)
Seat 3: ChrisCDee (big blind) folded on the Turn
Seat 4: led52 folded before Flop (didn't bet)
Seat 5: hl77777 folded before Flop (didn't bet)
Seat 6: Loholov folded before Flop (didn't bet)
Seat 7: simonzez folded before Flop (didn't bet)
Seat 8: KrystalAA folded before Flop (didn't bet)
Seat 9: chiyuki folded before Flop (didn't bet)



PokerStars Zoom Hand #84299756388:  Hold'em No Limit ($0.10/$0.25) - 2012/08/05 14:41:06 JST [2012/08/05 1:41:06 ET]
Table 'Whirlpool' 9-max Seat #1 is the button
Seat 1: fuguangps ($26.23 in chips) 
Seat 2: snejokCoxx ($12.77 in chips) 
Seat 3: 4plankton ($27.13 in chips) 
Seat 4: Loholov ($15.85 in chips) 
Seat 5: deepakmbh ($16.67 in chips) 
Seat 6: chiyuki ($24.38 in chips) 
Seat 7: phate-1up ($26.54 in chips) 
Seat 8: led52 ($12.15 in chips) 
Seat 9: Walturrr ($25.59 in chips) 
snejokCoxx: posts small blind $0.10
4plankton: posts big blind $0.25
*** HOLE CARDS ***
Dealt to chiyuki [9c 5d]
Loholov: folds 
deepakmbh: folds 
chiyuki: folds 
phate-1up: folds 
led52: raises $0.50 to $0.75
Walturrr: folds 
fuguangps: folds 
snejokCoxx: folds 
4plankton: folds 
Uncalled bet ($0.50) returned to led52
led52 collected $0.60 from pot
led52: doesn't show hand 
*** SUMMARY ***
Total pot $0.60 | Rake $0 
Seat 1: fuguangps (button) folded before Flop (didn't bet)
Seat 2: snejokCoxx (small blind) folded before Flop
Seat 3: 4plankton (big blind) folded before Flop
Seat 4: Loholov folded before Flop (didn't bet)
Seat 5: deepakmbh folded before Flop (didn't bet)
Seat 6: chiyuki folded before Flop (didn't bet)
Seat 7: phate-1up folded before Flop (didn't bet)
Seat 8: led52 collected ($0.60)
Seat 9: Walturrr folded before Flop (didn't bet)



PokerStars Zoom Hand #84299758894:  Hold'em No Limit ($0.10/$0.25) - 2012/08/05 14:41:17 JST [2012/08/05 1:41:17 ET]
Table 'Whirlpool' 9-max Seat #1 is the button
Seat 1: fuguangps ($27.29 in chips) 
Seat 2: chiyuki ($24.38 in chips) 
Seat 3: GovGus ($34.91 in chips) 
Seat 4: ChrisCDee ($28.70 in chips) 
Seat 5: snejokCoxx ($16.65 in chips) 
Seat 6: ZhukOFFskI ($33.74 in chips) 
Seat 7: Dejacob ($36.70 in chips) 
Seat 8: Paranoix1990 ($11.99 in chips) 
Seat 9: cofla tito ($8.27 in chips) 
chiyuki: posts small blind $0.10
GovGus: posts big blind $0.25
*** HOLE CARDS ***
Dealt to chiyuki [Qh 8d]
ChrisCDee: folds 
snejokCoxx: folds 
ZhukOFFskI: raises $0.50 to $0.75
Dejacob: folds 
Paranoix1990: calls $0.75
cofla tito: folds 
fuguangps: folds 
chiyuki: folds 
GovGus: folds 
*** FLOP *** [6h Qc 4d]
ZhukOFFskI: bets $1.25
Paranoix1990: folds 
Uncalled bet ($1.25) returned to ZhukOFFskI
ZhukOFFskI collected $1.77 from pot
ZhukOFFskI: doesn't show hand 
*** SUMMARY ***
Total pot $1.85 | Rake $0.08 
Board [6h Qc 4d]
Seat 1: fuguangps (button) folded before Flop (didn't bet)
Seat 2: chiyuki (small blind) folded before Flop
Seat 3: GovGus (big blind) folded before Flop
Seat 4: ChrisCDee folded before Flop (didn't bet)
Seat 5: snejokCoxx folded before Flop (didn't bet)
Seat 6: ZhukOFFskI collected ($1.77)
Seat 7: Dejacob folded before Flop (didn't bet)
Seat 8: Paranoix1990 folded on the Flop
Seat 9: cofla tito folded before Flop (didn't bet)



PokerStars Zoom Hand #84299760096:  Hold'em No Limit ($0.10/$0.25) - 2012/08/05 14:41:22 JST [2012/08/05 1:41:22 ET]
Table 'Whirlpool' 9-max Seat #1 is the button
Seat 1: KeLevro0 ($7.89 in chips) 
Seat 2: Loholov ($15.85 in chips) 
Seat 3: led52 ($13.17 in chips) 
Seat 4: Nerkit ($9.97 in chips) 
Seat 5: chiyuki ($24.28 in chips) 
Seat 6: Ladyteazer ($27.67 in chips) 
Seat 7: igor*gemert ($26.30 in chips) 
Seat 8: hl77777 ($9.77 in chips) 
Seat 9: Gichboy ($11.14 in chips) 
Loholov: posts small blind $0.10
led52: posts big blind $0.25
*** HOLE CARDS ***
Dealt to chiyuki [4d Js]
Nerkit: folds 
chiyuki: folds 
Ladyteazer: folds 
igor*gemert: folds 
hl77777: raises $0.50 to $0.75
Gichboy: raises $0.75 to $1.50
KeLevro0: folds 
Loholov: folds 
led52: folds 
hl77777: folds 
Uncalled bet ($0.75) returned to Gichboy
Gichboy collected $1.85 from pot
Gichboy: doesn't show hand 
*** SUMMARY ***
Total pot $1.85 | Rake $0 
Seat 1: KeLevro0 (button) folded before Flop (didn't bet)
Seat 2: Loholov (small blind) folded before Flop
Seat 3: led52 (big blind) folded before Flop
Seat 4: Nerkit folded before Flop (didn't bet)
Seat 5: chiyuki folded before Flop (didn't bet)
Seat 6: Ladyteazer folded before Flop (didn't bet)
Seat 7: igor*gemert folded before Flop (didn't bet)
Seat 8: hl77777 folded before Flop
Seat 9: Gichboy collected ($1.85)



PokerStars Zoom Hand #84299763081:  Hold'em No Limit ($0.10/$0.25) - 2012/08/05 14:41:34 JST [2012/08/05 1:41:34 ET]
Table 'Whirlpool' 9-max Seat #1 is the button
Seat 1: mid22 ($12.28 in chips) 
Seat 2: Alvinpe85 ($62.79 in chips) 
Seat 3: Landybob ($39.51 in chips) 
Seat 4: ZhukOFFskI ($33.84 in chips) 
Seat 5: Gichboy ($12.64 in chips) 
Seat 6: deepakmbh ($25.10 in chips) 
Seat 7: chiyuki ($24.28 in chips) 
Seat 8: hirozo ($25 in chips) 
Seat 9: Loholov ($19.55 in chips) 
Alvinpe85: posts small blind $0.10
Landybob: posts big blind $0.25
*** HOLE CARDS ***
Dealt to chiyuki [Th 8s]
ZhukOFFskI: folds 
Gichboy: folds 
deepakmbh: folds 
chiyuki: folds 
hirozo: raises $0.50 to $0.75
Loholov: folds 
mid22: folds 
Alvinpe85: folds 
Landybob: calls $0.50
*** FLOP *** [Td Kh Ad]
Landybob: checks 
hirozo: bets $1.02
Landybob: folds 
Uncalled bet ($1.02) returned to hirozo
hirozo collected $1.53 from pot
hirozo: doesn't show hand 
*** SUMMARY ***
Total pot $1.60 | Rake $0.07 
Board [Td Kh Ad]
Seat 1: mid22 (button) folded before Flop (didn't bet)
Seat 2: Alvinpe85 (small blind) folded before Flop
Seat 3: Landybob (big blind) folded on the Flop
Seat 4: ZhukOFFskI folded before Flop (didn't bet)
Seat 5: Gichboy folded before Flop (didn't bet)
Seat 6: deepakmbh folded before Flop (didn't bet)
Seat 7: chiyuki folded before Flop (didn't bet)
Seat 8: hirozo collected ($1.53)
Seat 9: Loholov folded before Flop (didn't bet)



PokerStars Zoom Hand #84299767539:  Hold'em No Limit ($0.10/$0.25) - 2012/08/05 14:41:52 JST [2012/08/05 1:41:52 ET]
Table 'Whirlpool' 9-max Seat #1 is the button
Seat 1: ll_LaMeR_ll ($78.83 in chips) 
Seat 2: seula i ($25.88 in chips) 
Seat 3: 1Karina1 ($28.78 in chips) 
Seat 4: chiyuki ($24.28 in chips) 
Seat 5: ZhukOFFskI ($33.84 in chips) 
Seat 6: hl77777 ($8.92 in chips) 
Seat 7: jacquelinewu ($33.56 in chips) 
Seat 8: snejokCoxx ($13.02 in chips) 
Seat 9: stalkerec ($7.44 in chips) 
seula i: posts small blind $0.10
1Karina1: posts big blind $0.25
*** HOLE CARDS ***
Dealt to chiyuki [Jh 4s]
chiyuki: folds 
ZhukOFFskI: folds 
hl77777: folds 
jacquelinewu: folds 
snejokCoxx: folds 
stalkerec: folds 
ll_LaMeR_ll: folds 
seula i: folds 
Uncalled bet ($0.15) returned to 1Karina1
1Karina1 collected $0.20 from pot
1Karina1: doesn't show hand 
*** SUMMARY ***
Total pot $0.20 | Rake $0 
Seat 1: ll_LaMeR_ll (button) folded before Flop (didn't bet)
Seat 2: seula i (small blind) folded before Flop
Seat 3: 1Karina1 (big blind) collected ($0.20)
Seat 4: chiyuki folded before Flop (didn't bet)
Seat 5: ZhukOFFskI folded before Flop (didn't bet)
Seat 6: hl77777 folded before Flop (didn't bet)
Seat 7: jacquelinewu folded before Flop (didn't bet)
Seat 8: snejokCoxx folded before Flop (didn't bet)
Seat 9: stalkerec folded before Flop (didn't bet)



PokerStars Zoom Hand #84299766272:  Hold'em No Limit ($0.10/$0.25) - 2012/08/05 14:41:47 JST [2012/08/05 1:41:47 ET]
Table 'Whirlpool' 9-max Seat #1 is the button
Seat 1: led52 ($10.40 in chips) 
Seat 2: hl77777 ($9.02 in chips) 
Seat 3: Walturrr ($25.03 in chips) 
Seat 4: KrystalAA ($23.99 in chips) 
Seat 5: fuguangps ($26.95 in chips) 
Seat 6: stalkerec ($7.44 in chips) 
Seat 7: ChrisCDee ($72.32 in chips) 
Seat 8: chiyuki ($24.28 in chips) 
Seat 9: snejokCoxx ($13.02 in chips) 
hl77777: posts small blind $0.10
Walturrr: posts big blind $0.25
*** HOLE CARDS ***
Dealt to chiyuki [2c 8c]
KrystalAA: folds 
fuguangps: folds 
stalkerec: folds 
ChrisCDee: folds 
chiyuki: folds 
snejokCoxx: folds 
led52: raises $0.50 to $0.75
hl77777: folds 
Walturrr: folds 
Uncalled bet ($0.50) returned to led52
led52 collected $0.60 from pot
led52: doesn't show hand 
*** SUMMARY ***
Total pot $0.60 | Rake $0 
Seat 1: led52 (button) collected ($0.60)
Seat 2: hl77777 (small blind) folded before Flop
Seat 3: Walturrr (big blind) folded before Flop
Seat 4: KrystalAA folded before Flop (didn't bet)
Seat 5: fuguangps folded before Flop (didn't bet)
Seat 6: stalkerec folded before Flop (didn't bet)
Seat 7: ChrisCDee folded before Flop (didn't bet)
Seat 8: chiyuki folded before Flop (didn't bet)
Seat 9: snejokCoxx folded before Flop (didn't bet)



PokerStars Zoom Hand #84299768252:  Hold'em No Limit ($0.10/$0.25) - 2012/08/05 14:41:55 JST [2012/08/05 1:41:55 ET]
Table 'Whirlpool' 9-max Seat #1 is the button
Seat 1: chiyuki ($24.28 in chips) 
Seat 2: dushvan ($42.29 in chips) 
Seat 3: snejokCoxx ($11.80 in chips) 
Seat 4: mjmichi ($28.33 in chips) 
Seat 5: Lasutchik ($78.33 in chips) 
Seat 6: Perstenev ($12.51 in chips) 
Seat 7: BlOnDhOlIc ($78.56 in chips) 
Seat 8: silvno31 ($30.72 in chips) 
Seat 9: Loholov ($16.09 in chips) 
dushvan: posts small blind $0.10
snejokCoxx: posts big blind $0.25
*** HOLE CARDS ***
Dealt to chiyuki [5d Ad]
mjmichi: folds 
Lasutchik: folds 
Perstenev: folds 
BlOnDhOlIc: folds 
silvno31: folds 
Loholov: folds 
chiyuki: raises $0.50 to $0.75
dushvan: folds 
snejokCoxx: folds 
Uncalled bet ($0.50) returned to chiyuki
chiyuki collected $0.60 from pot
chiyuki: doesn't show hand 
*** SUMMARY ***
Total pot $0.60 | Rake $0 
Seat 1: chiyuki (button) collected ($0.60)
Seat 2: dushvan (small blind) folded before Flop
Seat 3: snejokCoxx (big blind) folded before Flop
Seat 4: mjmichi folded before Flop (didn't bet)
Seat 5: Lasutchik folded before Flop (didn't bet)
Seat 6: Perstenev folded before Flop (didn't bet)
Seat 7: BlOnDhOlIc folded before Flop (didn't bet)
Seat 8: silvno31 folded before Flop (didn't bet)
Seat 9: Loholov folded before Flop (didn't bet)



PokerStars Zoom Hand #84299749775:  Hold'em No Limit ($0.10/$0.25) - 2012/08/05 14:40:39 JST [2012/08/05 1:40:39 ET]
Table 'Whirlpool' 9-max Seat #1 is the button
Seat 1: 1Karina1 ($28.38 in chips) 
Seat 2: Walturrr ($25.69 in chips) 
Seat 3: chiyuki ($24.63 in chips) 
Seat 4: softdesign ($78.44 in chips) 
Seat 5: Nerkit ($10.32 in chips) 
Seat 6: cr0lox ($22.70 in chips) 
Seat 7: GovGus ($34.91 in chips) 
Seat 8: Lasutchik ($78.95 in chips) 
Seat 9: KrystalAA ($10.79 in chips) 
Walturrr: posts small blind $0.10
chiyuki: posts big blind $0.25
*** HOLE CARDS ***
Dealt to chiyuki [5d 8c]
softdesign: calls $0.25
Nerkit: folds 
cr0lox: folds 
GovGus: folds 
Lasutchik: folds 
KrystalAA: folds 
1Karina1: raises $0.75 to $1
Walturrr: folds 
chiyuki: folds 
softdesign: calls $0.75
*** FLOP *** [7c Js 8h]
softdesign: bets $1.75
1Karina1: raises $4 to $5.75
softdesign: calls $4
*** TURN *** [7c Js 8h] [Qh]
softdesign: checks 
1Karina1: bets $9.25
softdesign: calls $9.25
*** RIVER *** [7c Js 8h Qh] [4d]
softdesign: checks 
1Karina1: bets $12.38 and is all-in
softdesign has timed out
softdesign: folds 
Uncalled bet ($12.38) returned to 1Karina1
1Karina1 collected $30.89 from pot
1Karina1: doesn't show hand 
*** SUMMARY ***
Total pot $32.35 | Rake $1.46 
Board [7c Js 8h Qh 4d]
Seat 1: 1Karina1 (button) collected ($30.89)
Seat 2: Walturrr (small blind) folded before Flop
Seat 3: chiyuki (big blind) folded before Flop
Seat 4: softdesign folded on the River
Seat 5: Nerkit folded before Flop (didn't bet)
Seat 6: cr0lox folded before Flop (didn't bet)
Seat 7: GovGus folded before Flop (didn't bet)
Seat 8: Lasutchik folded before Flop (didn't bet)
Seat 9: KrystalAA folded before Flop (didn't bet)



PokerStars Zoom Hand #84299765051:  Hold'em No Limit ($0.10/$0.25) - 2012/08/05 14:41:42 JST [2012/08/05 1:41:42 ET]
Table 'Whirlpool' 9-max Seat #1 is the button
Seat 1: Perstenev ($12.51 in chips) 
Seat 2: Ellen1947 ($25.75 in chips) 
Seat 3: led52 ($12.66 in chips) 
Seat 4: Jene4kaBest ($10.80 in chips) 
Seat 5: chiyuki ($24.28 in chips) 
Seat 6: troms20 ($46.15 in chips) 
Seat 7: BlOnDhOlIc ($87.29 in chips) 
Seat 8: fuguangps ($27.29 in chips) 
Seat 9: KimPa39 ($23.94 in chips) 
Ellen1947: posts small blind $0.10
led52: posts big blind $0.25
*** HOLE CARDS ***
Dealt to chiyuki [4d Jc]
Jene4kaBest: folds 
chiyuki: folds 
troms20: folds 
BlOnDhOlIc: folds 
fuguangps: raises $0.50 to $0.75
KimPa39: folds 
Perstenev: folds 
Ellen1947: raises $1.35 to $2.10
led52: folds 
fuguangps: calls $1.35
*** FLOP *** [2d 6d 3h]
Ellen1947: bets $2.30
fuguangps: calls $2.30
*** TURN *** [2d 6d 3h] [3s]
Ellen1947: checks 
fuguangps: bets $5
Ellen1947: raises $16.35 to $21.35 and is all-in
fuguangps: calls $16.35
*** RIVER *** [2d 6d 3h 3s] [4c]
*** SHOW DOWN ***
Ellen1947: shows [9d 9s] (two pair, Nines and Threes)
fuguangps: shows [Qc Qh] (two pair, Queens and Threes)
fuguangps collected $49.75 from pot
*** SUMMARY ***
Total pot $51.75 | Rake $2 
Board [2d 6d 3h 3s 4c]
Seat 1: Perstenev (button) folded before Flop (didn't bet)
Seat 2: Ellen1947 (small blind) showed [9d 9s] and lost with two pair, Nines and Threes
Seat 3: led52 (big blind) folded before Flop
Seat 4: Jene4kaBest folded before Flop (didn't bet)
Seat 5: chiyuki folded before Flop (didn't bet)
Seat 6: troms20 folded before Flop (didn't bet)
Seat 7: BlOnDhOlIc folded before Flop (didn't bet)
Seat 8: fuguangps showed [Qc Qh] and won ($49.75) with two pair, Queens and Threes
Seat 9: KimPa39 folded before Flop (didn't bet)



PokerStars Zoom Hand #84299774797:  Hold'em No Limit ($0.10/$0.25) - 2012/08/05 14:42:23 JST [2012/08/05 1:42:23 ET]
Table 'Whirlpool' 9-max Seat #1 is the button
Seat 1: Dejacob ($33.88 in chips) 
Seat 2: led52 ($13.27 in chips) 
Seat 3: Perstenev ($11.51 in chips) 
Seat 4: peng2astic ($13.93 in chips) 
Seat 5: seula i ($116.96 in chips) 
Seat 6: fuguangps ($30.61 in chips) 
Seat 7: hl77777 ($13.10 in chips) 
Seat 8: azizmimi ($8.12 in chips) 
Seat 9: chiyuki ($24.63 in chips) 
led52: posts small blind $0.10
Perstenev: posts big blind $0.25
*** HOLE CARDS ***
Dealt to chiyuki [7h Jh]
peng2astic: calls $0.25
seula i: folds 
fuguangps: folds 
hl77777: folds 
azizmimi: folds 
chiyuki: folds 
Dejacob: folds 
led52: folds 
Perstenev: checks 
*** FLOP *** [6s Qh 3s]
Perstenev: checks 
peng2astic: checks 
*** TURN *** [6s Qh 3s] [3c]
Perstenev: checks 
peng2astic: bets $0.75
Perstenev: folds 
Uncalled bet ($0.75) returned to peng2astic
peng2astic collected $0.57 from pot
peng2astic: doesn't show hand 
*** SUMMARY ***
Total pot $0.60 | Rake $0.03 
Board [6s Qh 3s 3c]
Seat 1: Dejacob (button) folded before Flop (didn't bet)
Seat 2: led52 (small blind) folded before Flop
Seat 3: Perstenev (big blind) folded on the Turn
Seat 4: peng2astic collected ($0.57)
Seat 5: seula i folded before Flop (didn't bet)
Seat 6: fuguangps folded before Flop (didn't bet)
Seat 7: hl77777 folded before Flop (didn't bet)
Seat 8: azizmimi folded before Flop (didn't bet)
Seat 9: chiyuki folded before Flop (didn't bet)



PokerStars Zoom Hand #84299776992:  Hold'em No Limit ($0.10/$0.25) - 2012/08/05 14:42:32 JST [2012/08/05 1:42:32 ET]
Table 'Whirlpool' 9-max Seat #1 is the button
Seat 1: seula i ($116.96 in chips) 
Seat 2: Perstenev ($8.68 in chips) 
Seat 3: chiyuki ($24.63 in chips) 
Seat 4: hirozo ($25.78 in chips) 
Seat 5: Dan Royal ($46.50 in chips) 
Seat 6: hl77777 ($13.10 in chips) 
Seat 7: mjmichi ($25 in chips) 
Seat 8: Ladyteazer ($31.38 in chips) 
Seat 9: azizmimi ($8.12 in chips) 
Perstenev: posts small blind $0.10
chiyuki: posts big blind $0.25
*** HOLE CARDS ***
Dealt to chiyuki [6d Ac]
hirozo: folds 
Dan Royal: calls $0.25
hl77777: folds 
mjmichi: folds 
Ladyteazer: folds 
azizmimi: folds 
seula i: folds 
Perstenev: folds 
chiyuki: checks 
*** FLOP *** [8d 4h 2d]
chiyuki: checks 
Dan Royal: bets $0.25
chiyuki: folds 
Uncalled bet ($0.25) returned to Dan Royal
Dan Royal collected $0.57 from pot
Dan Royal: doesn't show hand 
*** SUMMARY ***
Total pot $0.60 | Rake $0.03 
Board [8d 4h 2d]
Seat 1: seula i (button) folded before Flop (didn't bet)
Seat 2: Perstenev (small blind) folded before Flop
Seat 3: chiyuki (big blind) folded on the Flop
Seat 4: hirozo folded before Flop (didn't bet)
Seat 5: Dan Royal collected ($0.57)
Seat 6: hl77777 folded before Flop (didn't bet)
Seat 7: mjmichi folded before Flop (didn't bet)
Seat 8: Ladyteazer folded before Flop (didn't bet)
Seat 9: azizmimi folded before Flop (didn't bet)



PokerStars Zoom Hand #84299775998:  Hold'em No Limit ($0.10/$0.25) - 2012/08/05 14:42:28 JST [2012/08/05 1:42:28 ET]
Table 'Whirlpool' 9-max Seat #1 is the button
Seat 1: Loholov ($19.55 in chips) 
Seat 2: Yogi707 ($13.29 in chips) 
Seat 3: KrystalAA ($11.04 in chips) 
Seat 4: Nerkit ($16.10 in chips) 
Seat 5: deepakmbh ($24.10 in chips) 
Seat 6: chiyuki ($24.63 in chips) 
Seat 7: azizmimi ($8.12 in chips) 
Seat 8: GovGus ($34.56 in chips) 
Seat 9: KeLevro0 ($12.15 in chips) 
Yogi707: posts small blind $0.10
KrystalAA: posts big blind $0.25
*** HOLE CARDS ***
Dealt to chiyuki [8h 6h]
Nerkit: folds 
deepakmbh: raises $0.50 to $0.75
chiyuki: folds 
azizmimi: folds 
GovGus: raises $1.50 to $2.25
KeLevro0: folds 
Loholov: folds 
Yogi707: folds 
KrystalAA: folds 
deepakmbh: calls $1.50
*** FLOP *** [6c Qc Ah]
deepakmbh: checks 
GovGus: bets $2.75
deepakmbh: calls $2.75
*** TURN *** [6c Qc Ah] [8d]
deepakmbh: checks 
GovGus: checks 
*** RIVER *** [6c Qc Ah 8d] [Jd]
deepakmbh: checks 
GovGus: checks 
*** SHOW DOWN ***
deepakmbh: shows [Ac 9c] (a pair of Aces)
GovGus: mucks hand 
deepakmbh collected $9.88 from pot
*** SUMMARY ***
Total pot $10.35 | Rake $0.47 
Board [6c Qc Ah 8d Jd]
Seat 1: Loholov (button) folded before Flop (didn't bet)
Seat 2: Yogi707 (small blind) folded before Flop
Seat 3: KrystalAA (big blind) folded before Flop
Seat 4: Nerkit folded before Flop (didn't bet)
Seat 5: deepakmbh showed [Ac 9c] and won ($9.88) with a pair of Aces
Seat 6: chiyuki folded before Flop (didn't bet)
Seat 7: azizmimi folded before Flop (didn't bet)
Seat 8: GovGus mucked [Th Tc]
Seat 9: KeLevro0 folded before Flop (didn't bet)



PokerStars Zoom Hand #84299787897:  Hold'em No Limit ($0.10/$0.25) - 2012/08/05 14:43:16 JST [2012/08/05 1:43:16 ET]
Table 'Whirlpool' 9-max Seat #1 is the button
Seat 1: KeLevro0 ($11.62 in chips) 
Seat 2: fuguangps ($26.05 in chips) 
Seat 3: JokerJudge ($24.65 in chips) 
Seat 4: chiyuki ($24.38 in chips) 
Seat 5: ZhukOFFskI ($33.84 in chips) 
Seat 6: hirozo ($34.33 in chips) 
Seat 7: seula i ($30.71 in chips) 
Seat 8: jacquelinewu ($27.32 in chips) 
Seat 9: KrystalAA ($10.79 in chips) 
fuguangps: posts small blind $0.10
JokerJudge: posts big blind $0.25
*** HOLE CARDS ***
Dealt to chiyuki [4s 6s]
chiyuki: folds 
ZhukOFFskI: folds 
hirozo: raises $0.50 to $0.75
seula i: folds 
jacquelinewu: folds 
KrystalAA: folds 
KeLevro0: folds 
fuguangps: folds 
JokerJudge: folds 
Uncalled bet ($0.50) returned to hirozo
hirozo collected $0.60 from pot
hirozo: doesn't show hand 
*** SUMMARY ***
Total pot $0.60 | Rake $0 
Seat 1: KeLevro0 (button) folded before Flop (didn't bet)
Seat 2: fuguangps (small blind) folded before Flop
Seat 3: JokerJudge (big blind) folded before Flop
Seat 4: chiyuki folded before Flop (didn't bet)
Seat 5: ZhukOFFskI folded before Flop (didn't bet)
Seat 6: hirozo collected ($0.60)
Seat 7: seula i folded before Flop (didn't bet)
Seat 8: jacquelinewu folded before Flop (didn't bet)
Seat 9: KrystalAA folded before Flop (didn't bet)



PokerStars Zoom Hand #84299785456:  Hold'em No Limit ($0.10/$0.25) - 2012/08/05 14:43:06 JST [2012/08/05 1:43:06 ET]
Table 'Whirlpool' 9-max Seat #1 is the button
Seat 1: JokerJudge ($24.65 in chips) 
Seat 2: Nerkit ($10.80 in chips) 
Seat 3: Alvinpe85 ($63.49 in chips) 
Seat 4: 1Karina1 ($25.70 in chips) 
Seat 5: fuguangps ($26.05 in chips) 
Seat 6: GovGus ($25 in chips) 
Seat 7: chiyuki ($24.38 in chips) 
Seat 8: KeLevro0 ($11.62 in chips) 
Seat 9: Perstenev ($13.46 in chips) 
Nerkit: posts small blind $0.10
Alvinpe85: posts big blind $0.25
*** HOLE CARDS ***
Dealt to chiyuki [Qh Jc]
1Karina1: folds 
fuguangps: folds 
GovGus: raises $0.75 to $1
chiyuki: folds 
KeLevro0: folds 
Perstenev: calls $1
JokerJudge: folds 
Nerkit: raises $9.80 to $10.80 and is all-in
Alvinpe85: folds 
GovGus: folds 
Perstenev: folds 
Uncalled bet ($9.80) returned to Nerkit
Nerkit collected $3.25 from pot
Nerkit: doesn't show hand 
*** SUMMARY ***
Total pot $3.25 | Rake $0 
Seat 1: JokerJudge (button) folded before Flop (didn't bet)
Seat 2: Nerkit (small blind) collected ($3.25)
Seat 3: Alvinpe85 (big blind) folded before Flop
Seat 4: 1Karina1 folded before Flop (didn't bet)
Seat 5: fuguangps folded before Flop (didn't bet)
Seat 6: GovGus folded before Flop
Seat 7: chiyuki folded before Flop (didn't bet)
Seat 8: KeLevro0 folded before Flop (didn't bet)
Seat 9: Perstenev folded before Flop



PokerStars Zoom Hand #84299789377:  Hold'em No Limit ($0.10/$0.25) - 2012/08/05 14:43:22 JST [2012/08/05 1:43:22 ET]
Table 'Whirlpool' 9-max Seat #1 is the button
Seat 1: mid22 ($12.35 in chips) 
Seat 2: chiyuki ($24.38 in chips) 
Seat 3: Wilcox76607 ($14.20 in chips) 
Seat 4: gunbowler ($146.60 in chips) 
Seat 5: Vahe50 ($16.27 in chips) 
Seat 6: WARIBANA7777 ($22.67 in chips) 
Seat 7: KeLevro0 ($11.62 in chips) 
Seat 8: BlOnDhOlIc ($38.96 in chips) 
Seat 9: led52 ($10.85 in chips) 
chiyuki: posts small blind $0.10
Wilcox76607: posts big blind $0.25
*** HOLE CARDS ***
Dealt to chiyuki [8h 8d]
gunbowler: raises $0.50 to $0.75
Vahe50: folds 
WARIBANA7777: folds 
KeLevro0: calls $0.75
BlOnDhOlIc: folds 
led52: folds 
mid22: folds 
chiyuki: calls $0.65
Wilcox76607: folds 
*** FLOP *** [Jc 5c 7c]
chiyuki: checks 
gunbowler: bets $1
KeLevro0: folds 
chiyuki: folds 
Uncalled bet ($1) returned to gunbowler
gunbowler collected $2.39 from pot
gunbowler: doesn't show hand 
*** SUMMARY ***
Total pot $2.50 | Rake $0.11 
Board [Jc 5c 7c]
Seat 1: mid22 (button) folded before Flop (didn't bet)
Seat 2: chiyuki (small blind) folded on the Flop
Seat 3: Wilcox76607 (big blind) folded before Flop
Seat 4: gunbowler collected ($2.39)
Seat 5: Vahe50 folded before Flop (didn't bet)
Seat 6: WARIBANA7777 folded before Flop (didn't bet)
Seat 7: KeLevro0 folded on the Flop
Seat 8: BlOnDhOlIc folded before Flop (didn't bet)
Seat 9: led52 folded before Flop (didn't bet)



PokerStars Zoom Hand #84299799338:  Hold'em No Limit ($0.10/$0.25) - 2012/08/05 14:44:04 JST [2012/08/05 1:44:04 ET]
Table 'Whirlpool' 9-max Seat #1 is the button
Seat 1: softdesign ($61.09 in chips) 
Seat 2: dushvan ($42.04 in chips) 
Seat 3: deadmoneykid ($25 in chips) 
Seat 4: stalkerec ($8.32 in chips) 
Seat 5: chiyuki ($23.63 in chips) 
Seat 6: led52 ($12.31 in chips) 
Seat 7: Vahe50 ($6 in chips) 
Seat 8: BlOnDhOlIc ($78.76 in chips) 
Seat 9: Paranoix1990 ($19.89 in chips) 
dushvan: posts small blind $0.10
deadmoneykid: posts big blind $0.25
*** HOLE CARDS ***
Dealt to chiyuki [9c Qh]
stalkerec: folds 
chiyuki: folds 
led52: raises $0.50 to $0.75
Vahe50: folds 
BlOnDhOlIc: folds 
Paranoix1990: folds 
softdesign: raises $1.50 to $2.25
dushvan: folds 
deadmoneykid: folds 
led52: folds 
Uncalled bet ($1.50) returned to softdesign
softdesign collected $1.85 from pot
softdesign: doesn't show hand 
*** SUMMARY ***
Total pot $1.85 | Rake $0 
Seat 1: softdesign (button) collected ($1.85)
Seat 2: dushvan (small blind) folded before Flop
Seat 3: deadmoneykid (big blind) folded before Flop
Seat 4: stalkerec folded before Flop (didn't bet)
Seat 5: chiyuki folded before Flop (didn't bet)
Seat 6: led52 folded before Flop
Seat 7: Vahe50 folded before Flop (didn't bet)
Seat 8: BlOnDhOlIc folded before Flop (didn't bet)
Seat 9: Paranoix1990 folded before Flop (didn't bet)



PokerStars Zoom Hand #84299801298:  Hold'em No Limit ($0.10/$0.25) - 2012/08/05 14:44:12 JST [2012/08/05 1:44:12 ET]
Table 'Whirlpool' 9-max Seat #1 is the button
Seat 1: seula i ($33.06 in chips) 
Seat 2: ZhukOFFskI ($33.59 in chips) 
Seat 3: GovGus ($29.56 in chips) 
Seat 4: deadmoneykid ($22.82 in chips) 
Seat 5: chiyuki ($23.63 in chips) 
Seat 6: snejokCoxx ($11.50 in chips) 
Seat 7: colorado2108 ($19.66 in chips) 
Seat 8: ChrisCDee ($71.57 in chips) 
Seat 9: mjmichi ($25 in chips) 
ZhukOFFskI: posts small blind $0.10
GovGus: posts big blind $0.25
*** HOLE CARDS ***
Dealt to chiyuki [7h 7c]
deadmoneykid: folds 
chiyuki: raises $0.50 to $0.75
snejokCoxx: folds 
colorado2108: raises $1 to $1.75
ChrisCDee: folds 
mjmichi: folds 
seula i: raises $31.31 to $33.06 and is all-in
ZhukOFFskI: folds 
GovGus: folds 
chiyuki: folds 
colorado2108: folds 
Uncalled bet ($31.31) returned to seula i
seula i collected $4.60 from pot
seula i: doesn't show hand 
*** SUMMARY ***
Total pot $4.60 | Rake $0 
Seat 1: seula i (button) collected ($4.60)
Seat 2: ZhukOFFskI (small blind) folded before Flop
Seat 3: GovGus (big blind) folded before Flop
Seat 4: deadmoneykid folded before Flop (didn't bet)
Seat 5: chiyuki folded before Flop
Seat 6: snejokCoxx folded before Flop (didn't bet)
Seat 7: colorado2108 folded before Flop
Seat 8: ChrisCDee folded before Flop (didn't bet)
Seat 9: mjmichi folded before Flop (didn't bet)



PokerStars Zoom Hand #84299810898:  Hold'em No Limit ($0.10/$0.25) - 2012/08/05 14:44:52 JST [2012/08/05 1:44:52 ET]
Table 'Whirlpool' 9-max Seat #1 is the button
Seat 1: chiyuki ($22.88 in chips) 
Seat 2: PillZ86 ($11.37 in chips) 
Seat 3: cofla tito ($12.77 in chips) 
Seat 4: seula i ($35.91 in chips) 
Seat 5: Walturrr ($26.46 in chips) 
Seat 6: mid22 ($8.35 in chips) 
Seat 7: canammark ($27.44 in chips) 
Seat 8: deadmoneykid ($24.08 in chips) 
Seat 9: Landybob ($37.01 in chips) 
PillZ86: posts small blind $0.10
cofla tito: posts big blind $0.25
*** HOLE CARDS ***
Dealt to chiyuki [6h Qd]
seula i: folds 
Walturrr: folds 
mid22: folds 
canammark: folds 
deadmoneykid: folds 
Landybob: folds 
chiyuki: folds 
PillZ86: raises $0.50 to $0.75
cofla tito: folds 
Uncalled bet ($0.50) returned to PillZ86
PillZ86 collected $0.50 from pot
PillZ86: doesn't show hand 
*** SUMMARY ***
Total pot $0.50 | Rake $0 
Seat 1: chiyuki (button) folded before Flop (didn't bet)
Seat 2: PillZ86 (small blind) collected ($0.50)
Seat 3: cofla tito (big blind) folded before Flop
Seat 4: seula i folded before Flop (didn't bet)
Seat 5: Walturrr folded before Flop (didn't bet)
Seat 6: mid22 folded before Flop (didn't bet)
Seat 7: canammark folded before Flop (didn't bet)
Seat 8: deadmoneykid folded before Flop (didn't bet)
Seat 9: Landybob folded before Flop (didn't bet)



PokerStars Zoom Hand #84299811888:  Hold'em No Limit ($0.10/$0.25) - 2012/08/05 14:44:56 JST [2012/08/05 1:44:56 ET]
Table 'Whirlpool' 9-max Seat #1 is the button
Seat 1: Lars111 ($14.76 in chips) 
Seat 2: Walturrr ($26.46 in chips) 
Seat 3: phate-1up ($41.34 in chips) 
Seat 4: fuguangps ($51.14 in chips) 
Seat 5: mid22 ($8.35 in chips) 
Seat 6: KeLevro0 ($12.15 in chips) 
Seat 7: hl77777 ($13.75 in chips) 
Seat 8: gunbowler ($146.59 in chips) 
Seat 9: chiyuki ($22.88 in chips) 
Walturrr: posts small blind $0.10
phate-1up: posts big blind $0.25
*** HOLE CARDS ***
Dealt to chiyuki [3c 3h]
fuguangps: folds 
mid22: folds 
KeLevro0: folds 
hl77777: folds 
gunbowler: folds 
chiyuki: raises $0.50 to $0.75
Lars111: calls $0.75
Walturrr: folds 
phate-1up: folds 
*** FLOP *** [4c 2d Td]
chiyuki: bets $0.88
Lars111: raises $3.53 to $4.41
chiyuki: folds 
Uncalled bet ($3.53) returned to Lars111
Lars111 collected $3.45 from pot
Lars111: doesn't show hand 
*** SUMMARY ***
Total pot $3.61 | Rake $0.16 
Board [4c 2d Td]
Seat 1: Lars111 (button) collected ($3.45)
Seat 2: Walturrr (small blind) folded before Flop
Seat 3: phate-1up (big blind) folded before Flop
Seat 4: fuguangps folded before Flop (didn't bet)
Seat 5: mid22 folded before Flop (didn't bet)
Seat 6: KeLevro0 folded before Flop (didn't bet)
Seat 7: hl77777 folded before Flop (didn't bet)
Seat 8: gunbowler folded before Flop (didn't bet)
Seat 9: chiyuki folded on the Flop



PokerStars Zoom Hand #84299818441:  Hold'em No Limit ($0.10/$0.25) - 2012/08/05 14:45:23 JST [2012/08/05 1:45:23 ET]
Table 'Whirlpool' 9-max Seat #1 is the button
Seat 1: led52 ($11.07 in chips) 
Seat 2: troublesomm ($25 in chips) 
Seat 3: chiyuki ($21.25 in chips) 
Seat 4: Tom1999 ($20.37 in chips) 
Seat 5: BlOnDhOlIc ($91.56 in chips) 
Seat 6: Sal y Limon1 ($25.40 in chips) 
Seat 7: Nerkit ($10.30 in chips) 
Seat 8: Phaedrus...3 ($26.29 in chips) 
Seat 9: Walturrr ($35.55 in chips) 
troublesomm: posts small blind $0.10
chiyuki: posts big blind $0.25
*** HOLE CARDS ***
Dealt to chiyuki [6c 8h]
Tom1999: folds 
BlOnDhOlIc: folds 
Sal y Limon1: folds 
Nerkit: folds 
Phaedrus...3: folds 
Walturrr: folds 
led52: folds 
troublesomm: folds 
Uncalled bet ($0.15) returned to chiyuki
chiyuki collected $0.20 from pot
chiyuki: doesn't show hand 
*** SUMMARY ***
Total pot $0.20 | Rake $0 
Seat 1: led52 (button) folded before Flop (didn't bet)
Seat 2: troublesomm (small blind) folded before Flop
Seat 3: chiyuki (big blind) collected ($0.20)
Seat 4: Tom1999 folded before Flop (didn't bet)
Seat 5: BlOnDhOlIc folded before Flop (didn't bet)
Seat 6: Sal y Limon1 folded before Flop (didn't bet)
Seat 7: Nerkit folded before Flop (didn't bet)
Seat 8: Phaedrus...3 folded before Flop (didn't bet)
Seat 9: Walturrr folded before Flop (didn't bet)



PokerStars Zoom Hand #84299822169:  Hold'em No Limit ($0.10/$0.25) - 2012/08/05 14:45:38 JST [2012/08/05 1:45:38 ET]
Table 'Whirlpool' 9-max Seat #1 is the button
Seat 1: led52 ($14.25 in chips) 
Seat 2: KeLevro0 ($11.90 in chips) 
Seat 3: hirozo ($40.57 in chips) 
Seat 4: Cyanidoff ($25 in chips) 
Seat 5: Jene4kaBest ($6.80 in chips) 
Seat 6: Ladyteazer ($29.74 in chips) 
Seat 7: cofla tito ($12.52 in chips) 
Seat 8: chiyuki ($21.35 in chips) 
Seat 9: BlOnDhOlIc ($91.56 in chips) 
KeLevro0: posts small blind $0.10
hirozo: posts big blind $0.25
*** HOLE CARDS ***
Dealt to chiyuki [5d 2s]
Cyanidoff: folds 
Jene4kaBest: folds 
Ladyteazer: raises $0.25 to $0.50
cofla tito: folds 
chiyuki: folds 
BlOnDhOlIc: folds 
led52: folds 
KeLevro0: folds 
hirozo: folds 
Uncalled bet ($0.25) returned to Ladyteazer
Ladyteazer collected $0.60 from pot
Ladyteazer: doesn't show hand 
*** SUMMARY ***
Total pot $0.60 | Rake $0 
Seat 1: led52 (button) folded before Flop (didn't bet)
Seat 2: KeLevro0 (small blind) folded before Flop
Seat 3: hirozo (big blind) folded before Flop
Seat 4: Cyanidoff folded before Flop (didn't bet)
Seat 5: Jene4kaBest folded before Flop (didn't bet)
Seat 6: Ladyteazer collected ($0.60)
Seat 7: cofla tito folded before Flop (didn't bet)
Seat 8: chiyuki folded before Flop (didn't bet)
Seat 9: BlOnDhOlIc folded before Flop (didn't bet)



PokerStars Zoom Hand #84299823605:  Hold'em No Limit ($0.10/$0.25) - 2012/08/05 14:45:44 JST [2012/08/05 1:45:44 ET]
Table 'Whirlpool' 9-max Seat #1 is the button
Seat 1: silvno31 ($32.30 in chips) 
Seat 2: Tom1999 ($20.12 in chips) 
Seat 3: peng2astic ($15.25 in chips) 
Seat 4: BlOnDhOlIc ($91.56 in chips) 
Seat 5: oktan60 ($24.39 in chips) 
Seat 6: chiyuki ($21.35 in chips) 
Seat 7: mariuka1 ($11.03 in chips) 
Seat 8: 4plankton ($28.41 in chips) 
Seat 9: 1Karina1 ($25.42 in chips) 
Tom1999: posts small blind $0.10
peng2astic: posts big blind $0.25
*** HOLE CARDS ***
Dealt to chiyuki [Ac 2c]
BlOnDhOlIc: raises $0.37 to $0.62
oktan60: calls $0.62
chiyuki: folds 
mariuka1: folds 
4plankton: folds 
1Karina1: folds 
silvno31: folds 
Tom1999: folds 
peng2astic: folds 
*** FLOP *** [Jh 6h 6c]
BlOnDhOlIc: bets $1
oktan60: folds 
Uncalled bet ($1) returned to BlOnDhOlIc
BlOnDhOlIc collected $1.52 from pot
BlOnDhOlIc: doesn't show hand 
*** SUMMARY ***
Total pot $1.59 | Rake $0.07 
Board [Jh 6h 6c]
Seat 1: silvno31 (button) folded before Flop (didn't bet)
Seat 2: Tom1999 (small blind) folded before Flop
Seat 3: peng2astic (big blind) folded before Flop
Seat 4: BlOnDhOlIc collected ($1.52)
Seat 5: oktan60 folded on the Flop
Seat 6: chiyuki folded before Flop (didn't bet)
Seat 7: mariuka1 folded before Flop (didn't bet)
Seat 8: 4plankton folded before Flop (didn't bet)
Seat 9: 1Karina1 folded before Flop (didn't bet)



PokerStars Zoom Hand #84299824625:  Hold'em No Limit ($0.10/$0.25) - 2012/08/05 14:45:48 JST [2012/08/05 1:45:48 ET]
Table 'Whirlpool' 9-max Seat #1 is the button
Seat 1: KeLevro0 ($11.86 in chips) 
Seat 2: 1Karina1 ($25.42 in chips) 
Seat 3: hl77777 ($13 in chips) 
Seat 4: cr0lox ($20.16 in chips) 
Seat 5: mariuka1 ($11.03 in chips) 
Seat 6: chiyuki ($21.35 in chips) 
Seat 7: 4plankton ($28.41 in chips) 
Seat 8: GovGus ($40.59 in chips) 
Seat 9: Tom1999 ($20.02 in chips) 
1Karina1: posts small blind $0.10
hl77777: posts big blind $0.25
*** HOLE CARDS ***
Dealt to chiyuki [6c Jd]
cr0lox: folds 
mariuka1: folds 
chiyuki: folds 
4plankton: raises $0.25 to $0.50
GovGus: calls $0.50
Tom1999: folds 
KeLevro0: folds 
1Karina1: calls $0.40
hl77777: raises $3 to $3.50
4plankton: folds 
GovGus: folds 
1Karina1: folds 
Uncalled bet ($3) returned to hl77777
hl77777 collected $2 from pot
hl77777: doesn't show hand 
*** SUMMARY ***
Total pot $2 | Rake $0 
Seat 1: KeLevro0 (button) folded before Flop (didn't bet)
Seat 2: 1Karina1 (small blind) folded before Flop
Seat 3: hl77777 (big blind) collected ($2)
Seat 4: cr0lox folded before Flop (didn't bet)
Seat 5: mariuka1 folded before Flop (didn't bet)
Seat 6: chiyuki folded before Flop (didn't bet)
Seat 7: 4plankton folded before Flop
Seat 8: GovGus folded before Flop
Seat 9: Tom1999 folded before Flop (didn't bet)



PokerStars Zoom Hand #84299821167:  Hold'em No Limit ($0.10/$0.25) - 2012/08/05 14:45:34 JST [2012/08/05 1:45:34 ET]
Table 'Whirlpool' 9-max Seat #1 is the button
Seat 1: deepakmbh ($28.66 in chips) 
Seat 2: Nagus3x ($21.83 in chips) 
Seat 3: pativyko ($19.19 in chips) 
Seat 4: tkd_joker ($24.30 in chips) 
Seat 5: bigred1102 ($21.36 in chips) 
Seat 6: cofla tito ($12.52 in chips) 
Seat 7: troublesomm ($25 in chips) 
Seat 8: chiyuki ($21.35 in chips) 
Seat 9: KeLevro0 ($11.50 in chips) 
Nagus3x: posts small blind $0.10
pativyko: posts big blind $0.25
*** HOLE CARDS ***
Dealt to chiyuki [Tc 4h]
tkd_joker: folds 
bigred1102: folds 
cofla tito: folds 
troublesomm: raises $0.25 to $0.50
chiyuki: folds 
KeLevro0: folds 
deepakmbh: folds 
Nagus3x: calls $0.40
pativyko: calls $0.25
*** FLOP *** [Qc Kc 2s]
Nagus3x: checks 
pativyko: checks 
troublesomm: checks 
*** TURN *** [Qc Kc 2s] [8s]
Nagus3x: bets $1.10
pativyko: folds 
troublesomm: folds 
Uncalled bet ($1.10) returned to Nagus3x
Nagus3x collected $1.43 from pot
Nagus3x: doesn't show hand 
*** SUMMARY ***
Total pot $1.50 | Rake $0.07 
Board [Qc Kc 2s 8s]
Seat 1: deepakmbh (button) folded before Flop (didn't bet)
Seat 2: Nagus3x (small blind) collected ($1.43)
Seat 3: pativyko (big blind) folded on the Turn
Seat 4: tkd_joker folded before Flop (didn't bet)
Seat 5: bigred1102 folded before Flop (didn't bet)
Seat 6: cofla tito folded before Flop (didn't bet)
Seat 7: troublesomm folded on the Turn
Seat 8: chiyuki folded before Flop (didn't bet)
Seat 9: KeLevro0 folded before Flop (didn't bet)



PokerStars Zoom Hand #84299825640:  Hold'em No Limit ($0.10/$0.25) - 2012/08/05 14:45:52 JST [2012/08/05 1:45:52 ET]
Table 'Whirlpool' 9-max Seat #1 is the button
Seat 1: 4ydo yogurt ($11.75 in chips) 
Seat 2: chiyuki ($21.35 in chips) 
Seat 3: cr0lox ($20.16 in chips) 
Seat 4: KrystalAA ($23.91 in chips) 
Seat 5: Perstenev ($13.97 in chips) 
Seat 6: ZhukOFFskI ($31.74 in chips) 
Seat 7: mjmichi ($26.25 in chips) 
Seat 8: Nerkit ($12.15 in chips) 
Seat 9: deepakmbh ($42.46 in chips) 
chiyuki: posts small blind $0.10
cr0lox: posts big blind $0.25
*** HOLE CARDS ***
Dealt to chiyuki [Jc Js]
KrystalAA: folds 
Perstenev: folds 
ZhukOFFskI: folds 
mjmichi: raises $0.50 to $0.75
Nerkit: folds 
deepakmbh: calls $0.75
4ydo yogurt: folds 
chiyuki: raises $2 to $2.75
cr0lox: folds 
mjmichi: folds 
deepakmbh: folds 
Uncalled bet ($2) returned to chiyuki
chiyuki collected $2.50 from pot
chiyuki: doesn't show hand 
*** SUMMARY ***
Total pot $2.50 | Rake $0 
Seat 1: 4ydo yogurt (button) folded before Flop (didn't bet)
Seat 2: chiyuki (small blind) collected ($2.50)
Seat 3: cr0lox (big blind) folded before Flop
Seat 4: KrystalAA folded before Flop (didn't bet)
Seat 5: Perstenev folded before Flop (didn't bet)
Seat 6: ZhukOFFskI folded before Flop (didn't bet)
Seat 7: mjmichi folded before Flop
Seat 8: Nerkit folded before Flop (didn't bet)
Seat 9: deepakmbh folded before Flop



PokerStars Zoom Hand #84299833683:  Hold'em No Limit ($0.10/$0.25) - 2012/08/05 14:46:26 JST [2012/08/05 1:46:26 ET]
Table 'Whirlpool' 9-max Seat #1 is the button
Seat 1: igor*gemert ($25.60 in chips) 
Seat 2: mariuka1 ($10.78 in chips) 
Seat 3: DanielWhyte ($49.54 in chips) 
Seat 4: Phaedrus...3 ($25.54 in chips) 
Seat 5: GovGus ($30.41 in chips) 
Seat 6: Nerkit ($11.31 in chips) 
Seat 7: chiyuki ($23.10 in chips) 
Seat 8: jacquelinewu ($36.91 in chips) 
Seat 9: Walturrr ($26.46 in chips) 
mariuka1: posts small blind $0.10
DanielWhyte: posts big blind $0.25
*** HOLE CARDS ***
Dealt to chiyuki [Kc 6d]
Phaedrus...3: folds 
GovGus: folds 
Nerkit: folds 
chiyuki: folds 
jacquelinewu: folds 
Walturrr: folds 
igor*gemert: folds 
mariuka1: folds 
Uncalled bet ($0.15) returned to DanielWhyte
DanielWhyte collected $0.20 from pot
DanielWhyte: doesn't show hand 
*** SUMMARY ***
Total pot $0.20 | Rake $0 
Seat 1: igor*gemert (button) folded before Flop (didn't bet)
Seat 2: mariuka1 (small blind) folded before Flop
Seat 3: DanielWhyte (big blind) collected ($0.20)
Seat 4: Phaedrus...3 folded before Flop (didn't bet)
Seat 5: GovGus folded before Flop (didn't bet)
Seat 6: Nerkit folded before Flop (didn't bet)
Seat 7: chiyuki folded before Flop (didn't bet)
Seat 8: jacquelinewu folded before Flop (didn't bet)
Seat 9: Walturrr folded before Flop (didn't bet)



PokerStars Zoom Hand #84299835664:  Hold'em No Limit ($0.10/$0.25) - 2012/08/05 14:46:34 JST [2012/08/05 1:46:34 ET]
Table 'Whirlpool' 9-max Seat #1 is the button
Seat 1: drunk_bender ($15.51 in chips) 
Seat 2: Cyanidoff ($25 in chips) 
Seat 3: mjmichi ($25.40 in chips) 
Seat 4: 4plankton ($27.81 in chips) 
Seat 5: chiyuki ($23.10 in chips) 
Seat 6: slapshot2011 ($34.12 in chips) 
Seat 7: pativyko ($18.69 in chips) 
Seat 8: Yogi707 ($21.29 in chips) 
Seat 9: Perstenev ($13.62 in chips) 
Cyanidoff: posts small blind $0.10
mjmichi: posts big blind $0.25
*** HOLE CARDS ***
Dealt to chiyuki [3c Kh]
4plankton: folds 
chiyuki: folds 
slapshot2011: folds 
pativyko: folds 
Yogi707: folds 
Perstenev: folds 
drunk_bender: folds 
Cyanidoff: folds 
Uncalled bet ($0.15) returned to mjmichi
mjmichi collected $0.20 from pot
mjmichi: doesn't show hand 
*** SUMMARY ***
Total pot $0.20 | Rake $0 
Seat 1: drunk_bender (button) folded before Flop (didn't bet)
Seat 2: Cyanidoff (small blind) folded before Flop
Seat 3: mjmichi (big blind) collected ($0.20)
Seat 4: 4plankton folded before Flop (didn't bet)
Seat 5: chiyuki folded before Flop (didn't bet)
Seat 6: slapshot2011 folded before Flop (didn't bet)
Seat 7: pativyko folded before Flop (didn't bet)
Seat 8: Yogi707 folded before Flop (didn't bet)
Seat 9: Perstenev folded before Flop (didn't bet)



PokerStars Zoom Hand #84299845716:  Hold'em No Limit ($0.10/$0.25) - 2012/08/05 14:47:16 JST [2012/08/05 1:47:16 ET]
Table 'Whirlpool' 9-max Seat #1 is the button
Seat 1: chiyuki ($22.85 in chips) 
Seat 2: led52 ($14.25 in chips) 
Seat 3: troublesomm ($25.35 in chips) 
Seat 4: jacquelinewu ($25.23 in chips) 
Seat 5: Nerkit ($9.70 in chips) 
Seat 6: pativyko ($18.59 in chips) 
Seat 7: Perstenev ($16.88 in chips) 
Seat 8: a_tasmanian ($29.73 in chips) 
Seat 9: 1Karina1 ($25 in chips) 
led52: posts small blind $0.10
troublesomm: posts big blind $0.25
*** HOLE CARDS ***
Dealt to chiyuki [3c 8s]
jacquelinewu: folds 
Nerkit: folds 
pativyko: folds 
Perstenev: folds 
a_tasmanian: folds 
1Karina1: folds 
chiyuki: folds 
led52: raises $0.50 to $0.75
troublesomm: folds 
Uncalled bet ($0.50) returned to led52
led52 collected $0.50 from pot
led52: doesn't show hand 
*** SUMMARY ***
Total pot $0.50 | Rake $0 
Seat 1: chiyuki (button) folded before Flop (didn't bet)
Seat 2: led52 (small blind) collected ($0.50)
Seat 3: troublesomm (big blind) folded before Flop
Seat 4: jacquelinewu folded before Flop (didn't bet)
Seat 5: Nerkit folded before Flop (didn't bet)
Seat 6: pativyko folded before Flop (didn't bet)
Seat 7: Perstenev folded before Flop (didn't bet)
Seat 8: a_tasmanian folded before Flop (didn't bet)
Seat 9: 1Karina1 folded before Flop (didn't bet)



PokerStars Zoom Hand #84299847450:  Hold'em No Limit ($0.10/$0.25) - 2012/08/05 14:47:23 JST [2012/08/05 1:47:23 ET]
Table 'Whirlpool' 9-max Seat #1 is the button
Seat 1: jacquelinewu ($29.91 in chips) 
Seat 2: Perstenev ($16.88 in chips) 
Seat 3: fuguangps ($25.88 in chips) 
Seat 4: Landybob ($34.76 in chips) 
Seat 5: chiyuki ($22.85 in chips) 
Seat 6: Ladyteazer ($30.09 in chips) 
Seat 7: ChrisCDee ($70.82 in chips) 
Seat 8: Sal y Limon1 ($25.43 in chips) 
Seat 9: Nerkit ($11.21 in chips) 
Perstenev: posts small blind $0.10
fuguangps: posts big blind $0.25
*** HOLE CARDS ***
Dealt to chiyuki [Ts 3c]
Landybob: folds 
chiyuki: folds 
Ladyteazer: folds 
ChrisCDee: raises $0.50 to $0.75
Sal y Limon1: folds 
Nerkit: folds 
jacquelinewu: raises $1.50 to $2.25
Perstenev: calls $2.15
fuguangps: folds 
ChrisCDee: folds 
*** FLOP *** [8h 4d 8s]
Perstenev: checks 
jacquelinewu: bets $2.50
Perstenev: calls $2.50
*** TURN *** [8h 4d 8s] [5c]
Perstenev: checks 
jacquelinewu: bets $6.50
Perstenev: raises $5.63 to $12.13 and is all-in
jacquelinewu: calls $5.63
*** RIVER *** [8h 4d 8s 5c] [9s]
*** SHOW DOWN ***
Perstenev: shows [Jh Jd] (two pair, Jacks and Eights)
jacquelinewu: shows [Kh Kc] (two pair, Kings and Eights)
jacquelinewu collected $33.20 from pot
*** SUMMARY ***
Total pot $34.76 | Rake $1.56 
Board [8h 4d 8s 5c 9s]
Seat 1: jacquelinewu (button) showed [Kh Kc] and won ($33.20) with two pair, Kings and Eights
Seat 2: Perstenev (small blind) showed [Jh Jd] and lost with two pair, Jacks and Eights
Seat 3: fuguangps (big blind) folded before Flop
Seat 4: Landybob folded before Flop (didn't bet)
Seat 5: chiyuki folded before Flop (didn't bet)
Seat 6: Ladyteazer folded before Flop (didn't bet)
Seat 7: ChrisCDee folded before Flop
Seat 8: Sal y Limon1 folded before Flop (didn't bet)
Seat 9: Nerkit folded before Flop (didn't bet)



PokerStars Zoom Hand #84299836428:  Hold'em No Limit ($0.10/$0.25) - 2012/08/05 14:46:37 JST [2012/08/05 1:46:37 ET]
Table 'Whirlpool' 9-max Seat #1 is the button
Seat 1: cr0lox ($19.81 in chips) 
Seat 2: deadmoneykid ($36.14 in chips) 
Seat 3: chiyuki ($23.10 in chips) 
Seat 4: seula i ($27.49 in chips) 
Seat 5: KrystalAA ($12.82 in chips) 
Seat 6: sparky5224 ($30.02 in chips) 
Seat 7: 1Karina1 ($31.02 in chips) 
Seat 8: led52 ($12.50 in chips) 
Seat 9: Dejacob ($29.57 in chips) 
deadmoneykid: posts small blind $0.10
chiyuki: posts big blind $0.25
*** HOLE CARDS ***
Dealt to chiyuki [9s Ah]
seula i: folds 
KrystalAA: folds 
sparky5224: calls $0.25
1Karina1: folds 
led52: folds 
Dejacob: raises $0.75 to $1
cr0lox: folds 
deadmoneykid: folds 
chiyuki: folds 
sparky5224: calls $0.75
*** FLOP *** [9c 9h 5c]
sparky5224: checks 
Dejacob: checks 
*** TURN *** [9c 9h 5c] [4s]
sparky5224: checks 
Dejacob: bets $2
sparky5224: calls $2
*** RIVER *** [9c 9h 5c 4s] [3h]
sparky5224: checks 
Dejacob: checks 
*** SHOW DOWN ***
sparky5224: shows [Jc Ad] (a pair of Nines)
Dejacob: mucks hand 
sparky5224 collected $6.06 from pot
*** SUMMARY ***
Total pot $6.35 | Rake $0.29 
Board [9c 9h 5c 4s 3h]
Seat 1: cr0lox (button) folded before Flop (didn't bet)
Seat 2: deadmoneykid (small blind) folded before Flop
Seat 3: chiyuki (big blind) folded before Flop
Seat 4: seula i folded before Flop (didn't bet)
Seat 5: KrystalAA folded before Flop (didn't bet)
Seat 6: sparky5224 showed [Jc Ad] and won ($6.06) with a pair of Nines
Seat 7: 1Karina1 folded before Flop (didn't bet)
Seat 8: led52 folded before Flop (didn't bet)
Seat 9: Dejacob mucked [Kd Js]



PokerStars Zoom Hand #84299848450:  Hold'em No Limit ($0.10/$0.25) - 2012/08/05 14:47:27 JST [2012/08/05 1:47:27 ET]
Table 'Whirlpool' 9-max Seat #1 is the button
Seat 1: gunbowler ($145.49 in chips) 
Seat 2: chiyuki ($22.85 in chips) 
Seat 3: snejokCoxx ($11.50 in chips) 
Seat 4: KrystalAA ($14.86 in chips) 
Seat 5: Vahe50 ($16.43 in chips) 
Seat 6: deadmoneykid ($25 in chips) 
Seat 7: Nagibator441 ($12.94 in chips) 
Seat 8: 1Karina1 ($44.89 in chips) 
Seat 9: a_tasmanian ($29.73 in chips) 
chiyuki: posts small blind $0.10
snejokCoxx: posts big blind $0.25
*** HOLE CARDS ***
Dealt to chiyuki [Ac 9h]
KrystalAA: folds 
Vahe50: folds 
deadmoneykid: folds 
Nagibator441: raises $0.50 to $0.75
1Karina1: calls $0.75
a_tasmanian: folds 
gunbowler: folds 
chiyuki: folds 
snejokCoxx: folds 
*** FLOP *** [6d Tc Qd]
Nagibator441: bets $1
1Karina1: folds 
Uncalled bet ($1) returned to Nagibator441
Nagibator441 collected $1.77 from pot
Nagibator441: doesn't show hand 
*** SUMMARY ***
Total pot $1.85 | Rake $0.08 
Board [6d Tc Qd]
Seat 1: gunbowler (button) folded before Flop (didn't bet)
Seat 2: chiyuki (small blind) folded before Flop
Seat 3: snejokCoxx (big blind) folded before Flop
Seat 4: KrystalAA folded before Flop (didn't bet)
Seat 5: Vahe50 folded before Flop (didn't bet)
Seat 6: deadmoneykid folded before Flop (didn't bet)
Seat 7: Nagibator441 collected ($1.77)
Seat 8: 1Karina1 folded on the Flop
Seat 9: a_tasmanian folded before Flop (didn't bet)



PokerStars Zoom Hand #84299855705:  Hold'em No Limit ($0.10/$0.25) - 2012/08/05 14:47:57 JST [2012/08/05 1:47:57 ET]
Table 'Whirlpool' 9-max Seat #1 is the button
Seat 1: Alvinpe85 ($44.82 in chips) 
Seat 2: ZhukOFFskI ($36 in chips) 
Seat 3: KrystalAA ($14.86 in chips) 
Seat 4: tkd_joker ($23.45 in chips) 
Seat 5: KeLevro0 ($12.25 in chips) 
Seat 6: BlOnDhOlIc ($92.01 in chips) 
Seat 7: silvno31 ($22.72 in chips) 
Seat 8: laurentzu84 ($25 in chips) 
Seat 9: chiyuki ($22.75 in chips) 
ZhukOFFskI: posts small blind $0.10
KrystalAA: posts big blind $0.25
*** HOLE CARDS ***
Dealt to chiyuki [3d 2s]
tkd_joker: folds 
KeLevro0: folds 
BlOnDhOlIc: folds 
silvno31: folds 
laurentzu84: raises $0.50 to $0.75
chiyuki: folds 
Alvinpe85: folds 
ZhukOFFskI: folds 
KrystalAA: folds 
Uncalled bet ($0.50) returned to laurentzu84
laurentzu84 collected $0.60 from pot
laurentzu84: doesn't show hand 
*** SUMMARY ***
Total pot $0.60 | Rake $0 
Seat 1: Alvinpe85 (button) folded before Flop (didn't bet)
Seat 2: ZhukOFFskI (small blind) folded before Flop
Seat 3: KrystalAA (big blind) folded before Flop
Seat 4: tkd_joker folded before Flop (didn't bet)
Seat 5: KeLevro0 folded before Flop (didn't bet)
Seat 6: BlOnDhOlIc folded before Flop (didn't bet)
Seat 7: silvno31 folded before Flop (didn't bet)
Seat 8: laurentzu84 collected ($0.60)
Seat 9: chiyuki folded before Flop (didn't bet)



PokerStars Zoom Hand #84299862083:  Hold'em No Limit ($0.10/$0.25) - 2012/08/05 14:48:23 JST [2012/08/05 1:48:23 ET]
Table 'Whirlpool' 9-max Seat #1 is the button
Seat 1: chiyuki ($22.75 in chips) 
Seat 2: hl77777 ($14.60 in chips) 
Seat 3: BlOnDhOlIc ($34.25 in chips) 
Seat 4: tribunpdm ($17.55 in chips) 
Seat 5: Dejacob ($26.47 in chips) 
Seat 6: ChrisCDee ($35.58 in chips) 
Seat 7: KeLevro0 ($12.15 in chips) 
Seat 8: Cyanidoff ($30.79 in chips) 
Seat 9: Phaedrus...3 ($25.16 in chips) 
hl77777: posts small blind $0.10
BlOnDhOlIc: posts big blind $0.25
*** HOLE CARDS ***
Dealt to chiyuki [3c Tc]
tribunpdm: folds 
Dejacob: folds 
ChrisCDee: folds 
KeLevro0: folds 
Cyanidoff: folds 
Phaedrus...3: folds 
chiyuki: raises $0.50 to $0.75
hl77777: folds 
BlOnDhOlIc: folds 
Uncalled bet ($0.50) returned to chiyuki
chiyuki collected $0.60 from pot
chiyuki: doesn't show hand 
*** SUMMARY ***
Total pot $0.60 | Rake $0 
Seat 1: chiyuki (button) collected ($0.60)
Seat 2: hl77777 (small blind) folded before Flop
Seat 3: BlOnDhOlIc (big blind) folded before Flop
Seat 4: tribunpdm folded before Flop (didn't bet)
Seat 5: Dejacob folded before Flop (didn't bet)
Seat 6: ChrisCDee folded before Flop (didn't bet)
Seat 7: KeLevro0 folded before Flop (didn't bet)
Seat 8: Cyanidoff folded before Flop (didn't bet)
Seat 9: Phaedrus...3 folded before Flop (didn't bet)



PokerStars Zoom Hand #84299857205:  Hold'em No Limit ($0.10/$0.25) - 2012/08/05 14:48:03 JST [2012/08/05 1:48:03 ET]
Table 'Whirlpool' 9-max Seat #1 is the button
Seat 1: DanielWhyte ($48.82 in chips) 
Seat 2: Nerkit ($11.31 in chips) 
Seat 3: mjmichi ($25.40 in chips) 
Seat 4: a_tasmanian ($29.48 in chips) 
Seat 5: KimPa39 ($24.50 in chips) 
Seat 6: BlOnDhOlIc ($36.86 in chips) 
Seat 7: cr0lox ($19.81 in chips) 
Seat 8: chiyuki ($22.75 in chips) 
Seat 9: tribunpdm ($17.65 in chips) 
Nerkit: posts small blind $0.10
mjmichi: posts big blind $0.25
*** HOLE CARDS ***
Dealt to chiyuki [8c 5s]
a_tasmanian: raises $0.50 to $0.75
KimPa39: folds 
BlOnDhOlIc: calls $0.75
cr0lox: calls $0.75
chiyuki: folds 
tribunpdm: folds 
DanielWhyte: folds 
Nerkit: folds 
mjmichi: folds 
*** FLOP *** [Td 6c 7h]
a_tasmanian: bets $2.25
BlOnDhOlIc: folds 
cr0lox: calls $2.25
*** TURN *** [Td 6c 7h] [Jc]
a_tasmanian: checks 
cr0lox: checks 
*** RIVER *** [Td 6c 7h Jc] [Ts]
a_tasmanian: bets $5
cr0lox: raises $11.81 to $16.81 and is all-in
a_tasmanian: calls $11.81
*** SHOW DOWN ***
cr0lox: shows [6d 6s] (a full house, Sixes full of Tens)
a_tasmanian: shows [Jd Js] (a full house, Jacks full of Tens)
a_tasmanian collected $38.89 from pot
*** SUMMARY ***
Total pot $40.72 | Rake $1.83 
Board [Td 6c 7h Jc Ts]
Seat 1: DanielWhyte (button) folded before Flop (didn't bet)
Seat 2: Nerkit (small blind) folded before Flop
Seat 3: mjmichi (big blind) folded before Flop
Seat 4: a_tasmanian showed [Jd Js] and won ($38.89) with a full house, Jacks full of Tens
Seat 5: KimPa39 folded before Flop (didn't bet)
Seat 6: BlOnDhOlIc folded on the Flop
Seat 7: cr0lox showed [6d 6s] and lost with a full house, Sixes full of Tens
Seat 8: chiyuki folded before Flop (didn't bet)
Seat 9: tribunpdm folded before Flop (didn't bet)



PokerStars Zoom Hand #84299870339:  Hold'em No Limit ($0.10/$0.25) - 2012/08/05 14:48:58 JST [2012/08/05 1:48:58 ET]
Table 'Whirlpool' 9-max Seat #1 is the button
Seat 1: mrvalet841 ($25.42 in chips) 
Seat 2: KimPa39 ($24.25 in chips) 
Seat 3: 4plankton ($27.08 in chips) 
Seat 4: chiyuki ($23.10 in chips) 
Seat 5: azizmimi ($8.46 in chips) 
Seat 6: troublesomm ($25 in chips) 
Seat 7: seula i ($39.14 in chips) 
Seat 8: fuguangps ($32.09 in chips) 
Seat 9: snejokCoxx ($12.25 in chips) 
KimPa39: posts small blind $0.10
4plankton: posts big blind $0.25
*** HOLE CARDS ***
Dealt to chiyuki [4h As]
chiyuki: folds 
azizmimi: folds 
troublesomm: folds 
seula i: folds 
fuguangps: folds 
snejokCoxx: folds 
mrvalet841: folds 
KimPa39: raises $0.50 to $0.75
4plankton: folds 
Uncalled bet ($0.50) returned to KimPa39
KimPa39 collected $0.50 from pot
KimPa39: doesn't show hand 
*** SUMMARY ***
Total pot $0.50 | Rake $0 
Seat 1: mrvalet841 (button) folded before Flop (didn't bet)
Seat 2: KimPa39 (small blind) collected ($0.50)
Seat 3: 4plankton (big blind) folded before Flop
Seat 4: chiyuki folded before Flop (didn't bet)
Seat 5: azizmimi folded before Flop (didn't bet)
Seat 6: troublesomm folded before Flop (didn't bet)
Seat 7: seula i folded before Flop (didn't bet)
Seat 8: fuguangps folded before Flop (didn't bet)
Seat 9: snejokCoxx folded before Flop (didn't bet)



PokerStars Zoom Hand #84299871791:  Hold'em No Limit ($0.10/$0.25) - 2012/08/05 14:49:04 JST [2012/08/05 1:49:04 ET]
Table 'Whirlpool' 9-max Seat #1 is the button
Seat 1: ChrisCDee ($71.09 in chips) 
Seat 2: Sal y Limon1 ($25.18 in chips) 
Seat 3: chiyuki ($23.10 in chips) 
Seat 4: Cyanidoff ($31.14 in chips) 
Seat 5: hl77777 ($10.97 in chips) 
Seat 6: rorfo23 ($22.74 in chips) 
Seat 7: azizmimi ($8.46 in chips) 
Seat 8: led52 ($12.40 in chips) 
Seat 9: mrvalet841 ($25.42 in chips) 
Sal y Limon1: posts small blind $0.10
chiyuki: posts big blind $0.25
*** HOLE CARDS ***
Dealt to chiyuki [Qd Ac]
Cyanidoff: folds 
hl77777: folds 
rorfo23: folds 
azizmimi: folds 
led52: folds 
mrvalet841: folds 
ChrisCDee: folds 
Sal y Limon1: folds 
Uncalled bet ($0.15) returned to chiyuki
chiyuki collected $0.20 from pot
chiyuki: doesn't show hand 
*** SUMMARY ***
Total pot $0.20 | Rake $0 
Seat 1: ChrisCDee (button) folded before Flop (didn't bet)
Seat 2: Sal y Limon1 (small blind) folded before Flop
Seat 3: chiyuki (big blind) collected ($0.20)
Seat 4: Cyanidoff folded before Flop (didn't bet)
Seat 5: hl77777 folded before Flop (didn't bet)
Seat 6: rorfo23 folded before Flop (didn't bet)
Seat 7: azizmimi folded before Flop (didn't bet)
Seat 8: led52 folded before Flop (didn't bet)
Seat 9: mrvalet841 folded before Flop (didn't bet)



PokerStars Zoom Hand #84299868644:  Hold'em No Limit ($0.10/$0.25) - 2012/08/05 14:48:51 JST [2012/08/05 1:48:51 ET]
Table 'Whirlpool' 9-max Seat #1 is the button
Seat 1: snejokCoxx ($12.25 in chips) 
Seat 2: Dan Royal ($44.82 in chips) 
Seat 3: Nerkit ($11.21 in chips) 
Seat 4: dushvan ($41.32 in chips) 
Seat 5: Dafleche ($14.30 in chips) 
Seat 6: Perstenev ($13.02 in chips) 
Seat 7: chiyuki ($23.10 in chips) 
Seat 8: DanielWhyte ($47.32 in chips) 
Seat 9: 1Karina1 ($29.02 in chips) 
Dan Royal: posts small blind $0.10
Nerkit: posts big blind $0.25
*** HOLE CARDS ***
Dealt to chiyuki [4h Tc]
dushvan: folds 
Dafleche: folds 
Perstenev: folds 
chiyuki: folds 
DanielWhyte: calls $0.25
1Karina1: folds 
snejokCoxx: folds 
Dan Royal: calls $0.15
Nerkit: checks 
*** FLOP *** [2c Ts 9h]
Dan Royal: checks 
Nerkit: checks 
DanielWhyte: checks 
*** TURN *** [2c Ts 9h] [Qd]
Dan Royal: checks 
Nerkit: checks 
DanielWhyte: checks 
*** RIVER *** [2c Ts 9h Qd] [9c]
Dan Royal: checks 
Nerkit: checks 
DanielWhyte: checks 
*** SHOW DOWN ***
Dan Royal: shows [2d Ac] (two pair, Nines and Deuces)
Nerkit: mucks hand 
DanielWhyte: mucks hand 
Dan Royal collected $0.72 from pot
*** SUMMARY ***
Total pot $0.75 | Rake $0.03 
Board [2c Ts 9h Qd 9c]
Seat 1: snejokCoxx (button) folded before Flop (didn't bet)
Seat 2: Dan Royal (small blind) showed [2d Ac] and won ($0.72) with two pair, Nines and Deuces
Seat 3: Nerkit (big blind) mucked [5d Jh]
Seat 4: dushvan folded before Flop (didn't bet)
Seat 5: Dafleche folded before Flop (didn't bet)
Seat 6: Perstenev folded before Flop (didn't bet)
Seat 7: chiyuki folded before Flop (didn't bet)
Seat 8: DanielWhyte mucked [2s 3s]
Seat 9: 1Karina1 folded before Flop (didn't bet)



PokerStars Zoom Hand #84299871061:  Hold'em No Limit ($0.10/$0.25) - 2012/08/05 14:49:01 JST [2012/08/05 1:49:01 ET]
Table 'Whirlpool' 9-max Seat #1 is the button
Seat 1: 1Karina1 ($28.92 in chips) 
Seat 2: softdesign ($63.55 in chips) 
Seat 3: Ellen1947 ($27.99 in chips) 
Seat 4: chiyuki ($23.10 in chips) 
Seat 5: ll_LaMeR_ll ($84.74 in chips) 
Seat 6: snejokCoxx ($11.15 in chips) 
Seat 7: Wilcox76607 ($31.96 in chips) 
Seat 8: wildy29 ($15 in chips) 
Seat 9: ZhukOFFskI ($28.03 in chips) 
softdesign: posts small blind $0.10
Ellen1947: posts big blind $0.25
*** HOLE CARDS ***
Dealt to chiyuki [Th Qh]
chiyuki: folds 
ll_LaMeR_ll: raises $0.50 to $0.75
snejokCoxx: folds 
Wilcox76607: folds 
wildy29: calls $0.75
ZhukOFFskI: folds 
1Karina1: folds 
softdesign: calls $0.65
Ellen1947: folds 
*** FLOP *** [8h 2s Kc]
softdesign: checks 
ll_LaMeR_ll: bets $1.25
wildy29: folds 
softdesign: folds 
Uncalled bet ($1.25) returned to ll_LaMeR_ll
ll_LaMeR_ll collected $2.39 from pot
ll_LaMeR_ll: doesn't show hand 
*** SUMMARY ***
Total pot $2.50 | Rake $0.11 
Board [8h 2s Kc]
Seat 1: 1Karina1 (button) folded before Flop (didn't bet)
Seat 2: softdesign (small blind) folded on the Flop
Seat 3: Ellen1947 (big blind) folded before Flop
Seat 4: chiyuki folded before Flop (didn't bet)
Seat 5: ll_LaMeR_ll collected ($2.39)
Seat 6: snejokCoxx folded before Flop (didn't bet)
Seat 7: Wilcox76607 folded before Flop (didn't bet)
Seat 8: wildy29 folded on the Flop
Seat 9: ZhukOFFskI folded before Flop (didn't bet)



PokerStars Zoom Hand #84299874309:  Hold'em No Limit ($0.10/$0.25) - 2012/08/05 14:49:14 JST [2012/08/05 1:49:14 ET]
Table 'Whirlpool' 9-max Seat #1 is the button
Seat 1: snejokCoxx ($11.15 in chips) 
Seat 2: edilson_ita ($23.24 in chips) 
Seat 3: ZhukOFFskI ($28.16 in chips) 
Seat 4: pativyko ($14.69 in chips) 
Seat 5: Nerkit ($17.48 in chips) 
Seat 6: chiyuki ($23.20 in chips) 
Seat 7: 1Karina1 ($28.92 in chips) 
Seat 8: led52 ($11.80 in chips) 
Seat 9: Alvinpe85 ($48.46 in chips) 
edilson_ita: posts small blind $0.10
ZhukOFFskI: posts big blind $0.25
*** HOLE CARDS ***
Dealt to chiyuki [2s Jd]
pativyko: raises $0.50 to $0.75
Nerkit: folds 
chiyuki: folds 
1Karina1: folds 
led52: folds 
Alvinpe85: folds 
snejokCoxx: folds 
edilson_ita: folds 
ZhukOFFskI: folds 
Uncalled bet ($0.50) returned to pativyko
pativyko collected $0.60 from pot
pativyko: doesn't show hand 
*** SUMMARY ***
Total pot $0.60 | Rake $0 
Seat 1: snejokCoxx (button) folded before Flop (didn't bet)
Seat 2: edilson_ita (small blind) folded before Flop
Seat 3: ZhukOFFskI (big blind) folded before Flop
Seat 4: pativyko collected ($0.60)
Seat 5: Nerkit folded before Flop (didn't bet)
Seat 6: chiyuki folded before Flop (didn't bet)
Seat 7: 1Karina1 folded before Flop (didn't bet)
Seat 8: led52 folded before Flop (didn't bet)
Seat 9: Alvinpe85 folded before Flop (didn't bet)



PokerStars Zoom Hand #84299876765:  Hold'em No Limit ($0.10/$0.25) - 2012/08/05 14:49:24 JST [2012/08/05 1:49:24 ET]
Table 'Whirlpool' 9-max Seat #1 is the button
Seat 1: mjmichi ($30.19 in chips) 
Seat 2: chiyuki ($23.20 in chips) 
Seat 3: phate-1up ($29.83 in chips) 
Seat 4: Ladyteazer ($29.84 in chips) 
Seat 5: DonSimonUsa ($27.69 in chips) 
Seat 6: Tom1999 ($18.13 in chips) 
Seat 7: KeLevro0 ($14.38 in chips) 
Seat 8: deepakmbh ($38.27 in chips) 
Seat 9: cofla tito ($9.49 in chips) 
chiyuki: posts small blind $0.10
phate-1up: posts big blind $0.25
*** HOLE CARDS ***
Dealt to chiyuki [7s 6s]
Ladyteazer: folds 
DonSimonUsa: folds 
Tom1999: folds 
KeLevro0: raises $0.42 to $0.67
deepakmbh: folds 
cofla tito: folds 
mjmichi: folds 
chiyuki: folds 
phate-1up: folds 
Uncalled bet ($0.42) returned to KeLevro0
KeLevro0 collected $0.60 from pot
KeLevro0: doesn't show hand 
*** SUMMARY ***
Total pot $0.60 | Rake $0 
Seat 1: mjmichi (button) folded before Flop (didn't bet)
Seat 2: chiyuki (small blind) folded before Flop
Seat 3: phate-1up (big blind) folded before Flop
Seat 4: Ladyteazer folded before Flop (didn't bet)
Seat 5: DonSimonUsa folded before Flop (didn't bet)
Seat 6: Tom1999 folded before Flop (didn't bet)
Seat 7: KeLevro0 collected ($0.60)
Seat 8: deepakmbh folded before Flop (didn't bet)
Seat 9: cofla tito folded before Flop (didn't bet)



PokerStars Zoom Hand #84299879609:  Hold'em No Limit ($0.10/$0.25) - 2012/08/05 14:49:37 JST [2012/08/05 1:49:37 ET]
Table 'Whirlpool' 9-max Seat #1 is the button
Seat 1: Walturrr ($35.46 in chips) 
Seat 2: Nerkit ($10.96 in chips) 
Seat 3: ZhukOFFskI ($28.03 in chips) 
Seat 4: chiyuki ($23.10 in chips) 
Seat 5: Tom1999 ($25.29 in chips) 
Seat 6: Ellen1947 ($28.96 in chips) 
Seat 7: snejokCoxx ($12.50 in chips) 
Seat 8: Ladyteazer ($29.74 in chips) 
Seat 9: Perstenev ($12.02 in chips) 
Nerkit: posts small blind $0.10
ZhukOFFskI: posts big blind $0.25
*** HOLE CARDS ***
Dealt to chiyuki [Js Qd]
chiyuki: folds 
Tom1999: folds 
Ellen1947: folds 
snejokCoxx: folds 
Ladyteazer: folds 
Perstenev: folds 
Walturrr: folds 
Nerkit: folds 
Uncalled bet ($0.15) returned to ZhukOFFskI
ZhukOFFskI collected $0.20 from pot
ZhukOFFskI: doesn't show hand 
*** SUMMARY ***
Total pot $0.20 | Rake $0 
Seat 1: Walturrr (button) folded before Flop (didn't bet)
Seat 2: Nerkit (small blind) folded before Flop
Seat 3: ZhukOFFskI (big blind) collected ($0.20)
Seat 4: chiyuki folded before Flop (didn't bet)
Seat 5: Tom1999 folded before Flop (didn't bet)
Seat 6: Ellen1947 folded before Flop (didn't bet)
Seat 7: snejokCoxx folded before Flop (didn't bet)
Seat 8: Ladyteazer folded before Flop (didn't bet)
Seat 9: Perstenev folded before Flop (didn't bet)



PokerStars Zoom Hand #84299875773:  Hold'em No Limit ($0.10/$0.25) - 2012/08/05 14:49:20 JST [2012/08/05 1:49:20 ET]
Table 'Whirlpool' 9-max Seat #1 is the button
Seat 1: gunbowler ($144.39 in chips) 
Seat 2: Alvinpe85 ($48.46 in chips) 
Seat 3: Landybob ($35.11 in chips) 
Seat 4: troublesomm ($25 in chips) 
Seat 5: ChrisCDee ($71.09 in chips) 
Seat 6: KeLevro0 ($11.90 in chips) 
Seat 7: edilson_ita ($23.14 in chips) 
Seat 8: deadmoneykid ($29.85 in chips) 
Seat 9: chiyuki ($23.20 in chips) 
Alvinpe85: posts small blind $0.10
Landybob: posts big blind $0.25
*** HOLE CARDS ***
Dealt to chiyuki [Ks 9s]
troublesomm: folds 
ChrisCDee: folds 
KeLevro0: folds 
edilson_ita: folds 
deadmoneykid: folds 
chiyuki: folds 
gunbowler: raises $0.50 to $0.75
Alvinpe85: calls $0.65
Landybob: folds 
*** FLOP *** [2s 2d 6s]
Alvinpe85: checks 
gunbowler: bets $1
Alvinpe85: raises $2 to $3
gunbowler: folds 
Uncalled bet ($2) returned to Alvinpe85
Alvinpe85 collected $3.58 from pot
Alvinpe85: doesn't show hand 
*** SUMMARY ***
Total pot $3.75 | Rake $0.17 
Board [2s 2d 6s]
Seat 1: gunbowler (button) folded on the Flop
Seat 2: Alvinpe85 (small blind) collected ($3.58)
Seat 3: Landybob (big blind) folded before Flop
Seat 4: troublesomm folded before Flop (didn't bet)
Seat 5: ChrisCDee folded before Flop (didn't bet)
Seat 6: KeLevro0 folded before Flop (didn't bet)
Seat 7: edilson_ita folded before Flop (didn't bet)
Seat 8: deadmoneykid folded before Flop (didn't bet)
Seat 9: chiyuki folded before Flop (didn't bet)



PokerStars Zoom Hand #84299886197:  Hold'em No Limit ($0.10/$0.25) - 2012/08/05 14:50:03 JST [2012/08/05 1:50:03 ET]
Table 'Whirlpool' 9-max Seat #1 is the button
Seat 1: DanielWhyte ($46.72 in chips) 
Seat 2: Walturrr ($27.15 in chips) 
Seat 3: chiyuki ($23.10 in chips) 
Seat 4: Dejacob ($26.47 in chips) 
Seat 5: phate-1up ($25.35 in chips) 
Seat 6: deadmoneykid ($27.92 in chips) 
Seat 7: 1Karina1 ($25 in chips) 
Seat 8: BlOnDhOlIc ($87.56 in chips) 
Seat 9: yane73 ($39.16 in chips) 
Walturrr: posts small blind $0.10
chiyuki: posts big blind $0.25
*** HOLE CARDS ***
Dealt to chiyuki [8s Ad]
Dejacob: folds 
phate-1up: folds 
deadmoneykid: folds 
1Karina1: folds 
BlOnDhOlIc: folds 
yane73: folds 
DanielWhyte: folds 
Walturrr: folds 
Uncalled bet ($0.15) returned to chiyuki
chiyuki collected $0.20 from pot
chiyuki: doesn't show hand 
*** SUMMARY ***
Total pot $0.20 | Rake $0 
Seat 1: DanielWhyte (button) folded before Flop (didn't bet)
Seat 2: Walturrr (small blind) folded before Flop
Seat 3: chiyuki (big blind) collected ($0.20)
Seat 4: Dejacob folded before Flop (didn't bet)
Seat 5: phate-1up folded before Flop (didn't bet)
Seat 6: deadmoneykid folded before Flop (didn't bet)
Seat 7: 1Karina1 folded before Flop (didn't bet)
Seat 8: BlOnDhOlIc folded before Flop (didn't bet)
Seat 9: yane73 folded before Flop (didn't bet)



PokerStars Zoom Hand #84299882306:  Hold'em No Limit ($0.10/$0.25) - 2012/08/05 14:49:48 JST [2012/08/05 1:49:48 ET]
Table 'Whirlpool' 9-max Seat #1 is the button
Seat 1: Landybob ($34.76 in chips) 
Seat 2: GovGus ($30.49 in chips) 
Seat 3: Nerkit ($9.60 in chips) 
Seat 4: chiyuki ($23.10 in chips) 
Seat 5: 1Karina1 ($28.92 in chips) 
Seat 6: KimPa39 ($24.85 in chips) 
Seat 7: Walturrr ($29.95 in chips) 
Seat 8: phate-1up ($29.58 in chips) 
Seat 9: led52 ($15.85 in chips) 
GovGus: posts small blind $0.10
Nerkit: posts big blind $0.25
*** HOLE CARDS ***
Dealt to chiyuki [Ad 3h]
chiyuki: folds 
1Karina1: folds 
KimPa39: raises $0.50 to $0.75
Walturrr: folds 
phate-1up: folds 
led52: folds 
Landybob: folds 
GovGus: calls $0.65
Nerkit: calls $0.50
*** FLOP *** [Qc 2h 7d]
GovGus: checks 
Nerkit: checks 
KimPa39: checks 
*** TURN *** [Qc 2h 7d] [4c]
GovGus: checks 
Nerkit: checks 
KimPa39: checks 
*** RIVER *** [Qc 2h 7d 4c] [9s]
GovGus: checks 
Nerkit: checks 
KimPa39: checks 
*** SHOW DOWN ***
GovGus: shows [Kd Td] (high card King)
Nerkit: shows [3d 3s] (a pair of Threes)
KimPa39: mucks hand 
Nerkit collected $2.15 from pot
*** SUMMARY ***
Total pot $2.25 | Rake $0.10 
Board [Qc 2h 7d 4c 9s]
Seat 1: Landybob (button) folded before Flop (didn't bet)
Seat 2: GovGus (small blind) showed [Kd Td] and lost with high card King
Seat 3: Nerkit (big blind) showed [3d 3s] and won ($2.15) with a pair of Threes
Seat 4: chiyuki folded before Flop (didn't bet)
Seat 5: 1Karina1 folded before Flop (didn't bet)
Seat 6: KimPa39 mucked [As Jh]
Seat 7: Walturrr folded before Flop (didn't bet)
Seat 8: phate-1up folded before Flop (didn't bet)
Seat 9: led52 folded before Flop (didn't bet)



PokerStars Zoom Hand #84299881078:  Hold'em No Limit ($0.10/$0.25) - 2012/08/05 14:49:43 JST [2012/08/05 1:49:43 ET]
Table 'Whirlpool' 9-max Seat #1 is the button
Seat 1: snejokCoxx ($12.15 in chips) 
Seat 2: DanielWhyte ($46.82 in chips) 
Seat 3: Sal y Limon1 ($25.88 in chips) 
Seat 4: BlOnDhOlIc ($79.92 in chips) 
Seat 5: Perstenev ($12.37 in chips) 
Seat 6: hirozo ($40.15 in chips) 
Seat 7: mjmichi ($30.19 in chips) 
Seat 8: chiyuki ($23.10 in chips) 
Seat 9: ZhukOFFskI ($27.81 in chips) 
DanielWhyte: posts small blind $0.10
Sal y Limon1: posts big blind $0.25
*** HOLE CARDS ***
Dealt to chiyuki [8s 5c]
BlOnDhOlIc: folds 
Perstenev: folds 
hirozo: folds 
mjmichi: raises $0.50 to $0.75
chiyuki: folds 
ZhukOFFskI: folds 
snejokCoxx: folds 
DanielWhyte: folds 
Sal y Limon1: calls $0.50
*** FLOP *** [Jc 2c Kd]
Sal y Limon1: checks 
mjmichi: bets $1.25
Sal y Limon1: calls $1.25
*** TURN *** [Jc 2c Kd] [Th]
Sal y Limon1: checks 
mjmichi: bets $2.75
Sal y Limon1: calls $2.75
*** RIVER *** [Jc 2c Kd Th] [9s]
Sal y Limon1: checks 
mjmichi: checks 
*** SHOW DOWN ***
Sal y Limon1: shows [Kh Ac] (a pair of Kings)
mjmichi: mucks hand 
Sal y Limon1 collected $9.17 from pot
*** SUMMARY ***
Total pot $9.60 | Rake $0.43 
Board [Jc 2c Kd Th 9s]
Seat 1: snejokCoxx (button) folded before Flop (didn't bet)
Seat 2: DanielWhyte (small blind) folded before Flop
Seat 3: Sal y Limon1 (big blind) showed [Kh Ac] and won ($9.17) with a pair of Kings
Seat 4: BlOnDhOlIc folded before Flop (didn't bet)
Seat 5: Perstenev folded before Flop (didn't bet)
Seat 6: hirozo folded before Flop (didn't bet)
Seat 7: mjmichi mucked [Ad Jd]
Seat 8: chiyuki folded before Flop (didn't bet)
Seat 9: ZhukOFFskI folded before Flop (didn't bet)



PokerStars Zoom Hand #84299878427:  Hold'em No Limit ($0.10/$0.25) - 2012/08/05 14:49:31 JST [2012/08/05 1:49:31 ET]
Table 'Whirlpool' 9-max Seat #1 is the button
Seat 1: ttjppy ($26.08 in chips) 
Seat 2: hl77777 ($10.97 in chips) 
Seat 3: DanielWhyte ($47.07 in chips) 
Seat 4: Nerkit ($17.48 in chips) 
Seat 5: DonSimonUsa ($27.69 in chips) 
Seat 6: azizmimi ($8.56 in chips) 
Seat 7: chiyuki ($23.10 in chips) 
Seat 8: KrystalAA ($14.86 in chips) 
Seat 9: led52 ($12.40 in chips) 
hl77777: posts small blind $0.10
DanielWhyte: posts big blind $0.25
*** HOLE CARDS ***
Dealt to chiyuki [4s 8d]
Nerkit: folds 
DonSimonUsa: folds 
azizmimi: raises $0.75 to $1
chiyuki: folds 
KrystalAA: folds 
led52: calls $1
ttjppy: calls $1
hl77777: raises $4 to $5
DanielWhyte: folds 
azizmimi: raises $3.56 to $8.56 and is all-in
led52: folds 
ttjppy: calls $7.56
hl77777: calls $3.56
*** FLOP *** [2c 6h Js]
hl77777: bets $2.41 and is all-in
ttjppy: calls $2.41
*** TURN *** [2c 6h Js] [2d]
*** RIVER *** [2c 6h Js 2d] [Jd]
*** SHOW DOWN ***
hl77777: shows [Ad Qh] (two pair, Jacks and Deuces)
ttjppy: shows [Tc Qd] (two pair, Jacks and Deuces - lower kicker)
hl77777 collected $4.60 from side pot
azizmimi: shows [As Ks] (two pair, Jacks and Deuces)
hl77777 collected $12.86 from main pot
azizmimi collected $12.86 from main pot
*** SUMMARY ***
Total pot $31.75 Main pot $25.72. Side pot $4.60. | Rake $1.43 
Board [2c 6h Js 2d Jd]
Seat 1: ttjppy (button) showed [Tc Qd] and lost with two pair, Jacks and Deuces
Seat 2: hl77777 (small blind) showed [Ad Qh] and won ($17.46) with two pair, Jacks and Deuces
Seat 3: DanielWhyte (big blind) folded before Flop
Seat 4: Nerkit folded before Flop (didn't bet)
Seat 5: DonSimonUsa folded before Flop (didn't bet)
Seat 6: azizmimi showed [As Ks] and won ($12.86) with two pair, Jacks and Deuces
Seat 7: chiyuki folded before Flop (didn't bet)
Seat 8: KrystalAA folded before Flop (didn't bet)
Seat 9: led52 folded before Flop



PokerStars Zoom Hand #84299883271:  Hold'em No Limit ($0.10/$0.25) - 2012/08/05 14:49:52 JST [2012/08/05 1:49:52 ET]
Table 'Whirlpool' 9-max Seat #1 is the button
Seat 1: chiyuki ($23.10 in chips) 
Seat 2: mrvalet841 ($25.17 in chips) 
Seat 3: Tom1999 ($25.29 in chips) 
Seat 4: BlOnDhOlIc ($79.92 in chips) 
Seat 5: Phaedrus...3 ($25 in chips) 
Seat 6: 1Karina1 ($25 in chips) 
Seat 7: DanielWhyte ($46.72 in chips) 
Seat 8: HighDuka ($27.39 in chips) 
Seat 9: 4plankton ($26.73 in chips) 
mrvalet841: posts small blind $0.10
Tom1999: posts big blind $0.25
*** HOLE CARDS ***
Dealt to chiyuki [Jc 8d]
BlOnDhOlIc: folds 
Phaedrus...3: folds 
1Karina1: folds 
DanielWhyte: folds 
HighDuka: folds 
4plankton: calls $0.25
chiyuki: folds 
mrvalet841: folds 
Tom1999: raises $0.50 to $0.75
4plankton: calls $0.50
*** FLOP *** [Qc Ac 8h]
Tom1999: bets $0.75
4plankton: calls $0.75
*** TURN *** [Qc Ac 8h] [9h]
Tom1999: bets $0.75
4plankton: raises $0.75 to $1.50
Tom1999: calls $0.75
*** RIVER *** [Qc Ac 8h 9h] [Kc]
Tom1999: bets $0.75
4plankton: calls $0.75
*** SHOW DOWN ***
Tom1999: shows [Qd Jh] (a pair of Queens)
4plankton: shows [Ad Ks] (two pair, Aces and Kings)
4plankton collected $7.26 from pot
*** SUMMARY ***
Total pot $7.60 | Rake $0.34 
Board [Qc Ac 8h 9h Kc]
Seat 1: chiyuki (button) folded before Flop (didn't bet)
Seat 2: mrvalet841 (small blind) folded before Flop
Seat 3: Tom1999 (big blind) showed [Qd Jh] and lost with a pair of Queens
Seat 4: BlOnDhOlIc folded before Flop (didn't bet)
Seat 5: Phaedrus...3 folded before Flop (didn't bet)
Seat 6: 1Karina1 folded before Flop (didn't bet)
Seat 7: DanielWhyte folded before Flop (didn't bet)
Seat 8: HighDuka folded before Flop (didn't bet)
Seat 9: 4plankton showed [Ad Ks] and won ($7.26) with two pair, Aces and Kings



PokerStars Zoom Hand #84299892866:  Hold'em No Limit ($0.10/$0.25) - 2012/08/05 14:50:30 JST [2012/08/05 1:50:30 ET]
Table 'Whirlpool' 9-max Seat #1 is the button
Seat 1: ChrisCDee ($70.84 in chips) 
Seat 2: Wilcox76607 ($38.41 in chips) 
Seat 3: phate-1up ($25.35 in chips) 
Seat 4: KrystalAA ($29.39 in chips) 
Seat 5: Landybob ($34.41 in chips) 
Seat 6: mjmichi ($42.05 in chips) 
Seat 7: ZhukOFFskI ($28.81 in chips) 
Seat 8: seula i ($29.78 in chips) 
Seat 9: chiyuki ($23.20 in chips) 
Wilcox76607: posts small blind $0.10
phate-1up: posts big blind $0.25
*** HOLE CARDS ***
Dealt to chiyuki [4h Qh]
KrystalAA: folds 
Landybob: folds 
mjmichi: folds 
ZhukOFFskI: folds 
seula i: raises $0.50 to $0.75
chiyuki: folds 
ChrisCDee: folds 
Wilcox76607: folds 
phate-1up: folds 
Uncalled bet ($0.50) returned to seula i
seula i collected $0.60 from pot
seula i: doesn't show hand 
*** SUMMARY ***
Total pot $0.60 | Rake $0 
Seat 1: ChrisCDee (button) folded before Flop (didn't bet)
Seat 2: Wilcox76607 (small blind) folded before Flop
Seat 3: phate-1up (big blind) folded before Flop
Seat 4: KrystalAA folded before Flop (didn't bet)
Seat 5: Landybob folded before Flop (didn't bet)
Seat 6: mjmichi folded before Flop (didn't bet)
Seat 7: ZhukOFFskI folded before Flop (didn't bet)
Seat 8: seula i collected ($0.60)
Seat 9: chiyuki folded before Flop (didn't bet)



PokerStars Zoom Hand #84299891852:  Hold'em No Limit ($0.10/$0.25) - 2012/08/05 14:50:26 JST [2012/08/05 1:50:26 ET]
Table 'Whirlpool' 9-max Seat #1 is the button
Seat 1: phate-1up ($46.09 in chips) 
Seat 2: Landybob ($34.51 in chips) 
Seat 3: 1Karina1 ($25 in chips) 
Seat 4: GovGus ($25 in chips) 
Seat 5: chiyuki ($23.20 in chips) 
Seat 6: pativyko ($15.04 in chips) 
Seat 7: snejokCoxx ($13.96 in chips) 
Seat 8: hirozo ($25 in chips) 
Seat 9: ZhukOFFskI ($28.81 in chips) 
Landybob: posts small blind $0.10
1Karina1: posts big blind $0.25
*** HOLE CARDS ***
Dealt to chiyuki [Ts 3s]
GovGus: folds 
chiyuki: folds 
pativyko: folds 
snejokCoxx: folds 
hirozo: raises $0.50 to $0.75
ZhukOFFskI: folds 
phate-1up: folds 
Landybob: folds 
1Karina1: folds 
Uncalled bet ($0.50) returned to hirozo
hirozo collected $0.60 from pot
hirozo: doesn't show hand 
*** SUMMARY ***
Total pot $0.60 | Rake $0 
Seat 1: phate-1up (button) folded before Flop (didn't bet)
Seat 2: Landybob (small blind) folded before Flop
Seat 3: 1Karina1 (big blind) folded before Flop
Seat 4: GovGus folded before Flop (didn't bet)
Seat 5: chiyuki folded before Flop (didn't bet)
Seat 6: pativyko folded before Flop (didn't bet)
Seat 7: snejokCoxx folded before Flop (didn't bet)
Seat 8: hirozo collected ($0.60)
Seat 9: ZhukOFFskI folded before Flop (didn't bet)



PokerStars Zoom Hand #84299895594:  Hold'em No Limit ($0.10/$0.25) - 2012/08/05 14:50:41 JST [2012/08/05 1:50:41 ET]
Table 'Whirlpool' 9-max Seat #1 is the button
Seat 1: jacquelinewu ($42.46 in chips) 
Seat 2: silvno31 ($24.80 in chips) 
Seat 3: 4plankton ($30.24 in chips) 
Seat 4: Nerkit ($10.24 in chips) 
Seat 5: Cyanidoff ($25.78 in chips) 
Seat 6: chiyuki ($23.20 in chips) 
Seat 7: Landybob ($34.41 in chips) 
Seat 8: azizmimi ($12.86 in chips) 
Seat 9: hl77777 ($17.46 in chips) 
silvno31: posts small blind $0.10
4plankton: posts big blind $0.25
*** HOLE CARDS ***
Dealt to chiyuki [Kd Qh]
Nerkit: folds 
Cyanidoff: folds 
chiyuki: raises $0.50 to $0.75
Landybob: folds 
azizmimi: folds 
hl77777: folds 
jacquelinewu: folds 
silvno31: folds 
4plankton: folds 
Uncalled bet ($0.50) returned to chiyuki
chiyuki collected $0.60 from pot
chiyuki: doesn't show hand 
*** SUMMARY ***
Total pot $0.60 | Rake $0 
Seat 1: jacquelinewu (button) folded before Flop (didn't bet)
Seat 2: silvno31 (small blind) folded before Flop
Seat 3: 4plankton (big blind) folded before Flop
Seat 4: Nerkit folded before Flop (didn't bet)
Seat 5: Cyanidoff folded before Flop (didn't bet)
Seat 6: chiyuki collected ($0.60)
Seat 7: Landybob folded before Flop (didn't bet)
Seat 8: azizmimi folded before Flop (didn't bet)
Seat 9: hl77777 folded before Flop (didn't bet)



PokerStars Zoom Hand #84299900048:  Hold'em No Limit ($0.10/$0.25) - 2012/08/05 14:51:00 JST [2012/08/05 1:51:00 ET]
Table 'Whirlpool' 9-max Seat #1 is the button
Seat 1: DanielWhyte ($46.72 in chips) 
Seat 2: chiyuki ($23.55 in chips) 
Seat 3: Tom1999 ($18.13 in chips) 
Seat 4: 1Karina1 ($25 in chips) 
Seat 5: cofla tito ($9.24 in chips) 
Seat 6: KimPa39 ($23.45 in chips) 
Seat 7: Lars111 ($30.34 in chips) 
Seat 8: Landybob ($34.41 in chips) 
Seat 9: snejokCoxx ($12 in chips) 
chiyuki: posts small blind $0.10
Tom1999: posts big blind $0.25
*** HOLE CARDS ***
Dealt to chiyuki [Qc 9c]
1Karina1: folds 
cofla tito: folds 
KimPa39: folds 
Lars111: folds 
Landybob: folds 
snejokCoxx: folds 
DanielWhyte: folds 
chiyuki: raises $0.50 to $0.75
Tom1999: raises $1 to $1.75
chiyuki: calls $1
*** FLOP *** [Jd 8h 6s]
chiyuki: checks 
Tom1999: bets $1.25
chiyuki: calls $1.25
*** TURN *** [Jd 8h 6s] [Jc]
chiyuki: checks 
Tom1999: bets $2.25
chiyuki: folds 
Uncalled bet ($2.25) returned to Tom1999
Tom1999 collected $5.73 from pot
Tom1999: doesn't show hand 
*** SUMMARY ***
Total pot $6 | Rake $0.27 
Board [Jd 8h 6s Jc]
Seat 1: DanielWhyte (button) folded before Flop (didn't bet)
Seat 2: chiyuki (small blind) folded on the Turn
Seat 3: Tom1999 (big blind) collected ($5.73)
Seat 4: 1Karina1 folded before Flop (didn't bet)
Seat 5: cofla tito folded before Flop (didn't bet)
Seat 6: KimPa39 folded before Flop (didn't bet)
Seat 7: Lars111 folded before Flop (didn't bet)
Seat 8: Landybob folded before Flop (didn't bet)
Seat 9: snejokCoxx folded before Flop (didn't bet)



PokerStars Zoom Hand #84299919510:  Hold'em No Limit ($0.10/$0.25) - 2012/08/05 14:52:19 JST [2012/08/05 1:52:19 ET]
Table 'Whirlpool' 9-max Seat #1 is the button
Seat 1: mjmichi ($25.44 in chips) 
Seat 2: troublesomm ($25.10 in chips) 
Seat 3: GovGus ($35.40 in chips) 
Seat 4: KeLevro0 ($11.90 in chips) 
Seat 5: silvno31 ($23.85 in chips) 
Seat 6: chiyuki ($20.55 in chips) 
Seat 7: seula i ($114.61 in chips) 
Seat 8: 4plankton ($29.39 in chips) 
Seat 9: led52 ($14.84 in chips) 
troublesomm: posts small blind $0.10
GovGus: posts big blind $0.25
*** HOLE CARDS ***
Dealt to chiyuki [Kh 6c]
KeLevro0: folds 
silvno31: raises $0.50 to $0.75
chiyuki: folds 
seula i: calls $0.75
4plankton: folds 
led52: folds 
mjmichi: folds 
troublesomm: folds 
GovGus: folds 
*** FLOP *** [Tc Jd 2d]
silvno31: bets $1.25
seula i: folds 
Uncalled bet ($1.25) returned to silvno31
silvno31 collected $1.77 from pot
silvno31: doesn't show hand 
*** SUMMARY ***
Total pot $1.85 | Rake $0.08 
Board [Tc Jd 2d]
Seat 1: mjmichi (button) folded before Flop (didn't bet)
Seat 2: troublesomm (small blind) folded before Flop
Seat 3: GovGus (big blind) folded before Flop
Seat 4: KeLevro0 folded before Flop (didn't bet)
Seat 5: silvno31 collected ($1.77)
Seat 6: chiyuki folded before Flop (didn't bet)
Seat 7: seula i folded on the Flop
Seat 8: 4plankton folded before Flop (didn't bet)
Seat 9: led52 folded before Flop (didn't bet)



PokerStars Zoom Hand #84299920739:  Hold'em No Limit ($0.10/$0.25) - 2012/08/05 14:52:24 JST [2012/08/05 1:52:24 ET]
Table 'Whirlpool' 9-max Seat #1 is the button
Seat 1: tribunpdm ($28.02 in chips) 
Seat 2: 4plankton ($29.39 in chips) 
Seat 3: colorado2108 ($10.85 in chips) 
Seat 4: Dejacob ($32.33 in chips) 
Seat 5: Dafleche ($20.61 in chips) 
Seat 6: Nagibator441 ($10.64 in chips) 
Seat 7: deadmoneykid ($28.27 in chips) 
Seat 8: chiyuki ($20.55 in chips) 
Seat 9: jacquelinewu ($46.58 in chips) 
4plankton: posts small blind $0.10
colorado2108: posts big blind $0.25
*** HOLE CARDS ***
Dealt to chiyuki [5s 7d]
Dejacob: folds 
Dafleche: folds 
Nagibator441: folds 
deadmoneykid: folds 
chiyuki: folds 
jacquelinewu: folds 
tribunpdm: folds 
4plankton: folds 
Uncalled bet ($0.15) returned to colorado2108
colorado2108 collected $0.20 from pot
colorado2108: doesn't show hand 
*** SUMMARY ***
Total pot $0.20 | Rake $0 
Seat 1: tribunpdm (button) folded before Flop (didn't bet)
Seat 2: 4plankton (small blind) folded before Flop
Seat 3: colorado2108 (big blind) collected ($0.20)
Seat 4: Dejacob folded before Flop (didn't bet)
Seat 5: Dafleche folded before Flop (didn't bet)
Seat 6: Nagibator441 folded before Flop (didn't bet)
Seat 7: deadmoneykid folded before Flop (didn't bet)
Seat 8: chiyuki folded before Flop (didn't bet)
Seat 9: jacquelinewu folded before Flop (didn't bet)



PokerStars Zoom Hand #84299924242:  Hold'em No Limit ($0.10/$0.25) - 2012/08/05 14:52:38 JST [2012/08/05 1:52:38 ET]
Table 'Whirlpool' 9-max Seat #1 is the button
Seat 1: Perstenev ($13.42 in chips) 
Seat 2: cofla tito ($8.38 in chips) 
Seat 3: chiyuki ($20.55 in chips) 
Seat 4: led52 ($11.50 in chips) 
Seat 5: Sal y Limon1 ($24.75 in chips) 
Seat 6: 1Karina1 ($25 in chips) 
Seat 7: jacquelinewu ($40.23 in chips) 
Seat 8: GovGus ($27.83 in chips) 
Seat 9: BlOnDhOlIc ($86.21 in chips) 
cofla tito: posts small blind $0.10
chiyuki: posts big blind $0.25
*** HOLE CARDS ***
Dealt to chiyuki [Th 5c]
led52: folds 
Sal y Limon1: folds 
1Karina1: folds 
jacquelinewu: folds 
GovGus: raises $0.75 to $1
BlOnDhOlIc: folds 
Perstenev: folds 
cofla tito: folds 
chiyuki: folds 
Uncalled bet ($0.75) returned to GovGus
GovGus collected $0.60 from pot
GovGus: doesn't show hand 
*** SUMMARY ***
Total pot $0.60 | Rake $0 
Seat 1: Perstenev (button) folded before Flop (didn't bet)
Seat 2: cofla tito (small blind) folded before Flop
Seat 3: chiyuki (big blind) folded before Flop
Seat 4: led52 folded before Flop (didn't bet)
Seat 5: Sal y Limon1 folded before Flop (didn't bet)
Seat 6: 1Karina1 folded before Flop (didn't bet)
Seat 7: jacquelinewu folded before Flop (didn't bet)
Seat 8: GovGus collected ($0.60)
Seat 9: BlOnDhOlIc folded before Flop (didn't bet)



PokerStars Zoom Hand #84299921478:  Hold'em No Limit ($0.10/$0.25) - 2012/08/05 14:52:27 JST [2012/08/05 1:52:27 ET]
Table 'Whirlpool' 9-max Seat #1 is the button
Seat 1: troublesomm ($25 in chips) 
Seat 2: Nerkit ($9.75 in chips) 
Seat 3: canammark ($23.80 in chips) 
Seat 4: hirozo ($50.90 in chips) 
Seat 5: chiyuki ($20.55 in chips) 
Seat 6: Sal y Limon1 ($24.75 in chips) 
Seat 7: Cyanidoff ($30.40 in chips) 
Seat 8: dushvan ($37.97 in chips) 
Seat 9: a_tasmanian ($46.79 in chips) 
Nerkit: posts small blind $0.10
canammark: posts big blind $0.25
*** HOLE CARDS ***
Dealt to chiyuki [2c 2d]
hirozo: raises $0.50 to $0.75
chiyuki: folds 
Sal y Limon1: folds 
Cyanidoff: folds 
dushvan: folds 
a_tasmanian: calls $0.75
troublesomm: calls $0.75
Nerkit: folds 
canammark: folds 
*** FLOP *** [9h 9s 6d]
hirozo: bets $1.24
a_tasmanian: calls $1.24
troublesomm: folds 
*** TURN *** [9h 9s 6d] [Kc]
hirozo: checks 
a_tasmanian: checks 
*** RIVER *** [9h 9s 6d Kc] [4h]
hirozo: checks 
a_tasmanian: checks 
*** SHOW DOWN ***
hirozo: shows [Ts Td] (two pair, Tens and Nines)
a_tasmanian: mucks hand 
hirozo collected $4.85 from pot
*** SUMMARY ***
Total pot $5.08 | Rake $0.23 
Board [9h 9s 6d Kc 4h]
Seat 1: troublesomm (button) folded on the Flop
Seat 2: Nerkit (small blind) folded before Flop
Seat 3: canammark (big blind) folded before Flop
Seat 4: hirozo showed [Ts Td] and won ($4.85) with two pair, Tens and Nines
Seat 5: chiyuki folded before Flop (didn't bet)
Seat 6: Sal y Limon1 folded before Flop (didn't bet)
Seat 7: Cyanidoff folded before Flop (didn't bet)
Seat 8: dushvan folded before Flop (didn't bet)
Seat 9: a_tasmanian mucked [7h 8h]



PokerStars Zoom Hand #84299929249:  Hold'em No Limit ($0.10/$0.25) - 2012/08/05 14:52:58 JST [2012/08/05 1:52:58 ET]
Table 'Whirlpool' 9-max Seat #1 is the button
Seat 1: KimPa39 ($21.10 in chips) 
Seat 2: Lars111 ($34.46 in chips) 
Seat 3: Sal y Limon1 ($24.75 in chips) 
Seat 4: led52 ($14.84 in chips) 
Seat 5: mjmichi ($25.79 in chips) 
Seat 6: chiyuki ($20.30 in chips) 
Seat 7: dushvan ($37.72 in chips) 
Seat 8: hirozo ($25 in chips) 
Seat 9: troublesomm ($25 in chips) 
Lars111: posts small blind $0.10
Sal y Limon1: posts big blind $0.25
*** HOLE CARDS ***
Dealt to chiyuki [9c 3h]
led52: folds 
mjmichi: folds 
chiyuki: folds 
dushvan: folds 
hirozo: folds 
troublesomm: folds 
KimPa39: folds 
Lars111: folds 
Uncalled bet ($0.15) returned to Sal y Limon1
Sal y Limon1 collected $0.20 from pot
Sal y Limon1: doesn't show hand 
*** SUMMARY ***
Total pot $0.20 | Rake $0 
Seat 1: KimPa39 (button) folded before Flop (didn't bet)
Seat 2: Lars111 (small blind) folded before Flop
Seat 3: Sal y Limon1 (big blind) collected ($0.20)
Seat 4: led52 folded before Flop (didn't bet)
Seat 5: mjmichi folded before Flop (didn't bet)
Seat 6: chiyuki folded before Flop (didn't bet)
Seat 7: dushvan folded before Flop (didn't bet)
Seat 8: hirozo folded before Flop (didn't bet)
Seat 9: troublesomm folded before Flop (didn't bet)



PokerStars Zoom Hand #84299932300:  Hold'em No Limit ($0.10/$0.25) - 2012/08/05 14:53:10 JST [2012/08/05 1:53:10 ET]
Table 'Whirlpool' 9-max Seat #1 is the button
Seat 1: pativyko ($15.54 in chips) 
Seat 2: Dejacob ($25 in chips) 
Seat 3: deadmoneykid ($29.30 in chips) 
Seat 4: mid22 ($7.63 in chips) 
Seat 5: canammark ($23.90 in chips) 
Seat 6: Alvinpe85 ($59.39 in chips) 
Seat 7: Perstenev ($15.98 in chips) 
Seat 8: chiyuki ($20.20 in chips) 
Seat 9: ZhukOFFskI ($49.35 in chips) 
Dejacob: posts small blind $0.10
deadmoneykid: posts big blind $0.25
*** HOLE CARDS ***
Dealt to chiyuki [As Kc]
mid22: folds 
canammark: folds 
Alvinpe85: folds 
Perstenev: folds 
chiyuki: raises $0.50 to $0.75
ZhukOFFskI: folds 
pativyko: folds 
Dejacob: folds 
deadmoneykid: folds 
Uncalled bet ($0.50) returned to chiyuki
chiyuki collected $0.60 from pot
chiyuki: doesn't show hand 
*** SUMMARY ***
Total pot $0.60 | Rake $0 
Seat 1: pativyko (button) folded before Flop (didn't bet)
Seat 2: Dejacob (small blind) folded before Flop
Seat 3: deadmoneykid (big blind) folded before Flop
Seat 4: mid22 folded before Flop (didn't bet)
Seat 5: canammark folded before Flop (didn't bet)
Seat 6: Alvinpe85 folded before Flop (didn't bet)
Seat 7: Perstenev folded before Flop (didn't bet)
Seat 8: chiyuki collected ($0.60)
Seat 9: ZhukOFFskI folded before Flop (didn't bet)



PokerStars Zoom Hand #84299926784:  Hold'em No Limit ($0.10/$0.25) - 2012/08/05 14:52:48 JST [2012/08/05 1:52:48 ET]
Table 'Whirlpool' 9-max Seat #1 is the button
Seat 1: el pore 5 ($26.55 in chips) 
Seat 2: kamikkaze ($15.45 in chips) 
Seat 3: KAKamiro ($25.22 in chips) 
Seat 4: jacquelinewu ($44.45 in chips) 
Seat 5: phate-1up ($72.03 in chips) 
Seat 6: 4plankton ($29.29 in chips) 
Seat 7: chiyuki ($20.30 in chips) 
Seat 8: Nerkit ($9.75 in chips) 
Seat 9: KeLevro0 ($11.80 in chips) 
kamikkaze: posts small blind $0.10
KAKamiro: posts big blind $0.25
*** HOLE CARDS ***
Dealt to chiyuki [5h Ad]
jacquelinewu: folds 
phate-1up: folds 
4plankton: folds 
chiyuki: folds 
Nerkit: folds 
KeLevro0: folds 
el pore 5: raises $0.30 to $0.55
kamikkaze: folds 
KAKamiro: calls $0.30
*** FLOP *** [3h Ac 2s]
KAKamiro: checks 
el pore 5: bets $0.50
KAKamiro: calls $0.50
*** TURN *** [3h Ac 2s] [Ts]
KAKamiro: checks 
el pore 5: bets $0.50
KAKamiro: folds 
Uncalled bet ($0.50) returned to el pore 5
el pore 5 collected $2.10 from pot
el pore 5: doesn't show hand 
*** SUMMARY ***
Total pot $2.20 | Rake $0.10 
Board [3h Ac 2s Ts]
Seat 1: el pore 5 (button) collected ($2.10)
Seat 2: kamikkaze (small blind) folded before Flop
Seat 3: KAKamiro (big blind) folded on the Turn
Seat 4: jacquelinewu folded before Flop (didn't bet)
Seat 5: phate-1up folded before Flop (didn't bet)
Seat 6: 4plankton folded before Flop (didn't bet)
Seat 7: chiyuki folded before Flop (didn't bet)
Seat 8: Nerkit folded before Flop (didn't bet)
Seat 9: KeLevro0 folded before Flop (didn't bet)



PokerStars Zoom Hand #84299923218:  Hold'em No Limit ($0.10/$0.25) - 2012/08/05 14:52:34 JST [2012/08/05 1:52:34 ET]
Table 'Whirlpool' 9-max Seat #1 is the button
Seat 1: chiyuki ($20.55 in chips) 
Seat 2: rorfo23 ($22.76 in chips) 
Seat 3: 4ydo yogurt ($22.74 in chips) 
Seat 4: Dejacob ($32.33 in chips) 
Seat 5: deepakmbh ($21.58 in chips) 
Seat 6: Perstenev ($13.42 in chips) 
Seat 7: snejokCoxx ($11.90 in chips) 
Seat 8: phate-1up ($72.03 in chips) 
Seat 9: mjmichi ($41.60 in chips) 
rorfo23: posts small blind $0.10
4ydo yogurt: posts big blind $0.25
*** HOLE CARDS ***
Dealt to chiyuki [Qs 3h]
Dejacob: folds 
deepakmbh: folds 
Perstenev: folds 
snejokCoxx: folds 
phate-1up: folds 
mjmichi: raises $0.50 to $0.75
chiyuki: folds 
rorfo23: calls $0.65
4ydo yogurt: folds 
*** FLOP *** [Qc 7c 5c]
rorfo23: bets $1.50
mjmichi: calls $1.50
*** TURN *** [Qc 7c 5c] [4c]
rorfo23: bets $1.75
mjmichi: calls $1.75
*** RIVER *** [Qc 7c 5c 4c] [Ac]
rorfo23: bets $1.75
mjmichi: calls $1.75
*** SHOW DOWN ***
rorfo23: shows [Qd Td] (a flush, Ace high)
mjmichi: shows [7h 7s] (a flush, Ace high)
rorfo23 collected $5.61 from pot
mjmichi collected $5.61 from pot
*** SUMMARY ***
Total pot $11.75 | Rake $0.53 
Board [Qc 7c 5c 4c Ac]
Seat 1: chiyuki (button) folded before Flop (didn't bet)
Seat 2: rorfo23 (small blind) showed [Qd Td] and won ($5.61) with a flush, Ace high
Seat 3: 4ydo yogurt (big blind) folded before Flop
Seat 4: Dejacob folded before Flop (didn't bet)
Seat 5: deepakmbh folded before Flop (didn't bet)
Seat 6: Perstenev folded before Flop (didn't bet)
Seat 7: snejokCoxx folded before Flop (didn't bet)
Seat 8: phate-1up folded before Flop (didn't bet)
Seat 9: mjmichi showed [7h 7s] and won ($5.61) with a flush, Ace high



PokerStars Zoom Hand #84299936061:  Hold'em No Limit ($0.10/$0.25) - 2012/08/05 14:53:26 JST [2012/08/05 1:53:26 ET]
Table 'Whirlpool' 9-max Seat #1 is the button
Seat 1: chiyuki ($20.55 in chips) 
Seat 2: 4ydo yogurt ($22.49 in chips) 
Seat 3: DanielWhyte ($45.72 in chips) 
Seat 4: 1Karina1 ($28.84 in chips) 
Seat 5: laurentzu84 ($37.20 in chips) 
Seat 6: Vahe50 ($13.54 in chips) 
Seat 7: Dejacob ($25 in chips) 
Seat 8: snejokCoxx ($11.55 in chips) 
Seat 9: deadmoneykid ($28.27 in chips) 
4ydo yogurt: posts small blind $0.10
DanielWhyte: posts big blind $0.25
*** HOLE CARDS ***
Dealt to chiyuki [Kh Td]
1Karina1: folds 
laurentzu84: folds 
Vahe50: folds 
Dejacob: folds 
snejokCoxx: folds 
deadmoneykid: folds 
chiyuki: raises $0.50 to $0.75
4ydo yogurt: folds 
DanielWhyte: calls $0.50
*** FLOP *** [7d Tc 3c]
DanielWhyte: checks 
chiyuki: bets $1
DanielWhyte: folds 
Uncalled bet ($1) returned to chiyuki
chiyuki collected $1.53 from pot
chiyuki: doesn't show hand 
*** SUMMARY ***
Total pot $1.60 | Rake $0.07 
Board [7d Tc 3c]
Seat 1: chiyuki (button) collected ($1.53)
Seat 2: 4ydo yogurt (small blind) folded before Flop
Seat 3: DanielWhyte (big blind) folded on the Flop
Seat 4: 1Karina1 folded before Flop (didn't bet)
Seat 5: laurentzu84 folded before Flop (didn't bet)
Seat 6: Vahe50 folded before Flop (didn't bet)
Seat 7: Dejacob folded before Flop (didn't bet)
Seat 8: snejokCoxx folded before Flop (didn't bet)
Seat 9: deadmoneykid folded before Flop (didn't bet)



PokerStars Zoom Hand #84299931545:  Hold'em No Limit ($0.10/$0.25) - 2012/08/05 14:53:07 JST [2012/08/05 1:53:07 ET]
Table 'Whirlpool' 9-max Seat #1 is the button
Seat 1: tribunpdm ($28.27 in chips) 
Seat 2: chiyuki ($20.30 in chips) 
Seat 3: seula i ($29.38 in chips) 
Seat 4: silvno31 ($24.87 in chips) 
Seat 5: cofla tito ($7.89 in chips) 
Seat 6: 4plankton ($29.29 in chips) 
Seat 7: Ellen1947 ($43.55 in chips) 
Seat 8: Vahe50 ($13.54 in chips) 
Seat 9: troublesomm ($31 in chips) 
chiyuki: posts small blind $0.10
seula i: posts big blind $0.25
*** HOLE CARDS ***
Dealt to chiyuki [7h 2s]
silvno31: raises $0.50 to $0.75
cofla tito: folds 
4plankton: folds 
Ellen1947: folds 
Vahe50: folds 
troublesomm: calls $0.75
tribunpdm: calls $0.75
chiyuki: folds 
seula i: folds 
*** FLOP *** [Ks Th Kh]
silvno31: checks 
troublesomm: checks 
tribunpdm: checks 
*** TURN *** [Ks Th Kh] [9c]
silvno31: checks 
troublesomm: bets $0.50
tribunpdm: calls $0.50
silvno31: folds 
*** RIVER *** [Ks Th Kh 9c] [3s]
troublesomm: bets $0.75
tribunpdm: folds 
Uncalled bet ($0.75) returned to troublesomm
troublesomm collected $3.44 from pot
troublesomm: doesn't show hand 
*** SUMMARY ***
Total pot $3.60 | Rake $0.16 
Board [Ks Th Kh 9c 3s]
Seat 1: tribunpdm (button) folded on the River
Seat 2: chiyuki (small blind) folded before Flop
Seat 3: seula i (big blind) folded before Flop
Seat 4: silvno31 folded on the Turn
Seat 5: cofla tito folded before Flop (didn't bet)
Seat 6: 4plankton folded before Flop (didn't bet)
Seat 7: Ellen1947 folded before Flop (didn't bet)
Seat 8: Vahe50 folded before Flop (didn't bet)
Seat 9: troublesomm collected ($3.44)



PokerStars Zoom Hand #84299930033:  Hold'em No Limit ($0.10/$0.25) - 2012/08/05 14:53:01 JST [2012/08/05 1:53:01 ET]
Table 'Whirlpool' 9-max Seat #1 is the button
Seat 1: 1Karina1 ($25 in chips) 
Seat 2: GovGus ($28.59 in chips) 
Seat 3: snejokCoxx ($11.90 in chips) 
Seat 4: seula i ($114.11 in chips) 
Seat 5: KrystalAA ($28.13 in chips) 
Seat 6: hobby56 ($15.56 in chips) 
Seat 7: troublesomm ($25 in chips) 
Seat 8: jacquelinewu ($46.58 in chips) 
Seat 9: chiyuki ($20.30 in chips) 
GovGus: posts small blind $0.10
snejokCoxx: posts big blind $0.25
*** HOLE CARDS ***
Dealt to chiyuki [Jd 6d]
seula i: folds 
KrystalAA: folds 
hobby56: folds 
troublesomm: folds 
jacquelinewu: folds 
chiyuki: folds 
1Karina1: raises $0.50 to $0.75
GovGus: folds 
snejokCoxx: calls $0.50
*** FLOP *** [8h 2c 2d]
snejokCoxx: checks 
1Karina1: bets $1
snejokCoxx: raises $1.75 to $2.75
1Karina1: raises $14.75 to $17.50
snejokCoxx: calls $8.40 and is all-in
Uncalled bet ($6.35) returned to 1Karina1
*** TURN *** [8h 2c 2d] [3d]
*** RIVER *** [8h 2c 2d 3d] [Ks]
*** SHOW DOWN ***
snejokCoxx: shows [Js Jh] (two pair, Jacks and Deuces)
1Karina1: shows [Th Tc] (two pair, Tens and Deuces)
snejokCoxx collected $22.82 from pot
*** SUMMARY ***
Total pot $23.90 | Rake $1.08 
Board [8h 2c 2d 3d Ks]
Seat 1: 1Karina1 (button) showed [Th Tc] and lost with two pair, Tens and Deuces
Seat 2: GovGus (small blind) folded before Flop
Seat 3: snejokCoxx (big blind) showed [Js Jh] and won ($22.82) with two pair, Jacks and Deuces
Seat 4: seula i folded before Flop (didn't bet)
Seat 5: KrystalAA folded before Flop (didn't bet)
Seat 6: hobby56 folded before Flop (didn't bet)
Seat 7: troublesomm folded before Flop (didn't bet)
Seat 8: jacquelinewu folded before Flop (didn't bet)
Seat 9: chiyuki folded before Flop (didn't bet)



PokerStars Zoom Hand #84299943649:  Hold'em No Limit ($0.10/$0.25) - 2012/08/05 14:53:57 JST [2012/08/05 1:53:57 ET]
Table 'Whirlpool' 9-max Seat #1 is the button
Seat 1: KrystalAA ($33.34 in chips) 
Seat 2: kamikkaze ($15.10 in chips) 
Seat 3: led52 ($12.50 in chips) 
Seat 4: Lars111 ($33.61 in chips) 
Seat 5: chiyuki ($21.33 in chips) 
Seat 6: DonSimonUsa ($20.02 in chips) 
Seat 7: troublesomm ($33.19 in chips) 
Seat 8: yane73 ($37.92 in chips) 
Seat 9: Alvinpe85 ($51.64 in chips) 
kamikkaze: posts small blind $0.10
led52: posts big blind $0.25
*** HOLE CARDS ***
Dealt to chiyuki [7s Qh]
Lars111: folds 
chiyuki: folds 
DonSimonUsa: folds 
troublesomm: folds 
yane73: folds 
Alvinpe85: folds 
KrystalAA: raises $0.46 to $0.71
kamikkaze: folds 
led52: folds 
Uncalled bet ($0.46) returned to KrystalAA
KrystalAA collected $0.60 from pot
KrystalAA: doesn't show hand 
*** SUMMARY ***
Total pot $0.60 | Rake $0 
Seat 1: KrystalAA (button) collected ($0.60)
Seat 2: kamikkaze (small blind) folded before Flop
Seat 3: led52 (big blind) folded before Flop
Seat 4: Lars111 folded before Flop (didn't bet)
Seat 5: chiyuki folded before Flop (didn't bet)
Seat 6: DonSimonUsa folded before Flop (didn't bet)
Seat 7: troublesomm folded before Flop (didn't bet)
Seat 8: yane73 folded before Flop (didn't bet)
Seat 9: Alvinpe85 folded before Flop (didn't bet)



PokerStars Zoom Hand #84299942885:  Hold'em No Limit ($0.10/$0.25) - 2012/08/05 14:53:54 JST [2012/08/05 1:53:54 ET]
Table 'Whirlpool' 9-max Seat #1 is the button
Seat 1: Vahe50 ($13.29 in chips) 
Seat 2: Walturrr ($26.71 in chips) 
Seat 3: PillZ86 ($16.15 in chips) 
Seat 4: Phaedrus...3 ($25 in chips) 
Seat 5: deadmoneykid ($21.20 in chips) 
Seat 6: dushvan ($37.97 in chips) 
Seat 7: chiyuki ($21.33 in chips) 
Seat 8: BlOnDhOlIc ($33.30 in chips) 
Seat 9: KeLevro0 ($11.90 in chips) 
Walturrr: posts small blind $0.10
PillZ86: posts big blind $0.25
*** HOLE CARDS ***
Dealt to chiyuki [3c Ks]
Phaedrus...3: raises $1.75 to $2
deadmoneykid: folds 
dushvan: folds 
chiyuki: folds 
BlOnDhOlIc: folds 
KeLevro0: folds 
Vahe50: folds 
Walturrr: folds 
PillZ86: folds 
Uncalled bet ($1.75) returned to Phaedrus...3
Phaedrus...3 collected $0.60 from pot
Phaedrus...3: doesn't show hand 
*** SUMMARY ***
Total pot $0.60 | Rake $0 
Seat 1: Vahe50 (button) folded before Flop (didn't bet)
Seat 2: Walturrr (small blind) folded before Flop
Seat 3: PillZ86 (big blind) folded before Flop
Seat 4: Phaedrus...3 collected ($0.60)
Seat 5: deadmoneykid folded before Flop (didn't bet)
Seat 6: dushvan folded before Flop (didn't bet)
Seat 7: chiyuki folded before Flop (didn't bet)
Seat 8: BlOnDhOlIc folded before Flop (didn't bet)
Seat 9: KeLevro0 folded before Flop (didn't bet)



PokerStars Zoom Hand #84299944408:  Hold'em No Limit ($0.10/$0.25) - 2012/08/05 14:54:00 JST [2012/08/05 1:54:00 ET]
Table 'Whirlpool' 9-max Seat #1 is the button
Seat 1: kamikkaze ($15 in chips) 
Seat 2: jacquelinewu ($26.95 in chips) 
Seat 3: chiyuki ($21.33 in chips) 
Seat 4: KeLevro0 ($11.68 in chips) 
Seat 5: DonSimonUsa ($20.02 in chips) 
Seat 6: simonzez ($19.67 in chips) 
Seat 7: BlOnDhOlIc ($88.77 in chips) 
Seat 8: deadmoneykid ($28.95 in chips) 
Seat 9: hirozo ($40.75 in chips) 
jacquelinewu: posts small blind $0.10
chiyuki: posts big blind $0.25
*** HOLE CARDS ***
Dealt to chiyuki [As 8h]
KeLevro0: folds 
DonSimonUsa: raises $0.30 to $0.55
simonzez: folds 
BlOnDhOlIc: folds 
deadmoneykid: folds 
hirozo: folds 
kamikkaze: folds 
jacquelinewu: folds 
chiyuki: calls $0.30
*** FLOP *** [Qd 2h 8d]
chiyuki: checks 
DonSimonUsa: checks 
*** TURN *** [Qd 2h 8d] [3h]
chiyuki: checks 
DonSimonUsa: checks 
*** RIVER *** [Qd 2h 8d 3h] [6s]
chiyuki: bets $1
DonSimonUsa: calls $1
*** SHOW DOWN ***
chiyuki: shows [As 8h] (a pair of Eights)
DonSimonUsa: mucks hand 
chiyuki collected $3.06 from pot
*** SUMMARY ***
Total pot $3.20 | Rake $0.14 
Board [Qd 2h 8d 3h 6s]
Seat 1: kamikkaze (button) folded before Flop (didn't bet)
Seat 2: jacquelinewu (small blind) folded before Flop
Seat 3: chiyuki (big blind) showed [As 8h] and won ($3.06) with a pair of Eights
Seat 4: KeLevro0 folded before Flop (didn't bet)
Seat 5: DonSimonUsa mucked [7c 7h]
Seat 6: simonzez folded before Flop (didn't bet)
Seat 7: BlOnDhOlIc folded before Flop (didn't bet)
Seat 8: deadmoneykid folded before Flop (didn't bet)
Seat 9: hirozo folded before Flop (didn't bet)



PokerStars Zoom Hand #84299956678:  Hold'em No Limit ($0.10/$0.25) - 2012/08/05 14:54:51 JST [2012/08/05 1:54:51 ET]
Table 'Whirlpool' 9-max Seat #1 is the button
Seat 1: ChrisCDee ($43.32 in chips) 
Seat 2: jacquelinewu ($39.23 in chips) 
Seat 3: 1Karina1 ($25 in chips) 
Seat 4: chiyuki ($22.84 in chips) 
Seat 5: KeLevro0 ($12.43 in chips) 
Seat 6: Nerkit ($15.25 in chips) 
Seat 7: Dejacob ($25 in chips) 
Seat 8: hirozo ($26 in chips) 
Seat 9: rorfo23 ($19.62 in chips) 
jacquelinewu: posts small blind $0.10
1Karina1: posts big blind $0.25
*** HOLE CARDS ***
Dealt to chiyuki [As Ac]
chiyuki: raises $0.50 to $0.75
KeLevro0: folds 
Nerkit: folds 
Dejacob: folds 
hirozo: folds 
rorfo23: folds 
ChrisCDee: folds 
jacquelinewu: folds 
1Karina1: folds 
Uncalled bet ($0.50) returned to chiyuki
chiyuki collected $0.60 from pot
chiyuki: doesn't show hand 
*** SUMMARY ***
Total pot $0.60 | Rake $0 
Seat 1: ChrisCDee (button) folded before Flop (didn't bet)
Seat 2: jacquelinewu (small blind) folded before Flop
Seat 3: 1Karina1 (big blind) folded before Flop
Seat 4: chiyuki collected ($0.60)
Seat 5: KeLevro0 folded before Flop (didn't bet)
Seat 6: Nerkit folded before Flop (didn't bet)
Seat 7: Dejacob folded before Flop (didn't bet)
Seat 8: hirozo folded before Flop (didn't bet)
Seat 9: rorfo23 folded before Flop (didn't bet)



PokerStars Zoom Hand #84299955231:  Hold'em No Limit ($0.10/$0.25) - 2012/08/05 14:54:45 JST [2012/08/05 1:54:45 ET]
Table 'Whirlpool' 9-max Seat #1 is the button
Seat 1: snejokCoxx ($12.35 in chips) 
Seat 2: troublesomm ($32.94 in chips) 
Seat 3: DutchShultzs ($25 in chips) 
Seat 4: chiyuki ($22.84 in chips) 
Seat 5: dushvan ($36.22 in chips) 
Seat 6: seula i ($113.61 in chips) 
Seat 7: Nerkit ($15.25 in chips) 
Seat 8: led52 ($12.50 in chips) 
Seat 9: BlOnDhOlIc ($87.77 in chips) 
troublesomm: posts small blind $0.10
DutchShultzs: posts big blind $0.25
*** HOLE CARDS ***
Dealt to chiyuki [Qs Jd]
chiyuki: folds 
dushvan: folds 
seula i: folds 
Nerkit: folds 
led52: folds 
BlOnDhOlIc: raises $0.37 to $0.62
snejokCoxx: calls $0.62
troublesomm: folds 
DutchShultzs: folds 
*** FLOP *** [Ts Kc 6c]
BlOnDhOlIc: bets $1
snejokCoxx: calls $1
*** TURN *** [Ts Kc 6c] [3c]
BlOnDhOlIc: checks 
snejokCoxx: checks 
*** RIVER *** [Ts Kc 6c 3c] [Td]
BlOnDhOlIc: bets $2
snejokCoxx: calls $2
*** SHOW DOWN ***
BlOnDhOlIc: shows [Kh Qc] (two pair, Kings and Tens)
snejokCoxx: shows [Qh Ks] (two pair, Kings and Tens)
BlOnDhOlIc collected $3.63 from pot
snejokCoxx collected $3.62 from pot
*** SUMMARY ***
Total pot $7.59 | Rake $0.34 
Board [Ts Kc 6c 3c Td]
Seat 1: snejokCoxx (button) showed [Qh Ks] and won ($3.62) with two pair, Kings and Tens
Seat 2: troublesomm (small blind) folded before Flop
Seat 3: DutchShultzs (big blind) folded before Flop
Seat 4: chiyuki folded before Flop (didn't bet)
Seat 5: dushvan folded before Flop (didn't bet)
Seat 6: seula i folded before Flop (didn't bet)
Seat 7: Nerkit folded before Flop (didn't bet)
Seat 8: led52 folded before Flop (didn't bet)
Seat 9: BlOnDhOlIc showed [Kh Qc] and won ($3.63) with two pair, Kings and Tens



PokerStars Zoom Hand #84299963521:  Hold'em No Limit ($0.10/$0.25) - 2012/08/05 14:55:19 JST [2012/08/05 1:55:19 ET]
Table 'Whirlpool' 9-max Seat #1 is the button
Seat 1: Sal y Limon1 ($24.75 in chips) 
Seat 2: chiyuki ($23.19 in chips) 
Seat 3: Alvinpe85 ($50.37 in chips) 
Seat 4: Perstenev ($12.47 in chips) 
Seat 5: 4plankton ($28.68 in chips) 
Seat 6: jacquelinewu ($46.50 in chips) 
Seat 7: PAMBOS.L ($16.82 in chips) 
Seat 8: Cyanidoff ($25 in chips) 
Seat 9: 1Karina1 ($28.84 in chips) 
chiyuki: posts small blind $0.10
Alvinpe85: posts big blind $0.25
*** HOLE CARDS ***
Dealt to chiyuki [7c 2d]
Perstenev: folds 
4plankton: folds 
jacquelinewu: folds 
PAMBOS.L: calls $0.25
Cyanidoff: raises $0.75 to $1
1Karina1: folds 
Sal y Limon1: folds 
chiyuki: folds 
Alvinpe85: folds 
PAMBOS.L: calls $0.75
*** FLOP *** [3c 5s Jc]
PAMBOS.L: checks 
Cyanidoff: bets $1.47
PAMBOS.L: folds 
Uncalled bet ($1.47) returned to Cyanidoff
Cyanidoff collected $2.24 from pot
Cyanidoff: doesn't show hand 
*** SUMMARY ***
Total pot $2.35 | Rake $0.11 
Board [3c 5s Jc]
Seat 1: Sal y Limon1 (button) folded before Flop (didn't bet)
Seat 2: chiyuki (small blind) folded before Flop
Seat 3: Alvinpe85 (big blind) folded before Flop
Seat 4: Perstenev folded before Flop (didn't bet)
Seat 5: 4plankton folded before Flop (didn't bet)
Seat 6: jacquelinewu folded before Flop (didn't bet)
Seat 7: PAMBOS.L folded on the Flop
Seat 8: Cyanidoff collected ($2.24)
Seat 9: 1Karina1 folded before Flop (didn't bet)



PokerStars Zoom Hand #84299964934:  Hold'em No Limit ($0.10/$0.25) - 2012/08/05 14:55:26 JST [2012/08/05 1:55:26 ET]
Table 'Whirlpool' 9-max Seat #1 is the button
Seat 1: led52 ($11.80 in chips) 
Seat 2: deadmoneykid ($21.20 in chips) 
Seat 3: Vahe50 ($13.54 in chips) 
Seat 4: Nerkit ($15 in chips) 
Seat 5: Dejacob ($25 in chips) 
Seat 6: chiyuki ($23.09 in chips) 
Seat 7: ZhukOFFskI ($48.75 in chips) 
Seat 8: Perstenev ($12.47 in chips) 
Seat 9: DanielWhyte ($51.35 in chips) 
deadmoneykid: posts small blind $0.10
Vahe50: posts big blind $0.25
*** HOLE CARDS ***
Dealt to chiyuki [3s 3d]
Nerkit: folds 
Dejacob: folds 
chiyuki: raises $0.50 to $0.75
ZhukOFFskI: folds 
Perstenev: folds 
DanielWhyte: folds 
led52: folds 
deadmoneykid: folds 
Vahe50: folds 
Uncalled bet ($0.50) returned to chiyuki
chiyuki collected $0.60 from pot
chiyuki: doesn't show hand 
*** SUMMARY ***
Total pot $0.60 | Rake $0 
Seat 1: led52 (button) folded before Flop (didn't bet)
Seat 2: deadmoneykid (small blind) folded before Flop
Seat 3: Vahe50 (big blind) folded before Flop
Seat 4: Nerkit folded before Flop (didn't bet)
Seat 5: Dejacob folded before Flop (didn't bet)
Seat 6: chiyuki collected ($0.60)
Seat 7: ZhukOFFskI folded before Flop (didn't bet)
Seat 8: Perstenev folded before Flop (didn't bet)
Seat 9: DanielWhyte folded before Flop (didn't bet)



PokerStars Zoom Hand #84299964342:  Hold'em No Limit ($0.10/$0.25) - 2012/08/05 14:55:23 JST [2012/08/05 1:55:23 ET]
Table 'Whirlpool' 9-max Seat #1 is the button
Seat 1: HighDuka ($41.32 in chips) 
Seat 2: simonzez ($20.62 in chips) 
Seat 3: Lars111 ($33.96 in chips) 
Seat 4: Landybob ($41.17 in chips) 
Seat 5: Nerkit ($15 in chips) 
Seat 6: 1Karina1 ($28.84 in chips) 
Seat 7: Perstenev ($12.47 in chips) 
Seat 8: ChrisCDee ($43.07 in chips) 
Seat 9: chiyuki ($23.09 in chips) 
simonzez: posts small blind $0.10
Lars111: posts big blind $0.25
*** HOLE CARDS ***
Dealt to chiyuki [Jc 5s]
Landybob: folds 
Nerkit: folds 
1Karina1: raises $0.50 to $0.75
Perstenev: folds 
ChrisCDee: folds 
chiyuki: folds 
HighDuka has timed out while disconnected
HighDuka: folds 
simonzez: calls $0.65
Lars111: folds 
*** FLOP *** [6s 4s 9s]
simonzez: bets $1
1Karina1: calls $1
*** TURN *** [6s 4s 9s] [5h]
simonzez: bets $1.75
1Karina1: folds 
Uncalled bet ($1.75) returned to simonzez
simonzez collected $3.58 from pot
simonzez: doesn't show hand 
*** SUMMARY ***
Total pot $3.75 | Rake $0.17 
Board [6s 4s 9s 5h]
Seat 1: HighDuka (button) folded before Flop (didn't bet)
Seat 2: simonzez (small blind) collected ($3.58)
Seat 3: Lars111 (big blind) folded before Flop
Seat 4: Landybob folded before Flop (didn't bet)
Seat 5: Nerkit folded before Flop (didn't bet)
Seat 6: 1Karina1 folded on the Turn
Seat 7: Perstenev folded before Flop (didn't bet)
Seat 8: ChrisCDee folded before Flop (didn't bet)
Seat 9: chiyuki folded before Flop (didn't bet)



PokerStars Zoom Hand #84299971863:  Hold'em No Limit ($0.10/$0.25) - 2012/08/05 14:56:02 JST [2012/08/05 1:56:02 ET]
Table 'Whirlpool' 9-max Seat #1 is the button
Seat 1: troublesomm ($26.79 in chips) 
Seat 2: sparky5224 ($36.33 in chips) 
Seat 3: mid22 ($9.66 in chips) 
Seat 4: BlOnDhOlIc ($32.45 in chips) 
Seat 5: jacquelinewu ($31.63 in chips) 
Seat 6: 1Karina1 ($25.45 in chips) 
Seat 7: rorfo23 ($24.50 in chips) 
Seat 8: Perstenev ($14.98 in chips) 
Seat 9: chiyuki ($23.44 in chips) 
sparky5224: posts small blind $0.10
mid22: posts big blind $0.25
*** HOLE CARDS ***
Dealt to chiyuki [Ac Th]
BlOnDhOlIc: folds 
jacquelinewu: folds 
1Karina1: folds 
rorfo23: folds 
Perstenev: raises $0.50 to $0.75
chiyuki: folds 
troublesomm: folds 
sparky5224: calls $0.65
mid22: folds 
*** FLOP *** [8d 3d 5s]
sparky5224: checks 
Perstenev: checks 
*** TURN *** [8d 3d 5s] [6c]
sparky5224: checks 
Perstenev: checks 
*** RIVER *** [8d 3d 5s 6c] [3h]
sparky5224: checks 
Perstenev: checks 
*** SHOW DOWN ***
sparky5224: shows [9h Td] (a pair of Threes)
Perstenev: shows [Ah Kd] (a pair of Threes - Ace kicker)
Perstenev collected $1.67 from pot
*** SUMMARY ***
Total pot $1.75 | Rake $0.08 
Board [8d 3d 5s 6c 3h]
Seat 1: troublesomm (button) folded before Flop (didn't bet)
Seat 2: sparky5224 (small blind) showed [9h Td] and lost with a pair of Threes
Seat 3: mid22 (big blind) folded before Flop
Seat 4: BlOnDhOlIc folded before Flop (didn't bet)
Seat 5: jacquelinewu folded before Flop (didn't bet)
Seat 6: 1Karina1 folded before Flop (didn't bet)
Seat 7: rorfo23 folded before Flop (didn't bet)
Seat 8: Perstenev showed [Ah Kd] and won ($1.67) with a pair of Threes
Seat 9: chiyuki folded before Flop (didn't bet)



PokerStars Zoom Hand #84299971132:  Hold'em No Limit ($0.10/$0.25) - 2012/08/05 14:55:58 JST [2012/08/05 1:55:58 ET]
Table 'Whirlpool' 9-max Seat #1 is the button
Seat 1: seula i ($112.36 in chips) 
Seat 2: 4plankton ($28.43 in chips) 
Seat 3: deepakmbh ($11.11 in chips) 
Seat 4: Perstenev ($14.98 in chips) 
Seat 5: chiyuki ($23.44 in chips) 
Seat 6: GovGus ($44.26 in chips) 
Seat 7: jacquelinewu ($31.63 in chips) 
Seat 8: phate-1up ($30.62 in chips) 
Seat 9: 4ydo yogurt ($23.69 in chips) 
4plankton: posts small blind $0.10
deepakmbh: posts big blind $0.25
*** HOLE CARDS ***
Dealt to chiyuki [8s 4d]
Perstenev: folds 
chiyuki: folds 
GovGus: folds 
jacquelinewu: folds 
phate-1up: raises $0.50 to $0.75
4ydo yogurt: folds 
seula i: folds 
4plankton: folds 
deepakmbh: calls $0.50
*** FLOP *** [Ac 7s 2d]
deepakmbh: checks 
phate-1up: bets $1.25
deepakmbh: calls $1.25
*** TURN *** [Ac 7s 2d] [3h]
deepakmbh: checks 
phate-1up: bets $2.50
deepakmbh: calls $2.50
*** RIVER *** [Ac 7s 2d 3h] [Jd]
deepakmbh: checks 
phate-1up: bets $6.75
deepakmbh: folds 
Uncalled bet ($6.75) returned to phate-1up
phate-1up collected $8.69 from pot
phate-1up: doesn't show hand 
*** SUMMARY ***
Total pot $9.10 | Rake $0.41 
Board [Ac 7s 2d 3h Jd]
Seat 1: seula i (button) folded before Flop (didn't bet)
Seat 2: 4plankton (small blind) folded before Flop
Seat 3: deepakmbh (big blind) folded on the River
Seat 4: Perstenev folded before Flop (didn't bet)
Seat 5: chiyuki folded before Flop (didn't bet)
Seat 6: GovGus folded before Flop (didn't bet)
Seat 7: jacquelinewu folded before Flop (didn't bet)
Seat 8: phate-1up collected ($8.69)
Seat 9: 4ydo yogurt folded before Flop (didn't bet)



PokerStars Zoom Hand #84299974807:  Hold'em No Limit ($0.10/$0.25) - 2012/08/05 14:56:17 JST [2012/08/05 1:56:17 ET]
Table 'Whirlpool' 9-max Seat #1 is the button
Seat 1: Gichboy ($14 in chips) 
Seat 2: 1Karina1 ($25.45 in chips) 
Seat 3: chiyuki ($23.44 in chips) 
Seat 4: 4plankton ($28.33 in chips) 
Seat 5: KrystalAA ($14.51 in chips) 
Seat 6: snejokCoxx ($12.25 in chips) 
Seat 7: mid22 ($9.41 in chips) 
Seat 8: seula i ($112.36 in chips) 
Seat 9: turbotom122 ($12.50 in chips) 
1Karina1: posts small blind $0.10
chiyuki: posts big blind $0.25
*** HOLE CARDS ***
Dealt to chiyuki [Jh 3c]
4plankton: calls $0.25
KrystalAA: folds 
snejokCoxx: folds 
mid22: folds 
seula i: folds 
turbotom122: folds 
Gichboy: folds 
1Karina1: folds 
chiyuki: checks 
*** FLOP *** [8h Js Qs]
chiyuki: checks 
4plankton: checks 
*** TURN *** [8h Js Qs] [Jc]
chiyuki: bets $0.50
4plankton: calls $0.50
*** RIVER *** [8h Js Qs Jc] [6s]
chiyuki: bets $1.50
4plankton: folds 
Uncalled bet ($1.50) returned to chiyuki
chiyuki collected $1.53 from pot
chiyuki: doesn't show hand 
*** SUMMARY ***
Total pot $1.60 | Rake $0.07 
Board [8h Js Qs Jc 6s]
Seat 1: Gichboy (button) folded before Flop (didn't bet)
Seat 2: 1Karina1 (small blind) folded before Flop
Seat 3: chiyuki (big blind) collected ($1.53)
Seat 4: 4plankton folded on the River
Seat 5: KrystalAA folded before Flop (didn't bet)
Seat 6: snejokCoxx folded before Flop (didn't bet)
Seat 7: mid22 folded before Flop (didn't bet)
Seat 8: seula i folded before Flop (didn't bet)
Seat 9: turbotom122 folded before Flop (didn't bet)



PokerStars Zoom Hand #84299983361:  Hold'em No Limit ($0.10/$0.25) - 2012/08/05 14:57:01 JST [2012/08/05 1:57:01 ET]
Table 'Whirlpool' 9-max Seat #1 is the button
Seat 1: ZhukOFFskI ($27.76 in chips) 
Seat 2: KeLevro0 ($11.08 in chips) 
Seat 3: 4plankton ($27.58 in chips) 
Seat 4: seula i ($25.74 in chips) 
Seat 5: Tom1999 ($23.35 in chips) 
Seat 6: empfang ($22.11 in chips) 
Seat 7: jacquelinewu ($47.90 in chips) 
Seat 8: chiyuki ($24.22 in chips) 
Seat 9: Cyanidoff ($31.58 in chips) 
KeLevro0: posts small blind $0.10
4plankton: posts big blind $0.25
*** HOLE CARDS ***
Dealt to chiyuki [3c 2s]
seula i: folds 
Tom1999: folds 
empfang: raises $0.50 to $0.75
jacquelinewu: folds 
chiyuki: folds 
Cyanidoff: folds 
ZhukOFFskI: folds 
KeLevro0: folds 
4plankton: folds 
Uncalled bet ($0.50) returned to empfang
empfang collected $0.60 from pot
empfang: doesn't show hand 
*** SUMMARY ***
Total pot $0.60 | Rake $0 
Seat 1: ZhukOFFskI (button) folded before Flop (didn't bet)
Seat 2: KeLevro0 (small blind) folded before Flop
Seat 3: 4plankton (big blind) folded before Flop
Seat 4: seula i folded before Flop (didn't bet)
Seat 5: Tom1999 folded before Flop (didn't bet)
Seat 6: empfang collected ($0.60)
Seat 7: jacquelinewu folded before Flop (didn't bet)
Seat 8: chiyuki folded before Flop (didn't bet)
Seat 9: Cyanidoff folded before Flop (didn't bet)



PokerStars Zoom Hand #84299985811:  Hold'em No Limit ($0.10/$0.25) - 2012/08/05 14:57:13 JST [2012/08/05 1:57:13 ET]
Table 'Whirlpool' 9-max Seat #1 is the button
Seat 1: chiyuki ($24.22 in chips) 
Seat 2: troublesomm ($26.54 in chips) 
Seat 3: jacquelinewu ($47.90 in chips) 
Seat 4: ChrisCDee ($47.19 in chips) 
Seat 5: KAKamiro ($29.78 in chips) 
Seat 6: snejokCoxx ($10.35 in chips) 
Seat 7: Tom1999 ($25.97 in chips) 
Seat 8: azizmimi ($22.05 in chips) 
Seat 9: kamikkaze ($14.75 in chips) 
troublesomm: posts small blind $0.10
jacquelinewu: posts big blind $0.25
*** HOLE CARDS ***
Dealt to chiyuki [Ad Ks]
ChrisCDee: folds 
KAKamiro: folds 
snejokCoxx: folds 
Tom1999: folds 
azizmimi: raises $0.50 to $0.75
kamikkaze: raises $14 to $14.75 and is all-in
chiyuki: folds 
troublesomm: folds 
jacquelinewu: calls $14.50
azizmimi: folds 
*** FLOP *** [2h Th 3d]
*** TURN *** [2h Th 3d] [9d]
*** RIVER *** [2h Th 3d 9d] [4c]
*** SHOW DOWN ***
jacquelinewu: shows [Qd Qs] (a pair of Queens)
kamikkaze: shows [Kh Kd] (a pair of Kings)
kamikkaze collected $28.98 from pot
*** SUMMARY ***
Total pot $30.35 | Rake $1.37 
Board [2h Th 3d 9d 4c]
Seat 1: chiyuki (button) folded before Flop (didn't bet)
Seat 2: troublesomm (small blind) folded before Flop
Seat 3: jacquelinewu (big blind) showed [Qd Qs] and lost with a pair of Queens
Seat 4: ChrisCDee folded before Flop (didn't bet)
Seat 5: KAKamiro folded before Flop (didn't bet)
Seat 6: snejokCoxx folded before Flop (didn't bet)
Seat 7: Tom1999 folded before Flop (didn't bet)
Seat 8: azizmimi folded before Flop
Seat 9: kamikkaze showed [Kh Kd] and won ($28.98) with a pair of Kings



PokerStars Zoom Hand #84299993620:  Hold'em No Limit ($0.10/$0.25) - 2012/08/05 14:57:52 JST [2012/08/05 1:57:52 ET]
Table 'Whirlpool' 9-max Seat #1 is the button
Seat 1: Wilcox76607 ($36.06 in chips) 
Seat 2: 1Karina1 ($25.10 in chips) 
Seat 3: Dejacob ($26.51 in chips) 
Seat 4: ChrisCDee ($29.66 in chips) 
Seat 5: mid22 ($8.31 in chips) 
Seat 6: silvno31 ($16.75 in chips) 
Seat 7: chiyuki ($24.22 in chips) 
Seat 8: Tom1999 ($23.45 in chips) 
Seat 9: Streikel ($19.91 in chips) 
1Karina1: posts small blind $0.10
Dejacob: posts big blind $0.25
*** HOLE CARDS ***
Dealt to chiyuki [Ac 4c]
ChrisCDee: folds 
mid22: folds 
silvno31: folds 
chiyuki: folds 
Tom1999: folds 
Streikel: folds 
Wilcox76607: folds 
1Karina1: folds 
Uncalled bet ($0.15) returned to Dejacob
Dejacob collected $0.20 from pot
Dejacob: doesn't show hand 
*** SUMMARY ***
Total pot $0.20 | Rake $0 
Seat 1: Wilcox76607 (button) folded before Flop (didn't bet)
Seat 2: 1Karina1 (small blind) folded before Flop
Seat 3: Dejacob (big blind) collected ($0.20)
Seat 4: ChrisCDee folded before Flop (didn't bet)
Seat 5: mid22 folded before Flop (didn't bet)
Seat 6: silvno31 folded before Flop (didn't bet)
Seat 7: chiyuki folded before Flop (didn't bet)
Seat 8: Tom1999 folded before Flop (didn't bet)
Seat 9: Streikel folded before Flop (didn't bet)



PokerStars Zoom Hand #84299995260:  Hold'em No Limit ($0.10/$0.25) - 2012/08/05 14:58:00 JST [2012/08/05 1:58:00 ET]
Table 'Whirlpool' 9-max Seat #1 is the button
Seat 1: Lars111 ($35.73 in chips) 
Seat 2: KeLevro0 ($12.25 in chips) 
Seat 3: Phaedrus...3 ($23.43 in chips) 
Seat 4: chiyuki ($24.22 in chips) 
Seat 5: Littlea029 ($24.25 in chips) 
Seat 6: edilson_ita ($3.09 in chips) 
Seat 7: Streikel ($19.91 in chips) 
Seat 8: Wilcox76607 ($36.06 in chips) 
Seat 9: deepakmbh ($53.97 in chips) 
KeLevro0: posts small blind $0.10
Phaedrus...3: posts big blind $0.25
*** HOLE CARDS ***
Dealt to chiyuki [6s 7c]
chiyuki: folds 
Littlea029: folds 
edilson_ita: folds 
Streikel: folds 
Wilcox76607: folds 
deepakmbh: raises $0.55 to $0.80
Lars111: folds 
KeLevro0: folds 
Phaedrus...3: folds 
Uncalled bet ($0.55) returned to deepakmbh
deepakmbh collected $0.60 from pot
deepakmbh: doesn't show hand 
*** SUMMARY ***
Total pot $0.60 | Rake $0 
Seat 1: Lars111 (button) folded before Flop (didn't bet)
Seat 2: KeLevro0 (small blind) folded before Flop
Seat 3: Phaedrus...3 (big blind) folded before Flop
Seat 4: chiyuki folded before Flop (didn't bet)
Seat 5: Littlea029 folded before Flop (didn't bet)
Seat 6: edilson_ita folded before Flop (didn't bet)
Seat 7: Streikel folded before Flop (didn't bet)
Seat 8: Wilcox76607 folded before Flop (didn't bet)
Seat 9: deepakmbh collected ($0.60)



PokerStars Zoom Hand #84299994417:  Hold'em No Limit ($0.10/$0.25) - 2012/08/05 14:57:56 JST [2012/08/05 1:57:56 ET]
Table 'Whirlpool' 9-max Seat #1 is the button
Seat 1: DutchShultzs ($25 in chips) 
Seat 2: silvno31 ($16.75 in chips) 
Seat 3: River_GmbH ($14.65 in chips) 
Seat 4: snejokCoxx ($11.53 in chips) 
Seat 5: mid22 ($8.31 in chips) 
Seat 6: chiyuki ($24.22 in chips) 
Seat 7: ChrisCDee ($29.66 in chips) 
Seat 8: Streikel ($19.91 in chips) 
Seat 9: Perstenev ($13 in chips) 
silvno31: posts small blind $0.10
River_GmbH: posts big blind $0.25
*** HOLE CARDS ***
Dealt to chiyuki [4c Ts]
snejokCoxx: folds 
mid22: calls $0.25
chiyuki: folds 
ChrisCDee: folds 
Streikel: folds 
Perstenev: folds 
DutchShultzs: folds 
silvno31: folds 
River_GmbH: checks 
*** FLOP *** [8h Th As]
River_GmbH: checks 
mid22: checks 
*** TURN *** [8h Th As] [7h]
River_GmbH: checks 
mid22: bets $0.25
River_GmbH: folds 
Uncalled bet ($0.25) returned to mid22
mid22 collected $0.57 from pot
mid22: doesn't show hand 
*** SUMMARY ***
Total pot $0.60 | Rake $0.03 
Board [8h Th As 7h]
Seat 1: DutchShultzs (button) folded before Flop (didn't bet)
Seat 2: silvno31 (small blind) folded before Flop
Seat 3: River_GmbH (big blind) folded on the Turn
Seat 4: snejokCoxx folded before Flop (didn't bet)
Seat 5: mid22 collected ($0.57)
Seat 6: chiyuki folded before Flop (didn't bet)
Seat 7: ChrisCDee folded before Flop (didn't bet)
Seat 8: Streikel folded before Flop (didn't bet)
Seat 9: Perstenev folded before Flop (didn't bet)



PokerStars Zoom Hand #84299996262:  Hold'em No Limit ($0.10/$0.25) - 2012/08/05 14:58:06 JST [2012/08/05 1:58:06 ET]
Table 'Whirlpool' 9-max Seat #1 is the button
Seat 1: turbotom122 ($14.35 in chips) 
Seat 2: chiyuki ($24.22 in chips) 
Seat 3: DutchShultzs ($25 in chips) 
Seat 4: PAMBOS.L ($11.30 in chips) 
Seat 5: Jene4kaBest ($16.02 in chips) 
Seat 6: simonzez ($22.27 in chips) 
Seat 7: Perstenev ($13 in chips) 
Seat 8: kamikkaze ($28.88 in chips) 
Seat 9: Dan Royal ($32.31 in chips) 
chiyuki: posts small blind $0.10
DutchShultzs: posts big blind $0.25
*** HOLE CARDS ***
Dealt to chiyuki [3d Kh]
PAMBOS.L: calls $0.25
Jene4kaBest: calls $0.25
simonzez: folds 
Perstenev: folds 
kamikkaze: folds 
Dan Royal: calls $0.25
turbotom122: raises $14.10 to $14.35 and is all-in
chiyuki: folds 
DutchShultzs: folds 
PAMBOS.L: folds 
Jene4kaBest: folds 
Dan Royal: folds 
Uncalled bet ($14.10) returned to turbotom122
turbotom122 collected $1.35 from pot
turbotom122: doesn't show hand 
*** SUMMARY ***
Total pot $1.35 | Rake $0 
Seat 1: turbotom122 (button) collected ($1.35)
Seat 2: chiyuki (small blind) folded before Flop
Seat 3: DutchShultzs (big blind) folded before Flop
Seat 4: PAMBOS.L folded before Flop
Seat 5: Jene4kaBest folded before Flop
Seat 6: simonzez folded before Flop (didn't bet)
Seat 7: Perstenev folded before Flop (didn't bet)
Seat 8: kamikkaze folded before Flop (didn't bet)
Seat 9: Dan Royal folded before Flop



PokerStars Zoom Hand #84299998686:  Hold'em No Limit ($0.10/$0.25) - 2012/08/05 14:58:18 JST [2012/08/05 1:58:18 ET]
Table 'Whirlpool' 9-max Seat #1 is the button
Seat 1: chiyuki ($24.12 in chips) 
Seat 2: GovGus ($36.39 in chips) 
Seat 3: troublesomm ($26.30 in chips) 
Seat 4: Paranoix1990 ($22.88 in chips) 
Seat 5: rorfo23 ($25.79 in chips) 
Seat 6: DutchShultzs ($25 in chips) 
Seat 7: kamikkaze ($28.88 in chips) 
Seat 8: gunbowler ($143.85 in chips) 
Seat 9: 1Karina1 ($25 in chips) 
GovGus: posts small blind $0.10
troublesomm: posts big blind $0.25
*** HOLE CARDS ***
Dealt to chiyuki [8s Jh]
Paranoix1990: folds 
rorfo23: folds 
DutchShultzs: folds 
kamikkaze: folds 
gunbowler: raises $0.50 to $0.75
1Karina1: folds 
chiyuki: folds 
GovGus: folds 
troublesomm: folds 
Uncalled bet ($0.50) returned to gunbowler
gunbowler collected $0.60 from pot
gunbowler: doesn't show hand 
*** SUMMARY ***
Total pot $0.60 | Rake $0 
Seat 1: chiyuki (button) folded before Flop (didn't bet)
Seat 2: GovGus (small blind) folded before Flop
Seat 3: troublesomm (big blind) folded before Flop
Seat 4: Paranoix1990 folded before Flop (didn't bet)
Seat 5: rorfo23 folded before Flop (didn't bet)
Seat 6: DutchShultzs folded before Flop (didn't bet)
Seat 7: kamikkaze folded before Flop (didn't bet)
Seat 8: gunbowler collected ($0.60)
Seat 9: 1Karina1 folded before Flop (didn't bet)



PokerStars Zoom Hand #84299999883:  Hold'em No Limit ($0.10/$0.25) - 2012/08/05 14:58:24 JST [2012/08/05 1:58:24 ET]
Table 'Whirlpool' 9-max Seat #1 is the button
Seat 1: KeLevro0 ($12.15 in chips) 
Seat 2: kamikkaze ($28.88 in chips) 
Seat 3: Nerkit ($11.15 in chips) 
Seat 4: hirozo ($74.36 in chips) 
Seat 5: deepakmbh ($25 in chips) 
Seat 6: cofla tito ($5.38 in chips) 
Seat 7: chiyuki ($24.12 in chips) 
Seat 8: Vahe50 ($16.25 in chips) 
Seat 9: Ellen1947 ($32.39 in chips) 
kamikkaze: posts small blind $0.10
Nerkit: posts big blind $0.25
*** HOLE CARDS ***
Dealt to chiyuki [4d Qd]
hirozo: folds 
deepakmbh: folds 
cofla tito: folds 
chiyuki: folds 
Vahe50: folds 
Ellen1947: folds 
KeLevro0: folds 
kamikkaze: folds 
Uncalled bet ($0.15) returned to Nerkit
Nerkit collected $0.20 from pot
Nerkit: doesn't show hand 
*** SUMMARY ***
Total pot $0.20 | Rake $0 
Seat 1: KeLevro0 (button) folded before Flop (didn't bet)
Seat 2: kamikkaze (small blind) folded before Flop
Seat 3: Nerkit (big blind) collected ($0.20)
Seat 4: hirozo folded before Flop (didn't bet)
Seat 5: deepakmbh folded before Flop (didn't bet)
Seat 6: cofla tito folded before Flop (didn't bet)
Seat 7: chiyuki folded before Flop (didn't bet)
Seat 8: Vahe50 folded before Flop (didn't bet)
Seat 9: Ellen1947 folded before Flop (didn't bet)



PokerStars Zoom Hand #84300000666:  Hold'em No Limit ($0.10/$0.25) - 2012/08/05 14:58:28 JST [2012/08/05 1:58:28 ET]
Table 'Whirlpool' 9-max Seat #1 is the button
Seat 1: DanielWhyte ($50.60 in chips) 
Seat 2: Faantomace ($25.95 in chips) 
Seat 3: ChrisCDee ($69.29 in chips) 
Seat 4: chiyuki ($24.12 in chips) 
Seat 5: deadmoneykid ($28.70 in chips) 
Seat 6: Dejacob ($26.19 in chips) 
Seat 7: Ellen1947 ($32.39 in chips) 
Seat 8: KeLevro0 ($12.15 in chips) 
Seat 9: Dafleche ($46.51 in chips) 
Faantomace: posts small blind $0.10
ChrisCDee: posts big blind $0.25
*** HOLE CARDS ***
Dealt to chiyuki [5h As]
chiyuki: folds 
deadmoneykid: folds 
Dejacob: folds 
Ellen1947: folds 
KeLevro0: folds 
Dafleche: calls $0.25
DanielWhyte: folds 
Faantomace: folds 
ChrisCDee: checks 
*** FLOP *** [Ks 9c 8h]
ChrisCDee: checks 
Dafleche: bets $0.50
ChrisCDee: folds 
Uncalled bet ($0.50) returned to Dafleche
Dafleche collected $0.57 from pot
Dafleche: doesn't show hand 
*** SUMMARY ***
Total pot $0.60 | Rake $0.03 
Board [Ks 9c 8h]
Seat 1: DanielWhyte (button) folded before Flop (didn't bet)
Seat 2: Faantomace (small blind) folded before Flop
Seat 3: ChrisCDee (big blind) folded on the Flop
Seat 4: chiyuki folded before Flop (didn't bet)
Seat 5: deadmoneykid folded before Flop (didn't bet)
Seat 6: Dejacob folded before Flop (didn't bet)
Seat 7: Ellen1947 folded before Flop (didn't bet)
Seat 8: KeLevro0 folded before Flop (didn't bet)
Seat 9: Dafleche collected ($0.57)



PokerStars Zoom Hand #84299997897:  Hold'em No Limit ($0.10/$0.25) - 2012/08/05 14:58:14 JST [2012/08/05 1:58:14 ET]
Table 'Whirlpool' 9-max Seat #1 is the button
Seat 1: Dejacob ($25.81 in chips) 
Seat 2: ChrisCDee ($29.66 in chips) 
Seat 3: KeLevro0 ($12.50 in chips) 
Seat 4: Phaedrus...3 ($23.18 in chips) 
Seat 5: Nerkit ($14.25 in chips) 
Seat 6: phate-1up ($25 in chips) 
Seat 7: rorfo23 ($25.79 in chips) 
Seat 8: chiyuki ($24.12 in chips) 
Seat 9: simonzez ($22.27 in chips) 
ChrisCDee: posts small blind $0.10
KeLevro0: posts big blind $0.25
*** HOLE CARDS ***
Dealt to chiyuki [2c 8d]
Phaedrus...3: folds 
Nerkit: folds 
phate-1up: folds 
rorfo23: folds 
chiyuki: folds 
simonzez: calls $0.25
Dejacob: folds 
ChrisCDee: raises $1 to $1.25
KeLevro0: folds 
simonzez: calls $1
*** FLOP *** [9s 3h Jc]
ChrisCDee: checks 
simonzez: bets $2
ChrisCDee: calls $2
*** TURN *** [9s 3h Jc] [6d]
ChrisCDee: checks 
simonzez: bets $2.75
ChrisCDee: folds 
Uncalled bet ($2.75) returned to simonzez
simonzez collected $6.45 from pot
simonzez: doesn't show hand 
*** SUMMARY ***
Total pot $6.75 | Rake $0.30 
Board [9s 3h Jc 6d]
Seat 1: Dejacob (button) folded before Flop (didn't bet)
Seat 2: ChrisCDee (small blind) folded on the Turn
Seat 3: KeLevro0 (big blind) folded before Flop
Seat 4: Phaedrus...3 folded before Flop (didn't bet)
Seat 5: Nerkit folded before Flop (didn't bet)
Seat 6: phate-1up folded before Flop (didn't bet)
Seat 7: rorfo23 folded before Flop (didn't bet)
Seat 8: chiyuki folded before Flop (didn't bet)
Seat 9: simonzez collected ($6.45)



PokerStars Zoom Hand #84300001246:  Hold'em No Limit ($0.10/$0.25) - 2012/08/05 14:58:31 JST [2012/08/05 1:58:31 ET]
Table 'Whirlpool' 9-max Seat #1 is the button
Seat 1: snejokCoxx ($12.15 in chips) 
Seat 2: seula i ($25.49 in chips) 
Seat 3: chiyuki ($24.12 in chips) 
Seat 4: Perstenev ($13.45 in chips) 
Seat 5: Nerkit ($20.08 in chips) 
Seat 6: troublesomm ($25.67 in chips) 
Seat 7: DutchShultzs ($25 in chips) 
Seat 8: KrystalAA ($29.41 in chips) 
Seat 9: gunbowler ($144.20 in chips) 
seula i: posts small blind $0.10
chiyuki: posts big blind $0.25
*** HOLE CARDS ***
Dealt to chiyuki [Jc Jh]
Perstenev: folds 
Nerkit: folds 
troublesomm: folds 
DutchShultzs: folds 
KrystalAA: folds 
gunbowler: raises $0.50 to $0.75
snejokCoxx: folds 
seula i: calls $0.65
chiyuki: raises $2 to $2.75
gunbowler: calls $2
seula i: calls $2
*** FLOP *** [Qh 5d Ac]
seula i: checks 
chiyuki: checks 
gunbowler: checks 
*** TURN *** [Qh 5d Ac] [Jd]
seula i: checks 
chiyuki: bets $4.25
gunbowler: calls $4.25
seula i: folds 
*** RIVER *** [Qh 5d Ac Jd] [Td]
chiyuki: bets $5.50
gunbowler: raises $7.10 to $12.60
chiyuki: folds 
Uncalled bet ($7.10) returned to gunbowler
gunbowler collected $26.50 from pot
gunbowler: doesn't show hand 
*** SUMMARY ***
Total pot $27.75 | Rake $1.25 
Board [Qh 5d Ac Jd Td]
Seat 1: snejokCoxx (button) folded before Flop (didn't bet)
Seat 2: seula i (small blind) folded on the Turn
Seat 3: chiyuki (big blind) folded on the River
Seat 4: Perstenev folded before Flop (didn't bet)
Seat 5: Nerkit folded before Flop (didn't bet)
Seat 6: troublesomm folded before Flop (didn't bet)
Seat 7: DutchShultzs folded before Flop (didn't bet)
Seat 8: KrystalAA folded before Flop (didn't bet)
Seat 9: gunbowler collected ($26.50)



PokerStars Zoom Hand #84300027946:  Hold'em No Limit ($0.10/$0.25) - 2012/08/05 15:00:46 JST [2012/08/05 2:00:46 ET]
Table 'Whirlpool' 9-max Seat #1 is the button
Seat 1: Streikel ($17.14 in chips) 
Seat 2: yane73 ($58.86 in chips) 
Seat 3: kamikkaze ($15 in chips) 
Seat 4: snejokCoxx ($12.63 in chips) 
Seat 5: chiyuki ($25 in chips) 
Seat 6: Dejacob ($31.09 in chips) 
Seat 7: PAMBOS.L ($10.30 in chips) 
Seat 8: hirozo ($73.26 in chips) 
Seat 9: Nerkit ($12.15 in chips) 
yane73: posts small blind $0.10
kamikkaze: posts big blind $0.25
*** HOLE CARDS ***
Dealt to chiyuki [6s Td]
snejokCoxx: folds 
chiyuki: folds 
Dejacob: folds 
PAMBOS.L: raises $0.35 to $0.60
hirozo: folds 
Nerkit: folds 
Streikel: folds 
yane73: folds 
kamikkaze: folds 
Uncalled bet ($0.35) returned to PAMBOS.L
PAMBOS.L collected $0.60 from pot
PAMBOS.L: doesn't show hand 
*** SUMMARY ***
Total pot $0.60 | Rake $0 
Seat 1: Streikel (button) folded before Flop (didn't bet)
Seat 2: yane73 (small blind) folded before Flop
Seat 3: kamikkaze (big blind) folded before Flop
Seat 4: snejokCoxx folded before Flop (didn't bet)
Seat 5: chiyuki folded before Flop (didn't bet)
Seat 6: Dejacob folded before Flop (didn't bet)
Seat 7: PAMBOS.L collected ($0.60)
Seat 8: hirozo folded before Flop (didn't bet)
Seat 9: Nerkit folded before Flop (didn't bet)



PokerStars Zoom Hand #84300028760:  Hold'em No Limit ($0.10/$0.25) - 2012/08/05 15:00:50 JST [2012/08/05 2:00:50 ET]
Table 'Whirlpool' 9-max Seat #1 is the button
Seat 1: seula i ($106.96 in chips) 
Seat 2: Tom1999 ($25.68 in chips) 
Seat 3: GovGus ($34.31 in chips) 
Seat 4: KeLevro0 ($11.93 in chips) 
Seat 5: phate-1up ($35.19 in chips) 
Seat 6: chiyuki ($25 in chips) 
Seat 7: Silveystryk ($24.65 in chips) 
Seat 8: Dejacob ($25.71 in chips) 
Seat 9: INSP!RON ($25.79 in chips) 
Tom1999: posts small blind $0.10
GovGus: posts big blind $0.25
*** HOLE CARDS ***
Dealt to chiyuki [Qs 4h]
KeLevro0: folds 
phate-1up: folds 
chiyuki: folds 
Silveystryk: folds 
Dejacob: folds 
INSP!RON: folds 
seula i: raises $0.75 to $1
Tom1999: folds 
GovGus: folds 
Uncalled bet ($0.75) returned to seula i
seula i collected $0.60 from pot
seula i: doesn't show hand 
*** SUMMARY ***
Total pot $0.60 | Rake $0 
Seat 1: seula i (button) collected ($0.60)
Seat 2: Tom1999 (small blind) folded before Flop
Seat 3: GovGus (big blind) folded before Flop
Seat 4: KeLevro0 folded before Flop (didn't bet)
Seat 5: phate-1up folded before Flop (didn't bet)
Seat 6: chiyuki folded before Flop (didn't bet)
Seat 7: Silveystryk folded before Flop (didn't bet)
Seat 8: Dejacob folded before Flop (didn't bet)
Seat 9: INSP!RON folded before Flop (didn't bet)



PokerStars Zoom Hand #84300029450:  Hold'em No Limit ($0.10/$0.25) - 2012/08/05 15:00:53 JST [2012/08/05 2:00:53 ET]
Table 'Whirlpool' 9-max Seat #1 is the button
Seat 1: snejokCoxx ($12.63 in chips) 
Seat 2: deadmoneykid ($26.87 in chips) 
Seat 3: Tom1999 ($25.58 in chips) 
Seat 4: Jene4kaBest ($15.77 in chips) 
Seat 5: 1Karina1 ($25 in chips) 
Seat 6: hirozo ($73.26 in chips) 
Seat 7: INSP!RON ($25.79 in chips) 
Seat 8: softdesign ($63.29 in chips) 
Seat 9: chiyuki ($25 in chips) 
deadmoneykid: posts small blind $0.10
Tom1999: posts big blind $0.25
*** HOLE CARDS ***
Dealt to chiyuki [7c 5s]
Jene4kaBest: folds 
1Karina1: folds 
hirozo: folds 
INSP!RON: folds 
softdesign: folds 
chiyuki: folds 
snejokCoxx: folds 
deadmoneykid: raises $0.35 to $0.60
Tom1999: raises $0.65 to $1.25
deadmoneykid: calls $0.65
*** FLOP *** [Kh Ts 3c]
deadmoneykid: checks 
Tom1999: bets $1.25
deadmoneykid: folds 
Uncalled bet ($1.25) returned to Tom1999
Tom1999 collected $2.39 from pot
Tom1999: doesn't show hand 
*** SUMMARY ***
Total pot $2.50 | Rake $0.11 
Board [Kh Ts 3c]
Seat 1: snejokCoxx (button) folded before Flop (didn't bet)
Seat 2: deadmoneykid (small blind) folded on the Flop
Seat 3: Tom1999 (big blind) collected ($2.39)
Seat 4: Jene4kaBest folded before Flop (didn't bet)
Seat 5: 1Karina1 folded before Flop (didn't bet)
Seat 6: hirozo folded before Flop (didn't bet)
Seat 7: INSP!RON folded before Flop (didn't bet)
Seat 8: softdesign folded before Flop (didn't bet)
Seat 9: chiyuki folded before Flop (didn't bet)



PokerStars Zoom Hand #84300030778:  Hold'em No Limit ($0.10/$0.25) - 2012/08/05 15:00:59 JST [2012/08/05 2:00:59 ET]
Table 'Whirlpool' 9-max Seat #1 is the button
Seat 1: Gichboy ($6.20 in chips) 
Seat 2: Dejacob ($46.21 in chips) 
Seat 3: jacquelinewu ($46.46 in chips) 
Seat 4: chiyuki ($25 in chips) 
Seat 5: silvno31 ($16.84 in chips) 
Seat 6: ChrisCDee ($26.16 in chips) 
Seat 7: kesstukas25 ($14.44 in chips) 
Seat 8: Vahe50 ($34.48 in chips) 
Seat 9: PillZ86 ($11.20 in chips) 
Dejacob: posts small blind $0.10
jacquelinewu: posts big blind $0.25
*** HOLE CARDS ***
Dealt to chiyuki [As 5d]
chiyuki: folds 
silvno31: folds 
ChrisCDee: folds 
kesstukas25: folds 
Vahe50: raises $0.25 to $0.50
PillZ86: raises $1.25 to $1.75
Gichboy: folds 
Dejacob: folds 
jacquelinewu: folds 
Vahe50: folds 
Uncalled bet ($1.25) returned to PillZ86
PillZ86 collected $1.35 from pot
PillZ86: doesn't show hand 
*** SUMMARY ***
Total pot $1.35 | Rake $0 
Seat 1: Gichboy (button) folded before Flop (didn't bet)
Seat 2: Dejacob (small blind) folded before Flop
Seat 3: jacquelinewu (big blind) folded before Flop
Seat 4: chiyuki folded before Flop (didn't bet)
Seat 5: silvno31 folded before Flop (didn't bet)
Seat 6: ChrisCDee folded before Flop (didn't bet)
Seat 7: kesstukas25 folded before Flop (didn't bet)
Seat 8: Vahe50 folded before Flop
Seat 9: PillZ86 collected ($1.35)



PokerStars Zoom Hand #84300038312:  Hold'em No Limit ($0.10/$0.25) - 2012/08/05 15:01:32 JST [2012/08/05 2:01:32 ET]
Table 'Whirlpool' 9-max Seat #1 is the button
Seat 1: JhonnyP1979 ($21.69 in chips) 
Seat 2: kesstukas25 ($14.19 in chips) 
Seat 3: kamikkaze ($15.25 in chips) 
Seat 4: chiyuki ($24.90 in chips) 
Seat 5: Nerkit ($12.15 in chips) 
Seat 6: troublesomm ($37.13 in chips) 
Seat 7: snejokCoxx ($12.63 in chips) 
Seat 8: tribunpdm ($25.25 in chips) 
Seat 9: phate-1up ($70.53 in chips) 
kesstukas25: posts small blind $0.10
kamikkaze: posts big blind $0.25
*** HOLE CARDS ***
Dealt to chiyuki [2d 9c]
chiyuki: folds 
Nerkit: folds 
troublesomm: folds 
snejokCoxx: folds 
tribunpdm: raises $0.50 to $0.75
phate-1up: folds 
JhonnyP1979: folds 
kesstukas25: folds 
kamikkaze: folds 
Uncalled bet ($0.50) returned to tribunpdm
tribunpdm collected $0.60 from pot
tribunpdm: doesn't show hand 
*** SUMMARY ***
Total pot $0.60 | Rake $0 
Seat 1: JhonnyP1979 (button) folded before Flop (didn't bet)
Seat 2: kesstukas25 (small blind) folded before Flop
Seat 3: kamikkaze (big blind) folded before Flop
Seat 4: chiyuki folded before Flop (didn't bet)
Seat 5: Nerkit folded before Flop (didn't bet)
Seat 6: troublesomm folded before Flop (didn't bet)
Seat 7: snejokCoxx folded before Flop (didn't bet)
Seat 8: tribunpdm collected ($0.60)
Seat 9: phate-1up folded before Flop (didn't bet)



PokerStars Zoom Hand #84300032096:  Hold'em No Limit ($0.10/$0.25) - 2012/08/05 15:01:05 JST [2012/08/05 2:01:05 ET]
Table 'Whirlpool' 9-max Seat #1 is the button
Seat 1: turbotom122 ($14.58 in chips) 
Seat 2: Alvinpe85 ($58.47 in chips) 
Seat 3: Perstenev ($9.28 in chips) 
Seat 4: dushvan ($43.78 in chips) 
Seat 5: INSP!RON ($25.79 in chips) 
Seat 6: phate-1up ($51.99 in chips) 
Seat 7: tribunpdm ($25 in chips) 
Seat 8: chiyuki ($25 in chips) 
Seat 9: snejokCoxx ($12.63 in chips) 
Alvinpe85: posts small blind $0.10
Perstenev: posts big blind $0.25
*** HOLE CARDS ***
Dealt to chiyuki [3h 8h]
dushvan: folds 
INSP!RON: folds 
phate-1up: raises $0.50 to $0.75
tribunpdm: folds 
chiyuki: folds 
snejokCoxx: folds 
turbotom122: folds 
Alvinpe85: folds 
Perstenev: calls $0.50
*** FLOP *** [2c 4s Jh]
Perstenev: checks 
phate-1up: checks 
*** TURN *** [2c 4s Jh] [9s]
Perstenev: checks 
phate-1up: checks 
*** RIVER *** [2c 4s Jh 9s] [Jd]
Perstenev: bets $1.14
phate-1up: calls $1.14
*** SHOW DOWN ***
Perstenev: shows [3d 3s] (two pair, Jacks and Threes)
phate-1up: mucks hand 
Perstenev collected $3.71 from pot
*** SUMMARY ***
Total pot $3.88 | Rake $0.17 
Board [2c 4s Jh 9s Jd]
Seat 1: turbotom122 (button) folded before Flop (didn't bet)
Seat 2: Alvinpe85 (small blind) folded before Flop
Seat 3: Perstenev (big blind) showed [3d 3s] and won ($3.71) with two pair, Jacks and Threes
Seat 4: dushvan folded before Flop (didn't bet)
Seat 5: INSP!RON folded before Flop (didn't bet)
Seat 6: phate-1up mucked [Ah Qc]
Seat 7: tribunpdm folded before Flop (didn't bet)
Seat 8: chiyuki folded before Flop (didn't bet)
Seat 9: snejokCoxx folded before Flop (didn't bet)



PokerStars Zoom Hand #84300040443:  Hold'em No Limit ($0.10/$0.25) - 2012/08/05 15:01:41 JST [2012/08/05 2:01:41 ET]
Table 'Whirlpool' 9-max Seat #1 is the button
Seat 1: chiyuki ($24.90 in chips) 
Seat 2: Dejacob ($31.44 in chips) 
Seat 3: Alvinpe85 ($58.37 in chips) 
Seat 4: mjmichi ($25 in chips) 
Seat 5: Tom1999 ($26.72 in chips) 
Seat 6: INSP!RON ($25.78 in chips) 
Seat 7: phate-1up ($70.53 in chips) 
Seat 8: JhonnyP1979 ($21.69 in chips) 
Seat 9: jacquelinewu ($25 in chips) 
Dejacob: posts small blind $0.10
Alvinpe85: posts big blind $0.25
*** HOLE CARDS ***
Dealt to chiyuki [Ts As]
mjmichi: folds 
Tom1999: raises $0.50 to $0.75
INSP!RON: folds 
phate-1up: folds 
JhonnyP1979: folds 
jacquelinewu: folds 
chiyuki: folds 
Dejacob: folds 
Alvinpe85: folds 
Uncalled bet ($0.50) returned to Tom1999
Tom1999 collected $0.60 from pot
Tom1999: doesn't show hand 
*** SUMMARY ***
Total pot $0.60 | Rake $0 
Seat 1: chiyuki (button) folded before Flop (didn't bet)
Seat 2: Dejacob (small blind) folded before Flop
Seat 3: Alvinpe85 (big blind) folded before Flop
Seat 4: mjmichi folded before Flop (didn't bet)
Seat 5: Tom1999 collected ($0.60)
Seat 6: INSP!RON folded before Flop (didn't bet)
Seat 7: phate-1up folded before Flop (didn't bet)
Seat 8: JhonnyP1979 folded before Flop (didn't bet)
Seat 9: jacquelinewu folded before Flop (didn't bet)



PokerStars Zoom Hand #84300033409:  Hold'em No Limit ($0.10/$0.25) - 2012/08/05 15:01:11 JST [2012/08/05 2:01:11 ET]
Table 'Whirlpool' 9-max Seat #1 is the button
Seat 1: GovGus ($26 in chips) 
Seat 2: chiyuki ($25 in chips) 
Seat 3: Silveystryk ($24.65 in chips) 
Seat 4: 1Karina1 ($25.69 in chips) 
Seat 5: silvno31 ($16.84 in chips) 
Seat 6: Nerkit ($12.15 in chips) 
Seat 7: Streikel ($17.49 in chips) 
Seat 8: snejokCoxx ($12.63 in chips) 
Seat 9: edilson_ita ($10.41 in chips) 
chiyuki: posts small blind $0.10
Silveystryk: posts big blind $0.25
*** HOLE CARDS ***
Dealt to chiyuki [4h 3s]
1Karina1: raises $0.50 to $0.75
silvno31: folds 
Nerkit: folds 
Streikel: folds 
snejokCoxx: folds 
edilson_ita: calls $0.75
GovGus: folds 
chiyuki: folds 
Silveystryk: folds 
*** FLOP *** [Tc 6s 8h]
1Karina1: bets $1.25
edilson_ita: calls $1.25
*** TURN *** [Tc 6s 8h] [Qh]
1Karina1: checks 
edilson_ita: bets $1.25
1Karina1: calls $1.25
*** RIVER *** [Tc 6s 8h Qh] [Ah]
1Karina1: checks 
edilson_ita: bets $2
1Karina1: calls $2
*** SHOW DOWN ***
edilson_ita: shows [8s As] (two pair, Aces and Eights)
1Karina1: mucks hand 
edilson_ita collected $10.36 from pot
*** SUMMARY ***
Total pot $10.85 | Rake $0.49 
Board [Tc 6s 8h Qh Ah]
Seat 1: GovGus (button) folded before Flop (didn't bet)
Seat 2: chiyuki (small blind) folded before Flop
Seat 3: Silveystryk (big blind) folded before Flop
Seat 4: 1Karina1 mucked [Jd Js]
Seat 5: silvno31 folded before Flop (didn't bet)
Seat 6: Nerkit folded before Flop (didn't bet)
Seat 7: Streikel folded before Flop (didn't bet)
Seat 8: snejokCoxx folded before Flop (didn't bet)
Seat 9: edilson_ita showed [8s As] and won ($10.36) with two pair, Aces and Eights



PokerStars Zoom Hand #84300039699:  Hold'em No Limit ($0.10/$0.25) - 2012/08/05 15:01:38 JST [2012/08/05 2:01:38 ET]
Table 'Whirlpool' 9-max Seat #1 is the button
Seat 1: 1Karina1 ($25.65 in chips) 
Seat 2: ZhukOFFskI ($28.68 in chips) 
Seat 3: hirozo ($73.26 in chips) 
Seat 4: drunk_bender ($25 in chips) 
Seat 5: deadmoneykid ($27.87 in chips) 
Seat 6: metrio982 ($10.90 in chips) 
Seat 7: chiyuki ($24.90 in chips) 
Seat 8: River_GmbH ($13.55 in chips) 
Seat 9: KeLevro0 ($11.68 in chips) 
ZhukOFFskI: posts small blind $0.10
hirozo: posts big blind $0.25
*** HOLE CARDS ***
Dealt to chiyuki [2h Qc]
drunk_bender: folds 
deadmoneykid: folds 
metrio982: calls $0.25
chiyuki: folds 
River_GmbH: folds 
KeLevro0: folds 
1Karina1: folds 
ZhukOFFskI: raises $0.75 to $1
hirozo: folds 
metrio982: calls $0.75
*** FLOP *** [6s 8d 9s]
ZhukOFFskI: bets $1.29
metrio982: folds 
Uncalled bet ($1.29) returned to ZhukOFFskI
ZhukOFFskI collected $2.15 from pot
ZhukOFFskI: doesn't show hand 
*** SUMMARY ***
Total pot $2.25 | Rake $0.10 
Board [6s 8d 9s]
Seat 1: 1Karina1 (button) folded before Flop (didn't bet)
Seat 2: ZhukOFFskI (small blind) collected ($2.15)
Seat 3: hirozo (big blind) folded before Flop
Seat 4: drunk_bender folded before Flop (didn't bet)
Seat 5: deadmoneykid folded before Flop (didn't bet)
Seat 6: metrio982 folded on the Flop
Seat 7: chiyuki folded before Flop (didn't bet)
Seat 8: River_GmbH folded before Flop (didn't bet)
Seat 9: KeLevro0 folded before Flop (didn't bet)



PokerStars Zoom Hand #84300044354:  Hold'em No Limit ($0.10/$0.25) - 2012/08/05 15:01:58 JST [2012/08/05 2:01:58 ET]
Table 'Whirlpool' 9-max Seat #1 is the button
Seat 1: snejokCoxx ($10.53 in chips) 
Seat 2: jacquelinewu ($25 in chips) 
Seat 3: chiyuki ($24.90 in chips) 
Seat 4: KrystalAA ($28.66 in chips) 
Seat 5: cofla tito ($14.32 in chips) 
Seat 6: Silveystryk ($24 in chips) 
Seat 7: dushvan ($43.78 in chips) 
Seat 8: Paranoix1990 ($17.33 in chips) 
Seat 9: hirozo ($49.50 in chips) 
jacquelinewu: posts small blind $0.10
chiyuki: posts big blind $0.25
*** HOLE CARDS ***
Dealt to chiyuki [6c 7s]
KrystalAA: folds 
cofla tito: folds 
Silveystryk: folds 
dushvan: folds 
Paranoix1990: calls $0.25
hirozo: folds 
snejokCoxx: folds 
jacquelinewu: folds 
chiyuki: checks 
*** FLOP *** [9d 2d 2s]
chiyuki: checks 
Paranoix1990: checks 
*** TURN *** [9d 2d 2s] [7d]
chiyuki: checks 
Paranoix1990: checks 
*** RIVER *** [9d 2d 2s 7d] [4c]
chiyuki: bets $0.75
Paranoix1990: folds 
Uncalled bet ($0.75) returned to chiyuki
chiyuki collected $0.57 from pot
chiyuki: doesn't show hand 
*** SUMMARY ***
Total pot $0.60 | Rake $0.03 
Board [9d 2d 2s 7d 4c]
Seat 1: snejokCoxx (button) folded before Flop (didn't bet)
Seat 2: jacquelinewu (small blind) folded before Flop
Seat 3: chiyuki (big blind) collected ($0.57)
Seat 4: KrystalAA folded before Flop (didn't bet)
Seat 5: cofla tito folded before Flop (didn't bet)
Seat 6: Silveystryk folded before Flop (didn't bet)
Seat 7: dushvan folded before Flop (didn't bet)
Seat 8: Paranoix1990 folded on the River
Seat 9: hirozo folded before Flop (didn't bet)



PokerStars Zoom Hand #84300065424:  Hold'em No Limit ($0.10/$0.25) - 2012/08/05 15:03:24 JST [2012/08/05 2:03:24 ET]
Table 'Whirlpool' 9-max Seat #1 is the button
Seat 1: dushvan ($44.48 in chips) 
Seat 2: KimPa39 ($28.22 in chips) 
Seat 3: snejokCoxx ($10.18 in chips) 
Seat 4: Perstenev ($11.75 in chips) 
Seat 5: kamikkaze ($15.12 in chips) 
Seat 6: ChrisCDee ($45.65 in chips) 
Seat 7: Dejacob ($45.51 in chips) 
Seat 8: chiyuki ($25.12 in chips) 
Seat 9: troublesomm ($25 in chips) 
KimPa39: posts small blind $0.10
snejokCoxx: posts big blind $0.25
*** HOLE CARDS ***
Dealt to chiyuki [6d Qs]
Perstenev: folds 
kamikkaze: folds 
ChrisCDee: folds 
Dejacob: folds 
chiyuki: folds 
troublesomm: folds 
dushvan: folds 
KimPa39: folds 
Uncalled bet ($0.15) returned to snejokCoxx
snejokCoxx collected $0.20 from pot
snejokCoxx: doesn't show hand 
*** SUMMARY ***
Total pot $0.20 | Rake $0 
Seat 1: dushvan (button) folded before Flop (didn't bet)
Seat 2: KimPa39 (small blind) folded before Flop
Seat 3: snejokCoxx (big blind) collected ($0.20)
Seat 4: Perstenev folded before Flop (didn't bet)
Seat 5: kamikkaze folded before Flop (didn't bet)
Seat 6: ChrisCDee folded before Flop (didn't bet)
Seat 7: Dejacob folded before Flop (didn't bet)
Seat 8: chiyuki folded before Flop (didn't bet)
Seat 9: troublesomm folded before Flop (didn't bet)



PokerStars Zoom Hand #84300061064:  Hold'em No Limit ($0.10/$0.25) - 2012/08/05 15:03:08 JST [2012/08/05 2:03:08 ET]
Table 'Whirlpool' 9-max Seat #1 is the button
Seat 1: JhonnyP1979 ($9.29 in chips) 
Seat 2: Tom1999 ($23.01 in chips) 
Seat 3: KrystalAA ($29.01 in chips) 
Seat 4: KimPa39 ($28.22 in chips) 
Seat 5: cofla tito ($8.50 in chips) 
Seat 6: Nerkit ($23.45 in chips) 
Seat 7: phate-1up ($49.85 in chips) 
Seat 8: risekuku468 ($40.01 in chips) 
Seat 9: chiyuki ($25.22 in chips) 
Tom1999: posts small blind $0.10
KrystalAA: posts big blind $0.25
*** HOLE CARDS ***
Dealt to chiyuki [3h 7d]
KimPa39: folds 
cofla tito: folds 
Nerkit: folds 
phate-1up: folds 
risekuku468: folds 
chiyuki: folds 
JhonnyP1979: raises $0.75 to $1
Tom1999: raises $0.75 to $1.75
KrystalAA: folds 
JhonnyP1979: calls $0.75
*** FLOP *** [Qh Js 3d]
Tom1999: bets $1.50
JhonnyP1979: calls $1.50
*** TURN *** [Qh Js 3d] [8d]
Tom1999: bets $4.83
JhonnyP1979: folds 
Uncalled bet ($4.83) returned to Tom1999
Tom1999 collected $6.45 from pot
Tom1999: doesn't show hand 
*** SUMMARY ***
Total pot $6.75 | Rake $0.30 
Board [Qh Js 3d 8d]
Seat 1: JhonnyP1979 (button) folded on the Turn
Seat 2: Tom1999 (small blind) collected ($6.45)
Seat 3: KrystalAA (big blind) folded before Flop
Seat 4: KimPa39 folded before Flop (didn't bet)
Seat 5: cofla tito folded before Flop (didn't bet)
Seat 6: Nerkit folded before Flop (didn't bet)
Seat 7: phate-1up folded before Flop (didn't bet)
Seat 8: risekuku468 folded before Flop (didn't bet)
Seat 9: chiyuki folded before Flop (didn't bet)



PokerStars Zoom Hand #84300060370:  Hold'em No Limit ($0.10/$0.25) - 2012/08/05 15:03:05 JST [2012/08/05 2:03:05 ET]
Table 'Whirlpool' 9-max Seat #1 is the button
Seat 1: kamikkaze ($13.30 in chips) 
Seat 2: hobby56 ($14.11 in chips) 
Seat 3: ygoegoe ($25 in chips) 
Seat 4: Perstenev ($16.40 in chips) 
Seat 5: jacquelinewu ($34.13 in chips) 
Seat 6: chiyuki ($25.22 in chips) 
Seat 7: Dejacob ($26.48 in chips) 
Seat 8: hirozo ($49.25 in chips) 
Seat 9: 1Karina1 ($25.40 in chips) 
hobby56: posts small blind $0.10
ygoegoe: posts big blind $0.25
*** HOLE CARDS ***
Dealt to chiyuki [7s 2c]
Perstenev: folds 
jacquelinewu: folds 
chiyuki: folds 
Dejacob: folds 
hirozo: raises $0.50 to $0.75
1Karina1: calls $0.75
kamikkaze: folds 
hobby56: folds 
ygoegoe: folds 
*** FLOP *** [5c Qd 4d]
hirozo: bets $1.18
1Karina1: folds 
Uncalled bet ($1.18) returned to hirozo
hirozo collected $1.77 from pot
hirozo: doesn't show hand 
*** SUMMARY ***
Total pot $1.85 | Rake $0.08 
Board [5c Qd 4d]
Seat 1: kamikkaze (button) folded before Flop (didn't bet)
Seat 2: hobby56 (small blind) folded before Flop
Seat 3: ygoegoe (big blind) folded before Flop
Seat 4: Perstenev folded before Flop (didn't bet)
Seat 5: jacquelinewu folded before Flop (didn't bet)
Seat 6: chiyuki folded before Flop (didn't bet)
Seat 7: Dejacob folded before Flop (didn't bet)
Seat 8: hirozo collected ($1.77)
Seat 9: 1Karina1 folded on the Flop



PokerStars Zoom Hand #84300066445:  Hold'em No Limit ($0.10/$0.25) - 2012/08/05 15:03:28 JST [2012/08/05 2:03:28 ET]
Table 'Whirlpool' 9-max Seat #1 is the button
Seat 1: Jene4kaBest ($14.42 in chips) 
Seat 2: Silveystryk ($24.50 in chips) 
Seat 3: Perstenev ($11.75 in chips) 
Seat 4: INSP!RON ($25.44 in chips) 
Seat 5: deadmoneykid ($28.60 in chips) 
Seat 6: deepakmbh ($67.50 in chips) 
Seat 7: chiyuki ($25.12 in chips) 
Seat 8: jacquelinewu ($41.81 in chips) 
Seat 9: KimPa39 ($28.12 in chips) 
Silveystryk: posts small blind $0.10
Perstenev: posts big blind $0.25
*** HOLE CARDS ***
Dealt to chiyuki [4s Kh]
INSP!RON: folds 
deadmoneykid: folds 
deepakmbh: folds 
chiyuki: folds 
jacquelinewu: folds 
KimPa39: folds 
Jene4kaBest: folds 
Silveystryk: folds 
Uncalled bet ($0.15) returned to Perstenev
Perstenev collected $0.20 from pot
Perstenev: doesn't show hand 
*** SUMMARY ***
Total pot $0.20 | Rake $0 
Seat 1: Jene4kaBest (button) folded before Flop (didn't bet)
Seat 2: Silveystryk (small blind) folded before Flop
Seat 3: Perstenev (big blind) collected ($0.20)
Seat 4: INSP!RON folded before Flop (didn't bet)
Seat 5: deadmoneykid folded before Flop (didn't bet)
Seat 6: deepakmbh folded before Flop (didn't bet)
Seat 7: chiyuki folded before Flop (didn't bet)
Seat 8: jacquelinewu folded before Flop (didn't bet)
Seat 9: KimPa39 folded before Flop (didn't bet)



PokerStars Zoom Hand #84300062856:  Hold'em No Limit ($0.10/$0.25) - 2012/08/05 15:03:15 JST [2012/08/05 2:03:15 ET]
Table 'Whirlpool' 9-max Seat #1 is the button
Seat 1: womble32 ($28.37 in chips) 
Seat 2: chiyuki ($25.22 in chips) 
Seat 3: jacquelinewu ($25 in chips) 
Seat 4: DutchShultzs ($25.44 in chips) 
Seat 5: GovGus ($34.74 in chips) 
Seat 6: ZhukOFFskI ($46.50 in chips) 
Seat 7: risekuku468 ($40.01 in chips) 
Seat 8: Nerkit ($23.45 in chips) 
Seat 9: KrystalAA ($33.51 in chips) 
chiyuki: posts small blind $0.10
jacquelinewu: posts big blind $0.25
*** HOLE CARDS ***
Dealt to chiyuki [9s 4s]
DutchShultzs: raises $0.50 to $0.75
GovGus: folds 
ZhukOFFskI: folds 
risekuku468: folds 
Nerkit: calls $0.75
KrystalAA: folds 
womble32: folds 
chiyuki: folds 
jacquelinewu: folds 
*** FLOP *** [3h Jh 9c]
DutchShultzs: bets $1.40
Nerkit: folds 
Uncalled bet ($1.40) returned to DutchShultzs
DutchShultzs collected $1.77 from pot
DutchShultzs: doesn't show hand 
*** SUMMARY ***
Total pot $1.85 | Rake $0.08 
Board [3h Jh 9c]
Seat 1: womble32 (button) folded before Flop (didn't bet)
Seat 2: chiyuki (small blind) folded before Flop
Seat 3: jacquelinewu (big blind) folded before Flop
Seat 4: DutchShultzs collected ($1.77)
Seat 5: GovGus folded before Flop (didn't bet)
Seat 6: ZhukOFFskI folded before Flop (didn't bet)
Seat 7: risekuku468 folded before Flop (didn't bet)
Seat 8: Nerkit folded on the Flop
Seat 9: KrystalAA folded before Flop (didn't bet)



PokerStars Zoom Hand #84300067621:  Hold'em No Limit ($0.10/$0.25) - 2012/08/05 15:03:33 JST [2012/08/05 2:03:33 ET]
Table 'Whirlpool' 9-max Seat #1 is the button
Seat 1: hirozo ($65.38 in chips) 
Seat 2: jeades ($14.75 in chips) 
Seat 3: el pore 5 ($14.88 in chips) 
Seat 4: drunk_bender ($23.70 in chips) 
Seat 5: chiyuki ($25.12 in chips) 
Seat 6: 1Karina1 ($27.76 in chips) 
Seat 7: Jene4kaBest ($14.42 in chips) 
Seat 8: troublesomm ($25 in chips) 
Seat 9: Vahe50 ($10.29 in chips) 
jeades: posts small blind $0.10
el pore 5: posts big blind $0.25
*** HOLE CARDS ***
Dealt to chiyuki [Td 7d]
drunk_bender: folds 
chiyuki: folds 
1Karina1: folds 
Jene4kaBest: raises $0.50 to $0.75
troublesomm: folds 
Vahe50: folds 
hirozo: raises $1.60 to $2.35
jeades: folds 
el pore 5: folds 
Jene4kaBest: folds 
Uncalled bet ($1.60) returned to hirozo
hirozo collected $1.85 from pot
hirozo: doesn't show hand 
*** SUMMARY ***
Total pot $1.85 | Rake $0 
Seat 1: hirozo (button) collected ($1.85)
Seat 2: jeades (small blind) folded before Flop
Seat 3: el pore 5 (big blind) folded before Flop
Seat 4: drunk_bender folded before Flop (didn't bet)
Seat 5: chiyuki folded before Flop (didn't bet)
Seat 6: 1Karina1 folded before Flop (didn't bet)
Seat 7: Jene4kaBest folded before Flop
Seat 8: troublesomm folded before Flop (didn't bet)
Seat 9: Vahe50 folded before Flop (didn't bet)



PokerStars Zoom Hand #84300068745:  Hold'em No Limit ($0.10/$0.25) - 2012/08/05 15:03:37 JST [2012/08/05 2:03:37 ET]
Table 'Whirlpool' 9-max Seat #1 is the button
Seat 1: phate-1up ($70.43 in chips) 
Seat 2: drunk_bender ($23.70 in chips) 
Seat 3: chiyuki ($25.12 in chips) 
Seat 4: GovGus ($42.06 in chips) 
Seat 5: 1Karina1 ($25 in chips) 
Seat 6: dushvan ($44.48 in chips) 
Seat 7: ChrisCDee ($25.12 in chips) 
Seat 8: snejokCoxx ($12.33 in chips) 
Seat 9: JhonnyP1979 ($6.04 in chips) 
drunk_bender: posts small blind $0.10
chiyuki: posts big blind $0.25
*** HOLE CARDS ***
Dealt to chiyuki [Tc 3d]
GovGus: folds 
1Karina1: calls $0.25
dushvan: folds 
ChrisCDee: folds 
snejokCoxx: folds 
JhonnyP1979: folds 
phate-1up: folds 
drunk_bender: folds 
chiyuki: checks 
*** FLOP *** [4s Js 5s]
chiyuki: checks 
1Karina1: bets $0.57
chiyuki: folds 
Uncalled bet ($0.57) returned to 1Karina1
1Karina1 collected $0.57 from pot
1Karina1: doesn't show hand 
*** SUMMARY ***
Total pot $0.60 | Rake $0.03 
Board [4s Js 5s]
Seat 1: phate-1up (button) folded before Flop (didn't bet)
Seat 2: drunk_bender (small blind) folded before Flop
Seat 3: chiyuki (big blind) folded on the Flop
Seat 4: GovGus folded before Flop (didn't bet)
Seat 5: 1Karina1 collected ($0.57)
Seat 6: dushvan folded before Flop (didn't bet)
Seat 7: ChrisCDee folded before Flop (didn't bet)
Seat 8: snejokCoxx folded before Flop (didn't bet)
Seat 9: JhonnyP1979 folded before Flop (didn't bet)



PokerStars Zoom Hand #84300076527:  Hold'em No Limit ($0.10/$0.25) - 2012/08/05 15:04:09 JST [2012/08/05 2:04:09 ET]
Table 'Whirlpool' 9-max Seat #1 is the button
Seat 1: chiyuki ($24.87 in chips) 
Seat 2: Wilcox76607 ($34.70 in chips) 
Seat 3: phate-1up ($49.75 in chips) 
Seat 4: DutchShultzs ($32.60 in chips) 
Seat 5: KrystalAA ($28.66 in chips) 
Seat 6: 1Karina1 ($25 in chips) 
Seat 7: starreset ($25 in chips) 
Seat 8: Perstenev ($15.68 in chips) 
Seat 9: snejokCoxx ($10.18 in chips) 
Wilcox76607: posts small blind $0.10
phate-1up: posts big blind $0.25
*** HOLE CARDS ***
Dealt to chiyuki [Jh 8d]
DutchShultzs: folds 
KrystalAA: folds 
1Karina1: folds 
starreset: raises $0.50 to $0.75
Perstenev: folds 
snejokCoxx: folds 
chiyuki: folds 
Wilcox76607: folds 
phate-1up: calls $0.50
*** FLOP *** [9s 7d Kh]
phate-1up: checks 
starreset: bets $1
phate-1up: folds 
Uncalled bet ($1) returned to starreset
starreset collected $1.53 from pot
starreset: doesn't show hand 
*** SUMMARY ***
Total pot $1.60 | Rake $0.07 
Board [9s 7d Kh]
Seat 1: chiyuki (button) folded before Flop (didn't bet)
Seat 2: Wilcox76607 (small blind) folded before Flop
Seat 3: phate-1up (big blind) folded on the Flop
Seat 4: DutchShultzs folded before Flop (didn't bet)
Seat 5: KrystalAA folded before Flop (didn't bet)
Seat 6: 1Karina1 folded before Flop (didn't bet)
Seat 7: starreset collected ($1.53)
Seat 8: Perstenev folded before Flop (didn't bet)
Seat 9: snejokCoxx folded before Flop (didn't bet)



PokerStars Zoom Hand #84300083821:  Hold'em No Limit ($0.10/$0.25) - 2012/08/05 15:04:38 JST [2012/08/05 2:04:38 ET]
Table 'Whirlpool' 9-max Seat #1 is the button
Seat 1: cofla tito ($9.64 in chips) 
Seat 2: phate-1up ($69.43 in chips) 
Seat 3: kamikkaze ($12.95 in chips) 
Seat 4: Silveystryk ($23.30 in chips) 
Seat 5: silvno31 ($18.02 in chips) 
Seat 6: chiyuki ($24.77 in chips) 
Seat 7: DutchShultzs ($30.06 in chips) 
Seat 8: womble32 ($28.37 in chips) 
Seat 9: seula i ($106.11 in chips) 
phate-1up: posts small blind $0.10
kamikkaze: posts big blind $0.25
*** HOLE CARDS ***
Dealt to chiyuki [Kh 3d]
Silveystryk: folds 
silvno31: folds 
chiyuki: folds 
DutchShultzs: folds 
womble32: folds 
seula i: folds 
cofla tito: folds 
phate-1up: folds 
Uncalled bet ($0.15) returned to kamikkaze
kamikkaze collected $0.20 from pot
kamikkaze: doesn't show hand 
*** SUMMARY ***
Total pot $0.20 | Rake $0 
Seat 1: cofla tito (button) folded before Flop (didn't bet)
Seat 2: phate-1up (small blind) folded before Flop
Seat 3: kamikkaze (big blind) collected ($0.20)
Seat 4: Silveystryk folded before Flop (didn't bet)
Seat 5: silvno31 folded before Flop (didn't bet)
Seat 6: chiyuki folded before Flop (didn't bet)
Seat 7: DutchShultzs folded before Flop (didn't bet)
Seat 8: womble32 folded before Flop (didn't bet)
Seat 9: seula i folded before Flop (didn't bet)



PokerStars Zoom Hand #84300085646:  Hold'em No Limit ($0.10/$0.25) - 2012/08/05 15:04:45 JST [2012/08/05 2:04:45 ET]
Table 'Whirlpool' 9-max Seat #1 is the button
Seat 1: chiyuki ($24.77 in chips) 
Seat 2: ygoegoe ($25 in chips) 
Seat 3: Perstenev ($15.68 in chips) 
Seat 4: bigred1102 ($30.51 in chips) 
Seat 5: el pore 5 ($16.46 in chips) 
Seat 6: 4ydo yogurt ($24.64 in chips) 
Seat 7: Streikel ($16.52 in chips) 
Seat 8: laurentzu84 ($27.46 in chips) 
Seat 9: mjmichi ($28.97 in chips) 
ygoegoe: posts small blind $0.10
Perstenev: posts big blind $0.25
*** HOLE CARDS ***
Dealt to chiyuki [2s 3h]
bigred1102: folds 
el pore 5: folds 
4ydo yogurt: folds 
Streikel: folds 
laurentzu84: folds 
mjmichi: folds 
chiyuki: folds 
ygoegoe: raises $0.37 to $0.62
Perstenev: folds 
Uncalled bet ($0.37) returned to ygoegoe
ygoegoe collected $0.50 from pot
ygoegoe: doesn't show hand 
*** SUMMARY ***
Total pot $0.50 | Rake $0 
Seat 1: chiyuki (button) folded before Flop (didn't bet)
Seat 2: ygoegoe (small blind) collected ($0.50)
Seat 3: Perstenev (big blind) folded before Flop
Seat 4: bigred1102 folded before Flop (didn't bet)
Seat 5: el pore 5 folded before Flop (didn't bet)
Seat 6: 4ydo yogurt folded before Flop (didn't bet)
Seat 7: Streikel folded before Flop (didn't bet)
Seat 8: laurentzu84 folded before Flop (didn't bet)
Seat 9: mjmichi folded before Flop (didn't bet)



PokerStars Zoom Hand #84300081543:  Hold'em No Limit ($0.10/$0.25) - 2012/08/05 15:04:29 JST [2012/08/05 2:04:29 ET]
Table 'Whirlpool' 9-max Seat #1 is the button
Seat 1: Littlea029 ($29.96 in chips) 
Seat 2: jacquelinewu ($26.52 in chips) 
Seat 3: snejokCoxx ($12.23 in chips) 
Seat 4: kamikkaze ($12.95 in chips) 
Seat 5: Silveystryk ($28.72 in chips) 
Seat 6: hirozo ($29.30 in chips) 
Seat 7: chiyuki ($24.87 in chips) 
Seat 8: DutchShultzs ($30.06 in chips) 
Seat 9: Alvinpe85 ($47.83 in chips) 
jacquelinewu: posts small blind $0.10
snejokCoxx: posts big blind $0.25
*** HOLE CARDS ***
Dealt to chiyuki [2s 3d]
kamikkaze: folds 
Silveystryk: folds 
hirozo: folds 
chiyuki: folds 
DutchShultzs: folds 
Alvinpe85: folds 
Littlea029: raises $0.25 to $0.50
jacquelinewu: folds 
snejokCoxx: folds 
Uncalled bet ($0.25) returned to Littlea029
Littlea029 collected $0.60 from pot
Littlea029: doesn't show hand 
*** SUMMARY ***
Total pot $0.60 | Rake $0 
Seat 1: Littlea029 (button) collected ($0.60)
Seat 2: jacquelinewu (small blind) folded before Flop
Seat 3: snejokCoxx (big blind) folded before Flop
Seat 4: kamikkaze folded before Flop (didn't bet)
Seat 5: Silveystryk folded before Flop (didn't bet)
Seat 6: hirozo folded before Flop (didn't bet)
Seat 7: chiyuki folded before Flop (didn't bet)
Seat 8: DutchShultzs folded before Flop (didn't bet)
Seat 9: Alvinpe85 folded before Flop (didn't bet)



PokerStars Zoom Hand #84300080783:  Hold'em No Limit ($0.10/$0.25) - 2012/08/05 15:04:26 JST [2012/08/05 2:04:26 ET]
Table 'Whirlpool' 9-max Seat #1 is the button
Seat 1: KrystalAA ($33.26 in chips) 
Seat 2: ZhukOFFskI ($48.19 in chips) 
Seat 3: Wilcox76607 ($34.60 in chips) 
Seat 4: troublesomm ($40.96 in chips) 
Seat 5: seula i ($34.31 in chips) 
Seat 6: DutchShultzs ($30.06 in chips) 
Seat 7: Perstenev ($15.68 in chips) 
Seat 8: risekuku468 ($40.01 in chips) 
Seat 9: chiyuki ($24.87 in chips) 
ZhukOFFskI: posts small blind $0.10
Wilcox76607: posts big blind $0.25
*** HOLE CARDS ***
Dealt to chiyuki [Jh 5c]
troublesomm: folds 
seula i: folds 
DutchShultzs: folds 
Perstenev: folds 
risekuku468: raises $0.50 to $0.75
chiyuki: folds 
KrystalAA: folds 
ZhukOFFskI: folds 
Wilcox76607: calls $0.50
*** FLOP *** [4d 7s 2c]
Wilcox76607: checks 
risekuku468: bets $1.14
Wilcox76607: folds 
Uncalled bet ($1.14) returned to risekuku468
risekuku468 collected $1.53 from pot
risekuku468: doesn't show hand 
*** SUMMARY ***
Total pot $1.60 | Rake $0.07 
Board [4d 7s 2c]
Seat 1: KrystalAA (button) folded before Flop (didn't bet)
Seat 2: ZhukOFFskI (small blind) folded before Flop
Seat 3: Wilcox76607 (big blind) folded on the Flop
Seat 4: troublesomm folded before Flop (didn't bet)
Seat 5: seula i folded before Flop (didn't bet)
Seat 6: DutchShultzs folded before Flop (didn't bet)
Seat 7: Perstenev folded before Flop (didn't bet)
Seat 8: risekuku468 collected ($1.53)
Seat 9: chiyuki folded before Flop (didn't bet)



PokerStars Zoom Hand #84300079503:  Hold'em No Limit ($0.10/$0.25) - 2012/08/05 15:04:21 JST [2012/08/05 2:04:21 ET]
Table 'Whirlpool' 9-max Seat #1 is the button
Seat 1: Nerkit ($9.02 in chips) 
Seat 2: Silveystryk ($23.40 in chips) 
Seat 3: Paranoix1990 ($17.83 in chips) 
Seat 4: ygoegoe ($25 in chips) 
Seat 5: Perstenev ($15.68 in chips) 
Seat 6: cofla tito ($12.27 in chips) 
Seat 7: Wilcox76607 ($34.60 in chips) 
Seat 8: chiyuki ($24.87 in chips) 
Seat 9: seula i ($34.31 in chips) 
Silveystryk: posts small blind $0.10
Paranoix1990: posts big blind $0.25
*** HOLE CARDS ***
Dealt to chiyuki [3c 2s]
ygoegoe: folds 
Perstenev: folds 
cofla tito: folds 
Wilcox76607: folds 
chiyuki: folds 
seula i: folds 
Nerkit: raises $0.37 to $0.62
Silveystryk: folds 
Paranoix1990: calls $0.37
*** FLOP *** [Qs 9c Kc]
Paranoix1990: checks 
Nerkit: bets $0.75
Paranoix1990: calls $0.75
*** TURN *** [Qs 9c Kc] [Jc]
Paranoix1990: bets $0.50
Nerkit: calls $0.50
*** RIVER *** [Qs 9c Kc Jc] [8c]
Paranoix1990: bets $0.25
Nerkit: calls $0.25
*** SHOW DOWN ***
Paranoix1990: shows [Jh Jd] (three of a kind, Jacks)
Nerkit: mucks hand 
Paranoix1990 collected $4.14 from pot
*** SUMMARY ***
Total pot $4.34 | Rake $0.20 
Board [Qs 9c Kc Jc 8c]
Seat 1: Nerkit (button) mucked [9s Qd]
Seat 2: Silveystryk (small blind) folded before Flop
Seat 3: Paranoix1990 (big blind) showed [Jh Jd] and won ($4.14) with three of a kind, Jacks
Seat 4: ygoegoe folded before Flop (didn't bet)
Seat 5: Perstenev folded before Flop (didn't bet)
Seat 6: cofla tito folded before Flop (didn't bet)
Seat 7: Wilcox76607 folded before Flop (didn't bet)
Seat 8: chiyuki folded before Flop (didn't bet)
Seat 9: seula i folded before Flop (didn't bet)



PokerStars Zoom Hand #84300082819:  Hold'em No Limit ($0.10/$0.25) - 2012/08/05 15:04:34 JST [2012/08/05 2:04:34 ET]
Table 'Whirlpool' 9-max Seat #1 is the button
Seat 1: Silveystryk ($23.30 in chips) 
Seat 2: chiyuki ($24.87 in chips) 
Seat 3: Rilko1975 ($25 in chips) 
Seat 4: yane73 ($75.44 in chips) 
Seat 5: puffy5533 ($28.72 in chips) 
Seat 6: deadmoneykid ($26.01 in chips) 
Seat 7: 1Karina1 ($28.31 in chips) 
Seat 8: kamikkaze ($12.95 in chips) 
Seat 9: Dejacob ($26.23 in chips) 
chiyuki: posts small blind $0.10
Rilko1975: posts big blind $0.25
*** HOLE CARDS ***
Dealt to chiyuki [7h 4s]
yane73: calls $0.25
puffy5533: folds 
deadmoneykid: folds 
1Karina1: folds 
kamikkaze: folds 
Dejacob: folds 
Silveystryk: folds 
chiyuki: folds 
Rilko1975: checks 
*** FLOP *** [Ks Tc Qd]
Rilko1975: checks 
yane73: bets $1
Rilko1975: folds 
Uncalled bet ($1) returned to yane73
yane73 collected $0.57 from pot
yane73: doesn't show hand 
*** SUMMARY ***
Total pot $0.60 | Rake $0.03 
Board [Ks Tc Qd]
Seat 1: Silveystryk (button) folded before Flop (didn't bet)
Seat 2: chiyuki (small blind) folded before Flop
Seat 3: Rilko1975 (big blind) folded on the Flop
Seat 4: yane73 collected ($0.57)
Seat 5: puffy5533 folded before Flop (didn't bet)
Seat 6: deadmoneykid folded before Flop (didn't bet)
Seat 7: 1Karina1 folded before Flop (didn't bet)
Seat 8: kamikkaze folded before Flop (didn't bet)
Seat 9: Dejacob folded before Flop (didn't bet)



PokerStars Zoom Hand #84300084891:  Hold'em No Limit ($0.10/$0.25) - 2012/08/05 15:04:42 JST [2012/08/05 2:04:42 ET]
Table 'Whirlpool' 9-max Seat #1 is the button
Seat 1: phate-1up ($48.90 in chips) 
Seat 2: troublesomm ($40.96 in chips) 
Seat 3: Alvinpe85 ($51.76 in chips) 
Seat 4: DutchShultzs ($30.06 in chips) 
Seat 5: chiyuki ($24.77 in chips) 
Seat 6: INSP!RON ($25 in chips) 
Seat 7: silvno31 ($18.02 in chips) 
Seat 8: hirozo ($50.62 in chips) 
Seat 9: Silveystryk ($23.30 in chips) 
troublesomm: posts small blind $0.10
Alvinpe85: posts big blind $0.25
*** HOLE CARDS ***
Dealt to chiyuki [Qh 7h]
DutchShultzs: folds 
chiyuki: folds 
INSP!RON: folds 
silvno31: raises $0.50 to $0.75
hirozo: folds 
Silveystryk: folds 
phate-1up: raises $1.50 to $2.25
troublesomm: folds 
Alvinpe85: folds 
silvno31: calls $1.50
*** FLOP *** [2h 4c Jd]
silvno31: checks 
phate-1up: bets $2.50
silvno31: calls $2.50
*** TURN *** [2h 4c Jd] [7c]
silvno31: checks 
phate-1up: checks 
*** RIVER *** [2h 4c Jd 7c] [As]
silvno31: checks 
phate-1up: bets $7
silvno31: folds 
Uncalled bet ($7) returned to phate-1up
phate-1up collected $9.41 from pot
phate-1up: doesn't show hand 
*** SUMMARY ***
Total pot $9.85 | Rake $0.44 
Board [2h 4c Jd 7c As]
Seat 1: phate-1up (button) collected ($9.41)
Seat 2: troublesomm (small blind) folded before Flop
Seat 3: Alvinpe85 (big blind) folded before Flop
Seat 4: DutchShultzs folded before Flop (didn't bet)
Seat 5: chiyuki folded before Flop (didn't bet)
Seat 6: INSP!RON folded before Flop (didn't bet)
Seat 7: silvno31 folded on the River
Seat 8: hirozo folded before Flop (didn't bet)
Seat 9: Silveystryk folded before Flop (didn't bet)



PokerStars Zoom Hand #84300087262:  Hold'em No Limit ($0.10/$0.25) - 2012/08/05 15:04:51 JST [2012/08/05 2:04:51 ET]
Table 'Whirlpool' 9-max Seat #1 is the button
Seat 1: GovGus ($28.20 in chips) 
Seat 2: cofla tito ($9.64 in chips) 
Seat 3: el pore 5 ($16.46 in chips) 
Seat 4: womble32 ($28.37 in chips) 
Seat 5: chiyuki ($24.77 in chips) 
Seat 6: laurentzu84 ($27.46 in chips) 
Seat 7: mjmichi ($28.97 in chips) 
Seat 8: Silveystryk ($23.30 in chips) 
Seat 9: ChrisCDee ($27.75 in chips) 
cofla tito: posts small blind $0.10
el pore 5: posts big blind $0.25
*** HOLE CARDS ***
Dealt to chiyuki [Qd Ad]
womble32: folds 
chiyuki: raises $0.50 to $0.75
laurentzu84: folds 
mjmichi: folds 
Silveystryk: calls $0.75
ChrisCDee: folds 
GovGus: calls $0.75
cofla tito: folds 
el pore 5: calls $0.50
*** FLOP *** [7h 4c 3s]
el pore 5: checks 
chiyuki: checks 
Silveystryk: checks 
GovGus: checks 
*** TURN *** [7h 4c 3s] [Ks]
el pore 5: checks 
chiyuki: checks 
Silveystryk: checks 
GovGus: checks 
*** RIVER *** [7h 4c 3s Ks] [9s]
el pore 5: checks 
chiyuki: checks 
Silveystryk: checks 
GovGus: checks 
*** SHOW DOWN ***
el pore 5: shows [4d 5d] (a pair of Fours)
chiyuki: mucks hand 
Silveystryk: mucks hand 
GovGus: mucks hand 
el pore 5 collected $2.96 from pot
*** SUMMARY ***
Total pot $3.10 | Rake $0.14 
Board [7h 4c 3s Ks 9s]
Seat 1: GovGus (button) mucked [6h 2h]
Seat 2: cofla tito (small blind) folded before Flop
Seat 3: el pore 5 (big blind) showed [4d 5d] and won ($2.96) with a pair of Fours
Seat 4: womble32 folded before Flop (didn't bet)
Seat 5: chiyuki mucked [Qd Ad]
Seat 6: laurentzu84 folded before Flop (didn't bet)
Seat 7: mjmichi folded before Flop (didn't bet)
Seat 8: Silveystryk mucked [Ah Th]
Seat 9: ChrisCDee folded before Flop (didn't bet)



PokerStars Zoom Hand #84300108752:  Hold'em No Limit ($0.10/$0.25) - 2012/08/05 15:06:16 JST [2012/08/05 2:06:16 ET]
Table 'Whirlpool' 9-max Seat #1 is the button
Seat 1: Gichboy ($4.89 in chips) 
Seat 2: GovGus ($27.45 in chips) 
Seat 3: 1Karina1 ($30.64 in chips) 
Seat 4: chiyuki ($24.02 in chips) 
Seat 5: deadmoneykid ($25.91 in chips) 
Seat 6: azizmimi ($28.14 in chips) 
Seat 7: KrystalAA ($28.31 in chips) 
Seat 8: troublesomm ($27.70 in chips) 
Seat 9: KeLevro0 ($13.68 in chips) 
GovGus: posts small blind $0.10
1Karina1: posts big blind $0.25
*** HOLE CARDS ***
Dealt to chiyuki [7h 8d]
chiyuki: folds 
deadmoneykid: folds 
azizmimi: folds 
KrystalAA: folds 
troublesomm: raises $0.50 to $0.75
KeLevro0: folds 
Gichboy: folds 
GovGus: folds 
1Karina1: folds 
Uncalled bet ($0.50) returned to troublesomm
troublesomm collected $0.60 from pot
troublesomm: doesn't show hand 
*** SUMMARY ***
Total pot $0.60 | Rake $0 
Seat 1: Gichboy (button) folded before Flop (didn't bet)
Seat 2: GovGus (small blind) folded before Flop
Seat 3: 1Karina1 (big blind) folded before Flop
Seat 4: chiyuki folded before Flop (didn't bet)
Seat 5: deadmoneykid folded before Flop (didn't bet)
Seat 6: azizmimi folded before Flop (didn't bet)
Seat 7: KrystalAA folded before Flop (didn't bet)
Seat 8: troublesomm collected ($0.60)
Seat 9: KeLevro0 folded before Flop (didn't bet)



PokerStars Zoom Hand #84300114508:  Hold'em No Limit ($0.10/$0.25) - 2012/08/05 15:06:39 JST [2012/08/05 2:06:39 ET]
Table 'Whirlpool' 9-max Seat #1 is the button
Seat 1: pandaaaaaa ($12.60 in chips) 
Seat 2: seula i ($31.81 in chips) 
Seat 3: Alvinpe85 ($48.51 in chips) 
Seat 4: phate-1up ($48.96 in chips) 
Seat 5: kamikkaze ($12.35 in chips) 
Seat 6: deepakmbh ($34.44 in chips) 
Seat 7: puffy5533 ($26.34 in chips) 
Seat 8: chiyuki ($23.77 in chips) 
Seat 9: WARIBANA7777 ($15.63 in chips) 
seula i: posts small blind $0.10
Alvinpe85: posts big blind $0.25
*** HOLE CARDS ***
Dealt to chiyuki [Ks 3h]
phate-1up: folds 
kamikkaze: folds 
deepakmbh: raises $0.50 to $0.75
puffy5533: folds 
chiyuki: folds 
WARIBANA7777: folds 
pandaaaaaa: folds 
seula i: folds 
Alvinpe85: folds 
Uncalled bet ($0.50) returned to deepakmbh
deepakmbh collected $0.60 from pot
deepakmbh: doesn't show hand 
*** SUMMARY ***
Total pot $0.60 | Rake $0 
Seat 1: pandaaaaaa (button) folded before Flop (didn't bet)
Seat 2: seula i (small blind) folded before Flop
Seat 3: Alvinpe85 (big blind) folded before Flop
Seat 4: phate-1up folded before Flop (didn't bet)
Seat 5: kamikkaze folded before Flop (didn't bet)
Seat 6: deepakmbh collected ($0.60)
Seat 7: puffy5533 folded before Flop (didn't bet)
Seat 8: chiyuki folded before Flop (didn't bet)
Seat 9: WARIBANA7777 folded before Flop (didn't bet)



PokerStars Zoom Hand #84300113215:  Hold'em No Limit ($0.10/$0.25) - 2012/08/05 15:06:34 JST [2012/08/05 2:06:34 ET]
Table 'Whirlpool' 9-max Seat #1 is the button
Seat 1: simonzez ($24.33 in chips) 
Seat 2: ZhukOFFskI ($29.23 in chips) 
Seat 3: KeLevro0 ($9.20 in chips) 
Seat 4: PillZ86 ($23.39 in chips) 
Seat 5: 1Karina1 ($25.10 in chips) 
Seat 6: puffy5533 ($26.34 in chips) 
Seat 7: Perstenev ($20.38 in chips) 
Seat 8: Alvinpe85 ($48.51 in chips) 
Seat 9: chiyuki ($23.77 in chips) 
ZhukOFFskI: posts small blind $0.10
KeLevro0: posts big blind $0.25
*** HOLE CARDS ***
Dealt to chiyuki [Jh 7c]
PillZ86: folds 
1Karina1: folds 
puffy5533: folds 
Perstenev: folds 
Alvinpe85: folds 
chiyuki: folds 
simonzez: calls $0.25
ZhukOFFskI: folds 
KeLevro0: checks 
*** FLOP *** [Qh 3c Td]
KeLevro0: checks 
simonzez: checks 
*** TURN *** [Qh 3c Td] [9c]
KeLevro0: bets $0.31
simonzez: folds 
Uncalled bet ($0.31) returned to KeLevro0
KeLevro0 collected $0.57 from pot
KeLevro0: doesn't show hand 
*** SUMMARY ***
Total pot $0.60 | Rake $0.03 
Board [Qh 3c Td 9c]
Seat 1: simonzez (button) folded on the Turn
Seat 2: ZhukOFFskI (small blind) folded before Flop
Seat 3: KeLevro0 (big blind) collected ($0.57)
Seat 4: PillZ86 folded before Flop (didn't bet)
Seat 5: 1Karina1 folded before Flop (didn't bet)
Seat 6: puffy5533 folded before Flop (didn't bet)
Seat 7: Perstenev folded before Flop (didn't bet)
Seat 8: Alvinpe85 folded before Flop (didn't bet)
Seat 9: chiyuki folded before Flop (didn't bet)



PokerStars Zoom Hand #84300116065:  Hold'em No Limit ($0.10/$0.25) - 2012/08/05 15:06:45 JST [2012/08/05 2:06:45 ET]
Table 'Whirlpool' 9-max Seat #1 is the button
Seat 1: WARIBANA7777 ($15.63 in chips) 
Seat 2: pandaaaaaa ($12.60 in chips) 
Seat 3: snejokCoxx ($13.90 in chips) 
Seat 4: chiyuki ($23.77 in chips) 
Seat 5: troublesomm ($40.61 in chips) 
Seat 6: hirozo ($80.65 in chips) 
Seat 7: Vahe50 ($13.94 in chips) 
Seat 8: DanielWhyte ($56.84 in chips) 
Seat 9: KrystalAA ($28.31 in chips) 
pandaaaaaa: posts small blind $0.10
snejokCoxx: posts big blind $0.25
*** HOLE CARDS ***
Dealt to chiyuki [8c Js]
chiyuki: folds 
troublesomm: raises $0.50 to $0.75
hirozo: folds 
Vahe50: folds 
DanielWhyte: folds 
KrystalAA: folds 
WARIBANA7777: folds 
pandaaaaaa: folds 
snejokCoxx: folds 
Uncalled bet ($0.50) returned to troublesomm
troublesomm collected $0.60 from pot
troublesomm: doesn't show hand 
*** SUMMARY ***
Total pot $0.60 | Rake $0 
Seat 1: WARIBANA7777 (button) folded before Flop (didn't bet)
Seat 2: pandaaaaaa (small blind) folded before Flop
Seat 3: snejokCoxx (big blind) folded before Flop
Seat 4: chiyuki folded before Flop (didn't bet)
Seat 5: troublesomm collected ($0.60)
Seat 6: hirozo folded before Flop (didn't bet)
Seat 7: Vahe50 folded before Flop (didn't bet)
Seat 8: DanielWhyte folded before Flop (didn't bet)
Seat 9: KrystalAA folded before Flop (didn't bet)



PokerStars Zoom Hand #84300109475:  Hold'em No Limit ($0.10/$0.25) - 2012/08/05 15:06:19 JST [2012/08/05 2:06:19 ET]
Table 'Whirlpool' 9-max Seat #1 is the button
Seat 1: MOReilly000 ($33.60 in chips) 
Seat 2: Silveystryk ($28.69 in chips) 
Seat 3: chiyuki ($24.02 in chips) 
Seat 4: Ellen1947 ($29.81 in chips) 
Seat 5: PillZ86 ($23.39 in chips) 
Seat 6: 4ydo yogurt ($25.24 in chips) 
Seat 7: pandaaaaaa ($12.50 in chips) 
Seat 8: luyifei ($11.10 in chips) 
Seat 9: ygoegoe ($26.76 in chips) 
Silveystryk: posts small blind $0.10
chiyuki: posts big blind $0.25
*** HOLE CARDS ***
Dealt to chiyuki [Kh 5s]
Ellen1947: folds 
PillZ86: folds 
4ydo yogurt: raises $0.50 to $0.75
pandaaaaaa: folds 
luyifei: folds 
ygoegoe: calls $0.75
MOReilly000: folds 
Silveystryk: calls $0.65
chiyuki: folds 
*** FLOP *** [Js Jh 4h]
Silveystryk: checks 
4ydo yogurt: bets $0.40
ygoegoe: raises $0.60 to $1
Silveystryk: folds 
4ydo yogurt: calls $0.60
*** TURN *** [Js Jh 4h] [7h]
4ydo yogurt: checks 
ygoegoe: bets $2.88
4ydo yogurt: folds 
Uncalled bet ($2.88) returned to ygoegoe
ygoegoe collected $4.30 from pot
ygoegoe: doesn't show hand 
*** SUMMARY ***
Total pot $4.50 | Rake $0.20 
Board [Js Jh 4h 7h]
Seat 1: MOReilly000 (button) folded before Flop (didn't bet)
Seat 2: Silveystryk (small blind) folded on the Flop
Seat 3: chiyuki (big blind) folded before Flop
Seat 4: Ellen1947 folded before Flop (didn't bet)
Seat 5: PillZ86 folded before Flop (didn't bet)
Seat 6: 4ydo yogurt folded on the Turn
Seat 7: pandaaaaaa folded before Flop (didn't bet)
Seat 8: luyifei folded before Flop (didn't bet)
Seat 9: ygoegoe collected ($4.30)



PokerStars Zoom Hand #84300112399:  Hold'em No Limit ($0.10/$0.25) - 2012/08/05 15:06:31 JST [2012/08/05 2:06:31 ET]
Table 'Whirlpool' 9-max Seat #1 is the button
Seat 1: phate-1up ($48.96 in chips) 
Seat 2: Nerkit ($11.50 in chips) 
Seat 3: WARIBANA7777 ($15.88 in chips) 
Seat 4: kesstukas25 ($12.52 in chips) 
Seat 5: 1Karina1 ($25.10 in chips) 
Seat 6: chiyuki ($23.77 in chips) 
Seat 7: hirozo ($71.78 in chips) 
Seat 8: Dejacob ($40.66 in chips) 
Seat 9: River_GmbH ($16.10 in chips) 
Nerkit: posts small blind $0.10
WARIBANA7777: posts big blind $0.25
*** HOLE CARDS ***
Dealt to chiyuki [Ks 5h]
kesstukas25: folds 
1Karina1: folds 
chiyuki: folds 
hirozo: folds 
Dejacob: raises $0.50 to $0.75
River_GmbH: calls $0.75
phate-1up: folds 
Nerkit: folds 
WARIBANA7777: folds 
*** FLOP *** [8s 3s 7s]
Dejacob: checks 
River_GmbH: bets $1.25
Dejacob: folds 
Uncalled bet ($1.25) returned to River_GmbH
River_GmbH collected $1.77 from pot
River_GmbH: doesn't show hand 
*** SUMMARY ***
Total pot $1.85 | Rake $0.08 
Board [8s 3s 7s]
Seat 1: phate-1up (button) folded before Flop (didn't bet)
Seat 2: Nerkit (small blind) folded before Flop
Seat 3: WARIBANA7777 (big blind) folded before Flop
Seat 4: kesstukas25 folded before Flop (didn't bet)
Seat 5: 1Karina1 folded before Flop (didn't bet)
Seat 6: chiyuki folded before Flop (didn't bet)
Seat 7: hirozo folded before Flop (didn't bet)
Seat 8: Dejacob folded on the Flop
Seat 9: River_GmbH collected ($1.77)



PokerStars Zoom Hand #84300119373:  Hold'em No Limit ($0.10/$0.25) - 2012/08/05 15:06:58 JST [2012/08/05 2:06:58 ET]
Table 'Whirlpool' 9-max Seat #1 is the button
Seat 1: chiyuki ($23.67 in chips) 
Seat 2: deadmoneykid ($25.66 in chips) 
Seat 3: DanielWhyte ($56.84 in chips) 
Seat 4: INSP!RON ($25 in chips) 
Seat 5: ChrisCDee ($45.40 in chips) 
Seat 6: Nerkit ($12.15 in chips) 
Seat 7: starreset ($31.27 in chips) 
Seat 8: DutchShultzs ($36.53 in chips) 
Seat 9: troublesomm ($25.77 in chips) 
deadmoneykid: posts small blind $0.10
DanielWhyte: posts big blind $0.25
*** HOLE CARDS ***
Dealt to chiyuki [As 4s]
INSP!RON: folds 
ChrisCDee: folds 
Nerkit: folds 
starreset: raises $0.50 to $0.75
DutchShultzs: folds 
troublesomm: folds 
chiyuki: folds 
deadmoneykid: folds 
DanielWhyte: folds 
Uncalled bet ($0.50) returned to starreset
starreset collected $0.60 from pot
starreset: doesn't show hand 
*** SUMMARY ***
Total pot $0.60 | Rake $0 
Seat 1: chiyuki (button) folded before Flop (didn't bet)
Seat 2: deadmoneykid (small blind) folded before Flop
Seat 3: DanielWhyte (big blind) folded before Flop
Seat 4: INSP!RON folded before Flop (didn't bet)
Seat 5: ChrisCDee folded before Flop (didn't bet)
Seat 6: Nerkit folded before Flop (didn't bet)
Seat 7: starreset collected ($0.60)
Seat 8: DutchShultzs folded before Flop (didn't bet)
Seat 9: troublesomm folded before Flop (didn't bet)



PokerStars Zoom Hand #84300117789:  Hold'em No Limit ($0.10/$0.25) - 2012/08/05 15:06:52 JST [2012/08/05 2:06:52 ET]
Table 'Whirlpool' 9-max Seat #1 is the button
Seat 1: kamikkaze ($12.35 in chips) 
Seat 2: chiyuki ($23.77 in chips) 
Seat 3: Andrei 23rus ($20.40 in chips) 
Seat 4: hirozo ($30.41 in chips) 
Seat 5: cofla tito ($10.19 in chips) 
Seat 6: snejokCoxx ($9.18 in chips) 
Seat 7: seula i ($25 in chips) 
Seat 8: GovGus ($25 in chips) 
Seat 9: Yoshimac ($12.65 in chips) 
chiyuki: posts small blind $0.10
Andrei 23rus: posts big blind $0.25
*** HOLE CARDS ***
Dealt to chiyuki [2s 8h]
hirozo: folds 
cofla tito: folds 
snejokCoxx: folds 
seula i: folds 
GovGus: folds 
Yoshimac: raises $0.50 to $0.75
kamikkaze: folds 
chiyuki: folds 
Andrei 23rus: calls $0.50
*** FLOP *** [6c 5c Qc]
Andrei 23rus: checks 
Yoshimac: bets $1.20
Andrei 23rus: folds 
Uncalled bet ($1.20) returned to Yoshimac
Yoshimac collected $1.53 from pot
Yoshimac: doesn't show hand 
*** SUMMARY ***
Total pot $1.60 | Rake $0.07 
Board [6c 5c Qc]
Seat 1: kamikkaze (button) folded before Flop (didn't bet)
Seat 2: chiyuki (small blind) folded before Flop
Seat 3: Andrei 23rus (big blind) folded on the Flop
Seat 4: hirozo folded before Flop (didn't bet)
Seat 5: cofla tito folded before Flop (didn't bet)
Seat 6: snejokCoxx folded before Flop (didn't bet)
Seat 7: seula i folded before Flop (didn't bet)
Seat 8: GovGus folded before Flop (didn't bet)
Seat 9: Yoshimac collected ($1.53)



PokerStars Zoom Hand #84300123469:  Hold'em No Limit ($0.10/$0.25) - 2012/08/05 15:07:14 JST [2012/08/05 2:07:14 ET]
Table 'Whirlpool' 9-max Seat #1 is the button
Seat 1: ZhukOFFskI ($29.48 in chips) 
Seat 2: troublesomm ($25.77 in chips) 
Seat 3: Nerkit ($9.40 in chips) 
Seat 4: chiyuki ($23.67 in chips) 
Seat 5: kesstukas25 ($12.50 in chips) 
Seat 6: GovGus ($31.11 in chips) 
Seat 7: Perstenev ($14.64 in chips) 
Seat 8: Streikel ($9.21 in chips) 
Seat 9: kamikkaze ($12.25 in chips) 
troublesomm: posts small blind $0.10
Nerkit: posts big blind $0.25
*** HOLE CARDS ***
Dealt to chiyuki [6d 2d]
chiyuki: folds 
kesstukas25: folds 
GovGus: folds 
Perstenev: folds 
Streikel: folds 
kamikkaze: folds 
ZhukOFFskI: raises $0.50 to $0.75
troublesomm: folds 
Nerkit: folds 
Uncalled bet ($0.50) returned to ZhukOFFskI
ZhukOFFskI collected $0.60 from pot
ZhukOFFskI: doesn't show hand 
*** SUMMARY ***
Total pot $0.60 | Rake $0 
Seat 1: ZhukOFFskI (button) collected ($0.60)
Seat 2: troublesomm (small blind) folded before Flop
Seat 3: Nerkit (big blind) folded before Flop
Seat 4: chiyuki folded before Flop (didn't bet)
Seat 5: kesstukas25 folded before Flop (didn't bet)
Seat 6: GovGus folded before Flop (didn't bet)
Seat 7: Perstenev folded before Flop (didn't bet)
Seat 8: Streikel folded before Flop (didn't bet)
Seat 9: kamikkaze folded before Flop (didn't bet)



PokerStars Zoom Hand #84300124228:  Hold'em No Limit ($0.10/$0.25) - 2012/08/05 15:07:17 JST [2012/08/05 2:07:17 ET]
Table 'Whirlpool' 9-max Seat #1 is the button
Seat 1: tribunpdm ($30.72 in chips) 
Seat 2: JhonnyP1979 ($5.69 in chips) 
Seat 3: troublesomm ($28.05 in chips) 
Seat 4: DutchShultzs ($33.19 in chips) 
Seat 5: WARIBANA7777 ($15.53 in chips) 
Seat 6: ZhukOFFskI ($48.51 in chips) 
Seat 7: chiyuki ($23.67 in chips) 
Seat 8: Nerkit ($9.50 in chips) 
Seat 9: drunk_bender ($25.78 in chips) 
JhonnyP1979: posts small blind $0.10
troublesomm: posts big blind $0.25
*** HOLE CARDS ***
Dealt to chiyuki [Th As]
DutchShultzs: folds 
WARIBANA7777: folds 
ZhukOFFskI: raises $0.50 to $0.75
chiyuki: folds 
Nerkit: folds 
drunk_bender: folds 
tribunpdm: calls $0.75
JhonnyP1979: folds 
troublesomm: folds 
*** FLOP *** [Ks Td 5d]
ZhukOFFskI: bets $1.06
tribunpdm: folds 
Uncalled bet ($1.06) returned to ZhukOFFskI
ZhukOFFskI collected $1.77 from pot
ZhukOFFskI: doesn't show hand 
*** SUMMARY ***
Total pot $1.85 | Rake $0.08 
Board [Ks Td 5d]
Seat 1: tribunpdm (button) folded on the Flop
Seat 2: JhonnyP1979 (small blind) folded before Flop
Seat 3: troublesomm (big blind) folded before Flop
Seat 4: DutchShultzs folded before Flop (didn't bet)
Seat 5: WARIBANA7777 folded before Flop (didn't bet)
Seat 6: ZhukOFFskI collected ($1.77)
Seat 7: chiyuki folded before Flop (didn't bet)
Seat 8: Nerkit folded before Flop (didn't bet)
Seat 9: drunk_bender folded before Flop (didn't bet)



PokerStars Zoom Hand #84300126261:  Hold'em No Limit ($0.10/$0.25) - 2012/08/05 15:07:25 JST [2012/08/05 2:07:25 ET]
Table 'Whirlpool' 9-max Seat #1 is the button
Seat 1: JhonnyP1979 ($5.59 in chips) 
Seat 2: pandaaaaaa ($12.50 in chips) 
Seat 3: chiyuki ($23.67 in chips) 
Seat 4: WARIBANA7777 ($15.53 in chips) 
Seat 5: laurentzu84 ($31.43 in chips) 
Seat 6: deadmoneykid ($29.10 in chips) 
Seat 7: mjmichi ($26.88 in chips) 
Seat 8: 1Karina1 ($25 in chips) 
Seat 9: DanielWhyte ($56.49 in chips) 
pandaaaaaa: posts small blind $0.10
chiyuki: posts big blind $0.25
*** HOLE CARDS ***
Dealt to chiyuki [4s 7d]
WARIBANA7777: folds 
laurentzu84: folds 
deadmoneykid: folds 
mjmichi: folds 
1Karina1: folds 
DanielWhyte: raises $0.25 to $0.50
JhonnyP1979: folds 
pandaaaaaa: folds 
chiyuki: folds 
Uncalled bet ($0.25) returned to DanielWhyte
DanielWhyte collected $0.60 from pot
DanielWhyte: doesn't show hand 
*** SUMMARY ***
Total pot $0.60 | Rake $0 
Seat 1: JhonnyP1979 (button) folded before Flop (didn't bet)
Seat 2: pandaaaaaa (small blind) folded before Flop
Seat 3: chiyuki (big blind) folded before Flop
Seat 4: WARIBANA7777 folded before Flop (didn't bet)
Seat 5: laurentzu84 folded before Flop (didn't bet)
Seat 6: deadmoneykid folded before Flop (didn't bet)
Seat 7: mjmichi folded before Flop (didn't bet)
Seat 8: 1Karina1 folded before Flop (didn't bet)
Seat 9: DanielWhyte collected ($0.60)



PokerStars Zoom Hand #84300130869:  Hold'em No Limit ($0.10/$0.25) - 2012/08/05 15:07:44 JST [2012/08/05 2:07:44 ET]
Table 'Whirlpool' 9-max Seat #1 is the button
Seat 1: KrystalAA ($27.96 in chips) 
Seat 2: hirozo ($80.40 in chips) 
Seat 3: kamikkaze ($15.27 in chips) 
Seat 4: NuMetal88 ($34.12 in chips) 
Seat 5: Dan Royal ($16.62 in chips) 
Seat 6: chiyuki ($23.42 in chips) 
Seat 7: pandaaaaaa ($12.15 in chips) 
Seat 8: Nerkit ($9.05 in chips) 
Seat 9: Lasutchik ($75.93 in chips) 
hirozo: posts small blind $0.10
kamikkaze: posts big blind $0.25
*** HOLE CARDS ***
Dealt to chiyuki [6h 5c]
NuMetal88: folds 
Dan Royal: folds 
chiyuki: folds 
pandaaaaaa: folds 
Nerkit: folds 
Lasutchik: folds 
KrystalAA: raises $0.46 to $0.71
hirozo: raises $1.52 to $2.23
kamikkaze: folds 
KrystalAA: calls $1.52
*** FLOP *** [7d 7s Kd]
hirozo: bets $2.25
KrystalAA: folds 
Uncalled bet ($2.25) returned to hirozo
hirozo collected $4.50 from pot
hirozo: doesn't show hand 
*** SUMMARY ***
Total pot $4.71 | Rake $0.21 
Board [7d 7s Kd]
Seat 1: KrystalAA (button) folded on the Flop
Seat 2: hirozo (small blind) collected ($4.50)
Seat 3: kamikkaze (big blind) folded before Flop
Seat 4: NuMetal88 folded before Flop (didn't bet)
Seat 5: Dan Royal folded before Flop (didn't bet)
Seat 6: chiyuki folded before Flop (didn't bet)
Seat 7: pandaaaaaa folded before Flop (didn't bet)
Seat 8: Nerkit folded before Flop (didn't bet)
Seat 9: Lasutchik folded before Flop (didn't bet)



PokerStars Zoom Hand #84300131873:  Hold'em No Limit ($0.10/$0.25) - 2012/08/05 15:07:48 JST [2012/08/05 2:07:48 ET]
Table 'Whirlpool' 9-max Seat #1 is the button
Seat 1: ZhukOFFskI ($36.81 in chips) 
Seat 2: risekuku468 ($39.22 in chips) 
Seat 3: troublesomm ($40.86 in chips) 
Seat 4: gunbowler ($225.05 in chips) 
Seat 5: pandaaaaaa ($12.15 in chips) 
Seat 6: svg51 ($16.52 in chips) 
Seat 7: Roglus ($17.62 in chips) 
Seat 8: Dejacob ($25 in chips) 
Seat 9: chiyuki ($23.42 in chips) 
risekuku468: posts small blind $0.10
troublesomm: posts big blind $0.25
*** HOLE CARDS ***
Dealt to chiyuki [Qd As]
gunbowler has timed out while disconnected
gunbowler: folds 
pandaaaaaa: folds 
svg51: folds 
Roglus: raises $0.62 to $0.87
Dejacob: folds 
chiyuki: raises $1.62 to $2.49
ZhukOFFskI: folds 
risekuku468: folds 
troublesomm: folds 
Roglus: calls $1.62
*** FLOP *** [6h Qh Jh]
Roglus: checks 
chiyuki: bets $3.75
Roglus: calls $3.75
*** TURN *** [6h Qh Jh] [3c]
Roglus: checks 
chiyuki: checks 
*** RIVER *** [6h Qh Jh 3c] [Ah]
Roglus: checks 
chiyuki: checks 
*** SHOW DOWN ***
Roglus: shows [Ac Ks] (a pair of Aces)
chiyuki: shows [Qd As] (two pair, Aces and Queens)
chiyuki collected $12.25 from pot
*** SUMMARY ***
Total pot $12.83 | Rake $0.58 
Board [6h Qh Jh 3c Ah]
Seat 1: ZhukOFFskI (button) folded before Flop (didn't bet)
Seat 2: risekuku468 (small blind) folded before Flop
Seat 3: troublesomm (big blind) folded before Flop
Seat 4: gunbowler folded before Flop (didn't bet)
Seat 5: pandaaaaaa folded before Flop (didn't bet)
Seat 6: svg51 folded before Flop (didn't bet)
Seat 7: Roglus showed [Ac Ks] and lost with a pair of Aces
Seat 8: Dejacob folded before Flop (didn't bet)
Seat 9: chiyuki showed [Qd As] and won ($12.25) with two pair, Aces and Queens



PokerStars Zoom Hand #84300145171:  Hold'em No Limit ($0.10/$0.25) - 2012/08/05 15:08:40 JST [2012/08/05 2:08:40 ET]
Table 'Whirlpool' 9-max Seat #1 is the button
Seat 1: troublesomm ($26.07 in chips) 
Seat 2: yane73 ($66.68 in chips) 
Seat 3: Roglus ($11.38 in chips) 
Seat 4: KrystalAA ($25.73 in chips) 
Seat 5: chiyuki ($29.43 in chips) 
Seat 6: Nerkit ($12.50 in chips) 
Seat 7: Perstenev ($13 in chips) 
Seat 8: NuMetal88 ($33.77 in chips) 
Seat 9: Rilko1975 ($28.39 in chips) 
yane73: posts small blind $0.10
Roglus: posts big blind $0.25
*** HOLE CARDS ***
Dealt to chiyuki [2d 3c]
KrystalAA: folds 
chiyuki: folds 
Nerkit: raises $0.50 to $0.75
Perstenev: folds 
NuMetal88: folds 
Rilko1975: folds 
troublesomm: folds 
yane73: folds 
Roglus: folds 
Uncalled bet ($0.50) returned to Nerkit
Nerkit collected $0.60 from pot
Nerkit: doesn't show hand 
*** SUMMARY ***
Total pot $0.60 | Rake $0 
Seat 1: troublesomm (button) folded before Flop (didn't bet)
Seat 2: yane73 (small blind) folded before Flop
Seat 3: Roglus (big blind) folded before Flop
Seat 4: KrystalAA folded before Flop (didn't bet)
Seat 5: chiyuki folded before Flop (didn't bet)
Seat 6: Nerkit collected ($0.60)
Seat 7: Perstenev folded before Flop (didn't bet)
Seat 8: NuMetal88 folded before Flop (didn't bet)
Seat 9: Rilko1975 folded before Flop (didn't bet)



PokerStars Zoom Hand #84300147004:  Hold'em No Limit ($0.10/$0.25) - 2012/08/05 15:08:47 JST [2012/08/05 2:08:47 ET]
Table 'Whirlpool' 9-max Seat #1 is the button
Seat 1: Silveystryk ($21.85 in chips) 
Seat 2: PAMBOS.L ($23.29 in chips) 
Seat 3: 1Karina1 ($25 in chips) 
Seat 4: chiyuki ($29.43 in chips) 
Seat 5: tribunpdm ($31.10 in chips) 
Seat 6: deepakmbh ($40.10 in chips) 
Seat 7: DutchShultzs ($35.78 in chips) 
Seat 8: Nerkit ($10.42 in chips) 
Seat 9: AAAKK777 ($26.23 in chips) 
PAMBOS.L: posts small blind $0.10
1Karina1: posts big blind $0.25
*** HOLE CARDS ***
Dealt to chiyuki [Jc Jd]
chiyuki: raises $0.50 to $0.75
tribunpdm: folds 
deepakmbh: folds 
DutchShultzs: folds 
Nerkit: folds 
AAAKK777: raises $0.75 to $1.50
Silveystryk: folds 
PAMBOS.L: folds 
1Karina1: folds 
chiyuki: raises $2 to $3.50
AAAKK777: calls $2
*** FLOP *** [4d 4h Qh]
chiyuki: bets $3.51
AAAKK777: raises $3.51 to $7.02
chiyuki: calls $3.51
*** TURN *** [4d 4h Qh] [5c]
chiyuki: checks 
AAAKK777: bets $7.25
chiyuki: folds 
Uncalled bet ($7.25) returned to AAAKK777
AAAKK777 collected $20.43 from pot
AAAKK777: doesn't show hand 
*** SUMMARY ***
Total pot $21.39 | Rake $0.96 
Board [4d 4h Qh 5c]
Seat 1: Silveystryk (button) folded before Flop (didn't bet)
Seat 2: PAMBOS.L (small blind) folded before Flop
Seat 3: 1Karina1 (big blind) folded before Flop
Seat 4: chiyuki folded on the Turn
Seat 5: tribunpdm folded before Flop (didn't bet)
Seat 6: deepakmbh folded before Flop (didn't bet)
Seat 7: DutchShultzs folded before Flop (didn't bet)
Seat 8: Nerkit folded before Flop (didn't bet)
Seat 9: AAAKK777 collected ($20.43)



PokerStars Zoom Hand #84300168599:  Hold'em No Limit ($0.10/$0.25) - 2012/08/05 15:10:13 JST [2012/08/05 2:10:13 ET]
Table 'Whirlpool' 9-max Seat #1 is the button
Seat 1: silvno31 ($27.40 in chips) 
Seat 2: mjmichi ($28.36 in chips) 
Seat 3: DanielWhyte ($56.94 in chips) 
Seat 4: masterkoolb ($13.62 in chips) 
Seat 5: deepakmbh ($66.19 in chips) 
Seat 6: Yoshimac ($14.28 in chips) 
Seat 7: DutchShultzs ($35.43 in chips) 
Seat 8: chiyuki ($24.90 in chips) 
Seat 9: rorfo23 ($15.40 in chips) 
mjmichi: posts small blind $0.10
DanielWhyte: posts big blind $0.25
*** HOLE CARDS ***
Dealt to chiyuki [Ks 4h]
masterkoolb: folds 
deepakmbh: folds 
Yoshimac: folds 
DutchShultzs: folds 
chiyuki: folds 
rorfo23: folds 
silvno31: folds 
mjmichi: folds 
Uncalled bet ($0.15) returned to DanielWhyte
DanielWhyte collected $0.20 from pot
DanielWhyte: doesn't show hand 
*** SUMMARY ***
Total pot $0.20 | Rake $0 
Seat 1: silvno31 (button) folded before Flop (didn't bet)
Seat 2: mjmichi (small blind) folded before Flop
Seat 3: DanielWhyte (big blind) collected ($0.20)
Seat 4: masterkoolb folded before Flop (didn't bet)
Seat 5: deepakmbh folded before Flop (didn't bet)
Seat 6: Yoshimac folded before Flop (didn't bet)
Seat 7: DutchShultzs folded before Flop (didn't bet)
Seat 8: chiyuki folded before Flop (didn't bet)
Seat 9: rorfo23 folded before Flop (didn't bet)



PokerStars Zoom Hand #84300167854:  Hold'em No Limit ($0.10/$0.25) - 2012/08/05 15:10:10 JST [2012/08/05 2:10:10 ET]
Table 'Whirlpool' 9-max Seat #1 is the button
Seat 1: chiyuki ($24.90 in chips) 
Seat 2: INSP!RON ($32.20 in chips) 
Seat 3: kesstukas25 ($12.50 in chips) 
Seat 4: troublesomm ($26.07 in chips) 
Seat 5: GovGus ($26.96 in chips) 
Seat 6: Perstenev ($12.60 in chips) 
Seat 7: hirozo ($71.68 in chips) 
Seat 8: gunbowler ($225.05 in chips) 
Seat 9: snejokCoxx ($12.25 in chips) 
INSP!RON: posts small blind $0.10
kesstukas25: posts big blind $0.25
*** HOLE CARDS ***
Dealt to chiyuki [5c 2h]
troublesomm: folds 
GovGus: folds 
Perstenev: folds 
hirozo: folds 
gunbowler: raises $0.50 to $0.75
snejokCoxx: folds 
chiyuki: folds 
INSP!RON: folds 
kesstukas25: folds 
Uncalled bet ($0.50) returned to gunbowler
gunbowler collected $0.60 from pot
gunbowler: doesn't show hand 
*** SUMMARY ***
Total pot $0.60 | Rake $0 
Seat 1: chiyuki (button) folded before Flop (didn't bet)
Seat 2: INSP!RON (small blind) folded before Flop
Seat 3: kesstukas25 (big blind) folded before Flop
Seat 4: troublesomm folded before Flop (didn't bet)
Seat 5: GovGus folded before Flop (didn't bet)
Seat 6: Perstenev folded before Flop (didn't bet)
Seat 7: hirozo folded before Flop (didn't bet)
Seat 8: gunbowler collected ($0.60)
Seat 9: snejokCoxx folded before Flop (didn't bet)



PokerStars Zoom Hand #84300169380:  Hold'em No Limit ($0.10/$0.25) - 2012/08/05 15:10:16 JST [2012/08/05 2:10:16 ET]
Table 'Whirlpool' 9-max Seat #1 is the button
Seat 1: Robchie ($16.68 in chips) 
Seat 2: kwkim73 ($25 in chips) 
Seat 3: 1Karina1 ($25 in chips) 
Seat 4: Perstenev ($12.60 in chips) 
Seat 5: WARIBANA7777 ($17.49 in chips) 
Seat 6: 4ydo yogurt ($33.08 in chips) 
Seat 7: deadmoneykid ($29.82 in chips) 
Seat 8: troublesomm ($40.26 in chips) 
Seat 9: chiyuki ($24.90 in chips) 
kwkim73: posts small blind $0.10
1Karina1: posts big blind $0.25
*** HOLE CARDS ***
Dealt to chiyuki [Ks Ah]
Perstenev: folds 
WARIBANA7777: folds 
4ydo yogurt: folds 
deadmoneykid: folds 
troublesomm: raises $0.25 to $0.50
chiyuki: raises $1.25 to $1.75
Robchie: folds 
kwkim73: folds 
1Karina1: folds 
troublesomm: folds 
Uncalled bet ($1.25) returned to chiyuki
chiyuki collected $1.35 from pot
chiyuki: doesn't show hand 
*** SUMMARY ***
Total pot $1.35 | Rake $0 
Seat 1: Robchie (button) folded before Flop (didn't bet)
Seat 2: kwkim73 (small blind) folded before Flop
Seat 3: 1Karina1 (big blind) folded before Flop
Seat 4: Perstenev folded before Flop (didn't bet)
Seat 5: WARIBANA7777 folded before Flop (didn't bet)
Seat 6: 4ydo yogurt folded before Flop (didn't bet)
Seat 7: deadmoneykid folded before Flop (didn't bet)
Seat 8: troublesomm folded before Flop
Seat 9: chiyuki collected ($1.35)



PokerStars Zoom Hand #84300178403:  Hold'em No Limit ($0.10/$0.25) - 2012/08/05 15:10:51 JST [2012/08/05 2:10:51 ET]
Table 'Whirlpool' 9-max Seat #1 is the button
Seat 1: AAAKK777 ($32.64 in chips) 
Seat 2: snejokCoxx ($9.86 in chips) 
Seat 3: chiyuki ($25.75 in chips) 
Seat 4: dushvan ($44.38 in chips) 
Seat 5: Dejacob ($25.25 in chips) 
Seat 6: seula i ($101.10 in chips) 
Seat 7: DutchShultzs ($35.18 in chips) 
Seat 8: kamikkaze ($14.40 in chips) 
Seat 9: KrystalAA ($32.17 in chips) 
snejokCoxx: posts small blind $0.10
chiyuki: posts big blind $0.25
*** HOLE CARDS ***
Dealt to chiyuki [6s 3c]
dushvan: folds 
Dejacob: folds 
seula i: folds 
DutchShultzs: raises $0.50 to $0.75
kamikkaze: folds 
KrystalAA: folds 
AAAKK777: folds 
snejokCoxx: folds 
chiyuki: folds 
Uncalled bet ($0.50) returned to DutchShultzs
DutchShultzs collected $0.60 from pot
DutchShultzs: doesn't show hand 
*** SUMMARY ***
Total pot $0.60 | Rake $0 
Seat 1: AAAKK777 (button) folded before Flop (didn't bet)
Seat 2: snejokCoxx (small blind) folded before Flop
Seat 3: chiyuki (big blind) folded before Flop
Seat 4: dushvan folded before Flop (didn't bet)
Seat 5: Dejacob folded before Flop (didn't bet)
Seat 6: seula i folded before Flop (didn't bet)
Seat 7: DutchShultzs collected ($0.60)
Seat 8: kamikkaze folded before Flop (didn't bet)
Seat 9: KrystalAA folded before Flop (didn't bet)



PokerStars Zoom Hand #84300182727:  Hold'em No Limit ($0.10/$0.25) - 2012/08/05 15:11:08 JST [2012/08/05 2:11:08 ET]
Table 'Whirlpool' 9-max Seat #1 is the button
Seat 1: kamikkaze ($16.33 in chips) 
Seat 2: ZhukOFFskI ($50.65 in chips) 
Seat 3: jeades ($19.92 in chips) 
Seat 4: hirozo ($80.91 in chips) 
Seat 5: Tom1999 ($16.20 in chips) 
Seat 6: chiyuki ($25.50 in chips) 
Seat 7: mjmichi ($31.77 in chips) 
Seat 8: masterkoolb ($12.50 in chips) 
Seat 9: Saruotiss ($24.39 in chips) 
ZhukOFFskI: posts small blind $0.10
jeades: posts big blind $0.25
*** HOLE CARDS ***
Dealt to chiyuki [9d 7h]
hirozo: folds 
Tom1999: raises $0.50 to $0.75
chiyuki: folds 
mjmichi: folds 
masterkoolb: folds 
Saruotiss: folds 
kamikkaze: folds 
ZhukOFFskI: folds 
jeades: folds 
Uncalled bet ($0.50) returned to Tom1999
Tom1999 collected $0.60 from pot
Tom1999: doesn't show hand 
*** SUMMARY ***
Total pot $0.60 | Rake $0 
Seat 1: kamikkaze (button) folded before Flop (didn't bet)
Seat 2: ZhukOFFskI (small blind) folded before Flop
Seat 3: jeades (big blind) folded before Flop
Seat 4: hirozo folded before Flop (didn't bet)
Seat 5: Tom1999 collected ($0.60)
Seat 6: chiyuki folded before Flop (didn't bet)
Seat 7: mjmichi folded before Flop (didn't bet)
Seat 8: masterkoolb folded before Flop (didn't bet)
Seat 9: Saruotiss folded before Flop (didn't bet)



PokerStars Zoom Hand #84300181211:  Hold'em No Limit ($0.10/$0.25) - 2012/08/05 15:11:02 JST [2012/08/05 2:11:02 ET]
Table 'Whirlpool' 9-max Seat #1 is the button
Seat 1: deadmoneykid ($29.82 in chips) 
Seat 2: drunk_bender ($26.24 in chips) 
Seat 3: KeLevro0 ($12.50 in chips) 
Seat 4: hirozo ($80.91 in chips) 
Seat 5: JhonnyP1979 ($7.07 in chips) 
Seat 6: 1Karina1 ($29.44 in chips) 
Seat 7: chiyuki ($25.50 in chips) 
Seat 8: kwkim73 ($25 in chips) 
Seat 9: kesstukas25 ($14.08 in chips) 
drunk_bender: posts small blind $0.10
KeLevro0: posts big blind $0.25
*** HOLE CARDS ***
Dealt to chiyuki [3c 9s]
hirozo: folds 
JhonnyP1979: folds 
1Karina1: folds 
chiyuki: folds 
kwkim73: folds 
kesstukas25: folds 
deadmoneykid: folds 
drunk_bender: folds 
Uncalled bet ($0.15) returned to KeLevro0
KeLevro0 collected $0.20 from pot
KeLevro0: doesn't show hand 
*** SUMMARY ***
Total pot $0.20 | Rake $0 
Seat 1: deadmoneykid (button) folded before Flop (didn't bet)
Seat 2: drunk_bender (small blind) folded before Flop
Seat 3: KeLevro0 (big blind) collected ($0.20)
Seat 4: hirozo folded before Flop (didn't bet)
Seat 5: JhonnyP1979 folded before Flop (didn't bet)
Seat 6: 1Karina1 folded before Flop (didn't bet)
Seat 7: chiyuki folded before Flop (didn't bet)
Seat 8: kwkim73 folded before Flop (didn't bet)
Seat 9: kesstukas25 folded before Flop (didn't bet)



PokerStars Zoom Hand #84300189969:  Hold'em No Limit ($0.10/$0.25) - 2012/08/05 15:11:37 JST [2012/08/05 2:11:37 ET]
Table 'Whirlpool' 9-max Seat #1 is the button
Seat 1: chiyuki ($25.40 in chips) 
Seat 2: kwkim73 ($29.65 in chips) 
Seat 3: INSP!RON ($26.30 in chips) 
Seat 4: ZhukOFFskI ($36.73 in chips) 
Seat 5: ygoegoe ($31.87 in chips) 
Seat 6: masterkoolb ($17.30 in chips) 
Seat 7: Vahe50 ($14.56 in chips) 
Seat 8: mid22 ($11.38 in chips) 
Seat 9: DanielWhyte ($59.62 in chips) 
kwkim73: posts small blind $0.10
INSP!RON: posts big blind $0.25
*** HOLE CARDS ***
Dealt to chiyuki [8s 3s]
ZhukOFFskI: raises $0.50 to $0.75
ygoegoe: folds 
masterkoolb: folds 
Vahe50: folds 
mid22: folds 
DanielWhyte: folds 
chiyuki: folds 
kwkim73: folds 
INSP!RON: folds 
Uncalled bet ($0.50) returned to ZhukOFFskI
ZhukOFFskI collected $0.60 from pot
ZhukOFFskI: doesn't show hand 
*** SUMMARY ***
Total pot $0.60 | Rake $0 
Seat 1: chiyuki (button) folded before Flop (didn't bet)
Seat 2: kwkim73 (small blind) folded before Flop
Seat 3: INSP!RON (big blind) folded before Flop
Seat 4: ZhukOFFskI collected ($0.60)
Seat 5: ygoegoe folded before Flop (didn't bet)
Seat 6: masterkoolb folded before Flop (didn't bet)
Seat 7: Vahe50 folded before Flop (didn't bet)
Seat 8: mid22 folded before Flop (didn't bet)
Seat 9: DanielWhyte folded before Flop (didn't bet)



PokerStars Zoom Hand #84300183768:  Hold'em No Limit ($0.10/$0.25) - 2012/08/05 15:11:12 JST [2012/08/05 2:11:12 ET]
Table 'Whirlpool' 9-max Seat #1 is the button
Seat 1: Dejacob ($40.79 in chips) 
Seat 2: chiyuki ($25.50 in chips) 
Seat 3: Nerkit ($11.75 in chips) 
Seat 4: seula i ($101.10 in chips) 
Seat 5: GovGus ($25 in chips) 
Seat 6: troublesomm ($28.10 in chips) 
Seat 7: kesstukas25 ($14.08 in chips) 
Seat 8: drunk_bender ($26.14 in chips) 
Seat 9: DPsemplic ($11.96 in chips) 
chiyuki: posts small blind $0.10
Nerkit: posts big blind $0.25
*** HOLE CARDS ***
Dealt to chiyuki [3c Ah]
seula i: folds 
GovGus: folds 
troublesomm: folds 
kesstukas25: folds 
drunk_bender: folds 
DPsemplic: raises $0.25 to $0.50
Dejacob: raises $1.25 to $1.75
chiyuki: folds 
Nerkit: folds 
DPsemplic: calls $1.25
*** FLOP *** [6d 2d Qc]
DPsemplic: checks 
Dejacob: bets $2
DPsemplic: calls $2
*** TURN *** [6d 2d Qc] [4d]
DPsemplic: checks 
Dejacob: checks 
*** RIVER *** [6d 2d Qc 4d] [5h]
DPsemplic: bets $0.50
Dejacob: raises $27.50 to $28
DPsemplic: folds 
Uncalled bet ($27.50) returned to Dejacob
Dejacob collected $8.45 from pot
Dejacob: doesn't show hand 
*** SUMMARY ***
Total pot $8.85 | Rake $0.40 
Board [6d 2d Qc 4d 5h]
Seat 1: Dejacob (button) collected ($8.45)
Seat 2: chiyuki (small blind) folded before Flop
Seat 3: Nerkit (big blind) folded before Flop
Seat 4: seula i folded before Flop (didn't bet)
Seat 5: GovGus folded before Flop (didn't bet)
Seat 6: troublesomm folded before Flop (didn't bet)
Seat 7: kesstukas25 folded before Flop (didn't bet)
Seat 8: drunk_bender folded before Flop (didn't bet)
Seat 9: DPsemplic folded on the River



PokerStars Zoom Hand #84300190983:  Hold'em No Limit ($0.10/$0.25) - 2012/08/05 15:11:41 JST [2012/08/05 2:11:41 ET]
Table 'Whirlpool' 9-max Seat #1 is the button
Seat 1: mid22 ($11.38 in chips) 
Seat 2: DutchShultzs ($25.84 in chips) 
Seat 3: NuMetal88 ($25.15 in chips) 
Seat 4: 1Karina1 ($29.44 in chips) 
Seat 5: Wilcox76607 ($34.98 in chips) 
Seat 6: Alvinpe85 ($45.95 in chips) 
Seat 7: Dejacob ($25 in chips) 
Seat 8: chiyuki ($25.40 in chips) 
Seat 9: jacquelinewu ($25 in chips) 
DutchShultzs: posts small blind $0.10
NuMetal88: posts big blind $0.25
*** HOLE CARDS ***
Dealt to chiyuki [9s Jh]
1Karina1: folds 
Wilcox76607: folds 
Alvinpe85: folds 
Dejacob: folds 
chiyuki: folds 
jacquelinewu: raises $0.50 to $0.75
mid22: folds 
DutchShultzs: folds 
NuMetal88: folds 
Uncalled bet ($0.50) returned to jacquelinewu
jacquelinewu collected $0.60 from pot
jacquelinewu: doesn't show hand 
*** SUMMARY ***
Total pot $0.60 | Rake $0 
Seat 1: mid22 (button) folded before Flop (didn't bet)
Seat 2: DutchShultzs (small blind) folded before Flop
Seat 3: NuMetal88 (big blind) folded before Flop
Seat 4: 1Karina1 folded before Flop (didn't bet)
Seat 5: Wilcox76607 folded before Flop (didn't bet)
Seat 6: Alvinpe85 folded before Flop (didn't bet)
Seat 7: Dejacob folded before Flop (didn't bet)
Seat 8: chiyuki folded before Flop (didn't bet)
Seat 9: jacquelinewu collected ($0.60)



PokerStars Zoom Hand #84300187604:  Hold'em No Limit ($0.10/$0.25) - 2012/08/05 15:11:28 JST [2012/08/05 2:11:28 ET]
Table 'Whirlpool' 9-max Seat #1 is the button
Seat 1: DutchShultzs ($25.84 in chips) 
Seat 2: Roglus ($6.98 in chips) 
Seat 3: hirozo ($47.47 in chips) 
Seat 4: kwkim73 ($29.65 in chips) 
Seat 5: kamikkaze ($16.23 in chips) 
Seat 6: starreset ($30.12 in chips) 
Seat 7: chiyuki ($25.40 in chips) 
Seat 8: rey2040 ($16.52 in chips) 
Seat 9: seula i ($101.10 in chips) 
Roglus: posts small blind $0.10
hirozo: posts big blind $0.25
*** HOLE CARDS ***
Dealt to chiyuki [7h Jh]
kwkim73: folds 
kamikkaze: folds 
starreset: raises $0.50 to $0.75
chiyuki: folds 
rey2040: raises $0.75 to $1.50
seula i: folds 
DutchShultzs: folds 
Roglus: folds 
hirozo: folds 
starreset: calls $0.75
*** FLOP *** [Td 4d 2c]
starreset: checks 
rey2040: bets $0.50
starreset: calls $0.50
*** TURN *** [Td 4d 2c] [4s]
starreset: checks 
rey2040: bets $0.50
starreset: calls $0.50
*** RIVER *** [Td 4d 2c 4s] [Jc]
starreset: checks 
rey2040: checks 
*** SHOW DOWN ***
starreset: shows [Js Ts] (two pair, Jacks and Tens)
rey2040: mucks hand 
starreset collected $5.11 from pot
*** SUMMARY ***
Total pot $5.35 | Rake $0.24 
Board [Td 4d 2c 4s Jc]
Seat 1: DutchShultzs (button) folded before Flop (didn't bet)
Seat 2: Roglus (small blind) folded before Flop
Seat 3: hirozo (big blind) folded before Flop
Seat 4: kwkim73 folded before Flop (didn't bet)
Seat 5: kamikkaze folded before Flop (didn't bet)
Seat 6: starreset showed [Js Ts] and won ($5.11) with two pair, Jacks and Tens
Seat 7: chiyuki folded before Flop (didn't bet)
Seat 8: rey2040 mucked [Kc Ad]
Seat 9: seula i folded before Flop (didn't bet)



PokerStars Zoom Hand #84300166556:  Hold'em No Limit ($0.10/$0.25) - 2012/08/05 15:10:04 JST [2012/08/05 2:10:04 ET]
Table 'Whirlpool' 9-max Seat #1 is the button
Seat 1: 4ydo yogurt ($33.08 in chips) 
Seat 2: chiyuki ($25 in chips) 
Seat 3: Dejacob ($25 in chips) 
Seat 4: kamikkaze ($14.75 in chips) 
Seat 5: mjmichi ($32.65 in chips) 
Seat 6: Lasutchik ($75.81 in chips) 
Seat 7: bigred1102 ($23.98 in chips) 
Seat 8: Streikel ($9.27 in chips) 
Seat 9: phate-1up ($47.96 in chips) 
chiyuki: posts small blind $0.10
Dejacob: posts big blind $0.25
*** HOLE CARDS ***
Dealt to chiyuki [6h 3h]
kamikkaze: folds 
mjmichi: folds 
Lasutchik: folds 
bigred1102: calls $0.25
Streikel: folds 
phate-1up: raises $1.25 to $1.50
4ydo yogurt: folds 
chiyuki: folds 
Dejacob: folds 
bigred1102: calls $1.25
*** FLOP *** [3s 4c 4h]
bigred1102: bets $1.50
phate-1up: calls $1.50
*** TURN *** [3s 4c 4h] [4s]
bigred1102: bets $1.50
phate-1up: calls $1.50
*** RIVER *** [3s 4c 4h 4s] [7s]
bigred1102: bets $1.50
phate-1up: raises $18 to $19.50
bigred1102 has timed out
bigred1102: folds 
Uncalled bet ($18) returned to phate-1up
phate-1up collected $11.79 from pot
phate-1up: doesn't show hand 
*** SUMMARY ***
Total pot $12.35 | Rake $0.56 
Board [3s 4c 4h 4s 7s]
Seat 1: 4ydo yogurt (button) folded before Flop (didn't bet)
Seat 2: chiyuki (small blind) folded before Flop
Seat 3: Dejacob (big blind) folded before Flop
Seat 4: kamikkaze folded before Flop (didn't bet)
Seat 5: mjmichi folded before Flop (didn't bet)
Seat 6: Lasutchik folded before Flop (didn't bet)
Seat 7: bigred1102 folded on the River
Seat 8: Streikel folded before Flop (didn't bet)
Seat 9: phate-1up collected ($11.79)



PokerStars Zoom Hand #84300184798:  Hold'em No Limit ($0.10/$0.25) - 2012/08/05 15:11:16 JST [2012/08/05 2:11:16 ET]
Table 'Whirlpool' 9-max Seat #1 is the button
Seat 1: hirozo ($27.35 in chips) 
Seat 2: Littlea029 ($31.96 in chips) 
Seat 3: pandaaaaaa ($10.05 in chips) 
Seat 4: mjmichi ($31.77 in chips) 
Seat 5: chiyuki ($25.40 in chips) 
Seat 6: masterkoolb ($17.55 in chips) 
Seat 7: ChrisCDee ($25.72 in chips) 
Seat 8: snejokCoxx ($13.20 in chips) 
Seat 9: phate-1up ($25 in chips) 
Littlea029: posts small blind $0.10
pandaaaaaa: posts big blind $0.25
*** HOLE CARDS ***
Dealt to chiyuki [2d 4h]
mjmichi: folds 
chiyuki: folds 
masterkoolb: folds 
ChrisCDee: folds 
snejokCoxx: folds 
phate-1up: raises $0.50 to $0.75
hirozo: raises $1.60 to $2.35
Littlea029: folds 
pandaaaaaa: folds 
phate-1up: raises $3.15 to $5.50
hirozo: raises $11.35 to $16.85
phate-1up: folds 
Uncalled bet ($11.35) returned to hirozo
hirozo collected $11.35 from pot
hirozo: doesn't show hand 
*** SUMMARY ***
Total pot $11.35 | Rake $0 
Seat 1: hirozo (button) collected ($11.35)
Seat 2: Littlea029 (small blind) folded before Flop
Seat 3: pandaaaaaa (big blind) folded before Flop
Seat 4: mjmichi folded before Flop (didn't bet)
Seat 5: chiyuki folded before Flop (didn't bet)
Seat 6: masterkoolb folded before Flop (didn't bet)
Seat 7: ChrisCDee folded before Flop (didn't bet)
Seat 8: snejokCoxx folded before Flop (didn't bet)
Seat 9: phate-1up folded before Flop



PokerStars Zoom Hand #84300193199:  Hold'em No Limit ($0.10/$0.25) - 2012/08/05 15:11:50 JST [2012/08/05 2:11:50 ET]
Table 'Whirlpool' 9-max Seat #1 is the button
Seat 1: pandaaaaaa ($9.80 in chips) 
Seat 2: KrystalAA ($37.34 in chips) 
Seat 3: GovGus ($25 in chips) 
Seat 4: Rafioso ($0.98 in chips) 
Seat 5: 1Karina1 ($29.44 in chips) 
Seat 6: chiyuki ($25.40 in chips) 
Seat 7: Perstenev ($18.28 in chips) 
Seat 8: Sal y Limon1 ($24.75 in chips) 
Seat 9: Dejacob ($25 in chips) 
KrystalAA: posts small blind $0.10
GovGus: posts big blind $0.25
*** HOLE CARDS ***
Dealt to chiyuki [9h 5d]
Rafioso: raises $0.73 to $0.98 and is all-in
1Karina1: folds 
chiyuki: folds 
Perstenev: calls $0.98
Sal y Limon1: folds 
Dejacob: folds 
pandaaaaaa: folds 
KrystalAA: folds 
GovGus: folds 
*** FLOP *** [Ts 8s 6s]
*** TURN *** [Ts 8s 6s] [Kc]
*** RIVER *** [Ts 8s 6s Kc] [Qh]
*** SHOW DOWN ***
Rafioso: shows [7d As] (high card Ace)
Perstenev: shows [Th Tc] (three of a kind, Tens)
Perstenev collected $2.21 from pot
*** SUMMARY ***
Total pot $2.31 | Rake $0.10 
Board [Ts 8s 6s Kc Qh]
Seat 1: pandaaaaaa (button) folded before Flop (didn't bet)
Seat 2: KrystalAA (small blind) folded before Flop
Seat 3: GovGus (big blind) folded before Flop
Seat 4: Rafioso showed [7d As] and lost with high card Ace
Seat 5: 1Karina1 folded before Flop (didn't bet)
Seat 6: chiyuki folded before Flop (didn't bet)
Seat 7: Perstenev showed [Th Tc] and won ($2.21) with three of a kind, Tens
Seat 8: Sal y Limon1 folded before Flop (didn't bet)
Seat 9: Dejacob folded before Flop (didn't bet)



PokerStars Zoom Hand #84300201599:  Hold'em No Limit ($0.10/$0.25) - 2012/08/05 15:12:23 JST [2012/08/05 2:12:23 ET]
Table 'Whirlpool' 9-max Seat #1 is the button
Seat 1: jacquelinewu ($25.35 in chips) 
Seat 2: ChrisCDee ($25.82 in chips) 
Seat 3: Tom1999 ($13.05 in chips) 
Seat 4: GovGus ($32.01 in chips) 
Seat 5: Roglus ($10.85 in chips) 
Seat 6: Perstenev ($14.41 in chips) 
Seat 7: KeLevro0 ($12.85 in chips) 
Seat 8: kwkim73 ($25 in chips) 
Seat 9: chiyuki ($25.15 in chips) 
ChrisCDee: posts small blind $0.10
Tom1999: posts big blind $0.25
*** HOLE CARDS ***
Dealt to chiyuki [4s Td]
GovGus: folds 
Roglus: raises $0.37 to $0.62
Perstenev: folds 
KeLevro0: folds 
kwkim73: folds 
chiyuki: folds 
jacquelinewu: folds 
ChrisCDee: folds 
Tom1999: folds 
Uncalled bet ($0.37) returned to Roglus
Roglus collected $0.60 from pot
Roglus: doesn't show hand 
*** SUMMARY ***
Total pot $0.60 | Rake $0 
Seat 1: jacquelinewu (button) folded before Flop (didn't bet)
Seat 2: ChrisCDee (small blind) folded before Flop
Seat 3: Tom1999 (big blind) folded before Flop
Seat 4: GovGus folded before Flop (didn't bet)
Seat 5: Roglus collected ($0.60)
Seat 6: Perstenev folded before Flop (didn't bet)
Seat 7: KeLevro0 folded before Flop (didn't bet)
Seat 8: kwkim73 folded before Flop (didn't bet)
Seat 9: chiyuki folded before Flop (didn't bet)



PokerStars Zoom Hand #84300192467:  Hold'em No Limit ($0.10/$0.25) - 2012/08/05 15:11:47 JST [2012/08/05 2:11:47 ET]
Table 'Whirlpool' 9-max Seat #1 is the button
Seat 1: Dan Royal ($20.95 in chips) 
Seat 2: therati ($20.58 in chips) 
Seat 3: JhonnyP1979 ($6.45 in chips) 
Seat 4: Wilcox76607 ($34.98 in chips) 
Seat 5: chiyuki ($25.40 in chips) 
Seat 6: deadmoneykid ($29.82 in chips) 
Seat 7: seula i ($40.72 in chips) 
Seat 8: INSP!RON ($26.05 in chips) 
Seat 9: Rafioso ($0.98 in chips) 
therati: posts small blind $0.10
JhonnyP1979: posts big blind $0.25
*** HOLE CARDS ***
Dealt to chiyuki [2d Td]
Wilcox76607: raises $0.50 to $0.75
chiyuki: folds 
deadmoneykid: folds 
seula i: folds 
INSP!RON: folds 
Rafioso: folds 
Dan Royal: folds 
therati: calls $0.65
JhonnyP1979: calls $0.50
*** FLOP *** [Kd Qd 5c]
therati: checks 
JhonnyP1979: checks 
Wilcox76607: bets $1
therati: calls $1
JhonnyP1979: calls $1
*** TURN *** [Kd Qd 5c] [Qs]
therati: checks 
JhonnyP1979: checks 
Wilcox76607: checks 
*** RIVER *** [Kd Qd 5c Qs] [Jd]
therati: checks 
JhonnyP1979: checks 
Wilcox76607: bets $3
therati: folds 
JhonnyP1979: folds 
Uncalled bet ($3) returned to Wilcox76607
Wilcox76607 collected $5.01 from pot
Wilcox76607: doesn't show hand 
*** SUMMARY ***
Total pot $5.25 | Rake $0.24 
Board [Kd Qd 5c Qs Jd]
Seat 1: Dan Royal (button) folded before Flop (didn't bet)
Seat 2: therati (small blind) folded on the River
Seat 3: JhonnyP1979 (big blind) folded on the River
Seat 4: Wilcox76607 collected ($5.01)
Seat 5: chiyuki folded before Flop (didn't bet)
Seat 6: deadmoneykid folded before Flop (didn't bet)
Seat 7: seula i folded before Flop (didn't bet)
Seat 8: INSP!RON folded before Flop (didn't bet)
Seat 9: Rafioso folded before Flop (didn't bet)



PokerStars Zoom Hand #84300195484:  Hold'em No Limit ($0.10/$0.25) - 2012/08/05 15:11:59 JST [2012/08/05 2:11:59 ET]
Table 'Whirlpool' 9-max Seat #1 is the button
Seat 1: Dejacob ($25 in chips) 
Seat 2: deadmoneykid ($29.82 in chips) 
Seat 3: chiyuki ($25.40 in chips) 
Seat 4: kamikkaze ($15.88 in chips) 
Seat 5: Ellen1947 ($23.25 in chips) 
Seat 6: Sal y Limon1 ($24.75 in chips) 
Seat 7: kaplya2010 ($23.02 in chips) 
Seat 8: 1Karina1 ($29.44 in chips) 
Seat 9: NuMetal88 ($25 in chips) 
deadmoneykid: posts small blind $0.10
chiyuki: posts big blind $0.25
*** HOLE CARDS ***
Dealt to chiyuki [Tc 3d]
kamikkaze: folds 
Ellen1947: folds 
Sal y Limon1: folds 
kaplya2010: folds 
1Karina1: folds 
NuMetal88: folds 
Dejacob: raises $0.50 to $0.75
deadmoneykid: raises $1.50 to $2.25
chiyuki: folds 
Dejacob: calls $1.50
*** FLOP *** [9c 8d 7h]
deadmoneykid: bets $2.50
Dejacob: folds 
Uncalled bet ($2.50) returned to deadmoneykid
deadmoneykid collected $4.54 from pot
deadmoneykid: doesn't show hand 
*** SUMMARY ***
Total pot $4.75 | Rake $0.21 
Board [9c 8d 7h]
Seat 1: Dejacob (button) folded on the Flop
Seat 2: deadmoneykid (small blind) collected ($4.54)
Seat 3: chiyuki (big blind) folded before Flop
Seat 4: kamikkaze folded before Flop (didn't bet)
Seat 5: Ellen1947 folded before Flop (didn't bet)
Seat 6: Sal y Limon1 folded before Flop (didn't bet)
Seat 7: kaplya2010 folded before Flop (didn't bet)
Seat 8: 1Karina1 folded before Flop (didn't bet)
Seat 9: NuMetal88 folded before Flop (didn't bet)



PokerStars Zoom Hand #84300205399:  Hold'em No Limit ($0.10/$0.25) - 2012/08/05 15:12:39 JST [2012/08/05 2:12:39 ET]
Table 'Whirlpool' 9-max Seat #1 is the button
Seat 1: pandaaaaaa ($11.97 in chips) 
Seat 2: Rilko1975 ($23.17 in chips) 
Seat 3: Perstenev ($14.41 in chips) 
Seat 4: chiyuki ($25.05 in chips) 
Seat 5: seula i ($29.11 in chips) 
Seat 6: kwkim73 ($25.70 in chips) 
Seat 7: luyifei ($22.89 in chips) 
Seat 8: colorado2108 ($49.56 in chips) 
Seat 9: ChrisCDee ($45.96 in chips) 
Rilko1975: posts small blind $0.10
Perstenev: posts big blind $0.25
*** HOLE CARDS ***
Dealt to chiyuki [Ac 4d]
chiyuki: folds 
seula i: folds 
kwkim73: folds 
luyifei: calls $0.25
colorado2108: folds 
ChrisCDee: calls $0.25
pandaaaaaa: raises $2 to $2.25
Rilko1975: folds 
Perstenev: folds 
luyifei: raises $2 to $4.25
ChrisCDee: folds 
pandaaaaaa: folds 
Uncalled bet ($2) returned to luyifei
luyifei collected $5.10 from pot
luyifei: doesn't show hand 
*** SUMMARY ***
Total pot $5.10 | Rake $0 
Seat 1: pandaaaaaa (button) folded before Flop
Seat 2: Rilko1975 (small blind) folded before Flop
Seat 3: Perstenev (big blind) folded before Flop
Seat 4: chiyuki folded before Flop (didn't bet)
Seat 5: seula i folded before Flop (didn't bet)
Seat 6: kwkim73 folded before Flop (didn't bet)
Seat 7: luyifei collected ($5.10)
Seat 8: colorado2108 folded before Flop (didn't bet)
Seat 9: ChrisCDee folded before Flop



PokerStars Zoom Hand #84300208258:  Hold'em No Limit ($0.10/$0.25) - 2012/08/05 15:12:50 JST [2012/08/05 2:12:50 ET]
Table 'Whirlpool' 9-max Seat #1 is the button
Seat 1: pandaaaaaa ($9.35 in chips) 
Seat 2: drunk_bender ($2.10 in chips) 
Seat 3: kwkim73 ($25 in chips) 
Seat 4: Yoshimac ($10.88 in chips) 
Seat 5: kamikkaze ($12.95 in chips) 
Seat 6: KeLevro0 ($12.85 in chips) 
Seat 7: chiyuki ($25.05 in chips) 
Seat 8: DutchShultzs ($35.18 in chips) 
Seat 9: therati ($18.83 in chips) 
drunk_bender: posts small blind $0.10
kwkim73: posts big blind $0.25
*** HOLE CARDS ***
Dealt to chiyuki [Th Jc]
Yoshimac: folds 
kamikkaze: folds 
KeLevro0: folds 
chiyuki: folds 
DutchShultzs: folds 
therati: folds 
pandaaaaaa: calls $0.25
drunk_bender: folds 
kwkim73: checks 
*** FLOP *** [5h Qh Qd]
kwkim73: checks 
pandaaaaaa: checks 
*** TURN *** [5h Qh Qd] [8c]
kwkim73: checks 
pandaaaaaa: checks 
*** RIVER *** [5h Qh Qd 8c] [7c]
kwkim73: checks 
pandaaaaaa: checks 
*** SHOW DOWN ***
kwkim73: shows [Kd 3c] (a pair of Queens)
pandaaaaaa: shows [3h 3s] (two pair, Queens and Threes)
pandaaaaaa collected $0.57 from pot
*** SUMMARY ***
Total pot $0.60 | Rake $0.03 
Board [5h Qh Qd 8c 7c]
Seat 1: pandaaaaaa (button) showed [3h 3s] and won ($0.57) with two pair, Queens and Threes
Seat 2: drunk_bender (small blind) folded before Flop
Seat 3: kwkim73 (big blind) showed [Kd 3c] and lost with a pair of Queens
Seat 4: Yoshimac folded before Flop (didn't bet)
Seat 5: kamikkaze folded before Flop (didn't bet)
Seat 6: KeLevro0 folded before Flop (didn't bet)
Seat 7: chiyuki folded before Flop (didn't bet)
Seat 8: DutchShultzs folded before Flop (didn't bet)
Seat 9: therati folded before Flop (didn't bet)



PokerStars Zoom Hand #84300210233:  Hold'em No Limit ($0.10/$0.25) - 2012/08/05 15:12:58 JST [2012/08/05 2:12:58 ET]
Table 'Whirlpool' 9-max Seat #1 is the button
Seat 1: phate-1up ($25 in chips) 
Seat 2: kamikkaze ($12.95 in chips) 
Seat 3: Ellen1947 ($26.95 in chips) 
Seat 4: troublesomm ($25 in chips) 
Seat 5: rorfo23 ($16.76 in chips) 
Seat 6: seula i ($40.72 in chips) 
Seat 7: masterkoolb ($12.50 in chips) 
Seat 8: turbotom122 ($28.47 in chips) 
Seat 9: chiyuki ($25.05 in chips) 
kamikkaze: posts small blind $0.10
Ellen1947: posts big blind $0.25
*** HOLE CARDS ***
Dealt to chiyuki [Ts 3c]
troublesomm: folds 
rorfo23: folds 
seula i: folds 
masterkoolb: folds 
turbotom122: folds 
chiyuki: folds 
phate-1up: raises $0.50 to $0.75
kamikkaze: folds 
Ellen1947: folds 
Uncalled bet ($0.50) returned to phate-1up
phate-1up collected $0.60 from pot
phate-1up: doesn't show hand 
*** SUMMARY ***
Total pot $0.60 | Rake $0 
Seat 1: phate-1up (button) collected ($0.60)
Seat 2: kamikkaze (small blind) folded before Flop
Seat 3: Ellen1947 (big blind) folded before Flop
Seat 4: troublesomm folded before Flop (didn't bet)
Seat 5: rorfo23 folded before Flop (didn't bet)
Seat 6: seula i folded before Flop (didn't bet)
Seat 7: masterkoolb folded before Flop (didn't bet)
Seat 8: turbotom122 folded before Flop (didn't bet)
Seat 9: chiyuki folded before Flop (didn't bet)



PokerStars Zoom Hand #84300211993:  Hold'em No Limit ($0.10/$0.25) - 2012/08/05 15:13:05 JST [2012/08/05 2:13:05 ET]
Table 'Whirlpool' 9-max Seat #1 is the button
Seat 1: kwkim73 ($25.70 in chips) 
Seat 2: hirozo ($32.95 in chips) 
Seat 3: masterkoolb ($12.50 in chips) 
Seat 4: INSP!RON ($30.85 in chips) 
Seat 5: kesstukas25 ($12.85 in chips) 
Seat 6: chiyuki ($25.05 in chips) 
Seat 7: Nerkit ($22.92 in chips) 
Seat 8: jacquelinewu ($26.21 in chips) 
Seat 9: 1Karina1 ($30.99 in chips) 
hirozo: posts small blind $0.10
masterkoolb: posts big blind $0.25
*** HOLE CARDS ***
Dealt to chiyuki [Ks 5s]
INSP!RON: raises $0.50 to $0.75
kesstukas25: folds 
chiyuki: folds 
Nerkit: folds 
jacquelinewu: folds 
1Karina1: folds 
kwkim73: folds 
hirozo: folds 
masterkoolb: folds 
Uncalled bet ($0.50) returned to INSP!RON
INSP!RON collected $0.60 from pot
INSP!RON: doesn't show hand 
*** SUMMARY ***
Total pot $0.60 | Rake $0 
Seat 1: kwkim73 (button) folded before Flop (didn't bet)
Seat 2: hirozo (small blind) folded before Flop
Seat 3: masterkoolb (big blind) folded before Flop
Seat 4: INSP!RON collected ($0.60)
Seat 5: kesstukas25 folded before Flop (didn't bet)
Seat 6: chiyuki folded before Flop (didn't bet)
Seat 7: Nerkit folded before Flop (didn't bet)
Seat 8: jacquelinewu folded before Flop (didn't bet)
Seat 9: 1Karina1 folded before Flop (didn't bet)



PokerStars Zoom Hand #84300203629:  Hold'em No Limit ($0.10/$0.25) - 2012/08/05 15:12:32 JST [2012/08/05 2:12:32 ET]
Table 'Whirlpool' 9-max Seat #1 is the button
Seat 1: kamikkaze ($15.88 in chips) 
Seat 2: chiyuki ($25.15 in chips) 
Seat 3: NuMetal88 ($25 in chips) 
Seat 4: 1Karina1 ($28.95 in chips) 
Seat 5: DutchShultzs ($40.46 in chips) 
Seat 6: 4plankton ($20.04 in chips) 
Seat 7: Nerkit ($11.40 in chips) 
Seat 8: el pore 5 ($12.31 in chips) 
Seat 9: jacquelinewu ($26.21 in chips) 
chiyuki: posts small blind $0.10
NuMetal88: posts big blind $0.25
*** HOLE CARDS ***
Dealt to chiyuki [3s 2h]
1Karina1: folds 
DutchShultzs: folds 
4plankton: folds 
Nerkit: raises $0.50 to $0.75
el pore 5: calls $0.75
jacquelinewu: folds 
kamikkaze: folds 
chiyuki: folds 
NuMetal88: folds 
*** FLOP *** [7h 3h Ah]
Nerkit: checks 
el pore 5: bets $0.50
Nerkit: calls $0.50
*** TURN *** [7h 3h Ah] [Ts]
Nerkit: checks 
el pore 5: bets $0.50
Nerkit: calls $0.50
*** RIVER *** [7h 3h Ah Ts] [6c]
Nerkit: checks 
el pore 5: bets $2
Nerkit: calls $2
*** SHOW DOWN ***
el pore 5: shows [8c Qc] (high card Ace)
Nerkit: shows [Kd Ks] (a pair of Kings)
Nerkit collected $7.50 from pot
*** SUMMARY ***
Total pot $7.85 | Rake $0.35 
Board [7h 3h Ah Ts 6c]
Seat 1: kamikkaze (button) folded before Flop (didn't bet)
Seat 2: chiyuki (small blind) folded before Flop
Seat 3: NuMetal88 (big blind) folded before Flop
Seat 4: 1Karina1 folded before Flop (didn't bet)
Seat 5: DutchShultzs folded before Flop (didn't bet)
Seat 6: 4plankton folded before Flop (didn't bet)
Seat 7: Nerkit showed [Kd Ks] and won ($7.50) with a pair of Kings
Seat 8: el pore 5 showed [8c Qc] and lost with high card Ace
Seat 9: jacquelinewu folded before Flop (didn't bet)



PokerStars Zoom Hand #84300211249:  Hold'em No Limit ($0.10/$0.25) - 2012/08/05 15:13:02 JST [2012/08/05 2:13:02 ET]
Table 'Whirlpool' 9-max Seat #1 is the button
Seat 1: chiyuki ($25.05 in chips) 
Seat 2: troublesomm ($25 in chips) 
Seat 3: rorfo23 ($16.76 in chips) 
Seat 4: ygoegoe ($31.02 in chips) 
Seat 5: turbotom122 ($28.47 in chips) 
Seat 6: DPsemplic ($6.56 in chips) 
Seat 7: kamikkaze ($12.85 in chips) 
Seat 8: DutchShultzs ($32.99 in chips) 
Seat 9: deadmoneykid ($25.46 in chips) 
troublesomm: posts small blind $0.10
rorfo23: posts big blind $0.25
*** HOLE CARDS ***
Dealt to chiyuki [Tc 5s]
ygoegoe: folds 
turbotom122: folds 
DPsemplic: raises $0.25 to $0.50
kamikkaze: folds 
DutchShultzs: folds 
deadmoneykid: folds 
chiyuki: folds 
troublesomm: folds 
rorfo23: folds 
Uncalled bet ($0.25) returned to DPsemplic
DPsemplic collected $0.60 from pot
DPsemplic: doesn't show hand 
*** SUMMARY ***
Total pot $0.60 | Rake $0 
Seat 1: chiyuki (button) folded before Flop (didn't bet)
Seat 2: troublesomm (small blind) folded before Flop
Seat 3: rorfo23 (big blind) folded before Flop
Seat 4: ygoegoe folded before Flop (didn't bet)
Seat 5: turbotom122 folded before Flop (didn't bet)
Seat 6: DPsemplic collected ($0.60)
Seat 7: kamikkaze folded before Flop (didn't bet)
Seat 8: DutchShultzs folded before Flop (didn't bet)
Seat 9: deadmoneykid folded before Flop (didn't bet)



PokerStars Zoom Hand #84300214233:  Hold'em No Limit ($0.10/$0.25) - 2012/08/05 15:13:14 JST [2012/08/05 2:13:14 ET]
Table 'Whirlpool' 9-max Seat #1 is the button
Seat 1: kesstukas25 ($12.98 in chips) 
Seat 2: kwkim73 ($25.70 in chips) 
Seat 3: chiyuki ($25.05 in chips) 
Seat 4: seula i ($40.72 in chips) 
Seat 5: snejokCoxx ($11.79 in chips) 
Seat 6: 1Karina1 ($30.99 in chips) 
Seat 7: laurentzu84 ($25 in chips) 
Seat 8: jacquelinewu ($25.45 in chips) 
Seat 9: ZhukOFFskI ($30.73 in chips) 
kwkim73: posts small blind $0.10
chiyuki: posts big blind $0.25
*** HOLE CARDS ***
Dealt to chiyuki [7d 2s]
seula i: folds 
snejokCoxx: folds 
1Karina1: folds 
laurentzu84: folds 
jacquelinewu: folds 
ZhukOFFskI: folds 
kesstukas25: folds 
kwkim73: folds 
Uncalled bet ($0.15) returned to chiyuki
chiyuki collected $0.20 from pot
chiyuki: doesn't show hand 
*** SUMMARY ***
Total pot $0.20 | Rake $0 
Seat 1: kesstukas25 (button) folded before Flop (didn't bet)
Seat 2: kwkim73 (small blind) folded before Flop
Seat 3: chiyuki (big blind) collected ($0.20)
Seat 4: seula i folded before Flop (didn't bet)
Seat 5: snejokCoxx folded before Flop (didn't bet)
Seat 6: 1Karina1 folded before Flop (didn't bet)
Seat 7: laurentzu84 folded before Flop (didn't bet)
Seat 8: jacquelinewu folded before Flop (didn't bet)
Seat 9: ZhukOFFskI folded before Flop (didn't bet)



PokerStars Zoom Hand #84300194693:  Hold'em No Limit ($0.10/$0.25) - 2012/08/05 15:11:56 JST [2012/08/05 2:11:56 ET]
Table 'Whirlpool' 9-max Seat #1 is the button
Seat 1: jacquelinewu ($26.71 in chips) 
Seat 2: deadmoneykid ($25.56 in chips) 
Seat 3: kwkim73 ($25.25 in chips) 
Seat 4: chiyuki ($25.40 in chips) 
Seat 5: troublesomm ($25.99 in chips) 
Seat 6: phate-1up ($68.47 in chips) 
Seat 7: silvno31 ($26.40 in chips) 
Seat 8: moku36 ($19.57 in chips) 
Seat 9: DutchShultzs ($35.43 in chips) 
deadmoneykid: posts small blind $0.10
kwkim73: posts big blind $0.25
*** HOLE CARDS ***
Dealt to chiyuki [Qd 9d]
chiyuki: folds 
troublesomm: raises $0.25 to $0.50
phate-1up: calls $0.50
silvno31: calls $0.50
moku36: folds 
DutchShultzs: folds 
jacquelinewu: calls $0.50
deadmoneykid: folds 
kwkim73: folds 
*** FLOP *** [4s Th 3c]
troublesomm: bets $1.23
phate-1up: raises $2.27 to $3.50
silvno31: folds 
jacquelinewu: folds 
troublesomm: calls $2.27
*** TURN *** [4s Th 3c] [Ah]
troublesomm: checks 
phate-1up: bets $5.25
troublesomm: calls $5.25
*** RIVER *** [4s Th 3c Ah] [Ad]
troublesomm: checks 
phate-1up: checks 
*** SHOW DOWN ***
troublesomm: shows [3s 3h] (a full house, Threes full of Aces)
phate-1up: mucks hand 
troublesomm collected $18.96 from pot
*** SUMMARY ***
Total pot $19.85 | Rake $0.89 
Board [4s Th 3c Ah Ad]
Seat 1: jacquelinewu (button) folded on the Flop
Seat 2: deadmoneykid (small blind) folded before Flop
Seat 3: kwkim73 (big blind) folded before Flop
Seat 4: chiyuki folded before Flop (didn't bet)
Seat 5: troublesomm showed [3s 3h] and won ($18.96) with a full house, Threes full of Aces
Seat 6: phate-1up mucked [6d 6s]
Seat 7: silvno31 folded on the Flop
Seat 8: moku36 folded before Flop (didn't bet)
Seat 9: DutchShultzs folded before Flop (didn't bet)



PokerStars Zoom Hand #84300212966:  Hold'em No Limit ($0.10/$0.25) - 2012/08/05 15:13:09 JST [2012/08/05 2:13:09 ET]
Table 'Whirlpool' 9-max Seat #1 is the button
Seat 1: ZhukOFFskI ($47.23 in chips) 
Seat 2: Silveystryk ($23.84 in chips) 
Seat 3: Perstenev ($10.30 in chips) 
Seat 4: kesstukas25 ($12.85 in chips) 
Seat 5: laurentzu84 ($25 in chips) 
Seat 6: snejokCoxx ($10.03 in chips) 
Seat 7: GovGus ($27.28 in chips) 
Seat 8: chiyuki ($25.05 in chips) 
Seat 9: seula i ($40.72 in chips) 
Silveystryk: posts small blind $0.10
Perstenev: posts big blind $0.25
*** HOLE CARDS ***
Dealt to chiyuki [9d 2h]
kesstukas25: folds 
laurentzu84: folds 
snejokCoxx: folds 
GovGus: raises $0.50 to $0.75
chiyuki: folds 
seula i: folds 
ZhukOFFskI: folds 
Silveystryk: calls $0.65
Perstenev: folds 
*** FLOP *** [Ac Kh 2c]
Silveystryk: checks 
GovGus: bets $1.08
Silveystryk: folds 
Uncalled bet ($1.08) returned to GovGus
GovGus collected $1.67 from pot
GovGus: doesn't show hand 
*** SUMMARY ***
Total pot $1.75 | Rake $0.08 
Board [Ac Kh 2c]
Seat 1: ZhukOFFskI (button) folded before Flop (didn't bet)
Seat 2: Silveystryk (small blind) folded on the Flop
Seat 3: Perstenev (big blind) folded before Flop
Seat 4: kesstukas25 folded before Flop (didn't bet)
Seat 5: laurentzu84 folded before Flop (didn't bet)
Seat 6: snejokCoxx folded before Flop (didn't bet)
Seat 7: GovGus collected ($1.67)
Seat 8: chiyuki folded before Flop (didn't bet)
Seat 9: seula i folded before Flop (didn't bet)



PokerStars Zoom Hand #84300206469:  Hold'em No Limit ($0.10/$0.25) - 2012/08/05 15:12:43 JST [2012/08/05 2:12:43 ET]
Table 'Whirlpool' 9-max Seat #1 is the button
Seat 1: Dejacob ($29.76 in chips) 
Seat 2: colorado2108 ($49.56 in chips) 
Seat 3: Robchie ($14.67 in chips) 
Seat 4: Ellen1947 ($26.95 in chips) 
Seat 5: starreset ($32.63 in chips) 
Seat 6: Tom1999 ($23.47 in chips) 
Seat 7: GravyWalrus ($11.84 in chips) 
Seat 8: chiyuki ($25.05 in chips) 
Seat 9: tribunpdm ($32.03 in chips) 
colorado2108: posts small blind $0.10
Robchie: posts big blind $0.25
*** HOLE CARDS ***
Dealt to chiyuki [9h 4h]
Ellen1947: folds 
starreset: folds 
Tom1999: folds 
GravyWalrus: folds 
chiyuki: folds 
tribunpdm: folds 
Dejacob: raises $0.50 to $0.75
colorado2108: calls $0.65
Robchie: calls $0.50
*** FLOP *** [Qh Ts 5h]
colorado2108: checks 
Robchie: bets $0.66
Dejacob: calls $0.66
colorado2108: calls $0.66
*** TURN *** [Qh Ts 5h] [3c]
colorado2108: checks 
Robchie: checks 
Dejacob: checks 
*** RIVER *** [Qh Ts 5h 3c] [8c]
colorado2108: checks 
Robchie: bets $0.26
Dejacob: calls $0.26
colorado2108: calls $0.26
*** SHOW DOWN ***
Robchie: shows [8d Kc] (a pair of Eights)
Dejacob: shows [Td 6d] (a pair of Tens)
colorado2108: mucks hand 
Dejacob collected $4.78 from pot
*** SUMMARY ***
Total pot $5.01 | Rake $0.23 
Board [Qh Ts 5h 3c 8c]
Seat 1: Dejacob (button) showed [Td 6d] and won ($4.78) with a pair of Tens
Seat 2: colorado2108 (small blind) mucked [Ah Jd]
Seat 3: Robchie (big blind) showed [8d Kc] and lost with a pair of Eights
Seat 4: Ellen1947 folded before Flop (didn't bet)
Seat 5: starreset folded before Flop (didn't bet)
Seat 6: Tom1999 folded before Flop (didn't bet)
Seat 7: GravyWalrus folded before Flop (didn't bet)
Seat 8: chiyuki folded before Flop (didn't bet)
Seat 9: tribunpdm folded before Flop (didn't bet)



PokerStars Zoom Hand #84300216966:  Hold'em No Limit ($0.10/$0.25) - 2012/08/05 15:13:25 JST [2012/08/05 2:13:25 ET]
Table 'Whirlpool' 9-max Seat #1 is the button
Seat 1: Perstenev ($14.06 in chips) 
Seat 2: kesstukas25 ($12.98 in chips) 
Seat 3: seula i ($29.11 in chips) 
Seat 4: kamikkaze ($12.85 in chips) 
Seat 5: KrystalAA ($29.95 in chips) 
Seat 6: chiyuki ($25.15 in chips) 
Seat 7: deadmoneykid ($31.59 in chips) 
Seat 8: Ellen1947 ($21.75 in chips) 
Seat 9: KeLevro0 ($14.76 in chips) 
kesstukas25: posts small blind $0.10
seula i: posts big blind $0.25
*** HOLE CARDS ***
Dealt to chiyuki [8s Ks]
kamikkaze: folds 
KrystalAA: folds 
chiyuki: folds 
deadmoneykid: folds 
Ellen1947: folds 
KeLevro0: raises $0.42 to $0.67
Perstenev: folds 
kesstukas25: folds 
seula i: folds 
Uncalled bet ($0.42) returned to KeLevro0
KeLevro0 collected $0.60 from pot
KeLevro0: doesn't show hand 
*** SUMMARY ***
Total pot $0.60 | Rake $0 
Seat 1: Perstenev (button) folded before Flop (didn't bet)
Seat 2: kesstukas25 (small blind) folded before Flop
Seat 3: seula i (big blind) folded before Flop
Seat 4: kamikkaze folded before Flop (didn't bet)
Seat 5: KrystalAA folded before Flop (didn't bet)
Seat 6: chiyuki folded before Flop (didn't bet)
Seat 7: deadmoneykid folded before Flop (didn't bet)
Seat 8: Ellen1947 folded before Flop (didn't bet)
Seat 9: KeLevro0 collected ($0.60)



PokerStars Zoom Hand #84300221855:  Hold'em No Limit ($0.10/$0.25) - 2012/08/05 15:13:45 JST [2012/08/05 2:13:45 ET]
Table 'Whirlpool' 9-max Seat #1 is the button
Seat 1: MarginX ($24 in chips) 
Seat 2: phate-1up ($51.68 in chips) 
Seat 3: WARIBANA7777 ($17.11 in chips) 
Seat 4: 4ydo yogurt ($39.38 in chips) 
Seat 5: troublesomm ($39.69 in chips) 
Seat 6: dushvan ($33.54 in chips) 
Seat 7: chiyuki ($25.05 in chips) 
Seat 8: svg51 ($13.82 in chips) 
Seat 9: el pore 5 ($8.46 in chips) 
phate-1up: posts small blind $0.10
WARIBANA7777: posts big blind $0.25
*** HOLE CARDS ***
Dealt to chiyuki [3s Tc]
4ydo yogurt: folds 
troublesomm: folds 
dushvan: folds 
chiyuki: folds 
svg51: folds 
el pore 5: raises $1.75 to $2
MarginX: folds 
phate-1up: folds 
WARIBANA7777: folds 
Uncalled bet ($1.75) returned to el pore 5
el pore 5 collected $0.60 from pot
el pore 5: doesn't show hand 
*** SUMMARY ***
Total pot $0.60 | Rake $0 
Seat 1: MarginX (button) folded before Flop (didn't bet)
Seat 2: phate-1up (small blind) folded before Flop
Seat 3: WARIBANA7777 (big blind) folded before Flop
Seat 4: 4ydo yogurt folded before Flop (didn't bet)
Seat 5: troublesomm folded before Flop (didn't bet)
Seat 6: dushvan folded before Flop (didn't bet)
Seat 7: chiyuki folded before Flop (didn't bet)
Seat 8: svg51 folded before Flop (didn't bet)
Seat 9: el pore 5 collected ($0.60)



PokerStars Zoom Hand #84300223402:  Hold'em No Limit ($0.10/$0.25) - 2012/08/05 15:13:51 JST [2012/08/05 2:13:51 ET]
Table 'Whirlpool' 9-max Seat #1 is the button
Seat 1: chiyuki ($25.05 in chips) 
Seat 2: seula i ($40.82 in chips) 
Seat 3: INSP!RON ($26.72 in chips) 
Seat 4: PAMBOS.L ($20.50 in chips) 
Seat 5: Robchie ($13 in chips) 
Seat 6: kamikkaze ($15.88 in chips) 
Seat 7: KeLevro0 ($14.02 in chips) 
Seat 8: phate-1up ($25.25 in chips) 
Seat 9: hirozo ($33.20 in chips) 
seula i: posts small blind $0.10
INSP!RON: posts big blind $0.25
*** HOLE CARDS ***
Dealt to chiyuki [8c Ah]
PAMBOS.L: folds 
Robchie: folds 
kamikkaze: raises $0.50 to $0.75
KeLevro0: folds 
phate-1up: folds 
hirozo: folds 
chiyuki: folds 
seula i: folds 
INSP!RON: folds 
Uncalled bet ($0.50) returned to kamikkaze
kamikkaze collected $0.60 from pot
kamikkaze: doesn't show hand 
*** SUMMARY ***
Total pot $0.60 | Rake $0 
Seat 1: chiyuki (button) folded before Flop (didn't bet)
Seat 2: seula i (small blind) folded before Flop
Seat 3: INSP!RON (big blind) folded before Flop
Seat 4: PAMBOS.L folded before Flop (didn't bet)
Seat 5: Robchie folded before Flop (didn't bet)
Seat 6: kamikkaze collected ($0.60)
Seat 7: KeLevro0 folded before Flop (didn't bet)
Seat 8: phate-1up folded before Flop (didn't bet)
Seat 9: hirozo folded before Flop (didn't bet)



PokerStars Zoom Hand #84300218292:  Hold'em No Limit ($0.10/$0.25) - 2012/08/05 15:13:30 JST [2012/08/05 2:13:30 ET]
Table 'Whirlpool' 9-max Seat #1 is the button
Seat 1: kwkim73 ($25 in chips) 
Seat 2: chiyuki ($25.15 in chips) 
Seat 3: DanielWhyte ($61.32 in chips) 
Seat 4: Nerkit ($22.92 in chips) 
Seat 5: pandaaaaaa ($9.72 in chips) 
Seat 6: jacquelinewu ($38 in chips) 
Seat 7: 4plankton ($18.94 in chips) 
Seat 8: NuMetal88 ($26.02 in chips) 
Seat 9: slapshot2011 ($24.93 in chips) 
chiyuki: posts small blind $0.10
DanielWhyte: posts big blind $0.25
*** HOLE CARDS ***
Dealt to chiyuki [9h 2s]
Nerkit: raises $0.50 to $0.75
pandaaaaaa: folds 
jacquelinewu: folds 
4plankton: folds 
NuMetal88: folds 
slapshot2011: folds 
kwkim73: folds 
chiyuki: folds 
DanielWhyte: raises $0.75 to $1.50
Nerkit: calls $0.75
*** FLOP *** [Kh 7h 9c]
DanielWhyte: bets $0.50
Nerkit: calls $0.50
*** TURN *** [Kh 7h 9c] [5c]
DanielWhyte: bets $2
Nerkit: calls $2
*** RIVER *** [Kh 7h 9c 5c] [Qh]
DanielWhyte: bets $2
Nerkit: folds 
Uncalled bet ($2) returned to DanielWhyte
DanielWhyte collected $7.74 from pot
DanielWhyte: doesn't show hand 
*** SUMMARY ***
Total pot $8.10 | Rake $0.36 
Board [Kh 7h 9c 5c Qh]
Seat 1: kwkim73 (button) folded before Flop (didn't bet)
Seat 2: chiyuki (small blind) folded before Flop
Seat 3: DanielWhyte (big blind) collected ($7.74)
Seat 4: Nerkit folded on the River
Seat 5: pandaaaaaa folded before Flop (didn't bet)
Seat 6: jacquelinewu folded before Flop (didn't bet)
Seat 7: 4plankton folded before Flop (didn't bet)
Seat 8: NuMetal88 folded before Flop (didn't bet)
Seat 9: slapshot2011 folded before Flop (didn't bet)



PokerStars Zoom Hand #84300229016:  Hold'em No Limit ($0.10/$0.25) - 2012/08/05 15:14:13 JST [2012/08/05 2:14:13 ET]
Table 'Whirlpool' 9-max Seat #1 is the button
Seat 1: kamikkaze ($16.23 in chips) 
Seat 2: masterkoolb ($12.50 in chips) 
Seat 3: chiyuki ($25.05 in chips) 
Seat 4: Lasutchik ($75.21 in chips) 
Seat 5: KeLevro0 ($11.75 in chips) 
Seat 6: starreset ($33.64 in chips) 
Seat 7: womble32 ($26.21 in chips) 
Seat 8: phate-1up ($53.30 in chips) 
Seat 9: karpexxx ($14.60 in chips) 
masterkoolb: posts small blind $0.10
chiyuki: posts big blind $0.25
*** HOLE CARDS ***
Dealt to chiyuki [Js Ac]
Lasutchik: folds 
KeLevro0: folds 
starreset: folds 
womble32: raises $0.50 to $0.75
phate-1up: folds 
karpexxx: folds 
kamikkaze: folds 
masterkoolb: folds 
chiyuki: folds 
Uncalled bet ($0.50) returned to womble32
womble32 collected $0.60 from pot
womble32: doesn't show hand 
*** SUMMARY ***
Total pot $0.60 | Rake $0 
Seat 1: kamikkaze (button) folded before Flop (didn't bet)
Seat 2: masterkoolb (small blind) folded before Flop
Seat 3: chiyuki (big blind) folded before Flop
Seat 4: Lasutchik folded before Flop (didn't bet)
Seat 5: KeLevro0 folded before Flop (didn't bet)
Seat 6: starreset folded before Flop (didn't bet)
Seat 7: womble32 collected ($0.60)
Seat 8: phate-1up folded before Flop (didn't bet)
Seat 9: karpexxx folded before Flop (didn't bet)



PokerStars Zoom Hand #84300221083:  Hold'em No Limit ($0.10/$0.25) - 2012/08/05 15:13:42 JST [2012/08/05 2:13:42 ET]
Table 'Whirlpool' 9-max Seat #1 is the button
Seat 1: AntoineHunt ($18.51 in chips) 
Seat 2: ZhukOFFskI ($46.98 in chips) 
Seat 3: snejokCoxx ($11.79 in chips) 
Seat 4: laurentzu84 ($25.10 in chips) 
Seat 5: chiyuki ($25.05 in chips) 
Seat 6: Silveystryk ($23.09 in chips) 
Seat 7: Perstenev ($14.06 in chips) 
Seat 8: KrystalAA ($34.49 in chips) 
Seat 9: Roglus ($8.70 in chips) 
ZhukOFFskI: posts small blind $0.10
snejokCoxx: posts big blind $0.25
*** HOLE CARDS ***
Dealt to chiyuki [4d 2c]
laurentzu84: folds 
chiyuki: folds 
Silveystryk: calls $0.25
Perstenev: folds 
KrystalAA: folds 
Roglus: folds 
AntoineHunt: folds 
ZhukOFFskI: calls $0.15
snejokCoxx: checks 
*** FLOP *** [8c 3s 9c]
ZhukOFFskI: bets $0.50
snejokCoxx: folds 
Silveystryk: folds 
Uncalled bet ($0.50) returned to ZhukOFFskI
ZhukOFFskI collected $0.72 from pot
ZhukOFFskI: doesn't show hand 
*** SUMMARY ***
Total pot $0.75 | Rake $0.03 
Board [8c 3s 9c]
Seat 1: AntoineHunt (button) folded before Flop (didn't bet)
Seat 2: ZhukOFFskI (small blind) collected ($0.72)
Seat 3: snejokCoxx (big blind) folded on the Flop
Seat 4: laurentzu84 folded before Flop (didn't bet)
Seat 5: chiyuki folded before Flop (didn't bet)
Seat 6: Silveystryk folded on the Flop
Seat 7: Perstenev folded before Flop (didn't bet)
Seat 8: KrystalAA folded before Flop (didn't bet)
Seat 9: Roglus folded before Flop (didn't bet)



PokerStars Zoom Hand #84300226518:  Hold'em No Limit ($0.10/$0.25) - 2012/08/05 15:14:03 JST [2012/08/05 2:14:03 ET]
Table 'Whirlpool' 9-max Seat #1 is the button
Seat 1: simonzez ($22.37 in chips) 
Seat 2: Dejacob ($25 in chips) 
Seat 3: dushvan ($33.54 in chips) 
Seat 4: Silveystryk ($27.43 in chips) 
Seat 5: el pore 5 ($8.81 in chips) 
Seat 6: tribunpdm ($29.33 in chips) 
Seat 7: jacquelinewu ($25.96 in chips) 
Seat 8: MarginX ($24 in chips) 
Seat 9: chiyuki ($25.05 in chips) 
Dejacob: posts small blind $0.10
dushvan: posts big blind $0.25
*** HOLE CARDS ***
Dealt to chiyuki [Jh 2s]
Silveystryk: folds 
el pore 5: folds 
tribunpdm: raises $0.50 to $0.75
jacquelinewu: folds 
MarginX: raises $1.75 to $2.50
chiyuki: folds 
simonzez: folds 
Dejacob: folds 
dushvan: folds 
tribunpdm: calls $1.75
*** FLOP *** [7c 7d 3c]
tribunpdm: checks 
MarginX: checks 
*** TURN *** [7c 7d 3c] [Jc]
tribunpdm: checks 
MarginX: checks 
*** RIVER *** [7c 7d 3c Jc] [6d]
tribunpdm: bets $1
MarginX: calls $1
*** SHOW DOWN ***
tribunpdm: shows [6s 6h] (a full house, Sixes full of Sevens)
MarginX: mucks hand 
tribunpdm collected $7.02 from pot
*** SUMMARY ***
Total pot $7.35 | Rake $0.33 
Board [7c 7d 3c Jc 6d]
Seat 1: simonzez (button) folded before Flop (didn't bet)
Seat 2: Dejacob (small blind) folded before Flop
Seat 3: dushvan (big blind) folded before Flop
Seat 4: Silveystryk folded before Flop (didn't bet)
Seat 5: el pore 5 folded before Flop (didn't bet)
Seat 6: tribunpdm showed [6s 6h] and won ($7.02) with a full house, Sixes full of Sevens
Seat 7: jacquelinewu folded before Flop (didn't bet)
Seat 8: MarginX mucked [Qc Ad]
Seat 9: chiyuki folded before Flop (didn't bet)



PokerStars Zoom Hand #84300227767:  Hold'em No Limit ($0.10/$0.25) - 2012/08/05 15:14:08 JST [2012/08/05 2:14:08 ET]
Table 'Whirlpool' 9-max Seat #1 is the button
Seat 1: Ellen1947 ($26.60 in chips) 
Seat 2: kwkim73 ($25.35 in chips) 
Seat 3: GovGus ($34.50 in chips) 
Seat 4: chiyuki ($25.05 in chips) 
Seat 5: Silveystryk ($27.43 in chips) 
Seat 6: Wilcox76607 ($36.64 in chips) 
Seat 7: starreset ($33.64 in chips) 
Seat 8: Dejacob ($25 in chips) 
Seat 9: jacquelinewu ($25.96 in chips) 
kwkim73: posts small blind $0.10
GovGus: posts big blind $0.25
*** HOLE CARDS ***
Dealt to chiyuki [4c 2s]
chiyuki: folds 
Silveystryk: folds 
Wilcox76607: raises $0.50 to $0.75
starreset: folds 
Dejacob: folds 
jacquelinewu: folds 
Ellen1947: folds 
kwkim73: raises $1.75 to $2.50
GovGus: folds 
Wilcox76607: folds 
Uncalled bet ($1.75) returned to kwkim73
kwkim73 collected $1.75 from pot
kwkim73: doesn't show hand 
*** SUMMARY ***
Total pot $1.75 | Rake $0 
Seat 1: Ellen1947 (button) folded before Flop (didn't bet)
Seat 2: kwkim73 (small blind) collected ($1.75)
Seat 3: GovGus (big blind) folded before Flop
Seat 4: chiyuki folded before Flop (didn't bet)
Seat 5: Silveystryk folded before Flop (didn't bet)
Seat 6: Wilcox76607 folded before Flop
Seat 7: starreset folded before Flop (didn't bet)
Seat 8: Dejacob folded before Flop (didn't bet)
Seat 9: jacquelinewu folded before Flop (didn't bet)



PokerStars Zoom Hand #84300233298:  Hold'em No Limit ($0.10/$0.25) - 2012/08/05 15:14:30 JST [2012/08/05 2:14:30 ET]
Table 'Whirlpool' 9-max Seat #1 is the button
Seat 1: Dejacob ($25.77 in chips) 
Seat 2: chiyuki ($24.80 in chips) 
Seat 3: risekuku468 ($38.56 in chips) 
Seat 4: KrystalAA ($34.39 in chips) 
Seat 5: kamikkaze ($16.23 in chips) 
Seat 6: phate-1up ($51.93 in chips) 
Seat 7: ChrisCDee ($72.31 in chips) 
Seat 8: puffy5533 ($24.75 in chips) 
Seat 9: Nerkit ($14.80 in chips) 
chiyuki: posts small blind $0.10
risekuku468: posts big blind $0.25
*** HOLE CARDS ***
Dealt to chiyuki [6h 6c]
KrystalAA: folds 
kamikkaze: folds 
phate-1up: folds 
ChrisCDee: folds 
puffy5533: folds 
Nerkit: folds 
Dejacob: raises $0.50 to $0.75
chiyuki: folds 
risekuku468: folds 
Uncalled bet ($0.50) returned to Dejacob
Dejacob collected $0.60 from pot
Dejacob: doesn't show hand 
*** SUMMARY ***
Total pot $0.60 | Rake $0 
Seat 1: Dejacob (button) collected ($0.60)
Seat 2: chiyuki (small blind) folded before Flop
Seat 3: risekuku468 (big blind) folded before Flop
Seat 4: KrystalAA folded before Flop (didn't bet)
Seat 5: kamikkaze folded before Flop (didn't bet)
Seat 6: phate-1up folded before Flop (didn't bet)
Seat 7: ChrisCDee folded before Flop (didn't bet)
Seat 8: puffy5533 folded before Flop (didn't bet)
Seat 9: Nerkit folded before Flop (didn't bet)



PokerStars Zoom Hand #84300241020:  Hold'em No Limit ($0.10/$0.25) - 2012/08/05 15:15:01 JST [2012/08/05 2:15:01 ET]
Table 'Whirlpool' 9-max Seat #1 is the button
Seat 1: KeLevro0 ($9.58 in chips) 
Seat 2: phate-1up ($53.82 in chips) 
Seat 3: Silveystryk ($27.33 in chips) 
Seat 4: rey2040 ($12.30 in chips) 
Seat 5: GovGus ($33.31 in chips) 
Seat 6: chiyuki ($24.70 in chips) 
Seat 7: GravyWalrus ($11.46 in chips) 
Seat 8: Rilko1975 ($32.53 in chips) 
Seat 9: Dan Royal ($40.69 in chips) 
phate-1up: posts small blind $0.10
Silveystryk: posts big blind $0.25
*** HOLE CARDS ***
Dealt to chiyuki [5h As]
rey2040: folds 
GovGus: folds 
chiyuki: folds 
GravyWalrus: folds 
Rilko1975: folds 
Dan Royal: folds 
KeLevro0: folds 
phate-1up: raises $0.50 to $0.75
Silveystryk: folds 
Uncalled bet ($0.50) returned to phate-1up
phate-1up collected $0.50 from pot
phate-1up: doesn't show hand 
*** SUMMARY ***
Total pot $0.50 | Rake $0 
Seat 1: KeLevro0 (button) folded before Flop (didn't bet)
Seat 2: phate-1up (small blind) collected ($0.50)
Seat 3: Silveystryk (big blind) folded before Flop
Seat 4: rey2040 folded before Flop (didn't bet)
Seat 5: GovGus folded before Flop (didn't bet)
Seat 6: chiyuki folded before Flop (didn't bet)
Seat 7: GravyWalrus folded before Flop (didn't bet)
Seat 8: Rilko1975 folded before Flop (didn't bet)
Seat 9: Dan Royal folded before Flop (didn't bet)



PokerStars Zoom Hand #84300245569:  Hold'em No Limit ($0.10/$0.25) - 2012/08/05 15:15:19 JST [2012/08/05 2:15:19 ET]
Table 'Whirlpool' 9-max Seat #1 is the button
Seat 1: hirozo ($32.85 in chips) 
Seat 2: dushvan ($32.94 in chips) 
Seat 3: kwkim73 ($28.08 in chips) 
Seat 4: snejokCoxx ($11.15 in chips) 
Seat 5: chiyuki ($24.70 in chips) 
Seat 6: KrystalAA ($33.68 in chips) 
Seat 7: Dejacob ($25 in chips) 
Seat 8: DutchShultzs ($33.42 in chips) 
Seat 9: womble32 ($27.03 in chips) 
dushvan: posts small blind $0.10
kwkim73: posts big blind $0.25
*** HOLE CARDS ***
Dealt to chiyuki [Kh 3s]
snejokCoxx: folds 
chiyuki: folds 
KrystalAA: raises $0.46 to $0.71
Dejacob: folds 
DutchShultzs: folds 
womble32: folds 
hirozo: folds 
dushvan: folds 
kwkim73: folds 
Uncalled bet ($0.46) returned to KrystalAA
KrystalAA collected $0.60 from pot
KrystalAA: doesn't show hand 
*** SUMMARY ***
Total pot $0.60 | Rake $0 
Seat 1: hirozo (button) folded before Flop (didn't bet)
Seat 2: dushvan (small blind) folded before Flop
Seat 3: kwkim73 (big blind) folded before Flop
Seat 4: snejokCoxx folded before Flop (didn't bet)
Seat 5: chiyuki folded before Flop (didn't bet)
Seat 6: KrystalAA collected ($0.60)
Seat 7: Dejacob folded before Flop (didn't bet)
Seat 8: DutchShultzs folded before Flop (didn't bet)
Seat 9: womble32 folded before Flop (didn't bet)



PokerStars Zoom Hand #84300244516:  Hold'em No Limit ($0.10/$0.25) - 2012/08/05 15:15:15 JST [2012/08/05 2:15:15 ET]
Table 'Whirlpool' 9-max Seat #1 is the button
Seat 1: Rilko1975 ($32.53 in chips) 
Seat 2: masterkoolb ($12.50 in chips) 
Seat 3: GovGus ($28.72 in chips) 
Seat 4: kwkim73 ($28.08 in chips) 
Seat 5: GravyWalrus ($11.36 in chips) 
Seat 6: troublesomm ($25 in chips) 
Seat 7: chiyuki ($24.70 in chips) 
Seat 8: pandaaaaaa ($10.02 in chips) 
Seat 9: ygoegoe ($32.88 in chips) 
masterkoolb: posts small blind $0.10
GovGus: posts big blind $0.25
*** HOLE CARDS ***
Dealt to chiyuki [7d Th]
kwkim73: folds 
GravyWalrus: folds 
troublesomm: folds 
chiyuki: folds 
pandaaaaaa: folds 
ygoegoe: folds 
Rilko1975: raises $0.50 to $0.75
masterkoolb: raises $1.75 to $2.50
GovGus: raises $4.25 to $6.75
Rilko1975: folds 
masterkoolb: calls $4.25
*** FLOP *** [9h Kh 2c]
masterkoolb: checks 
GovGus: bets $8.84
masterkoolb: folds 
Uncalled bet ($8.84) returned to GovGus
GovGus collected $13.61 from pot
GovGus: doesn't show hand 
*** SUMMARY ***
Total pot $14.25 | Rake $0.64 
Board [9h Kh 2c]
Seat 1: Rilko1975 (button) folded before Flop
Seat 2: masterkoolb (small blind) folded on the Flop
Seat 3: GovGus (big blind) collected ($13.61)
Seat 4: kwkim73 folded before Flop (didn't bet)
Seat 5: GravyWalrus folded before Flop (didn't bet)
Seat 6: troublesomm folded before Flop (didn't bet)
Seat 7: chiyuki folded before Flop (didn't bet)
Seat 8: pandaaaaaa folded before Flop (didn't bet)
Seat 9: ygoegoe folded before Flop (didn't bet)



PokerStars Zoom Hand #84300241998:  Hold'em No Limit ($0.10/$0.25) - 2012/08/05 15:15:05 JST [2012/08/05 2:15:05 ET]
Table 'Whirlpool' 9-max Seat #1 is the button
Seat 1: deadmoneykid ($31.86 in chips) 
Seat 2: jacquelinewu ($38.10 in chips) 
Seat 3: 1Karina1 ($27.08 in chips) 
Seat 4: GravyWalrus ($11.46 in chips) 
Seat 5: KeLevro0 ($9.58 in chips) 
Seat 6: Jene4kaBest ($12.15 in chips) 
Seat 7: Dan Royal ($40.69 in chips) 
Seat 8: chiyuki ($24.70 in chips) 
Seat 9: kwkim73 ($28.08 in chips) 
jacquelinewu: posts small blind $0.10
1Karina1: posts big blind $0.25
*** HOLE CARDS ***
Dealt to chiyuki [8h 2c]
GravyWalrus: folds 
KeLevro0: folds 
Jene4kaBest: folds 
Dan Royal: folds 
chiyuki: folds 
kwkim73: folds 
deadmoneykid: raises $0.35 to $0.60
jacquelinewu: raises $1.40 to $2
1Karina1: folds 
deadmoneykid: raises $3.50 to $5.50
jacquelinewu: folds 
Uncalled bet ($3.50) returned to deadmoneykid
deadmoneykid collected $4.25 from pot
deadmoneykid: doesn't show hand 
*** SUMMARY ***
Total pot $4.25 | Rake $0 
Seat 1: deadmoneykid (button) collected ($4.25)
Seat 2: jacquelinewu (small blind) folded before Flop
Seat 3: 1Karina1 (big blind) folded before Flop
Seat 4: GravyWalrus folded before Flop (didn't bet)
Seat 5: KeLevro0 folded before Flop (didn't bet)
Seat 6: Jene4kaBest folded before Flop (didn't bet)
Seat 7: Dan Royal folded before Flop (didn't bet)
Seat 8: chiyuki folded before Flop (didn't bet)
Seat 9: kwkim73 folded before Flop (didn't bet)



PokerStars Zoom Hand #84300246590:  Hold'em No Limit ($0.10/$0.25) - 2012/08/05 15:15:23 JST [2012/08/05 2:15:23 ET]
Table 'Whirlpool' 9-max Seat #1 is the button
Seat 1: chiyuki ($24.70 in chips) 
Seat 2: INSP!RON ($30.30 in chips) 
Seat 3: GravyWalrus ($11.36 in chips) 
Seat 4: KeLevro0 ($11.40 in chips) 
Seat 5: ygoegoe ($32.88 in chips) 
Seat 6: ZhukOFFskI ($29.39 in chips) 
Seat 7: WARIBANA7777 ($17.54 in chips) 
Seat 8: Dan Royal ($40.69 in chips) 
Seat 9: 1Karina1 ($26.83 in chips) 
INSP!RON: posts small blind $0.10
GravyWalrus: posts big blind $0.25
*** HOLE CARDS ***
Dealt to chiyuki [3c Tc]
KeLevro0: raises $0.42 to $0.67
ygoegoe: folds 
ZhukOFFskI: folds 
WARIBANA7777: folds 
Dan Royal: folds 
1Karina1: calls $0.67
chiyuki: folds 
INSP!RON: folds 
GravyWalrus: folds 
*** FLOP *** [9h 6c 3s]
KeLevro0: bets $0.90
1Karina1: calls $0.90
*** TURN *** [9h 6c 3s] [3d]
KeLevro0: checks 
1Karina1: bets $2.25
KeLevro0: folds 
Uncalled bet ($2.25) returned to 1Karina1
1Karina1 collected $3.33 from pot
1Karina1: doesn't show hand 
*** SUMMARY ***
Total pot $3.49 | Rake $0.16 
Board [9h 6c 3s 3d]
Seat 1: chiyuki (button) folded before Flop (didn't bet)
Seat 2: INSP!RON (small blind) folded before Flop
Seat 3: GravyWalrus (big blind) folded before Flop
Seat 4: KeLevro0 folded on the Turn
Seat 5: ygoegoe folded before Flop (didn't bet)
Seat 6: ZhukOFFskI folded before Flop (didn't bet)
Seat 7: WARIBANA7777 folded before Flop (didn't bet)
Seat 8: Dan Royal folded before Flop (didn't bet)
Seat 9: 1Karina1 collected ($3.33)



PokerStars Zoom Hand #84300248634:  Hold'em No Limit ($0.10/$0.25) - 2012/08/05 15:15:31 JST [2012/08/05 2:15:31 ET]
Table 'Whirlpool' 9-max Seat #1 is the button
Seat 1: Alvinpe85 ($44.40 in chips) 
Seat 2: Saruotiss ($47.36 in chips) 
Seat 3: moku36 ($19.61 in chips) 
Seat 4: troublesomm ($25 in chips) 
Seat 5: snejokCoxx ($14.57 in chips) 
Seat 6: Roglus ($6.70 in chips) 
Seat 7: jacquelinewu ($72.34 in chips) 
Seat 8: GravyWalrus ($11.11 in chips) 
Seat 9: chiyuki ($24.70 in chips) 
Saruotiss: posts small blind $0.10
moku36: posts big blind $0.25
*** HOLE CARDS ***
Dealt to chiyuki [Qd Ad]
troublesomm: folds 
snejokCoxx: raises $0.40 to $0.65
Roglus: calls $0.65
jacquelinewu: folds 
GravyWalrus: folds 
chiyuki: raises $1.90 to $2.55
Alvinpe85: folds 
Saruotiss: folds 
moku36: folds 
snejokCoxx: folds 
Roglus: calls $1.90
*** FLOP *** [4h 9c 3s]
Roglus: checks 
chiyuki: bets $3
Roglus: folds 
Uncalled bet ($3) returned to chiyuki
chiyuki collected $5.83 from pot
chiyuki: doesn't show hand 
*** SUMMARY ***
Total pot $6.10 | Rake $0.27 
Board [4h 9c 3s]
Seat 1: Alvinpe85 (button) folded before Flop (didn't bet)
Seat 2: Saruotiss (small blind) folded before Flop
Seat 3: moku36 (big blind) folded before Flop
Seat 4: troublesomm folded before Flop (didn't bet)
Seat 5: snejokCoxx folded before Flop
Seat 6: Roglus folded on the Flop
Seat 7: jacquelinewu folded before Flop (didn't bet)
Seat 8: GravyWalrus folded before Flop (didn't bet)
Seat 9: chiyuki collected ($5.83)



PokerStars Zoom Hand #84300260513:  Hold'em No Limit ($0.10/$0.25) - 2012/08/05 15:16:19 JST [2012/08/05 2:16:19 ET]
Table 'Whirlpool' 9-max Seat #1 is the button
Seat 1: GovGus ($33.31 in chips) 
Seat 2: therati ($22.13 in chips) 
Seat 3: kamikkaze ($13.07 in chips) 
Seat 4: snejokCoxx ($13.92 in chips) 
Seat 5: phate-1up ($52.71 in chips) 
Seat 6: rey2040 ($11.55 in chips) 
Seat 7: kwkim73 ($28.83 in chips) 
Seat 8: chiyuki ($27.98 in chips) 
Seat 9: DutchShultzs ($33.07 in chips) 
therati: posts small blind $0.10
kamikkaze: posts big blind $0.25
*** HOLE CARDS ***
Dealt to chiyuki [2s Qd]
snejokCoxx: folds 
phate-1up: folds 
rey2040: folds 
kwkim73: folds 
chiyuki: folds 
DutchShultzs: folds 
GovGus: raises $0.50 to $0.75
therati: folds 
kamikkaze: folds 
Uncalled bet ($0.50) returned to GovGus
GovGus collected $0.60 from pot
GovGus: doesn't show hand 
*** SUMMARY ***
Total pot $0.60 | Rake $0 
Seat 1: GovGus (button) collected ($0.60)
Seat 2: therati (small blind) folded before Flop
Seat 3: kamikkaze (big blind) folded before Flop
Seat 4: snejokCoxx folded before Flop (didn't bet)
Seat 5: phate-1up folded before Flop (didn't bet)
Seat 6: rey2040 folded before Flop (didn't bet)
Seat 7: kwkim73 folded before Flop (didn't bet)
Seat 8: chiyuki folded before Flop (didn't bet)
Seat 9: DutchShultzs folded before Flop (didn't bet)



PokerStars Zoom Hand #84300263865:  Hold'em No Limit ($0.10/$0.25) - 2012/08/05 15:16:32 JST [2012/08/05 2:16:32 ET]
Table 'Whirlpool' 9-max Seat #1 is the button
Seat 1: phate-1up ($29.32 in chips) 
Seat 2: pandaaaaaa ($9.77 in chips) 
Seat 3: Rilko1975 ($34.62 in chips) 
Seat 4: DutchShultzs ($25 in chips) 
Seat 5: deadmoneykid ($34.11 in chips) 
Seat 6: River_GmbH ($16.40 in chips) 
Seat 7: chiyuki ($27.73 in chips) 
Seat 8: Faantomace ($25.61 in chips) 
Seat 9: svg51 ($11.22 in chips) 
pandaaaaaa: posts small blind $0.10
Rilko1975: posts big blind $0.25
*** HOLE CARDS ***
Dealt to chiyuki [Qc Ad]
DutchShultzs: folds 
deadmoneykid: folds 
River_GmbH: folds 
chiyuki: raises $0.50 to $0.75
Faantomace: folds 
svg51: folds 
phate-1up: folds 
pandaaaaaa: folds 
Rilko1975: folds 
Uncalled bet ($0.50) returned to chiyuki
chiyuki collected $0.60 from pot
chiyuki: doesn't show hand 
*** SUMMARY ***
Total pot $0.60 | Rake $0 
Seat 1: phate-1up (button) folded before Flop (didn't bet)
Seat 2: pandaaaaaa (small blind) folded before Flop
Seat 3: Rilko1975 (big blind) folded before Flop
Seat 4: DutchShultzs folded before Flop (didn't bet)
Seat 5: deadmoneykid folded before Flop (didn't bet)
Seat 6: River_GmbH folded before Flop (didn't bet)
Seat 7: chiyuki collected ($0.60)
Seat 8: Faantomace folded before Flop (didn't bet)
Seat 9: svg51 folded before Flop (didn't bet)



PokerStars Zoom Hand #84300261288:  Hold'em No Limit ($0.10/$0.25) - 2012/08/05 15:16:22 JST [2012/08/05 2:16:22 ET]
Table 'Whirlpool' 9-max Seat #1 is the button
Seat 1: hirozo ($80.41 in chips) 
Seat 2: Dejacob ($25.35 in chips) 
Seat 3: chiyuki ($27.98 in chips) 
Seat 4: silvno31 ($26.84 in chips) 
Seat 5: laurentzu84 ($29.83 in chips) 
Seat 6: troublesomm ($35 in chips) 
Seat 7: DutchShultzs ($33.07 in chips) 
Seat 8: masterkoolb ($12.96 in chips) 
Seat 9: Silveystryk ($21.34 in chips) 
Dejacob: posts small blind $0.10
chiyuki: posts big blind $0.25
*** HOLE CARDS ***
Dealt to chiyuki [Qc 6s]
silvno31: raises $0.75 to $1
laurentzu84: calls $1
troublesomm: folds 
DutchShultzs: folds 
masterkoolb: folds 
Silveystryk: folds 
hirozo: folds 
Dejacob: folds 
chiyuki: folds 
*** FLOP *** [Qd 5c 6h]
silvno31: bets $1
laurentzu84: raises $1.75 to $2.75
silvno31: folds 
Uncalled bet ($1.75) returned to laurentzu84
laurentzu84 collected $4.15 from pot
laurentzu84: doesn't show hand 
*** SUMMARY ***
Total pot $4.35 | Rake $0.20 
Board [Qd 5c 6h]
Seat 1: hirozo (button) folded before Flop (didn't bet)
Seat 2: Dejacob (small blind) folded before Flop
Seat 3: chiyuki (big blind) folded before Flop
Seat 4: silvno31 folded on the Flop
Seat 5: laurentzu84 collected ($4.15)
Seat 6: troublesomm folded before Flop (didn't bet)
Seat 7: DutchShultzs folded before Flop (didn't bet)
Seat 8: masterkoolb folded before Flop (didn't bet)
Seat 9: Silveystryk folded before Flop (didn't bet)



PokerStars Zoom Hand #84300277974:  Hold'em No Limit ($0.10/$0.25) - 2012/08/05 15:17:28 JST [2012/08/05 2:17:28 ET]
Table 'Whirlpool' 9-max Seat #1 is the button
Seat 1: Yoshimac ($30.55 in chips) 
Seat 2: INSP!RON ($30.30 in chips) 
Seat 3: KeLevro0 ($12.50 in chips) 
Seat 4: chiyuki ($27.98 in chips) 
Seat 5: Perstenev ($12.39 in chips) 
Seat 6: Alvinpe85 ($49.85 in chips) 
Seat 7: pandaaaaaa ($9.67 in chips) 
Seat 8: AAAKK777 ($28.09 in chips) 
Seat 9: Saruotiss ($46.26 in chips) 
INSP!RON: posts small blind $0.10
KeLevro0: posts big blind $0.25
*** HOLE CARDS ***
Dealt to chiyuki [8c Kh]
chiyuki: folds 
Perstenev: folds 
Alvinpe85: folds 
pandaaaaaa: folds 
AAAKK777: raises $0.25 to $0.50
Saruotiss: folds 
Yoshimac: folds 
INSP!RON: folds 
KeLevro0: folds 
Uncalled bet ($0.25) returned to AAAKK777
AAAKK777 collected $0.60 from pot
AAAKK777: doesn't show hand 
*** SUMMARY ***
Total pot $0.60 | Rake $0 
Seat 1: Yoshimac (button) folded before Flop (didn't bet)
Seat 2: INSP!RON (small blind) folded before Flop
Seat 3: KeLevro0 (big blind) folded before Flop
Seat 4: chiyuki folded before Flop (didn't bet)
Seat 5: Perstenev folded before Flop (didn't bet)
Seat 6: Alvinpe85 folded before Flop (didn't bet)
Seat 7: pandaaaaaa folded before Flop (didn't bet)
Seat 8: AAAKK777 collected ($0.60)
Seat 9: Saruotiss folded before Flop (didn't bet)



PokerStars Zoom Hand #84300278967:  Hold'em No Limit ($0.10/$0.25) - 2012/08/05 15:17:32 JST [2012/08/05 2:17:32 ET]
Table 'Whirlpool' 9-max Seat #1 is the button
Seat 1: slapshot2011 ($25.44 in chips) 
Seat 2: Yoshimac ($30.55 in chips) 
Seat 3: GovGus ($36.18 in chips) 
Seat 4: chiyuki ($27.98 in chips) 
Seat 5: ygoegoe ($30.07 in chips) 
Seat 6: snejokCoxx ($12.40 in chips) 
Seat 7: therati ($21.28 in chips) 
Seat 8: wildy29 ($33.64 in chips) 
Seat 9: DutchShultzs ($31.58 in chips) 
Yoshimac: posts small blind $0.10
GovGus: posts big blind $0.25
*** HOLE CARDS ***
Dealt to chiyuki [Kc Ts]
chiyuki: folds 
ygoegoe: folds 
snejokCoxx: folds 
therati: folds 
wildy29: folds 
DutchShultzs: raises $0.50 to $0.75
slapshot2011: folds 
Yoshimac: folds 
GovGus: folds 
Uncalled bet ($0.50) returned to DutchShultzs
DutchShultzs collected $0.60 from pot
DutchShultzs: doesn't show hand 
*** SUMMARY ***
Total pot $0.60 | Rake $0 
Seat 1: slapshot2011 (button) folded before Flop (didn't bet)
Seat 2: Yoshimac (small blind) folded before Flop
Seat 3: GovGus (big blind) folded before Flop
Seat 4: chiyuki folded before Flop (didn't bet)
Seat 5: ygoegoe folded before Flop (didn't bet)
Seat 6: snejokCoxx folded before Flop (didn't bet)
Seat 7: therati folded before Flop (didn't bet)
Seat 8: wildy29 folded before Flop (didn't bet)
Seat 9: DutchShultzs collected ($0.60)



PokerStars Zoom Hand #84300270490:  Hold'em No Limit ($0.10/$0.25) - 2012/08/05 15:16:58 JST [2012/08/05 2:16:58 ET]
Table 'Whirlpool' 9-max Seat #1 is the button
Seat 1: phate-1up ($53.73 in chips) 
Seat 2: Alvinpe85 ($49.85 in chips) 
Seat 3: Jene4kaBest ($12.15 in chips) 
Seat 4: jacquelinewu ($73.11 in chips) 
Seat 5: chiyuki ($28.08 in chips) 
Seat 6: Ellen1947 ($24.90 in chips) 
Seat 7: seula i ($95.75 in chips) 
Seat 8: ygoegoe ($30.32 in chips) 
Seat 9: deadmoneykid ($24.21 in chips) 
Alvinpe85: posts small blind $0.10
Jene4kaBest: posts big blind $0.25
*** HOLE CARDS ***
Dealt to chiyuki [8s Qc]
jacquelinewu: folds 
chiyuki: folds 
Ellen1947: folds 
seula i: folds 
ygoegoe: folds 
deadmoneykid: raises $0.35 to $0.60
phate-1up: calls $0.60
Alvinpe85: folds 
Jene4kaBest: folds 
*** FLOP *** [Th 8h Qs]
deadmoneykid: bets $0.74
phate-1up: calls $0.74
*** TURN *** [Th 8h Qs] [Kh]
deadmoneykid: checks 
phate-1up: bets $1.50
deadmoneykid: calls $1.50
*** RIVER *** [Th 8h Qs Kh] [Qh]
deadmoneykid: checks 
phate-1up: checks 
*** SHOW DOWN ***
deadmoneykid: shows [Kc Jh] (a flush, King high)
phate-1up: mucks hand 
deadmoneykid collected $5.76 from pot
*** SUMMARY ***
Total pot $6.03 | Rake $0.27 
Board [Th 8h Qs Kh Qh]
Seat 1: phate-1up (button) mucked [Jc Ks]
Seat 2: Alvinpe85 (small blind) folded before Flop
Seat 3: Jene4kaBest (big blind) folded before Flop
Seat 4: jacquelinewu folded before Flop (didn't bet)
Seat 5: chiyuki folded before Flop (didn't bet)
Seat 6: Ellen1947 folded before Flop (didn't bet)
Seat 7: seula i folded before Flop (didn't bet)
Seat 8: ygoegoe folded before Flop (didn't bet)
Seat 9: deadmoneykid showed [Kc Jh] and won ($5.76) with a flush, King high



PokerStars Zoom Hand #84300274571:  Hold'em No Limit ($0.10/$0.25) - 2012/08/05 15:17:14 JST [2012/08/05 2:17:14 ET]
Table 'Whirlpool' 9-max Seat #1 is the button
Seat 1: Dejacob ($25.45 in chips) 
Seat 2: chiyuki ($28.08 in chips) 
Seat 3: 4plankton ($17.60 in chips) 
Seat 4: troublesomm ($35.35 in chips) 
Seat 5: Nerkit ($10.93 in chips) 
Seat 6: 1Karina1 ($37.35 in chips) 
Seat 7: Ellen1947 ($24.90 in chips) 
Seat 8: panaam ($22.42 in chips) 
Seat 9: Silveystryk ($26.63 in chips) 
chiyuki: posts small blind $0.10
4plankton: posts big blind $0.25
*** HOLE CARDS ***
Dealt to chiyuki [Js 4c]
troublesomm: folds 
Nerkit: folds 
1Karina1: raises $0.50 to $0.75
Ellen1947: calls $0.75
panaam: folds 
Silveystryk: folds 
Dejacob: folds 
chiyuki: folds 
4plankton: calls $0.50
*** FLOP *** [Qs Th Ts]
4plankton: checks 
1Karina1: checks 
Ellen1947: checks 
*** TURN *** [Qs Th Ts] [Qd]
4plankton: checks 
1Karina1: checks 
Ellen1947: checks 
*** RIVER *** [Qs Th Ts Qd] [6c]
4plankton: checks 
1Karina1: bets $1.68
Ellen1947: folds 
4plankton: folds 
Uncalled bet ($1.68) returned to 1Karina1
1Karina1 collected $2.24 from pot
1Karina1: doesn't show hand 
*** SUMMARY ***
Total pot $2.35 | Rake $0.11 
Board [Qs Th Ts Qd 6c]
Seat 1: Dejacob (button) folded before Flop (didn't bet)
Seat 2: chiyuki (small blind) folded before Flop
Seat 3: 4plankton (big blind) folded on the River
Seat 4: troublesomm folded before Flop (didn't bet)
Seat 5: Nerkit folded before Flop (didn't bet)
Seat 6: 1Karina1 collected ($2.24)
Seat 7: Ellen1947 folded on the River
Seat 8: panaam folded before Flop (didn't bet)
Seat 9: Silveystryk folded before Flop (didn't bet)



PokerStars Zoom Hand #84300282457:  Hold'em No Limit ($0.10/$0.25) - 2012/08/05 15:17:46 JST [2012/08/05 2:17:46 ET]
Table 'Whirlpool' 9-max Seat #1 is the button
Seat 1: Rici47 ($24.50 in chips) 
Seat 2: masterkoolb ($12.50 in chips) 
Seat 3: Silveystryk ($26.63 in chips) 
Seat 4: seula i ($27.41 in chips) 
Seat 5: chiyuki ($27.98 in chips) 
Seat 6: Alvinpe85 ($48.72 in chips) 
Seat 7: GovGus ($25.45 in chips) 
Seat 8: KeLevro0 ($12.15 in chips) 
Seat 9: WARIBANA7777 ($17.19 in chips) 
masterkoolb: posts small blind $0.10
Silveystryk: posts big blind $0.25
*** HOLE CARDS ***
Dealt to chiyuki [5c 6s]
seula i: folds 
chiyuki: folds 
Alvinpe85: folds 
GovGus: raises $0.75 to $1
KeLevro0: calls $1
WARIBANA7777: folds 
Rici47: folds 
masterkoolb: folds 
Silveystryk: folds 
*** FLOP *** [9h 4h Kh]
GovGus: bets $1.45
KeLevro0: folds 
Uncalled bet ($1.45) returned to GovGus
GovGus collected $2.24 from pot
GovGus: doesn't show hand 
*** SUMMARY ***
Total pot $2.35 | Rake $0.11 
Board [9h 4h Kh]
Seat 1: Rici47 (button) folded before Flop (didn't bet)
Seat 2: masterkoolb (small blind) folded before Flop
Seat 3: Silveystryk (big blind) folded before Flop
Seat 4: seula i folded before Flop (didn't bet)
Seat 5: chiyuki folded before Flop (didn't bet)
Seat 6: Alvinpe85 folded before Flop (didn't bet)
Seat 7: GovGus collected ($2.24)
Seat 8: KeLevro0 folded on the Flop
Seat 9: WARIBANA7777 folded before Flop (didn't bet)



PokerStars Zoom Hand #84300285962:  Hold'em No Limit ($0.10/$0.25) - 2012/08/05 15:18:00 JST [2012/08/05 2:18:00 ET]
Table 'Whirlpool' 9-max Seat #1 is the button
Seat 1: PetitAlejo ($26.65 in chips) 
Seat 2: ygoegoe ($30.07 in chips) 
Seat 3: ChrisCDee ($72.77 in chips) 
Seat 4: Saruotiss ($46.16 in chips) 
Seat 5: ZhukOFFskI ($34.64 in chips) 
Seat 6: Rilko1975 ($34.60 in chips) 
Seat 7: DanielWhyte ($64.56 in chips) 
Seat 8: DutchShultzs ($31.93 in chips) 
Seat 9: chiyuki ($27.98 in chips) 
ygoegoe: posts small blind $0.10
ChrisCDee: posts big blind $0.25
*** HOLE CARDS ***
Dealt to chiyuki [Qs 9d]
Saruotiss: folds 
ZhukOFFskI: folds 
Rilko1975: raises $0.25 to $0.50
DanielWhyte: folds 
DutchShultzs: folds 
chiyuki: folds 
PetitAlejo: folds 
ygoegoe: folds 
ChrisCDee: folds 
Uncalled bet ($0.25) returned to Rilko1975
Rilko1975 collected $0.60 from pot
Rilko1975: doesn't show hand 
*** SUMMARY ***
Total pot $0.60 | Rake $0 
Seat 1: PetitAlejo (button) folded before Flop (didn't bet)
Seat 2: ygoegoe (small blind) folded before Flop
Seat 3: ChrisCDee (big blind) folded before Flop
Seat 4: Saruotiss folded before Flop (didn't bet)
Seat 5: ZhukOFFskI folded before Flop (didn't bet)
Seat 6: Rilko1975 collected ($0.60)
Seat 7: DanielWhyte folded before Flop (didn't bet)
Seat 8: DutchShultzs folded before Flop (didn't bet)
Seat 9: chiyuki folded before Flop (didn't bet)



PokerStars Zoom Hand #84300279718:  Hold'em No Limit ($0.10/$0.25) - 2012/08/05 15:17:35 JST [2012/08/05 2:17:35 ET]
Table 'Whirlpool' 9-max Seat #1 is the button
Seat 1: chiyuki ($27.98 in chips) 
Seat 2: PetitAlejo ($25.10 in chips) 
Seat 3: Rici47 ($25 in chips) 
Seat 4: KrystalAA ($33.68 in chips) 
Seat 5: tribunpdm ($34.99 in chips) 
Seat 6: KeLevro0 ($9.48 in chips) 
Seat 7: Tom1999 ($11.62 in chips) 
Seat 8: JhonnyP1979 ($8.89 in chips) 
Seat 9: phate-1up ($50.37 in chips) 
PetitAlejo: posts small blind $0.10
Rici47: posts big blind $0.25
*** HOLE CARDS ***
Dealt to chiyuki [Th Kc]
KrystalAA: folds 
tribunpdm: raises $0.50 to $0.75
KeLevro0: folds 
Tom1999: folds 
JhonnyP1979: calls $0.75
phate-1up: folds 
chiyuki: folds 
PetitAlejo: folds 
Rici47: calls $0.50
*** FLOP *** [Ah 4h 3h]
Rici47: checks 
tribunpdm: checks 
JhonnyP1979: checks 
*** TURN *** [Ah 4h 3h] [7s]
Rici47: bets $1.25
tribunpdm: calls $1.25
JhonnyP1979: calls $1.25
*** RIVER *** [Ah 4h 3h 7s] [9h]
Rici47: checks 
tribunpdm: checks 
JhonnyP1979: bets $2.91
Rici47: folds 
tribunpdm: folds 
Uncalled bet ($2.91) returned to JhonnyP1979
JhonnyP1979 collected $5.83 from pot
JhonnyP1979: doesn't show hand 
*** SUMMARY ***
Total pot $6.10 | Rake $0.27 
Board [Ah 4h 3h 7s 9h]
Seat 1: chiyuki (button) folded before Flop (didn't bet)
Seat 2: PetitAlejo (small blind) folded before Flop
Seat 3: Rici47 (big blind) folded on the River
Seat 4: KrystalAA folded before Flop (didn't bet)
Seat 5: tribunpdm folded on the River
Seat 6: KeLevro0 folded before Flop (didn't bet)
Seat 7: Tom1999 folded before Flop (didn't bet)
Seat 8: JhonnyP1979 collected ($5.83)
Seat 9: phate-1up folded before Flop (didn't bet)



PokerStars Zoom Hand #84300284695:  Hold'em No Limit ($0.10/$0.25) - 2012/08/05 15:17:55 JST [2012/08/05 2:17:55 ET]
Table 'Whirlpool' 9-max Seat #1 is the button
Seat 1: Rilko1975 ($34.60 in chips) 
Seat 2: PetitAlejo ($26.75 in chips) 
Seat 3: AAAKK777 ($28.44 in chips) 
Seat 4: hirozo ($83.49 in chips) 
Seat 5: seula i ($27.41 in chips) 
Seat 6: chiyuki ($27.98 in chips) 
Seat 7: DutchShultzs ($31.93 in chips) 
Seat 8: deadmoneykid ($34.21 in chips) 
Seat 9: nastya040 ($17.94 in chips) 
PetitAlejo: posts small blind $0.10
AAAKK777: posts big blind $0.25
*** HOLE CARDS ***
Dealt to chiyuki [Td Ks]
hirozo: folds 
seula i: folds 
chiyuki: folds 
DutchShultzs: folds 
deadmoneykid: raises $0.35 to $0.60
nastya040: folds 
Rilko1975: folds 
PetitAlejo: folds 
AAAKK777: calls $0.35
*** FLOP *** [Kd 9d 7h]
AAAKK777: checks 
deadmoneykid: bets $0.93
AAAKK777: calls $0.93
*** TURN *** [Kd 9d 7h] [6h]
AAAKK777: checks 
deadmoneykid: checks 
*** RIVER *** [Kd 9d 7h 6h] [4c]
AAAKK777: bets $2.50
deadmoneykid: folds 
Uncalled bet ($2.50) returned to AAAKK777
AAAKK777 collected $3.02 from pot
AAAKK777: doesn't show hand 
*** SUMMARY ***
Total pot $3.16 | Rake $0.14 
Board [Kd 9d 7h 6h 4c]
Seat 1: Rilko1975 (button) folded before Flop (didn't bet)
Seat 2: PetitAlejo (small blind) folded before Flop
Seat 3: AAAKK777 (big blind) collected ($3.02)
Seat 4: hirozo folded before Flop (didn't bet)
Seat 5: seula i folded before Flop (didn't bet)
Seat 6: chiyuki folded before Flop (didn't bet)
Seat 7: DutchShultzs folded before Flop (didn't bet)
Seat 8: deadmoneykid folded on the River
Seat 9: nastya040 folded before Flop (didn't bet)



PokerStars Zoom Hand #84300286993:  Hold'em No Limit ($0.10/$0.25) - 2012/08/05 15:18:04 JST [2012/08/05 2:18:04 ET]
Table 'Whirlpool' 9-max Seat #1 is the button
Seat 1: Gichboy ($9.50 in chips) 
Seat 2: DutchShultzs ($31.93 in chips) 
Seat 3: chiyuki ($27.98 in chips) 
Seat 4: Dejacob ($42.09 in chips) 
Seat 5: hirozo ($76.77 in chips) 
Seat 6: DanielWhyte ($64.56 in chips) 
Seat 7: Perstenev ($12.39 in chips) 
Seat 8: KeLevro0 ($7.23 in chips) 
Seat 9: PetitAlejo ($26.65 in chips) 
DutchShultzs: posts small blind $0.10
chiyuki: posts big blind $0.25
*** HOLE CARDS ***
Dealt to chiyuki [3s Ad]
Dejacob: folds 
hirozo: folds 
DanielWhyte: folds 
Perstenev: folds 
KeLevro0: raises $0.42 to $0.67
PetitAlejo: folds 
Gichboy: calls $0.67
DutchShultzs: folds 
chiyuki: folds 
*** FLOP *** [9s 5s 5d]
KeLevro0: bets $1.23
Gichboy: calls $1.23
*** TURN *** [9s 5s 5d] [Ks]
KeLevro0: checks 
Gichboy: checks 
*** RIVER *** [9s 5s 5d Ks] [Qh]
KeLevro0: checks 
Gichboy: checks 
*** SHOW DOWN ***
KeLevro0: shows [Th Tc] (two pair, Tens and Fives)
Gichboy: mucks hand 
KeLevro0 collected $3.96 from pot
*** SUMMARY ***
Total pot $4.15 | Rake $0.19 
Board [9s 5s 5d Ks Qh]
Seat 1: Gichboy (button) mucked [9c 7s]
Seat 2: DutchShultzs (small blind) folded before Flop
Seat 3: chiyuki (big blind) folded before Flop
Seat 4: Dejacob folded before Flop (didn't bet)
Seat 5: hirozo folded before Flop (didn't bet)
Seat 6: DanielWhyte folded before Flop (didn't bet)
Seat 7: Perstenev folded before Flop (didn't bet)
Seat 8: KeLevro0 showed [Th Tc] and won ($3.96) with two pair, Tens and Fives
Seat 9: PetitAlejo folded before Flop (didn't bet)



PokerStars Zoom Hand #84300291266:  Hold'em No Limit ($0.10/$0.25) - 2012/08/05 15:18:21 JST [2012/08/05 2:18:21 ET]
Table 'Whirlpool' 9-max Seat #1 is the button
Seat 1: KrystalAA ($25.64 in chips) 
Seat 2: Rici47 ($23 in chips) 
Seat 3: phate-1up ($53.32 in chips) 
Seat 4: Nerkit ($10.93 in chips) 
Seat 5: ChrisCDee ($43.76 in chips) 
Seat 6: kwkim73 ($26.93 in chips) 
Seat 7: rey2040 ($8.65 in chips) 
Seat 8: chiyuki ($27.73 in chips) 
Seat 9: jacquelinewu ($36.45 in chips) 
Rici47: posts small blind $0.10
phate-1up: posts big blind $0.25
*** HOLE CARDS ***
Dealt to chiyuki [4d Jd]
Nerkit: folds 
ChrisCDee: raises $0.50 to $0.75
kwkim73: folds 
rey2040: folds 
chiyuki: folds 
jacquelinewu: folds 
KrystalAA: calls $0.75
Rici47: folds 
phate-1up: folds 
*** FLOP *** [3h Qs 2d]
ChrisCDee: bets $1.06
KrystalAA: folds 
Uncalled bet ($1.06) returned to ChrisCDee
ChrisCDee collected $1.77 from pot
ChrisCDee: doesn't show hand 
*** SUMMARY ***
Total pot $1.85 | Rake $0.08 
Board [3h Qs 2d]
Seat 1: KrystalAA (button) folded on the Flop
Seat 2: Rici47 (small blind) folded before Flop
Seat 3: phate-1up (big blind) folded before Flop
Seat 4: Nerkit folded before Flop (didn't bet)
Seat 5: ChrisCDee collected ($1.77)
Seat 6: kwkim73 folded before Flop (didn't bet)
Seat 7: rey2040 folded before Flop (didn't bet)
Seat 8: chiyuki folded before Flop (didn't bet)
Seat 9: jacquelinewu folded before Flop (didn't bet)



PokerStars Zoom Hand #84300292791:  Hold'em No Limit ($0.10/$0.25) - 2012/08/05 15:18:27 JST [2012/08/05 2:18:27 ET]
Table 'Whirlpool' 9-max Seat #1 is the button
Seat 1: kaplya2010 ($13.44 in chips) 
Seat 2: chiyuki ($27.73 in chips) 
Seat 3: WARIBANA7777 ($17.09 in chips) 
Seat 4: masterkoolb ($12.50 in chips) 
Seat 5: troublesomm ($35.35 in chips) 
Seat 6: svg51 ($12.57 in chips) 
Seat 7: Nerkit ($11.30 in chips) 
Seat 8: Rici47 ($24.40 in chips) 
Seat 9: Gichboy ($31.69 in chips) 
chiyuki: posts small blind $0.10
WARIBANA7777: posts big blind $0.25
*** HOLE CARDS ***
Dealt to chiyuki [7s 7c]
masterkoolb: folds 
troublesomm: folds 
svg51: folds 
Nerkit: folds 
Rici47: folds 
Gichboy: raises $0.50 to $0.75
kaplya2010: folds 
chiyuki: calls $0.65
WARIBANA7777: folds 
*** FLOP *** [5h 6c 2h]
chiyuki: checks 
Gichboy: checks 
*** TURN *** [5h 6c 2h] [Tc]
chiyuki: bets $0.83
Gichboy: raises $0.83 to $1.66
chiyuki: raises $1.59 to $3.25
Gichboy: folds 
Uncalled bet ($1.59) returned to chiyuki
chiyuki collected $4.84 from pot
chiyuki: doesn't show hand 
*** SUMMARY ***
Total pot $5.07 | Rake $0.23 
Board [5h 6c 2h Tc]
Seat 1: kaplya2010 (button) folded before Flop (didn't bet)
Seat 2: chiyuki (small blind) collected ($4.84)
Seat 3: WARIBANA7777 (big blind) folded before Flop
Seat 4: masterkoolb folded before Flop (didn't bet)
Seat 5: troublesomm folded before Flop (didn't bet)
Seat 6: svg51 folded before Flop (didn't bet)
Seat 7: Nerkit folded before Flop (didn't bet)
Seat 8: Rici47 folded before Flop (didn't bet)
Seat 9: Gichboy folded on the Turn



PokerStars Zoom Hand #84300310695:  Hold'em No Limit ($0.10/$0.25) - 2012/08/05 15:19:38 JST [2012/08/05 2:19:38 ET]
Table 'Whirlpool' 9-max Seat #1 is the button
Seat 1: womble32 ($27.87 in chips) 
Seat 2: pandaaaaaa ($8.92 in chips) 
Seat 3: mjmichi ($36.52 in chips) 
Seat 4: DanielWhyte ($64.06 in chips) 
Seat 5: 1Karina1 ($25 in chips) 
Seat 6: Dejacob ($36.88 in chips) 
Seat 7: chiyuki ($30.16 in chips) 
Seat 8: nice.franki ($12.60 in chips) 
Seat 9: troublesomm ($34.90 in chips) 
pandaaaaaa: posts small blind $0.10
mjmichi: posts big blind $0.25
*** HOLE CARDS ***
Dealt to chiyuki [4d Qs]
DanielWhyte: raises $0.50 to $0.75
1Karina1: folds 
Dejacob: folds 
chiyuki: folds 
nice.franki: folds 
troublesomm: folds 
womble32: folds 
pandaaaaaa: folds 
mjmichi: folds 
Uncalled bet ($0.50) returned to DanielWhyte
DanielWhyte collected $0.60 from pot
DanielWhyte: doesn't show hand 
*** SUMMARY ***
Total pot $0.60 | Rake $0 
Seat 1: womble32 (button) folded before Flop (didn't bet)
Seat 2: pandaaaaaa (small blind) folded before Flop
Seat 3: mjmichi (big blind) folded before Flop
Seat 4: DanielWhyte collected ($0.60)
Seat 5: 1Karina1 folded before Flop (didn't bet)
Seat 6: Dejacob folded before Flop (didn't bet)
Seat 7: chiyuki folded before Flop (didn't bet)
Seat 8: nice.franki folded before Flop (didn't bet)
Seat 9: troublesomm folded before Flop (didn't bet)



PokerStars Zoom Hand #84300311747:  Hold'em No Limit ($0.10/$0.25) - 2012/08/05 15:19:42 JST [2012/08/05 2:19:42 ET]
Table 'Whirlpool' 9-max Seat #1 is the button
Seat 1: xxx Spb xxx ($26.35 in chips) 
Seat 2: DutchShultzs ($32.47 in chips) 
Seat 3: masterkoolb ($17.64 in chips) 
Seat 4: Gichboy ($29.28 in chips) 
Seat 5: phate-1up ($54.46 in chips) 
Seat 6: KeLevro0 ($12.40 in chips) 
Seat 7: Perstenev ($13.75 in chips) 
Seat 8: Tom1999 ($5.92 in chips) 
Seat 9: chiyuki ($30.16 in chips) 
DutchShultzs: posts small blind $0.10
masterkoolb: posts big blind $0.25
*** HOLE CARDS ***
Dealt to chiyuki [9d 7h]
Gichboy: folds 
phate-1up: folds 
KeLevro0: folds 
Perstenev: calls $0.25
Tom1999: folds 
chiyuki: folds 
xxx Spb xxx: folds 
DutchShultzs: folds 
masterkoolb: raises $0.75 to $1
Perstenev: folds 
Uncalled bet ($0.75) returned to masterkoolb
masterkoolb collected $0.60 from pot
masterkoolb: doesn't show hand 
*** SUMMARY ***
Total pot $0.60 | Rake $0 
Seat 1: xxx Spb xxx (button) folded before Flop (didn't bet)
Seat 2: DutchShultzs (small blind) folded before Flop
Seat 3: masterkoolb (big blind) collected ($0.60)
Seat 4: Gichboy folded before Flop (didn't bet)
Seat 5: phate-1up folded before Flop (didn't bet)
Seat 6: KeLevro0 folded before Flop (didn't bet)
Seat 7: Perstenev folded before Flop
Seat 8: Tom1999 folded before Flop (didn't bet)
Seat 9: chiyuki folded before Flop (didn't bet)



PokerStars Zoom Hand #84300314795:  Hold'em No Limit ($0.10/$0.25) - 2012/08/05 15:19:55 JST [2012/08/05 2:19:55 ET]
Table 'Whirlpool' 9-max Seat #1 is the button
Seat 1: Lasutchik ($74.46 in chips) 
Seat 2: dergeb ($17.32 in chips) 
Seat 3: chiyuki ($30.16 in chips) 
Seat 4: KrystalAA ($19.40 in chips) 
Seat 5: snejokCoxx ($12.15 in chips) 
Seat 6: panaam ($21.85 in chips) 
Seat 7: kamikkaze ($25.93 in chips) 
Seat 8: ZhukOFFskI ($30.17 in chips) 
Seat 9: womble32 ($27.87 in chips) 
dergeb: posts small blind $0.10
chiyuki: posts big blind $0.25
*** HOLE CARDS ***
Dealt to chiyuki [4d 6s]
KrystalAA: folds 
snejokCoxx: folds 
panaam: folds 
kamikkaze: folds 
ZhukOFFskI: folds 
womble32: folds 
Lasutchik: folds 
dergeb: folds 
Uncalled bet ($0.15) returned to chiyuki
chiyuki collected $0.20 from pot
chiyuki: doesn't show hand 
*** SUMMARY ***
Total pot $0.20 | Rake $0 
Seat 1: Lasutchik (button) folded before Flop (didn't bet)
Seat 2: dergeb (small blind) folded before Flop
Seat 3: chiyuki (big blind) collected ($0.20)
Seat 4: KrystalAA folded before Flop (didn't bet)
Seat 5: snejokCoxx folded before Flop (didn't bet)
Seat 6: panaam folded before Flop (didn't bet)
Seat 7: kamikkaze folded before Flop (didn't bet)
Seat 8: ZhukOFFskI folded before Flop (didn't bet)
Seat 9: womble32 folded before Flop (didn't bet)



PokerStars Zoom Hand #84300314057:  Hold'em No Limit ($0.10/$0.25) - 2012/08/05 15:19:52 JST [2012/08/05 2:19:52 ET]
Table 'Whirlpool' 9-max Seat #1 is the button
Seat 1: chiyuki ($30.16 in chips) 
Seat 2: nice.franki ($12.60 in chips) 
Seat 3: ygoegoe ($44.20 in chips) 
Seat 4: GovGus ($26.04 in chips) 
Seat 5: KeLevro0 ($12.40 in chips) 
Seat 6: Ellen1947 ($23.45 in chips) 
Seat 7: macmauret ($20.56 in chips) 
Seat 8: Nerkit ($10.95 in chips) 
Seat 9: troublesomm ($36.76 in chips) 
nice.franki: posts small blind $0.10
ygoegoe: posts big blind $0.25
*** HOLE CARDS ***
Dealt to chiyuki [Jh Kc]
GovGus: folds 
KeLevro0: folds 
Ellen1947: folds 
macmauret: folds 
Nerkit: raises $0.50 to $0.75
troublesomm: raises $1.75 to $2.50
chiyuki: folds 
nice.franki: folds 
ygoegoe: folds 
Nerkit: folds 
Uncalled bet ($1.75) returned to troublesomm
troublesomm collected $1.85 from pot
troublesomm: doesn't show hand 
*** SUMMARY ***
Total pot $1.85 | Rake $0 
Seat 1: chiyuki (button) folded before Flop (didn't bet)
Seat 2: nice.franki (small blind) folded before Flop
Seat 3: ygoegoe (big blind) folded before Flop
Seat 4: GovGus folded before Flop (didn't bet)
Seat 5: KeLevro0 folded before Flop (didn't bet)
Seat 6: Ellen1947 folded before Flop (didn't bet)
Seat 7: macmauret folded before Flop (didn't bet)
Seat 8: Nerkit folded before Flop
Seat 9: troublesomm collected ($1.85)



PokerStars Zoom Hand #84300312530:  Hold'em No Limit ($0.10/$0.25) - 2012/08/05 15:19:45 JST [2012/08/05 2:19:45 ET]
Table 'Whirlpool' 9-max Seat #1 is the button
Seat 1: Tom1999 ($5.92 in chips) 
Seat 2: Yoshimac ($29.80 in chips) 
Seat 3: JhonnyP1979 ($10.39 in chips) 
Seat 4: dergeb ($17.32 in chips) 
Seat 5: kamikkaze ($26.03 in chips) 
Seat 6: chiyuki ($30.16 in chips) 
Seat 7: snejokCoxx ($15.16 in chips) 
Seat 8: dushvan ($55.53 in chips) 
Seat 9: panaam ($21.85 in chips) 
Yoshimac: posts small blind $0.10
JhonnyP1979: posts big blind $0.25
*** HOLE CARDS ***
Dealt to chiyuki [2c 3d]
dergeb: folds 
kamikkaze: folds 
chiyuki: folds 
snejokCoxx: folds 
dushvan: folds 
panaam: folds 
Tom1999: raises $0.50 to $0.75
Yoshimac: calls $0.65
JhonnyP1979: folds 
*** FLOP *** [Js Kc 9c]
Yoshimac: checks 
Tom1999: bets $0.75
Yoshimac: calls $0.75
*** TURN *** [Js Kc 9c] [Td]
Yoshimac: checks 
Tom1999: bets $1.25
Yoshimac: calls $1.25
*** RIVER *** [Js Kc 9c Td] [8h]
Yoshimac: checks 
Tom1999: bets $3.17 and is all-in
Yoshimac: calls $3.17
*** SHOW DOWN ***
Tom1999: shows [Qd Jh] (a straight, Nine to King)
Yoshimac: shows [8d Kd] (two pair, Kings and Eights)
Tom1999 collected $11.55 from pot
*** SUMMARY ***
Total pot $12.09 | Rake $0.54 
Board [Js Kc 9c Td 8h]
Seat 1: Tom1999 (button) showed [Qd Jh] and won ($11.55) with a straight, Nine to King
Seat 2: Yoshimac (small blind) showed [8d Kd] and lost with two pair, Kings and Eights
Seat 3: JhonnyP1979 (big blind) folded before Flop
Seat 4: dergeb folded before Flop (didn't bet)
Seat 5: kamikkaze folded before Flop (didn't bet)
Seat 6: chiyuki folded before Flop (didn't bet)
Seat 7: snejokCoxx folded before Flop (didn't bet)
Seat 8: dushvan folded before Flop (didn't bet)
Seat 9: panaam folded before Flop (didn't bet)



PokerStars Zoom Hand #84300327038:  Hold'em No Limit ($0.10/$0.25) - 2012/08/05 15:20:43 JST [2012/08/05 2:20:43 ET]
Table 'Whirlpool' 9-max Seat #1 is the button
Seat 1: ViTiV2010 ($12.25 in chips) 
Seat 2: Perstenev ($11.04 in chips) 
Seat 3: troublesomm ($34.90 in chips) 
Seat 4: ygoegoe ($43.20 in chips) 
Seat 5: kwkim73 ($26.92 in chips) 
Seat 6: DutchShultzs ($43.41 in chips) 
Seat 7: GSDP ($24.65 in chips) 
Seat 8: chiyuki ($30.26 in chips) 
Seat 9: PetitAlejo ($25 in chips) 
Perstenev: posts small blind $0.10
troublesomm: posts big blind $0.25
*** HOLE CARDS ***
Dealt to chiyuki [4c Tc]
ygoegoe: folds 
kwkim73: folds 
DutchShultzs: folds 
GSDP: folds 
chiyuki: folds 
PetitAlejo: raises $0.50 to $0.75
ViTiV2010: folds 
Perstenev: folds 
troublesomm: folds 
Uncalled bet ($0.50) returned to PetitAlejo
PetitAlejo collected $0.60 from pot
PetitAlejo: doesn't show hand 
*** SUMMARY ***
Total pot $0.60 | Rake $0 
Seat 1: ViTiV2010 (button) folded before Flop (didn't bet)
Seat 2: Perstenev (small blind) folded before Flop
Seat 3: troublesomm (big blind) folded before Flop
Seat 4: ygoegoe folded before Flop (didn't bet)
Seat 5: kwkim73 folded before Flop (didn't bet)
Seat 6: DutchShultzs folded before Flop (didn't bet)
Seat 7: GSDP folded before Flop (didn't bet)
Seat 8: chiyuki folded before Flop (didn't bet)
Seat 9: PetitAlejo collected ($0.60)



PokerStars Zoom Hand #84300329275:  Hold'em No Limit ($0.10/$0.25) - 2012/08/05 15:20:52 JST [2012/08/05 2:20:52 ET]
Table 'Whirlpool' 9-max Seat #1 is the button
Seat 1: Silveystryk ($26.35 in chips) 
Seat 2: chiyuki ($30.26 in chips) 
Seat 3: Perstenev ($13.15 in chips) 
Seat 4: KeLevro0 ($13.15 in chips) 
Seat 5: ChrisCDee ($43.68 in chips) 
Seat 6: GSDP ($24.65 in chips) 
Seat 7: deadmoneykid ($32.08 in chips) 
Seat 8: Dejacob ($37.53 in chips) 
Seat 9: 1Karina1 ($39.72 in chips) 
chiyuki: posts small blind $0.10
Perstenev: posts big blind $0.25
*** HOLE CARDS ***
Dealt to chiyuki [Tc Qh]
KeLevro0: folds 
ChrisCDee: folds 
GSDP: folds 
deadmoneykid: folds 
Dejacob: folds 
1Karina1: raises $0.50 to $0.75
Silveystryk: folds 
chiyuki: folds 
Perstenev: folds 
Uncalled bet ($0.50) returned to 1Karina1
1Karina1 collected $0.60 from pot
1Karina1: doesn't show hand 
*** SUMMARY ***
Total pot $0.60 | Rake $0 
Seat 1: Silveystryk (button) folded before Flop (didn't bet)
Seat 2: chiyuki (small blind) folded before Flop
Seat 3: Perstenev (big blind) folded before Flop
Seat 4: KeLevro0 folded before Flop (didn't bet)
Seat 5: ChrisCDee folded before Flop (didn't bet)
Seat 6: GSDP folded before Flop (didn't bet)
Seat 7: deadmoneykid folded before Flop (didn't bet)
Seat 8: Dejacob folded before Flop (didn't bet)
Seat 9: 1Karina1 collected ($0.60)



PokerStars Zoom Hand #84300325717:  Hold'em No Limit ($0.10/$0.25) - 2012/08/05 15:20:38 JST [2012/08/05 2:20:38 ET]
Table 'Whirlpool' 9-max Seat #1 is the button
Seat 1: Alvinpe85 ($51.48 in chips) 
Seat 2: DutchShultzs ($31.58 in chips) 
Seat 3: jacquelinewu ($30.72 in chips) 
Seat 4: chiyuki ($30.26 in chips) 
Seat 5: snejokCoxx ($13.47 in chips) 
Seat 6: Perstenev ($12.48 in chips) 
Seat 7: GovGus ($36.63 in chips) 
Seat 8: Littlea029 ($26.36 in chips) 
Seat 9: Ellen1947 ($22.05 in chips) 
DutchShultzs: posts small blind $0.10
jacquelinewu: posts big blind $0.25
*** HOLE CARDS ***
Dealt to chiyuki [2c 6c]
chiyuki: folds 
snejokCoxx: folds 
Perstenev: raises $0.50 to $0.75
GovGus: calls $0.75
Littlea029: folds 
Ellen1947: folds 
Alvinpe85: folds 
DutchShultzs: folds 
jacquelinewu: folds 
*** FLOP *** [Jc 5d Td]
Perstenev: bets $1.32
GovGus: calls $1.32
*** TURN *** [Jc 5d Td] [7h]
Perstenev: bets $3.21
GovGus: calls $3.21
*** RIVER *** [Jc 5d Td 7h] [6s]
Perstenev: bets $7.20 and is all-in
GovGus: folds 
Uncalled bet ($7.20) returned to Perstenev
Perstenev collected $10.42 from pot
Perstenev: doesn't show hand 
*** SUMMARY ***
Total pot $10.91 | Rake $0.49 
Board [Jc 5d Td 7h 6s]
Seat 1: Alvinpe85 (button) folded before Flop (didn't bet)
Seat 2: DutchShultzs (small blind) folded before Flop
Seat 3: jacquelinewu (big blind) folded before Flop
Seat 4: chiyuki folded before Flop (didn't bet)
Seat 5: snejokCoxx folded before Flop (didn't bet)
Seat 6: Perstenev collected ($10.42)
Seat 7: GovGus folded on the River
Seat 8: Littlea029 folded before Flop (didn't bet)
Seat 9: Ellen1947 folded before Flop (didn't bet)



PokerStars Zoom Hand #84300318035:  Hold'em No Limit ($0.10/$0.25) - 2012/08/05 15:20:08 JST [2012/08/05 2:20:08 ET]
Table 'Whirlpool' 9-max Seat #1 is the button
Seat 1: macmauret ($20.46 in chips) 
Seat 2: masterkoolb ($17.99 in chips) 
Seat 3: INSP!RON ($28.62 in chips) 
Seat 4: fima00000007 ($23.97 in chips) 
Seat 5: 4plankton ($16.50 in chips) 
Seat 6: kamikkaze ($25.93 in chips) 
Seat 7: chiyuki ($30.26 in chips) 
Seat 8: dergeb ($17.22 in chips) 
Seat 9: deadmoneykid ($32.08 in chips) 
masterkoolb: posts small blind $0.10
INSP!RON: posts big blind $0.25
*** HOLE CARDS ***
Dealt to chiyuki [Js Ad]
fima00000007: calls $0.25
4plankton: folds 
kamikkaze: folds 
chiyuki: folds 
dergeb: folds 
deadmoneykid: folds 
macmauret: folds 
masterkoolb: folds 
INSP!RON: checks 
*** FLOP *** [2c Qd 7s]
INSP!RON: bets $0.40
fima00000007: calls $0.40
*** TURN *** [2c Qd 7s] [5c]
INSP!RON: bets $1
fima00000007: calls $1
*** RIVER *** [2c Qd 7s 5c] [4d]
INSP!RON: checks 
fima00000007: bets $2.50
INSP!RON: raises $6.90 to $9.40
fima00000007: calls $6.90
*** SHOW DOWN ***
INSP!RON: shows [2h 2d] (three of a kind, Deuces)
fima00000007: mucks hand 
INSP!RON collected $21.20 from pot
*** SUMMARY ***
Total pot $22.20 | Rake $1 
Board [2c Qd 7s 5c 4d]
Seat 1: macmauret (button) folded before Flop (didn't bet)
Seat 2: masterkoolb (small blind) folded before Flop
Seat 3: INSP!RON (big blind) showed [2h 2d] and won ($21.20) with three of a kind, Deuces
Seat 4: fima00000007 mucked [Qc Th]
Seat 5: 4plankton folded before Flop (didn't bet)
Seat 6: kamikkaze folded before Flop (didn't bet)
Seat 7: chiyuki folded before Flop (didn't bet)
Seat 8: dergeb folded before Flop (didn't bet)
Seat 9: deadmoneykid folded before Flop (didn't bet)



PokerStars Zoom Hand #84300334448:  Hold'em No Limit ($0.10/$0.25) - 2012/08/05 15:21:13 JST [2012/08/05 2:21:13 ET]
Table 'Whirlpool' 9-max Seat #1 is the button
Seat 1: KeLevro0 ($13.15 in chips) 
Seat 2: kwkim73 ($26.67 in chips) 
Seat 3: nice.franki ($12.40 in chips) 
Seat 4: mjmichi ($36.52 in chips) 
Seat 5: chiyuki ($30.16 in chips) 
Seat 6: rey2040 ($8.40 in chips) 
Seat 7: GSDP ($23.55 in chips) 
Seat 8: jacquelinewu ($72.24 in chips) 
Seat 9: Ellen1947 ($22.05 in chips) 
kwkim73: posts small blind $0.10
nice.franki: posts big blind $0.25
*** HOLE CARDS ***
Dealt to chiyuki [6c Td]
mjmichi: folds 
chiyuki: folds 
rey2040: folds 
GSDP: raises $0.50 to $0.75
jacquelinewu: folds 
Ellen1947: folds 
KeLevro0: calls $0.75
kwkim73: folds 
nice.franki: folds 
*** FLOP *** [5s 2c 2s]
GSDP: checks 
KeLevro0: bets $0.99
GSDP: folds 
Uncalled bet ($0.99) returned to KeLevro0
KeLevro0 collected $1.77 from pot
KeLevro0: doesn't show hand 
*** SUMMARY ***
Total pot $1.85 | Rake $0.08 
Board [5s 2c 2s]
Seat 1: KeLevro0 (button) collected ($1.77)
Seat 2: kwkim73 (small blind) folded before Flop
Seat 3: nice.franki (big blind) folded before Flop
Seat 4: mjmichi folded before Flop (didn't bet)
Seat 5: chiyuki folded before Flop (didn't bet)
Seat 6: rey2040 folded before Flop (didn't bet)
Seat 7: GSDP folded on the Flop
Seat 8: jacquelinewu folded before Flop (didn't bet)
Seat 9: Ellen1947 folded before Flop (didn't bet)



PokerStars Zoom Hand #84300344420:  Hold'em No Limit ($0.10/$0.25) - 2012/08/05 15:21:52 JST [2012/08/05 2:21:52 ET]
Table 'Whirlpool' 9-max Seat #1 is the button
Seat 1: chiyuki ($30.16 in chips) 
Seat 2: Dan Royal ($23.12 in chips) 
Seat 3: Yoshimac ($22.98 in chips) 
Seat 4: GravyWalrus ($9.15 in chips) 
Seat 5: troublesomm ($32.15 in chips) 
Seat 6: Saruotiss ($56.32 in chips) 
Seat 7: panaam ($22.08 in chips) 
Seat 8: KeLevro0 ($8.84 in chips) 
Seat 9: ZhukOFFskI ($29.55 in chips) 
Dan Royal: posts small blind $0.10
Yoshimac: posts big blind $0.25
*** HOLE CARDS ***
Dealt to chiyuki [9c 2c]
GravyWalrus: folds 
troublesomm: folds 
Saruotiss: folds 
panaam: calls $0.25
KeLevro0: folds 
ZhukOFFskI: folds 
chiyuki: folds 
Dan Royal: raises $0.75 to $1
Yoshimac: folds 
panaam: calls $0.75
*** FLOP *** [2d Jh Ad]
Dan Royal: bets $1.25
panaam: folds 
Uncalled bet ($1.25) returned to Dan Royal
Dan Royal collected $2.15 from pot
Dan Royal: doesn't show hand 
*** SUMMARY ***
Total pot $2.25 | Rake $0.10 
Board [2d Jh Ad]
Seat 1: chiyuki (button) folded before Flop (didn't bet)
Seat 2: Dan Royal (small blind) collected ($2.15)
Seat 3: Yoshimac (big blind) folded before Flop
Seat 4: GravyWalrus folded before Flop (didn't bet)
Seat 5: troublesomm folded before Flop (didn't bet)
Seat 6: Saruotiss folded before Flop (didn't bet)
Seat 7: panaam folded on the Flop
Seat 8: KeLevro0 folded before Flop (didn't bet)
Seat 9: ZhukOFFskI folded before Flop (didn't bet)



PokerStars Zoom Hand #84300339831:  Hold'em No Limit ($0.10/$0.25) - 2012/08/05 15:21:34 JST [2012/08/05 2:21:34 ET]
Table 'Whirlpool' 9-max Seat #1 is the button
Seat 1: Silveystryk ($18.11 in chips) 
Seat 2: PetitAlejo ($25.10 in chips) 
Seat 3: kamikkaze ($9.50 in chips) 
Seat 4: phate-1up ($54.21 in chips) 
Seat 5: chiyuki ($30.16 in chips) 
Seat 6: Rilko1975 ($27.11 in chips) 
Seat 7: kwkim73 ($26.57 in chips) 
Seat 8: INSP!RON ($33.02 in chips) 
Seat 9: Perstenev ($10.69 in chips) 
PetitAlejo: posts small blind $0.10
kamikkaze: posts big blind $0.25
*** HOLE CARDS ***
Dealt to chiyuki [5h 4h]
phate-1up: folds 
chiyuki: folds 
Rilko1975: raises $0.50 to $0.75
kwkim73: folds 
INSP!RON: folds 
Perstenev: folds 
Silveystryk: calls $0.75
PetitAlejo: folds 
kamikkaze: folds 
*** FLOP *** [9d 6c 5c]
Rilko1975: checks 
Silveystryk: bets $1
Rilko1975: raises $1 to $2
Silveystryk: raises $3 to $5
Rilko1975: folds 
Uncalled bet ($3) returned to Silveystryk
Silveystryk collected $5.59 from pot
Silveystryk: doesn't show hand 
*** SUMMARY ***
Total pot $5.85 | Rake $0.26 
Board [9d 6c 5c]
Seat 1: Silveystryk (button) collected ($5.59)
Seat 2: PetitAlejo (small blind) folded before Flop
Seat 3: kamikkaze (big blind) folded before Flop
Seat 4: phate-1up folded before Flop (didn't bet)
Seat 5: chiyuki folded before Flop (didn't bet)
Seat 6: Rilko1975 folded on the Flop
Seat 7: kwkim73 folded before Flop (didn't bet)
Seat 8: INSP!RON folded before Flop (didn't bet)
Seat 9: Perstenev folded before Flop (didn't bet)



PokerStars Zoom Hand #84300346747:  Hold'em No Limit ($0.10/$0.25) - 2012/08/05 15:22:01 JST [2012/08/05 2:22:01 ET]
Table 'Whirlpool' 9-max Seat #1 is the button
Seat 1: phate-1up ($54.11 in chips) 
Seat 2: DanielWhyte ($61.81 in chips) 
Seat 3: 1Karina1 ($25.70 in chips) 
Seat 4: kwkim73 ($27.82 in chips) 
Seat 5: Saruotiss ($56.32 in chips) 
Seat 6: silvno31 ($47.62 in chips) 
Seat 7: Rici47 ($30.70 in chips) 
Seat 8: chiyuki ($30.16 in chips) 
Seat 9: troublesomm ($32.15 in chips) 
DanielWhyte: posts small blind $0.10
1Karina1: posts big blind $0.25
*** HOLE CARDS ***
Dealt to chiyuki [Ts 8h]
kwkim73: folds 
Saruotiss: folds 
silvno31: raises $0.50 to $0.75
Rici47: raises $1.50 to $2.25
chiyuki: folds 
troublesomm: folds 
phate-1up: folds 
DanielWhyte: folds 
1Karina1: folds 
silvno31: folds 
Uncalled bet ($1.50) returned to Rici47
Rici47 collected $1.85 from pot
Rici47: doesn't show hand 
*** SUMMARY ***
Total pot $1.85 | Rake $0 
Seat 1: phate-1up (button) folded before Flop (didn't bet)
Seat 2: DanielWhyte (small blind) folded before Flop
Seat 3: 1Karina1 (big blind) folded before Flop
Seat 4: kwkim73 folded before Flop (didn't bet)
Seat 5: Saruotiss folded before Flop (didn't bet)
Seat 6: silvno31 folded before Flop
Seat 7: Rici47 collected ($1.85)
Seat 8: chiyuki folded before Flop (didn't bet)
Seat 9: troublesomm folded before Flop (didn't bet)



PokerStars Zoom Hand #84300345963:  Hold'em No Limit ($0.10/$0.25) - 2012/08/05 15:21:58 JST [2012/08/05 2:21:58 ET]
Table 'Whirlpool' 9-max Seat #1 is the button
Seat 1: KeLevro0 ($8.84 in chips) 
Seat 2: wildy29 ($20.11 in chips) 
Seat 3: ygoegoe ($43.10 in chips) 
Seat 4: Alvinpe85 ($49.39 in chips) 
Seat 5: 1Karina1 ($26.27 in chips) 
Seat 6: Robchie ($14.61 in chips) 
Seat 7: troublesomm ($32.15 in chips) 
Seat 8: Perstenev ($12.80 in chips) 
Seat 9: chiyuki ($30.16 in chips) 
wildy29: posts small blind $0.10
ygoegoe: posts big blind $0.25
*** HOLE CARDS ***
Dealt to chiyuki [7c 8h]
Alvinpe85: folds 
1Karina1: folds 
Robchie: folds 
troublesomm: folds 
Perstenev: folds 
chiyuki: folds 
KeLevro0: folds 
wildy29: calls $0.15
ygoegoe: checks 
*** FLOP *** [Th 6h Ac]
wildy29: bets $0.50
ygoegoe: folds 
Uncalled bet ($0.50) returned to wildy29
wildy29 collected $0.48 from pot
wildy29: doesn't show hand 
*** SUMMARY ***
Total pot $0.50 | Rake $0.02 
Board [Th 6h Ac]
Seat 1: KeLevro0 (button) folded before Flop (didn't bet)
Seat 2: wildy29 (small blind) collected ($0.48)
Seat 3: ygoegoe (big blind) folded on the Flop
Seat 4: Alvinpe85 folded before Flop (didn't bet)
Seat 5: 1Karina1 folded before Flop (didn't bet)
Seat 6: Robchie folded before Flop (didn't bet)
Seat 7: troublesomm folded before Flop (didn't bet)
Seat 8: Perstenev folded before Flop (didn't bet)
Seat 9: chiyuki folded before Flop (didn't bet)



PokerStars Zoom Hand #84300352319:  Hold'em No Limit ($0.10/$0.25) - 2012/08/05 15:22:24 JST [2012/08/05 2:22:24 ET]
Table 'Whirlpool' 9-max Seat #1 is the button
Seat 1: Saruotiss ($56.32 in chips) 
Seat 2: Ellen1947 ($22.82 in chips) 
Seat 3: Grishukps ($12.50 in chips) 
Seat 4: ZhukOFFskI ($74.88 in chips) 
Seat 5: kamikkaze ($12.25 in chips) 
Seat 6: Silveystryk ($20.95 in chips) 
Seat 7: chiyuki ($29.91 in chips) 
Seat 8: Alvinpe85 ($49.39 in chips) 
Seat 9: slapshot2011 ($23.37 in chips) 
Ellen1947: posts small blind $0.10
Grishukps: posts big blind $0.25
*** HOLE CARDS ***
Dealt to chiyuki [7c 4d]
ZhukOFFskI: folds 
kamikkaze: folds 
Silveystryk: folds 
chiyuki: folds 
Alvinpe85: raises $0.50 to $0.75
slapshot2011: folds 
Saruotiss: folds 
Ellen1947: folds 
Grishukps: folds 
Uncalled bet ($0.50) returned to Alvinpe85
Alvinpe85 collected $0.60 from pot
Alvinpe85: doesn't show hand 
*** SUMMARY ***
Total pot $0.60 | Rake $0 
Seat 1: Saruotiss (button) folded before Flop (didn't bet)
Seat 2: Ellen1947 (small blind) folded before Flop
Seat 3: Grishukps (big blind) folded before Flop
Seat 4: ZhukOFFskI folded before Flop (didn't bet)
Seat 5: kamikkaze folded before Flop (didn't bet)
Seat 6: Silveystryk folded before Flop (didn't bet)
Seat 7: chiyuki folded before Flop (didn't bet)
Seat 8: Alvinpe85 collected ($0.60)
Seat 9: slapshot2011 folded before Flop (didn't bet)



PokerStars Zoom Hand #84300355654:  Hold'em No Limit ($0.10/$0.25) - 2012/08/05 15:22:37 JST [2012/08/05 2:22:37 ET]
Table 'Whirlpool' 9-max Seat #1 is the button
Seat 1: chiyuki ($29.81 in chips) 
Seat 2: GovGus ($25.35 in chips) 
Seat 3: Gichboy ($27.03 in chips) 
Seat 4: Rici47 ($31.80 in chips) 
Seat 5: nice.franki ($12.50 in chips) 
Seat 6: Dan Royal ($23.52 in chips) 
Seat 7: troublesomm ($29.06 in chips) 
Seat 8: snejokCoxx ($12.75 in chips) 
Seat 9: silvno31 ($46.97 in chips) 
GovGus: posts small blind $0.10
Gichboy: posts big blind $0.25
*** HOLE CARDS ***
Dealt to chiyuki [4d Kc]
Rici47: folds 
nice.franki: folds 
Dan Royal: folds 
troublesomm: folds 
snejokCoxx: folds 
silvno31: folds 
chiyuki: folds 
GovGus: folds 
Uncalled bet ($0.15) returned to Gichboy
Gichboy collected $0.20 from pot
Gichboy: doesn't show hand 
*** SUMMARY ***
Total pot $0.20 | Rake $0 
Seat 1: chiyuki (button) folded before Flop (didn't bet)
Seat 2: GovGus (small blind) folded before Flop
Seat 3: Gichboy (big blind) collected ($0.20)
Seat 4: Rici47 folded before Flop (didn't bet)
Seat 5: nice.franki folded before Flop (didn't bet)
Seat 6: Dan Royal folded before Flop (didn't bet)
Seat 7: troublesomm folded before Flop (didn't bet)
Seat 8: snejokCoxx folded before Flop (didn't bet)
Seat 9: silvno31 folded before Flop (didn't bet)



PokerStars Zoom Hand #84300359027:  Hold'em No Limit ($0.10/$0.25) - 2012/08/05 15:22:50 JST [2012/08/05 2:22:50 ET]
Table 'Whirlpool' 9-max Seat #1 is the button
Seat 1: dergeb ($20.25 in chips) 
Seat 2: snejokCoxx ($14.31 in chips) 
Seat 3: AAAKK777 ($34.76 in chips) 
Seat 4: panaam ($20.98 in chips) 
Seat 5: chiyuki ($29.81 in chips) 
Seat 6: kamikkaze ($12.62 in chips) 
Seat 7: Rici47 ($31.80 in chips) 
Seat 8: INSP!RON ($38.67 in chips) 
Seat 9: 1Karina1 ($27.05 in chips) 
snejokCoxx: posts small blind $0.10
AAAKK777: posts big blind $0.25
*** HOLE CARDS ***
Dealt to chiyuki [9d Qh]
panaam: folds 
chiyuki: folds 
kamikkaze: folds 
Rici47: folds 
INSP!RON: raises $0.35 to $0.60
1Karina1: folds 
dergeb: folds 
snejokCoxx: folds 
AAAKK777: folds 
Uncalled bet ($0.35) returned to INSP!RON
INSP!RON collected $0.60 from pot
INSP!RON: doesn't show hand 
*** SUMMARY ***
Total pot $0.60 | Rake $0 
Seat 1: dergeb (button) folded before Flop (didn't bet)
Seat 2: snejokCoxx (small blind) folded before Flop
Seat 3: AAAKK777 (big blind) folded before Flop
Seat 4: panaam folded before Flop (didn't bet)
Seat 5: chiyuki folded before Flop (didn't bet)
Seat 6: kamikkaze folded before Flop (didn't bet)
Seat 7: Rici47 folded before Flop (didn't bet)
Seat 8: INSP!RON collected ($0.60)
Seat 9: 1Karina1 folded before Flop (didn't bet)



PokerStars Zoom Hand #84300354882:  Hold'em No Limit ($0.10/$0.25) - 2012/08/05 15:22:34 JST [2012/08/05 2:22:34 ET]
Table 'Whirlpool' 9-max Seat #1 is the button
Seat 1: kamikkaze ($12.15 in chips) 
Seat 2: chiyuki ($29.91 in chips) 
Seat 3: KeLevro0 ($13.74 in chips) 
Seat 4: troublesomm ($29.06 in chips) 
Seat 5: GravyWalrus ($9.15 in chips) 
Seat 6: kwkim73 ($26.84 in chips) 
Seat 7: Dan Royal ($23.52 in chips) 
Seat 8: AntoineHunt ($35.60 in chips) 
Seat 9: cofla tito ($12.98 in chips) 
chiyuki: posts small blind $0.10
KeLevro0: posts big blind $0.25
*** HOLE CARDS ***
Dealt to chiyuki [Jd 3c]
troublesomm: folds 
GravyWalrus: folds 
kwkim73: folds 
Dan Royal: folds 
AntoineHunt: folds 
cofla tito: calls $0.25
kamikkaze: folds 
chiyuki: folds 
KeLevro0: checks 
*** FLOP *** [Ad 5h 2c]
KeLevro0: checks 
cofla tito: checks 
*** TURN *** [Ad 5h 2c] [Kh]
KeLevro0: checks 
cofla tito: bets $0.50
KeLevro0: folds 
Uncalled bet ($0.50) returned to cofla tito
cofla tito collected $0.57 from pot
cofla tito: doesn't show hand 
*** SUMMARY ***
Total pot $0.60 | Rake $0.03 
Board [Ad 5h 2c Kh]
Seat 1: kamikkaze (button) folded before Flop (didn't bet)
Seat 2: chiyuki (small blind) folded before Flop
Seat 3: KeLevro0 (big blind) folded on the Turn
Seat 4: troublesomm folded before Flop (didn't bet)
Seat 5: GravyWalrus folded before Flop (didn't bet)
Seat 6: kwkim73 folded before Flop (didn't bet)
Seat 7: Dan Royal folded before Flop (didn't bet)
Seat 8: AntoineHunt folded before Flop (didn't bet)
Seat 9: cofla tito collected ($0.57)



PokerStars Zoom Hand #84300359774:  Hold'em No Limit ($0.10/$0.25) - 2012/08/05 15:22:53 JST [2012/08/05 2:22:53 ET]
Table 'Whirlpool' 9-max Seat #1 is the button
Seat 1: Lasutchik ($72.45 in chips) 
Seat 2: GravyWalrus ($9.15 in chips) 
Seat 3: Perstenev ($12.05 in chips) 
Seat 4: chiyuki ($29.81 in chips) 
Seat 5: kamikkaze ($12.62 in chips) 
Seat 6: drunk_bender ($16.30 in chips) 
Seat 7: AntoineHunt ($35.60 in chips) 
Seat 8: seula i ($25 in chips) 
Seat 9: HighDuka ($27.99 in chips) 
GravyWalrus: posts small blind $0.10
Perstenev: posts big blind $0.25
*** HOLE CARDS ***
Dealt to chiyuki [5h Ks]
chiyuki: folds 
kamikkaze: folds 
drunk_bender: folds 
AntoineHunt: folds 
seula i: folds 
HighDuka: raises $0.50 to $0.75
Lasutchik: folds 
GravyWalrus: folds 
Perstenev: folds 
Uncalled bet ($0.50) returned to HighDuka
HighDuka collected $0.60 from pot
HighDuka: doesn't show hand 
*** SUMMARY ***
Total pot $0.60 | Rake $0 
Seat 1: Lasutchik (button) folded before Flop (didn't bet)
Seat 2: GravyWalrus (small blind) folded before Flop
Seat 3: Perstenev (big blind) folded before Flop
Seat 4: chiyuki folded before Flop (didn't bet)
Seat 5: kamikkaze folded before Flop (didn't bet)
Seat 6: drunk_bender folded before Flop (didn't bet)
Seat 7: AntoineHunt folded before Flop (didn't bet)
Seat 8: seula i folded before Flop (didn't bet)
Seat 9: HighDuka collected ($0.60)



PokerStars Zoom Hand #84300353546:  Hold'em No Limit ($0.10/$0.25) - 2012/08/05 15:22:29 JST [2012/08/05 2:22:29 ET]
Table 'Whirlpool' 9-max Seat #1 is the button
Seat 1: Ellen1947 ($23.85 in chips) 
Seat 2: 1Karina1 ($27.76 in chips) 
Seat 3: WARIBANA7777 ($14.33 in chips) 
Seat 4: Silveystryk ($26.08 in chips) 
Seat 5: Lasutchik ($72.55 in chips) 
Seat 6: chiyuki ($29.91 in chips) 
Seat 7: KeLevro0 ($13.23 in chips) 
Seat 8: ZhukOFFskI ($33.94 in chips) 
Seat 9: Rici47 ($43.28 in chips) 
1Karina1: posts small blind $0.10
WARIBANA7777: posts big blind $0.25
*** HOLE CARDS ***
Dealt to chiyuki [5h 8s]
Silveystryk: raises $0.50 to $0.75
Lasutchik: folds 
chiyuki: folds 
KeLevro0: folds 
ZhukOFFskI: folds 
Rici47: calls $0.75
Ellen1947: folds 
1Karina1: folds 
WARIBANA7777: folds 
*** FLOP *** [Ks Jh 6s]
Silveystryk: bets $1
Rici47: calls $1
*** TURN *** [Ks Jh 6s] [2s]
Silveystryk: checks 
Rici47: bets $1.50
Silveystryk: calls $1.50
*** RIVER *** [Ks Jh 6s 2s] [4h]
Silveystryk: checks 
Rici47: checks 
*** SHOW DOWN ***
Silveystryk: shows [Kd Ad] (a pair of Kings)
Rici47: mucks hand 
Silveystryk collected $6.54 from pot
*** SUMMARY ***
Total pot $6.85 | Rake $0.31 
Board [Ks Jh 6s 2s 4h]
Seat 1: Ellen1947 (button) folded before Flop (didn't bet)
Seat 2: 1Karina1 (small blind) folded before Flop
Seat 3: WARIBANA7777 (big blind) folded before Flop
Seat 4: Silveystryk showed [Kd Ad] and won ($6.54) with a pair of Kings
Seat 5: Lasutchik folded before Flop (didn't bet)
Seat 6: chiyuki folded before Flop (didn't bet)
Seat 7: KeLevro0 folded before Flop (didn't bet)
Seat 8: ZhukOFFskI folded before Flop (didn't bet)
Seat 9: Rici47 mucked [As Qd]



PokerStars Zoom Hand #84300358251:  Hold'em No Limit ($0.10/$0.25) - 2012/08/05 15:22:47 JST [2012/08/05 2:22:47 ET]
Table 'Whirlpool' 9-max Seat #1 is the button
Seat 1: Perstenev ($12.05 in chips) 
Seat 2: Rilko1975 ($37.61 in chips) 
Seat 3: ChrisCDee ($47.31 in chips) 
Seat 4: Rici47 ($31.80 in chips) 
Seat 5: jacquelinewu ($72.86 in chips) 
Seat 6: chiyuki ($29.81 in chips) 
Seat 7: Tom1999 ($14.82 in chips) 
Seat 8: Dan Royal ($23.52 in chips) 
Seat 9: phate-1up ($51.79 in chips) 
Rilko1975: posts small blind $0.10
ChrisCDee: posts big blind $0.25
*** HOLE CARDS ***
Dealt to chiyuki [5c Tc]
Rici47: folds 
jacquelinewu: folds 
chiyuki: folds 
Tom1999: folds 
Dan Royal: folds 
phate-1up: folds 
Perstenev: folds 
Rilko1975: calls $0.15
ChrisCDee: checks 
*** FLOP *** [5h 9s Td]
Rilko1975: checks 
ChrisCDee: bets $0.50
Rilko1975: folds 
Uncalled bet ($0.50) returned to ChrisCDee
ChrisCDee collected $0.48 from pot
ChrisCDee: doesn't show hand 
*** SUMMARY ***
Total pot $0.50 | Rake $0.02 
Board [5h 9s Td]
Seat 1: Perstenev (button) folded before Flop (didn't bet)
Seat 2: Rilko1975 (small blind) folded on the Flop
Seat 3: ChrisCDee (big blind) collected ($0.48)
Seat 4: Rici47 folded before Flop (didn't bet)
Seat 5: jacquelinewu folded before Flop (didn't bet)
Seat 6: chiyuki folded before Flop (didn't bet)
Seat 7: Tom1999 folded before Flop (didn't bet)
Seat 8: Dan Royal folded before Flop (didn't bet)
Seat 9: phate-1up folded before Flop (didn't bet)



PokerStars Zoom Hand #84300348040:  Hold'em No Limit ($0.10/$0.25) - 2012/08/05 15:22:06 JST [2012/08/05 2:22:06 ET]
Table 'Whirlpool' 9-max Seat #1 is the button
Seat 1: 4ydo yogurt ($33.69 in chips) 
Seat 2: deepakmbh ($22.15 in chips) 
Seat 3: chiyuki ($30.16 in chips) 
Seat 4: Saruotiss ($56.32 in chips) 
Seat 5: kwkim73 ($27.82 in chips) 
Seat 6: phate-1up ($54.11 in chips) 
Seat 7: hirozo ($77.29 in chips) 
Seat 8: cofla tito ($12.98 in chips) 
Seat 9: ZhukOFFskI ($34.04 in chips) 
deepakmbh: posts small blind $0.10
chiyuki: posts big blind $0.25
*** HOLE CARDS ***
Dealt to chiyuki [9c Qh]
Saruotiss: folds 
kwkim73: folds 
phate-1up: raises $0.50 to $0.75
hirozo: folds 
cofla tito: folds 
ZhukOFFskI: folds 
4ydo yogurt: calls $0.75
deepakmbh: calls $0.65
chiyuki: folds 
*** FLOP *** [7s 5h Tc]
deepakmbh: checks 
phate-1up: checks 
4ydo yogurt: bets $0.80
deepakmbh: raises $1.45 to $2.25
phate-1up: folds 
4ydo yogurt: calls $1.45
*** TURN *** [7s 5h Tc] [Kh]
deepakmbh: bets $4.80
4ydo yogurt: calls $4.80
*** RIVER *** [7s 5h Tc Kh] [6h]
deepakmbh: bets $14.35 and is all-in
4ydo yogurt: folds 
Uncalled bet ($14.35) returned to deepakmbh
deepakmbh collected $15.85 from pot
deepakmbh: doesn't show hand 
*** SUMMARY ***
Total pot $16.60 | Rake $0.75 
Board [7s 5h Tc Kh 6h]
Seat 1: 4ydo yogurt (button) folded on the River
Seat 2: deepakmbh (small blind) collected ($15.85)
Seat 3: chiyuki (big blind) folded before Flop
Seat 4: Saruotiss folded before Flop (didn't bet)
Seat 5: kwkim73 folded before Flop (didn't bet)
Seat 6: phate-1up folded on the Flop
Seat 7: hirozo folded before Flop (didn't bet)
Seat 8: cofla tito folded before Flop (didn't bet)
Seat 9: ZhukOFFskI folded before Flop (didn't bet)



PokerStars Zoom Hand #84300362370:  Hold'em No Limit ($0.10/$0.25) - 2012/08/05 15:23:03 JST [2012/08/05 2:23:03 ET]
Table 'Whirlpool' 9-max Seat #1 is the button
Seat 1: hirozo ($77.64 in chips) 
Seat 2: snejokCoxx ($12.82 in chips) 
Seat 3: KrystalAA ($17.65 in chips) 
Seat 4: Lasutchik ($72.45 in chips) 
Seat 5: xxx Spb xxx ($26.58 in chips) 
Seat 6: yane73 ($9.54 in chips) 
Seat 7: jacquelinewu ($36.89 in chips) 
Seat 8: masterkoolb ($12.50 in chips) 
Seat 9: chiyuki ($29.81 in chips) 
snejokCoxx: posts small blind $0.10
KrystalAA: posts big blind $0.25
*** HOLE CARDS ***
Dealt to chiyuki [5d 2c]
Lasutchik: folds 
xxx Spb xxx: folds 
yane73: folds 
jacquelinewu: folds 
masterkoolb: raises $0.60 to $0.85
chiyuki: folds 
hirozo: folds 
snejokCoxx: folds 
KrystalAA: folds 
Uncalled bet ($0.60) returned to masterkoolb
masterkoolb collected $0.60 from pot
masterkoolb: doesn't show hand 
*** SUMMARY ***
Total pot $0.60 | Rake $0 
Seat 1: hirozo (button) folded before Flop (didn't bet)
Seat 2: snejokCoxx (small blind) folded before Flop
Seat 3: KrystalAA (big blind) folded before Flop
Seat 4: Lasutchik folded before Flop (didn't bet)
Seat 5: xxx Spb xxx folded before Flop (didn't bet)
Seat 6: yane73 folded before Flop (didn't bet)
Seat 7: jacquelinewu folded before Flop (didn't bet)
Seat 8: masterkoolb collected ($0.60)
Seat 9: chiyuki folded before Flop (didn't bet)



PokerStars Zoom Hand #84300364200:  Hold'em No Limit ($0.10/$0.25) - 2012/08/05 15:23:10 JST [2012/08/05 2:23:10 ET]
Table 'Whirlpool' 9-max Seat #1 is the button
Seat 1: mjmichi ($49.23 in chips) 
Seat 2: Dan Royal ($23.62 in chips) 
Seat 3: xxx Spb xxx ($26.58 in chips) 
Seat 4: nastya040 ($21.18 in chips) 
Seat 5: kwkim73 ($27.47 in chips) 
Seat 6: jacquelinewu ($36.89 in chips) 
Seat 7: chiyuki ($29.81 in chips) 
Seat 8: yane73 ($9.54 in chips) 
Seat 9: grand maitre ($20.91 in chips) 
Dan Royal: posts small blind $0.10
xxx Spb xxx: posts big blind $0.25
*** HOLE CARDS ***
Dealt to chiyuki [Jd 9c]
nastya040: raises $0.25 to $0.50
kwkim73: folds 
jacquelinewu: folds 
chiyuki: folds 
yane73: folds 
grand maitre: folds 
mjmichi: folds 
Dan Royal: raises $1.50 to $2
xxx Spb xxx: folds 
nastya040: calls $1.50
*** FLOP *** [Ts Ks Qc]
Dan Royal: bets $3
nastya040: folds 
Uncalled bet ($3) returned to Dan Royal
Dan Royal collected $4.06 from pot
Dan Royal: doesn't show hand 
*** SUMMARY ***
Total pot $4.25 | Rake $0.19 
Board [Ts Ks Qc]
Seat 1: mjmichi (button) folded before Flop (didn't bet)
Seat 2: Dan Royal (small blind) collected ($4.06)
Seat 3: xxx Spb xxx (big blind) folded before Flop
Seat 4: nastya040 folded on the Flop
Seat 5: kwkim73 folded before Flop (didn't bet)
Seat 6: jacquelinewu folded before Flop (didn't bet)
Seat 7: chiyuki folded before Flop (didn't bet)
Seat 8: yane73 folded before Flop (didn't bet)
Seat 9: grand maitre folded before Flop (didn't bet)



PokerStars Zoom Hand #84300368049:  Hold'em No Limit ($0.10/$0.25) - 2012/08/05 15:23:26 JST [2012/08/05 2:23:26 ET]
Table 'Whirlpool' 9-max Seat #1 is the button
Seat 1: Dejacob ($53.92 in chips) 
Seat 2: chiyuki ($29.56 in chips) 
Seat 3: deepakmbh ($30.20 in chips) 
Seat 4: INSP!RON ($29.84 in chips) 
Seat 5: Lasutchik ($72.20 in chips) 
Seat 6: ygoegoe ($25.68 in chips) 
Seat 7: ViTiV2010 ($12.50 in chips) 
Seat 8: nice.franki ($12.15 in chips) 
Seat 9: panaam ($20.98 in chips) 
chiyuki: posts small blind $0.10
deepakmbh: posts big blind $0.25
*** HOLE CARDS ***
Dealt to chiyuki [Jd 4h]
INSP!RON: folds 
Lasutchik: folds 
ygoegoe: folds 
ViTiV2010: raises $0.50 to $0.75
nice.franki: folds 
panaam: folds 
Dejacob: folds 
chiyuki: folds 
deepakmbh: folds 
Uncalled bet ($0.50) returned to ViTiV2010
ViTiV2010 collected $0.60 from pot
ViTiV2010: doesn't show hand 
*** SUMMARY ***
Total pot $0.60 | Rake $0 
Seat 1: Dejacob (button) folded before Flop (didn't bet)
Seat 2: chiyuki (small blind) folded before Flop
Seat 3: deepakmbh (big blind) folded before Flop
Seat 4: INSP!RON folded before Flop (didn't bet)
Seat 5: Lasutchik folded before Flop (didn't bet)
Seat 6: ygoegoe folded before Flop (didn't bet)
Seat 7: ViTiV2010 collected ($0.60)
Seat 8: nice.franki folded before Flop (didn't bet)
Seat 9: panaam folded before Flop (didn't bet)



PokerStars Zoom Hand #84300368841:  Hold'em No Limit ($0.10/$0.25) - 2012/08/05 15:23:29 JST [2012/08/05 2:23:29 ET]
Table 'Whirlpool' 9-max Seat #1 is the button
Seat 1: INSP!RON ($29.84 in chips) 
Seat 2: deadmoneykid ($41.06 in chips) 
Seat 3: Wilcox76607 ($19.66 in chips) 
Seat 4: hirozo ($35.73 in chips) 
Seat 5: troublesomm ($25 in chips) 
Seat 6: chiyuki ($29.46 in chips) 
Seat 7: jacquelinewu ($72.76 in chips) 
Seat 8: Perstenev ($11.70 in chips) 
Seat 9: masterkoolb ($12.85 in chips) 
deadmoneykid: posts small blind $0.10
Wilcox76607: posts big blind $0.25
*** HOLE CARDS ***
Dealt to chiyuki [5d 4c]
hirozo: folds 
troublesomm: folds 
chiyuki: folds 
jacquelinewu: folds 
Perstenev: folds 
masterkoolb: folds 
INSP!RON: raises $0.35 to $0.60
deadmoneykid: folds 
Wilcox76607: folds 
Uncalled bet ($0.35) returned to INSP!RON
INSP!RON collected $0.60 from pot
INSP!RON: doesn't show hand 
*** SUMMARY ***
Total pot $0.60 | Rake $0 
Seat 1: INSP!RON (button) collected ($0.60)
Seat 2: deadmoneykid (small blind) folded before Flop
Seat 3: Wilcox76607 (big blind) folded before Flop
Seat 4: hirozo folded before Flop (didn't bet)
Seat 5: troublesomm folded before Flop (didn't bet)
Seat 6: chiyuki folded before Flop (didn't bet)
Seat 7: jacquelinewu folded before Flop (didn't bet)
Seat 8: Perstenev folded before Flop (didn't bet)
Seat 9: masterkoolb folded before Flop (didn't bet)



PokerStars Zoom Hand #84300364967:  Hold'em No Limit ($0.10/$0.25) - 2012/08/05 15:23:13 JST [2012/08/05 2:23:13 ET]
Table 'Whirlpool' 9-max Seat #1 is the button
Seat 1: Rilko1975 ($37.36 in chips) 
Seat 2: hirozo ($77.64 in chips) 
Seat 3: chiyuki ($29.81 in chips) 
Seat 4: 4ydo yogurt ($25.89 in chips) 
Seat 5: Perstenev ($11.70 in chips) 
Seat 6: deepakmbh ($29.18 in chips) 
Seat 7: DutchShultzs ($42.21 in chips) 
Seat 8: Silveystryk ($25.35 in chips) 
Seat 9: Grishukps ($12.50 in chips) 
hirozo: posts small blind $0.10
chiyuki: posts big blind $0.25
*** HOLE CARDS ***
Dealt to chiyuki [6d 3h]
4ydo yogurt: raises $0.50 to $0.75
Perstenev: folds 
deepakmbh: calls $0.75
DutchShultzs: folds 
Silveystryk: folds 
Grishukps: folds 
Rilko1975: folds 
hirozo: raises $2.35 to $3.10
chiyuki: folds 
4ydo yogurt: calls $2.35
deepakmbh: calls $2.35
*** FLOP *** [8h Jd 9d]
hirozo: bets $6.08
4ydo yogurt: folds 
deepakmbh: calls $6.08
*** TURN *** [8h Jd 9d] [4s]
hirozo: bets $13.83
deepakmbh: folds 
Uncalled bet ($13.83) returned to hirozo
hirozo collected $20.73 from pot
hirozo: doesn't show hand 
*** SUMMARY ***
Total pot $21.71 | Rake $0.98 
Board [8h Jd 9d 4s]
Seat 1: Rilko1975 (button) folded before Flop (didn't bet)
Seat 2: hirozo (small blind) collected ($20.73)
Seat 3: chiyuki (big blind) folded before Flop
Seat 4: 4ydo yogurt folded on the Flop
Seat 5: Perstenev folded before Flop (didn't bet)
Seat 6: deepakmbh folded on the Turn
Seat 7: DutchShultzs folded before Flop (didn't bet)
Seat 8: Silveystryk folded before Flop (didn't bet)
Seat 9: Grishukps folded before Flop (didn't bet)



PokerStars Zoom Hand #84300363127:  Hold'em No Limit ($0.10/$0.25) - 2012/08/05 15:23:06 JST [2012/08/05 2:23:06 ET]
Table 'Whirlpool' 9-max Seat #1 is the button
Seat 1: Gichboy ($27.13 in chips) 
Seat 2: mjmichi ($49.33 in chips) 
Seat 3: therati ($20.67 in chips) 
Seat 4: Dejacob ($39.60 in chips) 
Seat 5: DutchShultzs ($32.87 in chips) 
Seat 6: nastya040 ($21.18 in chips) 
Seat 7: troublesomm ($37.84 in chips) 
Seat 8: chiyuki ($29.81 in chips) 
Seat 9: cofla tito ($15.48 in chips) 
mjmichi: posts small blind $0.10
therati: posts big blind $0.25
*** HOLE CARDS ***
Dealt to chiyuki [Td Qh]
Dejacob: folds 
DutchShultzs: folds 
nastya040: folds 
troublesomm: raises $0.50 to $0.75
chiyuki: folds 
cofla tito: calls $0.75
Gichboy: folds 
mjmichi: folds 
therati: calls $0.50
*** FLOP *** [Qs 6c Ad]
therati: checks 
troublesomm: checks 
cofla tito: checks 
*** TURN *** [Qs 6c Ad] [9h]
therati: checks 
troublesomm: checks 
cofla tito: bets $0.75
therati: calls $0.75
troublesomm: folds 
*** RIVER *** [Qs 6c Ad 9h] [Ts]
therati: checks 
cofla tito: checks 
*** SHOW DOWN ***
therati: shows [Kh Ks] (a pair of Kings)
cofla tito: mucks hand 
therati collected $3.68 from pot
*** SUMMARY ***
Total pot $3.85 | Rake $0.17 
Board [Qs 6c Ad 9h Ts]
Seat 1: Gichboy (button) folded before Flop (didn't bet)
Seat 2: mjmichi (small blind) folded before Flop
Seat 3: therati (big blind) showed [Kh Ks] and won ($3.68) with a pair of Kings
Seat 4: Dejacob folded before Flop (didn't bet)
Seat 5: DutchShultzs folded before Flop (didn't bet)
Seat 6: nastya040 folded before Flop (didn't bet)
Seat 7: troublesomm folded on the Turn
Seat 8: chiyuki folded before Flop (didn't bet)
Seat 9: cofla tito mucked [8h 8c]



PokerStars Zoom Hand #84300369630:  Hold'em No Limit ($0.10/$0.25) - 2012/08/05 15:23:32 JST [2012/08/05 2:23:32 ET]
Table 'Whirlpool' 9-max Seat #1 is the button
Seat 1: pandaaaaaa ($7.37 in chips) 
Seat 2: KrystalAA ($17.40 in chips) 
Seat 3: slapshot2011 ($24.25 in chips) 
Seat 4: chiyuki ($29.46 in chips) 
Seat 5: AntoineHunt ($35.35 in chips) 
Seat 6: kwkim73 ($26.49 in chips) 
Seat 7: troublesomm ($25 in chips) 
Seat 8: mjmichi ($42.75 in chips) 
Seat 9: Grishukps ($12.50 in chips) 
KrystalAA: posts small blind $0.10
slapshot2011: posts big blind $0.25
*** HOLE CARDS ***
Dealt to chiyuki [6h 8d]
chiyuki: folds 
AntoineHunt: raises $0.50 to $0.75
kwkim73: raises $1.85 to $2.60
troublesomm: folds 
mjmichi: folds 
Grishukps: folds 
pandaaaaaa: folds 
KrystalAA: folds 
slapshot2011: folds 
AntoineHunt: raises $2.90 to $5.50
kwkim73: folds 
Uncalled bet ($2.90) returned to AntoineHunt
AntoineHunt collected $5.55 from pot
AntoineHunt: doesn't show hand 
*** SUMMARY ***
Total pot $5.55 | Rake $0 
Seat 1: pandaaaaaa (button) folded before Flop (didn't bet)
Seat 2: KrystalAA (small blind) folded before Flop
Seat 3: slapshot2011 (big blind) folded before Flop
Seat 4: chiyuki folded before Flop (didn't bet)
Seat 5: AntoineHunt collected ($5.55)
Seat 6: kwkim73 folded before Flop
Seat 7: troublesomm folded before Flop (didn't bet)
Seat 8: mjmichi folded before Flop (didn't bet)
Seat 9: Grishukps folded before Flop (didn't bet)



PokerStars Zoom Hand #84300371122:  Hold'em No Limit ($0.10/$0.25) - 2012/08/05 15:23:38 JST [2012/08/05 2:23:38 ET]
Table 'Whirlpool' 9-max Seat #1 is the button
Seat 1: AVerdonk ($24.66 in chips) 
Seat 2: 1Karina1 ($25 in chips) 
Seat 3: jacquelinewu ($72.76 in chips) 
Seat 4: chiyuki ($29.46 in chips) 
Seat 5: nastya040 ($19.18 in chips) 
Seat 6: svg51 ($11.19 in chips) 
Seat 7: Yoshimac ($21.63 in chips) 
Seat 8: ChrisCDee ($69.59 in chips) 
Seat 9: kamikkaze ($24.44 in chips) 
1Karina1: posts small blind $0.10
jacquelinewu: posts big blind $0.25
*** HOLE CARDS ***
Dealt to chiyuki [Kd As]
chiyuki: raises $0.50 to $0.75
nastya040: folds 
svg51: folds 
Yoshimac: folds 
ChrisCDee: folds 
kamikkaze: folds 
AVerdonk: folds 
1Karina1: calls $0.65
jacquelinewu: folds 
*** FLOP *** [6h 3h Js]
1Karina1: bets $1.25
chiyuki: folds 
Uncalled bet ($1.25) returned to 1Karina1
1Karina1 collected $1.67 from pot
1Karina1: doesn't show hand 
*** SUMMARY ***
Total pot $1.75 | Rake $0.08 
Board [6h 3h Js]
Seat 1: AVerdonk (button) folded before Flop (didn't bet)
Seat 2: 1Karina1 (small blind) collected ($1.67)
Seat 3: jacquelinewu (big blind) folded before Flop
Seat 4: chiyuki folded on the Flop
Seat 5: nastya040 folded before Flop (didn't bet)
Seat 6: svg51 folded before Flop (didn't bet)
Seat 7: Yoshimac folded before Flop (didn't bet)
Seat 8: ChrisCDee folded before Flop (didn't bet)
Seat 9: kamikkaze folded before Flop (didn't bet)



PokerStars Zoom Hand #84300384712:  Hold'em No Limit ($0.10/$0.25) - 2012/08/05 15:24:32 JST [2012/08/05 2:24:32 ET]
Table 'Whirlpool' 9-max Seat #1 is the button
Seat 1: 1Karina1 ($27.31 in chips) 
Seat 2: Nerkit ($12.50 in chips) 
Seat 3: Dan Royal ($26.03 in chips) 
Seat 4: Gichboy ($12.74 in chips) 
Seat 5: chiyuki ($28.71 in chips) 
Seat 6: ygoegoe ($43.10 in chips) 
Seat 7: kwkim73 ($26.95 in chips) 
Seat 8: dergeb ($23.56 in chips) 
Seat 9: GovGus ($29.35 in chips) 
Nerkit: posts small blind $0.10
Dan Royal: posts big blind $0.25
*** HOLE CARDS ***
Dealt to chiyuki [Kh 3h]
Gichboy: folds 
chiyuki: folds 
ygoegoe: folds 
kwkim73: folds 
dergeb: folds 
GovGus: folds 
1Karina1: folds 
Nerkit: raises $0.50 to $0.75
Dan Royal: folds 
Uncalled bet ($0.50) returned to Nerkit
Nerkit collected $0.50 from pot
Nerkit: doesn't show hand 
*** SUMMARY ***
Total pot $0.50 | Rake $0 
Seat 1: 1Karina1 (button) folded before Flop (didn't bet)
Seat 2: Nerkit (small blind) collected ($0.50)
Seat 3: Dan Royal (big blind) folded before Flop
Seat 4: Gichboy folded before Flop (didn't bet)
Seat 5: chiyuki folded before Flop (didn't bet)
Seat 6: ygoegoe folded before Flop (didn't bet)
Seat 7: kwkim73 folded before Flop (didn't bet)
Seat 8: dergeb folded before Flop (didn't bet)
Seat 9: GovGus folded before Flop (didn't bet)



PokerStars Zoom Hand #84300381337:  Hold'em No Limit ($0.10/$0.25) - 2012/08/05 15:24:18 JST [2012/08/05 2:24:18 ET]
Table 'Whirlpool' 9-max Seat #1 is the button
Seat 1: chiyuki ($28.71 in chips) 
Seat 2: crazycrown1 ($12.25 in chips) 
Seat 3: kwkim73 ($26.85 in chips) 
Seat 4: mjmichi ($49.33 in chips) 
Seat 5: Alvinpe85 ($55.98 in chips) 
Seat 6: nice.franki ($12.50 in chips) 
Seat 7: Silveystryk ($25 in chips) 
Seat 8: seula i ($26.13 in chips) 
Seat 9: Rilko1975 ($23.96 in chips) 
crazycrown1: posts small blind $0.10
kwkim73: posts big blind $0.25
*** HOLE CARDS ***
Dealt to chiyuki [7c Qs]
mjmichi: folds 
Alvinpe85: folds 
nice.franki: folds 
Silveystryk: folds 
seula i: raises $0.50 to $0.75
Rilko1975: folds 
chiyuki: folds 
crazycrown1: folds 
kwkim73: calls $0.50
*** FLOP *** [6d Jc 8c]
kwkim73: checks 
seula i: bets $1.25
kwkim73: folds 
Uncalled bet ($1.25) returned to seula i
seula i collected $1.53 from pot
seula i: doesn't show hand 
*** SUMMARY ***
Total pot $1.60 | Rake $0.07 
Board [6d Jc 8c]
Seat 1: chiyuki (button) folded before Flop (didn't bet)
Seat 2: crazycrown1 (small blind) folded before Flop
Seat 3: kwkim73 (big blind) folded on the Flop
Seat 4: mjmichi folded before Flop (didn't bet)
Seat 5: Alvinpe85 folded before Flop (didn't bet)
Seat 6: nice.franki folded before Flop (didn't bet)
Seat 7: Silveystryk folded before Flop (didn't bet)
Seat 8: seula i collected ($1.53)
Seat 9: Rilko1975 folded before Flop (didn't bet)



PokerStars Zoom Hand #84300391605:  Hold'em No Limit ($0.10/$0.25) - 2012/08/05 15:24:59 JST [2012/08/05 2:24:59 ET]
Table 'Whirlpool' 9-max Seat #1 is the button
Seat 1: Nagus3x ($26.14 in chips) 
Seat 2: nice.franki ($13 in chips) 
Seat 3: chiyuki ($28.71 in chips) 
Seat 4: svg51 ($14.43 in chips) 
Seat 5: phate-1up ($53.11 in chips) 
Seat 6: Dejacob ($25 in chips) 
Seat 7: DutchShultzs ($42.61 in chips) 
Seat 8: Alvinpe85 ($55.36 in chips) 
Seat 9: Ellen1947 ($23.85 in chips) 
nice.franki: posts small blind $0.10
chiyuki: posts big blind $0.25
*** HOLE CARDS ***
Dealt to chiyuki [Jd Qs]
svg51: folds 
phate-1up: folds 
Dejacob: folds 
DutchShultzs: folds 
Alvinpe85: folds 
Ellen1947: raises $0.50 to $0.75
Nagus3x: folds 
nice.franki: folds 
chiyuki: folds 
Uncalled bet ($0.50) returned to Ellen1947
Ellen1947 collected $0.60 from pot
Ellen1947: doesn't show hand 
*** SUMMARY ***
Total pot $0.60 | Rake $0 
Seat 1: Nagus3x (button) folded before Flop (didn't bet)
Seat 2: nice.franki (small blind) folded before Flop
Seat 3: chiyuki (big blind) folded before Flop
Seat 4: svg51 folded before Flop (didn't bet)
Seat 5: phate-1up folded before Flop (didn't bet)
Seat 6: Dejacob folded before Flop (didn't bet)
Seat 7: DutchShultzs folded before Flop (didn't bet)
Seat 8: Alvinpe85 folded before Flop (didn't bet)
Seat 9: Ellen1947 collected ($0.60)



PokerStars Zoom Hand #84300387003:  Hold'em No Limit ($0.10/$0.25) - 2012/08/05 15:24:41 JST [2012/08/05 2:24:41 ET]
Table 'Whirlpool' 9-max Seat #1 is the button
Seat 1: Tom1999 ($8.97 in chips) 
Seat 2: dergeb ($23.56 in chips) 
Seat 3: jacquelinewu ($33.65 in chips) 
Seat 4: nice.franki ($13.25 in chips) 
Seat 5: phate-1up ($42.17 in chips) 
Seat 6: deadmoneykid ($24.13 in chips) 
Seat 7: chiyuki ($28.71 in chips) 
Seat 8: Ellen1947 ($23.85 in chips) 
Seat 9: Tidder ($24.15 in chips) 
dergeb: posts small blind $0.10
jacquelinewu: posts big blind $0.25
*** HOLE CARDS ***
Dealt to chiyuki [6s 7d]
nice.franki: folds 
phate-1up: folds 
deadmoneykid: folds 
chiyuki: folds 
Ellen1947: folds 
Tidder: folds 
Tom1999: raises $0.50 to $0.75
dergeb: raises $0.75 to $1.50
jacquelinewu: folds 
Tom1999: calls $0.75
*** FLOP *** [Kh 2h 6h]
dergeb: bets $1.55
Tom1999: folds 
Uncalled bet ($1.55) returned to dergeb
dergeb collected $3.10 from pot
dergeb: doesn't show hand 
*** SUMMARY ***
Total pot $3.25 | Rake $0.15 
Board [Kh 2h 6h]
Seat 1: Tom1999 (button) folded on the Flop
Seat 2: dergeb (small blind) collected ($3.10)
Seat 3: jacquelinewu (big blind) folded before Flop
Seat 4: nice.franki folded before Flop (didn't bet)
Seat 5: phate-1up folded before Flop (didn't bet)
Seat 6: deadmoneykid folded before Flop (didn't bet)
Seat 7: chiyuki folded before Flop (didn't bet)
Seat 8: Ellen1947 folded before Flop (didn't bet)
Seat 9: Tidder folded before Flop (didn't bet)



PokerStars Zoom Hand #84300400059:  Hold'em No Limit ($0.10/$0.25) - 2012/08/05 15:25:32 JST [2012/08/05 2:25:32 ET]
Table 'Whirlpool' 9-max Seat #1 is the button
Seat 1: kamikkaze ($12.15 in chips) 
Seat 2: chiyuki ($28.46 in chips) 
Seat 3: Grishukps ($12.85 in chips) 
Seat 4: snejokCoxx ($15 in chips) 
Seat 5: ChrisCDee ($68.74 in chips) 
Seat 6: masterkoolb ($13.45 in chips) 
Seat 7: NuMetal88 ($26.03 in chips) 
Seat 8: ZhukOFFskI ($36.33 in chips) 
Seat 9: cofla tito ($14.31 in chips) 
chiyuki: posts small blind $0.10
Grishukps: posts big blind $0.25
*** HOLE CARDS ***
Dealt to chiyuki [5h 8d]
snejokCoxx: folds 
ChrisCDee: folds 
masterkoolb: folds 
NuMetal88: folds 
ZhukOFFskI: folds 
cofla tito: folds 
kamikkaze: folds 
chiyuki: folds 
Uncalled bet ($0.15) returned to Grishukps
Grishukps collected $0.20 from pot
Grishukps: doesn't show hand 
*** SUMMARY ***
Total pot $0.20 | Rake $0 
Seat 1: kamikkaze (button) folded before Flop (didn't bet)
Seat 2: chiyuki (small blind) folded before Flop
Seat 3: Grishukps (big blind) collected ($0.20)
Seat 4: snejokCoxx folded before Flop (didn't bet)
Seat 5: ChrisCDee folded before Flop (didn't bet)
Seat 6: masterkoolb folded before Flop (didn't bet)
Seat 7: NuMetal88 folded before Flop (didn't bet)
Seat 8: ZhukOFFskI folded before Flop (didn't bet)
Seat 9: cofla tito folded before Flop (didn't bet)



PokerStars Zoom Hand #84300398574:  Hold'em No Limit ($0.10/$0.25) - 2012/08/05 15:25:26 JST [2012/08/05 2:25:26 ET]
Table 'Whirlpool' 9-max Seat #1 is the button
Seat 1: HighDuka ($41.42 in chips) 
Seat 2: phate-1up ($42.17 in chips) 
Seat 3: 4plankton ($20.66 in chips) 
Seat 4: Tom1999 ($7.47 in chips) 
Seat 5: GSDP ($22.30 in chips) 
Seat 6: nice.franki ($11.80 in chips) 
Seat 7: masterkoolb ($13.45 in chips) 
Seat 8: chiyuki ($28.46 in chips) 
Seat 9: KeLevro0 ($12.89 in chips) 
phate-1up: posts small blind $0.10
4plankton: posts big blind $0.25
*** HOLE CARDS ***
Dealt to chiyuki [6s Jc]
Tom1999: folds 
GSDP: calls $0.25
nice.franki: folds 
masterkoolb: folds 
chiyuki: folds 
KeLevro0: folds 
HighDuka: calls $0.25
phate-1up: folds 
4plankton: checks 
*** FLOP *** [Qh Kd 6c]
4plankton: checks 
GSDP: checks 
HighDuka: bets $0.50
4plankton: folds 
GSDP: folds 
Uncalled bet ($0.50) returned to HighDuka
HighDuka collected $0.81 from pot
HighDuka: doesn't show hand 
*** SUMMARY ***
Total pot $0.85 | Rake $0.04 
Board [Qh Kd 6c]
Seat 1: HighDuka (button) collected ($0.81)
Seat 2: phate-1up (small blind) folded before Flop
Seat 3: 4plankton (big blind) folded on the Flop
Seat 4: Tom1999 folded before Flop (didn't bet)
Seat 5: GSDP folded on the Flop
Seat 6: nice.franki folded before Flop (didn't bet)
Seat 7: masterkoolb folded before Flop (didn't bet)
Seat 8: chiyuki folded before Flop (didn't bet)
Seat 9: KeLevro0 folded before Flop (didn't bet)



PokerStars Zoom Hand #84300402402:  Hold'em No Limit ($0.10/$0.25) - 2012/08/05 15:25:41 JST [2012/08/05 2:25:41 ET]
Table 'Whirlpool' 9-max Seat #1 is the button
Seat 1: chiyuki ($28.36 in chips) 
Seat 2: Rilko1975 ($22.56 in chips) 
Seat 3: Tidder ($23.75 in chips) 
Seat 4: wildy29 ($24.50 in chips) 
Seat 5: Perstenev ($10.95 in chips) 
Seat 6: ChrisCDee ($25 in chips) 
Seat 7: seula i ($26.06 in chips) 
Seat 8: kamikkaze ($12.15 in chips) 
Seat 9: snejokCoxx ($12.02 in chips) 
Rilko1975: posts small blind $0.10
Tidder: posts big blind $0.25
*** HOLE CARDS ***
Dealt to chiyuki [Qh 5s]
wildy29: folds 
Perstenev: folds 
ChrisCDee: folds 
seula i: folds 
kamikkaze: raises $0.38 to $0.63
snejokCoxx: folds 
chiyuki: folds 
Rilko1975: folds 
Tidder: folds 
Uncalled bet ($0.38) returned to kamikkaze
kamikkaze collected $0.60 from pot
kamikkaze: doesn't show hand 
*** SUMMARY ***
Total pot $0.60 | Rake $0 
Seat 1: chiyuki (button) folded before Flop (didn't bet)
Seat 2: Rilko1975 (small blind) folded before Flop
Seat 3: Tidder (big blind) folded before Flop
Seat 4: wildy29 folded before Flop (didn't bet)
Seat 5: Perstenev folded before Flop (didn't bet)
Seat 6: ChrisCDee folded before Flop (didn't bet)
Seat 7: seula i folded before Flop (didn't bet)
Seat 8: kamikkaze collected ($0.60)
Seat 9: snejokCoxx folded before Flop (didn't bet)



PokerStars Zoom Hand #84300400864:  Hold'em No Limit ($0.10/$0.25) - 2012/08/05 15:25:35 JST [2012/08/05 2:25:35 ET]
Table 'Whirlpool' 9-max Seat #1 is the button
Seat 1: Nerkit ($12.69 in chips) 
Seat 2: turbotom122 ($23.76 in chips) 
Seat 3: phate-1up ($53.11 in chips) 
Seat 4: chiyuki ($28.36 in chips) 
Seat 5: wildy29 ($24.50 in chips) 
Seat 6: kamikkaze ($12.15 in chips) 
Seat 7: nice.franki ($12.90 in chips) 
Seat 8: troublesomm ($37.09 in chips) 
Seat 9: panaam ($19.56 in chips) 
turbotom122: posts small blind $0.10
phate-1up: posts big blind $0.25
*** HOLE CARDS ***
Dealt to chiyuki [Ac 7d]
chiyuki: folds 
wildy29: folds 
kamikkaze: raises $0.38 to $0.63
nice.franki: folds 
troublesomm: folds 
panaam: folds 
Nerkit: raises $1.37 to $2
turbotom122: folds 
phate-1up: folds 
kamikkaze: calls $1.37
*** FLOP *** [Ks 8d Qd]
kamikkaze: checks 
Nerkit: bets $2.25
kamikkaze: folds 
Uncalled bet ($2.25) returned to Nerkit
Nerkit collected $4.15 from pot
Nerkit: doesn't show hand 
*** SUMMARY ***
Total pot $4.35 | Rake $0.20 
Board [Ks 8d Qd]
Seat 1: Nerkit (button) collected ($4.15)
Seat 2: turbotom122 (small blind) folded before Flop
Seat 3: phate-1up (big blind) folded before Flop
Seat 4: chiyuki folded before Flop (didn't bet)
Seat 5: wildy29 folded before Flop (didn't bet)
Seat 6: kamikkaze folded on the Flop
Seat 7: nice.franki folded before Flop (didn't bet)
Seat 8: troublesomm folded before Flop (didn't bet)
Seat 9: panaam folded before Flop (didn't bet)



PokerStars Zoom Hand #84300397272:  Hold'em No Limit ($0.10/$0.25) - 2012/08/05 15:25:21 JST [2012/08/05 2:25:21 ET]
Table 'Whirlpool' 9-max Seat #1 is the button
Seat 1: ViTiV2010 ($12.85 in chips) 
Seat 2: Silveystryk ($29.31 in chips) 
Seat 3: DutchShultzs ($32.77 in chips) 
Seat 4: 4plankton ($20.66 in chips) 
Seat 5: KeLevro0 ($12.89 in chips) 
Seat 6: svg51 ($14.18 in chips) 
Seat 7: phate-1up ($53.11 in chips) 
Seat 8: Dejacob ($25 in chips) 
Seat 9: chiyuki ($28.46 in chips) 
Silveystryk: posts small blind $0.10
DutchShultzs: posts big blind $0.25
*** HOLE CARDS ***
Dealt to chiyuki [7h 9s]
4plankton: folds 
KeLevro0: folds 
svg51: calls $0.25
phate-1up: folds 
Dejacob: folds 
chiyuki: folds 
ViTiV2010: folds 
Silveystryk: folds 
DutchShultzs: checks 
*** FLOP *** [2d Ad Td]
DutchShultzs: bets $0.45
svg51: calls $0.45
*** TURN *** [2d Ad Td] [Qc]
DutchShultzs: bets $1.10
svg51: calls $1.10
*** RIVER *** [2d Ad Td Qc] [6h]
DutchShultzs: bets $3.30
svg51: calls $3.30
*** SHOW DOWN ***
DutchShultzs: shows [5d 6d] (a flush, Ace high)
svg51: mucks hand 
DutchShultzs collected $9.84 from pot
*** SUMMARY ***
Total pot $10.30 | Rake $0.46 
Board [2d Ad Td Qc 6h]
Seat 1: ViTiV2010 (button) folded before Flop (didn't bet)
Seat 2: Silveystryk (small blind) folded before Flop
Seat 3: DutchShultzs (big blind) showed [5d 6d] and won ($9.84) with a flush, Ace high
Seat 4: 4plankton folded before Flop (didn't bet)
Seat 5: KeLevro0 folded before Flop (didn't bet)
Seat 6: svg51 mucked [Kc Jc]
Seat 7: phate-1up folded before Flop (didn't bet)
Seat 8: Dejacob folded before Flop (didn't bet)
Seat 9: chiyuki folded before Flop (didn't bet)



PokerStars Zoom Hand #84300408211:  Hold'em No Limit ($0.10/$0.25) - 2012/08/05 15:26:05 JST [2012/08/05 2:26:05 ET]
Table 'Whirlpool' 9-max Seat #1 is the button
Seat 1: Dan Royal ($30.01 in chips) 
Seat 2: seula i ($25.81 in chips) 
Seat 3: INSP!RON ($41.65 in chips) 
Seat 4: chiyuki ($28.36 in chips) 
Seat 5: Silveystryk ($25.20 in chips) 
Seat 6: ChrisCDee ($68.49 in chips) 
Seat 7: KeLevro0 ($11.86 in chips) 
Seat 8: kamikkaze ($10.15 in chips) 
Seat 9: Nerkit ($12.40 in chips) 
seula i: posts small blind $0.10
INSP!RON: posts big blind $0.25
*** HOLE CARDS ***
Dealt to chiyuki [Js 5s]
chiyuki: folds 
Silveystryk: folds 
ChrisCDee: folds 
KeLevro0: folds 
kamikkaze: folds 
Nerkit: folds 
Dan Royal: folds 
seula i: folds 
Uncalled bet ($0.15) returned to INSP!RON
INSP!RON collected $0.20 from pot
INSP!RON: doesn't show hand 
*** SUMMARY ***
Total pot $0.20 | Rake $0 
Seat 1: Dan Royal (button) folded before Flop (didn't bet)
Seat 2: seula i (small blind) folded before Flop
Seat 3: INSP!RON (big blind) collected ($0.20)
Seat 4: chiyuki folded before Flop (didn't bet)
Seat 5: Silveystryk folded before Flop (didn't bet)
Seat 6: ChrisCDee folded before Flop (didn't bet)
Seat 7: KeLevro0 folded before Flop (didn't bet)
Seat 8: kamikkaze folded before Flop (didn't bet)
Seat 9: Nerkit folded before Flop (didn't bet)



PokerStars Zoom Hand #84300406162:  Hold'em No Limit ($0.10/$0.25) - 2012/08/05 15:25:57 JST [2012/08/05 2:25:57 ET]
Table 'Whirlpool' 9-max Seat #1 is the button
Seat 1: kwkim73 ($25.10 in chips) 
Seat 2: Grishukps ($12.95 in chips) 
Seat 3: hirozo ($90.39 in chips) 
Seat 4: ZhukOFFskI ($36.23 in chips) 
Seat 5: AAAKK777 ($32.36 in chips) 
Seat 6: chiyuki ($28.36 in chips) 
Seat 7: Dan Royal ($30.01 in chips) 
Seat 8: therati ($21.75 in chips) 
Seat 9: GSDP ($21.94 in chips) 
Grishukps: posts small blind $0.10
hirozo: posts big blind $0.25
*** HOLE CARDS ***
Dealt to chiyuki [4h 2s]
ZhukOFFskI: folds 
AAAKK777: raises $0.75 to $1
chiyuki: folds 
Dan Royal: folds 
therati: folds 
GSDP: calls $1
kwkim73: folds 
Grishukps: folds 
hirozo: folds 
*** FLOP *** [Qs Jh 7h]
AAAKK777: bets $1
GSDP: raises $2 to $3
AAAKK777: calls $2
*** TURN *** [Qs Jh 7h] [8h]
AAAKK777: checks 
GSDP: checks 
*** RIVER *** [Qs Jh 7h 8h] [2c]
AAAKK777: checks 
GSDP: checks 
*** SHOW DOWN ***
AAAKK777: shows [Ac Kh] (high card Ace)
GSDP: shows [Qh Kd] (a pair of Queens)
GSDP collected $7.97 from pot
*** SUMMARY ***
Total pot $8.35 | Rake $0.38 
Board [Qs Jh 7h 8h 2c]
Seat 1: kwkim73 (button) folded before Flop (didn't bet)
Seat 2: Grishukps (small blind) folded before Flop
Seat 3: hirozo (big blind) folded before Flop
Seat 4: ZhukOFFskI folded before Flop (didn't bet)
Seat 5: AAAKK777 showed [Ac Kh] and lost with high card Ace
Seat 6: chiyuki folded before Flop (didn't bet)
Seat 7: Dan Royal folded before Flop (didn't bet)
Seat 8: therati folded before Flop (didn't bet)
Seat 9: GSDP showed [Qh Kd] and won ($7.97) with a pair of Queens



PokerStars Zoom Hand #84300408944:  Hold'em No Limit ($0.10/$0.25) - 2012/08/05 15:26:08 JST [2012/08/05 2:26:08 ET]
Table 'Whirlpool' 9-max Seat #1 is the button
Seat 1: Nerkit ($12.40 in chips) 
Seat 2: nice.franki ($12.90 in chips) 
Seat 3: NuMetal88 ($25.25 in chips) 
Seat 4: Perstenev ($13 in chips) 
Seat 5: troublesomm ($25 in chips) 
Seat 6: chiyuki ($28.36 in chips) 
Seat 7: Rilko1975 ($35.11 in chips) 
Seat 8: ygoegoe ($43.10 in chips) 
Seat 9: Yoshimac ($18.53 in chips) 
nice.franki: posts small blind $0.10
NuMetal88: posts big blind $0.25
*** HOLE CARDS ***
Dealt to chiyuki [6h 7d]
Perstenev: folds 
troublesomm: folds 
chiyuki: folds 
Rilko1975: raises $0.25 to $0.50
ygoegoe: raises $1 to $1.50
Yoshimac: folds 
Nerkit: folds 
nice.franki: folds 
NuMetal88: folds 
Rilko1975: folds 
Uncalled bet ($1) returned to ygoegoe
ygoegoe collected $1.35 from pot
ygoegoe: doesn't show hand 
*** SUMMARY ***
Total pot $1.35 | Rake $0 
Seat 1: Nerkit (button) folded before Flop (didn't bet)
Seat 2: nice.franki (small blind) folded before Flop
Seat 3: NuMetal88 (big blind) folded before Flop
Seat 4: Perstenev folded before Flop (didn't bet)
Seat 5: troublesomm folded before Flop (didn't bet)
Seat 6: chiyuki folded before Flop (didn't bet)
Seat 7: Rilko1975 folded before Flop
Seat 8: ygoegoe collected ($1.35)
Seat 9: Yoshimac folded before Flop (didn't bet)



PokerStars Zoom Hand #84300412319:  Hold'em No Limit ($0.10/$0.25) - 2012/08/05 15:26:21 JST [2012/08/05 2:26:21 ET]
Table 'Whirlpool' 9-max Seat #1 is the button
Seat 1: silvno31 ($44.96 in chips) 
Seat 2: Tom1999 ($2.22 in chips) 
Seat 3: ZhukOFFskI ($36.23 in chips) 
Seat 4: 4ydo yogurt ($30.68 in chips) 
Seat 5: snejokCoxx ($11.62 in chips) 
Seat 6: Yoshimac ($18.53 in chips) 
Seat 7: kaplya2010 ($23.26 in chips) 
Seat 8: nastya040 ($16.80 in chips) 
Seat 9: chiyuki ($28.36 in chips) 
Tom1999: posts small blind $0.10
ZhukOFFskI: posts big blind $0.25
*** HOLE CARDS ***
Dealt to chiyuki [Jc Qc]
4ydo yogurt: folds 
snejokCoxx: folds 
Yoshimac: folds 
kaplya2010: folds 
nastya040: folds 
chiyuki: raises $0.50 to $0.75
silvno31: folds 
Tom1999: folds 
ZhukOFFskI: folds 
Uncalled bet ($0.50) returned to chiyuki
chiyuki collected $0.60 from pot
chiyuki: doesn't show hand 
*** SUMMARY ***
Total pot $0.60 | Rake $0 
Seat 1: silvno31 (button) folded before Flop (didn't bet)
Seat 2: Tom1999 (small blind) folded before Flop
Seat 3: ZhukOFFskI (big blind) folded before Flop
Seat 4: 4ydo yogurt folded before Flop (didn't bet)
Seat 5: snejokCoxx folded before Flop (didn't bet)
Seat 6: Yoshimac folded before Flop (didn't bet)
Seat 7: kaplya2010 folded before Flop (didn't bet)
Seat 8: nastya040 folded before Flop (didn't bet)
Seat 9: chiyuki collected ($0.60)



PokerStars Zoom Hand #84300419107:  Hold'em No Limit ($0.10/$0.25) - 2012/08/05 15:26:48 JST [2012/08/05 2:26:48 ET]
Table 'Whirlpool' 9-max Seat #1 is the button
Seat 1: nice.franki ($12.55 in chips) 
Seat 2: God)Squall ($25.23 in chips) 
Seat 3: chiyuki ($28.71 in chips) 
Seat 4: troublesomm ($28.01 in chips) 
Seat 5: GovGus ($38.51 in chips) 
Seat 6: Saruotiss ($61.86 in chips) 
Seat 7: fima00000007 ($9.84 in chips) 
Seat 8: ZhukOFFskI ($75.58 in chips) 
Seat 9: Dan Royal ($30.11 in chips) 
God)Squall: posts small blind $0.10
chiyuki: posts big blind $0.25
*** HOLE CARDS ***
Dealt to chiyuki [5s 5h]
troublesomm: folds 
GovGus: folds 
Saruotiss: folds 
fima00000007: folds 
ZhukOFFskI: folds 
Dan Royal: raises $0.50 to $0.75
nice.franki: folds 
God)Squall: calls $0.65
chiyuki: calls $0.50
*** FLOP *** [2h Ac Tc]
God)Squall: checks 
chiyuki: checks 
Dan Royal: bets $1
God)Squall: folds 
chiyuki: folds 
Uncalled bet ($1) returned to Dan Royal
Dan Royal collected $2.15 from pot
Dan Royal: doesn't show hand 
*** SUMMARY ***
Total pot $2.25 | Rake $0.10 
Board [2h Ac Tc]
Seat 1: nice.franki (button) folded before Flop (didn't bet)
Seat 2: God)Squall (small blind) folded on the Flop
Seat 3: chiyuki (big blind) folded on the Flop
Seat 4: troublesomm folded before Flop (didn't bet)
Seat 5: GovGus folded before Flop (didn't bet)
Seat 6: Saruotiss folded before Flop (didn't bet)
Seat 7: fima00000007 folded before Flop (didn't bet)
Seat 8: ZhukOFFskI folded before Flop (didn't bet)
Seat 9: Dan Royal collected ($2.15)



PokerStars Zoom Hand #84300433325:  Hold'em No Limit ($0.10/$0.25) - 2012/08/05 15:27:45 JST [2012/08/05 2:27:45 ET]
Table 'Whirlpool' 9-max Seat #1 is the button
Seat 1: wildy29 ($41.59 in chips) 
Seat 2: Dan Royal ($31.51 in chips) 
Seat 3: opie62 ($25 in chips) 
Seat 4: River_GmbH ($15.85 in chips) 
Seat 5: Nerkit ($13.98 in chips) 
Seat 6: Alvinpe85 ($55.19 in chips) 
Seat 7: chiyuki ($27.96 in chips) 
Seat 8: ViTiV2010 ($12.70 in chips) 
Seat 9: Grishukps ($12.50 in chips) 
Dan Royal: posts small blind $0.10
opie62: posts big blind $0.25
*** HOLE CARDS ***
Dealt to chiyuki [6c Jc]
River_GmbH: folds 
Nerkit: folds 
Alvinpe85: folds 
chiyuki: folds 
ViTiV2010: folds 
Grishukps: folds 
wildy29: folds 
Dan Royal: folds 
Uncalled bet ($0.15) returned to opie62
opie62 collected $0.20 from pot
opie62: doesn't show hand 
*** SUMMARY ***
Total pot $0.20 | Rake $0 
Seat 1: wildy29 (button) folded before Flop (didn't bet)
Seat 2: Dan Royal (small blind) folded before Flop
Seat 3: opie62 (big blind) collected ($0.20)
Seat 4: River_GmbH folded before Flop (didn't bet)
Seat 5: Nerkit folded before Flop (didn't bet)
Seat 6: Alvinpe85 folded before Flop (didn't bet)
Seat 7: chiyuki folded before Flop (didn't bet)
Seat 8: ViTiV2010 folded before Flop (didn't bet)
Seat 9: Grishukps folded before Flop (didn't bet)



PokerStars Zoom Hand #84300432557:  Hold'em No Limit ($0.10/$0.25) - 2012/08/05 15:27:42 JST [2012/08/05 2:27:42 ET]
Table 'Whirlpool' 9-max Seat #1 is the button
Seat 1: phate-1up ($41.22 in chips) 
Seat 2: hirozo ($85.21 in chips) 
Seat 3: ziggzagg77 ($16.58 in chips) 
Seat 4: AntoineHunt ($41.19 in chips) 
Seat 5: nice.franki ($12.55 in chips) 
Seat 6: kwkim73 ($25.60 in chips) 
Seat 7: Lasutchik ($69.54 in chips) 
Seat 8: chiyuki ($27.96 in chips) 
Seat 9: KeLevro0 ($11.70 in chips) 
hirozo: posts small blind $0.10
ziggzagg77: posts big blind $0.25
*** HOLE CARDS ***
Dealt to chiyuki [Ts 2s]
AntoineHunt: folds 
nice.franki: folds 
kwkim73: folds 
Lasutchik: folds 
chiyuki: folds 
KeLevro0: folds 
phate-1up: raises $0.50 to $0.75
hirozo: folds 
ziggzagg77: calls $0.50
*** FLOP *** [2h 8d 9c]
ziggzagg77: checks 
phate-1up: bets $1.50
ziggzagg77: raises $3.50 to $5
phate-1up: raises $11 to $16
ziggzagg77: folds 
Uncalled bet ($11) returned to phate-1up
phate-1up collected $11.08 from pot
phate-1up: doesn't show hand 
*** SUMMARY ***
Total pot $11.60 | Rake $0.52 
Board [2h 8d 9c]
Seat 1: phate-1up (button) collected ($11.08)
Seat 2: hirozo (small blind) folded before Flop
Seat 3: ziggzagg77 (big blind) folded on the Flop
Seat 4: AntoineHunt folded before Flop (didn't bet)
Seat 5: nice.franki folded before Flop (didn't bet)
Seat 6: kwkim73 folded before Flop (didn't bet)
Seat 7: Lasutchik folded before Flop (didn't bet)
Seat 8: chiyuki folded before Flop (didn't bet)
Seat 9: KeLevro0 folded before Flop (didn't bet)



PokerStars Zoom Hand #84300438340:  Hold'em No Limit ($0.10/$0.25) - 2012/08/05 15:28:05 JST [2012/08/05 2:28:05 ET]
Table 'Whirlpool' 9-max Seat #1 is the button
Seat 1: KeLevro0 ($12.15 in chips) 
Seat 2: chiyuki ($27.96 in chips) 
Seat 3: troublesomm ($28.15 in chips) 
Seat 4: nice.franki ($10.40 in chips) 
Seat 5: Grishukps ($12.50 in chips) 
Seat 6: seula i ($25.46 in chips) 
Seat 7: Perstenev ($10.35 in chips) 
Seat 8: KrystalAA ($30.32 in chips) 
Seat 9: Ellen1947 ($26.12 in chips) 
chiyuki: posts small blind $0.10
troublesomm: posts big blind $0.25
*** HOLE CARDS ***
Dealt to chiyuki [7d 4d]
nice.franki: folds 
Grishukps: folds 
seula i: raises $0.50 to $0.75
Perstenev: folds 
KrystalAA: folds 
Ellen1947: folds 
KeLevro0: raises $1.75 to $2.50
chiyuki: folds 
troublesomm: folds 
seula i: folds 
Uncalled bet ($1.75) returned to KeLevro0
KeLevro0 collected $1.85 from pot
KeLevro0: doesn't show hand 
*** SUMMARY ***
Total pot $1.85 | Rake $0 
Seat 1: KeLevro0 (button) collected ($1.85)
Seat 2: chiyuki (small blind) folded before Flop
Seat 3: troublesomm (big blind) folded before Flop
Seat 4: nice.franki folded before Flop (didn't bet)
Seat 5: Grishukps folded before Flop (didn't bet)
Seat 6: seula i folded before Flop
Seat 7: Perstenev folded before Flop (didn't bet)
Seat 8: KrystalAA folded before Flop (didn't bet)
Seat 9: Ellen1947 folded before Flop (didn't bet)



PokerStars Zoom Hand #84300434836:  Hold'em No Limit ($0.10/$0.25) - 2012/08/05 15:27:51 JST [2012/08/05 2:27:51 ET]
Table 'Whirlpool' 9-max Seat #1 is the button
Seat 1: GSDP ($21.70 in chips) 
Seat 2: River_GmbH ($15.85 in chips) 
Seat 3: INSP!RON ($42.50 in chips) 
Seat 4: troublesomm ($36.74 in chips) 
Seat 5: chiyuki ($27.96 in chips) 
Seat 6: Silveystryk ($38.12 in chips) 
Seat 7: 4plankton ($19.81 in chips) 
Seat 8: Grishukps ($12.50 in chips) 
Seat 9: drunk_bender ($17.25 in chips) 
River_GmbH: posts small blind $0.10
INSP!RON: posts big blind $0.25
*** HOLE CARDS ***
Dealt to chiyuki [Ad 2d]
troublesomm: folds 
chiyuki: folds 
Silveystryk: folds 
4plankton: calls $0.25
Grishukps: folds 
drunk_bender: folds 
GSDP: calls $0.25
River_GmbH: calls $0.15
INSP!RON: checks 
*** FLOP *** [Qs Ts 8h]
River_GmbH: checks 
INSP!RON: checks 
4plankton: bets $0.25
GSDP: calls $0.25
River_GmbH: folds 
INSP!RON: folds 
*** TURN *** [Qs Ts 8h] [3d]
4plankton: bets $0.25
GSDP: calls $0.25
*** RIVER *** [Qs Ts 8h 3d] [Tc]
4plankton: checks 
GSDP: bets $1.25
4plankton: folds 
Uncalled bet ($1.25) returned to GSDP
GSDP collected $1.91 from pot
GSDP: doesn't show hand 
*** SUMMARY ***
Total pot $2 | Rake $0.09 
Board [Qs Ts 8h 3d Tc]
Seat 1: GSDP (button) collected ($1.91)
Seat 2: River_GmbH (small blind) folded on the Flop
Seat 3: INSP!RON (big blind) folded on the Flop
Seat 4: troublesomm folded before Flop (didn't bet)
Seat 5: chiyuki folded before Flop (didn't bet)
Seat 6: Silveystryk folded before Flop (didn't bet)
Seat 7: 4plankton folded on the River
Seat 8: Grishukps folded before Flop (didn't bet)
Seat 9: drunk_bender folded before Flop (didn't bet)



PokerStars Zoom Hand #84300440121:  Hold'em No Limit ($0.10/$0.25) - 2012/08/05 15:28:13 JST [2012/08/05 2:28:13 ET]
Table 'Whirlpool' 9-max Seat #1 is the button
Seat 1: chiyuki ($27.86 in chips) 
Seat 2: HighDuka ($40.23 in chips) 
Seat 3: ZhukOFFskI ($35.88 in chips) 
Seat 4: Grishukps ($12.50 in chips) 
Seat 5: JhonnyP1979 ($1.73 in chips) 
Seat 6: phate-1up ($52.41 in chips) 
Seat 7: deadmoneykid ($26.37 in chips) 
Seat 8: GSDP ($25.06 in chips) 
Seat 9: GovGus ($38.16 in chips) 
HighDuka: posts small blind $0.10
ZhukOFFskI: posts big blind $0.25
*** HOLE CARDS ***
Dealt to chiyuki [2c 6h]
Grishukps: folds 
JhonnyP1979: raises $1.48 to $1.73 and is all-in
phate-1up: calls $1.73
deadmoneykid: folds 
GSDP: folds 
GovGus: folds 
chiyuki: folds 
HighDuka: folds 
ZhukOFFskI: folds 
*** FLOP *** [6s Td 9c]
*** TURN *** [6s Td 9c] [Ah]
*** RIVER *** [6s Td 9c Ah] [Qd]
*** SHOW DOWN ***
JhonnyP1979: shows [3s As] (a pair of Aces)
phate-1up: shows [Jh Js] (a pair of Jacks)
JhonnyP1979 collected $3.64 from pot
*** SUMMARY ***
Total pot $3.81 | Rake $0.17 
Board [6s Td 9c Ah Qd]
Seat 1: chiyuki (button) folded before Flop (didn't bet)
Seat 2: HighDuka (small blind) folded before Flop
Seat 3: ZhukOFFskI (big blind) folded before Flop
Seat 4: Grishukps folded before Flop (didn't bet)
Seat 5: JhonnyP1979 showed [3s As] and won ($3.64) with a pair of Aces
Seat 6: phate-1up showed [Jh Js] and lost with a pair of Jacks
Seat 7: deadmoneykid folded before Flop (didn't bet)
Seat 8: GSDP folded before Flop (didn't bet)
Seat 9: GovGus folded before Flop (didn't bet)



PokerStars Zoom Hand #84300442690:  Hold'em No Limit ($0.10/$0.25) - 2012/08/05 15:28:23 JST [2012/08/05 2:28:23 ET]
Table 'Whirlpool' 9-max Seat #1 is the button
Seat 1: INSP!RON ($42.25 in chips) 
Seat 2: nastya040 ($15.90 in chips) 
Seat 3: Perstenev ($9 in chips) 
Seat 4: chiyuki ($27.86 in chips) 
Seat 5: Nerkit ($14.49 in chips) 
Seat 6: hirozo ($81.43 in chips) 
Seat 7: drunk_bender ($17.15 in chips) 
Seat 8: kwkim73 ($27.23 in chips) 
Seat 9: troublesomm ($36.39 in chips) 
nastya040: posts small blind $0.10
Perstenev: posts big blind $0.25
*** HOLE CARDS ***
Dealt to chiyuki [2c As]
chiyuki: folds 
Nerkit: raises $0.50 to $0.75
hirozo: folds 
drunk_bender: calls $0.75
kwkim73: folds 
troublesomm: folds 
INSP!RON: folds 
nastya040: folds 
Perstenev: folds 
*** FLOP *** [Qc 9c Qd]
Nerkit: bets $0.92
drunk_bender: folds 
Uncalled bet ($0.92) returned to Nerkit
Nerkit collected $1.77 from pot
Nerkit: doesn't show hand 
*** SUMMARY ***
Total pot $1.85 | Rake $0.08 
Board [Qc 9c Qd]
Seat 1: INSP!RON (button) folded before Flop (didn't bet)
Seat 2: nastya040 (small blind) folded before Flop
Seat 3: Perstenev (big blind) folded before Flop
Seat 4: chiyuki folded before Flop (didn't bet)
Seat 5: Nerkit collected ($1.77)
Seat 6: hirozo folded before Flop (didn't bet)
Seat 7: drunk_bender folded on the Flop
Seat 8: kwkim73 folded before Flop (didn't bet)
Seat 9: troublesomm folded before Flop (didn't bet)



PokerStars Zoom Hand #84300445653:  Hold'em No Limit ($0.10/$0.25) - 2012/08/05 15:28:35 JST [2012/08/05 2:28:35 ET]
Table 'Whirlpool' 9-max Seat #1 is the button
Seat 1: nice.franki ($11.80 in chips) 
Seat 2: seula i ($25 in chips) 
Seat 3: DutchShultzs ($43.93 in chips) 
Seat 4: NuMetal88 ($28.24 in chips) 
Seat 5: 1Karina1 ($25 in chips) 
Seat 6: deadmoneykid ($25.48 in chips) 
Seat 7: snejokCoxx ($10.27 in chips) 
Seat 8: chiyuki ($27.86 in chips) 
Seat 9: Vahe50 ($14.06 in chips) 
seula i: posts small blind $0.10
DutchShultzs: posts big blind $0.25
*** HOLE CARDS ***
Dealt to chiyuki [Qs Jd]
NuMetal88: folds 
1Karina1: folds 
deadmoneykid: folds 
snejokCoxx: folds 
chiyuki: folds 
Vahe50: raises $0.25 to $0.50
nice.franki: folds 
seula i: folds 
DutchShultzs: folds 
Uncalled bet ($0.25) returned to Vahe50
Vahe50 collected $0.60 from pot
Vahe50: doesn't show hand 
*** SUMMARY ***
Total pot $0.60 | Rake $0 
Seat 1: nice.franki (button) folded before Flop (didn't bet)
Seat 2: seula i (small blind) folded before Flop
Seat 3: DutchShultzs (big blind) folded before Flop
Seat 4: NuMetal88 folded before Flop (didn't bet)
Seat 5: 1Karina1 folded before Flop (didn't bet)
Seat 6: deadmoneykid folded before Flop (didn't bet)
Seat 7: snejokCoxx folded before Flop (didn't bet)
Seat 8: chiyuki folded before Flop (didn't bet)
Seat 9: Vahe50 collected ($0.60)



PokerStars Zoom Hand #84300446671:  Hold'em No Limit ($0.10/$0.25) - 2012/08/05 15:28:39 JST [2012/08/05 2:28:39 ET]
Table 'Whirlpool' 9-max Seat #1 is the button
Seat 1: Alvinpe85 ($54.84 in chips) 
Seat 2: kwkim73 ($25.35 in chips) 
Seat 3: chiyuki ($27.86 in chips) 
Seat 4: nice.franki ($11.80 in chips) 
Seat 5: ygoegoe ($44.40 in chips) 
Seat 6: God)Squall ($23.88 in chips) 
Seat 7: opie62 ($25 in chips) 
Seat 8: kamikkaze ($14.13 in chips) 
Seat 9: KrystalAA ($20.78 in chips) 
kwkim73: posts small blind $0.10
chiyuki: posts big blind $0.25
*** HOLE CARDS ***
Dealt to chiyuki [8c 9d]
nice.franki: folds 
ygoegoe: folds 
God)Squall: raises $0.50 to $0.75
opie62: folds 
kamikkaze: folds 
KrystalAA: folds 
Alvinpe85: folds 
kwkim73: folds 
chiyuki: folds 
Uncalled bet ($0.50) returned to God)Squall
God)Squall collected $0.60 from pot
God)Squall: doesn't show hand 
*** SUMMARY ***
Total pot $0.60 | Rake $0 
Seat 1: Alvinpe85 (button) folded before Flop (didn't bet)
Seat 2: kwkim73 (small blind) folded before Flop
Seat 3: chiyuki (big blind) folded before Flop
Seat 4: nice.franki folded before Flop (didn't bet)
Seat 5: ygoegoe folded before Flop (didn't bet)
Seat 6: God)Squall collected ($0.60)
Seat 7: opie62 folded before Flop (didn't bet)
Seat 8: kamikkaze folded before Flop (didn't bet)
Seat 9: KrystalAA folded before Flop (didn't bet)



PokerStars Zoom Hand #84300451229:  Hold'em No Limit ($0.10/$0.25) - 2012/08/05 15:28:57 JST [2012/08/05 2:28:57 ET]
Table 'Whirlpool' 9-max Seat #1 is the button
Seat 1: Rilko1975 ($25.17 in chips) 
Seat 2: chiyuki ($27.61 in chips) 
Seat 3: WARIBANA7777 ($15.03 in chips) 
Seat 4: Jene4kaBest ($17.69 in chips) 
Seat 5: jacquelinewu ($33.93 in chips) 
Seat 6: Dan Royal ($31.41 in chips) 
Seat 7: nice.franki ($11.11 in chips) 
Seat 8: Grishukps ($12.85 in chips) 
Seat 9: kwkim73 ($26.45 in chips) 
chiyuki: posts small blind $0.10
WARIBANA7777: posts big blind $0.25
*** HOLE CARDS ***
Dealt to chiyuki [6c Ad]
Jene4kaBest: folds 
jacquelinewu: folds 
Dan Royal: folds 
nice.franki: folds 
Grishukps: folds 
kwkim73: raises $0.50 to $0.75
Rilko1975: folds 
chiyuki: folds 
WARIBANA7777: folds 
Uncalled bet ($0.50) returned to kwkim73
kwkim73 collected $0.60 from pot
kwkim73: doesn't show hand 
*** SUMMARY ***
Total pot $0.60 | Rake $0 
Seat 1: Rilko1975 (button) folded before Flop (didn't bet)
Seat 2: chiyuki (small blind) folded before Flop
Seat 3: WARIBANA7777 (big blind) folded before Flop
Seat 4: Jene4kaBest folded before Flop (didn't bet)
Seat 5: jacquelinewu folded before Flop (didn't bet)
Seat 6: Dan Royal folded before Flop (didn't bet)
Seat 7: nice.franki folded before Flop (didn't bet)
Seat 8: Grishukps folded before Flop (didn't bet)
Seat 9: kwkim73 collected ($0.60)



PokerStars Zoom Hand #84300444154:  Hold'em No Limit ($0.10/$0.25) - 2012/08/05 15:28:29 JST [2012/08/05 2:28:29 ET]
Table 'Whirlpool' 9-max Seat #1 is the button
Seat 1: PAMBOS.L ($23.07 in chips) 
Seat 2: AntoineHunt ($41.29 in chips) 
Seat 3: nice.franki ($11.46 in chips) 
Seat 4: Grishukps ($12.50 in chips) 
Seat 5: Rici47 ($31.14 in chips) 
Seat 6: Tom1999 ($19.08 in chips) 
Seat 7: panaam ($20.53 in chips) 
Seat 8: Ellen1947 ($26.12 in chips) 
Seat 9: chiyuki ($27.86 in chips) 
AntoineHunt: posts small blind $0.10
nice.franki: posts big blind $0.25
*** HOLE CARDS ***
Dealt to chiyuki [6d 3c]
Grishukps: folds 
Rici47: folds 
Tom1999: raises $0.50 to $0.75
panaam: folds 
Ellen1947: folds 
chiyuki: folds 
PAMBOS.L: calls $0.75
AntoineHunt: folds 
nice.franki: folds 
*** FLOP *** [As Jd 4s]
Tom1999: checks 
PAMBOS.L: bets $0.90
Tom1999: calls $0.90
*** TURN *** [As Jd 4s] [4d]
Tom1999: checks 
PAMBOS.L: checks 
*** RIVER *** [As Jd 4s 4d] [6c]
Tom1999: bets $1.75
PAMBOS.L: folds 
Uncalled bet ($1.75) returned to Tom1999
Tom1999 collected $3.49 from pot
Tom1999: doesn't show hand 
*** SUMMARY ***
Total pot $3.65 | Rake $0.16 
Board [As Jd 4s 4d 6c]
Seat 1: PAMBOS.L (button) folded on the River
Seat 2: AntoineHunt (small blind) folded before Flop
Seat 3: nice.franki (big blind) folded before Flop
Seat 4: Grishukps folded before Flop (didn't bet)
Seat 5: Rici47 folded before Flop (didn't bet)
Seat 6: Tom1999 collected ($3.49)
Seat 7: panaam folded before Flop (didn't bet)
Seat 8: Ellen1947 folded before Flop (didn't bet)
Seat 9: chiyuki folded before Flop (didn't bet)



PokerStars Zoom Hand #84300456747:  Hold'em No Limit ($0.10/$0.25) - 2012/08/05 15:29:19 JST [2012/08/05 2:29:19 ET]
Table 'Whirlpool' 9-max Seat #1 is the button
Seat 1: NuMetal88 ($27.89 in chips) 
Seat 2: Jene4kaBest ($17.44 in chips) 
Seat 3: seula i ($25 in chips) 
Seat 4: ziggzagg77 ($11.88 in chips) 
Seat 5: chiyuki ($27.51 in chips) 
Seat 6: kwkim73 ($27.58 in chips) 
Seat 7: Nagus3x ($22.40 in chips) 
Seat 8: deadmoneykid ($39.48 in chips) 
Seat 9: Ellen1947 ($25.77 in chips) 
Jene4kaBest: posts small blind $0.10
seula i: posts big blind $0.25
*** HOLE CARDS ***
Dealt to chiyuki [Td 8s]
ziggzagg77: folds 
chiyuki: folds 
kwkim73: folds 
Nagus3x: folds 
deadmoneykid: folds 
Ellen1947: folds 
NuMetal88: raises $0.50 to $0.75
Jene4kaBest: folds 
seula i: folds 
Uncalled bet ($0.50) returned to NuMetal88
NuMetal88 collected $0.60 from pot
NuMetal88: doesn't show hand 
*** SUMMARY ***
Total pot $0.60 | Rake $0 
Seat 1: NuMetal88 (button) collected ($0.60)
Seat 2: Jene4kaBest (small blind) folded before Flop
Seat 3: seula i (big blind) folded before Flop
Seat 4: ziggzagg77 folded before Flop (didn't bet)
Seat 5: chiyuki folded before Flop (didn't bet)
Seat 6: kwkim73 folded before Flop (didn't bet)
Seat 7: Nagus3x folded before Flop (didn't bet)
Seat 8: deadmoneykid folded before Flop (didn't bet)
Seat 9: Ellen1947 folded before Flop (didn't bet)



PokerStars Zoom Hand #84300457746:  Hold'em No Limit ($0.10/$0.25) - 2012/08/05 15:29:24 JST [2012/08/05 2:29:24 ET]
Table 'Whirlpool' 9-max Seat #1 is the button
Seat 1: kwkim73 ($27.58 in chips) 
Seat 2: ziggzagg77 ($11.88 in chips) 
Seat 3: cofla tito ($12.06 in chips) 
Seat 4: Tom1999 ($20.92 in chips) 
Seat 5: KrystalAA ($34.98 in chips) 
Seat 6: God)Squall ($32.70 in chips) 
Seat 7: Ellen1947 ($25.77 in chips) 
Seat 8: yane73 ($8.46 in chips) 
Seat 9: chiyuki ($27.51 in chips) 
ziggzagg77: posts small blind $0.10
cofla tito: posts big blind $0.25
*** HOLE CARDS ***
Dealt to chiyuki [Kc 8c]
Tom1999: folds 
KrystalAA: folds 
God)Squall: folds 
Ellen1947: folds 
yane73: raises $1 to $1.25
chiyuki: folds 
kwkim73: folds 
ziggzagg77: folds 
cofla tito: folds 
Uncalled bet ($1) returned to yane73
yane73 collected $0.60 from pot
yane73: doesn't show hand 
*** SUMMARY ***
Total pot $0.60 | Rake $0 
Seat 1: kwkim73 (button) folded before Flop (didn't bet)
Seat 2: ziggzagg77 (small blind) folded before Flop
Seat 3: cofla tito (big blind) folded before Flop
Seat 4: Tom1999 folded before Flop (didn't bet)
Seat 5: KrystalAA folded before Flop (didn't bet)
Seat 6: God)Squall folded before Flop (didn't bet)
Seat 7: Ellen1947 folded before Flop (didn't bet)
Seat 8: yane73 collected ($0.60)
Seat 9: chiyuki folded before Flop (didn't bet)



PokerStars Zoom Hand #84300455537:  Hold'em No Limit ($0.10/$0.25) - 2012/08/05 15:29:14 JST [2012/08/05 2:29:14 ET]
Table 'Whirlpool' 9-max Seat #1 is the button
Seat 1: slapshot2011 ($18.28 in chips) 
Seat 2: troublesomm ($28.68 in chips) 
Seat 3: moku36 ($36.09 in chips) 
Seat 4: seula i ($25 in chips) 
Seat 5: KeLevro0 ($22.96 in chips) 
Seat 6: Perstenev ($18.26 in chips) 
Seat 7: chiyuki ($27.51 in chips) 
Seat 8: Silveystryk ($23.77 in chips) 
Seat 9: xxx Spb xxx ($44.93 in chips) 
troublesomm: posts small blind $0.10
moku36: posts big blind $0.25
*** HOLE CARDS ***
Dealt to chiyuki [9s 2d]
seula i: folds 
KeLevro0: folds 
Perstenev: calls $0.25
chiyuki: folds 
Silveystryk: folds 
xxx Spb xxx: folds 
slapshot2011: folds 
troublesomm: calls $0.15
moku36: checks 
*** FLOP *** [3c 8h Ad]
troublesomm: bets $0.39
moku36: folds 
Perstenev: calls $0.39
*** TURN *** [3c 8h Ad] [Ac]
troublesomm: checks 
Perstenev: checks 
*** RIVER *** [3c 8h Ad Ac] [2c]
troublesomm: bets $0.80
Perstenev: folds 
Uncalled bet ($0.80) returned to troublesomm
troublesomm collected $1.46 from pot
troublesomm: doesn't show hand 
*** SUMMARY ***
Total pot $1.53 | Rake $0.07 
Board [3c 8h Ad Ac 2c]
Seat 1: slapshot2011 (button) folded before Flop (didn't bet)
Seat 2: troublesomm (small blind) collected ($1.46)
Seat 3: moku36 (big blind) folded on the Flop
Seat 4: seula i folded before Flop (didn't bet)
Seat 5: KeLevro0 folded before Flop (didn't bet)
Seat 6: Perstenev folded on the River
Seat 7: chiyuki folded before Flop (didn't bet)
Seat 8: Silveystryk folded before Flop (didn't bet)
Seat 9: xxx Spb xxx folded before Flop (didn't bet)



PokerStars Zoom Hand #84300463473:  Hold'em No Limit ($0.10/$0.25) - 2012/08/05 15:29:47 JST [2012/08/05 2:29:47 ET]
Table 'Whirlpool' 9-max Seat #1 is the button
Seat 1: troublesomm ($36.04 in chips) 
Seat 2: JhonnyP1979 ($3.99 in chips) 
Seat 3: pandaaaaaa ($6.81 in chips) 
Seat 4: Silveystryk ($21.85 in chips) 
Seat 5: nastya040 ($19.61 in chips) 
Seat 6: chiyuki ($27.51 in chips) 
Seat 7: KeLevro0 ($10.49 in chips) 
Seat 8: Grishukps ($12.75 in chips) 
Seat 9: PAMBOS.L ($21.42 in chips) 
JhonnyP1979: posts small blind $0.10
pandaaaaaa: posts big blind $0.25
*** HOLE CARDS ***
Dealt to chiyuki [9h 9s]
Silveystryk: calls $0.25
nastya040: folds 
chiyuki: raises $0.75 to $1
KeLevro0: folds 
Grishukps: folds 
PAMBOS.L: folds 
troublesomm: folds 
JhonnyP1979: folds 
pandaaaaaa: folds 
Silveystryk: folds 
Uncalled bet ($0.75) returned to chiyuki
chiyuki collected $0.85 from pot
chiyuki: doesn't show hand 
*** SUMMARY ***
Total pot $0.85 | Rake $0 
Seat 1: troublesomm (button) folded before Flop (didn't bet)
Seat 2: JhonnyP1979 (small blind) folded before Flop
Seat 3: pandaaaaaa (big blind) folded before Flop
Seat 4: Silveystryk folded before Flop
Seat 5: nastya040 folded before Flop (didn't bet)
Seat 6: chiyuki collected ($0.85)
Seat 7: KeLevro0 folded before Flop (didn't bet)
Seat 8: Grishukps folded before Flop (didn't bet)
Seat 9: PAMBOS.L folded before Flop (didn't bet)



PokerStars Zoom Hand #84300459241:  Hold'em No Limit ($0.10/$0.25) - 2012/08/05 15:29:30 JST [2012/08/05 2:29:30 ET]
Table 'Whirlpool' 9-max Seat #1 is the button
Seat 1: chiyuki ($27.51 in chips) 
Seat 2: INSP!RON ($30.15 in chips) 
Seat 3: crazycrown1 ($12.50 in chips) 
Seat 4: KeLevro0 ($22.96 in chips) 
Seat 5: God)Squall ($32.70 in chips) 
Seat 6: KrystalAA ($34.98 in chips) 
Seat 7: Dejacob ($25 in chips) 
Seat 8: Ellen1947 ($25.77 in chips) 
Seat 9: GovGus ($25.77 in chips) 
INSP!RON: posts small blind $0.10
crazycrown1: posts big blind $0.25
*** HOLE CARDS ***
Dealt to chiyuki [Tc Qc]
KeLevro0: raises $0.42 to $0.67
God)Squall: folds 
KrystalAA: folds 
Dejacob: calls $0.67
Ellen1947: folds 
GovGus: folds 
chiyuki: folds 
INSP!RON: folds 
crazycrown1: calls $0.42
*** FLOP *** [5c 6h 3h]
crazycrown1: checks 
KeLevro0: bets $1.13
Dejacob: calls $1.13
crazycrown1: calls $1.13
*** TURN *** [5c 6h 3h] [Jd]
crazycrown1: checks 
KeLevro0: checks 
Dejacob: checks 
*** RIVER *** [5c 6h 3h Jd] [Kd]
crazycrown1: checks 
KeLevro0: checks 
Dejacob: checks 
*** SHOW DOWN ***
crazycrown1: shows [8c Jc] (a pair of Jacks)
KeLevro0: mucks hand 
Dejacob: mucks hand 
crazycrown1 collected $5.25 from pot
crazycrown1 is disconnected 
*** SUMMARY ***
Total pot $5.50 | Rake $0.25 
Board [5c 6h 3h Jd Kd]
Seat 1: chiyuki (button) folded before Flop (didn't bet)
Seat 2: INSP!RON (small blind) folded before Flop
Seat 3: crazycrown1 (big blind) showed [8c Jc] and won ($5.25) with a pair of Jacks
Seat 4: KeLevro0 mucked [9c 9s]
Seat 5: God)Squall folded before Flop (didn't bet)
Seat 6: KrystalAA folded before Flop (didn't bet)
Seat 7: Dejacob mucked [3d Ad]
Seat 8: Ellen1947 folded before Flop (didn't bet)
Seat 9: GovGus folded before Flop (didn't bet)



PokerStars Zoom Hand #84300468918:  Hold'em No Limit ($0.10/$0.25) - 2012/08/05 15:30:07 JST [2012/08/05 2:30:07 ET]
Table 'Whirlpool' 9-max Seat #1 is the button
Seat 1: Ellen1947 ($28.54 in chips) 
Seat 2: PAMBOS.L ($21.42 in chips) 
Seat 3: Faantomace ($33.88 in chips) 
Seat 4: AVerdonk ($30.40 in chips) 
Seat 5: 4plankton ($21.82 in chips) 
Seat 6: hirozo ($37.15 in chips) 
Seat 7: Silveystryk ($21.60 in chips) 
Seat 8: chiyuki ($28.11 in chips) 
Seat 9: deadmoneykid ($39.13 in chips) 
PAMBOS.L: posts small blind $0.10
Faantomace: posts big blind $0.25
*** HOLE CARDS ***
Dealt to chiyuki [3c 7d]
AVerdonk: raises $0.75 to $1
4plankton: folds 
hirozo: folds 
Silveystryk: folds 
chiyuki: folds 
deadmoneykid: folds 
Ellen1947: folds 
PAMBOS.L: folds 
Faantomace: folds 
Uncalled bet ($0.75) returned to AVerdonk
AVerdonk collected $0.60 from pot
AVerdonk: doesn't show hand 
*** SUMMARY ***
Total pot $0.60 | Rake $0 
Seat 1: Ellen1947 (button) folded before Flop (didn't bet)
Seat 2: PAMBOS.L (small blind) folded before Flop
Seat 3: Faantomace (big blind) folded before Flop
Seat 4: AVerdonk collected ($0.60)
Seat 5: 4plankton folded before Flop (didn't bet)
Seat 6: hirozo folded before Flop (didn't bet)
Seat 7: Silveystryk folded before Flop (didn't bet)
Seat 8: chiyuki folded before Flop (didn't bet)
Seat 9: deadmoneykid folded before Flop (didn't bet)



PokerStars Zoom Hand #84300469845:  Hold'em No Limit ($0.10/$0.25) - 2012/08/05 15:30:11 JST [2012/08/05 2:30:11 ET]
Table 'Whirlpool' 9-max Seat #1 is the button
Seat 1: WARIBANA7777 ($14.43 in chips) 
Seat 2: xxx Spb xxx ($25 in chips) 
Seat 3: KeLevro0 ($10.49 in chips) 
Seat 4: phate-1up ($86.05 in chips) 
Seat 5: ZhukOFFskI ($35.53 in chips) 
Seat 6: Dejacob ($25 in chips) 
Seat 7: chiyuki ($28.11 in chips) 
Seat 8: slapshot2011 ($17.43 in chips) 
Seat 9: God)Squall ($24.33 in chips) 
xxx Spb xxx: posts small blind $0.10
KeLevro0: posts big blind $0.25
*** HOLE CARDS ***
Dealt to chiyuki [3h 3c]
phate-1up: folds 
ZhukOFFskI: folds 
Dejacob: folds 
chiyuki: folds 
slapshot2011: calls $0.25
God)Squall: folds 
WARIBANA7777: folds 
xxx Spb xxx: calls $0.15
KeLevro0: checks 
*** FLOP *** [Ah Ts Ks]
xxx Spb xxx: checks 
KeLevro0: checks 
slapshot2011: bets $0.75
xxx Spb xxx: folds 
KeLevro0: folds 
Uncalled bet ($0.75) returned to slapshot2011
slapshot2011 collected $0.72 from pot
slapshot2011: doesn't show hand 
*** SUMMARY ***
Total pot $0.75 | Rake $0.03 
Board [Ah Ts Ks]
Seat 1: WARIBANA7777 (button) folded before Flop (didn't bet)
Seat 2: xxx Spb xxx (small blind) folded on the Flop
Seat 3: KeLevro0 (big blind) folded on the Flop
Seat 4: phate-1up folded before Flop (didn't bet)
Seat 5: ZhukOFFskI folded before Flop (didn't bet)
Seat 6: Dejacob folded before Flop (didn't bet)
Seat 7: chiyuki folded before Flop (didn't bet)
Seat 8: slapshot2011 collected ($0.72)
Seat 9: God)Squall folded before Flop (didn't bet)



PokerStars Zoom Hand #84300472080:  Hold'em No Limit ($0.10/$0.25) - 2012/08/05 15:30:20 JST [2012/08/05 2:30:20 ET]
Table 'Whirlpool' 9-max Seat #1 is the button
Seat 1: Faraz ($14.63 in chips) 
Seat 2: God)Squall ($24.33 in chips) 
Seat 3: chiyuki ($28.11 in chips) 
Seat 4: WARIBANA7777 ($14.43 in chips) 
Seat 5: 4ydo yogurt ($25.09 in chips) 
Seat 6: Nerkit ($14.76 in chips) 
Seat 7: silvno31 ($46.49 in chips) 
Seat 8: herkko11 ($11.22 in chips) 
Seat 9: drunk_bender ($16.40 in chips) 
God)Squall: posts small blind $0.10
chiyuki: posts big blind $0.25
*** HOLE CARDS ***
Dealt to chiyuki [2c 9c]
WARIBANA7777: folds 
4ydo yogurt: raises $0.50 to $0.75
Nerkit: folds 
silvno31: folds 
herkko11: folds 
drunk_bender: folds 
Faraz: folds 
God)Squall: raises $1.50 to $2.25
chiyuki: folds 
4ydo yogurt: calls $1.50
*** FLOP *** [5h Ah 9h]
God)Squall: checks 
4ydo yogurt: checks 
*** TURN *** [5h Ah 9h] [2d]
God)Squall: bets $3.50
4ydo yogurt: calls $3.50
*** RIVER *** [5h Ah 9h 2d] [6d]
God)Squall: bets $13.25
4ydo yogurt: folds 
Uncalled bet ($13.25) returned to God)Squall
God)Squall collected $11.22 from pot
God)Squall: doesn't show hand 
*** SUMMARY ***
Total pot $11.75 | Rake $0.53 
Board [5h Ah 9h 2d 6d]
Seat 1: Faraz (button) folded before Flop (didn't bet)
Seat 2: God)Squall (small blind) collected ($11.22)
Seat 3: chiyuki (big blind) folded before Flop
Seat 4: WARIBANA7777 folded before Flop (didn't bet)
Seat 5: 4ydo yogurt folded on the River
Seat 6: Nerkit folded before Flop (didn't bet)
Seat 7: silvno31 folded before Flop (didn't bet)
Seat 8: herkko11 folded before Flop (didn't bet)
Seat 9: drunk_bender folded before Flop (didn't bet)



PokerStars Zoom Hand #84300478781:  Hold'em No Limit ($0.10/$0.25) - 2012/08/05 15:30:48 JST [2012/08/05 2:30:48 ET]
Table 'Whirlpool' 9-max Seat #1 is the button
Seat 1: ZhukOFFskI ($35.28 in chips) 
Seat 2: chiyuki ($27.86 in chips) 
Seat 3: 1Karina1 ($28.42 in chips) 
Seat 4: GovGus ($25.67 in chips) 
Seat 5: pandaaaaaa ($9.88 in chips) 
Seat 6: cofla tito ($9.04 in chips) 
Seat 7: Dan Royal ($31.76 in chips) 
Seat 8: seula i ($25 in chips) 
Seat 9: Ellen1947 ($24.07 in chips) 
chiyuki: posts small blind $0.10
1Karina1: posts big blind $0.25
*** HOLE CARDS ***
Dealt to chiyuki [9s Kh]
GovGus: folds 
pandaaaaaa: folds 
cofla tito: folds 
Dan Royal: folds 
seula i: folds 
Ellen1947: folds 
ZhukOFFskI: folds 
chiyuki: raises $0.50 to $0.75
1Karina1: folds 
Uncalled bet ($0.50) returned to chiyuki
chiyuki collected $0.50 from pot
chiyuki: doesn't show hand 
*** SUMMARY ***
Total pot $0.50 | Rake $0 
Seat 1: ZhukOFFskI (button) folded before Flop (didn't bet)
Seat 2: chiyuki (small blind) collected ($0.50)
Seat 3: 1Karina1 (big blind) folded before Flop
Seat 4: GovGus folded before Flop (didn't bet)
Seat 5: pandaaaaaa folded before Flop (didn't bet)
Seat 6: cofla tito folded before Flop (didn't bet)
Seat 7: Dan Royal folded before Flop (didn't bet)
Seat 8: seula i folded before Flop (didn't bet)
Seat 9: Ellen1947 folded before Flop (didn't bet)



PokerStars Zoom Hand #84300470832:  Hold'em No Limit ($0.10/$0.25) - 2012/08/05 15:30:15 JST [2012/08/05 2:30:15 ET]
Table 'Whirlpool' 9-max Seat #1 is the button
Seat 1: Perstenev ($9.75 in chips) 
Seat 2: 1Karina1 ($28.52 in chips) 
Seat 3: PAMBOS.L ($21.32 in chips) 
Seat 4: Alvinpe85 ($55.29 in chips) 
Seat 5: chiyuki ($28.11 in chips) 
Seat 6: aSasha280 ($16.18 in chips) 
Seat 7: fima00000007 ($9.90 in chips) 
Seat 8: ViTiV2010 ($13.05 in chips) 
Seat 9: troublesomm ($29.38 in chips) 
1Karina1: posts small blind $0.10
PAMBOS.L: posts big blind $0.25
*** HOLE CARDS ***
Dealt to chiyuki [Qd 8d]
Alvinpe85: folds 
chiyuki: folds 
aSasha280: folds 
fima00000007: calls $0.25
ViTiV2010: folds 
troublesomm: folds 
Perstenev: folds 
1Karina1: folds 
PAMBOS.L: checks 
*** FLOP *** [4c Ad 7s]
PAMBOS.L: checks 
fima00000007: checks 
*** TURN *** [4c Ad 7s] [Jc]
PAMBOS.L: bets $0.42
fima00000007: calls $0.42
*** RIVER *** [4c Ad 7s Jc] [3d]
PAMBOS.L: bets $1.03
fima00000007: calls $1.03
*** SHOW DOWN ***
PAMBOS.L: shows [Kh 8s] (high card Ace)
fima00000007: shows [Ac 2d] (a pair of Aces)
fima00000007 collected $3.34 from pot
*** SUMMARY ***
Total pot $3.50 | Rake $0.16 
Board [4c Ad 7s Jc 3d]
Seat 1: Perstenev (button) folded before Flop (didn't bet)
Seat 2: 1Karina1 (small blind) folded before Flop
Seat 3: PAMBOS.L (big blind) showed [Kh 8s] and lost with high card Ace
Seat 4: Alvinpe85 folded before Flop (didn't bet)
Seat 5: chiyuki folded before Flop (didn't bet)
Seat 6: aSasha280 folded before Flop (didn't bet)
Seat 7: fima00000007 showed [Ac 2d] and won ($3.34) with a pair of Aces
Seat 8: ViTiV2010 folded before Flop (didn't bet)
Seat 9: troublesomm folded before Flop (didn't bet)



PokerStars Zoom Hand #84300476789:  Hold'em No Limit ($0.10/$0.25) - 2012/08/05 15:30:40 JST [2012/08/05 2:30:40 ET]
Table 'Whirlpool' 9-max Seat #1 is the button
Seat 1: seula i ($25 in chips) 
Seat 2: Faraz ($13.50 in chips) 
Seat 3: ZhukOFFskI ($22.30 in chips) 
Seat 4: DutchShultzs ($43.33 in chips) 
Seat 5: Nerkit ($17.55 in chips) 
Seat 6: chiyuki ($27.86 in chips) 
Seat 7: cofla tito ($11.21 in chips) 
Seat 8: snejokCoxx ($11.77 in chips) 
Seat 9: kwkim73 ($30.21 in chips) 
Faraz: posts small blind $0.10
ZhukOFFskI: posts big blind $0.25
*** HOLE CARDS ***
Dealt to chiyuki [2h 9h]
DutchShultzs: folds 
Nerkit: folds 
chiyuki: folds 
cofla tito: folds 
snejokCoxx: folds 
kwkim73: folds 
seula i: folds 
Faraz: calls $0.15
ZhukOFFskI: checks 
*** FLOP *** [9s 8h Qd]
Faraz: checks 
ZhukOFFskI: bets $0.25
Faraz: calls $0.25
*** TURN *** [9s 8h Qd] [5h]
Faraz: bets $0.25
ZhukOFFskI: folds 
Uncalled bet ($0.25) returned to Faraz
Faraz collected $0.96 from pot
Faraz: doesn't show hand 
*** SUMMARY ***
Total pot $1 | Rake $0.04 
Board [9s 8h Qd 5h]
Seat 1: seula i (button) folded before Flop (didn't bet)
Seat 2: Faraz (small blind) collected ($0.96)
Seat 3: ZhukOFFskI (big blind) folded on the Turn
Seat 4: DutchShultzs folded before Flop (didn't bet)
Seat 5: Nerkit folded before Flop (didn't bet)
Seat 6: chiyuki folded before Flop (didn't bet)
Seat 7: cofla tito folded before Flop (didn't bet)
Seat 8: snejokCoxx folded before Flop (didn't bet)
Seat 9: kwkim73 folded before Flop (didn't bet)



PokerStars Zoom Hand #84300484468:  Hold'em No Limit ($0.10/$0.25) - 2012/08/05 15:31:10 JST [2012/08/05 2:31:10 ET]
Table 'Whirlpool' 9-max Seat #1 is the button
Seat 1: chiyuki ($28.11 in chips) 
Seat 2: ZhukOFFskI ($35.28 in chips) 
Seat 3: Wilcox76607 ($12.57 in chips) 
Seat 4: 1Karina1 ($37.55 in chips) 
Seat 5: drunk_bender ($16.05 in chips) 
Seat 6: jacquelinewu ($34.28 in chips) 
Seat 7: KimPa39 ($26.73 in chips) 
Seat 8: deadmoneykid ($39.13 in chips) 
Seat 9: mjmichi ($46.84 in chips) 
ZhukOFFskI: posts small blind $0.10
Wilcox76607: posts big blind $0.25
*** HOLE CARDS ***
Dealt to chiyuki [Qc 8d]
1Karina1: folds 
drunk_bender: folds 
jacquelinewu: folds 
KimPa39: folds 
deadmoneykid: folds 
mjmichi: folds 
chiyuki: folds 
ZhukOFFskI: folds 
Uncalled bet ($0.15) returned to Wilcox76607
Wilcox76607 collected $0.20 from pot
Wilcox76607: doesn't show hand 
*** SUMMARY ***
Total pot $0.20 | Rake $0 
Seat 1: chiyuki (button) folded before Flop (didn't bet)
Seat 2: ZhukOFFskI (small blind) folded before Flop
Seat 3: Wilcox76607 (big blind) collected ($0.20)
Seat 4: 1Karina1 folded before Flop (didn't bet)
Seat 5: drunk_bender folded before Flop (didn't bet)
Seat 6: jacquelinewu folded before Flop (didn't bet)
Seat 7: KimPa39 folded before Flop (didn't bet)
Seat 8: deadmoneykid folded before Flop (didn't bet)
Seat 9: mjmichi folded before Flop (didn't bet)



PokerStars Zoom Hand #84300477505:  Hold'em No Limit ($0.10/$0.25) - 2012/08/05 15:30:43 JST [2012/08/05 2:30:43 ET]
Table 'Whirlpool' 9-max Seat #1 is the button
Seat 1: ViTiV2010 ($12.25 in chips) 
Seat 2: Silveystryk ($23.02 in chips) 
Seat 3: 1Karina1 ($25.49 in chips) 
Seat 4: Ellen1947 ($24.07 in chips) 
Seat 5: chiyuki ($27.86 in chips) 
Seat 6: turbotom122 ($14.30 in chips) 
Seat 7: nice.franki ($11.11 in chips) 
Seat 8: Grishukps ($12.50 in chips) 
Seat 9: jacquelinewu ($72.77 in chips) 
Silveystryk: posts small blind $0.10
1Karina1: posts big blind $0.25
*** HOLE CARDS ***
Dealt to chiyuki [5d Ac]
Ellen1947: folds 
chiyuki: folds 
turbotom122: calls $0.25
nice.franki: folds 
Grishukps: folds 
jacquelinewu: folds 
ViTiV2010: folds 
Silveystryk: calls $0.15
1Karina1: raises $0.90 to $1.15
turbotom122: calls $0.90
Silveystryk: folds 
*** FLOP *** [4s 6d 9h]
1Karina1: checks 
turbotom122: bets $2
1Karina1: folds 
Uncalled bet ($2) returned to turbotom122
turbotom122 collected $2.44 from pot
turbotom122: doesn't show hand 
*** SUMMARY ***
Total pot $2.55 | Rake $0.11 
Board [4s 6d 9h]
Seat 1: ViTiV2010 (button) folded before Flop (didn't bet)
Seat 2: Silveystryk (small blind) folded before Flop
Seat 3: 1Karina1 (big blind) folded on the Flop
Seat 4: Ellen1947 folded before Flop (didn't bet)
Seat 5: chiyuki folded before Flop (didn't bet)
Seat 6: turbotom122 collected ($2.44)
Seat 7: nice.franki folded before Flop (didn't bet)
Seat 8: Grishukps folded before Flop (didn't bet)
Seat 9: jacquelinewu folded before Flop (didn't bet)



PokerStars Zoom Hand #84300489052:  Hold'em No Limit ($0.10/$0.25) - 2012/08/05 15:31:28 JST [2012/08/05 2:31:28 ET]
Table 'Whirlpool' 9-max Seat #1 is the button
Seat 1: mjmichi ($53.62 in chips) 
Seat 2: herkko11 ($10.22 in chips) 
Seat 3: DutchShultzs ($25.15 in chips) 
Seat 4: hirozo ($89.41 in chips) 
Seat 5: Grishukps ($12.75 in chips) 
Seat 6: seula i ($25 in chips) 
Seat 7: GSDP ($42.58 in chips) 
Seat 8: phate-1up ($31.15 in chips) 
Seat 9: chiyuki ($28.11 in chips) 
herkko11: posts small blind $0.10
DutchShultzs: posts big blind $0.25
*** HOLE CARDS ***
Dealt to chiyuki [8h Td]
hirozo: folds 
Grishukps: folds 
seula i: raises $0.50 to $0.75
GSDP: folds 
phate-1up: folds 
chiyuki: folds 
mjmichi: folds 
herkko11: folds 
DutchShultzs: folds 
Uncalled bet ($0.50) returned to seula i
seula i collected $0.60 from pot
seula i: doesn't show hand 
*** SUMMARY ***
Total pot $0.60 | Rake $0 
Seat 1: mjmichi (button) folded before Flop (didn't bet)
Seat 2: herkko11 (small blind) folded before Flop
Seat 3: DutchShultzs (big blind) folded before Flop
Seat 4: hirozo folded before Flop (didn't bet)
Seat 5: Grishukps folded before Flop (didn't bet)
Seat 6: seula i collected ($0.60)
Seat 7: GSDP folded before Flop (didn't bet)
Seat 8: phate-1up folded before Flop (didn't bet)
Seat 9: chiyuki folded before Flop (didn't bet)



PokerStars Zoom Hand #84300487769:  Hold'em No Limit ($0.10/$0.25) - 2012/08/05 15:31:23 JST [2012/08/05 2:31:23 ET]
Table 'Whirlpool' 9-max Seat #1 is the button
Seat 1: masterkoolb ($13.87 in chips) 
Seat 2: silvno31 ($42.59 in chips) 
Seat 3: GovGus ($44.70 in chips) 
Seat 4: ZhukOFFskI ($35.18 in chips) 
Seat 5: Gichboy ($26.98 in chips) 
Seat 6: phate-1up ($49.88 in chips) 
Seat 7: River_GmbH ($15.25 in chips) 
Seat 8: chiyuki ($28.11 in chips) 
Seat 9: yane73 ($10.26 in chips) 
silvno31: posts small blind $0.10
GovGus: posts big blind $0.25
*** HOLE CARDS ***
Dealt to chiyuki [2s Ts]
ZhukOFFskI: folds 
Gichboy: raises $0.25 to $0.50
phate-1up: folds 
River_GmbH: folds 
chiyuki: folds 
yane73: folds 
masterkoolb: folds 
silvno31: calls $0.40
GovGus: folds 
*** FLOP *** [2h As Jh]
silvno31: bets $1.25
Gichboy: calls $1.25
*** TURN *** [2h As Jh] [5c]
silvno31: bets $6.75
Gichboy: folds 
Uncalled bet ($6.75) returned to silvno31
silvno31 collected $3.58 from pot
silvno31: doesn't show hand 
*** SUMMARY ***
Total pot $3.75 | Rake $0.17 
Board [2h As Jh 5c]
Seat 1: masterkoolb (button) folded before Flop (didn't bet)
Seat 2: silvno31 (small blind) collected ($3.58)
Seat 3: GovGus (big blind) folded before Flop
Seat 4: ZhukOFFskI folded before Flop (didn't bet)
Seat 5: Gichboy folded on the Turn
Seat 6: phate-1up folded before Flop (didn't bet)
Seat 7: River_GmbH folded before Flop (didn't bet)
Seat 8: chiyuki folded before Flop (didn't bet)
Seat 9: yane73 folded before Flop (didn't bet)



PokerStars Zoom Hand #84300490866:  Hold'em No Limit ($0.10/$0.25) - 2012/08/05 15:31:35 JST [2012/08/05 2:31:35 ET]
Table 'Whirlpool' 9-max Seat #1 is the button
Seat 1: yane73 ($10.26 in chips) 
Seat 2: GovGus ($39.40 in chips) 
Seat 3: mjmichi ($53.62 in chips) 
Seat 4: chiyuki ($28.11 in chips) 
Seat 5: ZhukOFFskI ($21.70 in chips) 
Seat 6: svg51 ($6.27 in chips) 
Seat 7: kwkim73 ($25 in chips) 
Seat 8: Serge Claws ($25 in chips) 
Seat 9: KrystalAA ($13.37 in chips) 
GovGus: posts small blind $0.10
mjmichi: posts big blind $0.25
*** HOLE CARDS ***
Dealt to chiyuki [8c Qs]
chiyuki: folds 
ZhukOFFskI: folds 
svg51: folds 
kwkim73: folds 
Serge Claws: folds 
KrystalAA: folds 
yane73: folds 
GovGus: raises $0.50 to $0.75
mjmichi: folds 
Uncalled bet ($0.50) returned to GovGus
GovGus collected $0.50 from pot
GovGus: doesn't show hand 
*** SUMMARY ***
Total pot $0.50 | Rake $0 
Seat 1: yane73 (button) folded before Flop (didn't bet)
Seat 2: GovGus (small blind) collected ($0.50)
Seat 3: mjmichi (big blind) folded before Flop
Seat 4: chiyuki folded before Flop (didn't bet)
Seat 5: ZhukOFFskI folded before Flop (didn't bet)
Seat 6: svg51 folded before Flop (didn't bet)
Seat 7: kwkim73 folded before Flop (didn't bet)
Seat 8: Serge Claws folded before Flop (didn't bet)
Seat 9: KrystalAA folded before Flop (didn't bet)



PokerStars Zoom Hand #84300490121:  Hold'em No Limit ($0.10/$0.25) - 2012/08/05 15:31:32 JST [2012/08/05 2:31:32 ET]
Table 'Whirlpool' 9-max Seat #1 is the button
Seat 1: herkko11 ($10.12 in chips) 
Seat 2: kwkim73 ($29.86 in chips) 
Seat 3: Dejacob ($25 in chips) 
Seat 4: chiyuki ($28.11 in chips) 
Seat 5: River_GmbH ($15.25 in chips) 
Seat 6: ZhukOFFskI ($80.95 in chips) 
Seat 7: 1Karina1 ($25 in chips) 
Seat 8: WARIBANA7777 ($13.98 in chips) 
Seat 9: AntoineHunt ($39.09 in chips) 
kwkim73: posts small blind $0.10
Dejacob: posts big blind $0.25
*** HOLE CARDS ***
Dealt to chiyuki [7c 3d]
chiyuki: folds 
River_GmbH: folds 
ZhukOFFskI: folds 
1Karina1: folds 
WARIBANA7777: raises $0.50 to $0.75
AntoineHunt: folds 
herkko11: calls $0.75
kwkim73: folds 
Dejacob: folds 
*** FLOP *** [5d 9s 4s]
WARIBANA7777: checks 
herkko11: bets $0.50
WARIBANA7777: calls $0.50
*** TURN *** [5d 9s 4s] [Kh]
WARIBANA7777: bets $1.73
herkko11: folds 
Uncalled bet ($1.73) returned to WARIBANA7777
WARIBANA7777 collected $2.72 from pot
WARIBANA7777: doesn't show hand 
*** SUMMARY ***
Total pot $2.85 | Rake $0.13 
Board [5d 9s 4s Kh]
Seat 1: herkko11 (button) folded on the Turn
Seat 2: kwkim73 (small blind) folded before Flop
Seat 3: Dejacob (big blind) folded before Flop
Seat 4: chiyuki folded before Flop (didn't bet)
Seat 5: River_GmbH folded before Flop (didn't bet)
Seat 6: ZhukOFFskI folded before Flop (didn't bet)
Seat 7: 1Karina1 folded before Flop (didn't bet)
Seat 8: WARIBANA7777 collected ($2.72)
Seat 9: AntoineHunt folded before Flop (didn't bet)



PokerStars Zoom Hand #84300491904:  Hold'em No Limit ($0.10/$0.25) - 2012/08/05 15:31:39 JST [2012/08/05 2:31:39 ET]
Table 'Whirlpool' 9-max Seat #1 is the button
Seat 1: Grishukps ($12.75 in chips) 
Seat 2: GovGus ($25.42 in chips) 
Seat 3: chiyuki ($28.11 in chips) 
Seat 4: hirozo ($43.78 in chips) 
Seat 5: deadmoneykid ($29.42 in chips) 
Seat 6: mjmichi ($47.19 in chips) 
Seat 7: INSP!RON ($40.58 in chips) 
Seat 8: hldtom ($26.10 in chips) 
Seat 9: ViTiV2010 ($12.70 in chips) 
GovGus: posts small blind $0.10
chiyuki: posts big blind $0.25
*** HOLE CARDS ***
Dealt to chiyuki [7c Ah]
hirozo: folds 
deadmoneykid: folds 
mjmichi: folds 
INSP!RON: folds 
hldtom: folds 
ViTiV2010: folds 
Grishukps: folds 
GovGus: raises $0.50 to $0.75
chiyuki: calls $0.50
*** FLOP *** [5s 9h Kd]
GovGus: bets $1
chiyuki: folds 
Uncalled bet ($1) returned to GovGus
GovGus collected $1.43 from pot
GovGus: doesn't show hand 
*** SUMMARY ***
Total pot $1.50 | Rake $0.07 
Board [5s 9h Kd]
Seat 1: Grishukps (button) folded before Flop (didn't bet)
Seat 2: GovGus (small blind) collected ($1.43)
Seat 3: chiyuki (big blind) folded on the Flop
Seat 4: hirozo folded before Flop (didn't bet)
Seat 5: deadmoneykid folded before Flop (didn't bet)
Seat 6: mjmichi folded before Flop (didn't bet)
Seat 7: INSP!RON folded before Flop (didn't bet)
Seat 8: hldtom folded before Flop (didn't bet)
Seat 9: ViTiV2010 folded before Flop (didn't bet)



PokerStars Zoom Hand #84300509532:  Hold'em No Limit ($0.10/$0.25) - 2012/08/05 15:32:49 JST [2012/08/05 2:32:49 ET]
Table 'Whirlpool' 9-max Seat #1 is the button
Seat 1: masterkoolb ($13.52 in chips) 
Seat 2: GSDP ($14.44 in chips) 
Seat 3: Serge Claws ($25 in chips) 
Seat 4: Faraz ($19.67 in chips) 
Seat 5: herkko11 ($8.87 in chips) 
Seat 6: hirozo ($71.53 in chips) 
Seat 7: chiyuki ($27.26 in chips) 
Seat 8: Ellen1947 ($25.35 in chips) 
Seat 9: NuMetal88 ($30.25 in chips) 
GSDP: posts small blind $0.10
Serge Claws: posts big blind $0.25
*** HOLE CARDS ***
Dealt to chiyuki [Jh Ad]
Faraz: folds 
herkko11: folds 
hirozo: folds 
chiyuki: raises $0.50 to $0.75
Ellen1947: folds 
NuMetal88: folds 
masterkoolb: folds 
GSDP: folds 
Serge Claws: folds 
Uncalled bet ($0.50) returned to chiyuki
chiyuki collected $0.60 from pot
chiyuki: doesn't show hand 
*** SUMMARY ***
Total pot $0.60 | Rake $0 
Seat 1: masterkoolb (button) folded before Flop (didn't bet)
Seat 2: GSDP (small blind) folded before Flop
Seat 3: Serge Claws (big blind) folded before Flop
Seat 4: Faraz folded before Flop (didn't bet)
Seat 5: herkko11 folded before Flop (didn't bet)
Seat 6: hirozo folded before Flop (didn't bet)
Seat 7: chiyuki collected ($0.60)
Seat 8: Ellen1947 folded before Flop (didn't bet)
Seat 9: NuMetal88 folded before Flop (didn't bet)



PokerStars Zoom Hand #84300517101:  Hold'em No Limit ($0.10/$0.25) - 2012/08/05 15:33:20 JST [2012/08/05 2:33:20 ET]
Table 'Whirlpool' 9-max Seat #1 is the button
Seat 1: jacquelinewu ($36.07 in chips) 
Seat 2: Dejacob ($35.19 in chips) 
Seat 3: Roglus ($11.97 in chips) 
Seat 4: River_GmbH ($14.90 in chips) 
Seat 5: PPP7SSS ($24.57 in chips) 
Seat 6: nice.franki ($11.10 in chips) 
Seat 7: kesstukas25 ($14.65 in chips) 
Seat 8: chiyuki ($27.61 in chips) 
Seat 9: Nerkit ($13.66 in chips) 
Dejacob: posts small blind $0.10
Roglus: posts big blind $0.25
*** HOLE CARDS ***
Dealt to chiyuki [8c 9c]
River_GmbH: folds 
PPP7SSS: folds 
nice.franki: folds 
kesstukas25: raises $0.50 to $0.75
chiyuki: folds 
Nerkit: folds 
jacquelinewu: folds 
Dejacob: folds 
Roglus: folds 
Uncalled bet ($0.50) returned to kesstukas25
kesstukas25 collected $0.60 from pot
kesstukas25: doesn't show hand 
*** SUMMARY ***
Total pot $0.60 | Rake $0 
Seat 1: jacquelinewu (button) folded before Flop (didn't bet)
Seat 2: Dejacob (small blind) folded before Flop
Seat 3: Roglus (big blind) folded before Flop
Seat 4: River_GmbH folded before Flop (didn't bet)
Seat 5: PPP7SSS folded before Flop (didn't bet)
Seat 6: nice.franki folded before Flop (didn't bet)
Seat 7: kesstukas25 collected ($0.60)
Seat 8: chiyuki folded before Flop (didn't bet)
Seat 9: Nerkit folded before Flop (didn't bet)



PokerStars Zoom Hand #84300516137:  Hold'em No Limit ($0.10/$0.25) - 2012/08/05 15:33:16 JST [2012/08/05 2:33:16 ET]
Table 'Whirlpool' 9-max Seat #1 is the button
Seat 1: Serge Claws ($25 in chips) 
Seat 2: slapshot2011 ($16.28 in chips) 
Seat 3: KrystalAA ($18.09 in chips) 
Seat 4: phate-1up ($44.69 in chips) 
Seat 5: deadmoneykid ($29.32 in chips) 
Seat 6: chiyuki ($27.61 in chips) 
Seat 7: nice.franki ($11.10 in chips) 
Seat 8: kesstukas25 ($14.65 in chips) 
Seat 9: JhonnyP1979 ($24.05 in chips) 
slapshot2011: posts small blind $0.10
KrystalAA: posts big blind $0.25
*** HOLE CARDS ***
Dealt to chiyuki [2s Kd]
phate-1up: folds 
deadmoneykid: folds 
chiyuki: folds 
nice.franki: folds 
kesstukas25: folds 
JhonnyP1979: raises $0.37 to $0.62
Serge Claws: raises $1.38 to $2
slapshot2011: folds 
KrystalAA: folds 
JhonnyP1979: folds 
Uncalled bet ($1.38) returned to Serge Claws
Serge Claws collected $1.59 from pot
Serge Claws: doesn't show hand 
*** SUMMARY ***
Total pot $1.59 | Rake $0 
Seat 1: Serge Claws (button) collected ($1.59)
Seat 2: slapshot2011 (small blind) folded before Flop
Seat 3: KrystalAA (big blind) folded before Flop
Seat 4: phate-1up folded before Flop (didn't bet)
Seat 5: deadmoneykid folded before Flop (didn't bet)
Seat 6: chiyuki folded before Flop (didn't bet)
Seat 7: nice.franki folded before Flop (didn't bet)
Seat 8: kesstukas25 folded before Flop (didn't bet)
Seat 9: JhonnyP1979 folded before Flop



PokerStars Zoom Hand #84300521366:  Hold'em No Limit ($0.10/$0.25) - 2012/08/05 15:33:36 JST [2012/08/05 2:33:36 ET]
Table 'Whirlpool' 9-max Seat #1 is the button
Seat 1: aSasha280 ($14.88 in chips) 
Seat 2: masterkoolb ($13.62 in chips) 
Seat 3: Wilcox76607 ($13.54 in chips) 
Seat 4: Lasutchik ($13.25 in chips) 
Seat 5: PPP7SSS ($24.92 in chips) 
Seat 6: DutchShultzs ($26.48 in chips) 
Seat 7: chiyuki ($27.61 in chips) 
Seat 8: jacquelinewu ($71.52 in chips) 
Seat 9: NENE54 ($14.17 in chips) 
masterkoolb: posts small blind $0.10
Wilcox76607: posts big blind $0.25
*** HOLE CARDS ***
Dealt to chiyuki [3h 3s]
Lasutchik: folds 
PPP7SSS: raises $24.67 to $24.92 and is all-in
DutchShultzs: folds 
chiyuki: folds 
jacquelinewu: folds 
NENE54: folds 
aSasha280: folds 
masterkoolb: folds 
Wilcox76607: folds 
Uncalled bet ($24.67) returned to PPP7SSS
PPP7SSS collected $0.60 from pot
PPP7SSS: doesn't show hand 
*** SUMMARY ***
Total pot $0.60 | Rake $0 
Seat 1: aSasha280 (button) folded before Flop (didn't bet)
Seat 2: masterkoolb (small blind) folded before Flop
Seat 3: Wilcox76607 (big blind) folded before Flop
Seat 4: Lasutchik folded before Flop (didn't bet)
Seat 5: PPP7SSS collected ($0.60)
Seat 6: DutchShultzs folded before Flop (didn't bet)
Seat 7: chiyuki folded before Flop (didn't bet)
Seat 8: jacquelinewu folded before Flop (didn't bet)
Seat 9: NENE54 folded before Flop (didn't bet)



PokerStars Zoom Hand #84300506723:  Hold'em No Limit ($0.10/$0.25) - 2012/08/05 15:32:38 JST [2012/08/05 2:32:38 ET]
Table 'Whirlpool' 9-max Seat #1 is the button
Seat 1: PAMBOS.L ($13.97 in chips) 
Seat 2: chiyuki ($27.36 in chips) 
Seat 3: phate-1up ($49.48 in chips) 
Seat 4: 1Karina1 ($27.92 in chips) 
Seat 5: KrystalAA ($13.37 in chips) 
Seat 6: aSasha280 ($15.23 in chips) 
Seat 7: mjmichi ($47.59 in chips) 
Seat 8: Grishukps ($12.50 in chips) 
Seat 9: Dejacob ($25 in chips) 
chiyuki: posts small blind $0.10
phate-1up: posts big blind $0.25
*** HOLE CARDS ***
Dealt to chiyuki [4d Kh]
1Karina1: raises $0.50 to $0.75
KrystalAA: folds 
aSasha280: folds 
mjmichi: calls $0.75
Grishukps: folds 
Dejacob: folds 
PAMBOS.L: calls $0.75
chiyuki: folds 
phate-1up: folds 
*** FLOP *** [Ts 2h 4s]
1Karina1: bets $1.75
mjmichi: calls $1.75
PAMBOS.L: calls $1.75
*** TURN *** [Ts 2h 4s] [Tc]
1Karina1: checks 
mjmichi: checks 
PAMBOS.L: checks 
*** RIVER *** [Ts 2h 4s Tc] [As]
1Karina1: checks 
mjmichi: checks 
PAMBOS.L: bets $3.75
1Karina1: folds 
mjmichi: calls $3.75
*** SHOW DOWN ***
PAMBOS.L: shows [7s Qs] (a flush, Ace high)
mjmichi: mucks hand 
PAMBOS.L collected $14.66 from pot
*** SUMMARY ***
Total pot $15.35 | Rake $0.69 
Board [Ts 2h 4s Tc As]
Seat 1: PAMBOS.L (button) showed [7s Qs] and won ($14.66) with a flush, Ace high
Seat 2: chiyuki (small blind) folded before Flop
Seat 3: phate-1up (big blind) folded before Flop
Seat 4: 1Karina1 folded on the River
Seat 5: KrystalAA folded before Flop (didn't bet)
Seat 6: aSasha280 folded before Flop (didn't bet)
Seat 7: mjmichi mucked [Ac Kc]
Seat 8: Grishukps folded before Flop (didn't bet)
Seat 9: Dejacob folded before Flop (didn't bet)



PokerStars Zoom Hand #84300519496:  Hold'em No Limit ($0.10/$0.25) - 2012/08/05 15:33:29 JST [2012/08/05 2:33:29 ET]
Table 'Whirlpool' 9-max Seat #1 is the button
Seat 1: INSP!RON ($48.22 in chips) 
Seat 2: Grishukps ($12.50 in chips) 
Seat 3: Spheroff ($24.12 in chips) 
Seat 4: nice.franki ($10.75 in chips) 
Seat 5: ZhukOFFskI ($35.18 in chips) 
Seat 6: chiyuki ($27.61 in chips) 
Seat 7: seula i ($25.35 in chips) 
Seat 8: Wilcox76607 ($13.54 in chips) 
Seat 9: crazycrown1 ($12.56 in chips) 
Grishukps: posts small blind $0.10
Spheroff: posts big blind $0.25
*** HOLE CARDS ***
Dealt to chiyuki [4h Qd]
nice.franki: folds 
ZhukOFFskI: folds 
chiyuki: folds 
seula i: raises $0.50 to $0.75
Wilcox76607: folds 
crazycrown1: calls $0.75
INSP!RON: folds 
Grishukps: folds 
Spheroff: folds 
*** FLOP *** [Ts Ah As]
seula i: bets $1.25
crazycrown1: folds 
Uncalled bet ($1.25) returned to seula i
seula i collected $1.77 from pot
seula i: doesn't show hand 
*** SUMMARY ***
Total pot $1.85 | Rake $0.08 
Board [Ts Ah As]
Seat 1: INSP!RON (button) folded before Flop (didn't bet)
Seat 2: Grishukps (small blind) folded before Flop
Seat 3: Spheroff (big blind) folded before Flop
Seat 4: nice.franki folded before Flop (didn't bet)
Seat 5: ZhukOFFskI folded before Flop (didn't bet)
Seat 6: chiyuki folded before Flop (didn't bet)
Seat 7: seula i collected ($1.77)
Seat 8: Wilcox76607 folded before Flop (didn't bet)
Seat 9: crazycrown1 folded on the Flop



PokerStars Zoom Hand #84300520289:  Hold'em No Limit ($0.10/$0.25) - 2012/08/05 15:33:32 JST [2012/08/05 2:33:32 ET]
Table 'Whirlpool' 9-max Seat #1 is the button
Seat 1: chiyuki ($27.61 in chips) 
Seat 2: panaam ($29.09 in chips) 
Seat 3: KeLevro0 ($11.24 in chips) 
Seat 4: Nerkit ($13.66 in chips) 
Seat 5: 1Karina1 ($25 in chips) 
Seat 6: leo2095 ($19.55 in chips) 
Seat 7: hirozo ($43.43 in chips) 
Seat 8: herkko11 ($8.52 in chips) 
Seat 9: GovGus ($41.56 in chips) 
panaam: posts small blind $0.10
KeLevro0: posts big blind $0.25
*** HOLE CARDS ***
Dealt to chiyuki [Tc 4c]
Nerkit: folds 
1Karina1: folds 
leo2095: folds 
hirozo: folds 
herkko11: folds 
GovGus: folds 
chiyuki: folds 
panaam: calls $0.15
KeLevro0: checks 
*** FLOP *** [5d 4s 5s]
panaam: checks 
KeLevro0: checks 
*** TURN *** [5d 4s 5s] [Kd]
panaam: checks 
KeLevro0: checks 
*** RIVER *** [5d 4s 5s Kd] [Td]
panaam: checks 
KeLevro0: checks 
*** SHOW DOWN ***
panaam: shows [9s 8s] (a pair of Fives)
KeLevro0: shows [6c Jd] (a pair of Fives - King+Jack kicker)
KeLevro0 collected $0.48 from pot
*** SUMMARY ***
Total pot $0.50 | Rake $0.02 
Board [5d 4s 5s Kd Td]
Seat 1: chiyuki (button) folded before Flop (didn't bet)
Seat 2: panaam (small blind) showed [9s 8s] and lost with a pair of Fives
Seat 3: KeLevro0 (big blind) showed [6c Jd] and won ($0.48) with a pair of Fives
Seat 4: Nerkit folded before Flop (didn't bet)
Seat 5: 1Karina1 folded before Flop (didn't bet)
Seat 6: leo2095 folded before Flop (didn't bet)
Seat 7: hirozo folded before Flop (didn't bet)
Seat 8: herkko11 folded before Flop (didn't bet)
Seat 9: GovGus folded before Flop (didn't bet)



PokerStars Zoom Hand #84300522653:  Hold'em No Limit ($0.10/$0.25) - 2012/08/05 15:33:41 JST [2012/08/05 2:33:41 ET]
Table 'Whirlpool' 9-max Seat #1 is the button
Seat 1: JhonnyP1979 ($23.18 in chips) 
Seat 2: nice.franki ($13 in chips) 
Seat 3: phate-1up ($74.21 in chips) 
Seat 4: snejokCoxx ($13.50 in chips) 
Seat 5: ziggzagg77 ($8.57 in chips) 
Seat 6: kaplya2010 ($17.39 in chips) 
Seat 7: DutchShultzs ($25 in chips) 
Seat 8: AAAKK777 ($22.26 in chips) 
Seat 9: chiyuki ($27.61 in chips) 
nice.franki: posts small blind $0.10
phate-1up: posts big blind $0.25
*** HOLE CARDS ***
Dealt to chiyuki [3s 4c]
snejokCoxx: folds 
ziggzagg77: raises $8.32 to $8.57 and is all-in
kaplya2010: folds 
DutchShultzs: folds 
AAAKK777: calls $8.57
chiyuki: folds 
JhonnyP1979: folds 
nice.franki: folds 
phate-1up: folds 
*** FLOP *** [2h 8c 6d]
*** TURN *** [2h 8c 6d] [Qc]
*** RIVER *** [2h 8c 6d Qc] [6c]
*** SHOW DOWN ***
ziggzagg77: shows [Qd Ah] (two pair, Queens and Sixes)
AAAKK777: shows [Qh Kh] (two pair, Queens and Sixes - lower kicker)
ziggzagg77 collected $16.70 from pot
*** SUMMARY ***
Total pot $17.49 | Rake $0.79 
Board [2h 8c 6d Qc 6c]
Seat 1: JhonnyP1979 (button) folded before Flop (didn't bet)
Seat 2: nice.franki (small blind) folded before Flop
Seat 3: phate-1up (big blind) folded before Flop
Seat 4: snejokCoxx folded before Flop (didn't bet)
Seat 5: ziggzagg77 showed [Qd Ah] and won ($16.70) with two pair, Queens and Sixes
Seat 6: kaplya2010 folded before Flop (didn't bet)
Seat 7: DutchShultzs folded before Flop (didn't bet)
Seat 8: AAAKK777 showed [Qh Kh] and lost with two pair, Queens and Sixes
Seat 9: chiyuki folded before Flop (didn't bet)



PokerStars Zoom Hand #84300523853:  Hold'em No Limit ($0.10/$0.25) - 2012/08/05 15:33:46 JST [2012/08/05 2:33:46 ET]
Table 'Whirlpool' 9-max Seat #1 is the button
Seat 1: kesstukas25 ($14.65 in chips) 
Seat 2: Nerkit ($12.81 in chips) 
Seat 3: chiyuki ($27.61 in chips) 
Seat 4: God)Squall ($29.38 in chips) 
Seat 5: pandaaaaaa ($10.09 in chips) 
Seat 6: WARIBANA7777 ($16.23 in chips) 
Seat 7: 1Karina1 ($36.30 in chips) 
Seat 8: jacquelinewu ($25.10 in chips) 
Seat 9: Faraz ($13.11 in chips) 
Nerkit: posts small blind $0.10
chiyuki: posts big blind $0.25
*** HOLE CARDS ***
Dealt to chiyuki [6c 9c]
God)Squall: folds 
pandaaaaaa: folds 
WARIBANA7777: folds 
1Karina1: folds 
jacquelinewu: folds 
Faraz: raises $0.25 to $0.50
kesstukas25: folds 
Nerkit: calls $0.40
chiyuki: calls $0.25
*** FLOP *** [3s Ks Ah]
Nerkit: bets $0.74
chiyuki: folds 
Faraz: folds 
Uncalled bet ($0.74) returned to Nerkit
Nerkit collected $1.43 from pot
Nerkit: doesn't show hand 
*** SUMMARY ***
Total pot $1.50 | Rake $0.07 
Board [3s Ks Ah]
Seat 1: kesstukas25 (button) folded before Flop (didn't bet)
Seat 2: Nerkit (small blind) collected ($1.43)
Seat 3: chiyuki (big blind) folded on the Flop
Seat 4: God)Squall folded before Flop (didn't bet)
Seat 5: pandaaaaaa folded before Flop (didn't bet)
Seat 6: WARIBANA7777 folded before Flop (didn't bet)
Seat 7: 1Karina1 folded before Flop (didn't bet)
Seat 8: jacquelinewu folded before Flop (didn't bet)
Seat 9: Faraz folded on the Flop



PokerStars Zoom Hand #84300535352:  Hold'em No Limit ($0.10/$0.25) - 2012/08/05 15:34:32 JST [2012/08/05 2:34:32 ET]
Table 'Whirlpool' 9-max Seat #1 is the button
Seat 1: GovGus ($41.31 in chips) 
Seat 2: 1Karina1 ($25.17 in chips) 
Seat 3: KimPa39 ($12.10 in chips) 
Seat 4: fil740 ($9.61 in chips) 
Seat 5: chiyuki ($27.11 in chips) 
Seat 6: phate-1up ($73.86 in chips) 
Seat 7: Fructionar ($25.45 in chips) 
Seat 8: snejokCoxx ($13.40 in chips) 
Seat 9: Ellen1947 ($24.45 in chips) 
1Karina1: posts small blind $0.10
KimPa39: posts big blind $0.25
*** HOLE CARDS ***
Dealt to chiyuki [Th 8d]
fil740: raises $0.50 to $0.75
chiyuki: folds 
phate-1up: folds 
Fructionar: folds 
snejokCoxx: folds 
Ellen1947: folds 
GovGus: folds 
1Karina1: folds 
KimPa39: folds 
Uncalled bet ($0.50) returned to fil740
fil740 collected $0.60 from pot
fil740: doesn't show hand 
*** SUMMARY ***
Total pot $0.60 | Rake $0 
Seat 1: GovGus (button) folded before Flop (didn't bet)
Seat 2: 1Karina1 (small blind) folded before Flop
Seat 3: KimPa39 (big blind) folded before Flop
Seat 4: fil740 collected ($0.60)
Seat 5: chiyuki folded before Flop (didn't bet)
Seat 6: phate-1up folded before Flop (didn't bet)
Seat 7: Fructionar folded before Flop (didn't bet)
Seat 8: snejokCoxx folded before Flop (didn't bet)
Seat 9: Ellen1947 folded before Flop (didn't bet)



PokerStars Zoom Hand #84300537608:  Hold'em No Limit ($0.10/$0.25) - 2012/08/05 15:34:41 JST [2012/08/05 2:34:41 ET]
Table 'Whirlpool' 9-max Seat #1 is the button
Seat 1: Rilko1975 ($26.88 in chips) 
Seat 2: chiyuki ($27.11 in chips) 
Seat 3: Grishukps ($12.50 in chips) 
Seat 4: opie62 ($28.80 in chips) 
Seat 5: KeLevro0 ($11.90 in chips) 
Seat 6: 4plankton ($27.36 in chips) 
Seat 7: phate-1up ($60.98 in chips) 
Seat 8: JhonnyP1979 ($17.10 in chips) 
Seat 9: kesstukas25 ($14.65 in chips) 
chiyuki: posts small blind $0.10
Grishukps: posts big blind $0.25
*** HOLE CARDS ***
Dealt to chiyuki [2c 9h]
opie62: folds 
KeLevro0: folds 
4plankton: folds 
phate-1up: folds 
JhonnyP1979: folds 
kesstukas25: folds 
Rilko1975: folds 
chiyuki: folds 
Uncalled bet ($0.15) returned to Grishukps
Grishukps collected $0.20 from pot
Grishukps: doesn't show hand 
*** SUMMARY ***
Total pot $0.20 | Rake $0 
Seat 1: Rilko1975 (button) folded before Flop (didn't bet)
Seat 2: chiyuki (small blind) folded before Flop
Seat 3: Grishukps (big blind) collected ($0.20)
Seat 4: opie62 folded before Flop (didn't bet)
Seat 5: KeLevro0 folded before Flop (didn't bet)
Seat 6: 4plankton folded before Flop (didn't bet)
Seat 7: phate-1up folded before Flop (didn't bet)
Seat 8: JhonnyP1979 folded before Flop (didn't bet)
Seat 9: kesstukas25 folded before Flop (didn't bet)



PokerStars Zoom Hand #84300539605:  Hold'em No Limit ($0.10/$0.25) - 2012/08/05 15:34:49 JST [2012/08/05 2:34:49 ET]
Table 'Whirlpool' 9-max Seat #1 is the button
Seat 1: chiyuki ($27.01 in chips) 
Seat 2: snejokCoxx ($11.75 in chips) 
Seat 3: hirozo ($89.83 in chips) 
Seat 4: PAMBOS.L ($22.13 in chips) 
Seat 5: ZhukOFFskI ($79.61 in chips) 
Seat 6: Serge Claws ($25 in chips) 
Seat 7: Vahe50 ($16.22 in chips) 
Seat 8: seula i ($25 in chips) 
Seat 9: Grishukps ($12.60 in chips) 
snejokCoxx: posts small blind $0.10
hirozo: posts big blind $0.25
*** HOLE CARDS ***
Dealt to chiyuki [7h Kd]
PAMBOS.L: folds 
ZhukOFFskI: folds 
Serge Claws: folds 
Vahe50: folds 
seula i: raises $0.50 to $0.75
Grishukps: folds 
chiyuki: folds 
snejokCoxx: folds 
hirozo: folds 
Uncalled bet ($0.50) returned to seula i
seula i collected $0.60 from pot
seula i: doesn't show hand 
*** SUMMARY ***
Total pot $0.60 | Rake $0 
Seat 1: chiyuki (button) folded before Flop (didn't bet)
Seat 2: snejokCoxx (small blind) folded before Flop
Seat 3: hirozo (big blind) folded before Flop
Seat 4: PAMBOS.L folded before Flop (didn't bet)
Seat 5: ZhukOFFskI folded before Flop (didn't bet)
Seat 6: Serge Claws folded before Flop (didn't bet)
Seat 7: Vahe50 folded before Flop (didn't bet)
Seat 8: seula i collected ($0.60)
Seat 9: Grishukps folded before Flop (didn't bet)



PokerStars Zoom Hand #84300538616:  Hold'em No Limit ($0.10/$0.25) - 2012/08/05 15:34:45 JST [2012/08/05 2:34:45 ET]
Table 'Whirlpool' 9-max Seat #1 is the button
Seat 1: Nerkit ($13.74 in chips) 
Seat 2: JhonnyP1979 ($17.10 in chips) 
Seat 3: Rilko1975 ($26.88 in chips) 
Seat 4: GovGus ($43.60 in chips) 
Seat 5: KrystalAA ($22.18 in chips) 
Seat 6: seula i ($25 in chips) 
Seat 7: fil740 ($9.96 in chips) 
Seat 8: kesstukas25 ($14.65 in chips) 
Seat 9: chiyuki ($27.01 in chips) 
JhonnyP1979: posts small blind $0.10
Rilko1975: posts big blind $0.25
*** HOLE CARDS ***
Dealt to chiyuki [9c Jd]
GovGus: folds 
KrystalAA: raises $0.46 to $0.71
seula i: folds 
fil740: folds 
kesstukas25: folds 
chiyuki: folds 
Nerkit: folds 
JhonnyP1979: calls $0.61
Rilko1975: folds 
*** FLOP *** [Qs As 8c]
JhonnyP1979: checks 
KrystalAA: bets $1.70
JhonnyP1979: folds 
Uncalled bet ($1.70) returned to KrystalAA
KrystalAA collected $1.59 from pot
KrystalAA: doesn't show hand 
*** SUMMARY ***
Total pot $1.67 | Rake $0.08 
Board [Qs As 8c]
Seat 1: Nerkit (button) folded before Flop (didn't bet)
Seat 2: JhonnyP1979 (small blind) folded on the Flop
Seat 3: Rilko1975 (big blind) folded before Flop
Seat 4: GovGus folded before Flop (didn't bet)
Seat 5: KrystalAA collected ($1.59)
Seat 6: seula i folded before Flop (didn't bet)
Seat 7: fil740 folded before Flop (didn't bet)
Seat 8: kesstukas25 folded before Flop (didn't bet)
Seat 9: chiyuki folded before Flop (didn't bet)



PokerStars Zoom Hand #84300536880:  Hold'em No Limit ($0.10/$0.25) - 2012/08/05 15:34:38 JST [2012/08/05 2:34:38 ET]
Table 'Whirlpool' 9-max Seat #1 is the button
Seat 1: KeLevro0 ($11.82 in chips) 
Seat 2: herkko11 ($8.27 in chips) 
Seat 3: Dan Royal ($41.58 in chips) 
Seat 4: chiyuki ($27.11 in chips) 
Seat 5: Robchie ($22.34 in chips) 
Seat 6: KimPa39 ($11.85 in chips) 
Seat 7: Serge Claws ($25.85 in chips) 
Seat 8: kesstukas25 ($14.65 in chips) 
Seat 9: 1Karina1 ($35.95 in chips) 
herkko11: posts small blind $0.10
Dan Royal: posts big blind $0.25
*** HOLE CARDS ***
Dealt to chiyuki [3s 9d]
chiyuki: folds 
Robchie: folds 
KimPa39: folds 
Serge Claws: folds 
kesstukas25: folds 
1Karina1: folds 
KeLevro0: raises $0.42 to $0.67
herkko11: calls $0.57
Dan Royal: folds 
*** FLOP *** [Kd Ac 8d]
herkko11: bets $0.50
KeLevro0: calls $0.50
*** TURN *** [Kd Ac 8d] [Ad]
herkko11: bets $0.50
KeLevro0: folds 
Uncalled bet ($0.50) returned to herkko11
herkko11 collected $2.47 from pot
herkko11: doesn't show hand 
*** SUMMARY ***
Total pot $2.59 | Rake $0.12 
Board [Kd Ac 8d Ad]
Seat 1: KeLevro0 (button) folded on the Turn
Seat 2: herkko11 (small blind) collected ($2.47)
Seat 3: Dan Royal (big blind) folded before Flop
Seat 4: chiyuki folded before Flop (didn't bet)
Seat 5: Robchie folded before Flop (didn't bet)
Seat 6: KimPa39 folded before Flop (didn't bet)
Seat 7: Serge Claws folded before Flop (didn't bet)
Seat 8: kesstukas25 folded before Flop (didn't bet)
Seat 9: 1Karina1 folded before Flop (didn't bet)



PokerStars Zoom Hand #84300546213:  Hold'em No Limit ($0.10/$0.25) - 2012/08/05 15:35:15 JST [2012/08/05 2:35:15 ET]
Table 'Whirlpool' 9-max Seat #1 is the button
Seat 1: kwkim73 ($27.30 in chips) 
Seat 2: genamator ($19.28 in chips) 
Seat 3: kaplya2010 ($15.79 in chips) 
Seat 4: PAMBOS.L ($22.03 in chips) 
Seat 5: ChrisCDee ($32.29 in chips) 
Seat 6: KrystalAA ($15.68 in chips) 
Seat 7: chiyuki ($27.01 in chips) 
Seat 8: kesstukas25 ($14.30 in chips) 
Seat 9: Grishukps ($12.50 in chips) 
genamator: posts small blind $0.10
kaplya2010: posts big blind $0.25
*** HOLE CARDS ***
Dealt to chiyuki [Ks Td]
PAMBOS.L: folds 
ChrisCDee: folds 
KrystalAA: folds 
chiyuki: folds 
kesstukas25: folds 
Grishukps: folds 
kwkim73: raises $0.50 to $0.75
genamator: folds 
kaplya2010: folds 
Uncalled bet ($0.50) returned to kwkim73
kwkim73 collected $0.60 from pot
kwkim73: doesn't show hand 
*** SUMMARY ***
Total pot $0.60 | Rake $0 
Seat 1: kwkim73 (button) collected ($0.60)
Seat 2: genamator (small blind) folded before Flop
Seat 3: kaplya2010 (big blind) folded before Flop
Seat 4: PAMBOS.L folded before Flop (didn't bet)
Seat 5: ChrisCDee folded before Flop (didn't bet)
Seat 6: KrystalAA folded before Flop (didn't bet)
Seat 7: chiyuki folded before Flop (didn't bet)
Seat 8: kesstukas25 folded before Flop (didn't bet)
Seat 9: Grishukps folded before Flop (didn't bet)



PokerStars Zoom Hand #84300536143:  Hold'em No Limit ($0.10/$0.25) - 2012/08/05 15:34:35 JST [2012/08/05 2:34:35 ET]
Table 'Whirlpool' 9-max Seat #1 is the button
Seat 1: Perstenev ($12.10 in chips) 
Seat 2: mjmichi ($57.22 in chips) 
Seat 3: tribunpdm ($40.01 in chips) 
Seat 4: chiyuki ($27.11 in chips) 
Seat 5: KeLevro0 ($12.15 in chips) 
Seat 6: svg51 ($4.32 in chips) 
Seat 7: masterkoolb ($13.52 in chips) 
Seat 8: Wilcox76607 ($13.54 in chips) 
Seat 9: hirozo ($71.18 in chips) 
mjmichi: posts small blind $0.10
tribunpdm: posts big blind $0.25
*** HOLE CARDS ***
Dealt to chiyuki [3h 9h]
chiyuki: folds 
KeLevro0: folds 
svg51: folds 
masterkoolb: folds 
Wilcox76607: folds 
hirozo: raises $0.50 to $0.75
Perstenev: folds 
mjmichi: folds 
tribunpdm: calls $0.50
*** FLOP *** [3d 8d 9c]
tribunpdm: checks 
hirozo: bets $1.02
tribunpdm: calls $1.02
*** TURN *** [3d 8d 9c] [5s]
tribunpdm: checks 
hirozo: bets $2.32
tribunpdm: folds 
Uncalled bet ($2.32) returned to hirozo
hirozo collected $3.48 from pot
hirozo: doesn't show hand 
hirozo is disconnected 
*** SUMMARY ***
Total pot $3.64 | Rake $0.16 
Board [3d 8d 9c 5s]
Seat 1: Perstenev (button) folded before Flop (didn't bet)
Seat 2: mjmichi (small blind) folded before Flop
Seat 3: tribunpdm (big blind) folded on the Turn
Seat 4: chiyuki folded before Flop (didn't bet)
Seat 5: KeLevro0 folded before Flop (didn't bet)
Seat 6: svg51 folded before Flop (didn't bet)
Seat 7: masterkoolb folded before Flop (didn't bet)
Seat 8: Wilcox76607 folded before Flop (didn't bet)
Seat 9: hirozo collected ($3.48)



PokerStars Zoom Hand #84300549219:  Hold'em No Limit ($0.10/$0.25) - 2012/08/05 15:35:28 JST [2012/08/05 2:35:28 ET]
Table 'Whirlpool' 9-max Seat #1 is the button
Seat 1: ziggzagg77 ($28.18 in chips) 
Seat 2: chiyuki ($27.01 in chips) 
Seat 3: leo2095 ($18.20 in chips) 
Seat 4: KeLevro0 ($10.55 in chips) 
Seat 5: Rici47 ($30.99 in chips) 
Seat 6: kamikkaze ($15.80 in chips) 
Seat 7: macmauret ($14.89 in chips) 
Seat 8: NuMetal88 ($29.45 in chips) 
Seat 9: herkko11 ($9.57 in chips) 
chiyuki: posts small blind $0.10
leo2095: posts big blind $0.25
*** HOLE CARDS ***
Dealt to chiyuki [Ks 8c]
KeLevro0: folds 
Rici47: folds 
kamikkaze: folds 
macmauret: folds 
NuMetal88: folds 
herkko11: folds 
ziggzagg77: folds 
chiyuki: folds 
Uncalled bet ($0.15) returned to leo2095
leo2095 collected $0.20 from pot
leo2095: doesn't show hand 
*** SUMMARY ***
Total pot $0.20 | Rake $0 
Seat 1: ziggzagg77 (button) folded before Flop (didn't bet)
Seat 2: chiyuki (small blind) folded before Flop
Seat 3: leo2095 (big blind) collected ($0.20)
Seat 4: KeLevro0 folded before Flop (didn't bet)
Seat 5: Rici47 folded before Flop (didn't bet)
Seat 6: kamikkaze folded before Flop (didn't bet)
Seat 7: macmauret folded before Flop (didn't bet)
Seat 8: NuMetal88 folded before Flop (didn't bet)
Seat 9: herkko11 folded before Flop (didn't bet)



PokerStars Zoom Hand #84300540591:  Hold'em No Limit ($0.10/$0.25) - 2012/08/05 15:34:53 JST [2012/08/05 2:34:53 ET]
Table 'Whirlpool' 9-max Seat #1 is the button
Seat 1: Grishukps ($12.60 in chips) 
Seat 2: PAMBOS.L ($22.13 in chips) 
Seat 3: INSP!RON ($49.71 in chips) 
Seat 4: NuMetal88 ($25 in chips) 
Seat 5: Vahe50 ($16.22 in chips) 
Seat 6: Robchie ($22.34 in chips) 
Seat 7: GSDP ($14.44 in chips) 
Seat 8: chiyuki ($27.01 in chips) 
Seat 9: Nerkit ($13.56 in chips) 
PAMBOS.L: posts small blind $0.10
INSP!RON: posts big blind $0.25
*** HOLE CARDS ***
Dealt to chiyuki [5s 9d]
NuMetal88: folds 
Vahe50: raises $0.50 to $0.75
Robchie: folds 
GSDP: calls $0.75
chiyuki: folds 
Nerkit: folds 
Grishukps: folds 
PAMBOS.L: folds 
INSP!RON: folds 
*** FLOP *** [4s 9c 2d]
Vahe50: bets $1.25
GSDP: calls $1.25
*** TURN *** [4s 9c 2d] [9s]
Vahe50: checks 
GSDP: bets $2.75
Vahe50: folds 
Uncalled bet ($2.75) returned to GSDP
GSDP collected $4.15 from pot
GSDP: doesn't show hand 
*** SUMMARY ***
Total pot $4.35 | Rake $0.20 
Board [4s 9c 2d 9s]
Seat 1: Grishukps (button) folded before Flop (didn't bet)
Seat 2: PAMBOS.L (small blind) folded before Flop
Seat 3: INSP!RON (big blind) folded before Flop
Seat 4: NuMetal88 folded before Flop (didn't bet)
Seat 5: Vahe50 folded on the Turn
Seat 6: Robchie folded before Flop (didn't bet)
Seat 7: GSDP collected ($4.15)
Seat 8: chiyuki folded before Flop (didn't bet)
Seat 9: Nerkit folded before Flop (didn't bet)



PokerStars Zoom Hand #84300553270:  Hold'em No Limit ($0.10/$0.25) - 2012/08/05 15:35:44 JST [2012/08/05 2:35:44 ET]
Table 'Whirlpool' 9-max Seat #1 is the button
Seat 1: Grishukps ($13.28 in chips) 
Seat 2: HighDuka ($38.98 in chips) 
Seat 3: chiyuki ($26.91 in chips) 
Seat 4: Nerkit ($13.39 in chips) 
Seat 5: Gichboy ($10.78 in chips) 
Seat 6: ZhukOFFskI ($79.51 in chips) 
Seat 7: kwkim73 ($27.65 in chips) 
Seat 8: nice.franki ($14.70 in chips) 
Seat 9: kesstukas25 ($14.05 in chips) 
HighDuka: posts small blind $0.10
chiyuki: posts big blind $0.25
*** HOLE CARDS ***
Dealt to chiyuki [3h Qh]
Nerkit: folds 
Gichboy: folds 
ZhukOFFskI: raises $0.50 to $0.75
kwkim73: folds 
nice.franki: folds 
kesstukas25: folds 
Grishukps: folds 
HighDuka: folds 
chiyuki: folds 
Uncalled bet ($0.50) returned to ZhukOFFskI
ZhukOFFskI collected $0.60 from pot
ZhukOFFskI: doesn't show hand 
*** SUMMARY ***
Total pot $0.60 | Rake $0 
Seat 1: Grishukps (button) folded before Flop (didn't bet)
Seat 2: HighDuka (small blind) folded before Flop
Seat 3: chiyuki (big blind) folded before Flop
Seat 4: Nerkit folded before Flop (didn't bet)
Seat 5: Gichboy folded before Flop (didn't bet)
Seat 6: ZhukOFFskI collected ($0.60)
Seat 7: kwkim73 folded before Flop (didn't bet)
Seat 8: nice.franki folded before Flop (didn't bet)
Seat 9: kesstukas25 folded before Flop (didn't bet)



PokerStars Zoom Hand #84300543345:  Hold'em No Limit ($0.10/$0.25) - 2012/08/05 15:35:04 JST [2012/08/05 2:35:04 ET]
Table 'Whirlpool' 9-max Seat #1 is the button
Seat 1: Serge Claws ($26.10 in chips) 
Seat 2: ViTiV2010 ($12.35 in chips) 
Seat 3: kesstukas25 ($14.65 in chips) 
Seat 4: silvno31 ($43.42 in chips) 
Seat 5: chiyuki ($27.01 in chips) 
Seat 6: wildy29 ($40.13 in chips) 
Seat 7: jacquelinewu ($25 in chips) 
Seat 8: deadmoneykid ($29.22 in chips) 
Seat 9: phate-1up ($60.88 in chips) 
ViTiV2010: posts small blind $0.10
kesstukas25: posts big blind $0.25
*** HOLE CARDS ***
Dealt to chiyuki [Kh 3d]
silvno31: raises $0.50 to $0.75
chiyuki: folds 
wildy29: calls $0.75
jacquelinewu: folds 
deadmoneykid: folds 
phate-1up: folds 
Serge Claws: folds 
ViTiV2010: folds 
kesstukas25: folds 
*** FLOP *** [Jd 4h Qh]
silvno31: bets $1
wildy29: calls $1
*** TURN *** [Jd 4h Qh] [5d]
silvno31: checks 
wildy29: bets $1
silvno31: calls $1
*** RIVER *** [Jd 4h Qh 5d] [7s]
silvno31: checks 
wildy29: bets $2.75
silvno31: folds 
Uncalled bet ($2.75) returned to wildy29
wildy29 collected $5.59 from pot
wildy29: doesn't show hand 
*** SUMMARY ***
Total pot $5.85 | Rake $0.26 
Board [Jd 4h Qh 5d 7s]
Seat 1: Serge Claws (button) folded before Flop (didn't bet)
Seat 2: ViTiV2010 (small blind) folded before Flop
Seat 3: kesstukas25 (big blind) folded before Flop
Seat 4: silvno31 folded on the River
Seat 5: chiyuki folded before Flop (didn't bet)
Seat 6: wildy29 collected ($5.59)
Seat 7: jacquelinewu folded before Flop (didn't bet)
Seat 8: deadmoneykid folded before Flop (didn't bet)
Seat 9: phate-1up folded before Flop (didn't bet)



PokerStars Zoom Hand #84300557079:  Hold'em No Limit ($0.10/$0.25) - 2012/08/05 15:35:59 JST [2012/08/05 2:35:59 ET]
Table 'Whirlpool' 9-max Seat #1 is the button
Seat 1: 1Karina1 ($31.96 in chips) 
Seat 2: DutchShultzs ($27.37 in chips) 
Seat 3: GSDP ($16.94 in chips) 
Seat 4: INSP!RON ($38.13 in chips) 
Seat 5: NuMetal88 ($29.20 in chips) 
Seat 6: chiyuki ($26.66 in chips) 
Seat 7: phate-1up ($73.61 in chips) 
Seat 8: Silveystryk ($20.72 in chips) 
Seat 9: KrystalAA ($15.68 in chips) 
DutchShultzs: posts small blind $0.10
GSDP: posts big blind $0.25
*** HOLE CARDS ***
Dealt to chiyuki [6d 5d]
INSP!RON: folds 
NuMetal88: folds 
chiyuki: folds 
phate-1up: folds 
Silveystryk: raises $0.25 to $0.50
KrystalAA: folds 
1Karina1: folds 
DutchShultzs: folds 
GSDP: calls $0.25
*** FLOP *** [2h 2s Ks]
GSDP: checks 
Silveystryk: bets $0.50
GSDP: folds 
Uncalled bet ($0.50) returned to Silveystryk
Silveystryk collected $1.05 from pot
Silveystryk: doesn't show hand 
*** SUMMARY ***
Total pot $1.10 | Rake $0.05 
Board [2h 2s Ks]
Seat 1: 1Karina1 (button) folded before Flop (didn't bet)
Seat 2: DutchShultzs (small blind) folded before Flop
Seat 3: GSDP (big blind) folded on the Flop
Seat 4: INSP!RON folded before Flop (didn't bet)
Seat 5: NuMetal88 folded before Flop (didn't bet)
Seat 6: chiyuki folded before Flop (didn't bet)
Seat 7: phate-1up folded before Flop (didn't bet)
Seat 8: Silveystryk collected ($1.05)
Seat 9: KrystalAA folded before Flop (didn't bet)



PokerStars Zoom Hand #84300561158:  Hold'em No Limit ($0.10/$0.25) - 2012/08/05 15:36:15 JST [2012/08/05 2:36:15 ET]
Table 'Whirlpool' 9-max Seat #1 is the button
Seat 1: laurentzu84 ($43.23 in chips) 
Seat 2: Jene4kaBest ($11.75 in chips) 
Seat 3: kamikkaze ($16.15 in chips) 
Seat 4: Nerkit ($13.66 in chips) 
Seat 5: chiyuki ($26.66 in chips) 
Seat 6: DutchShultzs ($25 in chips) 
Seat 7: nice.franki ($11.60 in chips) 
Seat 8: Perstenev ($11.75 in chips) 
Seat 9: phate-1up ($73.61 in chips) 
Jene4kaBest: posts small blind $0.10
kamikkaze: posts big blind $0.25
*** HOLE CARDS ***
Dealt to chiyuki [Qh Qd]
Nerkit: folds 
chiyuki: raises $0.50 to $0.75
DutchShultzs: folds 
nice.franki: folds 
Perstenev: folds 
phate-1up: folds 
laurentzu84: folds 
Jene4kaBest: folds 
kamikkaze: folds 
Uncalled bet ($0.50) returned to chiyuki
chiyuki collected $0.60 from pot
chiyuki: doesn't show hand 
*** SUMMARY ***
Total pot $0.60 | Rake $0 
Seat 1: laurentzu84 (button) folded before Flop (didn't bet)
Seat 2: Jene4kaBest (small blind) folded before Flop
Seat 3: kamikkaze (big blind) folded before Flop
Seat 4: Nerkit folded before Flop (didn't bet)
Seat 5: chiyuki collected ($0.60)
Seat 6: DutchShultzs folded before Flop (didn't bet)
Seat 7: nice.franki folded before Flop (didn't bet)
Seat 8: Perstenev folded before Flop (didn't bet)
Seat 9: phate-1up folded before Flop (didn't bet)



PokerStars Zoom Hand #84300557838:  Hold'em No Limit ($0.10/$0.25) - 2012/08/05 15:36:02 JST [2012/08/05 2:36:02 ET]
Table 'Whirlpool' 9-max Seat #1 is the button
Seat 1: chiyuki ($26.66 in chips) 
Seat 2: turbotom122 ($11.75 in chips) 
Seat 3: WARIBANA7777 ($16.13 in chips) 
Seat 4: kwkim73 ($27.65 in chips) 
Seat 5: genamator ($19.18 in chips) 
Seat 6: snejokCoxx ($12.34 in chips) 
Seat 7: ziggzagg77 ($28.18 in chips) 
Seat 8: pandaaaaaa ($8.99 in chips) 
Seat 9: opie62 ($26.55 in chips) 
turbotom122: posts small blind $0.10
WARIBANA7777: posts big blind $0.25
*** HOLE CARDS ***
Dealt to chiyuki [Tc 2s]
kwkim73: folds 
genamator: folds 
snejokCoxx: folds 
ziggzagg77: raises $0.50 to $0.75
pandaaaaaa: folds 
opie62: calls $0.75
chiyuki: folds 
turbotom122: calls $0.65
WARIBANA7777: folds 
*** FLOP *** [8d 3d Kc]
turbotom122: checks 
ziggzagg77: bets $1
opie62: calls $1
turbotom122: folds 
*** TURN *** [8d 3d Kc] [2c]
ziggzagg77: bets $2
opie62: raises $2.75 to $4.75
ziggzagg77: folds 
Uncalled bet ($2.75) returned to opie62
opie62 collected $8.12 from pot
opie62: doesn't show hand 
*** SUMMARY ***
Total pot $8.50 | Rake $0.38 
Board [8d 3d Kc 2c]
Seat 1: chiyuki (button) folded before Flop (didn't bet)
Seat 2: turbotom122 (small blind) folded on the Flop
Seat 3: WARIBANA7777 (big blind) folded before Flop
Seat 4: kwkim73 folded before Flop (didn't bet)
Seat 5: genamator folded before Flop (didn't bet)
Seat 6: snejokCoxx folded before Flop (didn't bet)
Seat 7: ziggzagg77 folded on the Turn
Seat 8: pandaaaaaa folded before Flop (didn't bet)
Seat 9: opie62 collected ($8.12)



PokerStars Zoom Hand #84300564473:  Hold'em No Limit ($0.10/$0.25) - 2012/08/05 15:36:28 JST [2012/08/05 2:36:28 ET]
Table 'Whirlpool' 9-max Seat #1 is the button
Seat 1: Limoilou ($25 in chips) 
Seat 2: Silveystryk ($38.89 in chips) 
Seat 3: NuMetal88 ($25 in chips) 
Seat 4: Rici47 ($26.95 in chips) 
Seat 5: soul_5577 ($35.11 in chips) 
Seat 6: Lasutchik ($13.69 in chips) 
Seat 7: GSDP ($45.78 in chips) 
Seat 8: Gichboy ($33.68 in chips) 
Seat 9: chiyuki ($27.01 in chips) 
Silveystryk: posts small blind $0.10
NuMetal88: posts big blind $0.25
*** HOLE CARDS ***
Dealt to chiyuki [7c 2h]
Rici47: folds 
soul_5577: folds 
Lasutchik: raises $0.50 to $0.75
GSDP: folds 
Gichboy: calls $0.75
chiyuki: folds 
Limoilou: folds 
Silveystryk: calls $0.65
NuMetal88: raises $2.25 to $3
Lasutchik: calls $2.25
Gichboy: folds 
Silveystryk: folds 
*** FLOP *** [4h Js Kd]
NuMetal88: bets $5.37
Lasutchik: calls $5.37
*** TURN *** [4h Js Kd] [9s]
NuMetal88: bets $8.71
Lasutchik: calls $5.32 and is all-in
Uncalled bet ($3.39) returned to NuMetal88
*** RIVER *** [4h Js Kd 9s] [2d]
*** SHOW DOWN ***
NuMetal88: shows [Ad Ac] (a pair of Aces)
Lasutchik: shows [As Kh] (a pair of Kings)
NuMetal88 collected $27.58 from pot
*** SUMMARY ***
Total pot $28.88 | Rake $1.30 
Board [4h Js Kd 9s 2d]
Seat 1: Limoilou (button) folded before Flop (didn't bet)
Seat 2: Silveystryk (small blind) folded before Flop
Seat 3: NuMetal88 (big blind) showed [Ad Ac] and won ($27.58) with a pair of Aces
Seat 4: Rici47 folded before Flop (didn't bet)
Seat 5: soul_5577 folded before Flop (didn't bet)
Seat 6: Lasutchik showed [As Kh] and lost with a pair of Kings
Seat 7: GSDP folded before Flop (didn't bet)
Seat 8: Gichboy folded before Flop
Seat 9: chiyuki folded before Flop (didn't bet)



PokerStars Zoom Hand #84300568508:  Hold'em No Limit ($0.10/$0.25) - 2012/08/05 15:36:45 JST [2012/08/05 2:36:45 ET]
Table 'Whirlpool' 9-max Seat #1 is the button
Seat 1: phate-1up ($50.60 in chips) 
Seat 2: pandaaaaaa ($11.82 in chips) 
Seat 3: Rilko1975 ($27.78 in chips) 
Seat 4: PPP7SSS ($21.12 in chips) 
Seat 5: 4ydo yogurt ($20.33 in chips) 
Seat 6: 1Karina1 ($35.60 in chips) 
Seat 7: chiyuki ($27.01 in chips) 
Seat 8: KeLevro0 ($9.99 in chips) 
Seat 9: Nerkit ($12.39 in chips) 
pandaaaaaa: posts small blind $0.10
Rilko1975: posts big blind $0.25
*** HOLE CARDS ***
Dealt to chiyuki [As Qs]
PPP7SSS: raises $0.50 to $0.75
4ydo yogurt: folds 
1Karina1: folds 
chiyuki: raises $1.50 to $2.25
KeLevro0: folds 
Nerkit: folds 
phate-1up: folds 
pandaaaaaa: folds 
Rilko1975: folds 
PPP7SSS: calls $1.50
*** FLOP *** [8h 2c 3d]
PPP7SSS: checks 
chiyuki: bets $2.31
PPP7SSS: calls $2.31
*** TURN *** [8h 2c 3d] [8d]
PPP7SSS: bets $0.75
chiyuki: calls $0.75
*** RIVER *** [8h 2c 3d 8d] [Qd]
PPP7SSS: bets $0.75
chiyuki: calls $0.75
*** SHOW DOWN ***
PPP7SSS: shows [6h 6d] (two pair, Eights and Sixes)
chiyuki: shows [As Qs] (two pair, Queens and Eights)
chiyuki collected $11.91 from pot
*** SUMMARY ***
Total pot $12.47 | Rake $0.56 
Board [8h 2c 3d 8d Qd]
Seat 1: phate-1up (button) folded before Flop (didn't bet)
Seat 2: pandaaaaaa (small blind) folded before Flop
Seat 3: Rilko1975 (big blind) folded before Flop
Seat 4: PPP7SSS showed [6h 6d] and lost with two pair, Eights and Sixes
Seat 5: 4ydo yogurt folded before Flop (didn't bet)
Seat 6: 1Karina1 folded before Flop (didn't bet)
Seat 7: chiyuki showed [As Qs] and won ($11.91) with two pair, Queens and Eights
Seat 8: KeLevro0 folded before Flop (didn't bet)
Seat 9: Nerkit folded before Flop (didn't bet)



PokerStars Zoom Hand #84300584095:  Hold'em No Limit ($0.10/$0.25) - 2012/08/05 15:37:46 JST [2012/08/05 2:37:46 ET]
Table 'Whirlpool' 9-max Seat #1 is the button
Seat 1: kwkim73 ($25.62 in chips) 
Seat 2: PPP7SSS ($15.06 in chips) 
Seat 3: phate-1up ($62.63 in chips) 
Seat 4: KrystalAA ($20.04 in chips) 
Seat 5: Faraz ($12.47 in chips) 
Seat 6: kamikkaze ($20.88 in chips) 
Seat 7: 1Karina1 ($34.27 in chips) 
Seat 8: chiyuki ($32.86 in chips) 
Seat 9: Roglus ($20.45 in chips) 
PPP7SSS: posts small blind $0.10
phate-1up: posts big blind $0.25
*** HOLE CARDS ***
Dealt to chiyuki [Th Qh]
KrystalAA: folds 
Faraz: folds 
kamikkaze: folds 
1Karina1: folds 
chiyuki: folds 
Roglus: folds 
kwkim73: folds 
PPP7SSS: folds 
Uncalled bet ($0.15) returned to phate-1up
phate-1up collected $0.20 from pot
phate-1up: doesn't show hand 
*** SUMMARY ***
Total pot $0.20 | Rake $0 
Seat 1: kwkim73 (button) folded before Flop (didn't bet)
Seat 2: PPP7SSS (small blind) folded before Flop
Seat 3: phate-1up (big blind) collected ($0.20)
Seat 4: KrystalAA folded before Flop (didn't bet)
Seat 5: Faraz folded before Flop (didn't bet)
Seat 6: kamikkaze folded before Flop (didn't bet)
Seat 7: 1Karina1 folded before Flop (didn't bet)
Seat 8: chiyuki folded before Flop (didn't bet)
Seat 9: Roglus folded before Flop (didn't bet)



PokerStars Zoom Hand #84300588667:  Hold'em No Limit ($0.10/$0.25) - 2012/08/05 15:38:05 JST [2012/08/05 2:38:05 ET]
Table 'Whirlpool' 9-max Seat #1 is the button
Seat 1: hirozo ($72.89 in chips) 
Seat 2: INSP!RON ($47.36 in chips) 
Seat 3: snejokCoxx ($12.25 in chips) 
Seat 4: chiyuki ($32.86 in chips) 
Seat 5: Perstenev ($9.84 in chips) 
Seat 6: jacquelinewu ($74.86 in chips) 
Seat 7: Serge Claws ($27.06 in chips) 
Seat 8: kamikkaze ($20.78 in chips) 
Seat 9: mjmichi ($42.69 in chips) 
INSP!RON: posts small blind $0.10
snejokCoxx: posts big blind $0.25
*** HOLE CARDS ***
Dealt to chiyuki [7d Ks]
chiyuki: folds 
Perstenev: folds 
jacquelinewu: folds 
Serge Claws: folds 
kamikkaze: folds 
mjmichi: folds 
hirozo: folds 
INSP!RON: raises $0.50 to $0.75
snejokCoxx: folds 
Uncalled bet ($0.50) returned to INSP!RON
INSP!RON collected $0.50 from pot
INSP!RON: doesn't show hand 
*** SUMMARY ***
Total pot $0.50 | Rake $0 
Seat 1: hirozo (button) folded before Flop (didn't bet)
Seat 2: INSP!RON (small blind) collected ($0.50)
Seat 3: snejokCoxx (big blind) folded before Flop
Seat 4: chiyuki folded before Flop (didn't bet)
Seat 5: Perstenev folded before Flop (didn't bet)
Seat 6: jacquelinewu folded before Flop (didn't bet)
Seat 7: Serge Claws folded before Flop (didn't bet)
Seat 8: kamikkaze folded before Flop (didn't bet)
Seat 9: mjmichi folded before Flop (didn't bet)



PokerStars Zoom Hand #84300589717:  Hold'em No Limit ($0.10/$0.25) - 2012/08/05 15:38:09 JST [2012/08/05 2:38:09 ET]
Table 'Whirlpool' 9-max Seat #1 is the button
Seat 1: 1Karina1 ($34.17 in chips) 
Seat 2: pandaaaaaa ($11.22 in chips) 
Seat 3: Perstenev ($13 in chips) 
Seat 4: chiyuki ($32.86 in chips) 
Seat 5: masterkoolb ($15.71 in chips) 
Seat 6: jacquelinewu ($30.18 in chips) 
Seat 7: kwkim73 ($25.62 in chips) 
Seat 8: Nerkit ($13.14 in chips) 
Seat 9: phate-1up ($59.88 in chips) 
pandaaaaaa: posts small blind $0.10
Perstenev: posts big blind $0.25
*** HOLE CARDS ***
Dealt to chiyuki [6c 6s]
chiyuki: folds 
masterkoolb: folds 
jacquelinewu: folds 
kwkim73: folds 
Nerkit: folds 
phate-1up: folds 
1Karina1: raises $0.50 to $0.75
pandaaaaaa: folds 
Perstenev: folds 
Uncalled bet ($0.50) returned to 1Karina1
1Karina1 collected $0.60 from pot
1Karina1: doesn't show hand 
*** SUMMARY ***
Total pot $0.60 | Rake $0 
Seat 1: 1Karina1 (button) collected ($0.60)
Seat 2: pandaaaaaa (small blind) folded before Flop
Seat 3: Perstenev (big blind) folded before Flop
Seat 4: chiyuki folded before Flop (didn't bet)
Seat 5: masterkoolb folded before Flop (didn't bet)
Seat 6: jacquelinewu folded before Flop (didn't bet)
Seat 7: kwkim73 folded before Flop (didn't bet)
Seat 8: Nerkit folded before Flop (didn't bet)
Seat 9: phate-1up folded before Flop (didn't bet)



PokerStars Zoom Hand #84300590940:  Hold'em No Limit ($0.10/$0.25) - 2012/08/05 15:38:14 JST [2012/08/05 2:38:14 ET]
Table 'Whirlpool' 9-max Seat #1 is the button
Seat 1: hirozo ($43.08 in chips) 
Seat 2: GovGus ($26.75 in chips) 
Seat 3: chiyuki ($32.86 in chips) 
Seat 4: Serge Claws ($27.06 in chips) 
Seat 5: Nerkit ($13.14 in chips) 
Seat 6: kwkim73 ($25.62 in chips) 
Seat 7: phate-1up ($59.88 in chips) 
Seat 8: Dan Royal ($34.62 in chips) 
Seat 9: masterkoolb ($15.71 in chips) 
GovGus: posts small blind $0.10
chiyuki: posts big blind $0.25
*** HOLE CARDS ***
Dealt to chiyuki [Ks 5d]
Serge Claws: raises $0.50 to $0.75
Nerkit: folds 
kwkim73: folds 
phate-1up: folds 
Dan Royal: calls $0.75
masterkoolb: folds 
hirozo: folds 
GovGus: calls $0.65
chiyuki: folds 
*** FLOP *** [8h 5c Jd]
GovGus: checks 
Serge Claws: bets $1.50
Dan Royal: folds 
GovGus: folds 
Uncalled bet ($1.50) returned to Serge Claws
Serge Claws collected $2.39 from pot
Serge Claws: doesn't show hand 
*** SUMMARY ***
Total pot $2.50 | Rake $0.11 
Board [8h 5c Jd]
Seat 1: hirozo (button) folded before Flop (didn't bet)
Seat 2: GovGus (small blind) folded on the Flop
Seat 3: chiyuki (big blind) folded before Flop
Seat 4: Serge Claws collected ($2.39)
Seat 5: Nerkit folded before Flop (didn't bet)
Seat 6: kwkim73 folded before Flop (didn't bet)
Seat 7: phate-1up folded before Flop (didn't bet)
Seat 8: Dan Royal folded on the Flop
Seat 9: masterkoolb folded before Flop (didn't bet)



PokerStars Zoom Hand #84300596243:  Hold'em No Limit ($0.10/$0.25) - 2012/08/05 15:38:35 JST [2012/08/05 2:38:35 ET]
Table 'Whirlpool' 9-max Seat #1 is the button
Seat 1: kwkim73 ($25.37 in chips) 
Seat 2: chiyuki ($32.61 in chips) 
Seat 3: JhonnyP1979 ($15.73 in chips) 
Seat 4: yvasilik ($20.40 in chips) 
Seat 5: Grishukps ($16.88 in chips) 
Seat 6: hirozo ($43.08 in chips) 
Seat 7: DutchShultzs ($35.35 in chips) 
Seat 8: INSP!RON ($47.24 in chips) 
Seat 9: ChrisCDee ($40.19 in chips) 
chiyuki: posts small blind $0.10
JhonnyP1979: posts big blind $0.25
*** HOLE CARDS ***
Dealt to chiyuki [8s 8d]
yvasilik: folds 
Grishukps: folds 
hirozo: folds 
DutchShultzs: folds 
INSP!RON: raises $0.50 to $0.75
ChrisCDee: folds 
kwkim73: folds 
chiyuki: calls $0.65
JhonnyP1979: calls $0.50
*** FLOP *** [7s 5d Jc]
chiyuki: checks 
JhonnyP1979: checks 
INSP!RON: bets $1.50
chiyuki: calls $1.50
JhonnyP1979: calls $1.50
*** TURN *** [7s 5d Jc] [9d]
chiyuki: checks 
JhonnyP1979: checks 
INSP!RON: bets $4.65
chiyuki: folds 
JhonnyP1979: raises $8.83 to $13.48 and is all-in
INSP!RON: folds 
Uncalled bet ($8.83) returned to JhonnyP1979
JhonnyP1979 collected $15.33 from pot
JhonnyP1979: doesn't show hand 
*** SUMMARY ***
Total pot $16.05 | Rake $0.72 
Board [7s 5d Jc 9d]
Seat 1: kwkim73 (button) folded before Flop (didn't bet)
Seat 2: chiyuki (small blind) folded on the Turn
Seat 3: JhonnyP1979 (big blind) collected ($15.33)
Seat 4: yvasilik folded before Flop (didn't bet)
Seat 5: Grishukps folded before Flop (didn't bet)
Seat 6: hirozo folded before Flop (didn't bet)
Seat 7: DutchShultzs folded before Flop (didn't bet)
Seat 8: INSP!RON folded on the Turn
Seat 9: ChrisCDee folded before Flop (didn't bet)



PokerStars Zoom Hand #84300616385:  Hold'em No Limit ($0.10/$0.25) - 2012/08/05 15:39:55 JST [2012/08/05 2:39:55 ET]
Table 'Whirlpool' 9-max Seat #1 is the button
Seat 1: Ozboy80 ($25.65 in chips) 
Seat 2: genamator ($19.71 in chips) 
Seat 3: NuMetal88 ($38.79 in chips) 
Seat 4: INSP!RON ($45.86 in chips) 
Seat 5: jacquelinewu ($25.71 in chips) 
Seat 6: chiyuki ($30.36 in chips) 
Seat 7: phate-1up ($61.70 in chips) 
Seat 8: KrystalAA ($42.48 in chips) 
Seat 9: GovGus ($36.35 in chips) 
genamator: posts small blind $0.10
NuMetal88: posts big blind $0.25
*** HOLE CARDS ***
Dealt to chiyuki [5c 4s]
INSP!RON: raises $0.50 to $0.75
jacquelinewu: folds 
chiyuki: folds 
phate-1up: calls $0.75
KrystalAA: calls $0.75
GovGus: folds 
Ozboy80: folds 
genamator: folds 
NuMetal88: folds 
*** FLOP *** [Kh 6h 7d]
INSP!RON: checks 
phate-1up: checks 
KrystalAA: checks 
*** TURN *** [Kh 6h 7d] [Ad]
INSP!RON: checks 
phate-1up: bets $1.50
KrystalAA: folds 
INSP!RON: calls $1.50
*** RIVER *** [Kh 6h 7d Ad] [5d]
INSP!RON: checks 
phate-1up: checks 
*** SHOW DOWN ***
INSP!RON: shows [As Jc] (a pair of Aces)
phate-1up: mucks hand 
INSP!RON collected $5.35 from pot
*** SUMMARY ***
Total pot $5.60 | Rake $0.25 
Board [Kh 6h 7d Ad 5d]
Seat 1: Ozboy80 (button) folded before Flop (didn't bet)
Seat 2: genamator (small blind) folded before Flop
Seat 3: NuMetal88 (big blind) folded before Flop
Seat 4: INSP!RON showed [As Jc] and won ($5.35) with a pair of Aces
Seat 5: jacquelinewu folded before Flop (didn't bet)
Seat 6: chiyuki folded before Flop (didn't bet)
Seat 7: phate-1up mucked [2d 2h]
Seat 8: KrystalAA folded on the Turn
Seat 9: GovGus folded before Flop (didn't bet)



PokerStars Zoom Hand #84300620739:  Hold'em No Limit ($0.10/$0.25) - 2012/08/05 15:40:12 JST [2012/08/05 2:40:12 ET]
Table 'Whirlpool' 9-max Seat #1 is the button
Seat 1: KeLevro0 ($12.36 in chips) 
Seat 2: pawn909 ($14.75 in chips) 
Seat 3: kamikkaze ($20.08 in chips) 
Seat 4: Silveystryk ($23.30 in chips) 
Seat 5: Rilko1975 ($25 in chips) 
Seat 6: River_GmbH ($13.35 in chips) 
Seat 7: Lasutchik ($11.80 in chips) 
Seat 8: Faraz ($12.03 in chips) 
Seat 9: chiyuki ($30.36 in chips) 
pawn909: posts small blind $0.10
kamikkaze: posts big blind $0.25
*** HOLE CARDS ***
Dealt to chiyuki [Js Td]
Silveystryk: folds 
Rilko1975: folds 
River_GmbH: folds 
Lasutchik: folds 
Faraz: raises $0.25 to $0.50
chiyuki: folds 
KeLevro0: raises $2 to $2.50
pawn909: folds 
kamikkaze: folds 
Faraz: folds 
Uncalled bet ($2) returned to KeLevro0
KeLevro0 collected $1.35 from pot
KeLevro0: doesn't show hand 
*** SUMMARY ***
Total pot $1.35 | Rake $0 
Seat 1: KeLevro0 (button) collected ($1.35)
Seat 2: pawn909 (small blind) folded before Flop
Seat 3: kamikkaze (big blind) folded before Flop
Seat 4: Silveystryk folded before Flop (didn't bet)
Seat 5: Rilko1975 folded before Flop (didn't bet)
Seat 6: River_GmbH folded before Flop (didn't bet)
Seat 7: Lasutchik folded before Flop (didn't bet)
Seat 8: Faraz folded before Flop
Seat 9: chiyuki folded before Flop (didn't bet)



PokerStars Zoom Hand #84300623620:  Hold'em No Limit ($0.10/$0.25) - 2012/08/05 15:40:24 JST [2012/08/05 2:40:24 ET]
Table 'Whirlpool' 9-max Seat #1 is the button
Seat 1: GSDP ($25.69 in chips) 
Seat 2: Serge Claws ($36.69 in chips) 
Seat 3: nastya040 ($9.83 in chips) 
Seat 4: opie62 ($22.57 in chips) 
Seat 5: nice.franki ($9 in chips) 
Seat 6: Lasutchik ($11.80 in chips) 
Seat 7: Rici47 ($40.34 in chips) 
Seat 8: chiyuki ($30.36 in chips) 
Seat 9: ZhukOFFskI ($35.78 in chips) 
Serge Claws: posts small blind $0.10
nastya040: posts big blind $0.25
*** HOLE CARDS ***
Dealt to chiyuki [7c 5c]
opie62: folds 
nice.franki: folds 
Lasutchik: folds 
Rici47: folds 
chiyuki: folds 
ZhukOFFskI: folds 
GSDP: raises $0.50 to $0.75
Serge Claws: raises $1.50 to $2.25
nastya040: folds 
GSDP: folds 
Uncalled bet ($1.50) returned to Serge Claws
Serge Claws collected $1.75 from pot
Serge Claws: doesn't show hand 
*** SUMMARY ***
Total pot $1.75 | Rake $0 
Seat 1: GSDP (button) folded before Flop
Seat 2: Serge Claws (small blind) collected ($1.75)
Seat 3: nastya040 (big blind) folded before Flop
Seat 4: opie62 folded before Flop (didn't bet)
Seat 5: nice.franki folded before Flop (didn't bet)
Seat 6: Lasutchik folded before Flop (didn't bet)
Seat 7: Rici47 folded before Flop (didn't bet)
Seat 8: chiyuki folded before Flop (didn't bet)
Seat 9: ZhukOFFskI folded before Flop (didn't bet)



PokerStars Zoom Hand #84300625941:  Hold'em No Limit ($0.10/$0.25) - 2012/08/05 15:40:33 JST [2012/08/05 2:40:33 ET]
Table 'Whirlpool' 9-max Seat #1 is the button
Seat 1: kwkim73 ($30.16 in chips) 
Seat 2: phate-1up ($64.34 in chips) 
Seat 3: nice.franki ($9 in chips) 
Seat 4: chiyuki ($30.36 in chips) 
Seat 5: ShaninPeter ($11.85 in chips) 
Seat 6: ZhukOFFskI ($20.02 in chips) 
Seat 7: Rilko1975 ($25.35 in chips) 
Seat 8: masterkoolb ($14.96 in chips) 
Seat 9: KrystalAA ($21.55 in chips) 
phate-1up: posts small blind $0.10
nice.franki: posts big blind $0.25
*** HOLE CARDS ***
Dealt to chiyuki [4d Jc]
chiyuki: folds 
ShaninPeter: folds 
ZhukOFFskI: folds 
Rilko1975: folds 
masterkoolb: folds 
KrystalAA: raises $0.46 to $0.71
kwkim73: folds 
phate-1up: folds 
nice.franki: folds 
Uncalled bet ($0.46) returned to KrystalAA
KrystalAA collected $0.60 from pot
KrystalAA: doesn't show hand 
*** SUMMARY ***
Total pot $0.60 | Rake $0 
Seat 1: kwkim73 (button) folded before Flop (didn't bet)
Seat 2: phate-1up (small blind) folded before Flop
Seat 3: nice.franki (big blind) folded before Flop
Seat 4: chiyuki folded before Flop (didn't bet)
Seat 5: ShaninPeter folded before Flop (didn't bet)
Seat 6: ZhukOFFskI folded before Flop (didn't bet)
Seat 7: Rilko1975 folded before Flop (didn't bet)
Seat 8: masterkoolb folded before Flop (didn't bet)
Seat 9: KrystalAA collected ($0.60)



PokerStars Zoom Hand #84300622848:  Hold'em No Limit ($0.10/$0.25) - 2012/08/05 15:40:21 JST [2012/08/05 2:40:21 ET]
Table 'Whirlpool' 9-max Seat #1 is the button
Seat 1: chiyuki ($30.36 in chips) 
Seat 2: banderas761 ($21.57 in chips) 
Seat 3: soul_5577 ($40.10 in chips) 
Seat 4: ChrisCDee ($64.68 in chips) 
Seat 5: 1Karina1 ($31.96 in chips) 
Seat 6: kwkim73 ($56.33 in chips) 
Seat 7: NuMetal88 ($38.54 in chips) 
Seat 8: phate-1up ($64.34 in chips) 
Seat 9: Serge Claws ($36.69 in chips) 
banderas761: posts small blind $0.10
soul_5577: posts big blind $0.25
*** HOLE CARDS ***
Dealt to chiyuki [7s 5h]
ChrisCDee: folds 
1Karina1: calls $0.25
kwkim73: folds 
NuMetal88: folds 
phate-1up: folds 
Serge Claws: folds 
chiyuki: folds 
banderas761: folds 
soul_5577: checks 
*** FLOP *** [8s 3s Qd]
soul_5577: checks 
1Karina1: bets $0.50
soul_5577: folds 
Uncalled bet ($0.50) returned to 1Karina1
1Karina1 collected $0.57 from pot
1Karina1: doesn't show hand 
*** SUMMARY ***
Total pot $0.60 | Rake $0.03 
Board [8s 3s Qd]
Seat 1: chiyuki (button) folded before Flop (didn't bet)
Seat 2: banderas761 (small blind) folded before Flop
Seat 3: soul_5577 (big blind) folded on the Flop
Seat 4: ChrisCDee folded before Flop (didn't bet)
Seat 5: 1Karina1 collected ($0.57)
Seat 6: kwkim73 folded before Flop (didn't bet)
Seat 7: NuMetal88 folded before Flop (didn't bet)
Seat 8: phate-1up folded before Flop (didn't bet)
Seat 9: Serge Claws folded before Flop (didn't bet)



PokerStars Zoom Hand #84300617922:  Hold'em No Limit ($0.10/$0.25) - 2012/08/05 15:40:01 JST [2012/08/05 2:40:01 ET]
Table 'Whirlpool' 9-max Seat #1 is the button
Seat 1: Lasutchik ($11.80 in chips) 
Seat 2: nice.franki ($12.20 in chips) 
Seat 3: hldtom ($12.50 in chips) 
Seat 4: jacquelinewu ($25.71 in chips) 
Seat 5: chiyuki ($30.36 in chips) 
Seat 6: phate-1up ($63.99 in chips) 
Seat 7: 1Karina1 ($25.64 in chips) 
Seat 8: Vahe50 ($19.09 in chips) 
Seat 9: DutchShultzs ($46.71 in chips) 
nice.franki: posts small blind $0.10
hldtom: posts big blind $0.25
*** HOLE CARDS ***
Dealt to chiyuki [Tc 2d]
jacquelinewu: raises $0.50 to $0.75
chiyuki: folds 
phate-1up: folds 
1Karina1: folds 
Vahe50: folds 
DutchShultzs: folds 
Lasutchik: folds 
nice.franki: folds 
hldtom: calls $0.50
*** FLOP *** [6d Kd 2h]
hldtom: checks 
jacquelinewu: bets $1.07
hldtom: folds 
Uncalled bet ($1.07) returned to jacquelinewu
jacquelinewu collected $1.53 from pot
jacquelinewu: doesn't show hand 
*** SUMMARY ***
Total pot $1.60 | Rake $0.07 
Board [6d Kd 2h]
Seat 1: Lasutchik (button) folded before Flop (didn't bet)
Seat 2: nice.franki (small blind) folded before Flop
Seat 3: hldtom (big blind) folded on the Flop
Seat 4: jacquelinewu collected ($1.53)
Seat 5: chiyuki folded before Flop (didn't bet)
Seat 6: phate-1up folded before Flop (didn't bet)
Seat 7: 1Karina1 folded before Flop (didn't bet)
Seat 8: Vahe50 folded before Flop (didn't bet)
Seat 9: DutchShultzs folded before Flop (didn't bet)



PokerStars Zoom Hand #84300626949:  Hold'em No Limit ($0.10/$0.25) - 2012/08/05 15:40:37 JST [2012/08/05 2:40:37 ET]
Table 'Whirlpool' 9-max Seat #1 is the button
Seat 1: nastya040 ($9.58 in chips) 
Seat 2: chiyuki ($30.36 in chips) 
Seat 3: mjmichi ($64.35 in chips) 
Seat 4: God)Squall ($34.12 in chips) 
Seat 5: masterkoolb ($14.96 in chips) 
Seat 6: 4ydo yogurt ($21.46 in chips) 
Seat 7: kamikkaze ($13.25 in chips) 
Seat 8: kwkim73 ($30.16 in chips) 
Seat 9: hldtom ($26.98 in chips) 
chiyuki: posts small blind $0.10
mjmichi: posts big blind $0.25
*** HOLE CARDS ***
Dealt to chiyuki [Jc 9s]
God)Squall: folds 
masterkoolb: folds 
4ydo yogurt: folds 
kamikkaze: folds 
kwkim73: folds 
hldtom: folds 
nastya040: raises $0.25 to $0.50
chiyuki: folds 
mjmichi: folds 
Uncalled bet ($0.25) returned to nastya040
nastya040 collected $0.60 from pot
nastya040: doesn't show hand 
*** SUMMARY ***
Total pot $0.60 | Rake $0 
Seat 1: nastya040 (button) collected ($0.60)
Seat 2: chiyuki (small blind) folded before Flop
Seat 3: mjmichi (big blind) folded before Flop
Seat 4: God)Squall folded before Flop (didn't bet)
Seat 5: masterkoolb folded before Flop (didn't bet)
Seat 6: 4ydo yogurt folded before Flop (didn't bet)
Seat 7: kamikkaze folded before Flop (didn't bet)
Seat 8: kwkim73 folded before Flop (didn't bet)
Seat 9: hldtom folded before Flop (didn't bet)



PokerStars Zoom Hand #84300631306:  Hold'em No Limit ($0.10/$0.25) - 2012/08/05 15:40:54 JST [2012/08/05 2:40:54 ET]
Table 'Whirlpool' 9-max Seat #1 is the button
Seat 1: God)Squall ($33.77 in chips) 
Seat 2: nice.franki ($12.10 in chips) 
Seat 3: chiyuki ($30.26 in chips) 
Seat 4: Silveystryk ($20.02 in chips) 
Seat 5: Grishukps ($12.50 in chips) 
Seat 6: NuMetal88 ($33.75 in chips) 
Seat 7: Serge Claws ($37.69 in chips) 
Seat 8: 500Ang ($25.98 in chips) 
Seat 9: ChrisCDee ($64.68 in chips) 
nice.franki: posts small blind $0.10
chiyuki: posts big blind $0.25
*** HOLE CARDS ***
Dealt to chiyuki [Ts 7h]
Silveystryk: calls $0.25
Grishukps: folds 
NuMetal88: folds 
Serge Claws: folds 
500Ang: calls $0.25
ChrisCDee: calls $0.25
God)Squall: folds 
nice.franki: folds 
chiyuki: checks 
*** FLOP *** [As 4c Qs]
chiyuki: checks 
Silveystryk: checks 
500Ang: checks 
ChrisCDee: checks 
*** TURN *** [As 4c Qs] [8c]
chiyuki: checks 
Silveystryk: checks 
500Ang: checks 
ChrisCDee: checks 
*** RIVER *** [As 4c Qs 8c] [9d]
chiyuki: checks 
Silveystryk: checks 
500Ang: checks 
ChrisCDee: checks 
*** SHOW DOWN ***
chiyuki: shows [Ts 7h] (high card Ace)
Silveystryk: shows [Qc Ks] (a pair of Queens)
500Ang: mucks hand 
ChrisCDee: mucks hand 
Silveystryk collected $1.05 from pot
*** SUMMARY ***
Total pot $1.10 | Rake $0.05 
Board [As 4c Qs 8c 9d]
Seat 1: God)Squall (button) folded before Flop (didn't bet)
Seat 2: nice.franki (small blind) folded before Flop
Seat 3: chiyuki (big blind) showed [Ts 7h] and lost with high card Ace
Seat 4: Silveystryk showed [Qc Ks] and won ($1.05) with a pair of Queens
Seat 5: Grishukps folded before Flop (didn't bet)
Seat 6: NuMetal88 folded before Flop (didn't bet)
Seat 7: Serge Claws folded before Flop (didn't bet)
Seat 8: 500Ang mucked [3c 3d]
Seat 9: ChrisCDee mucked [7s Js]



PokerStars Zoom Hand #84300624626:  Hold'em No Limit ($0.10/$0.25) - 2012/08/05 15:40:28 JST [2012/08/05 2:40:28 ET]
Table 'Whirlpool' 9-max Seat #1 is the button
Seat 1: Gichboy ($16.75 in chips) 
Seat 2: hldtom ($12.50 in chips) 
Seat 3: opie62 ($22.57 in chips) 
Seat 4: nice.franki ($9 in chips) 
Seat 5: ChrisCDee ($64.68 in chips) 
Seat 6: Alvinpe85 ($48.99 in chips) 
Seat 7: chiyuki ($30.36 in chips) 
Seat 8: kesstukas25 ($22.44 in chips) 
Seat 9: Vahe50 ($19.09 in chips) 
hldtom: posts small blind $0.10
opie62: posts big blind $0.25
*** HOLE CARDS ***
Dealt to chiyuki [4c Qd]
nice.franki: folds 
ChrisCDee: folds 
Alvinpe85: folds 
chiyuki: folds 
kesstukas25: folds 
Vahe50: raises $0.50 to $0.75
Gichboy: folds 
hldtom: folds 
opie62: calls $0.50
*** FLOP *** [6h 4s Tc]
opie62: checks 
Vahe50: bets $0.75
opie62: calls $0.75
*** TURN *** [6h 4s Tc] [8s]
opie62: checks 
Vahe50: checks 
*** RIVER *** [6h 4s Tc 8s] [9h]
opie62: checks 
Vahe50: bets $2.50
opie62: calls $2.50
*** SHOW DOWN ***
Vahe50: shows [Ad 7d] (a straight, Six to Ten)
opie62: mucks hand 
Vahe50 collected $7.74 from pot
*** SUMMARY ***
Total pot $8.10 | Rake $0.36 
Board [6h 4s Tc 8s 9h]
Seat 1: Gichboy (button) folded before Flop (didn't bet)
Seat 2: hldtom (small blind) folded before Flop
Seat 3: opie62 (big blind) mucked [Jc 8h]
Seat 4: nice.franki folded before Flop (didn't bet)
Seat 5: ChrisCDee folded before Flop (didn't bet)
Seat 6: Alvinpe85 folded before Flop (didn't bet)
Seat 7: chiyuki folded before Flop (didn't bet)
Seat 8: kesstukas25 folded before Flop (didn't bet)
Seat 9: Vahe50 showed [Ad 7d] and won ($7.74) with a straight, Six to Ten



PokerStars Zoom Hand #84300652733:  Hold'em No Limit ($0.10/$0.25) - 2012/08/05 15:42:19 JST [2012/08/05 2:42:19 ET]
Table 'Whirlpool' 9-max Seat #1 is the button
Seat 1: chiyuki ($30.01 in chips) 
Seat 2: DrunkTyphoon ($27.60 in chips) 
Seat 3: Nerkit ($16.69 in chips) 
Seat 4: kamikkaze ($19.10 in chips) 
Seat 5: jvds114 ($25 in chips) 
Seat 6: 1Karina1 ($36.42 in chips) 
Seat 7: ShaninPeter ($11.50 in chips) 
Seat 8: masterkoolb ($14.71 in chips) 
Seat 9: kesstukas25 ($22.09 in chips) 
DrunkTyphoon: posts small blind $0.10
Nerkit: posts big blind $0.25
*** HOLE CARDS ***
Dealt to chiyuki [5d Jh]
kamikkaze: folds 
jvds114: folds 
1Karina1: folds 
ShaninPeter: folds 
masterkoolb: folds 
kesstukas25: raises $0.50 to $0.75
chiyuki: folds 
DrunkTyphoon: folds 
Nerkit: folds 
Uncalled bet ($0.50) returned to kesstukas25
kesstukas25 collected $0.60 from pot
kesstukas25: doesn't show hand 
*** SUMMARY ***
Total pot $0.60 | Rake $0 
Seat 1: chiyuki (button) folded before Flop (didn't bet)
Seat 2: DrunkTyphoon (small blind) folded before Flop
Seat 3: Nerkit (big blind) folded before Flop
Seat 4: kamikkaze folded before Flop (didn't bet)
Seat 5: jvds114 folded before Flop (didn't bet)
Seat 6: 1Karina1 folded before Flop (didn't bet)
Seat 7: ShaninPeter folded before Flop (didn't bet)
Seat 8: masterkoolb folded before Flop (didn't bet)
Seat 9: kesstukas25 collected ($0.60)



PokerStars Zoom Hand #84300650042:  Hold'em No Limit ($0.10/$0.25) - 2012/08/05 15:42:08 JST [2012/08/05 2:42:08 ET]
Table 'Whirlpool' 9-max Seat #1 is the button
Seat 1: Grishukps ($12.50 in chips) 
Seat 2: River_GmbH ($13.10 in chips) 
Seat 3: Lasutchik ($11.80 in chips) 
Seat 4: 1Karina1 ($36.42 in chips) 
Seat 5: Ozboy80 ($27.74 in chips) 
Seat 6: chiyuki ($30.01 in chips) 
Seat 7: ZhukOFFskI ($64.40 in chips) 
Seat 8: drunk_bender ($15.90 in chips) 
Seat 9: Rilko1975 ($29.22 in chips) 
River_GmbH: posts small blind $0.10
Lasutchik: posts big blind $0.25
*** HOLE CARDS ***
Dealt to chiyuki [6c 5s]
1Karina1: folds 
Ozboy80: folds 
chiyuki: folds 
ZhukOFFskI: folds 
drunk_bender: folds 
Rilko1975: folds 
Grishukps: folds 
River_GmbH: raises $0.75 to $1
Lasutchik: folds 
Uncalled bet ($0.75) returned to River_GmbH
River_GmbH collected $0.50 from pot
River_GmbH: doesn't show hand 
*** SUMMARY ***
Total pot $0.50 | Rake $0 
Seat 1: Grishukps (button) folded before Flop (didn't bet)
Seat 2: River_GmbH (small blind) collected ($0.50)
Seat 3: Lasutchik (big blind) folded before Flop
Seat 4: 1Karina1 folded before Flop (didn't bet)
Seat 5: Ozboy80 folded before Flop (didn't bet)
Seat 6: chiyuki folded before Flop (didn't bet)
Seat 7: ZhukOFFskI folded before Flop (didn't bet)
Seat 8: drunk_bender folded before Flop (didn't bet)
Seat 9: Rilko1975 folded before Flop (didn't bet)



PokerStars Zoom Hand #84300652025:  Hold'em No Limit ($0.10/$0.25) - 2012/08/05 15:42:16 JST [2012/08/05 2:42:16 ET]
Table 'Whirlpool' 9-max Seat #1 is the button
Seat 1: PPP7SSS ($8.11 in chips) 
Seat 2: Alvinpe85 ($56.84 in chips) 
Seat 3: ChrisCDee ($64.43 in chips) 
Seat 4: NuMetal88 ($33.50 in chips) 
Seat 5: chiyuki ($30.01 in chips) 
Seat 6: nice.franki ($8.30 in chips) 
Seat 7: KeLevro0 ($9.73 in chips) 
Seat 8: risekuku468 ($28.04 in chips) 
Seat 9: laurentzu84 ($25.35 in chips) 
Alvinpe85: posts small blind $0.10
ChrisCDee: posts big blind $0.25
*** HOLE CARDS ***
Dealt to chiyuki [Jh 9s]
NuMetal88: folds 
chiyuki: folds 
nice.franki has timed out
nice.franki: folds 
KeLevro0: folds 
risekuku468: folds 
laurentzu84: folds 
PPP7SSS: folds 
Alvinpe85: folds 
Uncalled bet ($0.15) returned to ChrisCDee
ChrisCDee collected $0.20 from pot
ChrisCDee: doesn't show hand 
*** SUMMARY ***
Total pot $0.20 | Rake $0 
Seat 1: PPP7SSS (button) folded before Flop (didn't bet)
Seat 2: Alvinpe85 (small blind) folded before Flop
Seat 3: ChrisCDee (big blind) collected ($0.20)
Seat 4: NuMetal88 folded before Flop (didn't bet)
Seat 5: chiyuki folded before Flop (didn't bet)
Seat 6: nice.franki folded before Flop (didn't bet)
Seat 7: KeLevro0 folded before Flop (didn't bet)
Seat 8: risekuku468 folded before Flop (didn't bet)
Seat 9: laurentzu84 folded before Flop (didn't bet)



PokerStars Zoom Hand #84300653499:  Hold'em No Limit ($0.10/$0.25) - 2012/08/05 15:42:22 JST [2012/08/05 2:42:22 ET]
Table 'Whirlpool' 9-max Seat #1 is the button
Seat 1: ZhukOFFskI ($64.40 in chips) 
Seat 2: jacquelinewu ($25.89 in chips) 
Seat 3: Dejacob ($25 in chips) 
Seat 4: Rilko1975 ($29.22 in chips) 
Seat 5: kamikkaze ($19.10 in chips) 
Seat 6: panaam ($26.19 in chips) 
Seat 7: GovGus ($43.60 in chips) 
Seat 8: chiyuki ($30.01 in chips) 
Seat 9: risekuku468 ($28.04 in chips) 
jacquelinewu: posts small blind $0.10
Dejacob: posts big blind $0.25
*** HOLE CARDS ***
Dealt to chiyuki [4s Qs]
Rilko1975: folds 
kamikkaze: folds 
panaam: folds 
GovGus: folds 
chiyuki: folds 
risekuku468: raises $0.50 to $0.75
ZhukOFFskI: folds 
jacquelinewu: folds 
Dejacob: folds 
Uncalled bet ($0.50) returned to risekuku468
risekuku468 collected $0.60 from pot
risekuku468: doesn't show hand 
*** SUMMARY ***
Total pot $0.60 | Rake $0 
Seat 1: ZhukOFFskI (button) folded before Flop (didn't bet)
Seat 2: jacquelinewu (small blind) folded before Flop
Seat 3: Dejacob (big blind) folded before Flop
Seat 4: Rilko1975 folded before Flop (didn't bet)
Seat 5: kamikkaze folded before Flop (didn't bet)
Seat 6: panaam folded before Flop (didn't bet)
Seat 7: GovGus folded before Flop (didn't bet)
Seat 8: chiyuki folded before Flop (didn't bet)
Seat 9: risekuku468 collected ($0.60)



PokerStars Zoom Hand #84300657149:  Hold'em No Limit ($0.10/$0.25) - 2012/08/05 15:42:36 JST [2012/08/05 2:42:36 ET]
Table 'Whirlpool' 9-max Seat #1 is the button
Seat 1: Ellen1947 ($22.60 in chips) 
Seat 2: Dejacob ($25.10 in chips) 
Seat 3: GovGus ($43.60 in chips) 
Seat 4: KeLevro0 ($13.86 in chips) 
Seat 5: soul_5577 ($38.25 in chips) 
Seat 6: kwkim73 ($25.27 in chips) 
Seat 7: DrunkTyphoon ($27.50 in chips) 
Seat 8: Alvinpe85 ($56.74 in chips) 
Seat 9: chiyuki ($30.01 in chips) 
Dejacob: posts small blind $0.10
GovGus: posts big blind $0.25
*** HOLE CARDS ***
Dealt to chiyuki [8d 2s]
KeLevro0: folds 
soul_5577: folds 
kwkim73: folds 
DrunkTyphoon: folds 
Alvinpe85: folds 
chiyuki: folds 
Ellen1947: folds 
Dejacob: folds 
Uncalled bet ($0.15) returned to GovGus
GovGus collected $0.20 from pot
GovGus: doesn't show hand 
*** SUMMARY ***
Total pot $0.20 | Rake $0 
Seat 1: Ellen1947 (button) folded before Flop (didn't bet)
Seat 2: Dejacob (small blind) folded before Flop
Seat 3: GovGus (big blind) collected ($0.20)
Seat 4: KeLevro0 folded before Flop (didn't bet)
Seat 5: soul_5577 folded before Flop (didn't bet)
Seat 6: kwkim73 folded before Flop (didn't bet)
Seat 7: DrunkTyphoon folded before Flop (didn't bet)
Seat 8: Alvinpe85 folded before Flop (didn't bet)
Seat 9: chiyuki folded before Flop (didn't bet)



PokerStars Zoom Hand #84300660359:  Hold'em No Limit ($0.10/$0.25) - 2012/08/05 15:42:50 JST [2012/08/05 2:42:50 ET]
Table 'Whirlpool' 9-max Seat #1 is the button
Seat 1: Serge Claws ($41.65 in chips) 
Seat 2: Perstenev ($8.16 in chips) 
Seat 3: pawn909 ($14.55 in chips) 
Seat 4: Alvinpe85 ($56.74 in chips) 
Seat 5: kwkim73 ($55.13 in chips) 
Seat 6: jacquelinewu ($25.79 in chips) 
Seat 7: chiyuki ($30.01 in chips) 
Seat 8: Lasutchik ($11.55 in chips) 
Seat 9: Spheroff ($20.87 in chips) 
Perstenev: posts small blind $0.10
pawn909: posts big blind $0.25
*** HOLE CARDS ***
Dealt to chiyuki [4s Jd]
Alvinpe85: folds 
kwkim73: raises $0.50 to $0.75
jacquelinewu: folds 
chiyuki: folds 
Lasutchik: folds 
Spheroff: folds 
Serge Claws: folds 
Perstenev: folds 
pawn909: folds 
Uncalled bet ($0.50) returned to kwkim73
kwkim73 collected $0.60 from pot
kwkim73: doesn't show hand 
*** SUMMARY ***
Total pot $0.60 | Rake $0 
Seat 1: Serge Claws (button) folded before Flop (didn't bet)
Seat 2: Perstenev (small blind) folded before Flop
Seat 3: pawn909 (big blind) folded before Flop
Seat 4: Alvinpe85 folded before Flop (didn't bet)
Seat 5: kwkim73 collected ($0.60)
Seat 6: jacquelinewu folded before Flop (didn't bet)
Seat 7: chiyuki folded before Flop (didn't bet)
Seat 8: Lasutchik folded before Flop (didn't bet)
Seat 9: Spheroff folded before Flop (didn't bet)



PokerStars Zoom Hand #84300664153:  Hold'em No Limit ($0.10/$0.25) - 2012/08/05 15:43:05 JST [2012/08/05 2:43:05 ET]
Table 'Whirlpool' 9-max Seat #1 is the button
Seat 1: DrunkTyphoon ($25 in chips) 
Seat 2: Rici47 ($31.69 in chips) 
Seat 3: 1Karina1 ($31.58 in chips) 
Seat 4: chiyuki ($30.01 in chips) 
Seat 5: ChrisCDee ($37.09 in chips) 
Seat 6: ZhukOFFskI ($19.42 in chips) 
Seat 7: Grishukps ($13.27 in chips) 
Seat 8: Perstenev ($8.06 in chips) 
Seat 9: yvasilik ($22.13 in chips) 
Rici47: posts small blind $0.10
1Karina1: posts big blind $0.25
*** HOLE CARDS ***
Dealt to chiyuki [8s 4c]
chiyuki: folds 
ChrisCDee: folds 
ZhukOFFskI: folds 
Grishukps: folds 
Perstenev: folds 
yvasilik: folds 
DrunkTyphoon: folds 
Rici47: calls $0.15
1Karina1: raises $0.65 to $0.90
Rici47: calls $0.65
*** FLOP *** [7h 2h 4h]
Rici47: checks 
1Karina1: bets $1.25
Rici47: calls $1.25
*** TURN *** [7h 2h 4h] [2c]
Rici47: checks 
1Karina1: checks 
*** RIVER *** [7h 2h 4h 2c] [Tc]
Rici47: checks 
1Karina1: checks 
*** SHOW DOWN ***
Rici47: shows [Js Kh] (a pair of Deuces)
1Karina1: shows [Qs Ad] (a pair of Deuces - Ace kicker)
1Karina1 collected $4.11 from pot
*** SUMMARY ***
Total pot $4.30 | Rake $0.19 
Board [7h 2h 4h 2c Tc]
Seat 1: DrunkTyphoon (button) folded before Flop (didn't bet)
Seat 2: Rici47 (small blind) showed [Js Kh] and lost with a pair of Deuces
Seat 3: 1Karina1 (big blind) showed [Qs Ad] and won ($4.11) with a pair of Deuces
Seat 4: chiyuki folded before Flop (didn't bet)
Seat 5: ChrisCDee folded before Flop (didn't bet)
Seat 6: ZhukOFFskI folded before Flop (didn't bet)
Seat 7: Grishukps folded before Flop (didn't bet)
Seat 8: Perstenev folded before Flop (didn't bet)
Seat 9: yvasilik folded before Flop (didn't bet)



PokerStars Zoom Hand #84300665399:  Hold'em No Limit ($0.10/$0.25) - 2012/08/05 15:43:10 JST [2012/08/05 2:43:10 ET]
Table 'Whirlpool' 9-max Seat #1 is the button
Seat 1: ChrisCDee ($37.09 in chips) 
Seat 2: nice.franki ($8.05 in chips) 
Seat 3: chiyuki ($30.01 in chips) 
Seat 4: westhavenbc ($37.29 in chips) 
Seat 5: Roglus ($18.76 in chips) 
Seat 6: Perstenev ($7.75 in chips) 
Seat 7: Ellen1947 ($22.50 in chips) 
Seat 8: ShaninPeter ($11.50 in chips) 
Seat 9: Silveystryk ($24.41 in chips) 
nice.franki: posts small blind $0.10
chiyuki: posts big blind $0.25
*** HOLE CARDS ***
Dealt to chiyuki [8c Kd]
westhavenbc: folds 
Roglus: raises $0.50 to $0.75
Perstenev: folds 
Ellen1947: folds 
ShaninPeter: folds 
Silveystryk: folds 
ChrisCDee: folds 
nice.franki: folds 
chiyuki: folds 
Uncalled bet ($0.50) returned to Roglus
Roglus collected $0.60 from pot
Roglus: doesn't show hand 
*** SUMMARY ***
Total pot $0.60 | Rake $0 
Seat 1: ChrisCDee (button) folded before Flop (didn't bet)
Seat 2: nice.franki (small blind) folded before Flop
Seat 3: chiyuki (big blind) folded before Flop
Seat 4: westhavenbc folded before Flop (didn't bet)
Seat 5: Roglus collected ($0.60)
Seat 6: Perstenev folded before Flop (didn't bet)
Seat 7: Ellen1947 folded before Flop (didn't bet)
Seat 8: ShaninPeter folded before Flop (didn't bet)
Seat 9: Silveystryk folded before Flop (didn't bet)



PokerStars Zoom Hand #84300673683:  Hold'em No Limit ($0.10/$0.25) - 2012/08/05 15:43:42 JST [2012/08/05 2:43:42 ET]
Table 'Whirlpool' 9-max Seat #1 is the button
Seat 1: ZhukOFFskI ($64.40 in chips) 
Seat 2: ViTiV2010 ($13.17 in chips) 
Seat 3: TorTrade ($26.39 in chips) 
Seat 4: tribunpdm ($90.77 in chips) 
Seat 5: INSP!RON ($50.39 in chips) 
Seat 6: chiyuki ($29.66 in chips) 
Seat 7: kwkim73 ($25 in chips) 
Seat 8: Grishukps ($12.50 in chips) 
Seat 9: GSDP ($23.19 in chips) 
ViTiV2010: posts small blind $0.10
TorTrade: posts big blind $0.25
*** HOLE CARDS ***
Dealt to chiyuki [4c 6c]
tribunpdm: folds 
INSP!RON: folds 
chiyuki: folds 
kwkim73: raises $0.50 to $0.75
Grishukps: folds 
GSDP: folds 
ZhukOFFskI: raises $1.75 to $2.50
ViTiV2010: folds 
TorTrade: folds 
kwkim73: folds 
Uncalled bet ($1.75) returned to ZhukOFFskI
ZhukOFFskI collected $1.85 from pot
ZhukOFFskI: doesn't show hand 
*** SUMMARY ***
Total pot $1.85 | Rake $0 
Seat 1: ZhukOFFskI (button) collected ($1.85)
Seat 2: ViTiV2010 (small blind) folded before Flop
Seat 3: TorTrade (big blind) folded before Flop
Seat 4: tribunpdm folded before Flop (didn't bet)
Seat 5: INSP!RON folded before Flop (didn't bet)
Seat 6: chiyuki folded before Flop (didn't bet)
Seat 7: kwkim73 folded before Flop
Seat 8: Grishukps folded before Flop (didn't bet)
Seat 9: GSDP folded before Flop (didn't bet)



PokerStars Zoom Hand #84300677451:  Hold'em No Limit ($0.10/$0.25) - 2012/08/05 15:43:58 JST [2012/08/05 2:43:58 ET]
Table 'Whirlpool' 9-max Seat #1 is the button
Seat 1: KeLevro0 ($8.71 in chips) 
Seat 2: Perstenev ($7.81 in chips) 
Seat 3: chiyuki ($29.66 in chips) 
Seat 4: DutchShultzs ($34.96 in chips) 
Seat 5: masterkoolb ($13.61 in chips) 
Seat 6: yvasilik ($22.15 in chips) 
Seat 7: 1Karina1 ($35.82 in chips) 
Seat 8: Kasperlmusik ($25 in chips) 
Seat 9: INSP!RON ($41.69 in chips) 
Perstenev: posts small blind $0.10
chiyuki: posts big blind $0.25
*** HOLE CARDS ***
Dealt to chiyuki [Ad 7c]
DutchShultzs: folds 
masterkoolb: folds 
yvasilik: folds 
1Karina1: folds 
Kasperlmusik: folds 
INSP!RON: raises $0.50 to $0.75
KeLevro0: folds 
Perstenev: folds 
chiyuki: folds 
Uncalled bet ($0.50) returned to INSP!RON
INSP!RON collected $0.60 from pot
INSP!RON: doesn't show hand 
*** SUMMARY ***
Total pot $0.60 | Rake $0 
Seat 1: KeLevro0 (button) folded before Flop (didn't bet)
Seat 2: Perstenev (small blind) folded before Flop
Seat 3: chiyuki (big blind) folded before Flop
Seat 4: DutchShultzs folded before Flop (didn't bet)
Seat 5: masterkoolb folded before Flop (didn't bet)
Seat 6: yvasilik folded before Flop (didn't bet)
Seat 7: 1Karina1 folded before Flop (didn't bet)
Seat 8: Kasperlmusik folded before Flop (didn't bet)
Seat 9: INSP!RON collected ($0.60)



PokerStars Zoom Hand #84300669524:  Hold'em No Limit ($0.10/$0.25) - 2012/08/05 15:43:26 JST [2012/08/05 2:43:26 ET]
Table 'Whirlpool' 9-max Seat #1 is the button
Seat 1: Grishukps ($13.17 in chips) 
Seat 2: chiyuki ($29.76 in chips) 
Seat 3: masterkoolb ($13.86 in chips) 
Seat 4: ZhukOFFskI ($19.42 in chips) 
Seat 5: hldtom ($25.78 in chips) 
Seat 6: Vahe50 ($21.98 in chips) 
Seat 7: phate-1up ($45.34 in chips) 
Seat 8: Silveystryk ($24.41 in chips) 
Seat 9: Jene4kaBest ($9.74 in chips) 
chiyuki: posts small blind $0.10
masterkoolb: posts big blind $0.25
*** HOLE CARDS ***
Dealt to chiyuki [6c 8s]
ZhukOFFskI: folds 
hldtom: folds 
Vahe50: folds 
phate-1up: raises $0.50 to $0.75
Silveystryk: folds 
Jene4kaBest: calls $0.75
Grishukps: folds 
chiyuki: folds 
masterkoolb: folds 
*** FLOP *** [7h 3c 8d]
phate-1up: checks 
Jene4kaBest: checks 
*** TURN *** [7h 3c 8d] [9c]
phate-1up: bets $1.25
Jene4kaBest: calls $1.25
*** RIVER *** [7h 3c 8d 9c] [5s]
phate-1up: checks 
Jene4kaBest: bets $2.90
phate-1up: folds 
Uncalled bet ($2.90) returned to Jene4kaBest
Jene4kaBest collected $4.15 from pot
Jene4kaBest: doesn't show hand 
*** SUMMARY ***
Total pot $4.35 | Rake $0.20 
Board [7h 3c 8d 9c 5s]
Seat 1: Grishukps (button) folded before Flop (didn't bet)
Seat 2: chiyuki (small blind) folded before Flop
Seat 3: masterkoolb (big blind) folded before Flop
Seat 4: ZhukOFFskI folded before Flop (didn't bet)
Seat 5: hldtom folded before Flop (didn't bet)
Seat 6: Vahe50 folded before Flop (didn't bet)
Seat 7: phate-1up folded on the River
Seat 8: Silveystryk folded before Flop (didn't bet)
Seat 9: Jene4kaBest collected ($4.15)



PokerStars Zoom Hand #84300674966:  Hold'em No Limit ($0.10/$0.25) - 2012/08/05 15:43:47 JST [2012/08/05 2:43:47 ET]
Table 'Whirlpool' 9-max Seat #1 is the button
Seat 1: hldtom ($13.38 in chips) 
Seat 2: KeLevro0 ($8.81 in chips) 
Seat 3: Grishukps ($12.50 in chips) 
Seat 4: INSP!RON ($50.39 in chips) 
Seat 5: kesstukas25 ($16.80 in chips) 
Seat 6: nice.franki ($7.95 in chips) 
Seat 7: Rici47 ($29.54 in chips) 
Seat 8: chiyuki ($29.66 in chips) 
Seat 9: Perstenev ($8.88 in chips) 
KeLevro0: posts small blind $0.10
Grishukps: posts big blind $0.25
*** HOLE CARDS ***
Dealt to chiyuki [9c Qh]
INSP!RON: folds 
kesstukas25: raises $0.50 to $0.75
nice.franki: folds 
Rici47: folds 
chiyuki: folds 
Perstenev: folds 
hldtom: folds 
KeLevro0: folds 
Grishukps: raises $1.45 to $2.20
kesstukas25: folds 
Uncalled bet ($1.45) returned to Grishukps
Grishukps collected $1.60 from pot
Grishukps: doesn't show hand 
*** SUMMARY ***
Total pot $1.60 | Rake $0 
Seat 1: hldtom (button) folded before Flop (didn't bet)
Seat 2: KeLevro0 (small blind) folded before Flop
Seat 3: Grishukps (big blind) collected ($1.60)
Seat 4: INSP!RON folded before Flop (didn't bet)
Seat 5: kesstukas25 folded before Flop
Seat 6: nice.franki folded before Flop (didn't bet)
Seat 7: Rici47 folded before Flop (didn't bet)
Seat 8: chiyuki folded before Flop (didn't bet)
Seat 9: Perstenev folded before Flop (didn't bet)



PokerStars Zoom Hand #84300679740:  Hold'em No Limit ($0.10/$0.25) - 2012/08/05 15:44:07 JST [2012/08/05 2:44:07 ET]
Table 'Whirlpool' 9-max Seat #1 is the button
Seat 1: chiyuki ($29.41 in chips) 
Seat 2: hldtom ($13.38 in chips) 
Seat 3: Dan Royal ($25 in chips) 
Seat 4: DutchShultzs ($34.96 in chips) 
Seat 5: masterkoolb ($17.63 in chips) 
Seat 6: jacquelinewu ($25.73 in chips) 
Seat 7: GovGus ($43.60 in chips) 
Seat 8: KeLevro0 ($8.71 in chips) 
Seat 9: INSP!RON ($50.14 in chips) 
hldtom: posts small blind $0.10
Dan Royal: posts big blind $0.25
*** HOLE CARDS ***
Dealt to chiyuki [Js 8s]
DutchShultzs: folds 
masterkoolb: folds 
jacquelinewu: raises $0.50 to $0.75
GovGus: folds 
KeLevro0: folds 
INSP!RON: folds 
chiyuki: folds 
hldtom: folds 
Dan Royal: folds 
Uncalled bet ($0.50) returned to jacquelinewu
jacquelinewu collected $0.60 from pot
jacquelinewu: doesn't show hand 
*** SUMMARY ***
Total pot $0.60 | Rake $0 
Seat 1: chiyuki (button) folded before Flop (didn't bet)
Seat 2: hldtom (small blind) folded before Flop
Seat 3: Dan Royal (big blind) folded before Flop
Seat 4: DutchShultzs folded before Flop (didn't bet)
Seat 5: masterkoolb folded before Flop (didn't bet)
Seat 6: jacquelinewu collected ($0.60)
Seat 7: GovGus folded before Flop (didn't bet)
Seat 8: KeLevro0 folded before Flop (didn't bet)
Seat 9: INSP!RON folded before Flop (didn't bet)



PokerStars Zoom Hand #84300676711:  Hold'em No Limit ($0.10/$0.25) - 2012/08/05 15:43:55 JST [2012/08/05 2:43:55 ET]
Table 'Whirlpool' 9-max Seat #1 is the button
Seat 1: Gichboy ($32.67 in chips) 
Seat 2: Ellen1947 ($28.58 in chips) 
Seat 3: macmauret ($10.51 in chips) 
Seat 4: Serge Claws ($40.55 in chips) 
Seat 5: drunk_bender ($16.57 in chips) 
Seat 6: snejokCoxx ($12.50 in chips) 
Seat 7: chiyuki ($29.66 in chips) 
Seat 8: River_GmbH ($13.70 in chips) 
Seat 9: Dejacob ($25 in chips) 
Ellen1947: posts small blind $0.10
macmauret: posts big blind $0.25
*** HOLE CARDS ***
Dealt to chiyuki [8d 2s]
Serge Claws: folds 
drunk_bender: folds 
snejokCoxx: folds 
chiyuki: folds 
River_GmbH: folds 
Dejacob: folds 
Gichboy: raises $0.25 to $0.50
Ellen1947: calls $0.40
macmauret: folds 
*** FLOP *** [8h Ts 7h]
Ellen1947: checks 
Gichboy: checks 
*** TURN *** [8h Ts 7h] [6d]
Ellen1947: checks 
Gichboy: checks 
*** RIVER *** [8h Ts 7h 6d] [6h]
Ellen1947: checks 
Gichboy: checks 
*** SHOW DOWN ***
Ellen1947: shows [5h 5s] (two pair, Sixes and Fives)
Gichboy: mucks hand 
Ellen1947 collected $1.19 from pot
*** SUMMARY ***
Total pot $1.25 | Rake $0.06 
Board [8h Ts 7h 6d 6h]
Seat 1: Gichboy (button) mucked [Qc Kh]
Seat 2: Ellen1947 (small blind) showed [5h 5s] and won ($1.19) with two pair, Sixes and Fives
Seat 3: macmauret (big blind) folded before Flop
Seat 4: Serge Claws folded before Flop (didn't bet)
Seat 5: drunk_bender folded before Flop (didn't bet)
Seat 6: snejokCoxx folded before Flop (didn't bet)
Seat 7: chiyuki folded before Flop (didn't bet)
Seat 8: River_GmbH folded before Flop (didn't bet)
Seat 9: Dejacob folded before Flop (didn't bet)



PokerStars Zoom Hand #84300685871:  Hold'em No Limit ($0.10/$0.25) - 2012/08/05 15:44:31 JST [2012/08/05 2:44:31 ET]
Table 'Whirlpool' 9-max Seat #1 is the button
Seat 1: herkko11 ($6.18 in chips) 
Seat 2: kwkim73 ($28.06 in chips) 
Seat 3: rey2040 ($19.60 in chips) 
Seat 4: Ellen1947 ($22.25 in chips) 
Seat 5: snejokCoxx ($13.25 in chips) 
Seat 6: chiyuki ($29.41 in chips) 
Seat 7: nice.franki ($11.40 in chips) 
Seat 8: hldtom ($13.28 in chips) 
Seat 9: Alvinpe85 ($56.14 in chips) 
kwkim73: posts small blind $0.10
rey2040: posts big blind $0.25
*** HOLE CARDS ***
Dealt to chiyuki [Qc 9s]
Ellen1947: folds 
snejokCoxx: raises $0.40 to $0.65
chiyuki: folds 
nice.franki: folds 
hldtom: folds 
Alvinpe85: folds 
herkko11: folds 
kwkim73: folds 
rey2040: folds 
Uncalled bet ($0.40) returned to snejokCoxx
snejokCoxx collected $0.60 from pot
snejokCoxx: doesn't show hand 
*** SUMMARY ***
Total pot $0.60 | Rake $0 
Seat 1: herkko11 (button) folded before Flop (didn't bet)
Seat 2: kwkim73 (small blind) folded before Flop
Seat 3: rey2040 (big blind) folded before Flop
Seat 4: Ellen1947 folded before Flop (didn't bet)
Seat 5: snejokCoxx collected ($0.60)
Seat 6: chiyuki folded before Flop (didn't bet)
Seat 7: nice.franki folded before Flop (didn't bet)
Seat 8: hldtom folded before Flop (didn't bet)
Seat 9: Alvinpe85 folded before Flop (didn't bet)



PokerStars Zoom Hand #84300685136:  Hold'em No Limit ($0.10/$0.25) - 2012/08/05 15:44:28 JST [2012/08/05 2:44:28 ET]
Table 'Whirlpool' 9-max Seat #1 is the button
Seat 1: Rilko1975 ($24.85 in chips) 
Seat 2: Grishukps ($12.50 in chips) 
Seat 3: kesstukas25 ($16.05 in chips) 
Seat 4: masterkoolb ($17.73 in chips) 
Seat 5: ChrisCDee ($39.07 in chips) 
Seat 6: phate-1up ($43.09 in chips) 
Seat 7: Dejacob ($26.70 in chips) 
Seat 8: Dan Royal ($24.75 in chips) 
Seat 9: chiyuki ($29.41 in chips) 
Grishukps: posts small blind $0.10
kesstukas25: posts big blind $0.25
*** HOLE CARDS ***
Dealt to chiyuki [2d 4s]
masterkoolb: raises $0.60 to $0.85
ChrisCDee: folds 
phate-1up: folds 
Dejacob: folds 
Dan Royal: folds 
chiyuki: folds 
Rilko1975: calls $0.85
Grishukps: folds 
kesstukas25: folds 
*** FLOP *** [3d 6c Kh]
masterkoolb: bets $1.47
Rilko1975: folds 
Uncalled bet ($1.47) returned to masterkoolb
masterkoolb collected $1.96 from pot
masterkoolb: doesn't show hand 
*** SUMMARY ***
Total pot $2.05 | Rake $0.09 
Board [3d 6c Kh]
Seat 1: Rilko1975 (button) folded on the Flop
Seat 2: Grishukps (small blind) folded before Flop
Seat 3: kesstukas25 (big blind) folded before Flop
Seat 4: masterkoolb collected ($1.96)
Seat 5: ChrisCDee folded before Flop (didn't bet)
Seat 6: phate-1up folded before Flop (didn't bet)
Seat 7: Dejacob folded before Flop (didn't bet)
Seat 8: Dan Royal folded before Flop (didn't bet)
Seat 9: chiyuki folded before Flop (didn't bet)



PokerStars Zoom Hand #84300689990:  Hold'em No Limit ($0.10/$0.25) - 2012/08/05 15:44:47 JST [2012/08/05 2:44:47 ET]
Table 'Whirlpool' 9-max Seat #1 is the button
Seat 1: kwkim73 ($56.51 in chips) 
Seat 2: macmauret ($9.64 in chips) 
Seat 3: kkbruins0408 ($22.20 in chips) 
Seat 4: opie62 ($19.73 in chips) 
Seat 5: romanian c4 ($20.22 in chips) 
Seat 6: Spheroff ($19.87 in chips) 
Seat 7: chiyuki ($29.41 in chips) 
Seat 8: herkko11 ($6.18 in chips) 
Seat 9: ZhukOFFskI ($65.50 in chips) 
macmauret: posts small blind $0.10
kkbruins0408: posts big blind $0.25
*** HOLE CARDS ***
Dealt to chiyuki [7s Td]
opie62: folds 
romanian c4: raises $0.25 to $0.50
Spheroff: folds 
chiyuki: folds 
herkko11: folds 
ZhukOFFskI: folds 
kwkim73: folds 
macmauret: folds 
kkbruins0408: folds 
Uncalled bet ($0.25) returned to romanian c4
romanian c4 collected $0.60 from pot
romanian c4: doesn't show hand 
*** SUMMARY ***
Total pot $0.60 | Rake $0 
Seat 1: kwkim73 (button) folded before Flop (didn't bet)
Seat 2: macmauret (small blind) folded before Flop
Seat 3: kkbruins0408 (big blind) folded before Flop
Seat 4: opie62 folded before Flop (didn't bet)
Seat 5: romanian c4 collected ($0.60)
Seat 6: Spheroff folded before Flop (didn't bet)
Seat 7: chiyuki folded before Flop (didn't bet)
Seat 8: herkko11 folded before Flop (didn't bet)
Seat 9: ZhukOFFskI folded before Flop (didn't bet)



PokerStars Zoom Hand #84300687966:  Hold'em No Limit ($0.10/$0.25) - 2012/08/05 15:44:39 JST [2012/08/05 2:44:39 ET]
Table 'Whirlpool' 9-max Seat #1 is the button
Seat 1: 1Karina1 ($25.10 in chips) 
Seat 2: kesstukas25 ($15.80 in chips) 
Seat 3: phate-1up ($68.35 in chips) 
Seat 4: Alvinpe85 ($46.88 in chips) 
Seat 5: chiyuki ($29.41 in chips) 
Seat 6: DutchShultzs ($27.13 in chips) 
Seat 7: nice.franki ($11.15 in chips) 
Seat 8: soul_5577 ($37.55 in chips) 
Seat 9: jacquelinewu ($29.31 in chips) 
kesstukas25: posts small blind $0.10
phate-1up: posts big blind $0.25
*** HOLE CARDS ***
Dealt to chiyuki [8s 9s]
Alvinpe85: folds 
chiyuki: folds 
DutchShultzs: raises $0.50 to $0.75
nice.franki: folds 
soul_5577: calls $0.75
jacquelinewu: folds 
1Karina1: folds 
kesstukas25: folds 
phate-1up: folds 
*** FLOP *** [Qc 6d 8c]
DutchShultzs: checks 
soul_5577: bets $1.25
DutchShultzs: folds 
Uncalled bet ($1.25) returned to soul_5577
soul_5577 collected $1.77 from pot
soul_5577: doesn't show hand 
*** SUMMARY ***
Total pot $1.85 | Rake $0.08 
Board [Qc 6d 8c]
Seat 1: 1Karina1 (button) folded before Flop (didn't bet)
Seat 2: kesstukas25 (small blind) folded before Flop
Seat 3: phate-1up (big blind) folded before Flop
Seat 4: Alvinpe85 folded before Flop (didn't bet)
Seat 5: chiyuki folded before Flop (didn't bet)
Seat 6: DutchShultzs folded on the Flop
Seat 7: nice.franki folded before Flop (didn't bet)
Seat 8: soul_5577 collected ($1.77)
Seat 9: jacquelinewu folded before Flop (didn't bet)



PokerStars Zoom Hand #84300693834:  Hold'em No Limit ($0.10/$0.25) - 2012/08/05 15:45:02 JST [2012/08/05 2:45:02 ET]
Table 'Whirlpool' 9-max Seat #1 is the button
Seat 1: slapshot2011 ($4.24 in chips) 
Seat 2: pawn909 ($12.45 in chips) 
Seat 3: Gichboy ($32.17 in chips) 
Seat 4: chiyuki ($29.31 in chips) 
Seat 5: Rici47 ($36.74 in chips) 
Seat 6: Rilko1975 ($24.65 in chips) 
Seat 7: Limoilou ($33.57 in chips) 
Seat 8: snejokCoxx ($12.50 in chips) 
Seat 9: silvno31 ($66.09 in chips) 
pawn909: posts small blind $0.10
Gichboy: posts big blind $0.25
*** HOLE CARDS ***
Dealt to chiyuki [6d As]
chiyuki: folds 
Rici47: folds 
Rilko1975: folds 
Limoilou: folds 
snejokCoxx: folds 
silvno31: folds 
slapshot2011: folds 
pawn909: folds 
Uncalled bet ($0.15) returned to Gichboy
Gichboy collected $0.20 from pot
Gichboy: doesn't show hand 
*** SUMMARY ***
Total pot $0.20 | Rake $0 
Seat 1: slapshot2011 (button) folded before Flop (didn't bet)
Seat 2: pawn909 (small blind) folded before Flop
Seat 3: Gichboy (big blind) collected ($0.20)
Seat 4: chiyuki folded before Flop (didn't bet)
Seat 5: Rici47 folded before Flop (didn't bet)
Seat 6: Rilko1975 folded before Flop (didn't bet)
Seat 7: Limoilou folded before Flop (didn't bet)
Seat 8: snejokCoxx folded before Flop (didn't bet)
Seat 9: silvno31 folded before Flop (didn't bet)



PokerStars Zoom Hand #84300688732:  Hold'em No Limit ($0.10/$0.25) - 2012/08/05 15:44:42 JST [2012/08/05 2:44:42 ET]
Table 'Whirlpool' 9-max Seat #1 is the button
Seat 1: DrunkTyphoon ($25 in chips) 
Seat 2: GSDP ($50.49 in chips) 
Seat 3: snejokCoxx ($12.50 in chips) 
Seat 4: kkbruins0408 ($22.20 in chips) 
Seat 5: chiyuki ($29.41 in chips) 
Seat 6: Dejacob ($25 in chips) 
Seat 7: seula i ($27.56 in chips) 
Seat 8: PPP7SSS ($19.83 in chips) 
Seat 9: ViTiV2010 ($12.82 in chips) 
GSDP: posts small blind $0.10
snejokCoxx: posts big blind $0.25
*** HOLE CARDS ***
Dealt to chiyuki [8s Qc]
kkbruins0408: folds 
chiyuki: folds 
Dejacob: folds 
seula i: folds 
PPP7SSS: folds 
ViTiV2010: folds 
DrunkTyphoon: folds 
GSDP: calls $0.15
snejokCoxx: raises $0.50 to $0.75
GSDP: folds 
Uncalled bet ($0.50) returned to snejokCoxx
snejokCoxx collected $0.50 from pot
snejokCoxx: doesn't show hand 
*** SUMMARY ***
Total pot $0.50 | Rake $0 
Seat 1: DrunkTyphoon (button) folded before Flop (didn't bet)
Seat 2: GSDP (small blind) folded before Flop
Seat 3: snejokCoxx (big blind) collected ($0.50)
Seat 4: kkbruins0408 folded before Flop (didn't bet)
Seat 5: chiyuki folded before Flop (didn't bet)
Seat 6: Dejacob folded before Flop (didn't bet)
Seat 7: seula i folded before Flop (didn't bet)
Seat 8: PPP7SSS folded before Flop (didn't bet)
Seat 9: ViTiV2010 folded before Flop (didn't bet)



PokerStars Zoom Hand #84300692302:  Hold'em No Limit ($0.10/$0.25) - 2012/08/05 15:44:56 JST [2012/08/05 2:44:56 ET]
Table 'Whirlpool' 9-max Seat #1 is the button
Seat 1: Grishukps ($12.50 in chips) 
Seat 2: chiyuki ($29.41 in chips) 
Seat 3: yvasilik ($23.07 in chips) 
Seat 4: HighDuka ($34.41 in chips) 
Seat 5: Perstenev ($6.71 in chips) 
Seat 6: jvds114 ($27.40 in chips) 
Seat 7: Ozboy80 ($26.44 in chips) 
Seat 8: GSDP ($22.69 in chips) 
Seat 9: Serge Claws ($30.83 in chips) 
chiyuki: posts small blind $0.10
yvasilik: posts big blind $0.25
*** HOLE CARDS ***
Dealt to chiyuki [Tc 5c]
HighDuka: folds 
Perstenev: folds 
jvds114: raises $0.50 to $0.75
Ozboy80: folds 
GSDP: calls $0.75
Serge Claws: folds 
Grishukps: folds 
chiyuki: folds 
yvasilik: folds 
*** FLOP *** [8c 2h 7d]
jvds114: bets $2
GSDP: folds 
Uncalled bet ($2) returned to jvds114
jvds114 collected $1.77 from pot
jvds114: doesn't show hand 
*** SUMMARY ***
Total pot $1.85 | Rake $0.08 
Board [8c 2h 7d]
Seat 1: Grishukps (button) folded before Flop (didn't bet)
Seat 2: chiyuki (small blind) folded before Flop
Seat 3: yvasilik (big blind) folded before Flop
Seat 4: HighDuka folded before Flop (didn't bet)
Seat 5: Perstenev folded before Flop (didn't bet)
Seat 6: jvds114 collected ($1.77)
Seat 7: Ozboy80 folded before Flop (didn't bet)
Seat 8: GSDP folded on the Flop
Seat 9: Serge Claws folded before Flop (didn't bet)



PokerStars Zoom Hand #84300701138:  Hold'em No Limit ($0.10/$0.25) - 2012/08/05 15:45:31 JST [2012/08/05 2:45:31 ET]
Table 'Whirlpool' 9-max Seat #1 is the button
Seat 1: opie62 ($19.48 in chips) 
Seat 2: INSP!RON ($39.67 in chips) 
Seat 3: herkko11 ($6.53 in chips) 
Seat 4: ZhukOFFskI ($66.52 in chips) 
Seat 5: DrunkTyphoon ($30.50 in chips) 
Seat 6: WARIBANA7777 ($14.89 in chips) 
Seat 7: KeLevro0 ($11.90 in chips) 
Seat 8: Femali54 ($24.65 in chips) 
Seat 9: chiyuki ($29.31 in chips) 
INSP!RON: posts small blind $0.10
herkko11: posts big blind $0.25
*** HOLE CARDS ***
Dealt to chiyuki [6d 8d]
ZhukOFFskI: folds 
DrunkTyphoon: folds 
WARIBANA7777: folds 
KeLevro0: folds 
Femali54: folds 
chiyuki: folds 
opie62: raises $0.25 to $0.50
INSP!RON: folds 
herkko11: folds 
Uncalled bet ($0.25) returned to opie62
opie62 collected $0.60 from pot
opie62: doesn't show hand 
*** SUMMARY ***
Total pot $0.60 | Rake $0 
Seat 1: opie62 (button) collected ($0.60)
Seat 2: INSP!RON (small blind) folded before Flop
Seat 3: herkko11 (big blind) folded before Flop
Seat 4: ZhukOFFskI folded before Flop (didn't bet)
Seat 5: DrunkTyphoon folded before Flop (didn't bet)
Seat 6: WARIBANA7777 folded before Flop (didn't bet)
Seat 7: KeLevro0 folded before Flop (didn't bet)
Seat 8: Femali54 folded before Flop (didn't bet)
Seat 9: chiyuki folded before Flop (didn't bet)



PokerStars Zoom Hand #84300706078:  Hold'em No Limit ($0.10/$0.25) - 2012/08/05 15:45:50 JST [2012/08/05 2:45:50 ET]
Table 'Whirlpool' 9-max Seat #1 is the button
Seat 1: aivvo ($7.93 in chips) 
Seat 2: romanian c4 ($20.32 in chips) 
Seat 3: Grishukps ($12.85 in chips) 
Seat 4: svg51 ($2.59 in chips) 
Seat 5: chiyuki ($29.06 in chips) 
Seat 6: fwnaf ($14.10 in chips) 
Seat 7: nice.franki ($11.05 in chips) 
Seat 8: panaam ($21.69 in chips) 
Seat 9: Spheroff ($19.52 in chips) 
romanian c4: posts small blind $0.10
Grishukps: posts big blind $0.25
*** HOLE CARDS ***
Dealt to chiyuki [Qh 9h]
svg51: folds 
chiyuki: folds 
fwnaf: folds 
nice.franki: folds 
panaam: folds 
Spheroff: folds 
aivvo: folds 
romanian c4: folds 
Uncalled bet ($0.15) returned to Grishukps
Grishukps collected $0.20 from pot
Grishukps: doesn't show hand 
*** SUMMARY ***
Total pot $0.20 | Rake $0 
Seat 1: aivvo (button) folded before Flop (didn't bet)
Seat 2: romanian c4 (small blind) folded before Flop
Seat 3: Grishukps (big blind) collected ($0.20)
Seat 4: svg51 folded before Flop (didn't bet)
Seat 5: chiyuki folded before Flop (didn't bet)
Seat 6: fwnaf folded before Flop (didn't bet)
Seat 7: nice.franki folded before Flop (didn't bet)
Seat 8: panaam folded before Flop (didn't bet)
Seat 9: Spheroff folded before Flop (didn't bet)



PokerStars Zoom Hand #84300696517:  Hold'em No Limit ($0.10/$0.25) - 2012/08/05 15:45:13 JST [2012/08/05 2:45:13 ET]
Table 'Whirlpool' 9-max Seat #1 is the button
Seat 1: chiyuki ($29.31 in chips) 
Seat 2: GovGus ($41.92 in chips) 
Seat 3: snejokCoxx ($13.50 in chips) 
Seat 4: Ozboy80 ($26.34 in chips) 
Seat 5: Gichboy ($11.65 in chips) 
Seat 6: kesstukas25 ($15.70 in chips) 
Seat 7: herkko11 ($6.53 in chips) 
Seat 8: Silveystryk ($46.45 in chips) 
Seat 9: romanian c4 ($20.32 in chips) 
GovGus: posts small blind $0.10
snejokCoxx: posts big blind $0.25
*** HOLE CARDS ***
Dealt to chiyuki [Td 3d]
Ozboy80: raises $0.50 to $0.75
Gichboy: calls $0.75
kesstukas25: folds 
herkko11: folds 
Silveystryk: folds 
romanian c4: folds 
chiyuki: folds 
GovGus: folds 
snejokCoxx: folds 
*** FLOP *** [Th 5s 9c]
Ozboy80: bets $0.50
Gichboy: raises $0.75 to $1.25
Ozboy80: calls $0.75
*** TURN *** [Th 5s 9c] [3c]
Ozboy80: checks 
Gichboy: checks 
*** RIVER *** [Th 5s 9c 3c] [Qs]
Ozboy80: checks 
Gichboy: checks 
*** SHOW DOWN ***
Ozboy80: shows [Jc Ad] (high card Ace)
Gichboy: shows [Qd Jh] (a pair of Queens)
Gichboy collected $4.15 from pot
*** SUMMARY ***
Total pot $4.35 | Rake $0.20 
Board [Th 5s 9c 3c Qs]
Seat 1: chiyuki (button) folded before Flop (didn't bet)
Seat 2: GovGus (small blind) folded before Flop
Seat 3: snejokCoxx (big blind) folded before Flop
Seat 4: Ozboy80 showed [Jc Ad] and lost with high card Ace
Seat 5: Gichboy showed [Qd Jh] and won ($4.15) with a pair of Queens
Seat 6: kesstukas25 folded before Flop (didn't bet)
Seat 7: herkko11 folded before Flop (didn't bet)
Seat 8: Silveystryk folded before Flop (didn't bet)
Seat 9: romanian c4 folded before Flop (didn't bet)



PokerStars Zoom Hand #84300700113:  Hold'em No Limit ($0.10/$0.25) - 2012/08/05 15:45:27 JST [2012/08/05 2:45:27 ET]
Table 'Whirlpool' 9-max Seat #1 is the button
Seat 1: GovGus ($43.85 in chips) 
Seat 2: banderas761 ($21.35 in chips) 
Seat 3: nastya040 ($15.81 in chips) 
Seat 4: 1Karina1 ($25.10 in chips) 
Seat 5: seula i ($26.56 in chips) 
Seat 6: herkko11 ($6.53 in chips) 
Seat 7: kwkim73 ($56.51 in chips) 
Seat 8: chiyuki ($29.31 in chips) 
Seat 9: Kozyavkin ($24.65 in chips) 
banderas761: posts small blind $0.10
nastya040: posts big blind $0.25
*** HOLE CARDS ***
Dealt to chiyuki [6s 2c]
1Karina1: folds 
seula i: folds 
herkko11: folds 
kwkim73: folds 
chiyuki: folds 
Kozyavkin: folds 
GovGus: folds 
banderas761: calls $0.15
nastya040: checks 
*** FLOP *** [4c Qc 6c]
banderas761: checks 
nastya040: checks 
*** TURN *** [4c Qc 6c] [2h]
banderas761: checks 
nastya040: bets $0.25
banderas761: folds 
Uncalled bet ($0.25) returned to nastya040
nastya040 collected $0.48 from pot
nastya040: doesn't show hand 
*** SUMMARY ***
Total pot $0.50 | Rake $0.02 
Board [4c Qc 6c 2h]
Seat 1: GovGus (button) folded before Flop (didn't bet)
Seat 2: banderas761 (small blind) folded on the Turn
Seat 3: nastya040 (big blind) collected ($0.48)
Seat 4: 1Karina1 folded before Flop (didn't bet)
Seat 5: seula i folded before Flop (didn't bet)
Seat 6: herkko11 folded before Flop (didn't bet)
Seat 7: kwkim73 folded before Flop (didn't bet)
Seat 8: chiyuki folded before Flop (didn't bet)
Seat 9: Kozyavkin folded before Flop (didn't bet)



PokerStars Zoom Hand #84300702142:  Hold'em No Limit ($0.10/$0.25) - 2012/08/05 15:45:35 JST [2012/08/05 2:45:35 ET]
Table 'Whirlpool' 9-max Seat #1 is the button
Seat 1: GSDP ($50.24 in chips) 
Seat 2: Dejacob ($26.45 in chips) 
Seat 3: chiyuki ($29.31 in chips) 
Seat 4: DrunkTyphoon ($30.50 in chips) 
Seat 5: TorTrade ($26.14 in chips) 
Seat 6: Serge Claws ($25 in chips) 
Seat 7: Femali54 ($24.65 in chips) 
Seat 8: ZhukOFFskI ($66.52 in chips) 
Seat 9: KeLevro0 ($17.63 in chips) 
Dejacob: posts small blind $0.10
chiyuki: posts big blind $0.25
*** HOLE CARDS ***
Dealt to chiyuki [3h 2h]
DrunkTyphoon: raises $0.50 to $0.75
TorTrade: folds 
Serge Claws: folds 
Femali54: folds 
ZhukOFFskI: folds 
KeLevro0: folds 
GSDP: folds 
Dejacob: folds 
chiyuki: folds 
Uncalled bet ($0.50) returned to DrunkTyphoon
DrunkTyphoon collected $0.60 from pot
DrunkTyphoon: doesn't show hand 
*** SUMMARY ***
Total pot $0.60 | Rake $0 
Seat 1: GSDP (button) folded before Flop (didn't bet)
Seat 2: Dejacob (small blind) folded before Flop
Seat 3: chiyuki (big blind) folded before Flop
Seat 4: DrunkTyphoon collected ($0.60)
Seat 5: TorTrade folded before Flop (didn't bet)
Seat 6: Serge Claws folded before Flop (didn't bet)
Seat 7: Femali54 folded before Flop (didn't bet)
Seat 8: ZhukOFFskI folded before Flop (didn't bet)
Seat 9: KeLevro0 folded before Flop (didn't bet)



PokerStars Zoom Hand #84300707125:  Hold'em No Limit ($0.10/$0.25) - 2012/08/05 15:45:54 JST [2012/08/05 2:45:54 ET]
Table 'Whirlpool' 9-max Seat #1 is the button
Seat 1: panaam ($21.69 in chips) 
Seat 2: chiyuki ($29.06 in chips) 
Seat 3: romanian c4 ($20.22 in chips) 
Seat 4: Rici47 ($30.47 in chips) 
Seat 5: 0 operator 0 ($33.47 in chips) 
Seat 6: snejokCoxx ($13.25 in chips) 
Seat 7: aivvo ($7.93 in chips) 
Seat 8: tribunpdm ($88.52 in chips) 
Seat 9: Jene4kaBest ($12.46 in chips) 
chiyuki: posts small blind $0.10
romanian c4: posts big blind $0.25
*** HOLE CARDS ***
Dealt to chiyuki [Tc Js]
Rici47: folds 
0 operator 0: folds 
snejokCoxx: folds 
aivvo: folds 
tribunpdm: folds 
Jene4kaBest: folds 
panaam: folds 
chiyuki: raises $0.50 to $0.75
romanian c4: folds 
Uncalled bet ($0.50) returned to chiyuki
chiyuki collected $0.50 from pot
chiyuki: doesn't show hand 
*** SUMMARY ***
Total pot $0.50 | Rake $0 
Seat 1: panaam (button) folded before Flop (didn't bet)
Seat 2: chiyuki (small blind) collected ($0.50)
Seat 3: romanian c4 (big blind) folded before Flop
Seat 4: Rici47 folded before Flop (didn't bet)
Seat 5: 0 operator 0 folded before Flop (didn't bet)
Seat 6: snejokCoxx folded before Flop (didn't bet)
Seat 7: aivvo folded before Flop (didn't bet)
Seat 8: tribunpdm folded before Flop (didn't bet)
Seat 9: Jene4kaBest folded before Flop (didn't bet)



PokerStars Zoom Hand #84300704422:  Hold'em No Limit ($0.10/$0.25) - 2012/08/05 15:45:44 JST [2012/08/05 2:45:44 ET]
Table 'Whirlpool' 9-max Seat #1 is the button
Seat 1: 1Karina1 ($36.07 in chips) 
Seat 2: aivvo ($8.03 in chips) 
Seat 3: GovGus ($43.85 in chips) 
Seat 4: jacquelinewu ($32.29 in chips) 
Seat 5: drunk_bender ($18.96 in chips) 
Seat 6: chiyuki ($29.06 in chips) 
Seat 7: snejokCoxx ($13.25 in chips) 
Seat 8: ViTiV2010 ($12.24 in chips) 
Seat 9: panaam ($21.69 in chips) 
aivvo: posts small blind $0.10
GovGus: posts big blind $0.25
*** HOLE CARDS ***
Dealt to chiyuki [6h 9h]
jacquelinewu: folds 
drunk_bender: folds 
chiyuki: folds 
snejokCoxx: folds 
ViTiV2010: folds 
panaam: folds 
1Karina1: folds 
aivvo: folds 
Uncalled bet ($0.15) returned to GovGus
GovGus collected $0.20 from pot
GovGus: doesn't show hand 
*** SUMMARY ***
Total pot $0.20 | Rake $0 
Seat 1: 1Karina1 (button) folded before Flop (didn't bet)
Seat 2: aivvo (small blind) folded before Flop
Seat 3: GovGus (big blind) collected ($0.20)
Seat 4: jacquelinewu folded before Flop (didn't bet)
Seat 5: drunk_bender folded before Flop (didn't bet)
Seat 6: chiyuki folded before Flop (didn't bet)
Seat 7: snejokCoxx folded before Flop (didn't bet)
Seat 8: ViTiV2010 folded before Flop (didn't bet)
Seat 9: panaam folded before Flop (didn't bet)



PokerStars Zoom Hand #84300711253:  Hold'em No Limit ($0.10/$0.25) - 2012/08/05 15:46:10 JST [2012/08/05 2:46:10 ET]
Table 'Whirlpool' 9-max Seat #1 is the button
Seat 1: Perstenev ($24.76 in chips) 
Seat 2: moku36 ($44.20 in chips) 
Seat 3: jvds114 ($25 in chips) 
Seat 4: chiyuki ($29.31 in chips) 
Seat 5: Ellen1947 ($31.83 in chips) 
Seat 6: Kasperlmusik ($25.35 in chips) 
Seat 7: Alvinpe85 ($48.78 in chips) 
Seat 8: Grishukps ($12.95 in chips) 
Seat 9: ChrisCDee ($38.72 in chips) 
moku36: posts small blind $0.10
jvds114: posts big blind $0.25
*** HOLE CARDS ***
Dealt to chiyuki [Qd As]
chiyuki: raises $0.50 to $0.75
Ellen1947: folds 
Kasperlmusik: folds 
Alvinpe85: folds 
Grishukps: folds 
ChrisCDee: folds 
Perstenev: folds 
moku36: calls $0.65
jvds114: folds 
*** FLOP *** [Th Jh 5d]
moku36: checks 
chiyuki: bets $1
moku36: calls $1
*** TURN *** [Th Jh 5d] [9d]
moku36: checks 
chiyuki: checks 
*** RIVER *** [Th Jh 5d 9d] [9c]
moku36: bets $2.25
chiyuki: folds 
Uncalled bet ($2.25) returned to moku36
moku36 collected $3.58 from pot
moku36: doesn't show hand 
*** SUMMARY ***
Total pot $3.75 | Rake $0.17 
Board [Th Jh 5d 9d 9c]
Seat 1: Perstenev (button) folded before Flop (didn't bet)
Seat 2: moku36 (small blind) collected ($3.58)
Seat 3: jvds114 (big blind) folded before Flop
Seat 4: chiyuki folded on the River
Seat 5: Ellen1947 folded before Flop (didn't bet)
Seat 6: Kasperlmusik folded before Flop (didn't bet)
Seat 7: Alvinpe85 folded before Flop (didn't bet)
Seat 8: Grishukps folded before Flop (didn't bet)
Seat 9: ChrisCDee folded before Flop (didn't bet)



PokerStars Zoom Hand #84300722813:  Hold'em No Limit ($0.10/$0.25) - 2012/08/05 15:46:55 JST [2012/08/05 2:46:55 ET]
Table 'Whirlpool' 9-max Seat #1 is the button
Seat 1: Gichboy ($13.20 in chips) 
Seat 2: Saruotiss ($64.86 in chips) 
Seat 3: ChrisCDee ($38.72 in chips) 
Seat 4: Rilko1975 ($25.91 in chips) 
Seat 5: chiyuki ($27.56 in chips) 
Seat 6: jacquelinewu ($68.38 in chips) 
Seat 7: Serge Claws ($25 in chips) 
Seat 8: KeLevro0 ($8.36 in chips) 
Seat 9: seula i ($26.46 in chips) 
Saruotiss: posts small blind $0.10
ChrisCDee: posts big blind $0.25
*** HOLE CARDS ***
Dealt to chiyuki [4d 9h]
Rilko1975: folds 
chiyuki: folds 
jacquelinewu: folds 
Serge Claws: folds 
KeLevro0: folds 
seula i: folds 
Gichboy: folds 
Saruotiss: folds 
Uncalled bet ($0.15) returned to ChrisCDee
ChrisCDee collected $0.20 from pot
ChrisCDee: doesn't show hand 
ChrisCDee is disconnected 
*** SUMMARY ***
Total pot $0.20 | Rake $0 
Seat 1: Gichboy (button) folded before Flop (didn't bet)
Seat 2: Saruotiss (small blind) folded before Flop
Seat 3: ChrisCDee (big blind) collected ($0.20)
Seat 4: Rilko1975 folded before Flop (didn't bet)
Seat 5: chiyuki folded before Flop (didn't bet)
Seat 6: jacquelinewu folded before Flop (didn't bet)
Seat 7: Serge Claws folded before Flop (didn't bet)
Seat 8: KeLevro0 folded before Flop (didn't bet)
Seat 9: seula i folded before Flop (didn't bet)



PokerStars Zoom Hand #84300723846:  Hold'em No Limit ($0.10/$0.25) - 2012/08/05 15:46:59 JST [2012/08/05 2:46:59 ET]
Table 'Whirlpool' 9-max Seat #1 is the button
Seat 1: chiyuki ($27.56 in chips) 
Seat 2: 4plankton ($22.18 in chips) 
Seat 3: snejokCoxx ($12.59 in chips) 
Seat 4: jacquelinewu ($26.43 in chips) 
Seat 5: INSP!RON ($39.89 in chips) 
Seat 6: Silveystryk ($24.26 in chips) 
Seat 7: AntoineHunt ($36.59 in chips) 
Seat 8: Grishukps ($13.15 in chips) 
Seat 9: seula i ($25.35 in chips) 
4plankton: posts small blind $0.10
snejokCoxx: posts big blind $0.25
*** HOLE CARDS ***
Dealt to chiyuki [Qs 5c]
jacquelinewu: folds 
INSP!RON: folds 
Silveystryk: folds 
AntoineHunt: folds 
Grishukps: raises $0.50 to $0.75
seula i: folds 
chiyuki: folds 
4plankton: folds 
snejokCoxx: folds 
Uncalled bet ($0.50) returned to Grishukps
Grishukps collected $0.60 from pot
Grishukps: doesn't show hand 
*** SUMMARY ***
Total pot $0.60 | Rake $0 
Seat 1: chiyuki (button) folded before Flop (didn't bet)
Seat 2: 4plankton (small blind) folded before Flop
Seat 3: snejokCoxx (big blind) folded before Flop
Seat 4: jacquelinewu folded before Flop (didn't bet)
Seat 5: INSP!RON folded before Flop (didn't bet)
Seat 6: Silveystryk folded before Flop (didn't bet)
Seat 7: AntoineHunt folded before Flop (didn't bet)
Seat 8: Grishukps collected ($0.60)
Seat 9: seula i folded before Flop (didn't bet)



PokerStars Zoom Hand #84300725357:  Hold'em No Limit ($0.10/$0.25) - 2012/08/05 15:47:05 JST [2012/08/05 2:47:05 ET]
Table 'Whirlpool' 9-max Seat #1 is the button
Seat 1: DrunkTyphoon ($33.49 in chips) 
Seat 2: KrystalAA ($10.46 in chips) 
Seat 3: chiyuki ($27.56 in chips) 
Seat 4: hldtom ($25.82 in chips) 
Seat 5: INSP!RON ($40.69 in chips) 
Seat 6: jacquelinewu ($32.74 in chips) 
Seat 7: nice.franki ($10.90 in chips) 
Seat 8: yvasilik ($22.69 in chips) 
Seat 9: GovGus ($44.66 in chips) 
KrystalAA: posts small blind $0.10
chiyuki: posts big blind $0.25
*** HOLE CARDS ***
Dealt to chiyuki [4s 5s]
hldtom: folds 
INSP!RON: folds 
jacquelinewu: folds 
nice.franki: folds 
yvasilik: folds 
GovGus: raises $0.75 to $1
DrunkTyphoon: folds 
KrystalAA: folds 
chiyuki: folds 
Uncalled bet ($0.75) returned to GovGus
GovGus collected $0.60 from pot
GovGus: doesn't show hand 
*** SUMMARY ***
Total pot $0.60 | Rake $0 
Seat 1: DrunkTyphoon (button) folded before Flop (didn't bet)
Seat 2: KrystalAA (small blind) folded before Flop
Seat 3: chiyuki (big blind) folded before Flop
Seat 4: hldtom folded before Flop (didn't bet)
Seat 5: INSP!RON folded before Flop (didn't bet)
Seat 6: jacquelinewu folded before Flop (didn't bet)
Seat 7: nice.franki folded before Flop (didn't bet)
Seat 8: yvasilik folded before Flop (didn't bet)
Seat 9: GovGus collected ($0.60)



PokerStars Zoom Hand #84300731176:  Hold'em No Limit ($0.10/$0.25) - 2012/08/05 15:47:27 JST [2012/08/05 2:47:27 ET]
Table 'Whirlpool' 9-max Seat #1 is the button
Seat 1: KeLevro0 ($12.88 in chips) 
Seat 2: Silveystryk ($23.44 in chips) 
Seat 3: AAAKK777 ($11.30 in chips) 
Seat 4: DutchShultzs ($25.63 in chips) 
Seat 5: yvasilik ($22.59 in chips) 
Seat 6: Femali54 ($25 in chips) 
Seat 7: Rilko1975 ($24 in chips) 
Seat 8: chiyuki ($27.31 in chips) 
Seat 9: jacquelinewu ($32.99 in chips) 
Silveystryk: posts small blind $0.10
AAAKK777: posts big blind $0.25
*** HOLE CARDS ***
Dealt to chiyuki [4h Kd]
DutchShultzs: folds 
yvasilik: folds 
Femali54: folds 
Rilko1975: folds 
chiyuki: folds 
jacquelinewu: folds 
KeLevro0: folds 
Silveystryk: calls $0.15
AAAKK777: checks 
*** FLOP *** [2d 6c Th]
Silveystryk: bets $0.25
AAAKK777: calls $0.25
*** TURN *** [2d 6c Th] [5d]
Silveystryk: checks 
AAAKK777: bets $0.25
Silveystryk: calls $0.25
*** RIVER *** [2d 6c Th 5d] [Ts]
Silveystryk: checks 
AAAKK777: checks 
*** SHOW DOWN ***
Silveystryk: shows [4c 4s] (two pair, Tens and Fours)
AAAKK777: shows [9h 5h] (two pair, Tens and Fives)
AAAKK777 collected $1.43 from pot
*** SUMMARY ***
Total pot $1.50 | Rake $0.07 
Board [2d 6c Th 5d Ts]
Seat 1: KeLevro0 (button) folded before Flop (didn't bet)
Seat 2: Silveystryk (small blind) showed [4c 4s] and lost with two pair, Tens and Fours
Seat 3: AAAKK777 (big blind) showed [9h 5h] and won ($1.43) with two pair, Tens and Fives
Seat 4: DutchShultzs folded before Flop (didn't bet)
Seat 5: yvasilik folded before Flop (didn't bet)
Seat 6: Femali54 folded before Flop (didn't bet)
Seat 7: Rilko1975 folded before Flop (didn't bet)
Seat 8: chiyuki folded before Flop (didn't bet)
Seat 9: jacquelinewu folded before Flop (didn't bet)



PokerStars Zoom Hand #84300733184:  Hold'em No Limit ($0.10/$0.25) - 2012/08/05 15:47:36 JST [2012/08/05 2:47:36 ET]
Table 'Whirlpool' 9-max Seat #1 is the button
Seat 1: seula i ($27.01 in chips) 
Seat 2: kwkim73 ($25 in chips) 
Seat 3: fil740 ($9.63 in chips) 
Seat 4: GSDP ($19.29 in chips) 
Seat 5: 1Karina1 ($35.72 in chips) 
Seat 6: nice.franki ($6.90 in chips) 
Seat 7: chiyuki ($27.31 in chips) 
Seat 8: Nerkit ($11.75 in chips) 
Seat 9: snejokCoxx ($15.97 in chips) 
kwkim73: posts small blind $0.10
fil740: posts big blind $0.25
*** HOLE CARDS ***
Dealt to chiyuki [As Ad]
GSDP: folds 
1Karina1: folds 
nice.franki: folds 
chiyuki: raises $0.50 to $0.75
Nerkit: raises $1.50 to $2.25
snejokCoxx: folds 
seula i: folds 
kwkim73: folds 
fil740: folds 
chiyuki: raises $4 to $6.25
Nerkit: raises $5.50 to $11.75 and is all-in
chiyuki: calls $5.50
*** FLOP *** [6h Tc 8c]
*** TURN *** [6h Tc 8c] [Qs]
*** RIVER *** [6h Tc 8c Qs] [9s]
*** SHOW DOWN ***
chiyuki: shows [As Ad] (a pair of Aces)
Nerkit: mucks hand 
chiyuki collected $22.78 from pot
*** SUMMARY ***
Total pot $23.85 | Rake $1.07 
Board [6h Tc 8c Qs 9s]
Seat 1: seula i (button) folded before Flop (didn't bet)
Seat 2: kwkim73 (small blind) folded before Flop
Seat 3: fil740 (big blind) folded before Flop
Seat 4: GSDP folded before Flop (didn't bet)
Seat 5: 1Karina1 folded before Flop (didn't bet)
Seat 6: nice.franki folded before Flop (didn't bet)
Seat 7: chiyuki showed [As Ad] and won ($22.78) with a pair of Aces
Seat 8: Nerkit mucked [Ks Kc]
Seat 9: snejokCoxx folded before Flop (didn't bet)



PokerStars Zoom Hand #84300732180:  Hold'em No Limit ($0.10/$0.25) - 2012/08/05 15:47:32 JST [2012/08/05 2:47:32 ET]
Table 'Whirlpool' 9-max Seat #1 is the button
Seat 1: DrunkTyphoon ($33.49 in chips) 
Seat 2: herkko11 ($9.53 in chips) 
Seat 3: jvds114 ($26.27 in chips) 
Seat 4: KrystalAA ($38.02 in chips) 
Seat 5: Rilko1975 ($24 in chips) 
Seat 6: 1Karina1 ($35.72 in chips) 
Seat 7: Nerkit ($11.75 in chips) 
Seat 8: Femali54 ($25 in chips) 
Seat 9: chiyuki ($27.31 in chips) 
herkko11: posts small blind $0.10
jvds114: posts big blind $0.25
*** HOLE CARDS ***
Dealt to chiyuki [7c 8c]
KrystalAA: folds 
Rilko1975: folds 
1Karina1: folds 
Nerkit: folds 
Femali54: folds 
chiyuki: folds 
DrunkTyphoon: raises $0.50 to $0.75
herkko11: folds 
jvds114: raises $1.75 to $2.50
DrunkTyphoon: calls $1.75
*** FLOP *** [Qd Ad 6h]
jvds114: checks 
DrunkTyphoon: bets $3.26
jvds114: calls $3.26
*** TURN *** [Qd Ad 6h] [6s]
jvds114: checks 
DrunkTyphoon: checks 
*** RIVER *** [Qd Ad 6h 6s] [8s]
jvds114: bets $2
DrunkTyphoon: raises $2 to $4
jvds114: raises $2.75 to $6.75
DrunkTyphoon: calls $2.75
*** SHOW DOWN ***
jvds114: shows [6c 9h] (three of a kind, Sixes)
DrunkTyphoon: mucks hand 
jvds114 collected $23.99 from pot
*** SUMMARY ***
Total pot $25.12 | Rake $1.13 
Board [Qd Ad 6h 6s 8s]
Seat 1: DrunkTyphoon (button) mucked [Qs Ac]
Seat 2: herkko11 (small blind) folded before Flop
Seat 3: jvds114 (big blind) showed [6c 9h] and won ($23.99) with three of a kind, Sixes
Seat 4: KrystalAA folded before Flop (didn't bet)
Seat 5: Rilko1975 folded before Flop (didn't bet)
Seat 6: 1Karina1 folded before Flop (didn't bet)
Seat 7: Nerkit folded before Flop (didn't bet)
Seat 8: Femali54 folded before Flop (didn't bet)
Seat 9: chiyuki folded before Flop (didn't bet)



PokerStars Zoom Hand #84300742109:  Hold'em No Limit ($0.10/$0.25) - 2012/08/05 15:48:10 JST [2012/08/05 2:48:10 ET]
Table 'Whirlpool' 9-max Seat #1 is the button
Seat 1: Perstenev ($12.18 in chips) 
Seat 2: 1Karina1 ($43.59 in chips) 
Seat 3: PPP7SSS ($18.83 in chips) 
Seat 4: Rilko1975 ($26.47 in chips) 
Seat 5: Grishukps ($13.40 in chips) 
Seat 6: Trip_Krowns ($26.36 in chips) 
Seat 7: chiyuki ($38.34 in chips) 
Seat 8: rey2040 ($23.62 in chips) 
Seat 9: Serge Claws ($30.33 in chips) 
1Karina1: posts small blind $0.10
PPP7SSS: posts big blind $0.25
*** HOLE CARDS ***
Dealt to chiyuki [Ts 5c]
Rilko1975: folds 
Grishukps: folds 
Trip_Krowns: folds 
chiyuki: folds 
rey2040: folds 
Serge Claws: raises $0.50 to $0.75
Perstenev: folds 
1Karina1: raises $1.50 to $2.25
PPP7SSS: folds 
Serge Claws: folds 
Uncalled bet ($1.50) returned to 1Karina1
1Karina1 collected $1.75 from pot
1Karina1: doesn't show hand 
*** SUMMARY ***
Total pot $1.75 | Rake $0 
Seat 1: Perstenev (button) folded before Flop (didn't bet)
Seat 2: 1Karina1 (small blind) collected ($1.75)
Seat 3: PPP7SSS (big blind) folded before Flop
Seat 4: Rilko1975 folded before Flop (didn't bet)
Seat 5: Grishukps folded before Flop (didn't bet)
Seat 6: Trip_Krowns folded before Flop (didn't bet)
Seat 7: chiyuki folded before Flop (didn't bet)
Seat 8: rey2040 folded before Flop (didn't bet)
Seat 9: Serge Claws folded before Flop



PokerStars Zoom Hand #84300745699:  Hold'em No Limit ($0.10/$0.25) - 2012/08/05 15:48:24 JST [2012/08/05 2:48:24 ET]
Table 'Whirlpool' 9-max Seat #1 is the button
Seat 1: PPP7SSS ($18.58 in chips) 
Seat 2: chiyuki ($38.34 in chips) 
Seat 3: snejokCoxx ($12.24 in chips) 
Seat 4: Dan Royal ($26.22 in chips) 
Seat 5: Rici47 ($38.91 in chips) 
Seat 6: Perstenev ($7.18 in chips) 
Seat 7: seula i ($26.91 in chips) 
Seat 8: Saruotiss ($65.21 in chips) 
Seat 9: macmauret ($4.67 in chips) 
chiyuki: posts small blind $0.10
snejokCoxx: posts big blind $0.25
*** HOLE CARDS ***
Dealt to chiyuki [4c 8d]
Dan Royal: folds 
Rici47: folds 
Perstenev: folds 
seula i: folds 
Saruotiss: folds 
macmauret: raises $0.50 to $0.75
PPP7SSS: folds 
chiyuki: folds 
snejokCoxx: folds 
Uncalled bet ($0.50) returned to macmauret
macmauret collected $0.60 from pot
macmauret: doesn't show hand 
*** SUMMARY ***
Total pot $0.60 | Rake $0 
Seat 1: PPP7SSS (button) folded before Flop (didn't bet)
Seat 2: chiyuki (small blind) folded before Flop
Seat 3: snejokCoxx (big blind) folded before Flop
Seat 4: Dan Royal folded before Flop (didn't bet)
Seat 5: Rici47 folded before Flop (didn't bet)
Seat 6: Perstenev folded before Flop (didn't bet)
Seat 7: seula i folded before Flop (didn't bet)
Seat 8: Saruotiss folded before Flop (didn't bet)
Seat 9: macmauret collected ($0.60)



PokerStars Zoom Hand #84300747522:  Hold'em No Limit ($0.10/$0.25) - 2012/08/05 15:48:31 JST [2012/08/05 2:48:31 ET]
Table 'Whirlpool' 9-max Seat #1 is the button
Seat 1: chiyuki ($38.24 in chips) 
Seat 2: Saruotiss ($65.21 in chips) 
Seat 3: kwkim73 ($25 in chips) 
Seat 4: Limoilou ($32.50 in chips) 
Seat 5: TorTrade ($26.39 in chips) 
Seat 6: nice.franki ($12.15 in chips) 
Seat 7: Nerkit ($12.50 in chips) 
Seat 8: phate-1up ($63.92 in chips) 
Seat 9: Serge Claws ($39.58 in chips) 
Saruotiss: posts small blind $0.10
kwkim73: posts big blind $0.25
*** HOLE CARDS ***
Dealt to chiyuki [2c Kd]
Limoilou: folds 
TorTrade: folds 
nice.franki: folds 
Nerkit: folds 
phate-1up: folds 
Serge Claws: folds 
chiyuki: folds 
Saruotiss: raises $0.25 to $0.50
kwkim73: calls $0.25
*** FLOP *** [8h Js 9c]
Saruotiss: bets $0.25
kwkim73: folds 
Uncalled bet ($0.25) returned to Saruotiss
Saruotiss collected $0.96 from pot
Saruotiss: doesn't show hand 
*** SUMMARY ***
Total pot $1 | Rake $0.04 
Board [8h Js 9c]
Seat 1: chiyuki (button) folded before Flop (didn't bet)
Seat 2: Saruotiss (small blind) collected ($0.96)
Seat 3: kwkim73 (big blind) folded on the Flop
Seat 4: Limoilou folded before Flop (didn't bet)
Seat 5: TorTrade folded before Flop (didn't bet)
Seat 6: nice.franki folded before Flop (didn't bet)
Seat 7: Nerkit folded before Flop (didn't bet)
Seat 8: phate-1up folded before Flop (didn't bet)
Seat 9: Serge Claws folded before Flop (didn't bet)



PokerStars Zoom Hand #84300758556:  Hold'em No Limit ($0.10/$0.25) - 2012/08/05 15:49:14 JST [2012/08/05 2:49:14 ET]
Table 'Whirlpool' 9-max Seat #1 is the button
Seat 1: silvno31 ($66.35 in chips) 
Seat 2: Serge Claws ($39.33 in chips) 
Seat 3: macmauret ($4.92 in chips) 
Seat 4: chiyuki ($37.49 in chips) 
Seat 5: nice.franki ($10.55 in chips) 
Seat 6: DutchShultzs ($35.53 in chips) 
Seat 7: Fructionar ($35.99 in chips) 
Seat 8: SAILUSI ($24.65 in chips) 
Seat 9: KeLevro0 ($13.60 in chips) 
Serge Claws: posts small blind $0.10
macmauret: posts big blind $0.25
*** HOLE CARDS ***
Dealt to chiyuki [3d Jc]
chiyuki: folds 
nice.franki: folds 
DutchShultzs: folds 
Fructionar: folds 
SAILUSI: folds 
KeLevro0: folds 
silvno31: folds 
Serge Claws: folds 
Uncalled bet ($0.15) returned to macmauret
macmauret collected $0.20 from pot
macmauret: doesn't show hand 
*** SUMMARY ***
Total pot $0.20 | Rake $0 
Seat 1: silvno31 (button) folded before Flop (didn't bet)
Seat 2: Serge Claws (small blind) folded before Flop
Seat 3: macmauret (big blind) collected ($0.20)
Seat 4: chiyuki folded before Flop (didn't bet)
Seat 5: nice.franki folded before Flop (didn't bet)
Seat 6: DutchShultzs folded before Flop (didn't bet)
Seat 7: Fructionar folded before Flop (didn't bet)
Seat 8: SAILUSI folded before Flop (didn't bet)
Seat 9: KeLevro0 folded before Flop (didn't bet)



PokerStars Zoom Hand #84300748309:  Hold'em No Limit ($0.10/$0.25) - 2012/08/05 15:48:34 JST [2012/08/05 2:48:34 ET]
Table 'Whirlpool' 9-max Seat #1 is the button
Seat 1: NENE54 ($16.95 in chips) 
Seat 2: Faantomace ($31.08 in chips) 
Seat 3: Serge Claws ($29.58 in chips) 
Seat 4: laurentzu84 ($46.29 in chips) 
Seat 5: nastya040 ($18.81 in chips) 
Seat 6: GovGus ($49.08 in chips) 
Seat 7: KeLevro0 ($12.28 in chips) 
Seat 8: chiyuki ($38.24 in chips) 
Seat 9: opie62 ($24.05 in chips) 
Faantomace: posts small blind $0.10
Serge Claws: posts big blind $0.25
*** HOLE CARDS ***
Dealt to chiyuki [3h 3d]
laurentzu84: folds 
nastya040: raises $0.25 to $0.50
GovGus: folds 
KeLevro0: folds 
chiyuki: calls $0.50
opie62: folds 
NENE54: folds 
Faantomace: folds 
Serge Claws: calls $0.25
*** FLOP *** [8s Ts Ac]
Serge Claws: checks 
nastya040: bets $0.25
chiyuki: calls $0.25
Serge Claws: raises $0.75 to $1
nastya040: calls $0.75
chiyuki: folds 
*** TURN *** [8s Ts Ac] [7d]
Serge Claws: checks 
nastya040: checks 
*** RIVER *** [8s Ts Ac 7d] [4d]
Serge Claws: checks 
nastya040: checks 
*** SHOW DOWN ***
Serge Claws: shows [5h As] (a pair of Aces)
nastya040: shows [Js Ad] (a pair of Aces - Jack kicker)
nastya040 collected $3.68 from pot
*** SUMMARY ***
Total pot $3.85 | Rake $0.17 
Board [8s Ts Ac 7d 4d]
Seat 1: NENE54 (button) folded before Flop (didn't bet)
Seat 2: Faantomace (small blind) folded before Flop
Seat 3: Serge Claws (big blind) showed [5h As] and lost with a pair of Aces
Seat 4: laurentzu84 folded before Flop (didn't bet)
Seat 5: nastya040 showed [Js Ad] and won ($3.68) with a pair of Aces
Seat 6: GovGus folded before Flop (didn't bet)
Seat 7: KeLevro0 folded before Flop (didn't bet)
Seat 8: chiyuki folded on the Flop
Seat 9: opie62 folded before Flop (didn't bet)



PokerStars Zoom Hand #84300743941:  Hold'em No Limit ($0.10/$0.25) - 2012/08/05 15:48:17 JST [2012/08/05 2:48:17 ET]
Table 'Whirlpool' 9-max Seat #1 is the button
Seat 1: DutchShultzs ($35.63 in chips) 
Seat 2: kamikkaze ($18.95 in chips) 
Seat 3: INSP!RON ($40.19 in chips) 
Seat 4: hldtom ($13.61 in chips) 
Seat 5: Alvinpe85 ($46.27 in chips) 
Seat 6: chiyuki ($38.34 in chips) 
Seat 7: Rilko1975 ($24.90 in chips) 
Seat 8: nice.franki ($12.15 in chips) 
Seat 9: Fructionar ($35.54 in chips) 
kamikkaze: posts small blind $0.10
INSP!RON: posts big blind $0.25
*** HOLE CARDS ***
Dealt to chiyuki [Qc Jh]
hldtom: raises $0.50 to $0.75
Alvinpe85: folds 
chiyuki: folds 
Rilko1975: folds 
nice.franki: folds 
Fructionar: folds 
DutchShultzs: folds 
kamikkaze: calls $0.65
INSP!RON: folds 
*** FLOP *** [Ad 2h 8s]
kamikkaze: checks 
hldtom: checks 
*** TURN *** [Ad 2h 8s] [3h]
kamikkaze: bets $0.61
hldtom: calls $0.61
*** RIVER *** [Ad 2h 8s 3h] [Ac]
kamikkaze: checks 
hldtom: bets $1.42
kamikkaze: calls $1.42
*** SHOW DOWN ***
hldtom: shows [Qh 9h] (a pair of Aces)
kamikkaze: shows [7h 7c] (two pair, Aces and Sevens)
kamikkaze collected $5.55 from pot
*** SUMMARY ***
Total pot $5.81 | Rake $0.26 
Board [Ad 2h 8s 3h Ac]
Seat 1: DutchShultzs (button) folded before Flop (didn't bet)
Seat 2: kamikkaze (small blind) showed [7h 7c] and won ($5.55) with two pair, Aces and Sevens
Seat 3: INSP!RON (big blind) folded before Flop
Seat 4: hldtom showed [Qh 9h] and lost with a pair of Aces
Seat 5: Alvinpe85 folded before Flop (didn't bet)
Seat 6: chiyuki folded before Flop (didn't bet)
Seat 7: Rilko1975 folded before Flop (didn't bet)
Seat 8: nice.franki folded before Flop (didn't bet)
Seat 9: Fructionar folded before Flop (didn't bet)



PokerStars Zoom Hand #84300761987:  Hold'em No Limit ($0.10/$0.25) - 2012/08/05 15:49:27 JST [2012/08/05 2:49:27 ET]
Table 'Whirlpool' 9-max Seat #1 is the button
Seat 1: AAAKK777 ($12.84 in chips) 
Seat 2: 1Karina1 ($25 in chips) 
Seat 3: chiyuki ($37.39 in chips) 
Seat 4: nastya040 ($20.99 in chips) 
Seat 5: Femali54 ($26.24 in chips) 
Seat 6: Limoilou ($33.17 in chips) 
Seat 7: kesstukas25 ($12.90 in chips) 
Seat 8: pandaaaaaa ($15.90 in chips) 
Seat 9: xxx Spb xxx ($26.30 in chips) 
1Karina1: posts small blind $0.10
chiyuki: posts big blind $0.25
*** HOLE CARDS ***
Dealt to chiyuki [Ah Qh]
nastya040: folds 
Femali54: folds 
Limoilou: folds 
kesstukas25: folds 
pandaaaaaa: folds 
xxx Spb xxx: folds 
AAAKK777: folds 
1Karina1: folds 
Uncalled bet ($0.15) returned to chiyuki
chiyuki collected $0.20 from pot
chiyuki: doesn't show hand 
*** SUMMARY ***
Total pot $0.20 | Rake $0 
Seat 1: AAAKK777 (button) folded before Flop (didn't bet)
Seat 2: 1Karina1 (small blind) folded before Flop
Seat 3: chiyuki (big blind) collected ($0.20)
Seat 4: nastya040 folded before Flop (didn't bet)
Seat 5: Femali54 folded before Flop (didn't bet)
Seat 6: Limoilou folded before Flop (didn't bet)
Seat 7: kesstukas25 folded before Flop (didn't bet)
Seat 8: pandaaaaaa folded before Flop (didn't bet)
Seat 9: xxx Spb xxx folded before Flop (didn't bet)



PokerStars Zoom Hand #84300759852:  Hold'em No Limit ($0.10/$0.25) - 2012/08/05 15:49:19 JST [2012/08/05 2:49:19 ET]
Table 'Whirlpool' 9-max Seat #1 is the button
Seat 1: KrystalAA ($36.92 in chips) 
Seat 2: chiyuki ($37.49 in chips) 
Seat 3: silvno31 ($66.35 in chips) 
Seat 4: nice.franki ($12.15 in chips) 
Seat 5: jacquelinewu ($66.38 in chips) 
Seat 6: kwkim73 ($32.52 in chips) 
Seat 7: AntoineHunt ($33.01 in chips) 
Seat 8: yvasilik ($25.65 in chips) 
Seat 9: God)Squall ($27.72 in chips) 
chiyuki: posts small blind $0.10
silvno31: posts big blind $0.25
*** HOLE CARDS ***
Dealt to chiyuki [Tc 9h]
nice.franki: folds 
jacquelinewu: folds 
kwkim73: folds 
AntoineHunt: raises $0.50 to $0.75
yvasilik: folds 
God)Squall: folds 
KrystalAA: calls $0.75
chiyuki: folds 
silvno31: folds 
*** FLOP *** [Qh Ac Jh]
AntoineHunt: bets $0.75
KrystalAA: calls $0.75
*** TURN *** [Qh Ac Jh] [9c]
AntoineHunt: bets $2.25
KrystalAA: folds 
Uncalled bet ($2.25) returned to AntoineHunt
AntoineHunt collected $3.20 from pot
AntoineHunt: doesn't show hand 
*** SUMMARY ***
Total pot $3.35 | Rake $0.15 
Board [Qh Ac Jh 9c]
Seat 1: KrystalAA (button) folded on the Turn
Seat 2: chiyuki (small blind) folded before Flop
Seat 3: silvno31 (big blind) folded before Flop
Seat 4: nice.franki folded before Flop (didn't bet)
Seat 5: jacquelinewu folded before Flop (didn't bet)
Seat 6: kwkim73 folded before Flop (didn't bet)
Seat 7: AntoineHunt collected ($3.20)
Seat 8: yvasilik folded before Flop (didn't bet)
Seat 9: God)Squall folded before Flop (didn't bet)



PokerStars Zoom Hand #84300768157:  Hold'em No Limit ($0.10/$0.25) - 2012/08/05 15:49:51 JST [2012/08/05 2:49:51 ET]
Table 'Whirlpool' 9-max Seat #1 is the button
Seat 1: SAILUSI ($24.40 in chips) 
Seat 2: rey2040 ($19.75 in chips) 
Seat 3: Silveystryk ($47.43 in chips) 
Seat 4: tribunpdm ($93.23 in chips) 
Seat 5: phate-1up ($63.05 in chips) 
Seat 6: Grishukps ($12.50 in chips) 
Seat 7: Kasperlmusik ($26.63 in chips) 
Seat 8: jacquelinewu ($66.13 in chips) 
Seat 9: chiyuki ($37.49 in chips) 
rey2040: posts small blind $0.10
Silveystryk: posts big blind $0.25
*** HOLE CARDS ***
Dealt to chiyuki [Tc Ah]
tribunpdm: raises $0.50 to $0.75
phate-1up: folds 
Grishukps: folds 
Kasperlmusik: folds 
jacquelinewu: folds 
chiyuki: folds 
SAILUSI: folds 
rey2040: folds 
Silveystryk: folds 
Uncalled bet ($0.50) returned to tribunpdm
tribunpdm collected $0.60 from pot
tribunpdm: doesn't show hand 
*** SUMMARY ***
Total pot $0.60 | Rake $0 
Seat 1: SAILUSI (button) folded before Flop (didn't bet)
Seat 2: rey2040 (small blind) folded before Flop
Seat 3: Silveystryk (big blind) folded before Flop
Seat 4: tribunpdm collected ($0.60)
Seat 5: phate-1up folded before Flop (didn't bet)
Seat 6: Grishukps folded before Flop (didn't bet)
Seat 7: Kasperlmusik folded before Flop (didn't bet)
Seat 8: jacquelinewu folded before Flop (didn't bet)
Seat 9: chiyuki folded before Flop (didn't bet)



PokerStars Zoom Hand #84300770489:  Hold'em No Limit ($0.10/$0.25) - 2012/08/05 15:50:01 JST [2012/08/05 2:50:01 ET]
Table 'Whirlpool' 9-max Seat #1 is the button
Seat 1: Dan Royal ($25.12 in chips) 
Seat 2: Rilko1975 ($23.97 in chips) 
Seat 3: ShockLaMuc ($25 in chips) 
Seat 4: WARIBANA7777 ($16.82 in chips) 
Seat 5: snejokCoxx ($11.89 in chips) 
Seat 6: chiyuki ($37.49 in chips) 
Seat 7: pandaaaaaa ($15.65 in chips) 
Seat 8: Serge Claws ($28.33 in chips) 
Seat 9: rey2040 ($19.65 in chips) 
Rilko1975: posts small blind $0.10
ShockLaMuc: posts big blind $0.25
*** HOLE CARDS ***
Dealt to chiyuki [Ts Jd]
WARIBANA7777: folds 
snejokCoxx: folds 
chiyuki: folds 
pandaaaaaa: folds 
Serge Claws: folds 
rey2040: folds 
Dan Royal: folds 
Rilko1975: calls $0.15
ShockLaMuc: checks 
*** FLOP *** [Ah 9c 4h]
Rilko1975: checks 
ShockLaMuc: bets $0.33
Rilko1975: folds 
Uncalled bet ($0.33) returned to ShockLaMuc
ShockLaMuc collected $0.48 from pot
ShockLaMuc: doesn't show hand 
*** SUMMARY ***
Total pot $0.50 | Rake $0.02 
Board [Ah 9c 4h]
Seat 1: Dan Royal (button) folded before Flop (didn't bet)
Seat 2: Rilko1975 (small blind) folded on the Flop
Seat 3: ShockLaMuc (big blind) collected ($0.48)
Seat 4: WARIBANA7777 folded before Flop (didn't bet)
Seat 5: snejokCoxx folded before Flop (didn't bet)
Seat 6: chiyuki folded before Flop (didn't bet)
Seat 7: pandaaaaaa folded before Flop (didn't bet)
Seat 8: Serge Claws folded before Flop (didn't bet)
Seat 9: rey2040 folded before Flop (didn't bet)



PokerStars Zoom Hand #84300771770:  Hold'em No Limit ($0.10/$0.25) - 2012/08/05 15:50:06 JST [2012/08/05 2:50:06 ET]
Table 'Whirlpool' 9-max Seat #1 is the button
Seat 1: chiyuki ($37.49 in chips) 
Seat 2: snejokCoxx ($12.35 in chips) 
Seat 3: mjmichi ($38.86 in chips) 
Seat 4: DrunkTyphoon ($30.47 in chips) 
Seat 5: mr_pugsley69 ($18.40 in chips) 
Seat 6: Kasperlmusik ($36.05 in chips) 
Seat 7: phate-1up ($43.63 in chips) 
Seat 8: Faantomace ($33.13 in chips) 
Seat 9: SAILUSI ($24.30 in chips) 
snejokCoxx: posts small blind $0.10
mjmichi: posts big blind $0.25
*** HOLE CARDS ***
Dealt to chiyuki [5h 8d]
DrunkTyphoon: folds 
mr_pugsley69: folds 
Kasperlmusik: folds 
phate-1up: raises $0.50 to $0.75
Faantomace: folds 
SAILUSI: folds 
chiyuki: folds 
snejokCoxx: folds 
mjmichi: folds 
Uncalled bet ($0.50) returned to phate-1up
phate-1up collected $0.60 from pot
phate-1up: doesn't show hand 
*** SUMMARY ***
Total pot $0.60 | Rake $0 
Seat 1: chiyuki (button) folded before Flop (didn't bet)
Seat 2: snejokCoxx (small blind) folded before Flop
Seat 3: mjmichi (big blind) folded before Flop
Seat 4: DrunkTyphoon folded before Flop (didn't bet)
Seat 5: mr_pugsley69 folded before Flop (didn't bet)
Seat 6: Kasperlmusik folded before Flop (didn't bet)
Seat 7: phate-1up collected ($0.60)
Seat 8: Faantomace folded before Flop (didn't bet)
Seat 9: SAILUSI folded before Flop (didn't bet)



PokerStars Zoom Hand #84300776165:  Hold'em No Limit ($0.10/$0.25) - 2012/08/05 15:50:23 JST [2012/08/05 2:50:23 ET]
Table 'Whirlpool' 9-max Seat #1 is the button
Seat 1: kesstukas25 ($18.93 in chips) 
Seat 2: kwkim73 ($25 in chips) 
Seat 3: MurMurRu ($25 in chips) 
Seat 4: yvasilik ($25.30 in chips) 
Seat 5: Afcawins25 ($16.28 in chips) 
Seat 6: nice.franki ($11.80 in chips) 
Seat 7: chiyuki ($37.49 in chips) 
Seat 8: 1Karina1 ($25.10 in chips) 
Seat 9: WARIBANA7777 ($16.72 in chips) 
kwkim73: posts small blind $0.10
MurMurRu: posts big blind $0.25
*** HOLE CARDS ***
Dealt to chiyuki [8c Qc]
yvasilik: folds 
Afcawins25: folds 
nice.franki: folds 
chiyuki: folds 
1Karina1: folds 
WARIBANA7777: folds 
kesstukas25: raises $0.50 to $0.75
kwkim73: folds 
MurMurRu: raises $1.60 to $2.35
kesstukas25: folds 
Uncalled bet ($1.60) returned to MurMurRu
MurMurRu collected $1.60 from pot
MurMurRu: doesn't show hand 
*** SUMMARY ***
Total pot $1.60 | Rake $0 
Seat 1: kesstukas25 (button) folded before Flop
Seat 2: kwkim73 (small blind) folded before Flop
Seat 3: MurMurRu (big blind) collected ($1.60)
Seat 4: yvasilik folded before Flop (didn't bet)
Seat 5: Afcawins25 folded before Flop (didn't bet)
Seat 6: nice.franki folded before Flop (didn't bet)
Seat 7: chiyuki folded before Flop (didn't bet)
Seat 8: 1Karina1 folded before Flop (didn't bet)
Seat 9: WARIBANA7777 folded before Flop (didn't bet)



PokerStars Zoom Hand #84300775147:  Hold'em No Limit ($0.10/$0.25) - 2012/08/05 15:50:19 JST [2012/08/05 2:50:19 ET]
Table 'Whirlpool' 9-max Seat #1 is the button
Seat 1: phate-1up ($52.77 in chips) 
Seat 2: slapshot2011 ($24.21 in chips) 
Seat 3: snejokCoxx ($12.25 in chips) 
Seat 4: pawn909 ($24.83 in chips) 
Seat 5: chiyuki ($37.49 in chips) 
Seat 6: Grishukps ($12.50 in chips) 
Seat 7: Afcawins25 ($16.28 in chips) 
Seat 8: nice.franki ($6.55 in chips) 
Seat 9: Faantomace ($33.13 in chips) 
slapshot2011: posts small blind $0.10
snejokCoxx: posts big blind $0.25
*** HOLE CARDS ***
Dealt to chiyuki [3c Ts]
pawn909: folds 
chiyuki: folds 
Grishukps: folds 
Afcawins25: folds 
nice.franki: folds 
Faantomace: raises $0.50 to $0.75
phate-1up: folds 
slapshot2011: calls $0.65
snejokCoxx: folds 
*** FLOP *** [3h 7c 5h]
slapshot2011: checks 
Faantomace: bets $1.25
slapshot2011: folds 
Uncalled bet ($1.25) returned to Faantomace
Faantomace collected $1.67 from pot
Faantomace: doesn't show hand 
*** SUMMARY ***
Total pot $1.75 | Rake $0.08 
Board [3h 7c 5h]
Seat 1: phate-1up (button) folded before Flop (didn't bet)
Seat 2: slapshot2011 (small blind) folded on the Flop
Seat 3: snejokCoxx (big blind) folded before Flop
Seat 4: pawn909 folded before Flop (didn't bet)
Seat 5: chiyuki folded before Flop (didn't bet)
Seat 6: Grishukps folded before Flop (didn't bet)
Seat 7: Afcawins25 folded before Flop (didn't bet)
Seat 8: nice.franki folded before Flop (didn't bet)
Seat 9: Faantomace collected ($1.67)



PokerStars Zoom Hand #84300782073:  Hold'em No Limit ($0.10/$0.25) - 2012/08/05 15:50:46 JST [2012/08/05 2:50:46 ET]
Table 'Whirlpool' 9-max Seat #1 is the button
Seat 1: crazycrown1 ($14.46 in chips) 
Seat 2: Grishukps ($12.50 in chips) 
Seat 3: chiyuki ($37.49 in chips) 
Seat 4: Serge Claws ($28.08 in chips) 
Seat 5: Rilko1975 ($23.72 in chips) 
Seat 6: KeLevro0 ($11.48 in chips) 
Seat 7: yvasilik ($25.05 in chips) 
Seat 8: Fructionar ($37.47 in chips) 
Seat 9: NENE54 ($13.60 in chips) 
Grishukps: posts small blind $0.10
chiyuki: posts big blind $0.25
*** HOLE CARDS ***
Dealt to chiyuki [Qd Kh]
Serge Claws: folds 
Rilko1975: folds 
KeLevro0: folds 
yvasilik: folds 
Fructionar: folds 
NENE54: folds 
crazycrown1: folds 
Grishukps: folds 
Uncalled bet ($0.15) returned to chiyuki
chiyuki collected $0.20 from pot
chiyuki: doesn't show hand 
*** SUMMARY ***
Total pot $0.20 | Rake $0 
Seat 1: crazycrown1 (button) folded before Flop (didn't bet)
Seat 2: Grishukps (small blind) folded before Flop
Seat 3: chiyuki (big blind) collected ($0.20)
Seat 4: Serge Claws folded before Flop (didn't bet)
Seat 5: Rilko1975 folded before Flop (didn't bet)
Seat 6: KeLevro0 folded before Flop (didn't bet)
Seat 7: yvasilik folded before Flop (didn't bet)
Seat 8: Fructionar folded before Flop (didn't bet)
Seat 9: NENE54 folded before Flop (didn't bet)



PokerStars Zoom Hand #84300777258:  Hold'em No Limit ($0.10/$0.25) - 2012/08/05 15:50:27 JST [2012/08/05 2:50:27 ET]
Table 'Whirlpool' 9-max Seat #1 is the button
Seat 1: Kasperlmusik ($26.28 in chips) 
Seat 2: 1Karina1 ($37.02 in chips) 
Seat 3: yvasilik ($25.30 in chips) 
Seat 4: God)Squall ($27.72 in chips) 
Seat 5: nice.franki ($11.80 in chips) 
Seat 6: snejokCoxx ($10.75 in chips) 
Seat 7: WARIBANA7777 ($16.72 in chips) 
Seat 8: KrystalAA ($26.44 in chips) 
Seat 9: chiyuki ($37.49 in chips) 
1Karina1: posts small blind $0.10
yvasilik: posts big blind $0.25
*** HOLE CARDS ***
Dealt to chiyuki [8h Jc]
God)Squall: raises $0.50 to $0.75
nice.franki: folds 
snejokCoxx: folds 
WARIBANA7777: folds 
KrystalAA: folds 
chiyuki: folds 
Kasperlmusik: calls $0.75
1Karina1: folds 
yvasilik: folds 
*** FLOP *** [Qc 4c 7h]
God)Squall: checks 
Kasperlmusik: checks 
*** TURN *** [Qc 4c 7h] [3h]
God)Squall: checks 
Kasperlmusik: checks 
*** RIVER *** [Qc 4c 7h 3h] [4h]
God)Squall: checks 
Kasperlmusik: checks 
*** SHOW DOWN ***
God)Squall: shows [9s As] (a pair of Fours)
Kasperlmusik: mucks hand 
God)Squall collected $1.77 from pot
*** SUMMARY ***
Total pot $1.85 | Rake $0.08 
Board [Qc 4c 7h 3h 4h]
Seat 1: Kasperlmusik (button) mucked [Jd Td]
Seat 2: 1Karina1 (small blind) folded before Flop
Seat 3: yvasilik (big blind) folded before Flop
Seat 4: God)Squall showed [9s As] and won ($1.77) with a pair of Fours
Seat 5: nice.franki folded before Flop (didn't bet)
Seat 6: snejokCoxx folded before Flop (didn't bet)
Seat 7: WARIBANA7777 folded before Flop (didn't bet)
Seat 8: KrystalAA folded before Flop (didn't bet)
Seat 9: chiyuki folded before Flop (didn't bet)



PokerStars Zoom Hand #84300784920:  Hold'em No Limit ($0.10/$0.25) - 2012/08/05 15:50:57 JST [2012/08/05 2:50:57 ET]
Table 'Whirlpool' 9-max Seat #1 is the button
Seat 1: HighDuka ($32.86 in chips) 
Seat 2: Lasutchik ($10.92 in chips) 
Seat 3: KeLevro0 ($11.76 in chips) 
Seat 4: phate-1up ($52.77 in chips) 
Seat 5: kesstukas25 ($18.08 in chips) 
Seat 6: chiyuki ($37.59 in chips) 
Seat 7: Kasperlmusik ($35.70 in chips) 
Seat 8: River_GmbH ($15.77 in chips) 
Seat 9: ViTiV2010 ($11.90 in chips) 
Lasutchik: posts small blind $0.10
KeLevro0: posts big blind $0.25
*** HOLE CARDS ***
Dealt to chiyuki [5s Tc]
phate-1up: folds 
kesstukas25: folds 
chiyuki: folds 
Kasperlmusik: folds 
River_GmbH: folds 
ViTiV2010: folds 
HighDuka: raises $0.50 to $0.75
Lasutchik: folds 
KeLevro0: folds 
Uncalled bet ($0.50) returned to HighDuka
HighDuka collected $0.60 from pot
HighDuka: doesn't show hand 
*** SUMMARY ***
Total pot $0.60 | Rake $0 
Seat 1: HighDuka (button) collected ($0.60)
Seat 2: Lasutchik (small blind) folded before Flop
Seat 3: KeLevro0 (big blind) folded before Flop
Seat 4: phate-1up folded before Flop (didn't bet)
Seat 5: kesstukas25 folded before Flop (didn't bet)
Seat 6: chiyuki folded before Flop (didn't bet)
Seat 7: Kasperlmusik folded before Flop (didn't bet)
Seat 8: River_GmbH folded before Flop (didn't bet)
Seat 9: ViTiV2010 folded before Flop (didn't bet)



PokerStars Zoom Hand #84300780052:  Hold'em No Limit ($0.10/$0.25) - 2012/08/05 15:50:38 JST [2012/08/05 2:50:38 ET]
Table 'Whirlpool' 9-max Seat #1 is the button
Seat 1: herkko11 ($9.03 in chips) 
Seat 2: phate-1up ($43.98 in chips) 
Seat 3: INSP!RON ($35.76 in chips) 
Seat 4: hldtom ($27.14 in chips) 
Seat 5: Rilko1975 ($24.90 in chips) 
Seat 6: jacquelinewu ($27.62 in chips) 
Seat 7: rey2040 ($18.40 in chips) 
Seat 8: chiyuki ($37.49 in chips) 
Seat 9: leo2095 ($26.77 in chips) 
phate-1up: posts small blind $0.10
INSP!RON: posts big blind $0.25
*** HOLE CARDS ***
Dealt to chiyuki [5d Td]
hldtom: folds 
Rilko1975: folds 
jacquelinewu: folds 
rey2040: raises $0.50 to $0.75
chiyuki: folds 
leo2095: folds 
herkko11: folds 
phate-1up: calls $0.65
INSP!RON: folds 
*** FLOP *** [6c 9c 3s]
phate-1up: checks 
rey2040: checks 
*** TURN *** [6c 9c 3s] [Ah]
phate-1up: checks 
rey2040: bets $0.75
phate-1up: calls $0.75
*** RIVER *** [6c 9c 3s Ah] [2c]
phate-1up: bets $1.50
rey2040: calls $1.50
*** SHOW DOWN ***
phate-1up: shows [Jh Ac] (a pair of Aces)
rey2040: mucks hand 
phate-1up collected $5.97 from pot
*** SUMMARY ***
Total pot $6.25 | Rake $0.28 
Board [6c 9c 3s Ah 2c]
Seat 1: herkko11 (button) folded before Flop (didn't bet)
Seat 2: phate-1up (small blind) showed [Jh Ac] and won ($5.97) with a pair of Aces
Seat 3: INSP!RON (big blind) folded before Flop
Seat 4: hldtom folded before Flop (didn't bet)
Seat 5: Rilko1975 folded before Flop (didn't bet)
Seat 6: jacquelinewu folded before Flop (didn't bet)
Seat 7: rey2040 mucked [As 8d]
Seat 8: chiyuki folded before Flop (didn't bet)
Seat 9: leo2095 folded before Flop (didn't bet)



PokerStars Zoom Hand #84300787251:  Hold'em No Limit ($0.10/$0.25) - 2012/08/05 15:51:07 JST [2012/08/05 2:51:07 ET]
Table 'Whirlpool' 9-max Seat #1 is the button
Seat 1: KrystalAA ($13.57 in chips) 
Seat 2: MurMurRu ($25 in chips) 
Seat 3: ShockLaMuc ($24.55 in chips) 
Seat 4: snejokCoxx ($12 in chips) 
Seat 5: chiyuki ($37.59 in chips) 
Seat 6: masterkoolb ($14 in chips) 
Seat 7: seula i ($30.22 in chips) 
Seat 8: PPP7SSS ($15.68 in chips) 
Seat 9: Ozboy80 ($25.19 in chips) 
MurMurRu: posts small blind $0.10
ShockLaMuc: posts big blind $0.25
*** HOLE CARDS ***
Dealt to chiyuki [5c 6h]
snejokCoxx: folds 
chiyuki: folds 
masterkoolb: folds 
seula i: folds 
PPP7SSS: raises $0.50 to $0.75
Ozboy80: folds 
KrystalAA: folds 
MurMurRu: folds 
ShockLaMuc: folds 
Uncalled bet ($0.50) returned to PPP7SSS
PPP7SSS collected $0.60 from pot
PPP7SSS: doesn't show hand 
*** SUMMARY ***
Total pot $0.60 | Rake $0 
Seat 1: KrystalAA (button) folded before Flop (didn't bet)
Seat 2: MurMurRu (small blind) folded before Flop
Seat 3: ShockLaMuc (big blind) folded before Flop
Seat 4: snejokCoxx folded before Flop (didn't bet)
Seat 5: chiyuki folded before Flop (didn't bet)
Seat 6: masterkoolb folded before Flop (didn't bet)
Seat 7: seula i folded before Flop (didn't bet)
Seat 8: PPP7SSS collected ($0.60)
Seat 9: Ozboy80 folded before Flop (didn't bet)



PokerStars Zoom Hand #84300794802:  Hold'em No Limit ($0.10/$0.25) - 2012/08/05 15:51:36 JST [2012/08/05 2:51:36 ET]
Table 'Whirlpool' 9-max Seat #1 is the button
Seat 1: KeLevro0 ($11.51 in chips) 
Seat 2: ChrisCDee ($58.87 in chips) 
Seat 3: Alvinpe85 ($44.80 in chips) 
Seat 4: kwkim73 ($27.14 in chips) 
Seat 5: GovGus ($53.48 in chips) 
Seat 6: Grishukps ($12.75 in chips) 
Seat 7: PPP7SSS ($16.03 in chips) 
Seat 8: chiyuki ($37.49 in chips) 
Seat 9: 4ydo yogurt ($43.21 in chips) 
ChrisCDee: posts small blind $0.10
Alvinpe85: posts big blind $0.25
*** HOLE CARDS ***
Dealt to chiyuki [Kd 8d]
kwkim73: folds 
GovGus: folds 
Grishukps: folds 
PPP7SSS: folds 
chiyuki: folds 
4ydo yogurt: folds 
KeLevro0: folds 
ChrisCDee: folds 
Uncalled bet ($0.15) returned to Alvinpe85
Alvinpe85 collected $0.20 from pot
Alvinpe85: doesn't show hand 
*** SUMMARY ***
Total pot $0.20 | Rake $0 
Seat 1: KeLevro0 (button) folded before Flop (didn't bet)
Seat 2: ChrisCDee (small blind) folded before Flop
Seat 3: Alvinpe85 (big blind) collected ($0.20)
Seat 4: kwkim73 folded before Flop (didn't bet)
Seat 5: GovGus folded before Flop (didn't bet)
Seat 6: Grishukps folded before Flop (didn't bet)
Seat 7: PPP7SSS folded before Flop (didn't bet)
Seat 8: chiyuki folded before Flop (didn't bet)
Seat 9: 4ydo yogurt folded before Flop (didn't bet)



PokerStars Zoom Hand #84300797324:  Hold'em No Limit ($0.10/$0.25) - 2012/08/05 15:51:46 JST [2012/08/05 2:51:46 ET]
Table 'Whirlpool' 9-max Seat #1 is the button
Seat 1: Silveystryk ($46.78 in chips) 
Seat 2: GovGus ($30.09 in chips) 
Seat 3: jacquelinewu ($31.58 in chips) 
Seat 4: drunk_bender ($11.36 in chips) 
Seat 5: Saruotiss ($64.92 in chips) 
Seat 6: Rilko1975 ($23.37 in chips) 
Seat 7: ViTiV2010 ($10.04 in chips) 
Seat 8: phate-1up ($42.33 in chips) 
Seat 9: chiyuki ($37.49 in chips) 
GovGus: posts small blind $0.10
jacquelinewu: posts big blind $0.25
*** HOLE CARDS ***
Dealt to chiyuki [As 4h]
drunk_bender: folds 
Saruotiss: folds 
Rilko1975: folds 
ViTiV2010: folds 
phate-1up: folds 
chiyuki: folds 
Silveystryk: folds 
GovGus: raises $0.50 to $0.75
jacquelinewu: folds 
Uncalled bet ($0.50) returned to GovGus
GovGus collected $0.50 from pot
GovGus: doesn't show hand 
*** SUMMARY ***
Total pot $0.50 | Rake $0 
Seat 1: Silveystryk (button) folded before Flop (didn't bet)
Seat 2: GovGus (small blind) collected ($0.50)
Seat 3: jacquelinewu (big blind) folded before Flop
Seat 4: drunk_bender folded before Flop (didn't bet)
Seat 5: Saruotiss folded before Flop (didn't bet)
Seat 6: Rilko1975 folded before Flop (didn't bet)
Seat 7: ViTiV2010 folded before Flop (didn't bet)
Seat 8: phate-1up folded before Flop (didn't bet)
Seat 9: chiyuki folded before Flop (didn't bet)



PokerStars Zoom Hand #84300791650:  Hold'em No Limit ($0.10/$0.25) - 2012/08/05 15:51:24 JST [2012/08/05 2:51:24 ET]
Table 'Whirlpool' 9-max Seat #1 is the button
Seat 1: yvasilik ($25.30 in chips) 
Seat 2: chiyuki ($37.59 in chips) 
Seat 3: phate-1up ($52.77 in chips) 
Seat 4: NENE54 ($13.10 in chips) 
Seat 5: Perstenev ($12.65 in chips) 
Seat 6: seula i ($30.22 in chips) 
Seat 7: MurMurRu ($25 in chips) 
Seat 8: slapshot2011 ($21.96 in chips) 
Seat 9: Jene4kaBest ($21.13 in chips) 
chiyuki: posts small blind $0.10
phate-1up: posts big blind $0.25
*** HOLE CARDS ***
Dealt to chiyuki [2c 3s]
NENE54: calls $0.25
Perstenev: folds 
seula i: folds 
MurMurRu: raises $0.60 to $0.85
slapshot2011: folds 
Jene4kaBest: calls $0.85
yvasilik: folds 
chiyuki: folds 
phate-1up: folds 
NENE54: calls $0.60
*** FLOP *** [2h 6c 2d]
NENE54: bets $1.25
MurMurRu: folds 
Jene4kaBest: calls $1.25
*** TURN *** [2h 6c 2d] [Js]
NENE54: bets $1.25
Jene4kaBest: folds 
Uncalled bet ($1.25) returned to NENE54
NENE54 collected $5.16 from pot
NENE54: doesn't show hand 
*** SUMMARY ***
Total pot $5.40 | Rake $0.24 
Board [2h 6c 2d Js]
Seat 1: yvasilik (button) folded before Flop (didn't bet)
Seat 2: chiyuki (small blind) folded before Flop
Seat 3: phate-1up (big blind) folded before Flop
Seat 4: NENE54 collected ($5.16)
Seat 5: Perstenev folded before Flop (didn't bet)
Seat 6: seula i folded before Flop (didn't bet)
Seat 7: MurMurRu folded on the Flop
Seat 8: slapshot2011 folded before Flop (didn't bet)
Seat 9: Jene4kaBest folded on the Turn



PokerStars Zoom Hand #84300795592:  Hold'em No Limit ($0.10/$0.25) - 2012/08/05 15:51:39 JST [2012/08/05 2:51:39 ET]
Table 'Whirlpool' 9-max Seat #1 is the button
Seat 1: MurMurRu ($25 in chips) 
Seat 2: Grishukps ($12.75 in chips) 
Seat 3: munky3 ($24.25 in chips) 
Seat 4: Rici47 ($39.59 in chips) 
Seat 5: chiyuki ($37.49 in chips) 
Seat 6: drunk_bender ($11.36 in chips) 
Seat 7: ShockLaMuc ($24.30 in chips) 
Seat 8: hldtom ($13.95 in chips) 
Seat 9: Perstenev ($14.90 in chips) 
Grishukps: posts small blind $0.10
munky3: posts big blind $0.25
*** HOLE CARDS ***
Dealt to chiyuki [Jh 8d]
Rici47: folds 
chiyuki: folds 
drunk_bender: folds 
ShockLaMuc: folds 
hldtom: folds 
Perstenev: calls $0.25
MurMurRu: folds 
Grishukps: folds 
munky3: raises $0.25 to $0.50
Perstenev: calls $0.25
*** FLOP *** [2d 9h 9s]
munky3: bets $0.80
Perstenev: calls $0.80
*** TURN *** [2d 9h 9s] [As]
munky3: bets $1.25
Perstenev: folds 
Uncalled bet ($1.25) returned to munky3
munky3 collected $2.58 from pot
munky3: doesn't show hand 
*** SUMMARY ***
Total pot $2.70 | Rake $0.12 
Board [2d 9h 9s As]
Seat 1: MurMurRu (button) folded before Flop (didn't bet)
Seat 2: Grishukps (small blind) folded before Flop
Seat 3: munky3 (big blind) collected ($2.58)
Seat 4: Rici47 folded before Flop (didn't bet)
Seat 5: chiyuki folded before Flop (didn't bet)
Seat 6: drunk_bender folded before Flop (didn't bet)
Seat 7: ShockLaMuc folded before Flop (didn't bet)
Seat 8: hldtom folded before Flop (didn't bet)
Seat 9: Perstenev folded on the Turn



PokerStars Zoom Hand #84300802772:  Hold'em No Limit ($0.10/$0.25) - 2012/08/05 15:52:07 JST [2012/08/05 2:52:07 ET]
Table 'Whirlpool' 9-max Seat #1 is the button
Seat 1: nice.franki ($8.48 in chips) 
Seat 2: JhonnyP1979 ($15.65 in chips) 
Seat 3: Ellen1947 ($29.90 in chips) 
Seat 4: chiyuki ($37.49 in chips) 
Seat 5: GSDP ($24.39 in chips) 
Seat 6: Perstenev ($12.08 in chips) 
Seat 7: 1Karina1 ($36.57 in chips) 
Seat 8: jvds114 ($36.90 in chips) 
Seat 9: herkko11 ($9.03 in chips) 
JhonnyP1979: posts small blind $0.10
Ellen1947: posts big blind $0.25
*** HOLE CARDS ***
Dealt to chiyuki [5s Kd]
chiyuki: folds 
GSDP: folds 
Perstenev: folds 
1Karina1: folds 
jvds114: folds 
herkko11: folds 
nice.franki: folds 
JhonnyP1979: folds 
Uncalled bet ($0.15) returned to Ellen1947
Ellen1947 collected $0.20 from pot
Ellen1947: doesn't show hand 
*** SUMMARY ***
Total pot $0.20 | Rake $0 
Seat 1: nice.franki (button) folded before Flop (didn't bet)
Seat 2: JhonnyP1979 (small blind) folded before Flop
Seat 3: Ellen1947 (big blind) collected ($0.20)
Seat 4: chiyuki folded before Flop (didn't bet)
Seat 5: GSDP folded before Flop (didn't bet)
Seat 6: Perstenev folded before Flop (didn't bet)
Seat 7: 1Karina1 folded before Flop (didn't bet)
Seat 8: jvds114 folded before Flop (didn't bet)
Seat 9: herkko11 folded before Flop (didn't bet)



PokerStars Zoom Hand #84300796589:  Hold'em No Limit ($0.10/$0.25) - 2012/08/05 15:51:43 JST [2012/08/05 2:51:43 ET]
Table 'Whirlpool' 9-max Seat #1 is the button
Seat 1: snejokCoxx ($12.15 in chips) 
Seat 2: INSP!RON ($35.51 in chips) 
Seat 3: kwkim73 ($27.14 in chips) 
Seat 4: Femali54 ($24.84 in chips) 
Seat 5: Nerkit ($11.71 in chips) 
Seat 6: Rici47 ($39.59 in chips) 
Seat 7: chiyuki ($37.49 in chips) 
Seat 8: Perstenev ($12.30 in chips) 
Seat 9: mjmichi ($68.98 in chips) 
INSP!RON: posts small blind $0.10
kwkim73: posts big blind $0.25
*** HOLE CARDS ***
Dealt to chiyuki [Jd 9h]
Femali54: folds 
Nerkit: folds 
Rici47: folds 
chiyuki: folds 
Perstenev: calls $0.25
mjmichi: folds 
snejokCoxx: folds 
INSP!RON: folds 
kwkim73: checks 
*** FLOP *** [4h Ah Jh]
kwkim73: checks 
Perstenev: bets $0.50
kwkim73: folds 
Uncalled bet ($0.50) returned to Perstenev
Perstenev collected $0.57 from pot
Perstenev: doesn't show hand 
*** SUMMARY ***
Total pot $0.60 | Rake $0.03 
Board [4h Ah Jh]
Seat 1: snejokCoxx (button) folded before Flop (didn't bet)
Seat 2: INSP!RON (small blind) folded before Flop
Seat 3: kwkim73 (big blind) folded on the Flop
Seat 4: Femali54 folded before Flop (didn't bet)
Seat 5: Nerkit folded before Flop (didn't bet)
Seat 6: Rici47 folded before Flop (didn't bet)
Seat 7: chiyuki folded before Flop (didn't bet)
Seat 8: Perstenev collected ($0.57)
Seat 9: mjmichi folded before Flop (didn't bet)



PokerStars Zoom Hand #84300801693:  Hold'em No Limit ($0.10/$0.25) - 2012/08/05 15:52:03 JST [2012/08/05 2:52:03 ET]
Table 'Whirlpool' 9-max Seat #1 is the button
Seat 1: Grishukps ($12.50 in chips) 
Seat 2: slapshot2011 ($21.71 in chips) 
Seat 3: Nerkit ($11.71 in chips) 
Seat 4: Femali54 ($24.84 in chips) 
Seat 5: herkko11 ($9.03 in chips) 
Seat 6: chiyuki ($37.49 in chips) 
Seat 7: Perstenev ($12.08 in chips) 
Seat 8: misskitty354 ($10.68 in chips) 
Seat 9: Rilko1975 ($24.90 in chips) 
slapshot2011: posts small blind $0.10
Nerkit: posts big blind $0.25
*** HOLE CARDS ***
Dealt to chiyuki [4d 9d]
Femali54: folds 
herkko11: folds 
chiyuki: folds 
Perstenev: folds 
misskitty354: folds 
Rilko1975: folds 
Grishukps: folds 
slapshot2011: calls $0.15
Nerkit: checks 
*** FLOP *** [8c 7c 5h]
slapshot2011: checks 
Nerkit: checks 
*** TURN *** [8c 7c 5h] [6c]
slapshot2011: bets $0.75
Nerkit: folds 
Uncalled bet ($0.75) returned to slapshot2011
slapshot2011 collected $0.48 from pot
slapshot2011: doesn't show hand 
*** SUMMARY ***
Total pot $0.50 | Rake $0.02 
Board [8c 7c 5h 6c]
Seat 1: Grishukps (button) folded before Flop (didn't bet)
Seat 2: slapshot2011 (small blind) collected ($0.48)
Seat 3: Nerkit (big blind) folded on the Turn
Seat 4: Femali54 folded before Flop (didn't bet)
Seat 5: herkko11 folded before Flop (didn't bet)
Seat 6: chiyuki folded before Flop (didn't bet)
Seat 7: Perstenev folded before Flop (didn't bet)
Seat 8: misskitty354 folded before Flop (didn't bet)
Seat 9: Rilko1975 folded before Flop (didn't bet)



PokerStars Zoom Hand #84300800131:  Hold'em No Limit ($0.10/$0.25) - 2012/08/05 15:51:57 JST [2012/08/05 2:51:57 ET]
Table 'Whirlpool' 9-max Seat #1 is the button
Seat 1: chiyuki ($37.49 in chips) 
Seat 2: xxx Spb xxx ($25.79 in chips) 
Seat 3: Trip_Krowns ($24.90 in chips) 
Seat 4: pandaaaaaa ($14.05 in chips) 
Seat 5: 1Karina1 ($35.97 in chips) 
Seat 6: hldtom ($13.75 in chips) 
Seat 7: Ellen1947 ($29.90 in chips) 
Seat 8: KrystalAA ($26.34 in chips) 
Seat 9: ChrisCDee ($40.23 in chips) 
xxx Spb xxx: posts small blind $0.10
Trip_Krowns: posts big blind $0.25
*** HOLE CARDS ***
Dealt to chiyuki [9s 4s]
pandaaaaaa: calls $0.25
1Karina1: folds 
hldtom: folds 
Ellen1947: folds 
KrystalAA: folds 
ChrisCDee: folds 
chiyuki: folds 
xxx Spb xxx: folds 
Trip_Krowns: checks 
*** FLOP *** [Js 5h 8c]
Trip_Krowns: checks 
pandaaaaaa: checks 
*** TURN *** [Js 5h 8c] [Jc]
Trip_Krowns: checks 
pandaaaaaa: checks 
*** RIVER *** [Js 5h 8c Jc] [Kh]
Trip_Krowns: checks 
pandaaaaaa: checks 
*** SHOW DOWN ***
Trip_Krowns: shows [6d Kc] (two pair, Kings and Jacks)
pandaaaaaa: mucks hand 
Trip_Krowns collected $0.57 from pot
*** SUMMARY ***
Total pot $0.60 | Rake $0.03 
Board [Js 5h 8c Jc Kh]
Seat 1: chiyuki (button) folded before Flop (didn't bet)
Seat 2: xxx Spb xxx (small blind) folded before Flop
Seat 3: Trip_Krowns (big blind) showed [6d Kc] and won ($0.57) with two pair, Kings and Jacks
Seat 4: pandaaaaaa mucked [2h 2c]
Seat 5: 1Karina1 folded before Flop (didn't bet)
Seat 6: hldtom folded before Flop (didn't bet)
Seat 7: Ellen1947 folded before Flop (didn't bet)
Seat 8: KrystalAA folded before Flop (didn't bet)
Seat 9: ChrisCDee folded before Flop (didn't bet)



PokerStars Zoom Hand #84300803508:  Hold'em No Limit ($0.10/$0.25) - 2012/08/05 15:52:10 JST [2012/08/05 2:52:10 ET]
Table 'Whirlpool' 9-max Seat #1 is the button
Seat 1: hldtom ($25.10 in chips) 
Seat 2: kwkim73 ($27.73 in chips) 
Seat 3: chiyuki ($37.49 in chips) 
Seat 4: vpetrovi ($12.32 in chips) 
Seat 5: 4ydo yogurt ($44.23 in chips) 
Seat 6: DrunkTyphoon ($29.34 in chips) 
Seat 7: 1Karina1 ($43.64 in chips) 
Seat 8: Jene4kaBest ($19.03 in chips) 
Seat 9: Rilko1975 ($23.12 in chips) 
kwkim73: posts small blind $0.10
chiyuki: posts big blind $0.25
*** HOLE CARDS ***
Dealt to chiyuki [2c 8s]
vpetrovi: folds 
4ydo yogurt: folds 
DrunkTyphoon: folds 
1Karina1: folds 
Jene4kaBest: folds 
Rilko1975: raises $0.50 to $0.75
hldtom: folds 
kwkim73: folds 
chiyuki: folds 
Uncalled bet ($0.50) returned to Rilko1975
Rilko1975 collected $0.60 from pot
Rilko1975: doesn't show hand 
*** SUMMARY ***
Total pot $0.60 | Rake $0 
Seat 1: hldtom (button) folded before Flop (didn't bet)
Seat 2: kwkim73 (small blind) folded before Flop
Seat 3: chiyuki (big blind) folded before Flop
Seat 4: vpetrovi folded before Flop (didn't bet)
Seat 5: 4ydo yogurt folded before Flop (didn't bet)
Seat 6: DrunkTyphoon folded before Flop (didn't bet)
Seat 7: 1Karina1 folded before Flop (didn't bet)
Seat 8: Jene4kaBest folded before Flop (didn't bet)
Seat 9: Rilko1975 collected ($0.60)



PokerStars Zoom Hand #84300807152:  Hold'em No Limit ($0.10/$0.25) - 2012/08/05 15:52:25 JST [2012/08/05 2:52:25 ET]
Table 'Whirlpool' 9-max Seat #1 is the button
Seat 1: Dejacob ($25 in chips) 
Seat 2: chiyuki ($37.24 in chips) 
Seat 3: Perstenev ($12.08 in chips) 
Seat 4: 1Karina1 ($43.54 in chips) 
Seat 5: Ellen1947 ($29.90 in chips) 
Seat 6: GovGus ($30.34 in chips) 
Seat 7: Grishukps ($12.50 in chips) 
Seat 8: kesstukas25 ($15.07 in chips) 
Seat 9: slapshot2011 ($21.94 in chips) 
chiyuki: posts small blind $0.10
Perstenev: posts big blind $0.25
*** HOLE CARDS ***
Dealt to chiyuki [Jd Kd]
1Karina1: folds 
Ellen1947: folds 
GovGus: raises $0.75 to $1
Grishukps: folds 
kesstukas25: folds 
slapshot2011: folds 
Dejacob: folds 
chiyuki: folds 
Perstenev: folds 
Uncalled bet ($0.75) returned to GovGus
GovGus collected $0.60 from pot
GovGus: doesn't show hand 
*** SUMMARY ***
Total pot $0.60 | Rake $0 
Seat 1: Dejacob (button) folded before Flop (didn't bet)
Seat 2: chiyuki (small blind) folded before Flop
Seat 3: Perstenev (big blind) folded before Flop
Seat 4: 1Karina1 folded before Flop (didn't bet)
Seat 5: Ellen1947 folded before Flop (didn't bet)
Seat 6: GovGus collected ($0.60)
Seat 7: Grishukps folded before Flop (didn't bet)
Seat 8: kesstukas25 folded before Flop (didn't bet)
Seat 9: slapshot2011 folded before Flop (didn't bet)



PokerStars Zoom Hand #84300811550:  Hold'em No Limit ($0.10/$0.25) - 2012/08/05 15:52:42 JST [2012/08/05 2:52:42 ET]
Table 'Whirlpool' 9-max Seat #1 is the button
Seat 1: westhavenbc ($19.65 in chips) 
Seat 2: pawn909 ($24.58 in chips) 
Seat 3: MurMurRu ($25.50 in chips) 
Seat 4: chiyuki ($37.14 in chips) 
Seat 5: DrunkTyphoon ($28.99 in chips) 
Seat 6: Alvinpe85 ($67.24 in chips) 
Seat 7: Kasperlmusik ($32.45 in chips) 
Seat 8: xxx Spb xxx ($28.76 in chips) 
Seat 9: Dan Royal ($28.08 in chips) 
pawn909: posts small blind $0.10
MurMurRu: posts big blind $0.25
*** HOLE CARDS ***
Dealt to chiyuki [Ks 9c]
chiyuki: folds 
DrunkTyphoon: folds 
Alvinpe85: raises $0.50 to $0.75
Kasperlmusik: folds 
xxx Spb xxx: folds 
Dan Royal: folds 
westhavenbc: folds 
pawn909: folds 
MurMurRu: folds 
Uncalled bet ($0.50) returned to Alvinpe85
Alvinpe85 collected $0.60 from pot
Alvinpe85: doesn't show hand 
*** SUMMARY ***
Total pot $0.60 | Rake $0 
Seat 1: westhavenbc (button) folded before Flop (didn't bet)
Seat 2: pawn909 (small blind) folded before Flop
Seat 3: MurMurRu (big blind) folded before Flop
Seat 4: chiyuki folded before Flop (didn't bet)
Seat 5: DrunkTyphoon folded before Flop (didn't bet)
Seat 6: Alvinpe85 collected ($0.60)
Seat 7: Kasperlmusik folded before Flop (didn't bet)
Seat 8: xxx Spb xxx folded before Flop (didn't bet)
Seat 9: Dan Royal folded before Flop (didn't bet)



PokerStars Zoom Hand #84300812613:  Hold'em No Limit ($0.10/$0.25) - 2012/08/05 15:52:46 JST [2012/08/05 2:52:46 ET]
Table 'Whirlpool' 9-max Seat #1 is the button
Seat 1: luyifei ($6.05 in chips) 
Seat 2: masterkoolb ($13.27 in chips) 
Seat 3: Perstenev ($13.50 in chips) 
Seat 4: Silveystryk ($31.71 in chips) 
Seat 5: Kasperlmusik ($32.45 in chips) 
Seat 6: Dan Royal ($28.08 in chips) 
Seat 7: KrystalAA ($43.57 in chips) 
Seat 8: chiyuki ($37.14 in chips) 
Seat 9: munky3 ($25.78 in chips) 
masterkoolb: posts small blind $0.10
Perstenev: posts big blind $0.25
*** HOLE CARDS ***
Dealt to chiyuki [8s 4c]
Silveystryk: folds 
Kasperlmusik: folds 
Dan Royal: folds 
KrystalAA: raises $0.46 to $0.71
chiyuki: folds 
munky3: folds 
luyifei: calls $0.71
masterkoolb: folds 
Perstenev: folds 
*** FLOP *** [8h 4h Th]
KrystalAA: bets $1.30
luyifei: folds 
Uncalled bet ($1.30) returned to KrystalAA
KrystalAA collected $1.69 from pot
KrystalAA: doesn't show hand 
*** SUMMARY ***
Total pot $1.77 | Rake $0.08 
Board [8h 4h Th]
Seat 1: luyifei (button) folded on the Flop
Seat 2: masterkoolb (small blind) folded before Flop
Seat 3: Perstenev (big blind) folded before Flop
Seat 4: Silveystryk folded before Flop (didn't bet)
Seat 5: Kasperlmusik folded before Flop (didn't bet)
Seat 6: Dan Royal folded before Flop (didn't bet)
Seat 7: KrystalAA collected ($1.69)
Seat 8: chiyuki folded before Flop (didn't bet)
Seat 9: munky3 folded before Flop (didn't bet)



PokerStars Zoom Hand #84300810501:  Hold'em No Limit ($0.10/$0.25) - 2012/08/05 15:52:38 JST [2012/08/05 2:52:38 ET]
Table 'Whirlpool' 9-max Seat #1 is the button
Seat 1: Dan Royal ($28.08 in chips) 
Seat 2: Ozboy80 ($24.44 in chips) 
Seat 3: mjmichi ($37.01 in chips) 
Seat 4: chiyuki ($37.14 in chips) 
Seat 5: snejokCoxx ($10.75 in chips) 
Seat 6: hldtom ($13.60 in chips) 
Seat 7: kwkim73 ($25 in chips) 
Seat 8: pandaaaaaa ($13.80 in chips) 
Seat 9: Dejacob ($30.83 in chips) 
Ozboy80: posts small blind $0.10
mjmichi: posts big blind $0.25
*** HOLE CARDS ***
Dealt to chiyuki [Qd Jc]
chiyuki: folds 
snejokCoxx: raises $0.40 to $0.65
hldtom has timed out
hldtom: folds 
kwkim73: folds 
pandaaaaaa: folds 
Dejacob: folds 
Dan Royal: folds 
Ozboy80: folds 
mjmichi: folds 
Uncalled bet ($0.40) returned to snejokCoxx
snejokCoxx collected $0.60 from pot
snejokCoxx: doesn't show hand 
*** SUMMARY ***
Total pot $0.60 | Rake $0 
Seat 1: Dan Royal (button) folded before Flop (didn't bet)
Seat 2: Ozboy80 (small blind) folded before Flop
Seat 3: mjmichi (big blind) folded before Flop
Seat 4: chiyuki folded before Flop (didn't bet)
Seat 5: snejokCoxx collected ($0.60)
Seat 6: hldtom folded before Flop (didn't bet)
Seat 7: kwkim73 folded before Flop (didn't bet)
Seat 8: pandaaaaaa folded before Flop (didn't bet)
Seat 9: Dejacob folded before Flop (didn't bet)



PokerStars Zoom Hand #84300819108:  Hold'em No Limit ($0.10/$0.25) - 2012/08/05 15:53:11 JST [2012/08/05 2:53:11 ET]
Table 'Whirlpool' 9-max Seat #1 is the button
Seat 1: God)Squall ($28.24 in chips) 
Seat 2: Alvinpe85 ($44.55 in chips) 
Seat 3: Rici47 ($35.21 in chips) 
Seat 4: Serge Claws ($30.72 in chips) 
Seat 5: chiyuki ($37.14 in chips) 
Seat 6: JhonnyP1979 ($17.30 in chips) 
Seat 7: munky3 ($25.78 in chips) 
Seat 8: yvasilik ($24.87 in chips) 
Seat 9: vpetrovi ($11.47 in chips) 
Alvinpe85: posts small blind $0.10
Rici47: posts big blind $0.25
*** HOLE CARDS ***
Dealt to chiyuki [7d 7c]
Serge Claws: folds 
chiyuki: raises $0.50 to $0.75
JhonnyP1979: folds 
munky3: folds 
yvasilik: folds 
vpetrovi: folds 
God)Squall: folds 
Alvinpe85: folds 
Rici47: folds 
Uncalled bet ($0.50) returned to chiyuki
chiyuki collected $0.60 from pot
chiyuki: doesn't show hand 
*** SUMMARY ***
Total pot $0.60 | Rake $0 
Seat 1: God)Squall (button) folded before Flop (didn't bet)
Seat 2: Alvinpe85 (small blind) folded before Flop
Seat 3: Rici47 (big blind) folded before Flop
Seat 4: Serge Claws folded before Flop (didn't bet)
Seat 5: chiyuki collected ($0.60)
Seat 6: JhonnyP1979 folded before Flop (didn't bet)
Seat 7: munky3 folded before Flop (didn't bet)
Seat 8: yvasilik folded before Flop (didn't bet)
Seat 9: vpetrovi folded before Flop (didn't bet)



PokerStars Zoom Hand #84300815710:  Hold'em No Limit ($0.10/$0.25) - 2012/08/05 15:52:58 JST [2012/08/05 2:52:58 ET]
Table 'Whirlpool' 9-max Seat #1 is the button
Seat 1: Nerkit ($12.06 in chips) 
Seat 2: yoube ($24.25 in chips) 
Seat 3: nice.franki ($6.20 in chips) 
Seat 4: chiyuki ($37.14 in chips) 
Seat 5: Rilko1975 ($25.30 in chips) 
Seat 6: 1Karina1 ($43.29 in chips) 
Seat 7: KeLevro0 ($12.50 in chips) 
Seat 8: ViTiV2010 ($9.69 in chips) 
Seat 9: phate-1up ($51.67 in chips) 
yoube: posts small blind $0.10
nice.franki: posts big blind $0.25
*** HOLE CARDS ***
Dealt to chiyuki [2d 7h]
chiyuki: folds 
Rilko1975: folds 
1Karina1: folds 
KeLevro0: folds 
ViTiV2010: folds 
phate-1up: folds 
Nerkit: raises $0.50 to $0.75
yoube: folds 
nice.franki: raises $5.45 to $6.20 and is all-in
Nerkit: folds 
Uncalled bet ($5.45) returned to nice.franki
nice.franki collected $1.60 from pot
nice.franki: doesn't show hand 
*** SUMMARY ***
Total pot $1.60 | Rake $0 
Seat 1: Nerkit (button) folded before Flop
Seat 2: yoube (small blind) folded before Flop
Seat 3: nice.franki (big blind) collected ($1.60)
Seat 4: chiyuki folded before Flop (didn't bet)
Seat 5: Rilko1975 folded before Flop (didn't bet)
Seat 6: 1Karina1 folded before Flop (didn't bet)
Seat 7: KeLevro0 folded before Flop (didn't bet)
Seat 8: ViTiV2010 folded before Flop (didn't bet)
Seat 9: phate-1up folded before Flop (didn't bet)



PokerStars Zoom Hand #84300818032:  Hold'em No Limit ($0.10/$0.25) - 2012/08/05 15:53:07 JST [2012/08/05 2:53:07 ET]
Table 'Whirlpool' 9-max Seat #1 is the button
Seat 1: hldtom ($14.53 in chips) 
Seat 2: Perstenev ($10.48 in chips) 
Seat 3: seula i ($49.26 in chips) 
Seat 4: GovGus ($53.48 in chips) 
Seat 5: westhavenbc ($19.65 in chips) 
Seat 6: Limoilou ($28.57 in chips) 
Seat 7: chiyuki ($37.14 in chips) 
Seat 8: KeLevro0 ($12.58 in chips) 
Seat 9: AAAKK777 ($17.60 in chips) 
Perstenev: posts small blind $0.10
seula i: posts big blind $0.25
*** HOLE CARDS ***
Dealt to chiyuki [9s 2c]
GovGus: folds 
westhavenbc: raises $0.25 to $0.50
Limoilou: folds 
chiyuki: folds 
KeLevro0: raises $1.75 to $2.25
AAAKK777: folds 
hldtom: folds 
Perstenev: folds 
seula i: folds 
westhavenbc: folds 
Uncalled bet ($1.75) returned to KeLevro0
KeLevro0 collected $1.35 from pot
KeLevro0: doesn't show hand 
*** SUMMARY ***
Total pot $1.35 | Rake $0 
Seat 1: hldtom (button) folded before Flop (didn't bet)
Seat 2: Perstenev (small blind) folded before Flop
Seat 3: seula i (big blind) folded before Flop
Seat 4: GovGus folded before Flop (didn't bet)
Seat 5: westhavenbc folded before Flop
Seat 6: Limoilou folded before Flop (didn't bet)
Seat 7: chiyuki folded before Flop (didn't bet)
Seat 8: KeLevro0 collected ($1.35)
Seat 9: AAAKK777 folded before Flop (didn't bet)



PokerStars Zoom Hand #84300816746:  Hold'em No Limit ($0.10/$0.25) - 2012/08/05 15:53:02 JST [2012/08/05 2:53:02 ET]
Table 'Whirlpool' 9-max Seat #1 is the button
Seat 1: Rilko1975 ($25.30 in chips) 
Seat 2: Grishukps ($12.50 in chips) 
Seat 3: Dan Royal ($28.08 in chips) 
Seat 4: KeLevro0 ($12.58 in chips) 
Seat 5: luyifei ($5.34 in chips) 
Seat 6: 1Karina1 ($35.22 in chips) 
Seat 7: Dejacob ($25 in chips) 
Seat 8: kwkim73 ($25.35 in chips) 
Seat 9: chiyuki ($37.14 in chips) 
Grishukps: posts small blind $0.10
Dan Royal: posts big blind $0.25
*** HOLE CARDS ***
Dealt to chiyuki [7s Th]
KeLevro0: folds 
luyifei: raises $0.50 to $0.75
1Karina1: folds 
Dejacob: folds 
kwkim73: folds 
chiyuki: folds 
Rilko1975: folds 
Grishukps: folds 
Dan Royal: calls $0.50
*** FLOP *** [3s Tc 2s]
Dan Royal: checks 
luyifei: checks 
*** TURN *** [3s Tc 2s] [7c]
Dan Royal: bets $0.75
luyifei: raises $0.75 to $1.50
Dan Royal: raises $25.83 to $27.33 and is all-in
luyifei: calls $3.09 and is all-in
Uncalled bet ($22.74) returned to Dan Royal
*** RIVER *** [3s Tc 2s 7c] [5h]
*** SHOW DOWN ***
Dan Royal: shows [Ts Td] (three of a kind, Tens)
luyifei: shows [3h 3d] (three of a kind, Threes)
Dan Royal collected $10.29 from pot
*** SUMMARY ***
Total pot $10.78 | Rake $0.49 
Board [3s Tc 2s 7c 5h]
Seat 1: Rilko1975 (button) folded before Flop (didn't bet)
Seat 2: Grishukps (small blind) folded before Flop
Seat 3: Dan Royal (big blind) showed [Ts Td] and won ($10.29) with three of a kind, Tens
Seat 4: KeLevro0 folded before Flop (didn't bet)
Seat 5: luyifei showed [3h 3d] and lost with three of a kind, Threes
Seat 6: 1Karina1 folded before Flop (didn't bet)
Seat 7: Dejacob folded before Flop (didn't bet)
Seat 8: kwkim73 folded before Flop (didn't bet)
Seat 9: chiyuki folded before Flop (didn't bet)



PokerStars Zoom Hand #84300813868:  Hold'em No Limit ($0.10/$0.25) - 2012/08/05 15:52:51 JST [2012/08/05 2:52:51 ET]
Table 'Whirlpool' 9-max Seat #1 is the button
Seat 1: chiyuki ($37.14 in chips) 
Seat 2: CrittHunter ($24.75 in chips) 
Seat 3: MurMurRu ($25 in chips) 
Seat 4: Silveystryk ($21.44 in chips) 
Seat 5: pawn909 ($24.48 in chips) 
Seat 6: Ellen1947 ($30.90 in chips) 
Seat 7: munky3 ($25.78 in chips) 
Seat 8: snejokCoxx ($11.19 in chips) 
Seat 9: nice.franki ($8.23 in chips) 
CrittHunter: posts small blind $0.10
MurMurRu: posts big blind $0.25
*** HOLE CARDS ***
Dealt to chiyuki [Ad 5c]
Silveystryk: calls $0.25
pawn909: folds 
Ellen1947: folds 
munky3: folds 
snejokCoxx: folds 
nice.franki: folds 
chiyuki: folds 
CrittHunter: calls $0.15
MurMurRu: checks 
*** FLOP *** [As 3s Ah]
CrittHunter: checks 
MurMurRu: checks 
Silveystryk: bets $0.25
CrittHunter: calls $0.25
MurMurRu: folds 
*** TURN *** [As 3s Ah] [7d]
CrittHunter: checks 
Silveystryk: bets $0.25
CrittHunter: raises $0.75 to $1
Silveystryk: calls $0.75
*** RIVER *** [As 3s Ah 7d] [6s]
CrittHunter: bets $3.50
Silveystryk: calls $3.50
*** SHOW DOWN ***
CrittHunter: shows [3c Ac] (a full house, Aces full of Threes)
Silveystryk: mucks hand 
CrittHunter collected $9.79 from pot
*** SUMMARY ***
Total pot $10.25 | Rake $0.46 
Board [As 3s Ah 7d 6s]
Seat 1: chiyuki (button) folded before Flop (didn't bet)
Seat 2: CrittHunter (small blind) showed [3c Ac] and won ($9.79) with a full house, Aces full of Threes
Seat 3: MurMurRu (big blind) folded on the Flop
Seat 4: Silveystryk mucked [8s 7s]
Seat 5: pawn909 folded before Flop (didn't bet)
Seat 6: Ellen1947 folded before Flop (didn't bet)
Seat 7: munky3 folded before Flop (didn't bet)
Seat 8: snejokCoxx folded before Flop (didn't bet)
Seat 9: nice.franki folded before Flop (didn't bet)



PokerStars Zoom Hand #84300821480:  Hold'em No Limit ($0.10/$0.25) - 2012/08/05 15:53:20 JST [2012/08/05 2:53:20 ET]
Table 'Whirlpool' 9-max Seat #1 is the button
Seat 1: kwkim73 ($25 in chips) 
Seat 2: Saruotiss ($63.18 in chips) 
Seat 3: kamikkaze ($18.75 in chips) 
Seat 4: Dejacob ($25 in chips) 
Seat 5: INSP!RON ($35.16 in chips) 
Seat 6: chiyuki ($37.49 in chips) 
Seat 7: risekuku468 ($34.51 in chips) 
Seat 8: yoube ($24.15 in chips) 
Seat 9: TorTrade ($25.65 in chips) 
Saruotiss: posts small blind $0.10
kamikkaze: posts big blind $0.25
*** HOLE CARDS ***
Dealt to chiyuki [9h Kd]
Dejacob: raises $0.50 to $0.75
INSP!RON: folds 
chiyuki: folds 
risekuku468: folds 
yoube: folds 
TorTrade: calls $0.75
kwkim73: folds 
Saruotiss: folds 
kamikkaze: folds 
*** FLOP *** [5c 7d 3h]
Dejacob: bets $1.25
TorTrade: folds 
Uncalled bet ($1.25) returned to Dejacob
Dejacob collected $1.77 from pot
Dejacob: doesn't show hand 
*** SUMMARY ***
Total pot $1.85 | Rake $0.08 
Board [5c 7d 3h]
Seat 1: kwkim73 (button) folded before Flop (didn't bet)
Seat 2: Saruotiss (small blind) folded before Flop
Seat 3: kamikkaze (big blind) folded before Flop
Seat 4: Dejacob collected ($1.77)
Seat 5: INSP!RON folded before Flop (didn't bet)
Seat 6: chiyuki folded before Flop (didn't bet)
Seat 7: risekuku468 folded before Flop (didn't bet)
Seat 8: yoube folded before Flop (didn't bet)
Seat 9: TorTrade folded on the Flop



PokerStars Zoom Hand #84300823737:  Hold'em No Limit ($0.10/$0.25) - 2012/08/05 15:53:30 JST [2012/08/05 2:53:30 ET]
Table 'Whirlpool' 9-max Seat #1 is the button
Seat 1: fil740 ($5.72 in chips) 
Seat 2: ChrisCDee ($59.04 in chips) 
Seat 3: chiyuki ($37.49 in chips) 
Seat 4: yvasilik ($24.77 in chips) 
Seat 5: panaam ($35.66 in chips) 
Seat 6: KeLevro0 ($14.53 in chips) 
Seat 7: pandaaaaaa ($14.80 in chips) 
Seat 8: GSDP ($23.79 in chips) 
Seat 9: River_GmbH ($15.77 in chips) 
ChrisCDee: posts small blind $0.10
chiyuki: posts big blind $0.25
*** HOLE CARDS ***
Dealt to chiyuki [3h 5d]
yvasilik: folds 
panaam: raises $0.25 to $0.50
KeLevro0: folds 
pandaaaaaa: folds 
GSDP: calls $0.50
River_GmbH: folds 
fil740: folds 
ChrisCDee: folds 
chiyuki: folds 
*** FLOP *** [4s 4c 8s]
panaam: bets $0.75
GSDP: calls $0.75
*** TURN *** [4s 4c 8s] [9c]
panaam: bets $0.75
GSDP: calls $0.75
*** RIVER *** [4s 4c 8s 9c] [9h]
panaam: bets $0.75
GSDP: calls $0.75
*** SHOW DOWN ***
panaam: shows [7d 7s] (two pair, Nines and Sevens)
GSDP: mucks hand 
panaam collected $5.59 from pot
*** SUMMARY ***
Total pot $5.85 | Rake $0.26 
Board [4s 4c 8s 9c 9h]
Seat 1: fil740 (button) folded before Flop (didn't bet)
Seat 2: ChrisCDee (small blind) folded before Flop
Seat 3: chiyuki (big blind) folded before Flop
Seat 4: yvasilik folded before Flop (didn't bet)
Seat 5: panaam showed [7d 7s] and won ($5.59) with two pair, Nines and Sevens
Seat 6: KeLevro0 folded before Flop (didn't bet)
Seat 7: pandaaaaaa folded before Flop (didn't bet)
Seat 8: GSDP mucked [As Jc]
Seat 9: River_GmbH folded before Flop (didn't bet)



PokerStars Zoom Hand #84300827534:  Hold'em No Limit ($0.10/$0.25) - 2012/08/05 15:53:45 JST [2012/08/05 2:53:45 ET]
Table 'Whirlpool' 9-max Seat #1 is the button
Seat 1: TorTrade ($24.90 in chips) 
Seat 2: chiyuki ($37.24 in chips) 
Seat 3: yvasilik ($24.77 in chips) 
Seat 4: nice.franki ($7.05 in chips) 
Seat 5: misskitty354 ($10.15 in chips) 
Seat 6: God)Squall ($28.24 in chips) 
Seat 7: Kasperlmusik ($25 in chips) 
Seat 8: kamikkaze ($22.38 in chips) 
Seat 9: crazycrown1 ($12.15 in chips) 
chiyuki: posts small blind $0.10
yvasilik: posts big blind $0.25
*** HOLE CARDS ***
Dealt to chiyuki [4s Jc]
nice.franki: folds 
misskitty354: folds 
God)Squall: folds 
Kasperlmusik: folds 
kamikkaze: folds 
crazycrown1: folds 
TorTrade: raises $0.50 to $0.75
chiyuki: folds 
yvasilik: calls $0.50
*** FLOP *** [3d Qc Ts]
yvasilik: checks 
TorTrade: bets $1.14
yvasilik: folds 
Uncalled bet ($1.14) returned to TorTrade
TorTrade collected $1.53 from pot
TorTrade: doesn't show hand 
*** SUMMARY ***
Total pot $1.60 | Rake $0.07 
Board [3d Qc Ts]
Seat 1: TorTrade (button) collected ($1.53)
Seat 2: chiyuki (small blind) folded before Flop
Seat 3: yvasilik (big blind) folded on the Flop
Seat 4: nice.franki folded before Flop (didn't bet)
Seat 5: misskitty354 folded before Flop (didn't bet)
Seat 6: God)Squall folded before Flop (didn't bet)
Seat 7: Kasperlmusik folded before Flop (didn't bet)
Seat 8: kamikkaze folded before Flop (didn't bet)
Seat 9: crazycrown1 folded before Flop (didn't bet)



PokerStars Zoom Hand #84300829330:  Hold'em No Limit ($0.10/$0.25) - 2012/08/05 15:53:52 JST [2012/08/05 2:53:52 ET]
Table 'Whirlpool' 9-max Seat #1 is the button
Seat 1: jacquelinewu ($28.06 in chips) 
Seat 2: Dan Royal ($33.03 in chips) 
Seat 3: kamikkaze ($22.38 in chips) 
Seat 4: masterkoolb ($13.65 in chips) 
Seat 5: nice.franki ($7.05 in chips) 
Seat 6: westhavenbc ($19.15 in chips) 
Seat 7: herkko11 ($11.05 in chips) 
Seat 8: phate-1up ($51.67 in chips) 
Seat 9: chiyuki ($37.14 in chips) 
Dan Royal: posts small blind $0.10
kamikkaze: posts big blind $0.25
*** HOLE CARDS ***
Dealt to chiyuki [6h 9h]
masterkoolb: folds 
nice.franki: folds 
westhavenbc: raises $0.25 to $0.50
herkko11: folds 
phate-1up: calls $0.50
chiyuki: folds 
jacquelinewu: folds 
Dan Royal: folds 
kamikkaze: folds 
*** FLOP *** [7d 8d 2d]
westhavenbc: bets $1.50
phate-1up: raises $2.50 to $4
westhavenbc: folds 
Uncalled bet ($2.50) returned to phate-1up
phate-1up collected $4.15 from pot
phate-1up: doesn't show hand 
*** SUMMARY ***
Total pot $4.35 | Rake $0.20 
Board [7d 8d 2d]
Seat 1: jacquelinewu (button) folded before Flop (didn't bet)
Seat 2: Dan Royal (small blind) folded before Flop
Seat 3: kamikkaze (big blind) folded before Flop
Seat 4: masterkoolb folded before Flop (didn't bet)
Seat 5: nice.franki folded before Flop (didn't bet)
Seat 6: westhavenbc folded on the Flop
Seat 7: herkko11 folded before Flop (didn't bet)
Seat 8: phate-1up collected ($4.15)
Seat 9: chiyuki folded before Flop (didn't bet)



PokerStars Zoom Hand #84300833713:  Hold'em No Limit ($0.10/$0.25) - 2012/08/05 15:54:09 JST [2012/08/05 2:54:09 ET]
Table 'Whirlpool' 9-max Seat #1 is the button
Seat 1: 1Karina1 ($34.87 in chips) 
Seat 2: phate-1up ($54.98 in chips) 
Seat 3: Perstenev ($13 in chips) 
Seat 4: KrystalAA ($14.91 in chips) 
Seat 5: Limoilou ($28.22 in chips) 
Seat 6: GSDP ($21.04 in chips) 
Seat 7: chiyuki ($37.14 in chips) 
Seat 8: kesstukas25 ($17.81 in chips) 
Seat 9: mjmichi ($37.68 in chips) 
phate-1up: posts small blind $0.10
Perstenev: posts big blind $0.25
*** HOLE CARDS ***
Dealt to chiyuki [4s Qd]
KrystalAA: folds 
Limoilou: folds 
GSDP: folds 
chiyuki: folds 
kesstukas25: folds 
mjmichi: folds 
1Karina1: folds 
phate-1up: folds 
Uncalled bet ($0.15) returned to Perstenev
Perstenev collected $0.20 from pot
Perstenev: doesn't show hand 
*** SUMMARY ***
Total pot $0.20 | Rake $0 
Seat 1: 1Karina1 (button) folded before Flop (didn't bet)
Seat 2: phate-1up (small blind) folded before Flop
Seat 3: Perstenev (big blind) collected ($0.20)
Seat 4: KrystalAA folded before Flop (didn't bet)
Seat 5: Limoilou folded before Flop (didn't bet)
Seat 6: GSDP folded before Flop (didn't bet)
Seat 7: chiyuki folded before Flop (didn't bet)
Seat 8: kesstukas25 folded before Flop (didn't bet)
Seat 9: mjmichi folded before Flop (didn't bet)



PokerStars Zoom Hand #84300835807:  Hold'em No Limit ($0.10/$0.25) - 2012/08/05 15:54:17 JST [2012/08/05 2:54:17 ET]
Table 'Whirlpool' 9-max Seat #1 is the button
Seat 1: chiyuki ($37.14 in chips) 
Seat 2: Perstenev ($12.75 in chips) 
Seat 3: kwkim73 ($26.03 in chips) 
Seat 4: leo2095 ($28.15 in chips) 
Seat 5: pandaaaaaa ($15.65 in chips) 
Seat 6: Jene4kaBest ($16.43 in chips) 
Seat 7: drunk_bender ($14.41 in chips) 
Seat 8: kamikkaze ($18.15 in chips) 
Seat 9: nice.franki ($6.95 in chips) 
Perstenev: posts small blind $0.10
kwkim73: posts big blind $0.25
*** HOLE CARDS ***
Dealt to chiyuki [8c Jd]
leo2095: raises $0.50 to $0.75
pandaaaaaa: folds 
Jene4kaBest: folds 
drunk_bender: folds 
kamikkaze: folds 
nice.franki: folds 
chiyuki: folds 
Perstenev: folds 
kwkim73: folds 
Uncalled bet ($0.50) returned to leo2095
leo2095 collected $0.60 from pot
leo2095: doesn't show hand 
*** SUMMARY ***
Total pot $0.60 | Rake $0 
Seat 1: chiyuki (button) folded before Flop (didn't bet)
Seat 2: Perstenev (small blind) folded before Flop
Seat 3: kwkim73 (big blind) folded before Flop
Seat 4: leo2095 collected ($0.60)
Seat 5: pandaaaaaa folded before Flop (didn't bet)
Seat 6: Jene4kaBest folded before Flop (didn't bet)
Seat 7: drunk_bender folded before Flop (didn't bet)
Seat 8: kamikkaze folded before Flop (didn't bet)
Seat 9: nice.franki folded before Flop (didn't bet)



PokerStars Zoom Hand #84300832411:  Hold'em No Limit ($0.10/$0.25) - 2012/08/05 15:54:04 JST [2012/08/05 2:54:04 ET]
Table 'Whirlpool' 9-max Seat #1 is the button
Seat 1: mjmichi ($37.68 in chips) 
Seat 2: nice.franki ($12.50 in chips) 
Seat 3: 1Karina1 ($35.12 in chips) 
Seat 4: snejokCoxx ($10.50 in chips) 
Seat 5: GovGus ($40.50 in chips) 
Seat 6: romanian c4 ($4.49 in chips) 
Seat 7: CrittHunter ($29.54 in chips) 
Seat 8: chiyuki ($37.14 in chips) 
Seat 9: seula i ($49.38 in chips) 
nice.franki: posts small blind $0.10
1Karina1: posts big blind $0.25
*** HOLE CARDS ***
Dealt to chiyuki [Js 8d]
snejokCoxx: raises $0.40 to $0.65
GovGus: folds 
romanian c4: folds 
CrittHunter: folds 
chiyuki: folds 
seula i: calls $0.65
mjmichi: folds 
nice.franki: folds 
1Karina1: folds 
*** FLOP *** [Tc 7h 7d]
snejokCoxx: checks 
seula i: bets $1
snejokCoxx: folds 
Uncalled bet ($1) returned to seula i
seula i collected $1.58 from pot
seula i: doesn't show hand 
*** SUMMARY ***
Total pot $1.65 | Rake $0.07 
Board [Tc 7h 7d]
Seat 1: mjmichi (button) folded before Flop (didn't bet)
Seat 2: nice.franki (small blind) folded before Flop
Seat 3: 1Karina1 (big blind) folded before Flop
Seat 4: snejokCoxx folded on the Flop
Seat 5: GovGus folded before Flop (didn't bet)
Seat 6: romanian c4 folded before Flop (didn't bet)
Seat 7: CrittHunter folded before Flop (didn't bet)
Seat 8: chiyuki folded before Flop (didn't bet)
Seat 9: seula i collected ($1.58)



PokerStars Zoom Hand #84300839729:  Hold'em No Limit ($0.10/$0.25) - 2012/08/05 15:54:32 JST [2012/08/05 2:54:32 ET]
Table 'Whirlpool' 9-max Seat #1 is the button
Seat 1: Perstenev ($14.72 in chips) 
Seat 2: 1Karina1 ($35.82 in chips) 
Seat 3: chiyuki ($37.14 in chips) 
Seat 4: DrunkTyphoon ($32.27 in chips) 
Seat 5: nice.franki ($6.95 in chips) 
Seat 6: kesstukas25 ($18.08 in chips) 
Seat 7: romanian c4 ($4.39 in chips) 
Seat 8: Dejacob ($25 in chips) 
Seat 9: ShockLaMuc ($24.08 in chips) 
1Karina1: posts small blind $0.10
chiyuki: posts big blind $0.25
*** HOLE CARDS ***
Dealt to chiyuki [9h 5d]
DrunkTyphoon: folds 
nice.franki: folds 
kesstukas25: folds 
romanian c4: folds 
Dejacob: raises $0.50 to $0.75
ShockLaMuc: folds 
Perstenev: folds 
1Karina1: folds 
chiyuki: folds 
Uncalled bet ($0.50) returned to Dejacob
Dejacob collected $0.60 from pot
Dejacob: doesn't show hand 
*** SUMMARY ***
Total pot $0.60 | Rake $0 
Seat 1: Perstenev (button) folded before Flop (didn't bet)
Seat 2: 1Karina1 (small blind) folded before Flop
Seat 3: chiyuki (big blind) folded before Flop
Seat 4: DrunkTyphoon folded before Flop (didn't bet)
Seat 5: nice.franki folded before Flop (didn't bet)
Seat 6: kesstukas25 folded before Flop (didn't bet)
Seat 7: romanian c4 folded before Flop (didn't bet)
Seat 8: Dejacob collected ($0.60)
Seat 9: ShockLaMuc folded before Flop (didn't bet)



PokerStars Zoom Hand #84300828295:  Hold'em No Limit ($0.10/$0.25) - 2012/08/05 15:53:48 JST [2012/08/05 2:53:48 ET]
Table 'Whirlpool' 9-max Seat #1 is the button
Seat 1: INSP!RON ($37.54 in chips) 
Seat 2: Silveystryk ($16.44 in chips) 
Seat 3: 4plankton ($21.13 in chips) 
Seat 4: kamikkaze ($22.38 in chips) 
Seat 5: chiyuki ($37.14 in chips) 
Seat 6: munky3 ($25.78 in chips) 
Seat 7: PPP7SSS ($9.43 in chips) 
Seat 8: herkko11 ($11.05 in chips) 
Seat 9: jvds114 ($32.46 in chips) 
Silveystryk: posts small blind $0.10
4plankton: posts big blind $0.25
*** HOLE CARDS ***
Dealt to chiyuki [Tc 3s]
kamikkaze: folds 
chiyuki: folds 
munky3: raises $0.30 to $0.55
PPP7SSS: calls $0.55
herkko11: folds 
jvds114 has timed out
jvds114: folds 
INSP!RON: folds 
Silveystryk: calls $0.45
4plankton: folds 
*** FLOP *** [Js Ks Td]
Silveystryk: checks 
munky3: bets $1.75
PPP7SSS: calls $1.75
Silveystryk: folds 
*** TURN *** [Js Ks Td] [6s]
munky3: bets $3.50
PPP7SSS: raises $3.63 to $7.13 and is all-in
munky3: calls $3.63
*** RIVER *** [Js Ks Td 6s] [6c]
*** SHOW DOWN ***
munky3: shows [Qs Kh] (two pair, Kings and Sixes)
PPP7SSS: shows [Qh 9d] (a straight, Nine to King)
PPP7SSS collected $18.78 from pot
*** SUMMARY ***
Total pot $19.66 | Rake $0.88 
Board [Js Ks Td 6s 6c]
Seat 1: INSP!RON (button) folded before Flop (didn't bet)
Seat 2: Silveystryk (small blind) folded on the Flop
Seat 3: 4plankton (big blind) folded before Flop
Seat 4: kamikkaze folded before Flop (didn't bet)
Seat 5: chiyuki folded before Flop (didn't bet)
Seat 6: munky3 showed [Qs Kh] and lost with two pair, Kings and Sixes
Seat 7: PPP7SSS showed [Qh 9d] and won ($18.78) with a straight, Nine to King
Seat 8: herkko11 folded before Flop (didn't bet)
Seat 9: jvds114 folded before Flop (didn't bet)



PokerStars Zoom Hand #84300838673:  Hold'em No Limit ($0.10/$0.25) - 2012/08/05 15:54:28 JST [2012/08/05 2:54:28 ET]
Table 'Whirlpool' 9-max Seat #1 is the button
Seat 1: snejokCoxx ($11.19 in chips) 
Seat 2: masterkoolb ($13.02 in chips) 
Seat 3: GSDP ($46.43 in chips) 
Seat 4: TorTrade ($25.68 in chips) 
Seat 5: God)Squall ($27.99 in chips) 
Seat 6: chiyuki ($37.14 in chips) 
Seat 7: tribunpdm ($78.41 in chips) 
Seat 8: mjmichi ($37.68 in chips) 
Seat 9: wildy29 ($53.57 in chips) 
masterkoolb: posts small blind $0.10
GSDP: posts big blind $0.25
*** HOLE CARDS ***
Dealt to chiyuki [9h 4d]
TorTrade: folds 
God)Squall: folds 
chiyuki: folds 
tribunpdm: raises $0.50 to $0.75
mjmichi: folds 
wildy29: calls $0.75
snejokCoxx: calls $0.75
masterkoolb: folds 
GSDP: calls $0.50
*** FLOP *** [5h 5c 3h]
GSDP: checks 
tribunpdm: checks 
wildy29: bets $0.50
snejokCoxx: folds 
GSDP: calls $0.50
tribunpdm: calls $0.50
*** TURN *** [5h 5c 3h] [6s]
GSDP: checks 
tribunpdm: checks 
wildy29: checks 
*** RIVER *** [5h 5c 3h 6s] [9s]
GSDP: checks 
tribunpdm: checks 
wildy29: bets $1.50
GSDP: folds 
tribunpdm: calls $1.50
*** SHOW DOWN ***
wildy29: shows [8c Tc] (a pair of Fives)
tribunpdm: shows [7c 7h] (two pair, Sevens and Fives)
tribunpdm collected $7.26 from pot
*** SUMMARY ***
Total pot $7.60 | Rake $0.34 
Board [5h 5c 3h 6s 9s]
Seat 1: snejokCoxx (button) folded on the Flop
Seat 2: masterkoolb (small blind) folded before Flop
Seat 3: GSDP (big blind) folded on the River
Seat 4: TorTrade folded before Flop (didn't bet)
Seat 5: God)Squall folded before Flop (didn't bet)
Seat 6: chiyuki folded before Flop (didn't bet)
Seat 7: tribunpdm showed [7c 7h] and won ($7.26) with two pair, Sevens and Fives
Seat 8: mjmichi folded before Flop (didn't bet)
Seat 9: wildy29 showed [8c Tc] and lost with a pair of Fives



PokerStars Zoom Hand #84300842475:  Hold'em No Limit ($0.10/$0.25) - 2012/08/05 15:54:44 JST [2012/08/05 2:54:44 ET]
Table 'Whirlpool' 9-max Seat #1 is the button
Seat 1: kwkim73 ($25.35 in chips) 
Seat 2: seula i ($50.31 in chips) 
Seat 3: TorTrade ($25.68 in chips) 
Seat 4: chiyuki ($36.89 in chips) 
Seat 5: mjmichi ($37.78 in chips) 
Seat 6: Grishukps ($12.50 in chips) 
Seat 7: ChrisCDee ($58.69 in chips) 
Seat 8: 1Karina1 ($38.87 in chips) 
Seat 9: westhavenbc ($19.83 in chips) 
seula i: posts small blind $0.10
TorTrade: posts big blind $0.25
*** HOLE CARDS ***
Dealt to chiyuki [As Ad]
chiyuki: raises $0.50 to $0.75
mjmichi: folds 
Grishukps: folds 
ChrisCDee: folds 
1Karina1: folds 
westhavenbc: folds 
kwkim73: folds 
seula i: folds 
TorTrade: calls $0.50
*** FLOP *** [Td Tc 7s]
TorTrade: checks 
chiyuki: bets $1
TorTrade: calls $1
*** TURN *** [Td Tc 7s] [Jc]
TorTrade: checks 
chiyuki: bets $1.75
TorTrade: folds 
Uncalled bet ($1.75) returned to chiyuki
chiyuki collected $3.44 from pot
chiyuki: doesn't show hand 
*** SUMMARY ***
Total pot $3.60 | Rake $0.16 
Board [Td Tc 7s Jc]
Seat 1: kwkim73 (button) folded before Flop (didn't bet)
Seat 2: seula i (small blind) folded before Flop
Seat 3: TorTrade (big blind) folded on the Turn
Seat 4: chiyuki collected ($3.44)
Seat 5: mjmichi folded before Flop (didn't bet)
Seat 6: Grishukps folded before Flop (didn't bet)
Seat 7: ChrisCDee folded before Flop (didn't bet)
Seat 8: 1Karina1 folded before Flop (didn't bet)
Seat 9: westhavenbc folded before Flop (didn't bet)



PokerStars Zoom Hand #84300853508:  Hold'em No Limit ($0.10/$0.25) - 2012/08/05 15:55:32 JST [2012/08/05 2:55:32 ET]
Table 'Whirlpool' 9-max Seat #1 is the button
Seat 1: Nerkit ($14.97 in chips) 
Seat 2: chiyuki ($38.58 in chips) 
Seat 3: kwkim73 ($26.03 in chips) 
Seat 4: ChrisCDee ($44.24 in chips) 
Seat 5: MurMurRu ($25.99 in chips) 
Seat 6: seula i ($49.96 in chips) 
Seat 7: pawn909 ($22.88 in chips) 
Seat 8: God)Squall ($27.24 in chips) 
Seat 9: CrittHunter ($29.19 in chips) 
chiyuki: posts small blind $0.10
kwkim73: posts big blind $0.25
*** HOLE CARDS ***
Dealt to chiyuki [Kc Th]
ChrisCDee: folds 
MurMurRu: folds 
seula i: folds 
pawn909: folds 
God)Squall: raises $0.50 to $0.75
CrittHunter: folds 
Nerkit: folds 
chiyuki: folds 
kwkim73: folds 
Uncalled bet ($0.50) returned to God)Squall
God)Squall collected $0.60 from pot
God)Squall: doesn't show hand 
*** SUMMARY ***
Total pot $0.60 | Rake $0 
Seat 1: Nerkit (button) folded before Flop (didn't bet)
Seat 2: chiyuki (small blind) folded before Flop
Seat 3: kwkim73 (big blind) folded before Flop
Seat 4: ChrisCDee folded before Flop (didn't bet)
Seat 5: MurMurRu folded before Flop (didn't bet)
Seat 6: seula i folded before Flop (didn't bet)
Seat 7: pawn909 folded before Flop (didn't bet)
Seat 8: God)Squall collected ($0.60)
Seat 9: CrittHunter folded before Flop (didn't bet)



PokerStars Zoom Hand #84300859203:  Hold'em No Limit ($0.10/$0.25) - 2012/08/05 15:56:00 JST [2012/08/05 2:56:00 ET]
Table 'Whirlpool' 9-max Seat #1 is the button
Seat 1: CrittHunter ($28.84 in chips) 
Seat 2: Rilko1975 ($24.75 in chips) 
Seat 3: pandaaaaaa ($14.90 in chips) 
Seat 4: kesstukas25 ($17.46 in chips) 
Seat 5: chiyuki ($38.48 in chips) 
Seat 6: 4plankton ($19.88 in chips) 
Seat 7: kwkim73 ($25 in chips) 
Seat 8: slapshot2011 ($18.52 in chips) 
Seat 9: KrystalAA ($25.64 in chips) 
Rilko1975: posts small blind $0.10
pandaaaaaa: posts big blind $0.25
*** HOLE CARDS ***
Dealt to chiyuki [3s Qc]
kesstukas25: folds 
chiyuki: folds 
4plankton: folds 
kwkim73: folds 
slapshot2011: folds 
KrystalAA: raises $0.64 to $0.89
CrittHunter: calls $0.89
Rilko1975: folds 
pandaaaaaa: folds 
*** FLOP *** [Td Jc 6h]
KrystalAA: bets $2.17
CrittHunter: folds 
Uncalled bet ($2.17) returned to KrystalAA
KrystalAA collected $2.03 from pot
KrystalAA: doesn't show hand 
*** SUMMARY ***
Total pot $2.13 | Rake $0.10 
Board [Td Jc 6h]
Seat 1: CrittHunter (button) folded on the Flop
Seat 2: Rilko1975 (small blind) folded before Flop
Seat 3: pandaaaaaa (big blind) folded before Flop
Seat 4: kesstukas25 folded before Flop (didn't bet)
Seat 5: chiyuki folded before Flop (didn't bet)
Seat 6: 4plankton folded before Flop (didn't bet)
Seat 7: kwkim73 folded before Flop (didn't bet)
Seat 8: slapshot2011 folded before Flop (didn't bet)
Seat 9: KrystalAA collected ($2.03)



PokerStars Zoom Hand #84300858131:  Hold'em No Limit ($0.10/$0.25) - 2012/08/05 15:55:54 JST [2012/08/05 2:55:54 ET]
Table 'Whirlpool' 9-max Seat #1 is the button
Seat 1: Perstenev ($13.47 in chips) 
Seat 2: Komissar82 ($11.95 in chips) 
Seat 3: 6nikola9 ($19.84 in chips) 
Seat 4: River_GmbH ($21.44 in chips) 
Seat 5: Nerkit ($9 in chips) 
Seat 6: Femali54 ($24.85 in chips) 
Seat 7: Grishukps ($12.50 in chips) 
Seat 8: chiyuki ($38.48 in chips) 
Seat 9: leo2095 ($27.75 in chips) 
Komissar82: posts small blind $0.10
6nikola9: posts big blind $0.25
*** HOLE CARDS ***
Dealt to chiyuki [8d 2h]
River_GmbH: folds 
Nerkit: folds 
Femali54: folds 
Grishukps: folds 
chiyuki: folds 
leo2095: folds 
Perstenev: folds 
Komissar82: calls $0.15
6nikola9: raises $0.50 to $0.75
Komissar82: calls $0.50
*** FLOP *** [Th 4h 6s]
Komissar82: checks 
6nikola9: checks 
*** TURN *** [Th 4h 6s] [5d]
Komissar82: bets $0.25
6nikola9: calls $0.25
*** RIVER *** [Th 4h 6s 5d] [2c]
Komissar82: bets $0.50
6nikola9: raises $0.50 to $1
Komissar82: folds 
Uncalled bet ($0.50) returned to 6nikola9
6nikola9 collected $2.86 from pot
6nikola9: doesn't show hand 
*** SUMMARY ***
Total pot $3 | Rake $0.14 
Board [Th 4h 6s 5d 2c]
Seat 1: Perstenev (button) folded before Flop (didn't bet)
Seat 2: Komissar82 (small blind) folded on the River
Seat 3: 6nikola9 (big blind) collected ($2.86)
Seat 4: River_GmbH folded before Flop (didn't bet)
Seat 5: Nerkit folded before Flop (didn't bet)
Seat 6: Femali54 folded before Flop (didn't bet)
Seat 7: Grishukps folded before Flop (didn't bet)
Seat 8: chiyuki folded before Flop (didn't bet)
Seat 9: leo2095 folded before Flop (didn't bet)



PokerStars Zoom Hand #84300866138:  Hold'em No Limit ($0.10/$0.25) - 2012/08/05 15:56:33 JST [2012/08/05 2:56:33 ET]
Table 'Whirlpool' 9-max Seat #1 is the button
Seat 1: Saruotiss ($61.51 in chips) 
Seat 2: MurMurRu ($25.35 in chips) 
Seat 3: rey2040 ($13.90 in chips) 
Seat 4: seula i ($49.86 in chips) 
Seat 5: slapshot2011 ($18.84 in chips) 
Seat 6: CrittHunter ($27.95 in chips) 
Seat 7: chiyuki ($38.48 in chips) 
Seat 8: jacquelinewu ($32.46 in chips) 
Seat 9: nice.franki ($11.63 in chips) 
MurMurRu: posts small blind $0.10
rey2040: posts big blind $0.25
*** HOLE CARDS ***
Dealt to chiyuki [Ks 8d]
seula i: folds 
slapshot2011: folds 
CrittHunter: folds 
chiyuki: folds 
jacquelinewu: raises $0.50 to $0.75
nice.franki: raises $1.25 to $2
Saruotiss: folds 
MurMurRu: folds 
rey2040: folds 
jacquelinewu: folds 
Uncalled bet ($1.25) returned to nice.franki
nice.franki collected $1.85 from pot
nice.franki: doesn't show hand 
*** SUMMARY ***
Total pot $1.85 | Rake $0 
Seat 1: Saruotiss (button) folded before Flop (didn't bet)
Seat 2: MurMurRu (small blind) folded before Flop
Seat 3: rey2040 (big blind) folded before Flop
Seat 4: seula i folded before Flop (didn't bet)
Seat 5: slapshot2011 folded before Flop (didn't bet)
Seat 6: CrittHunter folded before Flop (didn't bet)
Seat 7: chiyuki folded before Flop (didn't bet)
Seat 8: jacquelinewu folded before Flop
Seat 9: nice.franki collected ($1.85)



PokerStars Zoom Hand #84300869279:  Hold'em No Limit ($0.10/$0.25) - 2012/08/05 15:56:48 JST [2012/08/05 2:56:48 ET]
Table 'Whirlpool' 9-max Seat #1 is the button
Seat 1: PPP7SSS ($29.73 in chips) 
Seat 2: slapshot2011 ($18.84 in chips) 
Seat 3: INSP!RON ($31.81 in chips) 
Seat 4: romanian c4 ($11.25 in chips) 
Seat 5: Grishukps ($12.90 in chips) 
Seat 6: nice.franki ($6.25 in chips) 
Seat 7: phate-1up ($40.58 in chips) 
Seat 8: chiyuki ($38.23 in chips) 
Seat 9: schoof 2 ($25.26 in chips) 
slapshot2011: posts small blind $0.10
INSP!RON: posts big blind $0.25
*** HOLE CARDS ***
Dealt to chiyuki [Jh 7d]
romanian c4: folds 
Grishukps: folds 
nice.franki: folds 
phate-1up: folds 
chiyuki: folds 
schoof 2: raises $0.50 to $0.75
PPP7SSS: folds 
slapshot2011: folds 
INSP!RON: folds 
Uncalled bet ($0.50) returned to schoof 2
schoof 2 collected $0.60 from pot
schoof 2: doesn't show hand 
*** SUMMARY ***
Total pot $0.60 | Rake $0 
Seat 1: PPP7SSS (button) folded before Flop (didn't bet)
Seat 2: slapshot2011 (small blind) folded before Flop
Seat 3: INSP!RON (big blind) folded before Flop
Seat 4: romanian c4 folded before Flop (didn't bet)
Seat 5: Grishukps folded before Flop (didn't bet)
Seat 6: nice.franki folded before Flop (didn't bet)
Seat 7: phate-1up folded before Flop (didn't bet)
Seat 8: chiyuki folded before Flop (didn't bet)
Seat 9: schoof 2 collected ($0.60)



PokerStars Zoom Hand #84300867172:  Hold'em No Limit ($0.10/$0.25) - 2012/08/05 15:56:38 JST [2012/08/05 2:56:38 ET]
Table 'Whirlpool' 9-max Seat #1 is the button
Seat 1: KrystalAA ($13.31 in chips) 
Seat 2: Ellen1947 ($29.80 in chips) 
Seat 3: chiyuki ($38.48 in chips) 
Seat 4: CrittHunter ($27.95 in chips) 
Seat 5: INSP!RON ($31.81 in chips) 
Seat 6: snejokCoxx ($11.50 in chips) 
Seat 7: laurentzu84 ($26.02 in chips) 
Seat 8: GovGus ($32.76 in chips) 
Seat 9: Perstenev ($11.05 in chips) 
Ellen1947: posts small blind $0.10
chiyuki: posts big blind $0.25
*** HOLE CARDS ***
Dealt to chiyuki [Qs 3s]
CrittHunter: raises $0.50 to $0.75
INSP!RON: folds 
snejokCoxx: folds 
laurentzu84: folds 
GovGus: calls $0.75
Perstenev: folds 
KrystalAA: calls $0.75
Ellen1947: folds 
chiyuki: folds 
*** FLOP *** [As 2d 2h]
CrittHunter: checks 
GovGus: bets $1.50
KrystalAA: folds 
CrittHunter: folds 
Uncalled bet ($1.50) returned to GovGus
GovGus collected $2.48 from pot
GovGus: doesn't show hand 
*** SUMMARY ***
Total pot $2.60 | Rake $0.12 
Board [As 2d 2h]
Seat 1: KrystalAA (button) folded on the Flop
Seat 2: Ellen1947 (small blind) folded before Flop
Seat 3: chiyuki (big blind) folded before Flop
Seat 4: CrittHunter folded on the Flop
Seat 5: INSP!RON folded before Flop (didn't bet)
Seat 6: snejokCoxx folded before Flop (didn't bet)
Seat 7: laurentzu84 folded before Flop (didn't bet)
Seat 8: GovGus collected ($2.48)
Seat 9: Perstenev folded before Flop (didn't bet)



PokerStars Zoom Hand #84300870414:  Hold'em No Limit ($0.10/$0.25) - 2012/08/05 15:56:53 JST [2012/08/05 2:56:53 ET]
Table 'Whirlpool' 9-max Seat #1 is the button
Seat 1: slapshot2011 ($18.74 in chips) 
Seat 2: ChrisCDee ($58.09 in chips) 
Seat 3: 1Karina1 ($35.37 in chips) 
Seat 4: Silveystryk ($15.14 in chips) 
Seat 5: Perstenev ($12.97 in chips) 
Seat 6: chiyuki ($38.23 in chips) 
Seat 7: hldtom ($12.50 in chips) 
Seat 8: kwkim73 ($26.03 in chips) 
Seat 9: westhavenbc ($16.86 in chips) 
ChrisCDee: posts small blind $0.10
1Karina1: posts big blind $0.25
*** HOLE CARDS ***
Dealt to chiyuki [8h 4d]
Silveystryk: folds 
Perstenev: folds 
chiyuki: folds 
hldtom: raises $0.50 to $0.75
kwkim73: folds 
westhavenbc: folds 
slapshot2011: folds 
ChrisCDee: folds 
1Karina1: folds 
Uncalled bet ($0.50) returned to hldtom
hldtom collected $0.60 from pot
hldtom: doesn't show hand 
*** SUMMARY ***
Total pot $0.60 | Rake $0 
Seat 1: slapshot2011 (button) folded before Flop (didn't bet)
Seat 2: ChrisCDee (small blind) folded before Flop
Seat 3: 1Karina1 (big blind) folded before Flop
Seat 4: Silveystryk folded before Flop (didn't bet)
Seat 5: Perstenev folded before Flop (didn't bet)
Seat 6: chiyuki folded before Flop (didn't bet)
Seat 7: hldtom collected ($0.60)
Seat 8: kwkim73 folded before Flop (didn't bet)
Seat 9: westhavenbc folded before Flop (didn't bet)



PokerStars Zoom Hand #84300871474:  Hold'em No Limit ($0.10/$0.25) - 2012/08/05 15:56:58 JST [2012/08/05 2:56:58 ET]
Table 'Whirlpool' 9-max Seat #1 is the button
Seat 1: nice.franki ($7.53 in chips) 
Seat 2: chiyuki ($38.23 in chips) 
Seat 3: MurMurRu ($27.36 in chips) 
Seat 4: JhonnyP1979 ($18.97 in chips) 
Seat 5: ChrisCDee ($57.99 in chips) 
Seat 6: masterkoolb ($18.29 in chips) 
Seat 7: phate-1up ($60.47 in chips) 
Seat 8: Trip_Krowns ($33.91 in chips) 
Seat 9: jvds114 ($41.01 in chips) 
chiyuki: posts small blind $0.10
MurMurRu: posts big blind $0.25
*** HOLE CARDS ***
Dealt to chiyuki [3s 3c]
JhonnyP1979: raises $0.37 to $0.62
ChrisCDee: folds 
masterkoolb: raises $1.59 to $2.21
phate-1up: folds 
Trip_Krowns: folds 
jvds114: folds 
nice.franki: folds 
chiyuki: folds 
MurMurRu: folds 
JhonnyP1979: folds 
Uncalled bet ($1.59) returned to masterkoolb
masterkoolb collected $1.59 from pot
masterkoolb: doesn't show hand 
*** SUMMARY ***
Total pot $1.59 | Rake $0 
Seat 1: nice.franki (button) folded before Flop (didn't bet)
Seat 2: chiyuki (small blind) folded before Flop
Seat 3: MurMurRu (big blind) folded before Flop
Seat 4: JhonnyP1979 folded before Flop
Seat 5: ChrisCDee folded before Flop (didn't bet)
Seat 6: masterkoolb collected ($1.59)
Seat 7: phate-1up folded before Flop (didn't bet)
Seat 8: Trip_Krowns folded before Flop (didn't bet)
Seat 9: jvds114 folded before Flop (didn't bet)



PokerStars Zoom Hand #84300861708:  Hold'em No Limit ($0.10/$0.25) - 2012/08/05 15:56:12 JST [2012/08/05 2:56:12 ET]
Table 'Whirlpool' 9-max Seat #1 is the button
Seat 1: chiyuki ($38.48 in chips) 
Seat 2: Robert39 ($21.26 in chips) 
Seat 3: HighDuka ($30.66 in chips) 
Seat 4: Perstenev ($18.92 in chips) 
Seat 5: phate-1up ($40.68 in chips) 
Seat 6: 1Karina1 ($25 in chips) 
Seat 7: JhonnyP1979 ($15.73 in chips) 
Seat 8: MurMurRu ($25.35 in chips) 
Seat 9: Alvinpe85 ($72.68 in chips) 
Robert39: posts small blind $0.10
HighDuka: posts big blind $0.25
*** HOLE CARDS ***
Dealt to chiyuki [Ad 7d]
Perstenev: folds 
phate-1up: folds 
1Karina1: folds 
JhonnyP1979: folds 
MurMurRu: folds 
Alvinpe85: raises $0.37 to $0.62
chiyuki: folds 
Robert39: raises $0.63 to $1.25
HighDuka: calls $1
Alvinpe85: raises $2.75 to $4
Robert39: calls $2.75
HighDuka: calls $2.75
*** FLOP *** [Js Ks 4d]
Robert39: checks 
HighDuka: folds 
Alvinpe85: bets $6
Robert39: calls $6
*** TURN *** [Js Ks 4d] [Jd]
Robert39: checks 
Alvinpe85: checks 
*** RIVER *** [Js Ks 4d Jd] [8h]
Robert39: bets $11.26 and is all-in
Alvinpe85: calls $11.26
*** SHOW DOWN ***
Robert39: shows [As Qh] (a pair of Jacks)
Alvinpe85: shows [Kd Kh] (a full house, Kings full of Jacks)
Alvinpe85 collected $44.52 from pot
*** SUMMARY ***
Total pot $46.52 | Rake $2 
Board [Js Ks 4d Jd 8h]
Seat 1: chiyuki (button) folded before Flop (didn't bet)
Seat 2: Robert39 (small blind) showed [As Qh] and lost with a pair of Jacks
Seat 3: HighDuka (big blind) folded on the Flop
Seat 4: Perstenev folded before Flop (didn't bet)
Seat 5: phate-1up folded before Flop (didn't bet)
Seat 6: 1Karina1 folded before Flop (didn't bet)
Seat 7: JhonnyP1979 folded before Flop (didn't bet)
Seat 8: MurMurRu folded before Flop (didn't bet)
Seat 9: Alvinpe85 showed [Kd Kh] and won ($44.52) with a full house, Kings full of Jacks



PokerStars Zoom Hand #84300874185:  Hold'em No Limit ($0.10/$0.25) - 2012/08/05 15:57:12 JST [2012/08/05 2:57:12 ET]
Table 'Whirlpool' 9-max Seat #1 is the button
Seat 1: yoube ($29.67 in chips) 
Seat 2: Perstenev ($11.05 in chips) 
Seat 3: GovGus ($34.49 in chips) 
Seat 4: Bahia gyn ($19.62 in chips) 
Seat 5: westhavenbc ($16.86 in chips) 
Seat 6: Limoilou ($25.48 in chips) 
Seat 7: Grishukps ($12.50 in chips) 
Seat 8: Nerkit ($11.83 in chips) 
Seat 9: chiyuki ($38.13 in chips) 
Perstenev: posts small blind $0.10
GovGus: posts big blind $0.25
*** HOLE CARDS ***
Dealt to chiyuki [Kh 4c]
Bahia gyn: folds 
westhavenbc: folds 
Limoilou: folds 
Grishukps: folds 
Nerkit: folds 
chiyuki: folds 
yoube: folds 
Perstenev: folds 
Uncalled bet ($0.15) returned to GovGus
GovGus collected $0.20 from pot
GovGus: doesn't show hand 
*** SUMMARY ***
Total pot $0.20 | Rake $0 
Seat 1: yoube (button) folded before Flop (didn't bet)
Seat 2: Perstenev (small blind) folded before Flop
Seat 3: GovGus (big blind) collected ($0.20)
Seat 4: Bahia gyn folded before Flop (didn't bet)
Seat 5: westhavenbc folded before Flop (didn't bet)
Seat 6: Limoilou folded before Flop (didn't bet)
Seat 7: Grishukps folded before Flop (didn't bet)
Seat 8: Nerkit folded before Flop (didn't bet)
Seat 9: chiyuki folded before Flop (didn't bet)



PokerStars Zoom Hand #84300875065:  Hold'em No Limit ($0.10/$0.25) - 2012/08/05 15:57:16 JST [2012/08/05 2:57:16 ET]
Table 'Whirlpool' 9-max Seat #1 is the button
Seat 1: boboshooter ($23.50 in chips) 
Seat 2: yoube ($29.67 in chips) 
Seat 3: kwkim73 ($26.03 in chips) 
Seat 4: Trip_Krowns ($33.91 in chips) 
Seat 5: seula i ($47.06 in chips) 
Seat 6: chiyuki ($38.13 in chips) 
Seat 7: kesstukas25 ($16.71 in chips) 
Seat 8: KrystalAA ($12.56 in chips) 
Seat 9: phate-1up ($57.58 in chips) 
yoube: posts small blind $0.10
kwkim73: posts big blind $0.25
*** HOLE CARDS ***
Dealt to chiyuki [Qd 6s]
Trip_Krowns: raises $0.50 to $0.75
seula i: folds 
chiyuki: folds 
kesstukas25: folds 
KrystalAA: folds 
phate-1up: folds 
boboshooter: folds 
yoube: folds 
kwkim73: folds 
Uncalled bet ($0.50) returned to Trip_Krowns
Trip_Krowns collected $0.60 from pot
Trip_Krowns: doesn't show hand 
*** SUMMARY ***
Total pot $0.60 | Rake $0 
Seat 1: boboshooter (button) folded before Flop (didn't bet)
Seat 2: yoube (small blind) folded before Flop
Seat 3: kwkim73 (big blind) folded before Flop
Seat 4: Trip_Krowns collected ($0.60)
Seat 5: seula i folded before Flop (didn't bet)
Seat 6: chiyuki folded before Flop (didn't bet)
Seat 7: kesstukas25 folded before Flop (didn't bet)
Seat 8: KrystalAA folded before Flop (didn't bet)
Seat 9: phate-1up folded before Flop (didn't bet)



PokerStars Zoom Hand #84300865079:  Hold'em No Limit ($0.10/$0.25) - 2012/08/05 15:56:28 JST [2012/08/05 2:56:28 ET]
Table 'Whirlpool' 9-max Seat #1 is the button
Seat 1: GovGus ($28.87 in chips) 
Seat 2: munky3 ($28.13 in chips) 
Seat 3: phate-1up ($57.71 in chips) 
Seat 4: wildy29 ($52.06 in chips) 
Seat 5: kwkim73 ($25.35 in chips) 
Seat 6: AAAKK777 ($12.86 in chips) 
Seat 7: Grishukps ($12.60 in chips) 
Seat 8: TorTrade ($21.85 in chips) 
Seat 9: chiyuki ($38.48 in chips) 
munky3: posts small blind $0.10
phate-1up: posts big blind $0.25
*** HOLE CARDS ***
Dealt to chiyuki [Ks 5c]
wildy29: calls $0.25
kwkim73: folds 
AAAKK777: folds 
Grishukps: folds 
TorTrade: folds 
chiyuki: folds 
GovGus: raises $0.75 to $1
munky3: folds 
phate-1up: folds 
wildy29: calls $0.75
*** FLOP *** [9c Th Ah]
wildy29: checks 
GovGus: checks 
*** TURN *** [9c Th Ah] [6d]
wildy29: bets $0.25
GovGus: raises $0.75 to $1
wildy29: calls $0.75
*** RIVER *** [9c Th Ah 6d] [Ad]
wildy29: bets $2.50
GovGus: calls $2.50
*** SHOW DOWN ***
wildy29: shows [9d As] (a full house, Aces full of Nines)
GovGus: mucks hand 
wildy29 collected $8.93 from pot
*** SUMMARY ***
Total pot $9.35 | Rake $0.42 
Board [9c Th Ah 6d Ad]
Seat 1: GovGus (button) mucked [Kh Kc]
Seat 2: munky3 (small blind) folded before Flop
Seat 3: phate-1up (big blind) folded before Flop
Seat 4: wildy29 showed [9d As] and won ($8.93) with a full house, Aces full of Nines
Seat 5: kwkim73 folded before Flop (didn't bet)
Seat 6: AAAKK777 folded before Flop (didn't bet)
Seat 7: Grishukps folded before Flop (didn't bet)
Seat 8: TorTrade folded before Flop (didn't bet)
Seat 9: chiyuki folded before Flop (didn't bet)



PokerStars Zoom Hand #84300876590:  Hold'em No Limit ($0.10/$0.25) - 2012/08/05 15:57:23 JST [2012/08/05 2:57:23 ET]
Table 'Whirlpool' 9-max Seat #1 is the button
Seat 1: Dan Royal ($33.23 in chips) 
Seat 2: risekuku468 ($33.81 in chips) 
Seat 3: INSP!RON ($39.46 in chips) 
Seat 4: DrunkTyphoon ($37.66 in chips) 
Seat 5: chiyuki ($38.13 in chips) 
Seat 6: kesstukas25 ($16.71 in chips) 
Seat 7: hldtom ($42.92 in chips) 
Seat 8: FoRlan77 ($28.68 in chips) 
Seat 9: Dionisko ($12.50 in chips) 
risekuku468: posts small blind $0.10
INSP!RON: posts big blind $0.25
*** HOLE CARDS ***
Dealt to chiyuki [3s 9s]
DrunkTyphoon: folds 
chiyuki: folds 
kesstukas25: folds 
hldtom: calls $0.25
FoRlan77: folds 
Dionisko: folds 
Dan Royal: raises $0.75 to $1
risekuku468: folds 
INSP!RON: folds 
hldtom: folds 
Uncalled bet ($0.75) returned to Dan Royal
Dan Royal collected $0.85 from pot
Dan Royal: doesn't show hand 
*** SUMMARY ***
Total pot $0.85 | Rake $0 
Seat 1: Dan Royal (button) collected ($0.85)
Seat 2: risekuku468 (small blind) folded before Flop
Seat 3: INSP!RON (big blind) folded before Flop
Seat 4: DrunkTyphoon folded before Flop (didn't bet)
Seat 5: chiyuki folded before Flop (didn't bet)
Seat 6: kesstukas25 folded before Flop (didn't bet)
Seat 7: hldtom folded before Flop
Seat 8: FoRlan77 folded before Flop (didn't bet)
Seat 9: Dionisko folded before Flop (didn't bet)



PokerStars Zoom Hand #84300881866:  Hold'em No Limit ($0.10/$0.25) - 2012/08/05 15:57:47 JST [2012/08/05 2:57:47 ET]
Table 'Whirlpool' 9-max Seat #1 is the button
Seat 1: xxASSO124xx ($12.25 in chips) 
Seat 2: romanian c4 ($11 in chips) 
Seat 3: GovGus ($25 in chips) 
Seat 4: chiyuki ($38.13 in chips) 
Seat 5: Perstenev ($14.69 in chips) 
Seat 6: Dejacob ($25.10 in chips) 
Seat 7: Silveystryk ($43.76 in chips) 
Seat 8: hldtom ($12.85 in chips) 
Seat 9: Serge Claws ($61.13 in chips) 
romanian c4: posts small blind $0.10
GovGus: posts big blind $0.25
*** HOLE CARDS ***
Dealt to chiyuki [8s Qh]
chiyuki: folds 
Perstenev: folds 
Dejacob: folds 
Silveystryk: folds 
hldtom: folds 
Serge Claws: folds 
xxASSO124xx: raises $0.50 to $0.75
romanian c4: raises $10.25 to $11 and is all-in
GovGus: folds 
xxASSO124xx: folds 
Uncalled bet ($10.25) returned to romanian c4
romanian c4 collected $1.75 from pot
romanian c4: doesn't show hand 
*** SUMMARY ***
Total pot $1.75 | Rake $0 
Seat 1: xxASSO124xx (button) folded before Flop
Seat 2: romanian c4 (small blind) collected ($1.75)
Seat 3: GovGus (big blind) folded before Flop
Seat 4: chiyuki folded before Flop (didn't bet)
Seat 5: Perstenev folded before Flop (didn't bet)
Seat 6: Dejacob folded before Flop (didn't bet)
Seat 7: Silveystryk folded before Flop (didn't bet)
Seat 8: hldtom folded before Flop (didn't bet)
Seat 9: Serge Claws folded before Flop (didn't bet)



PokerStars Zoom Hand #84300882717:  Hold'em No Limit ($0.10/$0.25) - 2012/08/05 15:57:51 JST [2012/08/05 2:57:51 ET]
Table 'Whirlpool' 9-max Seat #1 is the button
Seat 1: pawn909 ($21.08 in chips) 
Seat 2: Dejacob ($25.10 in chips) 
Seat 3: seula i ($73.07 in chips) 
Seat 4: hldtom ($42.67 in chips) 
Seat 5: yvasilik ($23.83 in chips) 
Seat 6: ShockLaMuc ($22.90 in chips) 
Seat 7: chiyuki ($38.13 in chips) 
Seat 8: slapshot2011 ($18.74 in chips) 
Seat 9: Silveystryk ($29.91 in chips) 
Dejacob: posts small blind $0.10
seula i: posts big blind $0.25
*** HOLE CARDS ***
Dealt to chiyuki [Jc Ad]
hldtom: folds 
yvasilik: raises $0.50 to $0.75
ShockLaMuc: folds 
chiyuki: folds 
slapshot2011: folds 
Silveystryk: folds 
pawn909: folds 
Dejacob: folds 
seula i: folds 
Uncalled bet ($0.50) returned to yvasilik
yvasilik collected $0.60 from pot
yvasilik: doesn't show hand 
*** SUMMARY ***
Total pot $0.60 | Rake $0 
Seat 1: pawn909 (button) folded before Flop (didn't bet)
Seat 2: Dejacob (small blind) folded before Flop
Seat 3: seula i (big blind) folded before Flop
Seat 4: hldtom folded before Flop (didn't bet)
Seat 5: yvasilik collected ($0.60)
Seat 6: ShockLaMuc folded before Flop (didn't bet)
Seat 7: chiyuki folded before Flop (didn't bet)
Seat 8: slapshot2011 folded before Flop (didn't bet)
Seat 9: Silveystryk folded before Flop (didn't bet)



PokerStars Zoom Hand #84300886147:  Hold'em No Limit ($0.10/$0.25) - 2012/08/05 15:58:07 JST [2012/08/05 2:58:07 ET]
Table 'Whirlpool' 9-max Seat #1 is the button
Seat 1: Trip_Krowns ($33.51 in chips) 
Seat 2: kwkim73 ($37.41 in chips) 
Seat 3: nice.franki ($12.40 in chips) 
Seat 4: chiyuki ($38.13 in chips) 
Seat 5: Dejacob ($43.09 in chips) 
Seat 6: INSP!RON ($38.85 in chips) 
Seat 7: Fructionar ($34.72 in chips) 
Seat 8: westhavenbc ($18.47 in chips) 
Seat 9: GovGus ($25 in chips) 
kwkim73: posts small blind $0.10
nice.franki: posts big blind $0.25
*** HOLE CARDS ***
Dealt to chiyuki [7h 9s]
chiyuki: folds 
Dejacob: folds 
INSP!RON: folds 
Fructionar: folds 
westhavenbc: folds 
GovGus: folds 
Trip_Krowns: folds 
kwkim73: folds 
Uncalled bet ($0.15) returned to nice.franki
nice.franki collected $0.20 from pot
nice.franki: doesn't show hand 
*** SUMMARY ***
Total pot $0.20 | Rake $0 
Seat 1: Trip_Krowns (button) folded before Flop (didn't bet)
Seat 2: kwkim73 (small blind) folded before Flop
Seat 3: nice.franki (big blind) collected ($0.20)
Seat 4: chiyuki folded before Flop (didn't bet)
Seat 5: Dejacob folded before Flop (didn't bet)
Seat 6: INSP!RON folded before Flop (didn't bet)
Seat 7: Fructionar folded before Flop (didn't bet)
Seat 8: westhavenbc folded before Flop (didn't bet)
Seat 9: GovGus folded before Flop (didn't bet)



PokerStars Zoom Hand #84300890917:  Hold'em No Limit ($0.10/$0.25) - 2012/08/05 15:58:30 JST [2012/08/05 2:58:30 ET]
Table 'Whirlpool' 9-max Seat #1 is the button
Seat 1: Ellen1947 ($28.83 in chips) 
Seat 2: chiyuki ($37.88 in chips) 
Seat 3: kkbruins0408 ($10.19 in chips) 
Seat 4: Alvinpe85 ($95.59 in chips) 
Seat 5: DrunkTyphoon ($28.28 in chips) 
Seat 6: seula i ($72.82 in chips) 
Seat 7: Dan Royal ($33.48 in chips) 
Seat 8: NoWurriz ($18.88 in chips) 
Seat 9: Perstenev ($14.69 in chips) 
chiyuki: posts small blind $0.10
kkbruins0408: posts big blind $0.25
*** HOLE CARDS ***
Dealt to chiyuki [2s 7s]
Alvinpe85: folds 
DrunkTyphoon: folds 
seula i: folds 
Dan Royal: folds 
NoWurriz: folds 
Perstenev: folds 
Ellen1947: raises $0.25 to $0.50
chiyuki: folds 
kkbruins0408: folds 
Uncalled bet ($0.25) returned to Ellen1947
Ellen1947 collected $0.60 from pot
Ellen1947: doesn't show hand 
*** SUMMARY ***
Total pot $0.60 | Rake $0 
Seat 1: Ellen1947 (button) collected ($0.60)
Seat 2: chiyuki (small blind) folded before Flop
Seat 3: kkbruins0408 (big blind) folded before Flop
Seat 4: Alvinpe85 folded before Flop (didn't bet)
Seat 5: DrunkTyphoon folded before Flop (didn't bet)
Seat 6: seula i folded before Flop (didn't bet)
Seat 7: Dan Royal folded before Flop (didn't bet)
Seat 8: NoWurriz folded before Flop (didn't bet)
Seat 9: Perstenev folded before Flop (didn't bet)



PokerStars Zoom Hand #84300890075:  Hold'em No Limit ($0.10/$0.25) - 2012/08/05 15:58:26 JST [2012/08/05 2:58:26 ET]
Table 'Whirlpool' 9-max Seat #1 is the button
Seat 1: Dan Royal ($33.48 in chips) 
Seat 2: EvgenyBaikov ($23.95 in chips) 
Seat 3: deepakmbh ($25 in chips) 
Seat 4: snejokCoxx ($9.23 in chips) 
Seat 5: tribunpdm ($67.87 in chips) 
Seat 6: boboshooter ($24.87 in chips) 
Seat 7: chiyuki ($37.88 in chips) 
Seat 8: Perstenev ($17.29 in chips) 
Seat 9: kwkim73 ($26.13 in chips) 
EvgenyBaikov: posts small blind $0.10
deepakmbh: posts big blind $0.25
*** HOLE CARDS ***
Dealt to chiyuki [3h 6c]
snejokCoxx: folds 
tribunpdm: folds 
boboshooter: folds 
chiyuki: folds 
Perstenev: folds 
kwkim73: folds 
Dan Royal: folds 
EvgenyBaikov: calls $0.15
deepakmbh: checks 
*** FLOP *** [4d 8d Jd]
EvgenyBaikov: bets $0.75
deepakmbh: folds 
Uncalled bet ($0.75) returned to EvgenyBaikov
EvgenyBaikov collected $0.48 from pot
EvgenyBaikov: doesn't show hand 
*** SUMMARY ***
Total pot $0.50 | Rake $0.02 
Board [4d 8d Jd]
Seat 1: Dan Royal (button) folded before Flop (didn't bet)
Seat 2: EvgenyBaikov (small blind) collected ($0.48)
Seat 3: deepakmbh (big blind) folded on the Flop
Seat 4: snejokCoxx folded before Flop (didn't bet)
Seat 5: tribunpdm folded before Flop (didn't bet)
Seat 6: boboshooter folded before Flop (didn't bet)
Seat 7: chiyuki folded before Flop (didn't bet)
Seat 8: Perstenev folded before Flop (didn't bet)
Seat 9: kwkim73 folded before Flop (didn't bet)



PokerStars Zoom Hand #84300892679:  Hold'em No Limit ($0.10/$0.25) - 2012/08/05 15:58:38 JST [2012/08/05 2:58:38 ET]
Table 'Whirlpool' 9-max Seat #1 is the button
Seat 1: laurentzu84 ($31.50 in chips) 
Seat 2: Grishukps ($12.50 in chips) 
Seat 3: ShockLaMuc ($15.85 in chips) 
Seat 4: Serge Claws ($28.40 in chips) 
Seat 5: seula i ($72.82 in chips) 
Seat 6: slapshot2011 ($18.24 in chips) 
Seat 7: westhavenbc ($18.37 in chips) 
Seat 8: Afcawins25 ($16.59 in chips) 
Seat 9: chiyuki ($37.78 in chips) 
Grishukps: posts small blind $0.10
ShockLaMuc: posts big blind $0.25
*** HOLE CARDS ***
Dealt to chiyuki [5h 9d]
Serge Claws: folds 
seula i: folds 
slapshot2011: folds 
westhavenbc: folds 
Afcawins25: folds 
chiyuki: folds 
laurentzu84: folds 
Grishukps: folds 
Uncalled bet ($0.15) returned to ShockLaMuc
ShockLaMuc collected $0.20 from pot
ShockLaMuc: doesn't show hand 
*** SUMMARY ***
Total pot $0.20 | Rake $0 
Seat 1: laurentzu84 (button) folded before Flop (didn't bet)
Seat 2: Grishukps (small blind) folded before Flop
Seat 3: ShockLaMuc (big blind) collected ($0.20)
Seat 4: Serge Claws folded before Flop (didn't bet)
Seat 5: seula i folded before Flop (didn't bet)
Seat 6: slapshot2011 folded before Flop (didn't bet)
Seat 7: westhavenbc folded before Flop (didn't bet)
Seat 8: Afcawins25 folded before Flop (didn't bet)
Seat 9: chiyuki folded before Flop (didn't bet)



PokerStars Zoom Hand #84300877462:  Hold'em No Limit ($0.10/$0.25) - 2012/08/05 15:57:27 JST [2012/08/05 2:57:27 ET]
Table 'Whirlpool' 9-max Seat #1 is the button
Seat 1: chiyuki ($38.13 in chips) 
Seat 2: jacquelinewu ($25.62 in chips) 
Seat 3: phate-1up ($60.37 in chips) 
Seat 4: schoof 2 ($25.51 in chips) 
Seat 5: dergeb ($17.09 in chips) 
Seat 6: KrystalAA ($12.56 in chips) 
Seat 7: FoRlan77 ($28.68 in chips) 
Seat 8: Dionisko ($12.50 in chips) 
Seat 9: DrunkTyphoon ($37.66 in chips) 
jacquelinewu: posts small blind $0.10
phate-1up: posts big blind $0.25
*** HOLE CARDS ***
Dealt to chiyuki [6h 5h]
schoof 2: calls $0.25
dergeb: folds 
KrystalAA: folds 
FoRlan77: folds 
Dionisko: folds 
DrunkTyphoon: folds 
chiyuki: folds 
jacquelinewu: raises $1.25 to $1.50
phate-1up: folds 
schoof 2: calls $1.25
*** FLOP *** [5d 7d Jh]
jacquelinewu: checks 
schoof 2: bets $1.75
jacquelinewu: calls $1.75
*** TURN *** [5d 7d Jh] [5c]
jacquelinewu: checks 
schoof 2: bets $2.75
jacquelinewu: folds 
Uncalled bet ($2.75) returned to schoof 2
schoof 2 collected $6.45 from pot
schoof 2: doesn't show hand 
*** SUMMARY ***
Total pot $6.75 | Rake $0.30 
Board [5d 7d Jh 5c]
Seat 1: chiyuki (button) folded before Flop (didn't bet)
Seat 2: jacquelinewu (small blind) folded on the Turn
Seat 3: phate-1up (big blind) folded before Flop
Seat 4: schoof 2 collected ($6.45)
Seat 5: dergeb folded before Flop (didn't bet)
Seat 6: KrystalAA folded before Flop (didn't bet)
Seat 7: FoRlan77 folded before Flop (didn't bet)
Seat 8: Dionisko folded before Flop (didn't bet)
Seat 9: DrunkTyphoon folded before Flop (didn't bet)



PokerStars Zoom Hand #84300887483:  Hold'em No Limit ($0.10/$0.25) - 2012/08/05 15:58:13 JST [2012/08/05 2:58:13 ET]
Table 'Whirlpool' 9-max Seat #1 is the button
Seat 1: SAILUSI ($31.71 in chips) 
Seat 2: Jene4kaBest ($16.37 in chips) 
Seat 3: chiyuki ($38.13 in chips) 
Seat 4: nice.franki ($13.16 in chips) 
Seat 5: Rilko1975 ($25.07 in chips) 
Seat 6: opie62 ($24.50 in chips) 
Seat 7: snejokCoxx ($11.15 in chips) 
Seat 8: GovGus ($62.48 in chips) 
Seat 9: seula i ($72.82 in chips) 
Jene4kaBest: posts small blind $0.10
chiyuki: posts big blind $0.25
*** HOLE CARDS ***
Dealt to chiyuki [2h Td]
nice.franki: raises $0.75 to $1
Rilko1975: folds 
opie62: folds 
snejokCoxx: folds 
GovGus: folds 
seula i: folds 
SAILUSI: calls $1
Jene4kaBest: calls $0.90
chiyuki: folds 
*** FLOP *** [8h Qd 4s]
Jene4kaBest: checks 
nice.franki: checks 
SAILUSI: checks 
*** TURN *** [8h Qd 4s] [Kh]
Jene4kaBest: checks 
nice.franki: bets $2
SAILUSI: calls $2
Jene4kaBest: folds 
*** RIVER *** [8h Qd 4s Kh] [5s]
nice.franki: bets $4
SAILUSI: raises $4 to $8
nice.franki: raises $2.16 to $10.16 and is all-in
SAILUSI: calls $2.16
*** SHOW DOWN ***
nice.franki: shows [Qc Qs] (three of a kind, Queens)
SAILUSI: mucks hand 
nice.franki collected $26.33 from pot
*** SUMMARY ***
Total pot $27.57 | Rake $1.24 
Board [8h Qd 4s Kh 5s]
Seat 1: SAILUSI (button) mucked [4h 4c]
Seat 2: Jene4kaBest (small blind) folded on the Turn
Seat 3: chiyuki (big blind) folded before Flop
Seat 4: nice.franki showed [Qc Qs] and won ($26.33) with three of a kind, Queens
Seat 5: Rilko1975 folded before Flop (didn't bet)
Seat 6: opie62 folded before Flop (didn't bet)
Seat 7: snejokCoxx folded before Flop (didn't bet)
Seat 8: GovGus folded before Flop (didn't bet)
Seat 9: seula i folded before Flop (didn't bet)



PokerStars Zoom Hand #84300894450:  Hold'em No Limit ($0.10/$0.25) - 2012/08/05 15:58:46 JST [2012/08/05 2:58:46 ET]
Table 'Whirlpool' 9-max Seat #1 is the button
Seat 1: chiyuki ($37.78 in chips) 
Seat 2: Roglus ($12.49 in chips) 
Seat 3: Dionisko ($8.65 in chips) 
Seat 4: seula i ($27.97 in chips) 
Seat 5: kesstukas25 ($30.91 in chips) 
Seat 6: westhavenbc ($18.37 in chips) 
Seat 7: Silveystryk ($43.51 in chips) 
Seat 8: Lasutchik ($28.18 in chips) 
Seat 9: Dejacob ($44.01 in chips) 
Roglus: posts small blind $0.10
Dionisko: posts big blind $0.25
*** HOLE CARDS ***
Dealt to chiyuki [5s 4d]
seula i: raises $0.25 to $0.50
kesstukas25: folds 
westhavenbc: folds 
Silveystryk: folds 
Lasutchik: folds 
Dejacob: folds 
chiyuki: folds 
Roglus: folds 
Dionisko: folds 
Uncalled bet ($0.25) returned to seula i
seula i collected $0.60 from pot
seula i: doesn't show hand 
*** SUMMARY ***
Total pot $0.60 | Rake $0 
Seat 1: chiyuki (button) folded before Flop (didn't bet)
Seat 2: Roglus (small blind) folded before Flop
Seat 3: Dionisko (big blind) folded before Flop
Seat 4: seula i collected ($0.60)
Seat 5: kesstukas25 folded before Flop (didn't bet)
Seat 6: westhavenbc folded before Flop (didn't bet)
Seat 7: Silveystryk folded before Flop (didn't bet)
Seat 8: Lasutchik folded before Flop (didn't bet)
Seat 9: Dejacob folded before Flop (didn't bet)



PokerStars Zoom Hand #84300902516:  Hold'em No Limit ($0.10/$0.25) - 2012/08/05 15:59:23 JST [2012/08/05 2:59:23 ET]
Table 'Whirlpool' 9-max Seat #1 is the button
Seat 1: DrunkTyphoon ($36.96 in chips) 
Seat 2: Dejacob ($28.49 in chips) 
Seat 3: ShockLaMuc ($25.80 in chips) 
Seat 4: jacquelinewu ($25 in chips) 
Seat 5: xxASSO124xx ($11.40 in chips) 
Seat 6: Alvinpe85 ($41.56 in chips) 
Seat 7: FoRlan77 ($25 in chips) 
Seat 8: chiyuki ($37.53 in chips) 
Seat 9: rey2040 ($11.80 in chips) 
Dejacob: posts small blind $0.10
ShockLaMuc: posts big blind $0.25
*** HOLE CARDS ***
Dealt to chiyuki [Ah 9d]
jacquelinewu: folds 
xxASSO124xx: folds 
Alvinpe85: folds 
FoRlan77: folds 
chiyuki: folds 
rey2040: folds 
DrunkTyphoon: folds 
Dejacob: folds 
Uncalled bet ($0.15) returned to ShockLaMuc
ShockLaMuc collected $0.20 from pot
ShockLaMuc: doesn't show hand 
*** SUMMARY ***
Total pot $0.20 | Rake $0 
Seat 1: DrunkTyphoon (button) folded before Flop (didn't bet)
Seat 2: Dejacob (small blind) folded before Flop
Seat 3: ShockLaMuc (big blind) collected ($0.20)
Seat 4: jacquelinewu folded before Flop (didn't bet)
Seat 5: xxASSO124xx folded before Flop (didn't bet)
Seat 6: Alvinpe85 folded before Flop (didn't bet)
Seat 7: FoRlan77 folded before Flop (didn't bet)
Seat 8: chiyuki folded before Flop (didn't bet)
Seat 9: rey2040 folded before Flop (didn't bet)



PokerStars Zoom Hand #84300904009:  Hold'em No Limit ($0.10/$0.25) - 2012/08/05 15:59:30 JST [2012/08/05 2:59:30 ET]
Table 'Whirlpool' 9-max Seat #1 is the button
Seat 1: seula i ($44.31 in chips) 
Seat 2: Silveystryk ($28.77 in chips) 
Seat 3: Nerkit ($12.61 in chips) 
Seat 4: chiyuki ($37.53 in chips) 
Seat 5: scaredsare ($30.43 in chips) 
Seat 6: Dejacob ($28.39 in chips) 
Seat 7: fil740 ($10.77 in chips) 
Seat 8: DrunkTyphoon ($36.96 in chips) 
Seat 9: GovGus ($34.49 in chips) 
Silveystryk: posts small blind $0.10
Nerkit: posts big blind $0.25
*** HOLE CARDS ***
Dealt to chiyuki [Ac 4d]
chiyuki: folds 
scaredsare: folds 
Dejacob: folds 
fil740: raises $0.25 to $0.50
DrunkTyphoon: folds 
GovGus: folds 
seula i: folds 
Silveystryk: folds 
Nerkit: folds 
Uncalled bet ($0.25) returned to fil740
fil740 collected $0.60 from pot
fil740: doesn't show hand 
*** SUMMARY ***
Total pot $0.60 | Rake $0 
Seat 1: seula i (button) folded before Flop (didn't bet)
Seat 2: Silveystryk (small blind) folded before Flop
Seat 3: Nerkit (big blind) folded before Flop
Seat 4: chiyuki folded before Flop (didn't bet)
Seat 5: scaredsare folded before Flop (didn't bet)
Seat 6: Dejacob folded before Flop (didn't bet)
Seat 7: fil740 collected ($0.60)
Seat 8: DrunkTyphoon folded before Flop (didn't bet)
Seat 9: GovGus folded before Flop (didn't bet)



PokerStars Zoom Hand #84300896875:  Hold'em No Limit ($0.10/$0.25) - 2012/08/05 15:58:57 JST [2012/08/05 2:58:57 ET]
Table 'Whirlpool' 9-max Seat #1 is the button
Seat 1: Roglus ($12.39 in chips) 
Seat 2: pawn909 ($19.83 in chips) 
Seat 3: chiyuki ($37.78 in chips) 
Seat 4: kwkim73 ($25.81 in chips) 
Seat 5: Afcawins25 ($16.59 in chips) 
Seat 6: HighDuka ($17.13 in chips) 
Seat 7: ShockLaMuc ($15.95 in chips) 
Seat 8: INSP!RON ($39.46 in chips) 
Seat 9: Grishukps ($12.85 in chips) 
pawn909: posts small blind $0.10
chiyuki: posts big blind $0.25
*** HOLE CARDS ***
Dealt to chiyuki [Td 8c]
kwkim73: folds 
Afcawins25: raises $0.54 to $0.79
HighDuka: folds 
ShockLaMuc: folds 
INSP!RON: folds 
Grishukps: folds 
Roglus: folds 
pawn909: calls $0.69
chiyuki: folds 
*** FLOP *** [Qc 7h 2s]
pawn909: checks 
Afcawins25: bets $1
pawn909: raises $1.50 to $2.50
Afcawins25: calls $1.50
*** TURN *** [Qc 7h 2s] [9d]
pawn909: bets $2.99
Afcawins25: folds 
Uncalled bet ($2.99) returned to pawn909
pawn909 collected $6.52 from pot
pawn909: doesn't show hand 
*** SUMMARY ***
Total pot $6.83 | Rake $0.31 
Board [Qc 7h 2s 9d]
Seat 1: Roglus (button) folded before Flop (didn't bet)
Seat 2: pawn909 (small blind) collected ($6.52)
Seat 3: chiyuki (big blind) folded before Flop
Seat 4: kwkim73 folded before Flop (didn't bet)
Seat 5: Afcawins25 folded on the Turn
Seat 6: HighDuka folded before Flop (didn't bet)
Seat 7: ShockLaMuc folded before Flop (didn't bet)
Seat 8: INSP!RON folded before Flop (didn't bet)
Seat 9: Grishukps folded before Flop (didn't bet)



PokerStars Zoom Hand #84300893490:  Hold'em No Limit ($0.10/$0.25) - 2012/08/05 15:58:42 JST [2012/08/05 2:58:42 ET]
Table 'Whirlpool' 9-max Seat #1 is the button
Seat 1: opie62 ($24.25 in chips) 
Seat 2: jacquelinewu ($31.09 in chips) 
Seat 3: INSP!RON ($39.71 in chips) 
Seat 4: westhavenbc ($18.37 in chips) 
Seat 5: GovGus ($25 in chips) 
Seat 6: Dionisko ($8.65 in chips) 
Seat 7: andy0815r ($24.65 in chips) 
Seat 8: chiyuki ($37.78 in chips) 
Seat 9: Saruotiss ($61.86 in chips) 
jacquelinewu: posts small blind $0.10
INSP!RON: posts big blind $0.25
*** HOLE CARDS ***
Dealt to chiyuki [Qh 6s]
westhavenbc: folds 
GovGus: raises $0.75 to $1
Dionisko: folds 
andy0815r: calls $1
chiyuki: folds 
Saruotiss: folds 
opie62: folds 
jacquelinewu: folds 
INSP!RON: folds 
*** FLOP *** [9c 5d 8d]
GovGus: bets $1.25
andy0815r: calls $1.25
*** TURN *** [9c 5d 8d] [2d]
GovGus: bets $2.75
andy0815r: calls $2.75
*** RIVER *** [9c 5d 8d 2d] [3h]
GovGus: checks 
andy0815r: bets $4.94
GovGus: calls $4.94
*** SHOW DOWN ***
andy0815r: shows [Td Ad] (a flush, Ace high)
GovGus: mucks hand 
andy0815r collected $19.32 from pot
*** SUMMARY ***
Total pot $20.23 | Rake $0.91 
Board [9c 5d 8d 2d 3h]
Seat 1: opie62 (button) folded before Flop (didn't bet)
Seat 2: jacquelinewu (small blind) folded before Flop
Seat 3: INSP!RON (big blind) folded before Flop
Seat 4: westhavenbc folded before Flop (didn't bet)
Seat 5: GovGus mucked [Ts Tc]
Seat 6: Dionisko folded before Flop (didn't bet)
Seat 7: andy0815r showed [Td Ad] and won ($19.32) with a flush, Ace high
Seat 8: chiyuki folded before Flop (didn't bet)
Seat 9: Saruotiss folded before Flop (didn't bet)



PokerStars Zoom Hand #84300904899:  Hold'em No Limit ($0.10/$0.25) - 2012/08/05 15:59:35 JST [2012/08/05 2:59:35 ET]
Table 'Whirlpool' 9-max Seat #1 is the button
Seat 1: 6nikola9 ($20.61 in chips) 
Seat 2: chiyuki ($37.53 in chips) 
Seat 3: kwkim73 ($36.95 in chips) 
Seat 4: westhavenbc ($18.01 in chips) 
Seat 5: Rilko1975 ($24.52 in chips) 
Seat 6: DrunkTyphoon ($36.96 in chips) 
Seat 7: andy0815r ($28.17 in chips) 
Seat 8: phate-1up ($66.26 in chips) 
Seat 9: romanian c4 ($13.45 in chips) 
chiyuki: posts small blind $0.10
kwkim73: posts big blind $0.25
*** HOLE CARDS ***
Dealt to chiyuki [Ks Ac]
westhavenbc: folds 
Rilko1975: folds 
DrunkTyphoon: raises $0.50 to $0.75
andy0815r: folds 
phate-1up: folds 
romanian c4: folds 
6nikola9: calls $0.75
chiyuki: raises $2 to $2.75
kwkim73: folds 
DrunkTyphoon: folds 
6nikola9: folds 
Uncalled bet ($2) returned to chiyuki
chiyuki collected $2.50 from pot
chiyuki: doesn't show hand 
*** SUMMARY ***
Total pot $2.50 | Rake $0 
Seat 1: 6nikola9 (button) folded before Flop
Seat 2: chiyuki (small blind) collected ($2.50)
Seat 3: kwkim73 (big blind) folded before Flop
Seat 4: westhavenbc folded before Flop (didn't bet)
Seat 5: Rilko1975 folded before Flop (didn't bet)
Seat 6: DrunkTyphoon folded before Flop
Seat 7: andy0815r folded before Flop (didn't bet)
Seat 8: phate-1up folded before Flop (didn't bet)
Seat 9: romanian c4 folded before Flop (didn't bet)



PokerStars Zoom Hand #84300899742:  Hold'em No Limit ($0.10/$0.25) - 2012/08/05 15:59:10 JST [2012/08/05 2:59:10 ET]
Table 'Whirlpool' 9-max Seat #1 is the button
Seat 1: GovGus ($61.88 in chips) 
Seat 2: Alvinpe85 ($41.66 in chips) 
Seat 3: westhavenbc ($18.27 in chips) 
Seat 4: seula i ($28.32 in chips) 
Seat 5: chiyuki ($37.53 in chips) 
Seat 6: nice.franki ($5.03 in chips) 
Seat 7: wildy29 ($56.69 in chips) 
Seat 8: Serge Claws ($28.30 in chips) 
Seat 9: KrystalAA ($12.56 in chips) 
Alvinpe85: posts small blind $0.10
westhavenbc: posts big blind $0.25
*** HOLE CARDS ***
Dealt to chiyuki [2c 5d]
seula i: folds 
chiyuki: folds 
nice.franki: folds 
wildy29: calls $0.25
Serge Claws: folds 
KrystalAA: calls $0.25
GovGus: calls $0.25
Alvinpe85: folds 
westhavenbc: checks 
*** FLOP *** [4c 9c 8s]
westhavenbc: checks 
wildy29: checks 
KrystalAA: bets $0.80
GovGus: calls $0.80
westhavenbc: folds 
wildy29: calls $0.80
*** TURN *** [4c 9c 8s] [Jd]
wildy29: checks 
KrystalAA: checks 
GovGus: bets $2
wildy29: calls $2
KrystalAA: folds 
*** RIVER *** [4c 9c 8s Jd] [6c]
wildy29: checks 
GovGus: checks 
*** SHOW DOWN ***
wildy29: shows [Kc Kh] (a pair of Kings)
GovGus: mucks hand 
wildy29 collected $7.16 from pot
*** SUMMARY ***
Total pot $7.50 | Rake $0.34 
Board [4c 9c 8s Jd 6c]
Seat 1: GovGus (button) mucked [Ts Jc]
Seat 2: Alvinpe85 (small blind) folded before Flop
Seat 3: westhavenbc (big blind) folded on the Flop
Seat 4: seula i folded before Flop (didn't bet)
Seat 5: chiyuki folded before Flop (didn't bet)
Seat 6: nice.franki folded before Flop (didn't bet)
Seat 7: wildy29 showed [Kc Kh] and won ($7.16) with a pair of Kings
Seat 8: Serge Claws folded before Flop (didn't bet)
Seat 9: KrystalAA folded on the Turn



PokerStars Zoom Hand #84300901437:  Hold'em No Limit ($0.10/$0.25) - 2012/08/05 15:59:18 JST [2012/08/05 2:59:18 ET]
Table 'Whirlpool' 9-max Seat #1 is the button
Seat 1: ShockLaMuc ($25.80 in chips) 
Seat 2: DrunkTyphoon ($37.06 in chips) 
Seat 3: dergeb ($16.69 in chips) 
Seat 4: Rici47 ($31.02 in chips) 
Seat 5: chiyuki ($37.53 in chips) 
Seat 6: Serge Claws ($28.30 in chips) 
Seat 7: Saruotiss ($61.76 in chips) 
Seat 8: snejokCoxx ($8.88 in chips) 
Seat 9: kesstukas25 ($30.81 in chips) 
DrunkTyphoon: posts small blind $0.10
dergeb: posts big blind $0.25
*** HOLE CARDS ***
Dealt to chiyuki [2d Kh]
Rici47: folds 
chiyuki: folds 
Serge Claws: folds 
Saruotiss: folds 
snejokCoxx: raises $0.40 to $0.65
kesstukas25: calls $0.65
ShockLaMuc: folds 
DrunkTyphoon: folds 
dergeb: calls $0.40
*** FLOP *** [4c 5d 2s]
dergeb: checks 
snejokCoxx: bets $1.29
kesstukas25: folds 
dergeb: calls $1.29
*** TURN *** [4c 5d 2s] [9h]
dergeb: bets $2.21
snejokCoxx: raises $4.73 to $6.94 and is all-in
dergeb: calls $4.73
*** RIVER *** [4c 5d 2s 9h] [8h]
*** SHOW DOWN ***
dergeb: shows [7d 7h] (a pair of Sevens)
snejokCoxx: shows [5c 5h] (three of a kind, Fives)
snejokCoxx collected $17.68 from pot
*** SUMMARY ***
Total pot $18.51 | Rake $0.83 
Board [4c 5d 2s 9h 8h]
Seat 1: ShockLaMuc (button) folded before Flop (didn't bet)
Seat 2: DrunkTyphoon (small blind) folded before Flop
Seat 3: dergeb (big blind) showed [7d 7h] and lost with a pair of Sevens
Seat 4: Rici47 folded before Flop (didn't bet)
Seat 5: chiyuki folded before Flop (didn't bet)
Seat 6: Serge Claws folded before Flop (didn't bet)
Seat 7: Saruotiss folded before Flop (didn't bet)
Seat 8: snejokCoxx showed [5c 5h] and won ($17.68) with three of a kind, Fives
Seat 9: kesstukas25 folded on the Flop



PokerStars Zoom Hand #84300913990:  Hold'em No Limit ($0.10/$0.25) - 2012/08/05 16:00:16 JST [2012/08/05 3:00:16 ET]
Table 'Whirlpool' 9-max Seat #1 is the button
Seat 1: chiyuki ($39.28 in chips) 
Seat 2: snejokCoxx ($12.25 in chips) 
Seat 3: kesstukas25 ($30.16 in chips) 
Seat 4: ChrisCDee ($54.88 in chips) 
Seat 5: leo2095 ($17.25 in chips) 
Seat 6: Serge Claws ($27.95 in chips) 
Seat 7: Spheroff ($24.55 in chips) 
Seat 8: andy0815r ($32.22 in chips) 
Seat 9: KsuhaLove ($12.64 in chips) 
snejokCoxx: posts small blind $0.10
kesstukas25: posts big blind $0.25
*** HOLE CARDS ***
Dealt to chiyuki [9h 5s]
ChrisCDee: folds 
leo2095: folds 
Serge Claws: folds 
Spheroff: folds 
andy0815r: folds 
KsuhaLove: folds 
chiyuki: folds 
snejokCoxx: raises $0.40 to $0.65
kesstukas25: folds 
Uncalled bet ($0.40) returned to snejokCoxx
snejokCoxx collected $0.50 from pot
snejokCoxx: doesn't show hand 
*** SUMMARY ***
Total pot $0.50 | Rake $0 
Seat 1: chiyuki (button) folded before Flop (didn't bet)
Seat 2: snejokCoxx (small blind) collected ($0.50)
Seat 3: kesstukas25 (big blind) folded before Flop
Seat 4: ChrisCDee folded before Flop (didn't bet)
Seat 5: leo2095 folded before Flop (didn't bet)
Seat 6: Serge Claws folded before Flop (didn't bet)
Seat 7: Spheroff folded before Flop (didn't bet)
Seat 8: andy0815r folded before Flop (didn't bet)
Seat 9: KsuhaLove folded before Flop (didn't bet)



PokerStars Zoom Hand #84300895563:  Hold'em No Limit ($0.10/$0.25) - 2012/08/05 15:58:51 JST [2012/08/05 2:58:51 ET]
Table 'Whirlpool' 9-max Seat #1 is the button
Seat 1: Jene4kaBest ($15.37 in chips) 
Seat 2: crazycrown1 ($8.02 in chips) 
Seat 3: MurMurRu ($26.93 in chips) 
Seat 4: GSDP ($38.68 in chips) 
Seat 5: westhavenbc ($18.37 in chips) 
Seat 6: chiyuki ($37.78 in chips) 
Seat 7: Dan Royal ($33.48 in chips) 
Seat 8: Faantomace ($32.14 in chips) 
Seat 9: pawn909 ($19.83 in chips) 
crazycrown1: posts small blind $0.10
MurMurRu: posts big blind $0.25
*** HOLE CARDS ***
Dealt to chiyuki [8d As]
GSDP: folds 
westhavenbc: folds 
chiyuki: folds 
Dan Royal: folds 
Faantomace: calls $0.25
pawn909: folds 
Jene4kaBest: raises $0.75 to $1
crazycrown1: folds 
MurMurRu: calls $0.75
Faantomace: calls $0.75
*** FLOP *** [9h Jd 5d]
MurMurRu: checks 
Faantomace: checks 
Jene4kaBest: bets $1.25
MurMurRu: calls $1.25
Faantomace: calls $1.25
*** TURN *** [9h Jd 5d] [Td]
MurMurRu: checks 
Faantomace: checks 
Jene4kaBest: bets $2.50
MurMurRu: folds 
Faantomace: calls $2.50
*** RIVER *** [9h Jd 5d Td] [8h]
Faantomace: bets $1.75
Jene4kaBest: calls $1.75
*** SHOW DOWN ***
Faantomace: shows [Qc 9s] (a straight, Eight to Queen)
Jene4kaBest: mucks hand 
Faantomace collected $14.66 from pot
*** SUMMARY ***
Total pot $15.35 | Rake $0.69 
Board [9h Jd 5d Td 8h]
Seat 1: Jene4kaBest (button) mucked [5s 5h]
Seat 2: crazycrown1 (small blind) folded before Flop
Seat 3: MurMurRu (big blind) folded on the Turn
Seat 4: GSDP folded before Flop (didn't bet)
Seat 5: westhavenbc folded before Flop (didn't bet)
Seat 6: chiyuki folded before Flop (didn't bet)
Seat 7: Dan Royal folded before Flop (didn't bet)
Seat 8: Faantomace showed [Qc 9s] and won ($14.66) with a straight, Eight to Queen
Seat 9: pawn909 folded before Flop (didn't bet)



PokerStars Zoom Hand #84300911362:  Hold'em No Limit ($0.10/$0.25) - 2012/08/05 16:00:04 JST [2012/08/05 3:00:04 ET]
Table 'Whirlpool' 9-max Seat #1 is the button
Seat 1: mjmichi ($25 in chips) 
Seat 2: seula i ($44.31 in chips) 
Seat 3: scaredsare ($16.01 in chips) 
Seat 4: GovGus ($25 in chips) 
Seat 5: Dejacob ($28.39 in chips) 
Seat 6: pawn909 ($23.06 in chips) 
Seat 7: chiyuki ($39.28 in chips) 
Seat 8: kesstukas25 ($30.16 in chips) 
Seat 9: kwkim73 ($25 in chips) 
seula i: posts small blind $0.10
scaredsare: posts big blind $0.25
*** HOLE CARDS ***
Dealt to chiyuki [4h Td]
GovGus: folds 
Dejacob: folds 
pawn909: folds 
chiyuki: folds 
kesstukas25: folds 
kwkim73: raises $0.50 to $0.75
mjmichi: folds 
seula i: calls $0.65
scaredsare: folds 
*** FLOP *** [8h 5d 6h]
seula i: bets $1.25
kwkim73: folds 
Uncalled bet ($1.25) returned to seula i
seula i collected $1.67 from pot
seula i: doesn't show hand 
*** SUMMARY ***
Total pot $1.75 | Rake $0.08 
Board [8h 5d 6h]
Seat 1: mjmichi (button) folded before Flop (didn't bet)
Seat 2: seula i (small blind) collected ($1.67)
Seat 3: scaredsare (big blind) folded before Flop
Seat 4: GovGus folded before Flop (didn't bet)
Seat 5: Dejacob folded before Flop (didn't bet)
Seat 6: pawn909 folded before Flop (didn't bet)
Seat 7: chiyuki folded before Flop (didn't bet)
Seat 8: kesstukas25 folded before Flop (didn't bet)
Seat 9: kwkim73 folded on the Flop



PokerStars Zoom Hand #84300915376:  Hold'em No Limit ($0.10/$0.25) - 2012/08/05 16:00:22 JST [2012/08/05 3:00:22 ET]
Table 'Whirlpool' 9-max Seat #1 is the button
Seat 1: Limoilou ($28.41 in chips) 
Seat 2: FoRlan77 ($27.83 in chips) 
Seat 3: chiyuki ($39.28 in chips) 
Seat 4: hldtom ($13.90 in chips) 
Seat 5: ShockLaMuc ($26.90 in chips) 
Seat 6: Lasutchik ($27.56 in chips) 
Seat 7: Perstenev ($9.79 in chips) 
Seat 8: drunk_bender ($24.30 in chips) 
Seat 9: phate-1up ($66.26 in chips) 
FoRlan77: posts small blind $0.10
chiyuki: posts big blind $0.25
*** HOLE CARDS ***
Dealt to chiyuki [2h Qc]
hldtom: folds 
ShockLaMuc: folds 
Lasutchik: folds 
Perstenev: folds 
drunk_bender: folds 
phate-1up: folds 
Limoilou: raises $0.25 to $0.50
FoRlan77: folds 
chiyuki: folds 
Uncalled bet ($0.25) returned to Limoilou
Limoilou collected $0.60 from pot
Limoilou: doesn't show hand 
*** SUMMARY ***
Total pot $0.60 | Rake $0 
Seat 1: Limoilou (button) collected ($0.60)
Seat 2: FoRlan77 (small blind) folded before Flop
Seat 3: chiyuki (big blind) folded before Flop
Seat 4: hldtom folded before Flop (didn't bet)
Seat 5: ShockLaMuc folded before Flop (didn't bet)
Seat 6: Lasutchik folded before Flop (didn't bet)
Seat 7: Perstenev folded before Flop (didn't bet)
Seat 8: drunk_bender folded before Flop (didn't bet)
Seat 9: phate-1up folded before Flop (didn't bet)



PokerStars Zoom Hand #84300912710:  Hold'em No Limit ($0.10/$0.25) - 2012/08/05 16:00:10 JST [2012/08/05 3:00:10 ET]
Table 'Whirlpool' 9-max Seat #1 is the button
Seat 1: KrystalAA ($11.51 in chips) 
Seat 2: nice.franki ($7.18 in chips) 
Seat 3: GovGus ($25 in chips) 
Seat 4: AAAKK777 ($15.95 in chips) 
Seat 5: Rilko1975 ($24.57 in chips) 
Seat 6: chiyuki ($39.28 in chips) 
Seat 7: Grishukps ($13 in chips) 
Seat 8: Alvinpe85 ($93.17 in chips) 
Seat 9: mjmichi ($25 in chips) 
nice.franki: posts small blind $0.10
GovGus: posts big blind $0.25
*** HOLE CARDS ***
Dealt to chiyuki [2c 6s]
AAAKK777: raises $0.25 to $0.50
Rilko1975: folds 
chiyuki: folds 
Grishukps: folds 
Alvinpe85: calls $0.50
mjmichi: folds 
KrystalAA: folds 
nice.franki: folds 
GovGus: calls $0.25
*** FLOP *** [Qd 3c Js]
GovGus: checks 
AAAKK777: checks 
Alvinpe85: checks 
*** TURN *** [Qd 3c Js] [Kd]
GovGus: checks 
AAAKK777: checks 
Alvinpe85: checks 
*** RIVER *** [Qd 3c Js Kd] [9c]
GovGus: checks 
AAAKK777: checks 
Alvinpe85: checks 
*** SHOW DOWN ***
GovGus: shows [3h 5h] (a pair of Threes)
AAAKK777: mucks hand 
Alvinpe85: shows [4h 4s] (a pair of Fours)
Alvinpe85 collected $1.53 from pot
*** SUMMARY ***
Total pot $1.60 | Rake $0.07 
Board [Qd 3c Js Kd 9c]
Seat 1: KrystalAA (button) folded before Flop (didn't bet)
Seat 2: nice.franki (small blind) folded before Flop
Seat 3: GovGus (big blind) showed [3h 5h] and lost with a pair of Threes
Seat 4: AAAKK777 mucked [2d Ac]
Seat 5: Rilko1975 folded before Flop (didn't bet)
Seat 6: chiyuki folded before Flop (didn't bet)
Seat 7: Grishukps folded before Flop (didn't bet)
Seat 8: Alvinpe85 showed [4h 4s] and won ($1.53) with a pair of Fours
Seat 9: mjmichi folded before Flop (didn't bet)



PokerStars Zoom Hand #84300922158:  Hold'em No Limit ($0.10/$0.25) - 2012/08/05 16:00:52 JST [2012/08/05 3:00:52 ET]
Table 'Whirlpool' 9-max Seat #1 is the button
Seat 1: Rilko1975 ($24.22 in chips) 
Seat 2: pawn909 ($22.81 in chips) 
Seat 3: Dan Royal ($32.28 in chips) 
Seat 4: Serge Claws ($39.82 in chips) 
Seat 5: kwkim73 ($25 in chips) 
Seat 6: masterkoolb ($19.12 in chips) 
Seat 7: snejokCoxx ($17.68 in chips) 
Seat 8: Fructionar ($44.24 in chips) 
Seat 9: chiyuki ($39.03 in chips) 
pawn909: posts small blind $0.10
Dan Royal: posts big blind $0.25
*** HOLE CARDS ***
Dealt to chiyuki [6c 2c]
Serge Claws: folds 
kwkim73: folds 
masterkoolb: folds 
snejokCoxx: folds 
Fructionar: folds 
chiyuki: folds 
Rilko1975: raises $0.25 to $0.50
pawn909: folds 
Dan Royal: raises $1.50 to $2
Rilko1975: folds 
Uncalled bet ($1.50) returned to Dan Royal
Dan Royal collected $1.10 from pot
Dan Royal: doesn't show hand 
*** SUMMARY ***
Total pot $1.10 | Rake $0 
Seat 1: Rilko1975 (button) folded before Flop
Seat 2: pawn909 (small blind) folded before Flop
Seat 3: Dan Royal (big blind) collected ($1.10)
Seat 4: Serge Claws folded before Flop (didn't bet)
Seat 5: kwkim73 folded before Flop (didn't bet)
Seat 6: masterkoolb folded before Flop (didn't bet)
Seat 7: snejokCoxx folded before Flop (didn't bet)
Seat 8: Fructionar folded before Flop (didn't bet)
Seat 9: chiyuki folded before Flop (didn't bet)



PokerStars Zoom Hand #84300926770:  Hold'em No Limit ($0.10/$0.25) - 2012/08/05 16:01:11 JST [2012/08/05 3:01:11 ET]
Table 'Whirlpool' 9-max Seat #1 is the button
Seat 1: Alvinpe85 ($47.28 in chips) 
Seat 2: chiyuki ($39.03 in chips) 
Seat 3: Cripple86 ($25 in chips) 
Seat 4: seula i ($27.32 in chips) 
Seat 5: KrystalAA ($16.75 in chips) 
Seat 6: westhavenbc ($17.01 in chips) 
Seat 7: GovGus ($58.83 in chips) 
Seat 8: Rici47 ($30.67 in chips) 
Seat 9: Grishukps ($12.50 in chips) 
chiyuki: posts small blind $0.10
Cripple86: posts big blind $0.25
*** HOLE CARDS ***
Dealt to chiyuki [7h Qc]
seula i: folds 
KrystalAA: folds 
westhavenbc: raises $0.25 to $0.50
GovGus: folds 
Rici47: folds 
Grishukps: folds 
Alvinpe85: folds 
chiyuki: folds 
Cripple86: folds 
Uncalled bet ($0.25) returned to westhavenbc
westhavenbc collected $0.60 from pot
westhavenbc: doesn't show hand 
*** SUMMARY ***
Total pot $0.60 | Rake $0 
Seat 1: Alvinpe85 (button) folded before Flop (didn't bet)
Seat 2: chiyuki (small blind) folded before Flop
Seat 3: Cripple86 (big blind) folded before Flop
Seat 4: seula i folded before Flop (didn't bet)
Seat 5: KrystalAA folded before Flop (didn't bet)
Seat 6: westhavenbc collected ($0.60)
Seat 7: GovGus folded before Flop (didn't bet)
Seat 8: Rici47 folded before Flop (didn't bet)
Seat 9: Grishukps folded before Flop (didn't bet)



PokerStars Zoom Hand #84300930123:  Hold'em No Limit ($0.10/$0.25) - 2012/08/05 16:01:24 JST [2012/08/05 3:01:24 ET]
Table 'Whirlpool' 9-max Seat #1 is the button
Seat 1: chiyuki ($38.93 in chips) 
Seat 2: DrunkTyphoon ($36.09 in chips) 
Seat 3: Grishukps ($12.85 in chips) 
Seat 4: GovGus ($41.91 in chips) 
Seat 5: FoRlan77 ($27.48 in chips) 
Seat 6: MurMurRu ($25 in chips) 
Seat 7: Dejacob ($25.95 in chips) 
Seat 8: yoube ($33.11 in chips) 
Seat 9: ShockLaMuc ($14.85 in chips) 
DrunkTyphoon: posts small blind $0.10
Grishukps: posts big blind $0.25
*** HOLE CARDS ***
Dealt to chiyuki [6h Ah]
GovGus: folds 
FoRlan77: folds 
MurMurRu: folds 
Dejacob: folds 
yoube: folds 
ShockLaMuc: folds 
chiyuki: raises $0.50 to $0.75
DrunkTyphoon: folds 
Grishukps: folds 
Uncalled bet ($0.50) returned to chiyuki
chiyuki collected $0.60 from pot
chiyuki: doesn't show hand 
*** SUMMARY ***
Total pot $0.60 | Rake $0 
Seat 1: chiyuki (button) collected ($0.60)
Seat 2: DrunkTyphoon (small blind) folded before Flop
Seat 3: Grishukps (big blind) folded before Flop
Seat 4: GovGus folded before Flop (didn't bet)
Seat 5: FoRlan77 folded before Flop (didn't bet)
Seat 6: MurMurRu folded before Flop (didn't bet)
Seat 7: Dejacob folded before Flop (didn't bet)
Seat 8: yoube folded before Flop (didn't bet)
Seat 9: ShockLaMuc folded before Flop (didn't bet)



PokerStars Zoom Hand #84300924535:  Hold'em No Limit ($0.10/$0.25) - 2012/08/05 16:01:02 JST [2012/08/05 3:01:02 ET]
Table 'Whirlpool' 9-max Seat #1 is the button
Seat 1: ViTiV2010 ($12.50 in chips) 
Seat 2: Dejacob ($44.66 in chips) 
Seat 3: jacquelinewu ($79.41 in chips) 
Seat 4: Roglus ($15.15 in chips) 
Seat 5: seula i ($27.32 in chips) 
Seat 6: PPP7SSS ($27.40 in chips) 
Seat 7: crazycrown1 ($9.39 in chips) 
Seat 8: chiyuki ($39.03 in chips) 
Seat 9: KsuhaLove ($11.39 in chips) 
Dejacob: posts small blind $0.10
jacquelinewu: posts big blind $0.25
*** HOLE CARDS ***
Dealt to chiyuki [5d Jc]
Roglus: folds 
seula i: folds 
PPP7SSS: raises $0.25 to $0.50
crazycrown1: calls $0.50
chiyuki: folds 
KsuhaLove: folds 
ViTiV2010: folds 
Dejacob: folds 
jacquelinewu: calls $0.25
*** FLOP *** [As 9h 6s]
jacquelinewu: checks 
PPP7SSS: bets $0.75
crazycrown1: folds 
jacquelinewu: folds 
Uncalled bet ($0.75) returned to PPP7SSS
PPP7SSS collected $1.53 from pot
PPP7SSS: doesn't show hand 
*** SUMMARY ***
Total pot $1.60 | Rake $0.07 
Board [As 9h 6s]
Seat 1: ViTiV2010 (button) folded before Flop (didn't bet)
Seat 2: Dejacob (small blind) folded before Flop
Seat 3: jacquelinewu (big blind) folded on the Flop
Seat 4: Roglus folded before Flop (didn't bet)
Seat 5: seula i folded before Flop (didn't bet)
Seat 6: PPP7SSS collected ($1.53)
Seat 7: crazycrown1 folded on the Flop
Seat 8: chiyuki folded before Flop (didn't bet)
Seat 9: KsuhaLove folded before Flop (didn't bet)



PokerStars Zoom Hand #84300922884:  Hold'em No Limit ($0.10/$0.25) - 2012/08/05 16:00:55 JST [2012/08/05 3:00:55 ET]
Table 'Whirlpool' 9-max Seat #1 is the button
Seat 1: GovGus ($25 in chips) 
Seat 2: scaredsare ($15.26 in chips) 
Seat 3: fil740 ($12.04 in chips) 
Seat 4: nice.franki ($7.08 in chips) 
Seat 5: chiyuki ($39.03 in chips) 
Seat 6: tribunpdm ($78.84 in chips) 
Seat 7: CrittHunter ($24.55 in chips) 
Seat 8: leo2095 ($17 in chips) 
Seat 9: Alvinpe85 ($94.20 in chips) 
scaredsare: posts small blind $0.10
fil740: posts big blind $0.25
*** HOLE CARDS ***
Dealt to chiyuki [8h 4c]
nice.franki: folds 
chiyuki: folds 
tribunpdm: folds 
CrittHunter: folds 
leo2095: folds 
Alvinpe85: folds 
GovGus: raises $0.75 to $1
scaredsare: calls $0.90
fil740: folds 
*** FLOP *** [Qc 9s Kc]
scaredsare: checks 
GovGus: bets $1.25
scaredsare: calls $1.25
*** TURN *** [Qc 9s Kc] [8s]
scaredsare: checks 
GovGus: checks 
*** RIVER *** [Qc 9s Kc 8s] [5d]
scaredsare: checks 
GovGus: checks 
*** SHOW DOWN ***
scaredsare: shows [Qs Ac] (a pair of Queens)
GovGus: mucks hand 
scaredsare collected $4.54 from pot
*** SUMMARY ***
Total pot $4.75 | Rake $0.21 
Board [Qc 9s Kc 8s 5d]
Seat 1: GovGus (button) mucked [2d Ad]
Seat 2: scaredsare (small blind) showed [Qs Ac] and won ($4.54) with a pair of Queens
Seat 3: fil740 (big blind) folded before Flop
Seat 4: nice.franki folded before Flop (didn't bet)
Seat 5: chiyuki folded before Flop (didn't bet)
Seat 6: tribunpdm folded before Flop (didn't bet)
Seat 7: CrittHunter folded before Flop (didn't bet)
Seat 8: leo2095 folded before Flop (didn't bet)
Seat 9: Alvinpe85 folded before Flop (didn't bet)



PokerStars Zoom Hand #84300925772:  Hold'em No Limit ($0.10/$0.25) - 2012/08/05 16:01:07 JST [2012/08/05 3:01:07 ET]
Table 'Whirlpool' 9-max Seat #1 is the button
Seat 1: FoRlan77 ($27.48 in chips) 
Seat 2: Trip_Krowns ($26.47 in chips) 
Seat 3: nice.franki ($7.08 in chips) 
Seat 4: Dejacob ($25.79 in chips) 
Seat 5: tribunpdm ($78.84 in chips) 
Seat 6: ChrisCDee ($55.23 in chips) 
Seat 7: JhonnyP1979 ($16.93 in chips) 
Seat 8: Nerkit ($24.56 in chips) 
Seat 9: chiyuki ($39.03 in chips) 
Trip_Krowns: posts small blind $0.10
nice.franki: posts big blind $0.25
*** HOLE CARDS ***
Dealt to chiyuki [6s 4s]
Dejacob: folds 
tribunpdm: raises $0.25 to $0.50
ChrisCDee: folds 
JhonnyP1979: calls $0.50
Nerkit: folds 
chiyuki: folds 
FoRlan77: folds 
Trip_Krowns: folds 
nice.franki: folds 
*** FLOP *** [9c 8d 8c]
tribunpdm: bets $1
JhonnyP1979: calls $1
*** TURN *** [9c 8d 8c] [2h]
tribunpdm: bets $1.75
JhonnyP1979: calls $1.75
*** RIVER *** [9c 8d 8c 2h] [2c]
tribunpdm: checks 
JhonnyP1979: bets $4.90
tribunpdm: calls $4.90
*** SHOW DOWN ***
JhonnyP1979: shows [Tc Js] (two pair, Eights and Deuces)
tribunpdm: shows [Ac 6c] (a flush, Ace high)
tribunpdm collected $15.90 from pot
*** SUMMARY ***
Total pot $16.65 | Rake $0.75 
Board [9c 8d 8c 2h 2c]
Seat 1: FoRlan77 (button) folded before Flop (didn't bet)
Seat 2: Trip_Krowns (small blind) folded before Flop
Seat 3: nice.franki (big blind) folded before Flop
Seat 4: Dejacob folded before Flop (didn't bet)
Seat 5: tribunpdm showed [Ac 6c] and won ($15.90) with a flush, Ace high
Seat 6: ChrisCDee folded before Flop (didn't bet)
Seat 7: JhonnyP1979 showed [Tc Js] and lost with two pair, Eights and Deuces
Seat 8: Nerkit folded before Flop (didn't bet)
Seat 9: chiyuki folded before Flop (didn't bet)



PokerStars Zoom Hand #84300934363:  Hold'em No Limit ($0.10/$0.25) - 2012/08/05 16:01:41 JST [2012/08/05 3:01:41 ET]
Table 'Whirlpool' 9-max Seat #1 is the button
Seat 1: Femali54 ($26.83 in chips) 
Seat 2: GSDP ($18.96 in chips) 
Seat 3: azizmimi ($26.43 in chips) 
Seat 4: jacquelinewu ($78.91 in chips) 
Seat 5: Lasutchik ($26.81 in chips) 
Seat 6: Nerkit ($15.35 in chips) 
Seat 7: chiyuki ($39.28 in chips) 
Seat 8: Rici47 ($25.50 in chips) 
Seat 9: andy0815r ($34.03 in chips) 
GSDP: posts small blind $0.10
azizmimi: posts big blind $0.25
*** HOLE CARDS ***
Dealt to chiyuki [9c 7s]
jacquelinewu: raises $0.50 to $0.75
Lasutchik: folds 
Nerkit: folds 
chiyuki: folds 
Rici47: folds 
andy0815r: folds 
Femali54: folds 
GSDP: folds 
azizmimi: calls $0.50
*** FLOP *** [3s Qs 8d]
azizmimi: checks 
jacquelinewu: bets $1.07
azizmimi: calls $1.07
*** TURN *** [3s Qs 8d] [Kh]
azizmimi: checks 
jacquelinewu: checks 
*** RIVER *** [3s Qs 8d Kh] [Kd]
azizmimi: bets $1.78
jacquelinewu: folds 
Uncalled bet ($1.78) returned to azizmimi
azizmimi collected $3.57 from pot
azizmimi: doesn't show hand 
*** SUMMARY ***
Total pot $3.74 | Rake $0.17 
Board [3s Qs 8d Kh Kd]
Seat 1: Femali54 (button) folded before Flop (didn't bet)
Seat 2: GSDP (small blind) folded before Flop
Seat 3: azizmimi (big blind) collected ($3.57)
Seat 4: jacquelinewu folded on the River
Seat 5: Lasutchik folded before Flop (didn't bet)
Seat 6: Nerkit folded before Flop (didn't bet)
Seat 7: chiyuki folded before Flop (didn't bet)
Seat 8: Rici47 folded before Flop (didn't bet)
Seat 9: andy0815r folded before Flop (didn't bet)



PokerStars Zoom Hand #84300937175:  Hold'em No Limit ($0.10/$0.25) - 2012/08/05 16:01:52 JST [2012/08/05 3:01:52 ET]
Table 'Whirlpool' 9-max Seat #1 is the button
Seat 1: kwkim73 ($25 in chips) 
Seat 2: nice.franki ($12.25 in chips) 
Seat 3: scaredsare ($31.54 in chips) 
Seat 4: kesstukas25 ($30.83 in chips) 
Seat 5: phate-1up ($65.91 in chips) 
Seat 6: chiyuki ($39.28 in chips) 
Seat 7: seula i ($44.98 in chips) 
Seat 8: MurMurRu ($25.35 in chips) 
Seat 9: ShockLaMuc ($23.15 in chips) 
nice.franki: posts small blind $0.10
scaredsare: posts big blind $0.25
*** HOLE CARDS ***
Dealt to chiyuki [Ad Ac]
kesstukas25: folds 
phate-1up: folds 
chiyuki: raises $0.50 to $0.75
seula i: folds 
MurMurRu: folds 
ShockLaMuc: folds 
kwkim73: folds 
nice.franki: folds 
scaredsare: folds 
Uncalled bet ($0.50) returned to chiyuki
chiyuki collected $0.60 from pot
chiyuki: doesn't show hand 
*** SUMMARY ***
Total pot $0.60 | Rake $0 
Seat 1: kwkim73 (button) folded before Flop (didn't bet)
Seat 2: nice.franki (small blind) folded before Flop
Seat 3: scaredsare (big blind) folded before Flop
Seat 4: kesstukas25 folded before Flop (didn't bet)
Seat 5: phate-1up folded before Flop (didn't bet)
Seat 6: chiyuki collected ($0.60)
Seat 7: seula i folded before Flop (didn't bet)
Seat 8: MurMurRu folded before Flop (didn't bet)
Seat 9: ShockLaMuc folded before Flop (didn't bet)



PokerStars Zoom Hand #84300945807:  Hold'em No Limit ($0.10/$0.25) - 2012/08/05 16:02:27 JST [2012/08/05 3:02:27 ET]
Table 'Whirlpool' 9-max Seat #1 is the button
Seat 1: ViTiV2010 ($12.50 in chips) 
Seat 2: Perstenev ($12.16 in chips) 
Seat 3: Rici47 ($25.40 in chips) 
Seat 4: chiyuki ($39.63 in chips) 
Seat 5: GovGus ($37.49 in chips) 
Seat 6: Spheroff ($24.90 in chips) 
Seat 7: andy0815r ($36.60 in chips) 
Seat 8: masterkoolb ($19.78 in chips) 
Seat 9: Serge Claws ($42.20 in chips) 
Perstenev: posts small blind $0.10
Rici47: posts big blind $0.25
*** HOLE CARDS ***
Dealt to chiyuki [4h As]
chiyuki: folds 
GovGus: folds 
Spheroff: folds 
andy0815r: raises $0.50 to $0.75
masterkoolb: folds 
Serge Claws: folds 
ViTiV2010: folds 
Perstenev: folds 
Rici47: calls $0.50
*** FLOP *** [2s 7d 3h]
Rici47: checks 
andy0815r: checks 
*** TURN *** [2s 7d 3h] [7s]
Rici47: bets $1
andy0815r: calls $1
*** RIVER *** [2s 7d 3h 7s] [7c]
Rici47: checks 
andy0815r: checks 
*** SHOW DOWN ***
Rici47: shows [9s 9d] (a full house, Sevens full of Nines)
andy0815r: mucks hand 
Rici47 collected $3.44 from pot
*** SUMMARY ***
Total pot $3.60 | Rake $0.16 
Board [2s 7d 3h 7s 7c]
Seat 1: ViTiV2010 (button) folded before Flop (didn't bet)
Seat 2: Perstenev (small blind) folded before Flop
Seat 3: Rici47 (big blind) showed [9s 9d] and won ($3.44) with a full house, Sevens full of Nines
Seat 4: chiyuki folded before Flop (didn't bet)
Seat 5: GovGus folded before Flop (didn't bet)
Seat 6: Spheroff folded before Flop (didn't bet)
Seat 7: andy0815r mucked [Ks Ah]
Seat 8: masterkoolb folded before Flop (didn't bet)
Seat 9: Serge Claws folded before Flop (didn't bet)



PokerStars Zoom Hand #84300947801:  Hold'em No Limit ($0.10/$0.25) - 2012/08/05 16:02:35 JST [2012/08/05 3:02:35 ET]
Table 'Whirlpool' 9-max Seat #1 is the button
Seat 1: azizmimi ($28.18 in chips) 
Seat 2: Lindikor ($14.75 in chips) 
Seat 3: chiyuki ($39.63 in chips) 
Seat 4: munky3 ($38.95 in chips) 
Seat 5: poorpoor6551 ($10.90 in chips) 
Seat 6: DrunkTyphoon ($36.34 in chips) 
Seat 7: dergeb ($8.03 in chips) 
Seat 8: seula i ($44.88 in chips) 
Seat 9: mjmichi ($28.55 in chips) 
Lindikor: posts small blind $0.10
chiyuki: posts big blind $0.25
*** HOLE CARDS ***
Dealt to chiyuki [8h Ts]
munky3: calls $0.25
poorpoor6551: folds 
DrunkTyphoon: folds 
dergeb: folds 
seula i: folds 
mjmichi: folds 
azizmimi: folds 
Lindikor: folds 
chiyuki: checks 
*** FLOP *** [Qs 6d 4c]
chiyuki: checks 
munky3: bets $0.25
chiyuki: folds 
Uncalled bet ($0.25) returned to munky3
munky3 collected $0.57 from pot
munky3: doesn't show hand 
*** SUMMARY ***
Total pot $0.60 | Rake $0.03 
Board [Qs 6d 4c]
Seat 1: azizmimi (button) folded before Flop (didn't bet)
Seat 2: Lindikor (small blind) folded before Flop
Seat 3: chiyuki (big blind) folded on the Flop
Seat 4: munky3 collected ($0.57)
Seat 5: poorpoor6551 folded before Flop (didn't bet)
Seat 6: DrunkTyphoon folded before Flop (didn't bet)
Seat 7: dergeb folded before Flop (didn't bet)
Seat 8: seula i folded before Flop (didn't bet)
Seat 9: mjmichi folded before Flop (didn't bet)



PokerStars Zoom Hand #84300962475:  Hold'em No Limit ($0.10/$0.25) - 2012/08/05 16:03:32 JST [2012/08/05 3:03:32 ET]
Table 'Whirlpool' 9-max Seat #1 is the button
Seat 1: Perstenev ($11.41 in chips) 
Seat 2: INSP!RON ($34.41 in chips) 
Seat 3: Dionisko ($37.20 in chips) 
Seat 4: roksmokndonk ($24.65 in chips) 
Seat 5: phate-1up ($40.97 in chips) 
Seat 6: tribunpdm ($84.24 in chips) 
Seat 7: jacquelinewu ($30.29 in chips) 
Seat 8: chiyuki ($39.38 in chips) 
Seat 9: nice.franki ($5.73 in chips) 
INSP!RON: posts small blind $0.10
Dionisko: posts big blind $0.25
*** HOLE CARDS ***
Dealt to chiyuki [6h 3c]
roksmokndonk: folds 
phate-1up: folds 
tribunpdm: raises $0.50 to $0.75
jacquelinewu: folds 
chiyuki: folds 
nice.franki: folds 
Perstenev: folds 
INSP!RON: folds 
Dionisko: raises $1.25 to $2
tribunpdm: calls $1.25
*** FLOP *** [Jh As 6d]
Dionisko: checks 
tribunpdm: checks 
*** TURN *** [Jh As 6d] [Ac]
Dionisko: checks 
tribunpdm: bets $2.50
Dionisko: calls $2.50
*** RIVER *** [Jh As 6d Ac] [Qs]
Dionisko: checks 
tribunpdm: bets $5.50
Dionisko: calls $5.50
*** SHOW DOWN ***
tribunpdm: shows [7c 9c] (a pair of Aces)
Dionisko: shows [Ks Kd] (two pair, Aces and Kings)
Dionisko collected $19.20 from pot
*** SUMMARY ***
Total pot $20.10 | Rake $0.90 
Board [Jh As 6d Ac Qs]
Seat 1: Perstenev (button) folded before Flop (didn't bet)
Seat 2: INSP!RON (small blind) folded before Flop
Seat 3: Dionisko (big blind) showed [Ks Kd] and won ($19.20) with two pair, Aces and Kings
Seat 4: roksmokndonk folded before Flop (didn't bet)
Seat 5: phate-1up folded before Flop (didn't bet)
Seat 6: tribunpdm showed [7c 9c] and lost with a pair of Aces
Seat 7: jacquelinewu folded before Flop (didn't bet)
Seat 8: chiyuki folded before Flop (didn't bet)
Seat 9: nice.franki folded before Flop (didn't bet)



PokerStars Zoom Hand #84300974206:  Hold'em No Limit ($0.10/$0.25) - 2012/08/05 16:04:17 JST [2012/08/05 3:04:17 ET]
Table 'Whirlpool' 9-max Seat #1 is the button
Seat 1: fwnaf ($24.11 in chips) 
Seat 2: chiyuki ($39.38 in chips) 
Seat 3: nice.franki ($5.73 in chips) 
Seat 4: Femali54 ($22.58 in chips) 
Seat 5: Tonychanman ($16.70 in chips) 
Seat 6: Roglus ($13.56 in chips) 
Seat 7: Cripple86 ($25.60 in chips) 
Seat 8: munky3 ($39.07 in chips) 
Seat 9: tribunpdm ($74.24 in chips) 
chiyuki: posts small blind $0.10
nice.franki: posts big blind $0.25
*** HOLE CARDS ***
Dealt to chiyuki [8c Jc]
Femali54: folds 
Tonychanman: folds 
Roglus: folds 
Cripple86: folds 
munky3: folds 
tribunpdm: folds 
fwnaf: folds 
chiyuki: raises $0.50 to $0.75
nice.franki: folds 
Uncalled bet ($0.50) returned to chiyuki
chiyuki collected $0.50 from pot
chiyuki: doesn't show hand 
*** SUMMARY ***
Total pot $0.50 | Rake $0 
Seat 1: fwnaf (button) folded before Flop (didn't bet)
Seat 2: chiyuki (small blind) collected ($0.50)
Seat 3: nice.franki (big blind) folded before Flop
Seat 4: Femali54 folded before Flop (didn't bet)
Seat 5: Tonychanman folded before Flop (didn't bet)
Seat 6: Roglus folded before Flop (didn't bet)
Seat 7: Cripple86 folded before Flop (didn't bet)
Seat 8: munky3 folded before Flop (didn't bet)
Seat 9: tribunpdm folded before Flop (didn't bet)



PokerStars Zoom Hand #84300972346:  Hold'em No Limit ($0.10/$0.25) - 2012/08/05 16:04:10 JST [2012/08/05 3:04:10 ET]
Table 'Whirlpool' 9-max Seat #1 is the button
Seat 1: ivan130 ($23 in chips) 
Seat 2: Perstenev ($14.86 in chips) 
Seat 3: GovGus ($45.44 in chips) 
Seat 4: seula i ($44.53 in chips) 
Seat 5: MurMurRu ($25 in chips) 
Seat 6: chiyuki ($39.38 in chips) 
Seat 7: zongo1 ($23.80 in chips) 
Seat 8: Alvinpe85 ($95.72 in chips) 
Seat 9: phate-1up ($40.97 in chips) 
Perstenev: posts small blind $0.10
GovGus: posts big blind $0.25
*** HOLE CARDS ***
Dealt to chiyuki [5d 5s]
seula i: folds 
MurMurRu: folds 
chiyuki: folds 
zongo1: folds 
Alvinpe85: folds 
phate-1up: folds 
ivan130: folds 
Perstenev: raises $0.50 to $0.75
GovGus: raises $1.50 to $2.25
Perstenev: calls $1.50
*** FLOP *** [5c 4h 7s]
Perstenev: checks 
GovGus: bets $2.75
Perstenev: folds 
Uncalled bet ($2.75) returned to GovGus
GovGus collected $4.30 from pot
GovGus: doesn't show hand 
*** SUMMARY ***
Total pot $4.50 | Rake $0.20 
Board [5c 4h 7s]
Seat 1: ivan130 (button) folded before Flop (didn't bet)
Seat 2: Perstenev (small blind) folded on the Flop
Seat 3: GovGus (big blind) collected ($4.30)
Seat 4: seula i folded before Flop (didn't bet)
Seat 5: MurMurRu folded before Flop (didn't bet)
Seat 6: chiyuki folded before Flop (didn't bet)
Seat 7: zongo1 folded before Flop (didn't bet)
Seat 8: Alvinpe85 folded before Flop (didn't bet)
Seat 9: phate-1up folded before Flop (didn't bet)



PokerStars Zoom Hand #84300964067:  Hold'em No Limit ($0.10/$0.25) - 2012/08/05 16:03:38 JST [2012/08/05 3:03:38 ET]
Table 'Whirlpool' 9-max Seat #1 is the button
Seat 1: chiyuki ($39.38 in chips) 
Seat 2: snejokCoxx ($12.25 in chips) 
Seat 3: 1Karina1 ($34.12 in chips) 
Seat 4: ShockLaMuc ($26.55 in chips) 
Seat 5: seula i ($26.62 in chips) 
Seat 6: Bahia gyn ($25.81 in chips) 
Seat 7: silvno31 ($68.05 in chips) 
Seat 8: Nerkit ($15.35 in chips) 
Seat 9: 6nikola9 ($6.84 in chips) 
snejokCoxx: posts small blind $0.10
1Karina1: posts big blind $0.25
*** HOLE CARDS ***
Dealt to chiyuki [9d Ah]
ShockLaMuc: folds 
seula i: folds 
Bahia gyn: raises $0.50 to $0.75
silvno31: folds 
Nerkit: folds 
6nikola9: folds 
chiyuki: folds 
snejokCoxx: folds 
1Karina1: folds 
Uncalled bet ($0.50) returned to Bahia gyn
Bahia gyn collected $0.60 from pot
Bahia gyn: doesn't show hand 
*** SUMMARY ***
Total pot $0.60 | Rake $0 
Seat 1: chiyuki (button) folded before Flop (didn't bet)
Seat 2: snejokCoxx (small blind) folded before Flop
Seat 3: 1Karina1 (big blind) folded before Flop
Seat 4: ShockLaMuc folded before Flop (didn't bet)
Seat 5: seula i folded before Flop (didn't bet)
Seat 6: Bahia gyn collected ($0.60)
Seat 7: silvno31 folded before Flop (didn't bet)
Seat 8: Nerkit folded before Flop (didn't bet)
Seat 9: 6nikola9 folded before Flop (didn't bet)



PokerStars Zoom Hand #84300981158:  Hold'em No Limit ($0.10/$0.25) - 2012/08/05 16:04:43 JST [2012/08/05 3:04:43 ET]
Table 'Whirlpool' 9-max Seat #1 is the button
Seat 1: Perstenev ($12.61 in chips) 
Seat 2: leo2095 ($26.41 in chips) 
Seat 3: jacquelinewu ($25.59 in chips) 
Seat 4: snejokCoxx ($12.25 in chips) 
Seat 5: chiyuki ($39.63 in chips) 
Seat 6: deepakmbh ($35.36 in chips) 
Seat 7: 4ydo yogurt ($60.84 in chips) 
Seat 8: Nerkit ($15 in chips) 
Seat 9: masterkoolb ($12.50 in chips) 
leo2095: posts small blind $0.10
jacquelinewu: posts big blind $0.25
*** HOLE CARDS ***
Dealt to chiyuki [7h 2d]
snejokCoxx: folds 
chiyuki: folds 
deepakmbh: raises $0.50 to $0.75
4ydo yogurt: folds 
Nerkit: folds 
masterkoolb: folds 
Perstenev: folds 
leo2095: folds 
jacquelinewu: folds 
Uncalled bet ($0.50) returned to deepakmbh
deepakmbh collected $0.60 from pot
deepakmbh: doesn't show hand 
*** SUMMARY ***
Total pot $0.60 | Rake $0 
Seat 1: Perstenev (button) folded before Flop (didn't bet)
Seat 2: leo2095 (small blind) folded before Flop
Seat 3: jacquelinewu (big blind) folded before Flop
Seat 4: snejokCoxx folded before Flop (didn't bet)
Seat 5: chiyuki folded before Flop (didn't bet)
Seat 6: deepakmbh collected ($0.60)
Seat 7: 4ydo yogurt folded before Flop (didn't bet)
Seat 8: Nerkit folded before Flop (didn't bet)
Seat 9: masterkoolb folded before Flop (didn't bet)



PokerStars Zoom Hand #84300984368:  Hold'em No Limit ($0.10/$0.25) - 2012/08/05 16:04:55 JST [2012/08/05 3:04:55 ET]
Table 'Whirlpool' 9-max Seat #1 is the button
Seat 1: xxASSO124xx ($8.97 in chips) 
Seat 2: Rici47 ($26.49 in chips) 
Seat 3: Fructionar ($50.13 in chips) 
Seat 4: chiyuki ($39.63 in chips) 
Seat 5: pawn909 ($20.48 in chips) 
Seat 6: andy0815r ($35.91 in chips) 
Seat 7: INSP!RON ($35.16 in chips) 
Seat 8: phate-1up ($59.64 in chips) 
Seat 9: yoube ($46.63 in chips) 
Rici47: posts small blind $0.10
Fructionar: posts big blind $0.25
*** HOLE CARDS ***
Dealt to chiyuki [8h Qs]
chiyuki: folds 
pawn909: folds 
andy0815r: folds 
INSP!RON: raises $0.50 to $0.75
phate-1up: folds 
yoube: folds 
xxASSO124xx: folds 
Rici47: folds 
Fructionar: calls $0.50
*** FLOP *** [6d 3c Ts]
Fructionar: checks 
INSP!RON: bets $1.10
Fructionar: raises $1.86 to $2.96
INSP!RON: folds 
Uncalled bet ($1.86) returned to Fructionar
Fructionar collected $3.63 from pot
Fructionar: doesn't show hand 
*** SUMMARY ***
Total pot $3.80 | Rake $0.17 
Board [6d 3c Ts]
Seat 1: xxASSO124xx (button) folded before Flop (didn't bet)
Seat 2: Rici47 (small blind) folded before Flop
Seat 3: Fructionar (big blind) collected ($3.63)
Seat 4: chiyuki folded before Flop (didn't bet)
Seat 5: pawn909 folded before Flop (didn't bet)
Seat 6: andy0815r folded before Flop (didn't bet)
Seat 7: INSP!RON folded on the Flop
Seat 8: phate-1up folded before Flop (didn't bet)
Seat 9: yoube folded before Flop (didn't bet)



PokerStars Zoom Hand #84300979692:  Hold'em No Limit ($0.10/$0.25) - 2012/08/05 16:04:38 JST [2012/08/05 3:04:38 ET]
Table 'Whirlpool' 9-max Seat #1 is the button
Seat 1: CrittHunter ($22.71 in chips) 
Seat 2: Mytea88 ($13.75 in chips) 
Seat 3: Saruotiss ($61.03 in chips) 
Seat 4: Grishukps ($12.60 in chips) 
Seat 5: deepakmbh ($35.36 in chips) 
Seat 6: Cripple86 ($26.59 in chips) 
Seat 7: chiyuki ($39.63 in chips) 
Seat 8: DrunkTyphoon ($36.34 in chips) 
Seat 9: hldtom ($18.50 in chips) 
Mytea88: posts small blind $0.10
Saruotiss: posts big blind $0.25
*** HOLE CARDS ***
Dealt to chiyuki [Kh 6d]
Grishukps: folds 
deepakmbh: folds 
Cripple86: folds 
chiyuki: folds 
DrunkTyphoon: folds 
hldtom: raises $0.50 to $0.75
CrittHunter: folds 
Mytea88: folds 
Saruotiss: raises $0.50 to $1.25
hldtom: calls $0.50
*** FLOP *** [9h 3s Ks]
Saruotiss: checks 
hldtom: bets $1.88
Saruotiss: folds 
Uncalled bet ($1.88) returned to hldtom
hldtom collected $2.48 from pot
hldtom: doesn't show hand 
*** SUMMARY ***
Total pot $2.60 | Rake $0.12 
Board [9h 3s Ks]
Seat 1: CrittHunter (button) folded before Flop (didn't bet)
Seat 2: Mytea88 (small blind) folded before Flop
Seat 3: Saruotiss (big blind) folded on the Flop
Seat 4: Grishukps folded before Flop (didn't bet)
Seat 5: deepakmbh folded before Flop (didn't bet)
Seat 6: Cripple86 folded before Flop (didn't bet)
Seat 7: chiyuki folded before Flop (didn't bet)
Seat 8: DrunkTyphoon folded before Flop (didn't bet)
Seat 9: hldtom collected ($2.48)



PokerStars Zoom Hand #84300982499:  Hold'em No Limit ($0.10/$0.25) - 2012/08/05 16:04:48 JST [2012/08/05 3:04:48 ET]
Table 'Whirlpool' 9-max Seat #1 is the button
Seat 1: wildy29 ($91.36 in chips) 
Seat 2: nice.franki ($5.48 in chips) 
Seat 3: silvno31 ($64.95 in chips) 
Seat 4: Faantomace ($30.05 in chips) 
Seat 5: Nerkit ($12.25 in chips) 
Seat 6: Limoilou ($27.56 in chips) 
Seat 7: Cripple86 ($25 in chips) 
Seat 8: yoube ($46.63 in chips) 
Seat 9: chiyuki ($39.63 in chips) 
nice.franki: posts small blind $0.10
silvno31: posts big blind $0.25
*** HOLE CARDS ***
Dealt to chiyuki [6d 3c]
Faantomace: folds 
Nerkit: raises $0.50 to $0.75
Limoilou: folds 
Cripple86: folds 
yoube: folds 
chiyuki: folds 
wildy29: folds 
nice.franki: folds 
silvno31: calls $0.50
*** FLOP *** [Jd 3d 7d]
silvno31: checks 
Nerkit: bets $1
silvno31: calls $1
*** TURN *** [Jd 3d 7d] [Ts]
silvno31: checks 
Nerkit: checks 
*** RIVER *** [Jd 3d 7d Ts] [Jh]
silvno31: bets $1.50
Nerkit: folds 
Uncalled bet ($1.50) returned to silvno31
silvno31 collected $3.44 from pot
silvno31: doesn't show hand 
*** SUMMARY ***
Total pot $3.60 | Rake $0.16 
Board [Jd 3d 7d Ts Jh]
Seat 1: wildy29 (button) folded before Flop (didn't bet)
Seat 2: nice.franki (small blind) folded before Flop
Seat 3: silvno31 (big blind) collected ($3.44)
Seat 4: Faantomace folded before Flop (didn't bet)
Seat 5: Nerkit folded on the River
Seat 6: Limoilou folded before Flop (didn't bet)
Seat 7: Cripple86 folded before Flop (didn't bet)
Seat 8: yoube folded before Flop (didn't bet)
Seat 9: chiyuki folded before Flop (didn't bet)



PokerStars Zoom Hand #84300985150:  Hold'em No Limit ($0.10/$0.25) - 2012/08/05 16:04:58 JST [2012/08/05 3:04:58 ET]
Table 'Whirlpool' 9-max Seat #1 is the button
Seat 1: ShockLaMuc ($26.20 in chips) 
Seat 2: Grishukps ($12.50 in chips) 
Seat 3: chiyuki ($39.63 in chips) 
Seat 4: Limoilou ($27.56 in chips) 
Seat 5: phate-1up ($60.78 in chips) 
Seat 6: 6nikola9 ($6.49 in chips) 
Seat 7: wildy29 ($91.36 in chips) 
Seat 8: GSDP ($37.85 in chips) 
Seat 9: Serge Claws ($42.63 in chips) 
Grishukps: posts small blind $0.10
chiyuki: posts big blind $0.25
*** HOLE CARDS ***
Dealt to chiyuki [9s Ts]
Limoilou: folds 
phate-1up: folds 
6nikola9: folds 
wildy29: calls $0.25
GSDP: calls $0.25
Serge Claws: folds 
ShockLaMuc: calls $0.25
Grishukps: folds 
chiyuki: checks 
*** FLOP *** [Ks Kd 7c]
chiyuki: checks 
wildy29: checks 
GSDP: checks 
ShockLaMuc: checks 
*** TURN *** [Ks Kd 7c] [Ad]
chiyuki: checks 
wildy29: checks 
GSDP: checks 
ShockLaMuc: checks 
*** RIVER *** [Ks Kd 7c Ad] [2h]
chiyuki: checks 
wildy29: checks 
GSDP: checks 
ShockLaMuc: checks 
*** SHOW DOWN ***
chiyuki: shows [9s Ts] (a pair of Kings)
wildy29: mucks hand 
GSDP: mucks hand 
ShockLaMuc: mucks hand 
chiyuki collected $1.05 from pot
*** SUMMARY ***
Total pot $1.10 | Rake $0.05 
Board [Ks Kd 7c Ad 2h]
Seat 1: ShockLaMuc (button) mucked [9d 6d]
Seat 2: Grishukps (small blind) folded before Flop
Seat 3: chiyuki (big blind) showed [9s Ts] and won ($1.05) with a pair of Kings
Seat 4: Limoilou folded before Flop (didn't bet)
Seat 5: phate-1up folded before Flop (didn't bet)
Seat 6: 6nikola9 folded before Flop (didn't bet)
Seat 7: wildy29 mucked [5s 4s]
Seat 8: GSDP mucked [5d 4d]
Seat 9: Serge Claws folded before Flop (didn't bet)



PokerStars Zoom Hand #84300983274:  Hold'em No Limit ($0.10/$0.25) - 2012/08/05 16:04:51 JST [2012/08/05 3:04:51 ET]
Table 'Whirlpool' 9-max Seat #1 is the button
Seat 1: Grumpy as 2 ($12.65 in chips) 
Seat 2: scaredsare ($15.37 in chips) 
Seat 3: MurMurRu ($27.68 in chips) 
Seat 4: snejokCoxx ($12.15 in chips) 
Seat 5: Fructionar ($50.13 in chips) 
Seat 6: westhavenbc ($15.16 in chips) 
Seat 7: Jene4kaBest ($11.36 in chips) 
Seat 8: chiyuki ($39.63 in chips) 
Seat 9: Perstenev ($8.78 in chips) 
scaredsare: posts small blind $0.10
MurMurRu: posts big blind $0.25
*** HOLE CARDS ***
Dealt to chiyuki [8c 2h]
snejokCoxx: folds 
Fructionar: folds 
westhavenbc: folds 
Jene4kaBest: raises $0.50 to $0.75
chiyuki: folds 
Perstenev: folds 
Grumpy as 2: folds 
scaredsare: calls $0.65
MurMurRu: calls $0.50
*** FLOP *** [5d 5h Qd]
scaredsare: checks 
MurMurRu: checks 
Jene4kaBest: bets $0.75
scaredsare: calls $0.75
MurMurRu: calls $0.75
*** TURN *** [5d 5h Qd] [4c]
scaredsare: checks 
MurMurRu: checks 
Jene4kaBest: bets $2.50
scaredsare: calls $2.50
MurMurRu: raises $8.85 to $11.35
Jene4kaBest: calls $7.36 and is all-in
scaredsare: folds 
Uncalled bet ($1.49) returned to MurMurRu
*** RIVER *** [5d 5h Qd 4c] [6c]
*** SHOW DOWN ***
MurMurRu: shows [5s As] (three of a kind, Fives)
Jene4kaBest: mucks hand 
MurMurRu collected $25.52 from pot
*** SUMMARY ***
Total pot $26.72 | Rake $1.20 
Board [5d 5h Qd 4c 6c]
Seat 1: Grumpy as 2 (button) folded before Flop (didn't bet)
Seat 2: scaredsare (small blind) folded on the Turn
Seat 3: MurMurRu (big blind) showed [5s As] and won ($25.52) with three of a kind, Fives
Seat 4: snejokCoxx folded before Flop (didn't bet)
Seat 5: Fructionar folded before Flop (didn't bet)
Seat 6: westhavenbc folded before Flop (didn't bet)
Seat 7: Jene4kaBest mucked [Ah Ad]
Seat 8: chiyuki folded before Flop (didn't bet)
Seat 9: Perstenev folded before Flop (didn't bet)



PokerStars Zoom Hand #84301002902:  Hold'em No Limit ($0.10/$0.25) - 2012/08/05 16:06:05 JST [2012/08/05 3:06:05 ET]
Table 'Whirlpool' 9-max Seat #1 is the button
Seat 1: 1Karina1 ($55.19 in chips) 
Seat 2: Perstenev ($16.02 in chips) 
Seat 3: Grumpy as 2 ($11.90 in chips) 
Seat 4: Ellen1947 ($31.66 in chips) 
Seat 5: Kasperlmusik ($28.42 in chips) 
Seat 6: seula i ($25.35 in chips) 
Seat 7: nice.franki ($5.38 in chips) 
Seat 8: azizmimi ($30.25 in chips) 
Seat 9: chiyuki ($40.43 in chips) 
Perstenev: posts small blind $0.10
Grumpy as 2: posts big blind $0.25
*** HOLE CARDS ***
Dealt to chiyuki [7c Ks]
Ellen1947: folds 
Kasperlmusik: folds 
seula i: folds 
nice.franki: folds 
azizmimi: folds 
chiyuki: folds 
1Karina1: folds 
Perstenev: calls $0.15
Grumpy as 2: checks 
*** FLOP *** [Kh Ah Td]
Perstenev: bets $0.48
Grumpy as 2: folds 
Uncalled bet ($0.48) returned to Perstenev
Perstenev collected $0.48 from pot
Perstenev: doesn't show hand 
*** SUMMARY ***
Total pot $0.50 | Rake $0.02 
Board [Kh Ah Td]
Seat 1: 1Karina1 (button) folded before Flop (didn't bet)
Seat 2: Perstenev (small blind) collected ($0.48)
Seat 3: Grumpy as 2 (big blind) folded on the Flop
Seat 4: Ellen1947 folded before Flop (didn't bet)
Seat 5: Kasperlmusik folded before Flop (didn't bet)
Seat 6: seula i folded before Flop (didn't bet)
Seat 7: nice.franki folded before Flop (didn't bet)
Seat 8: azizmimi folded before Flop (didn't bet)
Seat 9: chiyuki folded before Flop (didn't bet)



PokerStars Zoom Hand #84301001284:  Hold'em No Limit ($0.10/$0.25) - 2012/08/05 16:05:59 JST [2012/08/05 3:05:59 ET]
Table 'Whirlpool' 9-max Seat #1 is the button
Seat 1: Limoilou ($28.48 in chips) 
Seat 2: westhavenbc ($18.30 in chips) 
Seat 3: Vall179 ($25 in chips) 
Seat 4: 1Karina1 ($55.19 in chips) 
Seat 5: Ellen1947 ($31.66 in chips) 
Seat 6: chiyuki ($40.43 in chips) 
Seat 7: Rici47 ($38.97 in chips) 
Seat 8: Perstenev ($16.02 in chips) 
Seat 9: Grishukps ($12.50 in chips) 
westhavenbc: posts small blind $0.10
Vall179: posts big blind $0.25
*** HOLE CARDS ***
Dealt to chiyuki [Ts Ah]
1Karina1: folds 
Ellen1947: folds 
chiyuki: folds 
Rici47: folds 
Perstenev: folds 
Grishukps: raises $0.37 to $0.62
Limoilou: folds 
westhavenbc: folds 
Vall179: folds 
Uncalled bet ($0.37) returned to Grishukps
Grishukps collected $0.60 from pot
Grishukps: doesn't show hand 
*** SUMMARY ***
Total pot $0.60 | Rake $0 
Seat 1: Limoilou (button) folded before Flop (didn't bet)
Seat 2: westhavenbc (small blind) folded before Flop
Seat 3: Vall179 (big blind) folded before Flop
Seat 4: 1Karina1 folded before Flop (didn't bet)
Seat 5: Ellen1947 folded before Flop (didn't bet)
Seat 6: chiyuki folded before Flop (didn't bet)
Seat 7: Rici47 folded before Flop (didn't bet)
Seat 8: Perstenev folded before Flop (didn't bet)
Seat 9: Grishukps collected ($0.60)



PokerStars Zoom Hand #84301008222:  Hold'em No Limit ($0.10/$0.25) - 2012/08/05 16:06:25 JST [2012/08/05 3:06:25 ET]
Table 'Whirlpool' 9-max Seat #1 is the button
Seat 1: Fructionar ($51.41 in chips) 
Seat 2: kesstukas25 ($31.05 in chips) 
Seat 3: Cripple86 ($25.25 in chips) 
Seat 4: DanielWhyte ($33.65 in chips) 
Seat 5: chiyuki ($40.33 in chips) 
Seat 6: schoof 2 ($56.59 in chips) 
Seat 7: masterkoolb ($14.23 in chips) 
Seat 8: GovGus ($47.63 in chips) 
Seat 9: phate-1up ($64.03 in chips) 
kesstukas25: posts small blind $0.10
Cripple86: posts big blind $0.25
*** HOLE CARDS ***
Dealt to chiyuki [8c 8h]
DanielWhyte: raises $0.50 to $0.75
chiyuki: calls $0.75
schoof 2: folds 
masterkoolb: folds 
GovGus: folds 
phate-1up: folds 
Fructionar: folds 
kesstukas25: folds 
Cripple86: folds 
*** FLOP *** [Qc 4d Ac]
DanielWhyte: checks 
chiyuki: checks 
*** TURN *** [Qc 4d Ac] [2d]
DanielWhyte: bets $0.50
chiyuki: folds 
Uncalled bet ($0.50) returned to DanielWhyte
DanielWhyte collected $1.77 from pot
DanielWhyte: doesn't show hand 
*** SUMMARY ***
Total pot $1.85 | Rake $0.08 
Board [Qc 4d Ac 2d]
Seat 1: Fructionar (button) folded before Flop (didn't bet)
Seat 2: kesstukas25 (small blind) folded before Flop
Seat 3: Cripple86 (big blind) folded before Flop
Seat 4: DanielWhyte collected ($1.77)
Seat 5: chiyuki folded on the Turn
Seat 6: schoof 2 folded before Flop (didn't bet)
Seat 7: masterkoolb folded before Flop (didn't bet)
Seat 8: GovGus folded before Flop (didn't bet)
Seat 9: phate-1up folded before Flop (didn't bet)



PokerStars Zoom Hand #84301006134:  Hold'em No Limit ($0.10/$0.25) - 2012/08/05 16:06:17 JST [2012/08/05 3:06:17 ET]
Table 'Whirlpool' 9-max Seat #1 is the button
Seat 1: kesstukas25 ($12.50 in chips) 
Seat 2: chiyuki ($40.43 in chips) 
Seat 3: Loholov ($15 in chips) 
Seat 4: kwkim73 ($31.19 in chips) 
Seat 5: seula i ($44.18 in chips) 
Seat 6: azizmimi ($30.15 in chips) 
Seat 7: andy0815r ($33.66 in chips) 
Seat 8: Vall179 ($24.65 in chips) 
Seat 9: Grishukps ($12.75 in chips) 
chiyuki: posts small blind $0.10
Loholov: posts big blind $0.25
*** HOLE CARDS ***
Dealt to chiyuki [8c Qc]
kwkim73: folds 
seula i: raises $0.50 to $0.75
azizmimi: folds 
andy0815r: calls $0.75
Vall179: folds 
Grishukps: folds 
kesstukas25: folds 
chiyuki: folds 
Loholov: raises $2.25 to $3
seula i: folds 
andy0815r: calls $2.25
*** FLOP *** [2d 2s Qd]
Loholov: bets $4
andy0815r: calls $4
*** TURN *** [2d 2s Qd] [Jh]
Loholov: checks 
andy0815r: bets $10.63
Loholov: calls $8 and is all-in
Uncalled bet ($2.63) returned to andy0815r
*** RIVER *** [2d 2s Qd Jh] [9h]
*** SHOW DOWN ***
Loholov: shows [Kh As] (a pair of Deuces)
andy0815r: shows [Td Ts] (two pair, Tens and Deuces)
andy0815r collected $29.46 from pot
*** SUMMARY ***
Total pot $30.85 | Rake $1.39 
Board [2d 2s Qd Jh 9h]
Seat 1: kesstukas25 (button) folded before Flop (didn't bet)
Seat 2: chiyuki (small blind) folded before Flop
Seat 3: Loholov (big blind) showed [Kh As] and lost with a pair of Deuces
Seat 4: kwkim73 folded before Flop (didn't bet)
Seat 5: seula i folded before Flop
Seat 6: azizmimi folded before Flop (didn't bet)
Seat 7: andy0815r showed [Td Ts] and won ($29.46) with two pair, Tens and Deuces
Seat 8: Vall179 folded before Flop (didn't bet)
Seat 9: Grishukps folded before Flop (didn't bet)



PokerStars Zoom Hand #84300999902:  Hold'em No Limit ($0.10/$0.25) - 2012/08/05 16:05:54 JST [2012/08/05 3:05:54 ET]
Table 'Whirlpool' 9-max Seat #1 is the button
Seat 1: ShockLaMuc ($21.85 in chips) 
Seat 2: MurMurRu ($41.84 in chips) 
Seat 3: CrittHunter ($21.61 in chips) 
Seat 4: Perstenev ($16.02 in chips) 
Seat 5: deepakmbh ($33.96 in chips) 
Seat 6: wildy29 ($91.11 in chips) 
Seat 7: chiyuki ($40.43 in chips) 
Seat 8: Cripple86 ($25 in chips) 
Seat 9: GSDP ($24.84 in chips) 
MurMurRu: posts small blind $0.10
CrittHunter: posts big blind $0.25
*** HOLE CARDS ***
Dealt to chiyuki [Jc 8h]
Perstenev: folds 
deepakmbh: folds 
wildy29: calls $0.25
chiyuki: folds 
Cripple86: folds 
GSDP: folds 
ShockLaMuc: calls $0.25
MurMurRu: folds 
CrittHunter: checks 
*** FLOP *** [Ah 6h 6c]
CrittHunter: checks 
wildy29: checks 
ShockLaMuc: bets $0.55
CrittHunter: folds 
wildy29: calls $0.55
*** TURN *** [Ah 6h 6c] [Qs]
wildy29: checks 
ShockLaMuc: bets $2.25
wildy29: calls $2.25
*** RIVER *** [Ah 6h 6c Qs] [5h]
wildy29: checks 
ShockLaMuc: checks 
*** SHOW DOWN ***
wildy29: shows [6s 4s] (three of a kind, Sixes)
ShockLaMuc: shows [4d 6d] (three of a kind, Sixes)
wildy29 collected $3.08 from pot
ShockLaMuc collected $3.08 from pot
*** SUMMARY ***
Total pot $6.45 | Rake $0.29 
Board [Ah 6h 6c Qs 5h]
Seat 1: ShockLaMuc (button) showed [4d 6d] and won ($3.08) with three of a kind, Sixes
Seat 2: MurMurRu (small blind) folded before Flop
Seat 3: CrittHunter (big blind) folded on the Flop
Seat 4: Perstenev folded before Flop (didn't bet)
Seat 5: deepakmbh folded before Flop (didn't bet)
Seat 6: wildy29 showed [6s 4s] and won ($3.08) with three of a kind, Sixes
Seat 7: chiyuki folded before Flop (didn't bet)
Seat 8: Cripple86 folded before Flop (didn't bet)
Seat 9: GSDP folded before Flop (didn't bet)



PokerStars Zoom Hand #84301016010:  Hold'em No Limit ($0.10/$0.25) - 2012/08/05 16:06:55 JST [2012/08/05 3:06:55 ET]
Table 'Whirlpool' 9-max Seat #1 is the button
Seat 1: chiyuki ($39.58 in chips) 
Seat 2: Loholov ($15 in chips) 
Seat 3: DanielWhyte ($34.67 in chips) 
Seat 4: Perstenev ($11.38 in chips) 
Seat 5: DrunkTyphoon ($42.10 in chips) 
Seat 6: Cripple86 ($25.35 in chips) 
Seat 7: opie62 ($31.70 in chips) 
Seat 8: Dejacob ($33.77 in chips) 
Seat 9: Serge Claws ($65.05 in chips) 
Loholov: posts small blind $0.10
DanielWhyte: posts big blind $0.25
*** HOLE CARDS ***
Dealt to chiyuki [2d Jh]
Perstenev: folds 
DrunkTyphoon: folds 
Cripple86: folds 
opie62: folds 
Dejacob: folds 
Serge Claws: folds 
chiyuki: folds 
Loholov: folds 
Uncalled bet ($0.15) returned to DanielWhyte
DanielWhyte collected $0.20 from pot
DanielWhyte: doesn't show hand 
*** SUMMARY ***
Total pot $0.20 | Rake $0 
Seat 1: chiyuki (button) folded before Flop (didn't bet)
Seat 2: Loholov (small blind) folded before Flop
Seat 3: DanielWhyte (big blind) collected ($0.20)
Seat 4: Perstenev folded before Flop (didn't bet)
Seat 5: DrunkTyphoon folded before Flop (didn't bet)
Seat 6: Cripple86 folded before Flop (didn't bet)
Seat 7: opie62 folded before Flop (didn't bet)
Seat 8: Dejacob folded before Flop (didn't bet)
Seat 9: Serge Claws folded before Flop (didn't bet)



PokerStars Zoom Hand #84301018361:  Hold'em No Limit ($0.10/$0.25) - 2012/08/05 16:07:04 JST [2012/08/05 3:07:04 ET]
Table 'Whirlpool' 9-max Seat #1 is the button
Seat 1: phate-1up ($40.47 in chips) 
Seat 2: Loholov ($15 in chips) 
Seat 3: chiyuki ($39.58 in chips) 
Seat 4: kwkim73 ($26.48 in chips) 
Seat 5: Serge Claws ($64.95 in chips) 
Seat 6: ShockLaMuc ($22.20 in chips) 
Seat 7: azizmimi ($30.93 in chips) 
Seat 8: Cripple86 ($29.98 in chips) 
Seat 9: andy0815r ($48.12 in chips) 
Loholov: posts small blind $0.10
chiyuki: posts big blind $0.25
*** HOLE CARDS ***
Dealt to chiyuki [7h Qc]
Loholov said, "fish"
kwkim73: folds 
Serge Claws: folds 
ShockLaMuc: folds 
azizmimi: folds 
Cripple86: folds 
andy0815r: folds 
phate-1up: raises $0.50 to $0.75
Loholov: folds 
chiyuki: folds 
Uncalled bet ($0.50) returned to phate-1up
phate-1up collected $0.60 from pot
phate-1up: doesn't show hand 
*** SUMMARY ***
Total pot $0.60 | Rake $0 
Seat 1: phate-1up (button) collected ($0.60)
Seat 2: Loholov (small blind) folded before Flop
Seat 3: chiyuki (big blind) folded before Flop
Seat 4: kwkim73 folded before Flop (didn't bet)
Seat 5: Serge Claws folded before Flop (didn't bet)
Seat 6: ShockLaMuc folded before Flop (didn't bet)
Seat 7: azizmimi folded before Flop (didn't bet)
Seat 8: Cripple86 folded before Flop (didn't bet)
Seat 9: andy0815r folded before Flop (didn't bet)



PokerStars Zoom Hand #84301017293:  Hold'em No Limit ($0.10/$0.25) - 2012/08/05 16:07:00 JST [2012/08/05 3:07:00 ET]
Table 'Whirlpool' 9-max Seat #1 is the button
Seat 1: 1Karina1 ($37.61 in chips) 
Seat 2: Dejacob ($33.77 in chips) 
Seat 3: Lasutchik ($28.44 in chips) 
Seat 4: Grishukps ($12.50 in chips) 
Seat 5: Cripple86 ($25.35 in chips) 
Seat 6: TorTrade ($23.22 in chips) 
Seat 7: chiyuki ($39.58 in chips) 
Seat 8: Rici47 ($39.65 in chips) 
Seat 9: GovGus ($47.29 in chips) 
Dejacob: posts small blind $0.10
Lasutchik: posts big blind $0.25
*** HOLE CARDS ***
Dealt to chiyuki [7s 2d]
Grishukps: folds 
Cripple86: folds 
TorTrade: folds 
chiyuki: folds 
Rici47: folds 
GovGus: folds 
1Karina1: folds 
Dejacob: folds 
Uncalled bet ($0.15) returned to Lasutchik
Lasutchik collected $0.20 from pot
Lasutchik: doesn't show hand 
*** SUMMARY ***
Total pot $0.20 | Rake $0 
Seat 1: 1Karina1 (button) folded before Flop (didn't bet)
Seat 2: Dejacob (small blind) folded before Flop
Seat 3: Lasutchik (big blind) collected ($0.20)
Seat 4: Grishukps folded before Flop (didn't bet)
Seat 5: Cripple86 folded before Flop (didn't bet)
Seat 6: TorTrade folded before Flop (didn't bet)
Seat 7: chiyuki folded before Flop (didn't bet)
Seat 8: Rici47 folded before Flop (didn't bet)
Seat 9: GovGus folded before Flop (didn't bet)



PokerStars Zoom Hand #84301024283:  Hold'em No Limit ($0.10/$0.25) - 2012/08/05 16:07:26 JST [2012/08/05 3:07:26 ET]
Table 'Whirlpool' 9-max Seat #1 is the button
Seat 1: pandaaaaaa ($18.11 in chips) 
Seat 2: Grishukps ($12.50 in chips) 
Seat 3: andy0815r ($48.12 in chips) 
Seat 4: INSP!RON ($31.93 in chips) 
Seat 5: chiyuki ($39.33 in chips) 
Seat 6: kwkim73 ($32.37 in chips) 
Seat 7: Cripple86 ($25 in chips) 
Seat 8: pikhtovnikov ($25.13 in chips) 
Seat 9: Vall179 ($24.30 in chips) 
Grishukps: posts small blind $0.10
andy0815r: posts big blind $0.25
*** HOLE CARDS ***
Dealt to chiyuki [8h 2d]
INSP!RON: folds 
chiyuki: folds 
kwkim73: folds 
Cripple86: folds 
pikhtovnikov: folds 
Vall179: folds 
pandaaaaaa: folds 
Grishukps: raises $0.37 to $0.62
andy0815r: folds 
Uncalled bet ($0.37) returned to Grishukps
Grishukps collected $0.50 from pot
Grishukps: doesn't show hand 
*** SUMMARY ***
Total pot $0.50 | Rake $0 
Seat 1: pandaaaaaa (button) folded before Flop (didn't bet)
Seat 2: Grishukps (small blind) collected ($0.50)
Seat 3: andy0815r (big blind) folded before Flop
Seat 4: INSP!RON folded before Flop (didn't bet)
Seat 5: chiyuki folded before Flop (didn't bet)
Seat 6: kwkim73 folded before Flop (didn't bet)
Seat 7: Cripple86 folded before Flop (didn't bet)
Seat 8: pikhtovnikov folded before Flop (didn't bet)
Seat 9: Vall179 folded before Flop (didn't bet)



PokerStars Zoom Hand #84301030226:  Hold'em No Limit ($0.10/$0.25) - 2012/08/05 16:07:48 JST [2012/08/05 3:07:48 ET]
Table 'Whirlpool' 9-max Seat #1 is the button
Seat 1: chiyuki ($39.33 in chips) 
Seat 2: xxASSO124xx ($10.21 in chips) 
Seat 3: 4plankton ($8.68 in chips) 
Seat 4: 1Karina1 ($36.01 in chips) 
Seat 5: INSP!RON ($31.17 in chips) 
Seat 6: deepakmbh ($24.16 in chips) 
Seat 7: scaredsare ($25.03 in chips) 
Seat 8: Nerkit ($8.90 in chips) 
Seat 9: mjmichi ($25.60 in chips) 
xxASSO124xx: posts small blind $0.10
4plankton: posts big blind $0.25
*** HOLE CARDS ***
Dealt to chiyuki [4s Js]
1Karina1: folds 
INSP!RON: folds 
deepakmbh: raises $0.50 to $0.75
scaredsare: folds 
Nerkit: folds 
mjmichi: folds 
chiyuki: folds 
xxASSO124xx: folds 
4plankton: folds 
Uncalled bet ($0.50) returned to deepakmbh
deepakmbh collected $0.60 from pot
deepakmbh: doesn't show hand 
*** SUMMARY ***
Total pot $0.60 | Rake $0 
Seat 1: chiyuki (button) folded before Flop (didn't bet)
Seat 2: xxASSO124xx (small blind) folded before Flop
Seat 3: 4plankton (big blind) folded before Flop
Seat 4: 1Karina1 folded before Flop (didn't bet)
Seat 5: INSP!RON folded before Flop (didn't bet)
Seat 6: deepakmbh collected ($0.60)
Seat 7: scaredsare folded before Flop (didn't bet)
Seat 8: Nerkit folded before Flop (didn't bet)
Seat 9: mjmichi folded before Flop (didn't bet)



PokerStars Zoom Hand #84301029416:  Hold'em No Limit ($0.10/$0.25) - 2012/08/05 16:07:45 JST [2012/08/05 3:07:45 ET]
Table 'Whirlpool' 9-max Seat #1 is the button
Seat 1: masterkoolb ($12.88 in chips) 
Seat 2: hldtom ($27.54 in chips) 
Seat 3: Tonychanman ($18.27 in chips) 
Seat 4: chiyuki ($39.33 in chips) 
Seat 5: snejokCoxx ($11.22 in chips) 
Seat 6: Ellen1947 ($32.69 in chips) 
Seat 7: DrunkTyphoon ($42.10 in chips) 
Seat 8: Blue-GumBum ($10.82 in chips) 
Seat 9: Perstenev ($15.65 in chips) 
hldtom: posts small blind $0.10
Tonychanman: posts big blind $0.25
*** HOLE CARDS ***
Dealt to chiyuki [2s 4d]
chiyuki: folds 
snejokCoxx: folds 
Ellen1947: folds 
DrunkTyphoon: folds 
Blue-GumBum: calls $0.25
Perstenev: calls $0.25
masterkoolb: folds 
hldtom: folds 
Tonychanman: checks 
*** FLOP *** [Ts Tc Qc]
Tonychanman: checks 
Blue-GumBum: checks 
Perstenev: bets $0.25
Tonychanman: folds 
Blue-GumBum: calls $0.25
*** TURN *** [Ts Tc Qc] [7d]
Blue-GumBum: checks 
Perstenev: bets $0.25
Blue-GumBum: calls $0.25
*** RIVER *** [Ts Tc Qc 7d] [Ac]
Blue-GumBum: checks 
Perstenev: checks 
*** SHOW DOWN ***
Blue-GumBum: shows [As Jd] (two pair, Aces and Tens)
Perstenev: mucks hand 
Blue-GumBum collected $1.77 from pot
*** SUMMARY ***
Total pot $1.85 | Rake $0.08 
Board [Ts Tc Qc 7d Ac]
Seat 1: masterkoolb (button) folded before Flop (didn't bet)
Seat 2: hldtom (small blind) folded before Flop
Seat 3: Tonychanman (big blind) folded on the Flop
Seat 4: chiyuki folded before Flop (didn't bet)
Seat 5: snejokCoxx folded before Flop (didn't bet)
Seat 6: Ellen1947 folded before Flop (didn't bet)
Seat 7: DrunkTyphoon folded before Flop (didn't bet)
Seat 8: Blue-GumBum showed [As Jd] and won ($1.77) with two pair, Aces and Tens
Seat 9: Perstenev mucked [Js Qs]



PokerStars Zoom Hand #84301025681:  Hold'em No Limit ($0.10/$0.25) - 2012/08/05 16:07:31 JST [2012/08/05 3:07:31 ET]
Table 'Whirlpool' 9-max Seat #1 is the button
Seat 1: Nerkit ($20.45 in chips) 
Seat 2: Lasutchik ($28.54 in chips) 
Seat 3: kwkim73 ($32.37 in chips) 
Seat 4: Perstenev ($15.90 in chips) 
Seat 5: Femali54 ($26.76 in chips) 
Seat 6: chiyuki ($39.33 in chips) 
Seat 7: 4plankton ($8.68 in chips) 
Seat 8: Cripple86 ($25 in chips) 
Seat 9: tribunpdm ($68.86 in chips) 
Lasutchik: posts small blind $0.10
kwkim73: posts big blind $0.25
*** HOLE CARDS ***
Dealt to chiyuki [7s 7c]
Perstenev: folds 
Femali54: raises $0.50 to $0.75
chiyuki: folds 
4plankton: folds 
Cripple86: folds 
tribunpdm: calls $0.75
Nerkit: folds 
Lasutchik: folds 
kwkim73: calls $0.50
*** FLOP *** [6c Ah 5c]
kwkim73: checks 
Femali54: bets $1.50
tribunpdm: folds 
kwkim73: calls $1.50
*** TURN *** [6c Ah 5c] [Ks]
kwkim73: checks 
Femali54: checks 
*** RIVER *** [6c Ah 5c Ks] [9s]
kwkim73: bets $2.75
Femali54: folds 
Uncalled bet ($2.75) returned to kwkim73
kwkim73 collected $5.11 from pot
kwkim73: doesn't show hand 
*** SUMMARY ***
Total pot $5.35 | Rake $0.24 
Board [6c Ah 5c Ks 9s]
Seat 1: Nerkit (button) folded before Flop (didn't bet)
Seat 2: Lasutchik (small blind) folded before Flop
Seat 3: kwkim73 (big blind) collected ($5.11)
Seat 4: Perstenev folded before Flop (didn't bet)
Seat 5: Femali54 folded on the River
Seat 6: chiyuki folded before Flop (didn't bet)
Seat 7: 4plankton folded before Flop (didn't bet)
Seat 8: Cripple86 folded before Flop (didn't bet)
Seat 9: tribunpdm folded on the Flop



PokerStars Zoom Hand #84301027825:  Hold'em No Limit ($0.10/$0.25) - 2012/08/05 16:07:39 JST [2012/08/05 3:07:39 ET]
Table 'Whirlpool' 9-max Seat #1 is the button
Seat 1: kwkim73 ($26.38 in chips) 
Seat 2: Dejacob ($26.09 in chips) 
Seat 3: Rici47 ($39.65 in chips) 
Seat 4: Cripple86 ($25 in chips) 
Seat 5: slapshot2011 ($34.53 in chips) 
Seat 6: DanielWhyte ($34.67 in chips) 
Seat 7: Kozyavkin ($13.56 in chips) 
Seat 8: chiyuki ($39.33 in chips) 
Seat 9: phate-1up ($55.54 in chips) 
Dejacob: posts small blind $0.10
Rici47: posts big blind $0.25
*** HOLE CARDS ***
Dealt to chiyuki [3d Qs]
Cripple86: folds 
slapshot2011: folds 
DanielWhyte: folds 
Kozyavkin: calls $0.25
chiyuki: folds 
phate-1up: folds 
kwkim73: folds 
Dejacob: raises $0.75 to $1
Rici47: calls $0.75
Kozyavkin: calls $0.75
*** FLOP *** [9s 8c 7d]
Dejacob: checks 
Rici47: checks 
Kozyavkin: bets $1
Dejacob: folds 
Rici47: calls $1
*** TURN *** [9s 8c 7d] [Jc]
Rici47: checks 
Kozyavkin: checks 
*** RIVER *** [9s 8c 7d Jc] [5c]
Rici47: bets $2.25
Kozyavkin: calls $2.25
*** SHOW DOWN ***
Rici47: shows [Ac Tc] (a flush, Ace high)
Kozyavkin: mucks hand 
Rici47 collected $9.07 from pot
*** SUMMARY ***
Total pot $9.50 | Rake $0.43 
Board [9s 8c 7d Jc 5c]
Seat 1: kwkim73 (button) folded before Flop (didn't bet)
Seat 2: Dejacob (small blind) folded on the Flop
Seat 3: Rici47 (big blind) showed [Ac Tc] and won ($9.07) with a flush, Ace high
Seat 4: Cripple86 folded before Flop (didn't bet)
Seat 5: slapshot2011 folded before Flop (didn't bet)
Seat 6: DanielWhyte folded before Flop (didn't bet)
Seat 7: Kozyavkin mucked [6d 8d]
Seat 8: chiyuki folded before Flop (didn't bet)
Seat 9: phate-1up folded before Flop (didn't bet)



PokerStars Zoom Hand #84301036750:  Hold'em No Limit ($0.10/$0.25) - 2012/08/05 16:08:13 JST [2012/08/05 3:08:13 ET]
Table 'Whirlpool' 9-max Seat #1 is the button
Seat 1: Nerkit ($12.50 in chips) 
Seat 2: chiyuki ($39.33 in chips) 
Seat 3: RRMM_again ($25 in chips) 
Seat 4: GovGus ($47.04 in chips) 
Seat 5: xxASSO124xx ($10.11 in chips) 
Seat 6: Jene4kaBest ($9.03 in chips) 
Seat 7: CrittHunter ($21.36 in chips) 
Seat 8: Alvinpe85 ($29.59 in chips) 
Seat 9: hldtom ($27.61 in chips) 
chiyuki: posts small blind $0.10
RRMM_again: posts big blind $0.25
*** HOLE CARDS ***
Dealt to chiyuki [Td As]
GovGus: folds 
xxASSO124xx: folds 
Jene4kaBest: folds 
CrittHunter: folds 
Alvinpe85: folds 
hldtom: calls $0.25
Nerkit: folds 
chiyuki: calls $0.15
RRMM_again: checks 
*** FLOP *** [Qc Kh 4c]
chiyuki: checks 
RRMM_again: bets $0.25
hldtom: folds 
chiyuki: calls $0.25
*** TURN *** [Qc Kh 4c] [4s]
chiyuki: checks 
RRMM_again: bets $0.50
chiyuki: folds 
Uncalled bet ($0.50) returned to RRMM_again
RRMM_again collected $1.19 from pot
RRMM_again: doesn't show hand 
*** SUMMARY ***
Total pot $1.25 | Rake $0.06 
Board [Qc Kh 4c 4s]
Seat 1: Nerkit (button) folded before Flop (didn't bet)
Seat 2: chiyuki (small blind) folded on the Turn
Seat 3: RRMM_again (big blind) collected ($1.19)
Seat 4: GovGus folded before Flop (didn't bet)
Seat 5: xxASSO124xx folded before Flop (didn't bet)
Seat 6: Jene4kaBest folded before Flop (didn't bet)
Seat 7: CrittHunter folded before Flop (didn't bet)
Seat 8: Alvinpe85 folded before Flop (didn't bet)
Seat 9: hldtom folded on the Flop



PokerStars Zoom Hand #84301049904:  Hold'em No Limit ($0.10/$0.25) - 2012/08/05 16:09:02 JST [2012/08/05 3:09:02 ET]
Table 'Whirlpool' 9-max Seat #1 is the button
Seat 1: Lindikor ($16.84 in chips) 
Seat 2: slapshot2011 ($36.46 in chips) 
Seat 3: yoube ($70.91 in chips) 
Seat 4: zongo1 ($25.79 in chips) 
Seat 5: 4plankton ($8.08 in chips) 
Seat 6: Limoilou ($27.13 in chips) 
Seat 7: Roglus ($5.59 in chips) 
Seat 8: Perstenev ($13.67 in chips) 
Seat 9: chiyuki ($38.83 in chips) 
slapshot2011: posts small blind $0.10
yoube: posts big blind $0.25
*** HOLE CARDS ***
Dealt to chiyuki [Ac 4s]
zongo1: folds 
4plankton: folds 
Limoilou: folds 
Roglus: folds 
Perstenev: folds 
chiyuki: folds 
Lindikor: folds 
slapshot2011: folds 
Uncalled bet ($0.15) returned to yoube
yoube collected $0.20 from pot
yoube: doesn't show hand 
*** SUMMARY ***
Total pot $0.20 | Rake $0 
Seat 1: Lindikor (button) folded before Flop (didn't bet)
Seat 2: slapshot2011 (small blind) folded before Flop
Seat 3: yoube (big blind) collected ($0.20)
Seat 4: zongo1 folded before Flop (didn't bet)
Seat 5: 4plankton folded before Flop (didn't bet)
Seat 6: Limoilou folded before Flop (didn't bet)
Seat 7: Roglus folded before Flop (didn't bet)
Seat 8: Perstenev folded before Flop (didn't bet)
Seat 9: chiyuki folded before Flop (didn't bet)



PokerStars Zoom Hand #84301057408:  Hold'em No Limit ($0.10/$0.25) - 2012/08/05 16:09:31 JST [2012/08/05 3:09:31 ET]
Table 'Whirlpool' 9-max Seat #1 is the button
Seat 1: nice.franki ($10 in chips) 
Seat 2: Grishukps ($12.50 in chips) 
Seat 3: 1Karina1 ($35.91 in chips) 
Seat 4: chiyuki ($38.83 in chips) 
Seat 5: deepakmbh ($29.31 in chips) 
Seat 6: hldtom ($27.19 in chips) 
Seat 7: Lindikor ($5.76 in chips) 
Seat 8: Limoilou ($27.13 in chips) 
Seat 9: teaser07 ($25 in chips) 
Grishukps: posts small blind $0.10
1Karina1: posts big blind $0.25
*** HOLE CARDS ***
Dealt to chiyuki [Qc 7s]
chiyuki: folds 
deepakmbh: folds 
hldtom: folds 
Lindikor: folds 
Limoilou: folds 
teaser07: folds 
nice.franki: folds 
Grishukps: raises $0.37 to $0.62
1Karina1: folds 
Uncalled bet ($0.37) returned to Grishukps
Grishukps collected $0.50 from pot
Grishukps: doesn't show hand 
*** SUMMARY ***
Total pot $0.50 | Rake $0 
Seat 1: nice.franki (button) folded before Flop (didn't bet)
Seat 2: Grishukps (small blind) collected ($0.50)
Seat 3: 1Karina1 (big blind) folded before Flop
Seat 4: chiyuki folded before Flop (didn't bet)
Seat 5: deepakmbh folded before Flop (didn't bet)
Seat 6: hldtom folded before Flop (didn't bet)
Seat 7: Lindikor folded before Flop (didn't bet)
Seat 8: Limoilou folded before Flop (didn't bet)
Seat 9: teaser07 folded before Flop (didn't bet)



PokerStars Zoom Hand #84301058267:  Hold'em No Limit ($0.10/$0.25) - 2012/08/05 16:09:34 JST [2012/08/05 3:09:34 ET]
Table 'Whirlpool' 9-max Seat #1 is the button
Seat 1: nice.franki ($3.66 in chips) 
Seat 2: Bahia gyn ($19.91 in chips) 
Seat 3: 1Karina1 ($62.30 in chips) 
Seat 4: TorTrade ($28.15 in chips) 
Seat 5: chiyuki ($38.83 in chips) 
Seat 6: Blue-GumBum ($11.59 in chips) 
Seat 7: andy0815r ($32.07 in chips) 
Seat 8: 4ydo yogurt ($64.51 in chips) 
Seat 9: men1989 ($23.04 in chips) 
Bahia gyn: posts small blind $0.10
1Karina1: posts big blind $0.25
*** HOLE CARDS ***
Dealt to chiyuki [7c 8s]
TorTrade: folds 
chiyuki: folds 
Blue-GumBum: folds 
andy0815r: folds 
4ydo yogurt: raises $0.50 to $0.75
men1989: folds 
nice.franki: folds 
Bahia gyn: folds 
1Karina1: folds 
Uncalled bet ($0.50) returned to 4ydo yogurt
4ydo yogurt collected $0.60 from pot
4ydo yogurt: doesn't show hand 
*** SUMMARY ***
Total pot $0.60 | Rake $0 
Seat 1: nice.franki (button) folded before Flop (didn't bet)
Seat 2: Bahia gyn (small blind) folded before Flop
Seat 3: 1Karina1 (big blind) folded before Flop
Seat 4: TorTrade folded before Flop (didn't bet)
Seat 5: chiyuki folded before Flop (didn't bet)
Seat 6: Blue-GumBum folded before Flop (didn't bet)
Seat 7: andy0815r folded before Flop (didn't bet)
Seat 8: 4ydo yogurt collected ($0.60)
Seat 9: men1989 folded before Flop (didn't bet)



PokerStars Zoom Hand #84301059305:  Hold'em No Limit ($0.10/$0.25) - 2012/08/05 16:09:38 JST [2012/08/05 3:09:38 ET]
Table 'Whirlpool' 9-max Seat #1 is the button
Seat 1: men1989 ($23.04 in chips) 
Seat 2: Lasutchik ($28.66 in chips) 
Seat 3: chiyuki ($38.83 in chips) 
Seat 4: NEZZA177 ($23.65 in chips) 
Seat 5: Vall179 ($23.95 in chips) 
Seat 6: ShockLaMuc ($20.75 in chips) 
Seat 7: Blue-GumBum ($11.59 in chips) 
Seat 8: leo2095 ($24.86 in chips) 
Seat 9: Kasperlmusik ($32.89 in chips) 
Lasutchik: posts small blind $0.10
chiyuki: posts big blind $0.25
*** HOLE CARDS ***
Dealt to chiyuki [7d 2c]
NEZZA177: calls $0.25
Vall179: folds 
ShockLaMuc: folds 
Blue-GumBum: folds 
leo2095: folds 
Kasperlmusik: folds 
men1989: folds 
Lasutchik: calls $0.15
chiyuki: checks 
*** FLOP *** [5d 4c Kd]
Lasutchik: bets $0.25
chiyuki: folds 
NEZZA177: calls $0.25
*** TURN *** [5d 4c Kd] [Qs]
Lasutchik: bets $0.83
NEZZA177: calls $0.83
*** RIVER *** [5d 4c Kd Qs] [8c]
Lasutchik: bets $1.94
NEZZA177: raises $1.94 to $3.88
Lasutchik: calls $1.94
*** SHOW DOWN ***
NEZZA177: shows [8d Qd] (two pair, Queens and Eights)
Lasutchik: shows [Ks 4s] (two pair, Kings and Fours)
Lasutchik collected $10.19 from pot
*** SUMMARY ***
Total pot $10.67 | Rake $0.48 
Board [5d 4c Kd Qs 8c]
Seat 1: men1989 (button) folded before Flop (didn't bet)
Seat 2: Lasutchik (small blind) showed [Ks 4s] and won ($10.19) with two pair, Kings and Fours
Seat 3: chiyuki (big blind) folded on the Flop
Seat 4: NEZZA177 showed [8d Qd] and lost with two pair, Queens and Eights
Seat 5: Vall179 folded before Flop (didn't bet)
Seat 6: ShockLaMuc folded before Flop (didn't bet)
Seat 7: Blue-GumBum folded before Flop (didn't bet)
Seat 8: leo2095 folded before Flop (didn't bet)
Seat 9: Kasperlmusik folded before Flop (didn't bet)



PokerStars Zoom Hand #84301064481:  Hold'em No Limit ($0.10/$0.25) - 2012/08/05 16:09:57 JST [2012/08/05 3:09:57 ET]
Table 'Whirlpool' 9-max Seat #1 is the button
Seat 1: zongo1 ($25.79 in chips) 
Seat 2: ShockLaMuc ($20.93 in chips) 
Seat 3: Blue-GumBum ($11.49 in chips) 
Seat 4: masterkoolb ($12.85 in chips) 
Seat 5: Rici47 ($44.72 in chips) 
Seat 6: 4plankton ($7.73 in chips) 
Seat 7: chiyuki ($38.58 in chips) 
Seat 8: Grumpy as 2 ($14.20 in chips) 
Seat 9: nice.franki ($10 in chips) 
ShockLaMuc: posts small blind $0.10
Blue-GumBum: posts big blind $0.25
*** HOLE CARDS ***
Dealt to chiyuki [Ts 5c]
masterkoolb: folds 
Rici47: raises $0.50 to $0.75
4plankton: folds 
chiyuki: folds 
Grumpy as 2: folds 
nice.franki: folds 
zongo1: calls $0.75
ShockLaMuc: folds 
Blue-GumBum: folds 
*** FLOP *** [6s 7d 4h]
Rici47: bets $0.75
zongo1: folds 
Uncalled bet ($0.75) returned to Rici47
Rici47 collected $1.77 from pot
Rici47: doesn't show hand 
*** SUMMARY ***
Total pot $1.85 | Rake $0.08 
Board [6s 7d 4h]
Seat 1: zongo1 (button) folded on the Flop
Seat 2: ShockLaMuc (small blind) folded before Flop
Seat 3: Blue-GumBum (big blind) folded before Flop
Seat 4: masterkoolb folded before Flop (didn't bet)
Seat 5: Rici47 collected ($1.77)
Seat 6: 4plankton folded before Flop (didn't bet)
Seat 7: chiyuki folded before Flop (didn't bet)
Seat 8: Grumpy as 2 folded before Flop (didn't bet)
Seat 9: nice.franki folded before Flop (didn't bet)



PokerStars Zoom Hand #84301067457:  Hold'em No Limit ($0.10/$0.25) - 2012/08/05 16:10:08 JST [2012/08/05 3:10:08 ET]
Table 'Whirlpool' 9-max Seat #1 is the button
Seat 1: chiyuki ($38.58 in chips) 
Seat 2: 1Karina1 ($35.66 in chips) 
Seat 3: pandaaaaaa ($19.86 in chips) 
Seat 4: fil740 ($11.93 in chips) 
Seat 5: Alvinpe85 ($29.24 in chips) 
Seat 6: kwkim73 ($30.59 in chips) 
Seat 7: Perstenev ($13.67 in chips) 
Seat 8: xxx Spb xxx ($27.58 in chips) 
Seat 9: Dejacob ($25 in chips) 
1Karina1: posts small blind $0.10
pandaaaaaa: posts big blind $0.25
*** HOLE CARDS ***
Dealt to chiyuki [9h 6s]
fil740: folds 
Alvinpe85: folds 
kwkim73: folds 
Perstenev: folds 
xxx Spb xxx: folds 
Dejacob: raises $0.50 to $0.75
chiyuki: folds 
1Karina1: folds 
pandaaaaaa: folds 
Uncalled bet ($0.50) returned to Dejacob
Dejacob collected $0.60 from pot
Dejacob: doesn't show hand 
*** SUMMARY ***
Total pot $0.60 | Rake $0 
Seat 1: chiyuki (button) folded before Flop (didn't bet)
Seat 2: 1Karina1 (small blind) folded before Flop
Seat 3: pandaaaaaa (big blind) folded before Flop
Seat 4: fil740 folded before Flop (didn't bet)
Seat 5: Alvinpe85 folded before Flop (didn't bet)
Seat 6: kwkim73 folded before Flop (didn't bet)
Seat 7: Perstenev folded before Flop (didn't bet)
Seat 8: xxx Spb xxx folded before Flop (didn't bet)
Seat 9: Dejacob collected ($0.60)



PokerStars Zoom Hand #84301073478:  Hold'em No Limit ($0.10/$0.25) - 2012/08/05 16:10:31 JST [2012/08/05 3:10:31 ET]
Table 'Whirlpool' 9-max Seat #1 is the button
Seat 1: GSDP ($26.19 in chips) 
Seat 2: Serge Claws ($37.28 in chips) 
Seat 3: leo2095 ($24.01 in chips) 
Seat 4: Kasperlmusik ($39.58 in chips) 
Seat 5: DrunkTyphoon ($36.89 in chips) 
Seat 6: chiyuki ($38.58 in chips) 
Seat 7: roksmokndonk ($20.90 in chips) 
Seat 8: 1Karina1 ($61.95 in chips) 
Seat 9: kesstukas25 ($12.50 in chips) 
Serge Claws: posts small blind $0.10
leo2095: posts big blind $0.25
*** HOLE CARDS ***
Dealt to chiyuki [7d 5s]
Kasperlmusik: folds 
DrunkTyphoon: folds 
chiyuki: folds 
roksmokndonk: folds 
1Karina1: folds 
kesstukas25: folds 
GSDP: raises $0.50 to $0.75
Serge Claws: folds 
leo2095: folds 
Uncalled bet ($0.50) returned to GSDP
GSDP collected $0.60 from pot
GSDP: doesn't show hand 
*** SUMMARY ***
Total pot $0.60 | Rake $0 
Seat 1: GSDP (button) collected ($0.60)
Seat 2: Serge Claws (small blind) folded before Flop
Seat 3: leo2095 (big blind) folded before Flop
Seat 4: Kasperlmusik folded before Flop (didn't bet)
Seat 5: DrunkTyphoon folded before Flop (didn't bet)
Seat 6: chiyuki folded before Flop (didn't bet)
Seat 7: roksmokndonk folded before Flop (didn't bet)
Seat 8: 1Karina1 folded before Flop (didn't bet)
Seat 9: kesstukas25 folded before Flop (didn't bet)



PokerStars Zoom Hand #84301076743:  Hold'em No Limit ($0.10/$0.25) - 2012/08/05 16:10:43 JST [2012/08/05 3:10:43 ET]
Table 'Whirlpool' 9-max Seat #1 is the button
Seat 1: 1Karina1 ($35.56 in chips) 
Seat 2: Dejacob ($25 in chips) 
Seat 3: fil740 ($10.93 in chips) 
Seat 4: Alvinpe85 ($28.99 in chips) 
Seat 5: Lasutchik ($12.15 in chips) 
Seat 6: chiyuki ($38.48 in chips) 
Seat 7: phate-1up ($55.19 in chips) 
Seat 8: pandaaaaaa ($19.51 in chips) 
Seat 9: Femali54 ($27.12 in chips) 
Dejacob: posts small blind $0.10
fil740: posts big blind $0.25
*** HOLE CARDS ***
Dealt to chiyuki [7h Ah]
Alvinpe85: folds 
Lasutchik: folds 
chiyuki: folds 
phate-1up: folds 
pandaaaaaa: folds 
Femali54: folds 
1Karina1: folds 
Dejacob: folds 
Uncalled bet ($0.15) returned to fil740
fil740 collected $0.20 from pot
fil740: doesn't show hand 
*** SUMMARY ***
Total pot $0.20 | Rake $0 
Seat 1: 1Karina1 (button) folded before Flop (didn't bet)
Seat 2: Dejacob (small blind) folded before Flop
Seat 3: fil740 (big blind) collected ($0.20)
Seat 4: Alvinpe85 folded before Flop (didn't bet)
Seat 5: Lasutchik folded before Flop (didn't bet)
Seat 6: chiyuki folded before Flop (didn't bet)
Seat 7: phate-1up folded before Flop (didn't bet)
Seat 8: pandaaaaaa folded before Flop (didn't bet)
Seat 9: Femali54 folded before Flop (didn't bet)



PokerStars Zoom Hand #84301074293:  Hold'em No Limit ($0.10/$0.25) - 2012/08/05 16:10:34 JST [2012/08/05 3:10:34 ET]
Table 'Whirlpool' 9-max Seat #1 is the button
Seat 1: hldtom ($64.71 in chips) 
Seat 2: chiyuki ($38.58 in chips) 
Seat 3: RRMM_again ($24.84 in chips) 
Seat 4: GovGus ($31.93 in chips) 
Seat 5: Kasperlmusik ($39.58 in chips) 
Seat 6: Vall179 ($22.98 in chips) 
Seat 7: Lasutchik ($12.15 in chips) 
Seat 8: phate-1up ($37.02 in chips) 
Seat 9: INSP!RON ($30.32 in chips) 
chiyuki: posts small blind $0.10
RRMM_again: posts big blind $0.25
*** HOLE CARDS ***
Dealt to chiyuki [7c Jh]
GovGus: raises $0.75 to $1
Kasperlmusik: folds 
Vall179: folds 
Lasutchik: folds 
phate-1up: folds 
INSP!RON: folds 
hldtom: folds 
chiyuki: folds 
RRMM_again: folds 
Uncalled bet ($0.75) returned to GovGus
GovGus collected $0.60 from pot
GovGus: doesn't show hand 
*** SUMMARY ***
Total pot $0.60 | Rake $0 
Seat 1: hldtom (button) folded before Flop (didn't bet)
Seat 2: chiyuki (small blind) folded before Flop
Seat 3: RRMM_again (big blind) folded before Flop
Seat 4: GovGus collected ($0.60)
Seat 5: Kasperlmusik folded before Flop (didn't bet)
Seat 6: Vall179 folded before Flop (didn't bet)
Seat 7: Lasutchik folded before Flop (didn't bet)
Seat 8: phate-1up folded before Flop (didn't bet)
Seat 9: INSP!RON folded before Flop (didn't bet)



PokerStars Zoom Hand #84301075678:  Hold'em No Limit ($0.10/$0.25) - 2012/08/05 16:10:39 JST [2012/08/05 3:10:39 ET]
Table 'Whirlpool' 9-max Seat #1 is the button
Seat 1: teaser07 ($25.35 in chips) 
Seat 2: CrittHunter ($20.38 in chips) 
Seat 3: poorpoor6551 ($16.71 in chips) 
Seat 4: nice.franki ($11.02 in chips) 
Seat 5: seula i ($71.21 in chips) 
Seat 6: Lasutchik ($12.15 in chips) 
Seat 7: PPP7SSS ($53.82 in chips) 
Seat 8: Limoilou ($26.78 in chips) 
Seat 9: chiyuki ($38.48 in chips) 
CrittHunter: posts small blind $0.10
poorpoor6551: posts big blind $0.25
*** HOLE CARDS ***
Dealt to chiyuki [Tc 2h]
nice.franki: folds 
seula i: folds 
Lasutchik: folds 
PPP7SSS: folds 
Limoilou: raises $0.50 to $0.75
chiyuki: folds 
teaser07: folds 
CrittHunter: folds 
poorpoor6551: folds 
Uncalled bet ($0.50) returned to Limoilou
Limoilou collected $0.60 from pot
Limoilou: doesn't show hand 
*** SUMMARY ***
Total pot $0.60 | Rake $0 
Seat 1: teaser07 (button) folded before Flop (didn't bet)
Seat 2: CrittHunter (small blind) folded before Flop
Seat 3: poorpoor6551 (big blind) folded before Flop
Seat 4: nice.franki folded before Flop (didn't bet)
Seat 5: seula i folded before Flop (didn't bet)
Seat 6: Lasutchik folded before Flop (didn't bet)
Seat 7: PPP7SSS folded before Flop (didn't bet)
Seat 8: Limoilou collected ($0.60)
Seat 9: chiyuki folded before Flop (didn't bet)



PokerStars Zoom Hand #84301077853:  Hold'em No Limit ($0.10/$0.25) - 2012/08/05 16:10:47 JST [2012/08/05 3:10:47 ET]
Table 'Whirlpool' 9-max Seat #1 is the button
Seat 1: Dejacob ($25 in chips) 
Seat 2: Kasperlmusik ($39.58 in chips) 
Seat 3: Cripple86 ($27.43 in chips) 
Seat 4: GSDP ($41.79 in chips) 
Seat 5: xxx Spb xxx ($29.81 in chips) 
Seat 6: Loholov ($15 in chips) 
Seat 7: AntoineHunt ($39.96 in chips) 
Seat 8: chiyuki ($38.48 in chips) 
Seat 9: 1Karina1 ($35.56 in chips) 
Kasperlmusik: posts small blind $0.10
Cripple86: posts big blind $0.25
*** HOLE CARDS ***
Dealt to chiyuki [Kc 6c]
GSDP: folds 
xxx Spb xxx: folds 
Loholov: folds 
AntoineHunt: folds 
chiyuki: folds 
1Karina1: folds 
Dejacob: folds 
Kasperlmusik: folds 
Uncalled bet ($0.15) returned to Cripple86
Cripple86 collected $0.20 from pot
Cripple86: doesn't show hand 
*** SUMMARY ***
Total pot $0.20 | Rake $0 
Seat 1: Dejacob (button) folded before Flop (didn't bet)
Seat 2: Kasperlmusik (small blind) folded before Flop
Seat 3: Cripple86 (big blind) collected ($0.20)
Seat 4: GSDP folded before Flop (didn't bet)
Seat 5: xxx Spb xxx folded before Flop (didn't bet)
Seat 6: Loholov folded before Flop (didn't bet)
Seat 7: AntoineHunt folded before Flop (didn't bet)
Seat 8: chiyuki folded before Flop (didn't bet)
Seat 9: 1Karina1 folded before Flop (didn't bet)



PokerStars Zoom Hand #84301071817:  Hold'em No Limit ($0.10/$0.25) - 2012/08/05 16:10:25 JST [2012/08/05 3:10:25 ET]
Table 'Whirlpool' 9-max Seat #1 is the button
Seat 1: Cripple86 ($28.88 in chips) 
Seat 2: kwkim73 ($35.48 in chips) 
Seat 3: Loholov ($16.15 in chips) 
Seat 4: yoube ($70.91 in chips) 
Seat 5: schoof 2 ($29.74 in chips) 
Seat 6: 4plankton ($7.63 in chips) 
Seat 7: Limoilou ($26.78 in chips) 
Seat 8: chiyuki ($38.58 in chips) 
Seat 9: snejokCoxx ($11.82 in chips) 
kwkim73: posts small blind $0.10
Loholov: posts big blind $0.25
*** HOLE CARDS ***
Dealt to chiyuki [5s Jd]
yoube: raises $0.50 to $0.75
schoof 2: calls $0.75
4plankton: folds 
Limoilou: folds 
chiyuki: folds 
snejokCoxx: folds 
Cripple86: folds 
kwkim73: folds 
Loholov: folds 
*** FLOP *** [9c 6s Kc]
yoube: checks 
schoof 2: bets $0.50
yoube: calls $0.50
*** TURN *** [9c 6s Kc] [Qs]
yoube: checks 
schoof 2: checks 
*** RIVER *** [9c 6s Kc Qs] [4h]
yoube: bets $2.50
schoof 2: folds 
Uncalled bet ($2.50) returned to yoube
yoube collected $2.72 from pot
yoube: doesn't show hand 
*** SUMMARY ***
Total pot $2.85 | Rake $0.13 
Board [9c 6s Kc Qs 4h]
Seat 1: Cripple86 (button) folded before Flop (didn't bet)
Seat 2: kwkim73 (small blind) folded before Flop
Seat 3: Loholov (big blind) folded before Flop
Seat 4: yoube collected ($2.72)
Seat 5: schoof 2 folded on the River
Seat 6: 4plankton folded before Flop (didn't bet)
Seat 7: Limoilou folded before Flop (didn't bet)
Seat 8: chiyuki folded before Flop (didn't bet)
Seat 9: snejokCoxx folded before Flop (didn't bet)



PokerStars Zoom Hand #84301078899:  Hold'em No Limit ($0.10/$0.25) - 2012/08/05 16:10:51 JST [2012/08/05 3:10:51 ET]
Table 'Whirlpool' 9-max Seat #1 is the button
Seat 1: Spheroff ($13.80 in chips) 
Seat 2: FoRlan77 ($25 in chips) 
Seat 3: chiyuki ($38.48 in chips) 
Seat 4: Grishukps ($12.50 in chips) 
Seat 5: 4ydo yogurt ($61.86 in chips) 
Seat 6: Ellen1947 ($28.56 in chips) 
Seat 7: Nerkit ($13.42 in chips) 
Seat 8: Kasperlmusik ($39.48 in chips) 
Seat 9: phate-1up ($36.92 in chips) 
FoRlan77: posts small blind $0.10
chiyuki: posts big blind $0.25
*** HOLE CARDS ***
Dealt to chiyuki [5d Ah]
Grishukps: folds 
4ydo yogurt: folds 
Ellen1947: folds 
Nerkit: folds 
Kasperlmusik: folds 
phate-1up: folds 
Spheroff: folds 
FoRlan77: raises $0.50 to $0.75
chiyuki: raises $1.50 to $2.25
FoRlan77: folds 
Uncalled bet ($1.50) returned to chiyuki
chiyuki collected $1.50 from pot
chiyuki: doesn't show hand 
*** SUMMARY ***
Total pot $1.50 | Rake $0 
Seat 1: Spheroff (button) folded before Flop (didn't bet)
Seat 2: FoRlan77 (small blind) folded before Flop
Seat 3: chiyuki (big blind) collected ($1.50)
Seat 4: Grishukps folded before Flop (didn't bet)
Seat 5: 4ydo yogurt folded before Flop (didn't bet)
Seat 6: Ellen1947 folded before Flop (didn't bet)
Seat 7: Nerkit folded before Flop (didn't bet)
Seat 8: Kasperlmusik folded before Flop (didn't bet)
Seat 9: phate-1up folded before Flop (didn't bet)



PokerStars Zoom Hand #84301092996:  Hold'em No Limit ($0.10/$0.25) - 2012/08/05 16:11:44 JST [2012/08/05 3:11:44 ET]
Table 'Whirlpool' 9-max Seat #1 is the button
Seat 1: Kasperlmusik ($39.48 in chips) 
Seat 2: chiyuki ($39.23 in chips) 
Seat 3: snejokCoxx ($11.72 in chips) 
Seat 4: men1989 ($25 in chips) 
Seat 5: tribunpdm ($68.48 in chips) 
Seat 6: seula i ($36.23 in chips) 
Seat 7: DrunkTyphoon ($47 in chips) 
Seat 8: mamlind ($14.84 in chips) 
Seat 9: 280128si ($15.75 in chips) 
chiyuki: posts small blind $0.10
snejokCoxx: posts big blind $0.25
*** HOLE CARDS ***
Dealt to chiyuki [8d Kc]
men1989: folds 
tribunpdm: folds 
seula i: folds 
DrunkTyphoon: folds 
mamlind: folds 
280128si: folds 
Kasperlmusik: folds 
chiyuki: folds 
Uncalled bet ($0.15) returned to snejokCoxx
snejokCoxx collected $0.20 from pot
snejokCoxx: doesn't show hand 
*** SUMMARY ***
Total pot $0.20 | Rake $0 
Seat 1: Kasperlmusik (button) folded before Flop (didn't bet)
Seat 2: chiyuki (small blind) folded before Flop
Seat 3: snejokCoxx (big blind) collected ($0.20)
Seat 4: men1989 folded before Flop (didn't bet)
Seat 5: tribunpdm folded before Flop (didn't bet)
Seat 6: seula i folded before Flop (didn't bet)
Seat 7: DrunkTyphoon folded before Flop (didn't bet)
Seat 8: mamlind folded before Flop (didn't bet)
Seat 9: 280128si folded before Flop (didn't bet)



PokerStars Zoom Hand #84301091641:  Hold'em No Limit ($0.10/$0.25) - 2012/08/05 16:11:39 JST [2012/08/05 3:11:39 ET]
Table 'Whirlpool' 9-max Seat #1 is the button
Seat 1: chiyuki ($39.23 in chips) 
Seat 2: yoube ($72.13 in chips) 
Seat 3: Ellen1947 ($31.48 in chips) 
Seat 4: Lindikor ($19.58 in chips) 
Seat 5: hldtom ($24.89 in chips) 
Seat 6: teaser07 ($25.35 in chips) 
Seat 7: Vall179 ($23.02 in chips) 
Seat 8: nice.franki ($10.67 in chips) 
Seat 9: masterkoolb ($15.34 in chips) 
yoube: posts small blind $0.10
Ellen1947: posts big blind $0.25
*** HOLE CARDS ***
Dealt to chiyuki [Td 3s]
Lindikor: folds 
hldtom: raises $0.50 to $0.75
teaser07: folds 
Vall179: folds 
nice.franki: folds 
masterkoolb: folds 
chiyuki: folds 
yoube: folds 
Ellen1947: folds 
Uncalled bet ($0.50) returned to hldtom
hldtom collected $0.60 from pot
hldtom: doesn't show hand 
*** SUMMARY ***
Total pot $0.60 | Rake $0 
Seat 1: chiyuki (button) folded before Flop (didn't bet)
Seat 2: yoube (small blind) folded before Flop
Seat 3: Ellen1947 (big blind) folded before Flop
Seat 4: Lindikor folded before Flop (didn't bet)
Seat 5: hldtom collected ($0.60)
Seat 6: teaser07 folded before Flop (didn't bet)
Seat 7: Vall179 folded before Flop (didn't bet)
Seat 8: nice.franki folded before Flop (didn't bet)
Seat 9: masterkoolb folded before Flop (didn't bet)



PokerStars Zoom Hand #84301095073:  Hold'em No Limit ($0.10/$0.25) - 2012/08/05 16:11:52 JST [2012/08/05 3:11:52 ET]
Table 'Whirlpool' 9-max Seat #1 is the button
Seat 1: snejokCoxx ($19.28 in chips) 
Seat 2: DanielWhyte ($30.72 in chips) 
Seat 3: Kasperlmusik ($39.48 in chips) 
Seat 4: roksmokndonk ($20.05 in chips) 
Seat 5: Tonychanman ($22.81 in chips) 
Seat 6: Nerkit ($13.07 in chips) 
Seat 7: mamlind ($14.84 in chips) 
Seat 8: yoube ($72.03 in chips) 
Seat 9: chiyuki ($39.13 in chips) 
DanielWhyte: posts small blind $0.10
Kasperlmusik: posts big blind $0.25
*** HOLE CARDS ***
Dealt to chiyuki [4h Qs]
roksmokndonk: folds 
Tonychanman: folds 
Nerkit: folds 
mamlind: folds 
yoube: folds 
chiyuki: folds 
snejokCoxx: folds 
DanielWhyte: folds 
Uncalled bet ($0.15) returned to Kasperlmusik
Kasperlmusik collected $0.20 from pot
Kasperlmusik: doesn't show hand 
*** SUMMARY ***
Total pot $0.20 | Rake $0 
Seat 1: snejokCoxx (button) folded before Flop (didn't bet)
Seat 2: DanielWhyte (small blind) folded before Flop
Seat 3: Kasperlmusik (big blind) collected ($0.20)
Seat 4: roksmokndonk folded before Flop (didn't bet)
Seat 5: Tonychanman folded before Flop (didn't bet)
Seat 6: Nerkit folded before Flop (didn't bet)
Seat 7: mamlind folded before Flop (didn't bet)
Seat 8: yoube folded before Flop (didn't bet)
Seat 9: chiyuki folded before Flop (didn't bet)



PokerStars Zoom Hand #84301090565:  Hold'em No Limit ($0.10/$0.25) - 2012/08/05 16:11:34 JST [2012/08/05 3:11:34 ET]
Table 'Whirlpool' 9-max Seat #1 is the button
Seat 1: yoube ($72.13 in chips) 
Seat 2: Nerkit ($13.17 in chips) 
Seat 3: kwkim73 ($35.03 in chips) 
Seat 4: men1989 ($18.79 in chips) 
Seat 5: chiyuki ($39.23 in chips) 
Seat 6: Dejacob ($32.98 in chips) 
Seat 7: Loholov ($16.82 in chips) 
Seat 8: GovGus ($40.80 in chips) 
Seat 9: 4ydo yogurt ($62.11 in chips) 
Nerkit: posts small blind $0.10
kwkim73: posts big blind $0.25
*** HOLE CARDS ***
Dealt to chiyuki [9c Jd]
men1989: folds 
chiyuki: folds 
Dejacob: folds 
Loholov: raises $0.50 to $0.75
GovGus: folds 
4ydo yogurt: folds 
yoube: folds 
Nerkit: folds 
kwkim73: raises $1.75 to $2.50
Loholov: calls $1.75
*** FLOP *** [Ac 9h Th]
kwkim73: bets $3.40
Loholov: folds 
Uncalled bet ($3.40) returned to kwkim73
kwkim73 collected $4.87 from pot
kwkim73: doesn't show hand 
*** SUMMARY ***
Total pot $5.10 | Rake $0.23 
Board [Ac 9h Th]
Seat 1: yoube (button) folded before Flop (didn't bet)
Seat 2: Nerkit (small blind) folded before Flop
Seat 3: kwkim73 (big blind) collected ($4.87)
Seat 4: men1989 folded before Flop (didn't bet)
Seat 5: chiyuki folded before Flop (didn't bet)
Seat 6: Dejacob folded before Flop (didn't bet)
Seat 7: Loholov folded on the Flop
Seat 8: GovGus folded before Flop (didn't bet)
Seat 9: 4ydo yogurt folded before Flop (didn't bet)



PokerStars Zoom Hand #84301094038:  Hold'em No Limit ($0.10/$0.25) - 2012/08/05 16:11:48 JST [2012/08/05 3:11:48 ET]
Table 'Whirlpool' 9-max Seat #1 is the button
Seat 1: Tonychanman ($22.81 in chips) 
Seat 2: tribunpdm ($68.48 in chips) 
Seat 3: men1989 ($25 in chips) 
Seat 4: Kasperlmusik ($39.48 in chips) 
Seat 5: Dejacob ($32.98 in chips) 
Seat 6: INSP!RON ($27.82 in chips) 
Seat 7: chiyuki ($39.13 in chips) 
Seat 8: 280128si ($15.75 in chips) 
Seat 9: mamlind ($14.84 in chips) 
tribunpdm: posts small blind $0.10
men1989: posts big blind $0.25
*** HOLE CARDS ***
Dealt to chiyuki [5c 7h]
Kasperlmusik: folds 
Dejacob: folds 
INSP!RON: raises $0.50 to $0.75
chiyuki: folds 
280128si: folds 
mamlind: folds 
Tonychanman: folds 
tribunpdm: folds 
men1989: folds 
Uncalled bet ($0.50) returned to INSP!RON
INSP!RON collected $0.60 from pot
INSP!RON: doesn't show hand 
*** SUMMARY ***
Total pot $0.60 | Rake $0 
Seat 1: Tonychanman (button) folded before Flop (didn't bet)
Seat 2: tribunpdm (small blind) folded before Flop
Seat 3: men1989 (big blind) folded before Flop
Seat 4: Kasperlmusik folded before Flop (didn't bet)
Seat 5: Dejacob folded before Flop (didn't bet)
Seat 6: INSP!RON collected ($0.60)
Seat 7: chiyuki folded before Flop (didn't bet)
Seat 8: 280128si folded before Flop (didn't bet)
Seat 9: mamlind folded before Flop (didn't bet)



PokerStars Zoom Hand #84301097624:  Hold'em No Limit ($0.10/$0.25) - 2012/08/05 16:12:01 JST [2012/08/05 3:12:01 ET]
Table 'Whirlpool' 9-max Seat #1 is the button
Seat 1: Cripple86 ($25 in chips) 
Seat 2: TSAL7 ($25 in chips) 
Seat 3: Rici47 ($45.39 in chips) 
Seat 4: olligol123 ($25 in chips) 
Seat 5: chiyuki ($39.13 in chips) 
Seat 6: DrunkTyphoon ($47 in chips) 
Seat 7: masterkoolb ($15.44 in chips) 
Seat 8: Nerkit ($12.15 in chips) 
Seat 9: Serge Claws ($25 in chips) 
TSAL7: posts small blind $0.10
Rici47: posts big blind $0.25
*** HOLE CARDS ***
Dealt to chiyuki [7h 3s]
olligol123: folds 
chiyuki: folds 
DrunkTyphoon: folds 
masterkoolb: folds 
Nerkit: folds 
Serge Claws: folds 
Cripple86: raises $0.50 to $0.75
TSAL7: folds 
Rici47: folds 
Uncalled bet ($0.50) returned to Cripple86
Cripple86 collected $0.60 from pot
Cripple86: doesn't show hand 
*** SUMMARY ***
Total pot $0.60 | Rake $0 
Seat 1: Cripple86 (button) collected ($0.60)
Seat 2: TSAL7 (small blind) folded before Flop
Seat 3: Rici47 (big blind) folded before Flop
Seat 4: olligol123 folded before Flop (didn't bet)
Seat 5: chiyuki folded before Flop (didn't bet)
Seat 6: DrunkTyphoon folded before Flop (didn't bet)
Seat 7: masterkoolb folded before Flop (didn't bet)
Seat 8: Nerkit folded before Flop (didn't bet)
Seat 9: Serge Claws folded before Flop (didn't bet)



PokerStars Zoom Hand #84301098756:  Hold'em No Limit ($0.10/$0.25) - 2012/08/05 16:12:05 JST [2012/08/05 3:12:05 ET]
Table 'Whirlpool' 9-max Seat #1 is the button
Seat 1: leo2095 ($25.95 in chips) 
Seat 2: nice.franki ($3.31 in chips) 
Seat 3: DrunkTyphoon ($47 in chips) 
Seat 4: Dejacob ($32.98 in chips) 
Seat 5: mamlind ($14.84 in chips) 
Seat 6: Alvinpe85 ($28.29 in chips) 
Seat 7: chiyuki ($39.13 in chips) 
Seat 8: Perstenev ($5.03 in chips) 
Seat 9: Roglus ($9.28 in chips) 
nice.franki: posts small blind $0.10
DrunkTyphoon: posts big blind $0.25
*** HOLE CARDS ***
Dealt to chiyuki [Kd 9s]
Dejacob: folds 
mamlind: raises $0.50 to $0.75
Alvinpe85: folds 
chiyuki: folds 
Perstenev: folds 
Roglus: folds 
leo2095: folds 
nice.franki: folds 
DrunkTyphoon: folds 
Uncalled bet ($0.50) returned to mamlind
mamlind collected $0.60 from pot
mamlind: doesn't show hand 
*** SUMMARY ***
Total pot $0.60 | Rake $0 
Seat 1: leo2095 (button) folded before Flop (didn't bet)
Seat 2: nice.franki (small blind) folded before Flop
Seat 3: DrunkTyphoon (big blind) folded before Flop
Seat 4: Dejacob folded before Flop (didn't bet)
Seat 5: mamlind collected ($0.60)
Seat 6: Alvinpe85 folded before Flop (didn't bet)
Seat 7: chiyuki folded before Flop (didn't bet)
Seat 8: Perstenev folded before Flop (didn't bet)
Seat 9: Roglus folded before Flop (didn't bet)



PokerStars Zoom Hand #84301100080:  Hold'em No Limit ($0.10/$0.25) - 2012/08/05 16:12:10 JST [2012/08/05 3:12:10 ET]
Table 'Whirlpool' 9-max Seat #1 is the button
Seat 1: Femali54 ($19.92 in chips) 
Seat 2: .7.DanDan.7. ($16.04 in chips) 
Seat 3: Roglus ($9.28 in chips) 
Seat 4: chiyuki ($39.13 in chips) 
Seat 5: Rici47 ($47.77 in chips) 
Seat 6: tribunpdm ($68.73 in chips) 
Seat 7: 4ydo yogurt ($62.21 in chips) 
Seat 8: Kasperlmusik ($39.58 in chips) 
Seat 9: masterkoolb ($12.50 in chips) 
.7.DanDan.7.: posts small blind $0.10
Roglus: posts big blind $0.25
*** HOLE CARDS ***
Dealt to chiyuki [Qc 6d]
chiyuki: folds 
Rici47: folds 
tribunpdm: folds 
4ydo yogurt: raises $0.50 to $0.75
Kasperlmusik: folds 
masterkoolb: folds 
Femali54: folds 
.7.DanDan.7.: folds 
Roglus: folds 
Uncalled bet ($0.50) returned to 4ydo yogurt
4ydo yogurt collected $0.60 from pot
4ydo yogurt: doesn't show hand 
*** SUMMARY ***
Total pot $0.60 | Rake $0 
Seat 1: Femali54 (button) folded before Flop (didn't bet)
Seat 2: .7.DanDan.7. (small blind) folded before Flop
Seat 3: Roglus (big blind) folded before Flop
Seat 4: chiyuki folded before Flop (didn't bet)
Seat 5: Rici47 folded before Flop (didn't bet)
Seat 6: tribunpdm folded before Flop (didn't bet)
Seat 7: 4ydo yogurt collected ($0.60)
Seat 8: Kasperlmusik folded before Flop (didn't bet)
Seat 9: masterkoolb folded before Flop (didn't bet)



PokerStars Zoom Hand #84301096807:  Hold'em No Limit ($0.10/$0.25) - 2012/08/05 16:11:58 JST [2012/08/05 3:11:58 ET]
Table 'Whirlpool' 9-max Seat #1 is the button
Seat 1: Grishukps ($12.60 in chips) 
Seat 2: snejokCoxx ($11.82 in chips) 
Seat 3: Femali54 ($20.17 in chips) 
Seat 4: Faantomace ($34.09 in chips) 
Seat 5: masterkoolb ($15.44 in chips) 
Seat 6: Vall179 ($23.02 in chips) 
Seat 7: nice.franki ($10.67 in chips) 
Seat 8: chiyuki ($39.13 in chips) 
Seat 9: Loholov ($15 in chips) 
snejokCoxx: posts small blind $0.10
Femali54: posts big blind $0.25
*** HOLE CARDS ***
Dealt to chiyuki [3c Js]
Faantomace: folds 
masterkoolb: folds 
Vall179: raises $0.50 to $0.75
nice.franki: folds 
chiyuki: folds 
Loholov: calls $0.75
Grishukps: folds 
snejokCoxx: folds 
Femali54: folds 
*** FLOP *** [Jd Kh 7s]
Vall179: bets $1.07
Loholov: folds 
Uncalled bet ($1.07) returned to Vall179
Vall179 collected $1.77 from pot
Vall179: doesn't show hand 
*** SUMMARY ***
Total pot $1.85 | Rake $0.08 
Board [Jd Kh 7s]
Seat 1: Grishukps (button) folded before Flop (didn't bet)
Seat 2: snejokCoxx (small blind) folded before Flop
Seat 3: Femali54 (big blind) folded before Flop
Seat 4: Faantomace folded before Flop (didn't bet)
Seat 5: masterkoolb folded before Flop (didn't bet)
Seat 6: Vall179 collected ($1.77)
Seat 7: nice.franki folded before Flop (didn't bet)
Seat 8: chiyuki folded before Flop (didn't bet)
Seat 9: Loholov folded on the Flop



PokerStars Zoom Hand #84301101766:  Hold'em No Limit ($0.10/$0.25) - 2012/08/05 16:12:16 JST [2012/08/05 3:12:16 ET]
Table 'Whirlpool' 9-max Seat #1 is the button
Seat 1: DrunkTyphoon ($37.72 in chips) 
Seat 2: poorpoor6551 ($15.36 in chips) 
Seat 3: chiyuki ($39.13 in chips) 
Seat 4: 1Karina1 ($30.66 in chips) 
Seat 5: Roglus ($9.03 in chips) 
Seat 6: Rici47 ($45.04 in chips) 
Seat 7: Trip_Krowns ($26.09 in chips) 
Seat 8: Dejacob ($33.32 in chips) 
Seat 9: Nerkit ($13.07 in chips) 
poorpoor6551: posts small blind $0.10
chiyuki: posts big blind $0.25
*** HOLE CARDS ***
Dealt to chiyuki [9c 6d]
1Karina1: folds 
Roglus: folds 
Rici47: folds 
Trip_Krowns: folds 
Dejacob: raises $0.50 to $0.75
Nerkit: folds 
DrunkTyphoon: folds 
poorpoor6551: calls $0.65
chiyuki: folds 
*** FLOP *** [4s 6h Ad]
poorpoor6551: checks 
Dejacob: checks 
*** TURN *** [4s 6h Ad] [3s]
poorpoor6551: bets $1
Dejacob: folds 
Uncalled bet ($1) returned to poorpoor6551
poorpoor6551 collected $1.67 from pot
poorpoor6551: doesn't show hand 
*** SUMMARY ***
Total pot $1.75 | Rake $0.08 
Board [4s 6h Ad 3s]
Seat 1: DrunkTyphoon (button) folded before Flop (didn't bet)
Seat 2: poorpoor6551 (small blind) collected ($1.67)
Seat 3: chiyuki (big blind) folded before Flop
Seat 4: 1Karina1 folded before Flop (didn't bet)
Seat 5: Roglus folded before Flop (didn't bet)
Seat 6: Rici47 folded before Flop (didn't bet)
Seat 7: Trip_Krowns folded before Flop (didn't bet)
Seat 8: Dejacob folded on the Turn
Seat 9: Nerkit folded before Flop (didn't bet)



PokerStars Zoom Hand #84301105003:  Hold'em No Limit ($0.10/$0.25) - 2012/08/05 16:12:28 JST [2012/08/05 3:12:28 ET]
Table 'Whirlpool' 9-max Seat #1 is the button
Seat 1: Alvinpe85 ($28.04 in chips) 
Seat 2: Perstenev ($15.28 in chips) 
Seat 3: Cripple86 ($28.13 in chips) 
Seat 4: Loholov ($15 in chips) 
Seat 5: Rici47 ($45.04 in chips) 
Seat 6: chiyuki ($38.88 in chips) 
Seat 7: Roglus ($9.03 in chips) 
Seat 8: teaser07 ($26.35 in chips) 
Seat 9: Femali54 ($19.82 in chips) 
Perstenev: posts small blind $0.10
Cripple86: posts big blind $0.25
*** HOLE CARDS ***
Dealt to chiyuki [Jh Qs]
Loholov: folds 
Rici47: folds 
chiyuki: folds 
Roglus: folds 
teaser07: folds 
Femali54: folds 
Alvinpe85: raises $0.37 to $0.62
Perstenev: folds 
Cripple86: folds 
Uncalled bet ($0.37) returned to Alvinpe85
Alvinpe85 collected $0.60 from pot
Alvinpe85: doesn't show hand 
*** SUMMARY ***
Total pot $0.60 | Rake $0 
Seat 1: Alvinpe85 (button) collected ($0.60)
Seat 2: Perstenev (small blind) folded before Flop
Seat 3: Cripple86 (big blind) folded before Flop
Seat 4: Loholov folded before Flop (didn't bet)
Seat 5: Rici47 folded before Flop (didn't bet)
Seat 6: chiyuki folded before Flop (didn't bet)
Seat 7: Roglus folded before Flop (didn't bet)
Seat 8: teaser07 folded before Flop (didn't bet)
Seat 9: Femali54 folded before Flop (didn't bet)



PokerStars Zoom Hand #84301113657:  Hold'em No Limit ($0.10/$0.25) - 2012/08/05 16:13:01 JST [2012/08/05 3:13:01 ET]
Table 'Whirlpool' 9-max Seat #1 is the button
Seat 1: Vall179 ($23.79 in chips) 
Seat 2: chiyuki ($38.88 in chips) 
Seat 3: d4dda ($24.65 in chips) 
Seat 4: leo2095 ($25.60 in chips) 
Seat 5: nice.franki ($12.05 in chips) 
Seat 6: Cripple86 ($25.70 in chips) 
Seat 7: Perstenev ($12.57 in chips) 
Seat 8: kesstukas25 ($12.50 in chips) 
Seat 9: pandaaaaaa ($18.91 in chips) 
chiyuki: posts small blind $0.10
d4dda: posts big blind $0.25
*** HOLE CARDS ***
Dealt to chiyuki [3s 5s]
leo2095: folds 
nice.franki: folds 
Cripple86: folds 
Perstenev: calls $0.25
kesstukas25: folds 
pandaaaaaa: folds 
Vall179: folds 
chiyuki: folds 
d4dda: checks 
*** FLOP *** [3c 9s 2h]
d4dda: checks 
Perstenev: checks 
*** TURN *** [3c 9s 2h] [Tc]
d4dda: checks 
Perstenev: bets $0.25
d4dda: folds 
Uncalled bet ($0.25) returned to Perstenev
Perstenev collected $0.57 from pot
Perstenev: doesn't show hand 
*** SUMMARY ***
Total pot $0.60 | Rake $0.03 
Board [3c 9s 2h Tc]
Seat 1: Vall179 (button) folded before Flop (didn't bet)
Seat 2: chiyuki (small blind) folded before Flop
Seat 3: d4dda (big blind) folded on the Turn
Seat 4: leo2095 folded before Flop (didn't bet)
Seat 5: nice.franki folded before Flop (didn't bet)
Seat 6: Cripple86 folded before Flop (didn't bet)
Seat 7: Perstenev collected ($0.57)
Seat 8: kesstukas25 folded before Flop (didn't bet)
Seat 9: pandaaaaaa folded before Flop (didn't bet)



PokerStars Zoom Hand #84301114995:  Hold'em No Limit ($0.10/$0.25) - 2012/08/05 16:13:06 JST [2012/08/05 3:13:06 ET]
Table 'Whirlpool' 9-max Seat #1 is the button
Seat 1: chiyuki ($38.78 in chips) 
Seat 2: Serge Claws ($39.31 in chips) 
Seat 3: kwkim73 ($35.51 in chips) 
Seat 4: slapshot2011 ($37.38 in chips) 
Seat 5: Cripple86 ($25.84 in chips) 
Seat 6: Grishukps ($12.50 in chips) 
Seat 7: scaredsare ($20.44 in chips) 
Seat 8: roksmokndonk ($21.99 in chips) 
Seat 9: top gun 2950 ($40.73 in chips) 
Serge Claws: posts small blind $0.10
kwkim73: posts big blind $0.25
*** HOLE CARDS ***
Dealt to chiyuki [7c Ad]
slapshot2011: folds 
Cripple86: folds 
Grishukps: folds 
scaredsare: folds 
roksmokndonk: calls $0.25
top gun 2950: folds 
chiyuki: folds 
Serge Claws: folds 
kwkim73: checks 
*** FLOP *** [Jc 9s Kc]
kwkim73: checks 
roksmokndonk: bets $0.25
kwkim73: folds 
Uncalled bet ($0.25) returned to roksmokndonk
roksmokndonk collected $0.57 from pot
roksmokndonk: doesn't show hand 
*** SUMMARY ***
Total pot $0.60 | Rake $0.03 
Board [Jc 9s Kc]
Seat 1: chiyuki (button) folded before Flop (didn't bet)
Seat 2: Serge Claws (small blind) folded before Flop
Seat 3: kwkim73 (big blind) folded on the Flop
Seat 4: slapshot2011 folded before Flop (didn't bet)
Seat 5: Cripple86 folded before Flop (didn't bet)
Seat 6: Grishukps folded before Flop (didn't bet)
Seat 7: scaredsare folded before Flop (didn't bet)
Seat 8: roksmokndonk collected ($0.57)
Seat 9: top gun 2950 folded before Flop (didn't bet)



PokerStars Zoom Hand #84301106100:  Hold'em No Limit ($0.10/$0.25) - 2012/08/05 16:12:32 JST [2012/08/05 3:12:32 ET]
Table 'Whirlpool' 9-max Seat #1 is the button
Seat 1: olligol123 ($24.65 in chips) 
Seat 2: schoof 2 ($24.68 in chips) 
Seat 3: Lasutchik ($12.50 in chips) 
Seat 4: chiyuki ($38.88 in chips) 
Seat 5: .7.DanDan.7. ($15.69 in chips) 
Seat 6: leo2095 ($25.70 in chips) 
Seat 7: nice.franki ($12.50 in chips) 
Seat 8: hldtom ($25.24 in chips) 
Seat 9: Cripple86 ($29.23 in chips) 
schoof 2: posts small blind $0.10
Lasutchik: posts big blind $0.25
*** HOLE CARDS ***
Dealt to chiyuki [Tc 8c]
chiyuki: folds 
.7.DanDan.7.: folds 
leo2095: folds 
nice.franki: folds 
hldtom: raises $0.50 to $0.75
Cripple86: folds 
olligol123: calls $0.75
schoof 2: calls $0.65
Lasutchik: folds 
*** FLOP *** [Qh 5d Qc]
schoof 2: checks 
hldtom: bets $1.19
olligol123: calls $1.19
schoof 2: folds 
*** TURN *** [Qh 5d Qc] [2c]
hldtom: checks 
olligol123: checks 
*** RIVER *** [Qh 5d Qc 2c] [Kh]
hldtom: checks 
olligol123: checks 
*** SHOW DOWN ***
hldtom: shows [Ah 4h] (a pair of Queens)
olligol123: shows [7h 7s] (two pair, Queens and Sevens)
olligol123 collected $4.66 from pot
*** SUMMARY ***
Total pot $4.88 | Rake $0.22 
Board [Qh 5d Qc 2c Kh]
Seat 1: olligol123 (button) showed [7h 7s] and won ($4.66) with two pair, Queens and Sevens
Seat 2: schoof 2 (small blind) folded on the Flop
Seat 3: Lasutchik (big blind) folded before Flop
Seat 4: chiyuki folded before Flop (didn't bet)
Seat 5: .7.DanDan.7. folded before Flop (didn't bet)
Seat 6: leo2095 folded before Flop (didn't bet)
Seat 7: nice.franki folded before Flop (didn't bet)
Seat 8: hldtom showed [Ah 4h] and lost with a pair of Queens
Seat 9: Cripple86 folded before Flop (didn't bet)



PokerStars Zoom Hand #84301118600:  Hold'em No Limit ($0.10/$0.25) - 2012/08/05 16:13:19 JST [2012/08/05 3:13:19 ET]
Table 'Whirlpool' 9-max Seat #1 is the button
Seat 1: snejokCoxx ($12.15 in chips) 
Seat 2: kwkim73 ($25 in chips) 
Seat 3: Perstenev ($4.68 in chips) 
Seat 4: Alvinpe85 ($28.29 in chips) 
Seat 5: INSP!RON ($35.59 in chips) 
Seat 6: DrunkTyphoon ($46.30 in chips) 
Seat 7: Grishukps ($12.50 in chips) 
Seat 8: TSAL7 ($21.58 in chips) 
Seat 9: chiyuki ($38.78 in chips) 
kwkim73: posts small blind $0.10
Perstenev: posts big blind $0.25
*** HOLE CARDS ***
Dealt to chiyuki [Ah 6s]
Alvinpe85: folds 
INSP!RON: folds 
DrunkTyphoon: folds 
Grishukps: folds 
TSAL7: folds 
chiyuki: folds 
snejokCoxx: raises $0.40 to $0.65
kwkim73: folds 
Perstenev: folds 
Uncalled bet ($0.40) returned to snejokCoxx
snejokCoxx collected $0.60 from pot
snejokCoxx: doesn't show hand 
*** SUMMARY ***
Total pot $0.60 | Rake $0 
Seat 1: snejokCoxx (button) collected ($0.60)
Seat 2: kwkim73 (small blind) folded before Flop
Seat 3: Perstenev (big blind) folded before Flop
Seat 4: Alvinpe85 folded before Flop (didn't bet)
Seat 5: INSP!RON folded before Flop (didn't bet)
Seat 6: DrunkTyphoon folded before Flop (didn't bet)
Seat 7: Grishukps folded before Flop (didn't bet)
Seat 8: TSAL7 folded before Flop (didn't bet)
Seat 9: chiyuki folded before Flop (didn't bet)



PokerStars Zoom Hand #84301106867:  Hold'em No Limit ($0.10/$0.25) - 2012/08/05 16:12:35 JST [2012/08/05 3:12:35 ET]
Table 'Whirlpool' 9-max Seat #1 is the button
Seat 1: soul_5577 ($36.68 in chips) 
Seat 2: Loholov ($15 in chips) 
Seat 3: DrunkTyphoon ($37.72 in chips) 
Seat 4: ivan130 ($28.16 in chips) 
Seat 5: kesstukas25 ($31.76 in chips) 
Seat 6: chiyuki ($38.88 in chips) 
Seat 7: zongo1 ($24.79 in chips) 
Seat 8: Grishukps ($12.50 in chips) 
Seat 9: 1Karina1 ($25.35 in chips) 
Loholov: posts small blind $0.10
DrunkTyphoon: posts big blind $0.25
*** HOLE CARDS ***
Dealt to chiyuki [4s 4c]
ivan130 has timed out
ivan130: folds 
kesstukas25: raises $0.50 to $0.75
chiyuki: folds 
zongo1: folds 
Grishukps: folds 
1Karina1: folds 
soul_5577: folds 
Loholov: folds 
DrunkTyphoon: calls $0.50
*** FLOP *** [4d As 9d]
DrunkTyphoon: checks 
kesstukas25: bets $1
DrunkTyphoon: calls $1
*** TURN *** [4d As 9d] [Ks]
DrunkTyphoon: checks 
kesstukas25: checks 
*** RIVER *** [4d As 9d Ks] [3d]
DrunkTyphoon: checks 
kesstukas25: checks 
*** SHOW DOWN ***
DrunkTyphoon: shows [Jd Jc] (a pair of Jacks)
kesstukas25: mucks hand 
DrunkTyphoon collected $3.44 from pot
*** SUMMARY ***
Total pot $3.60 | Rake $0.16 
Board [4d As 9d Ks 3d]
Seat 1: soul_5577 (button) folded before Flop (didn't bet)
Seat 2: Loholov (small blind) folded before Flop
Seat 3: DrunkTyphoon (big blind) showed [Jd Jc] and won ($3.44) with a pair of Jacks
Seat 4: ivan130 folded before Flop (didn't bet)
Seat 5: kesstukas25 mucked [7h 7s]
Seat 6: chiyuki folded before Flop (didn't bet)
Seat 7: zongo1 folded before Flop (didn't bet)
Seat 8: Grishukps folded before Flop (didn't bet)
Seat 9: 1Karina1 folded before Flop (didn't bet)



PokerStars Zoom Hand #84301119659:  Hold'em No Limit ($0.10/$0.25) - 2012/08/05 16:13:23 JST [2012/08/05 3:13:23 ET]
Table 'Whirlpool' 9-max Seat #1 is the button
Seat 1: INSP!RON ($26.57 in chips) 
Seat 2: Dejacob ($31.82 in chips) 
Seat 3: a_tasmanian ($25 in chips) 
Seat 4: Cripple86 ($25.84 in chips) 
Seat 5: mjmichi ($75.77 in chips) 
Seat 6: TSAL7 ($21.58 in chips) 
Seat 7: AntoineHunt ($36.11 in chips) 
Seat 8: chiyuki ($38.78 in chips) 
Seat 9: Grishukps ($12.50 in chips) 
Dejacob: posts small blind $0.10
a_tasmanian: posts big blind $0.25
*** HOLE CARDS ***
Dealt to chiyuki [5s Kh]
Cripple86: folds 
mjmichi: folds 
TSAL7: folds 
AntoineHunt: folds 
chiyuki: folds 
Grishukps: folds 
INSP!RON: raises $0.35 to $0.60
Dejacob: folds 
a_tasmanian: calls $0.35
*** FLOP *** [Jd 9d 7h]
a_tasmanian: checks 
INSP!RON: bets $0.90
a_tasmanian: folds 
Uncalled bet ($0.90) returned to INSP!RON
INSP!RON collected $1.24 from pot
INSP!RON: doesn't show hand 
*** SUMMARY ***
Total pot $1.30 | Rake $0.06 
Board [Jd 9d 7h]
Seat 1: INSP!RON (button) collected ($1.24)
Seat 2: Dejacob (small blind) folded before Flop
Seat 3: a_tasmanian (big blind) folded on the Flop
Seat 4: Cripple86 folded before Flop (didn't bet)
Seat 5: mjmichi folded before Flop (didn't bet)
Seat 6: TSAL7 folded before Flop (didn't bet)
Seat 7: AntoineHunt folded before Flop (didn't bet)
Seat 8: chiyuki folded before Flop (didn't bet)
Seat 9: Grishukps folded before Flop (didn't bet)



PokerStars Zoom Hand #84301121317:  Hold'em No Limit ($0.10/$0.25) - 2012/08/05 16:13:29 JST [2012/08/05 3:13:29 ET]
Table 'Whirlpool' 9-max Seat #1 is the button
Seat 1: drunk_bender ($28.41 in chips) 
Seat 2: Grishukps ($12.50 in chips) 
Seat 3: Cripple86 ($25.84 in chips) 
Seat 4: Femali54 ($19.47 in chips) 
Seat 5: chiyuki ($38.78 in chips) 
Seat 6: olligol123 ($23.25 in chips) 
Seat 7: roksmokndonk ($22.31 in chips) 
Seat 8: Vall179 ($23.69 in chips) 
Seat 9: 1Karina1 ($30.59 in chips) 
Grishukps: posts small blind $0.10
Cripple86: posts big blind $0.25
*** HOLE CARDS ***
Dealt to chiyuki [2s 6s]
Femali54: folds 
chiyuki: folds 
olligol123: folds 
roksmokndonk: folds 
Vall179: folds 
1Karina1: folds 
drunk_bender: folds 
Grishukps: folds 
Uncalled bet ($0.15) returned to Cripple86
Cripple86 collected $0.20 from pot
Cripple86: doesn't show hand 
*** SUMMARY ***
Total pot $0.20 | Rake $0 
Seat 1: drunk_bender (button) folded before Flop (didn't bet)
Seat 2: Grishukps (small blind) folded before Flop
Seat 3: Cripple86 (big blind) collected ($0.20)
Seat 4: Femali54 folded before Flop (didn't bet)
Seat 5: chiyuki folded before Flop (didn't bet)
Seat 6: olligol123 folded before Flop (didn't bet)
Seat 7: roksmokndonk folded before Flop (didn't bet)
Seat 8: Vall179 folded before Flop (didn't bet)
Seat 9: 1Karina1 folded before Flop (didn't bet)



PokerStars Zoom Hand #84301124509:  Hold'em No Limit ($0.10/$0.25) - 2012/08/05 16:13:41 JST [2012/08/05 3:13:41 ET]
Table 'Whirlpool' 9-max Seat #1 is the button
Seat 1: deepakmbh ($27.13 in chips) 
Seat 2: Perstenev ($14.93 in chips) 
Seat 3: chiyuki ($38.78 in chips) 
Seat 4: AntoineHunt ($36.11 in chips) 
Seat 5: Alvinpe85 ($104.84 in chips) 
Seat 6: loszavera ($30.34 in chips) 
Seat 7: Vall179 ($23.69 in chips) 
Seat 8: 1Karina1 ($64.25 in chips) 
Seat 9: Grishukps ($12.50 in chips) 
Perstenev: posts small blind $0.10
chiyuki: posts big blind $0.25
*** HOLE CARDS ***
Dealt to chiyuki [Qs 3d]
AntoineHunt: folds 
Alvinpe85: folds 
loszavera: folds 
Vall179: folds 
1Karina1: folds 
Grishukps: raises $0.37 to $0.62
deepakmbh: calls $0.62
Perstenev: folds 
chiyuki: folds 
*** FLOP *** [Kc 8h 9s]
Grishukps: bets $1
deepakmbh: folds 
Uncalled bet ($1) returned to Grishukps
Grishukps collected $1.52 from pot
Grishukps: doesn't show hand 
*** SUMMARY ***
Total pot $1.59 | Rake $0.07 
Board [Kc 8h 9s]
Seat 1: deepakmbh (button) folded on the Flop
Seat 2: Perstenev (small blind) folded before Flop
Seat 3: chiyuki (big blind) folded before Flop
Seat 4: AntoineHunt folded before Flop (didn't bet)
Seat 5: Alvinpe85 folded before Flop (didn't bet)
Seat 6: loszavera folded before Flop (didn't bet)
Seat 7: Vall179 folded before Flop (didn't bet)
Seat 8: 1Karina1 folded before Flop (didn't bet)
Seat 9: Grishukps collected ($1.52)



PokerStars Zoom Hand #84301122441:  Hold'em No Limit ($0.10/$0.25) - 2012/08/05 16:13:33 JST [2012/08/05 3:13:33 ET]
Table 'Whirlpool' 9-max Seat #1 is the button
Seat 1: theo0630 ($13.15 in chips) 
Seat 2: Grumpy as 2 ($12.58 in chips) 
Seat 3: Loholov ($19.47 in chips) 
Seat 4: chiyuki ($38.78 in chips) 
Seat 5: Serge Claws ($28.60 in chips) 
Seat 6: 19MJJ21 ($20.97 in chips) 
Seat 7: snejokCoxx ($13.08 in chips) 
Seat 8: Vall179 ($22.28 in chips) 
Seat 9: kwkim73 ($35.26 in chips) 
Grumpy as 2: posts small blind $0.10
Loholov: posts big blind $0.25
*** HOLE CARDS ***
Dealt to chiyuki [8s 5s]
chiyuki: folds 
Serge Claws: folds 
19MJJ21: raises $0.45 to $0.70
snejokCoxx: calls $0.70
Vall179: folds 
kwkim73: folds 
theo0630: folds 
Grumpy as 2: folds 
Loholov: folds 
*** FLOP *** [5c 8h Ks]
19MJJ21: bets $1.25
snejokCoxx: calls $1.25
*** TURN *** [5c 8h Ks] [9h]
19MJJ21: bets $2.60
snejokCoxx: folds 
Uncalled bet ($2.60) returned to 19MJJ21
19MJJ21 collected $4.06 from pot
19MJJ21: doesn't show hand 
*** SUMMARY ***
Total pot $4.25 | Rake $0.19 
Board [5c 8h Ks 9h]
Seat 1: theo0630 (button) folded before Flop (didn't bet)
Seat 2: Grumpy as 2 (small blind) folded before Flop
Seat 3: Loholov (big blind) folded before Flop
Seat 4: chiyuki folded before Flop (didn't bet)
Seat 5: Serge Claws folded before Flop (didn't bet)
Seat 6: 19MJJ21 collected ($4.06)
Seat 7: snejokCoxx folded on the Turn
Seat 8: Vall179 folded before Flop (didn't bet)
Seat 9: kwkim73 folded before Flop (didn't bet)



PokerStars Zoom Hand #84301123763:  Hold'em No Limit ($0.10/$0.25) - 2012/08/05 16:13:38 JST [2012/08/05 3:13:38 ET]
Table 'Whirlpool' 9-max Seat #1 is the button
Seat 1: Grishukps ($12.50 in chips) 
Seat 2: kwkim73 ($35.26 in chips) 
Seat 3: benjuer ($25 in chips) 
Seat 4: chiyuki ($38.78 in chips) 
Seat 5: 280128si ($15.40 in chips) 
Seat 6: INSP!RON ($32.55 in chips) 
Seat 7: teaser07 ($25.70 in chips) 
Seat 8: fwnaf ($20.46 in chips) 
Seat 9: Serge Claws ($28.60 in chips) 
kwkim73: posts small blind $0.10
benjuer: posts big blind $0.25
*** HOLE CARDS ***
Dealt to chiyuki [9c 3d]
chiyuki: folds 
280128si: folds 
INSP!RON: folds 
teaser07: raises $0.50 to $0.75
fwnaf: folds 
Serge Claws: calls $0.75
Grishukps: folds 
kwkim73: folds 
benjuer: folds 
*** FLOP *** [4s Kh Jd]
teaser07: checks 
Serge Claws: bets $1
teaser07: folds 
Uncalled bet ($1) returned to Serge Claws
Serge Claws collected $1.77 from pot
Serge Claws: doesn't show hand 
*** SUMMARY ***
Total pot $1.85 | Rake $0.08 
Board [4s Kh Jd]
Seat 1: Grishukps (button) folded before Flop (didn't bet)
Seat 2: kwkim73 (small blind) folded before Flop
Seat 3: benjuer (big blind) folded before Flop
Seat 4: chiyuki folded before Flop (didn't bet)
Seat 5: 280128si folded before Flop (didn't bet)
Seat 6: INSP!RON folded before Flop (didn't bet)
Seat 7: teaser07 folded on the Flop
Seat 8: fwnaf folded before Flop (didn't bet)
Seat 9: Serge Claws collected ($1.77)



PokerStars Zoom Hand #84301130201:  Hold'em No Limit ($0.10/$0.25) - 2012/08/05 16:14:03 JST [2012/08/05 3:14:03 ET]
Table 'Whirlpool' 9-max Seat #1 is the button
Seat 1: DrunkTyphoon ($39.31 in chips) 
Seat 2: chiyuki ($38.53 in chips) 
Seat 3: masterkoolb ($12.85 in chips) 
Seat 4: poorpoor6551 ($11.78 in chips) 
Seat 5: Dejacob ($31.13 in chips) 
Seat 6: xxx Spb xxx ($27.58 in chips) 
Seat 7: INSP!RON ($35.34 in chips) 
Seat 8: 280128si ($15.40 in chips) 
Seat 9: Loholov ($29.46 in chips) 
chiyuki: posts small blind $0.10
masterkoolb: posts big blind $0.25
*** HOLE CARDS ***
Dealt to chiyuki [9s 9h]
poorpoor6551: calls $0.25
Dejacob: folds 
xxx Spb xxx: raises $0.75 to $1
INSP!RON: folds 
280128si: folds 
Loholov: folds 
DrunkTyphoon: folds 
chiyuki: folds 
masterkoolb: folds 
poorpoor6551: calls $0.75
*** FLOP *** [2h 6c 3c]
poorpoor6551: checks 
xxx Spb xxx: bets $1.68
poorpoor6551: folds 
Uncalled bet ($1.68) returned to xxx Spb xxx
xxx Spb xxx collected $2.24 from pot
xxx Spb xxx: doesn't show hand 
*** SUMMARY ***
Total pot $2.35 | Rake $0.11 
Board [2h 6c 3c]
Seat 1: DrunkTyphoon (button) folded before Flop (didn't bet)
Seat 2: chiyuki (small blind) folded before Flop
Seat 3: masterkoolb (big blind) folded before Flop
Seat 4: poorpoor6551 folded on the Flop
Seat 5: Dejacob folded before Flop (didn't bet)
Seat 6: xxx Spb xxx collected ($2.24)
Seat 7: INSP!RON folded before Flop (didn't bet)
Seat 8: 280128si folded before Flop (didn't bet)
Seat 9: Loholov folded before Flop (didn't bet)



PokerStars Zoom Hand #84301134508:  Hold'em No Limit ($0.10/$0.25) - 2012/08/05 16:14:19 JST [2012/08/05 3:14:19 ET]
Table 'Whirlpool' 9-max Seat #1 is the button
Seat 1: Alvinpe85 ($28.04 in chips) 
Seat 2: svg51 ($14.75 in chips) 
Seat 3: codan23 ($14.28 in chips) 
Seat 4: MurMurRu ($26.68 in chips) 
Seat 5: galaxe ($24 in chips) 
Seat 6: 1Karina1 ($64 in chips) 
Seat 7: chiyuki ($38.43 in chips) 
Seat 8: Serge Claws ($67.58 in chips) 
Seat 9: Mytea88 ($13.40 in chips) 
svg51: posts small blind $0.10
codan23: posts big blind $0.25
*** HOLE CARDS ***
Dealt to chiyuki [8s Qs]
MurMurRu: folds 
galaxe: folds 
1Karina1: folds 
chiyuki: folds 
Serge Claws: raises $0.50 to $0.75
Mytea88: folds 
Alvinpe85: calls $0.75
svg51: folds 
codan23: folds 
*** FLOP *** [9c 4d 4c]
Serge Claws: checks 
Alvinpe85: bets $1.06
Serge Claws: folds 
Uncalled bet ($1.06) returned to Alvinpe85
Alvinpe85 collected $1.77 from pot
Alvinpe85: doesn't show hand 
*** SUMMARY ***
Total pot $1.85 | Rake $0.08 
Board [9c 4d 4c]
Seat 1: Alvinpe85 (button) collected ($1.77)
Seat 2: svg51 (small blind) folded before Flop
Seat 3: codan23 (big blind) folded before Flop
Seat 4: MurMurRu folded before Flop (didn't bet)
Seat 5: galaxe folded before Flop (didn't bet)
Seat 6: 1Karina1 folded before Flop (didn't bet)
Seat 7: chiyuki folded before Flop (didn't bet)
Seat 8: Serge Claws folded on the Flop
Seat 9: Mytea88 folded before Flop (didn't bet)



PokerStars Zoom Hand #84301140171:  Hold'em No Limit ($0.10/$0.25) - 2012/08/05 16:14:40 JST [2012/08/05 3:14:40 ET]
Table 'Whirlpool' 9-max Seat #1 is the button
Seat 1: Grishukps ($12.50 in chips) 
Seat 2: wildy29 ($98.07 in chips) 
Seat 3: mamlind ($15.19 in chips) 
Seat 4: DrunkTyphoon ($39.41 in chips) 
Seat 5: theo0630 ($11.40 in chips) 
Seat 6: pandaaaaaa ($17.91 in chips) 
Seat 7: drunk_bender ($28.16 in chips) 
Seat 8: Patient90122 ($29.22 in chips) 
Seat 9: chiyuki ($38.43 in chips) 
wildy29: posts small blind $0.10
mamlind: posts big blind $0.25
*** HOLE CARDS ***
Dealt to chiyuki [7s 5s]
DrunkTyphoon: folds 
theo0630: folds 
pandaaaaaa: folds 
drunk_bender: folds 
Patient90122: raises $0.50 to $0.75
chiyuki: folds 
Grishukps: folds 
wildy29: folds 
mamlind: folds 
Uncalled bet ($0.50) returned to Patient90122
Patient90122 collected $0.60 from pot
Patient90122: doesn't show hand 
*** SUMMARY ***
Total pot $0.60 | Rake $0 
Seat 1: Grishukps (button) folded before Flop (didn't bet)
Seat 2: wildy29 (small blind) folded before Flop
Seat 3: mamlind (big blind) folded before Flop
Seat 4: DrunkTyphoon folded before Flop (didn't bet)
Seat 5: theo0630 folded before Flop (didn't bet)
Seat 6: pandaaaaaa folded before Flop (didn't bet)
Seat 7: drunk_bender folded before Flop (didn't bet)
Seat 8: Patient90122 collected ($0.60)
Seat 9: chiyuki folded before Flop (didn't bet)



PokerStars Zoom Hand #84301143248:  Hold'em No Limit ($0.10/$0.25) - 2012/08/05 16:14:51 JST [2012/08/05 3:14:51 ET]
Table 'Whirlpool' 9-max Seat #1 is the button
Seat 1: d4dda ($22.05 in chips) 
Seat 2: Grishukps ($12.50 in chips) 
Seat 3: INSP!RON ($26.31 in chips) 
Seat 4: Loholov ($18.47 in chips) 
Seat 5: chiyuki ($38.43 in chips) 
Seat 6: mamlind ($14.94 in chips) 
Seat 7: olligol123 ($25 in chips) 
Seat 8: RRMM_again ($26.54 in chips) 
Seat 9: hldtom ($12.64 in chips) 
Grishukps: posts small blind $0.10
INSP!RON: posts big blind $0.25
*** HOLE CARDS ***
Dealt to chiyuki [Qh Tc]
Loholov: folds 
chiyuki: folds 
mamlind: folds 
olligol123: folds 
RRMM_again: raises $0.25 to $0.50
hldtom: folds 
d4dda: folds 
Grishukps: folds 
INSP!RON: folds 
Uncalled bet ($0.25) returned to RRMM_again
RRMM_again collected $0.60 from pot
RRMM_again: doesn't show hand 
*** SUMMARY ***
Total pot $0.60 | Rake $0 
Seat 1: d4dda (button) folded before Flop (didn't bet)
Seat 2: Grishukps (small blind) folded before Flop
Seat 3: INSP!RON (big blind) folded before Flop
Seat 4: Loholov folded before Flop (didn't bet)
Seat 5: chiyuki folded before Flop (didn't bet)
Seat 6: mamlind folded before Flop (didn't bet)
Seat 7: olligol123 folded before Flop (didn't bet)
Seat 8: RRMM_again collected ($0.60)
Seat 9: hldtom folded before Flop (didn't bet)



PokerStars Zoom Hand #84301144307:  Hold'em No Limit ($0.10/$0.25) - 2012/08/05 16:14:55 JST [2012/08/05 3:14:55 ET]
Table 'Whirlpool' 9-max Seat #1 is the button
Seat 1: snejokCoxx ($11.47 in chips) 
Seat 2: Loholov ($18.47 in chips) 
Seat 3: 1Karina1 ($63.90 in chips) 
Seat 4: chiyuki ($38.43 in chips) 
Seat 5: kesstukas25 ($29.09 in chips) 
Seat 6: teaser07 ($25.50 in chips) 
Seat 7: .7.DanDan.7. ($13.09 in chips) 
Seat 8: DrunkTyphoon ($39.31 in chips) 
Seat 9: silvno31 ($68.46 in chips) 
Loholov: posts small blind $0.10
1Karina1: posts big blind $0.25
*** HOLE CARDS ***
Dealt to chiyuki [8s 8h]
chiyuki: raises $0.50 to $0.75
kesstukas25: folds 
teaser07: folds 
.7.DanDan.7.: folds 
DrunkTyphoon: folds 
silvno31: folds 
snejokCoxx: folds 
Loholov: folds 
1Karina1: folds 
Uncalled bet ($0.50) returned to chiyuki
chiyuki collected $0.60 from pot
chiyuki: doesn't show hand 
*** SUMMARY ***
Total pot $0.60 | Rake $0 
Seat 1: snejokCoxx (button) folded before Flop (didn't bet)
Seat 2: Loholov (small blind) folded before Flop
Seat 3: 1Karina1 (big blind) folded before Flop
Seat 4: chiyuki collected ($0.60)
Seat 5: kesstukas25 folded before Flop (didn't bet)
Seat 6: teaser07 folded before Flop (didn't bet)
Seat 7: .7.DanDan.7. folded before Flop (didn't bet)
Seat 8: DrunkTyphoon folded before Flop (didn't bet)
Seat 9: silvno31 folded before Flop (didn't bet)



PokerStars Zoom Hand #84301141792:  Hold'em No Limit ($0.10/$0.25) - 2012/08/05 16:14:46 JST [2012/08/05 3:14:46 ET]
Table 'Whirlpool' 9-max Seat #1 is the button
Seat 1: mjmichi ($80 in chips) 
Seat 2: TorTrade ($25.10 in chips) 
Seat 3: kwkim73 ($25 in chips) 
Seat 4: RRMM_again ($26.54 in chips) 
Seat 5: Mytea88 ($13.40 in chips) 
Seat 6: Femali54 ($15.74 in chips) 
Seat 7: Serge Claws ($66.83 in chips) 
Seat 8: chiyuki ($38.43 in chips) 
Seat 9: Alvinpe85 ($28.96 in chips) 
TorTrade: posts small blind $0.10
kwkim73: posts big blind $0.25
*** HOLE CARDS ***
Dealt to chiyuki [5h 7c]
RRMM_again: folds 
Mytea88: folds 
Femali54: folds 
Serge Claws: raises $0.50 to $0.75
chiyuki: folds 
Alvinpe85: folds 
mjmichi: calls $0.75
TorTrade: folds 
kwkim73: folds 
*** FLOP *** [4s Ac As]
Serge Claws: bets $0.75
mjmichi: calls $0.75
*** TURN *** [4s Ac As] [Js]
Serge Claws: checks 
mjmichi: bets $2.25
Serge Claws: folds 
Uncalled bet ($2.25) returned to mjmichi
mjmichi collected $3.20 from pot
mjmichi: doesn't show hand 
*** SUMMARY ***
Total pot $3.35 | Rake $0.15 
Board [4s Ac As Js]
Seat 1: mjmichi (button) collected ($3.20)
Seat 2: TorTrade (small blind) folded before Flop
Seat 3: kwkim73 (big blind) folded before Flop
Seat 4: RRMM_again folded before Flop (didn't bet)
Seat 5: Mytea88 folded before Flop (didn't bet)
Seat 6: Femali54 folded before Flop (didn't bet)
Seat 7: Serge Claws folded on the Turn
Seat 8: chiyuki folded before Flop (didn't bet)
Seat 9: Alvinpe85 folded before Flop (didn't bet)



PokerStars Zoom Hand #84301135550:  Hold'em No Limit ($0.10/$0.25) - 2012/08/05 16:14:23 JST [2012/08/05 3:14:23 ET]
Table 'Whirlpool' 9-max Seat #1 is the button
Seat 1: chiyuki ($38.43 in chips) 
Seat 2: Cripple86 ($32.92 in chips) 
Seat 3: yoube ($71.57 in chips) 
Seat 4: Limoilou ($31.56 in chips) 
Seat 5: GSDP ($28.46 in chips) 
Seat 6: kwkim73 ($25 in chips) 
Seat 7: Spheroff ($10.75 in chips) 
Seat 8: mamlind ($15.19 in chips) 
Seat 9: hldtom ($71.19 in chips) 
Cripple86: posts small blind $0.10
yoube: posts big blind $0.25
*** HOLE CARDS ***
Dealt to chiyuki [Ks 9c]
Limoilou: folds 
GSDP: raises $0.75 to $1
kwkim73: folds 
Spheroff: folds 
mamlind: folds 
hldtom: calls $1
chiyuki: folds 
Cripple86: folds 
yoube: calls $0.75
*** FLOP *** [4h 5s 8h]
yoube: checks 
GSDP: bets $2.25
hldtom: folds 
yoube: raises $3 to $5.25
GSDP: calls $3
*** TURN *** [4h 5s 8h] [2h]
yoube: bets $5.75
GSDP: calls $5.75
*** RIVER *** [4h 5s 8h 2h] [8d]
yoube: bets $20
GSDP: calls $16.46 and is all-in
Uncalled bet ($3.54) returned to yoube
*** SHOW DOWN ***
yoube: shows [4c 4d] (a full house, Fours full of Eights)
GSDP: shows [Kd Kc] (two pair, Kings and Eights)
yoube collected $56.02 from pot
*** SUMMARY ***
Total pot $58.02 | Rake $2 
Board [4h 5s 8h 2h 8d]
Seat 1: chiyuki (button) folded before Flop (didn't bet)
Seat 2: Cripple86 (small blind) folded before Flop
Seat 3: yoube (big blind) showed [4c 4d] and won ($56.02) with a full house, Fours full of Eights
Seat 4: Limoilou folded before Flop (didn't bet)
Seat 5: GSDP showed [Kd Kc] and lost with two pair, Kings and Eights
Seat 6: kwkim73 folded before Flop (didn't bet)
Seat 7: Spheroff folded before Flop (didn't bet)
Seat 8: mamlind folded before Flop (didn't bet)
Seat 9: hldtom folded on the Flop



PokerStars Zoom Hand #84301148462:  Hold'em No Limit ($0.10/$0.25) - 2012/08/05 16:15:11 JST [2012/08/05 3:15:11 ET]
Table 'Whirlpool' 9-max Seat #1 is the button
Seat 1: INSP!RON ($35.24 in chips) 
Seat 2: Bondvsta ($25 in chips) 
Seat 3: chiyuki ($38.78 in chips) 
Seat 4: DrunkTyphoon ($39.31 in chips) 
Seat 5: Ellen1947 ($24.30 in chips) 
Seat 6: fwnaf ($21.48 in chips) 
Seat 7: Loholov ($18.37 in chips) 
Seat 8: Lindikor ($9.53 in chips) 
Seat 9: pikhtovnikov ($26.60 in chips) 
Bondvsta: posts small blind $0.10
chiyuki: posts big blind $0.25
*** HOLE CARDS ***
Dealt to chiyuki [2c Kc]
DrunkTyphoon: raises $0.50 to $0.75
Ellen1947: folds 
fwnaf: calls $0.75
Loholov: folds 
Lindikor: folds 
pikhtovnikov: folds 
INSP!RON: folds 
Bondvsta: folds 
chiyuki: folds 
*** FLOP *** [4h Td Jd]
DrunkTyphoon: bets $1.18
fwnaf: calls $1.18
*** TURN *** [4h Td Jd] [Ac]
DrunkTyphoon: bets $2.69
fwnaf: calls $2.69
*** RIVER *** [4h Td Jd Ac] [9h]
DrunkTyphoon: checks 
fwnaf: checks 
*** SHOW DOWN ***
DrunkTyphoon: shows [8d 8h] (a pair of Eights)
fwnaf: shows [Ah Qh] (a pair of Aces)
fwnaf collected $9.16 from pot
*** SUMMARY ***
Total pot $9.59 | Rake $0.43 
Board [4h Td Jd Ac 9h]
Seat 1: INSP!RON (button) folded before Flop (didn't bet)
Seat 2: Bondvsta (small blind) folded before Flop
Seat 3: chiyuki (big blind) folded before Flop
Seat 4: DrunkTyphoon showed [8d 8h] and lost with a pair of Eights
Seat 5: Ellen1947 folded before Flop (didn't bet)
Seat 6: fwnaf showed [Ah Qh] and won ($9.16) with a pair of Aces
Seat 7: Loholov folded before Flop (didn't bet)
Seat 8: Lindikor folded before Flop (didn't bet)
Seat 9: pikhtovnikov folded before Flop (didn't bet)



PokerStars Zoom Hand #84301157038:  Hold'em No Limit ($0.10/$0.25) - 2012/08/05 16:15:42 JST [2012/08/05 3:15:42 ET]
Table 'Whirlpool' 9-max Seat #1 is the button
Seat 1: benjuer ($28.49 in chips) 
Seat 2: svg51 ($13.40 in chips) 
Seat 3: 4plankton ($4.18 in chips) 
Seat 4: Lasutchik ($13.99 in chips) 
Seat 5: INSP!RON ($26.93 in chips) 
Seat 6: Perstenev ($12.58 in chips) 
Seat 7: chiyuki ($38.53 in chips) 
Seat 8: Faantomace ($34.31 in chips) 
Seat 9: Dejacob ($29.63 in chips) 
svg51: posts small blind $0.10
4plankton: posts big blind $0.25
*** HOLE CARDS ***
Dealt to chiyuki [Kc 8c]
Lasutchik: folds 
INSP!RON: folds 
Perstenev: folds 
chiyuki: folds 
Faantomace: raises $0.75 to $1
Dejacob: calls $1
benjuer: folds 
svg51: folds 
4plankton: folds 
*** FLOP *** [4s 8d 4c]
Faantomace: checks 
Dejacob: checks 
*** TURN *** [4s 8d 4c] [9c]
Faantomace: bets $1.75
Dejacob: folds 
Uncalled bet ($1.75) returned to Faantomace
Faantomace collected $2.24 from pot
Faantomace: doesn't show hand 
*** SUMMARY ***
Total pot $2.35 | Rake $0.11 
Board [4s 8d 4c 9c]
Seat 1: benjuer (button) folded before Flop (didn't bet)
Seat 2: svg51 (small blind) folded before Flop
Seat 3: 4plankton (big blind) folded before Flop
Seat 4: Lasutchik folded before Flop (didn't bet)
Seat 5: INSP!RON folded before Flop (didn't bet)
Seat 6: Perstenev folded before Flop (didn't bet)
Seat 7: chiyuki folded before Flop (didn't bet)
Seat 8: Faantomace collected ($2.24)
Seat 9: Dejacob folded on the Turn



PokerStars Zoom Hand #84301159733:  Hold'em No Limit ($0.10/$0.25) - 2012/08/05 16:15:52 JST [2012/08/05 3:15:52 ET]
Table 'Whirlpool' 9-max Seat #1 is the button
Seat 1: chiyuki ($38.43 in chips) 
Seat 2: olligol123 ($26.12 in chips) 
Seat 3: tribunpdm ($76.04 in chips) 
Seat 4: phate-1up ($102 in chips) 
Seat 5: Dejacob ($35.96 in chips) 
Seat 6: 4ydo yogurt ($60.76 in chips) 
Seat 7: Vall179 ($31.29 in chips) 
Seat 8: Cripple86 ($25.59 in chips) 
Seat 9: Lindikor ($9.43 in chips) 
olligol123: posts small blind $0.10
tribunpdm: posts big blind $0.25
*** HOLE CARDS ***
Dealt to chiyuki [As Ah]
phate-1up: folds 
Dejacob: folds 
4ydo yogurt: folds 
Vall179: folds 
Cripple86: folds 
Lindikor: folds 
chiyuki: raises $0.50 to $0.75
olligol123: calls $0.65
tribunpdm: calls $0.50
*** FLOP *** [2h 7s Ts]
olligol123: checks 
tribunpdm: checks 
chiyuki: bets $1.75
olligol123: folds 
tribunpdm: folds 
Uncalled bet ($1.75) returned to chiyuki
chiyuki collected $2.15 from pot
chiyuki: doesn't show hand 
*** SUMMARY ***
Total pot $2.25 | Rake $0.10 
Board [2h 7s Ts]
Seat 1: chiyuki (button) collected ($2.15)
Seat 2: olligol123 (small blind) folded on the Flop
Seat 3: tribunpdm (big blind) folded on the Flop
Seat 4: phate-1up folded before Flop (didn't bet)
Seat 5: Dejacob folded before Flop (didn't bet)
Seat 6: 4ydo yogurt folded before Flop (didn't bet)
Seat 7: Vall179 folded before Flop (didn't bet)
Seat 8: Cripple86 folded before Flop (didn't bet)
Seat 9: Lindikor folded before Flop (didn't bet)



PokerStars Zoom Hand #84301158682:  Hold'em No Limit ($0.10/$0.25) - 2012/08/05 16:15:48 JST [2012/08/05 3:15:48 ET]
Table 'Whirlpool' 9-max Seat #1 is the button
Seat 1: INSP!RON ($26.93 in chips) 
Seat 2: chiyuki ($38.53 in chips) 
Seat 3: kwkim73 ($46.97 in chips) 
Seat 4: MurMurRu ($34.80 in chips) 
Seat 5: Serge Claws ($40.42 in chips) 
Seat 6: GovGus ($25 in chips) 
Seat 7: 19MJJ21 ($16.20 in chips) 
Seat 8: kesstukas25 ($28.69 in chips) 
Seat 9: snejokCoxx ($22.15 in chips) 
chiyuki: posts small blind $0.10
kwkim73: posts big blind $0.25
*** HOLE CARDS ***
Dealt to chiyuki [7s Kd]
MurMurRu: folds 
Serge Claws: folds 
GovGus: folds 
19MJJ21: folds 
kesstukas25: raises $0.50 to $0.75
snejokCoxx: calls $0.75
INSP!RON: folds 
chiyuki: folds 
kwkim73: folds 
*** FLOP *** [3d Qs 3c]
kesstukas25: bets $1
snejokCoxx: calls $1
*** TURN *** [3d Qs 3c] [3s]
kesstukas25: bets $1.25
snejokCoxx: calls $1.25
*** RIVER *** [3d Qs 3c 3s] [4d]
kesstukas25: bets $1.25
snejokCoxx: calls $1.25
*** SHOW DOWN ***
kesstukas25: shows [5s 5d] (a full house, Threes full of Fives)
snejokCoxx: shows [8d 8s] (a full house, Threes full of Eights)
snejokCoxx collected $8.45 from pot
*** SUMMARY ***
Total pot $8.85 | Rake $0.40 
Board [3d Qs 3c 3s 4d]
Seat 1: INSP!RON (button) folded before Flop (didn't bet)
Seat 2: chiyuki (small blind) folded before Flop
Seat 3: kwkim73 (big blind) folded before Flop
Seat 4: MurMurRu folded before Flop (didn't bet)
Seat 5: Serge Claws folded before Flop (didn't bet)
Seat 6: GovGus folded before Flop (didn't bet)
Seat 7: 19MJJ21 folded before Flop (didn't bet)
Seat 8: kesstukas25 showed [5s 5d] and lost with a full house, Threes full of Fives
Seat 9: snejokCoxx showed [8d 8s] and won ($8.45) with a full house, Threes full of Eights



PokerStars Zoom Hand #84301177413:  Hold'em No Limit ($0.10/$0.25) - 2012/08/05 16:16:57 JST [2012/08/05 3:16:57 ET]
Table 'Whirlpool' 9-max Seat #1 is the button
Seat 1: munky3 ($25.44 in chips) 
Seat 2: benjuer ($28.59 in chips) 
Seat 3: PPP7SSS ($40.22 in chips) 
Seat 4: soul_5577 ($35.33 in chips) 
Seat 5: INSP!RON ($26.93 in chips) 
Seat 6: scaredsare ($23.48 in chips) 
Seat 7: Loholov ($15 in chips) 
Seat 8: chiyuki ($39.83 in chips) 
Seat 9: nice.franki ($3.56 in chips) 
benjuer: posts small blind $0.10
PPP7SSS: posts big blind $0.25
*** HOLE CARDS ***
Dealt to chiyuki [4s 2d]
soul_5577: folds 
INSP!RON: folds 
scaredsare: folds 
Loholov: folds 
chiyuki: folds 
nice.franki: folds 
munky3: folds 
benjuer: folds 
Uncalled bet ($0.15) returned to PPP7SSS
PPP7SSS collected $0.20 from pot
PPP7SSS: doesn't show hand 
*** SUMMARY ***
Total pot $0.20 | Rake $0 
Seat 1: munky3 (button) folded before Flop (didn't bet)
Seat 2: benjuer (small blind) folded before Flop
Seat 3: PPP7SSS (big blind) collected ($0.20)
Seat 4: soul_5577 folded before Flop (didn't bet)
Seat 5: INSP!RON folded before Flop (didn't bet)
Seat 6: scaredsare folded before Flop (didn't bet)
Seat 7: Loholov folded before Flop (didn't bet)
Seat 8: chiyuki folded before Flop (didn't bet)
Seat 9: nice.franki folded before Flop (didn't bet)



PokerStars Zoom Hand #84301173533:  Hold'em No Limit ($0.10/$0.25) - 2012/08/05 16:16:43 JST [2012/08/05 3:16:43 ET]
Table 'Whirlpool' 9-max Seat #1 is the button
Seat 1: teaser07 ($25.50 in chips) 
Seat 2: INSP!RON ($27.28 in chips) 
Seat 3: 19MJJ21 ($16.55 in chips) 
Seat 4: tribunpdm ($75.29 in chips) 
Seat 5: Femali54 ($20.27 in chips) 
Seat 6: chiyuki ($39.83 in chips) 
Seat 7: Lindikor ($14.37 in chips) 
Seat 8: Kozyavkin ($6.23 in chips) 
Seat 9: theo0630 ($5.86 in chips) 
INSP!RON: posts small blind $0.10
19MJJ21: posts big blind $0.25
*** HOLE CARDS ***
Dealt to chiyuki [Kc 3s]
tribunpdm: raises $0.50 to $0.75
Femali54: folds 
chiyuki: folds 
Lindikor: folds 
Kozyavkin: calls $0.75
theo0630: folds 
teaser07: folds 
INSP!RON: folds 
19MJJ21: folds 
*** FLOP *** [Tc 3h 6h]
tribunpdm: checks 
Kozyavkin: checks 
*** TURN *** [Tc 3h 6h] [Th]
tribunpdm: checks 
Kozyavkin: checks 
*** RIVER *** [Tc 3h 6h Th] [Ac]
tribunpdm: checks 
Kozyavkin: checks 
*** SHOW DOWN ***
tribunpdm: shows [Kd Ah] (two pair, Aces and Tens)
Kozyavkin: mucks hand 
tribunpdm collected $1.77 from pot
*** SUMMARY ***
Total pot $1.85 | Rake $0.08 
Board [Tc 3h 6h Th Ac]
Seat 1: teaser07 (button) folded before Flop (didn't bet)
Seat 2: INSP!RON (small blind) folded before Flop
Seat 3: 19MJJ21 (big blind) folded before Flop
Seat 4: tribunpdm showed [Kd Ah] and won ($1.77) with two pair, Aces and Tens
Seat 5: Femali54 folded before Flop (didn't bet)
Seat 6: chiyuki folded before Flop (didn't bet)
Seat 7: Lindikor folded before Flop (didn't bet)
Seat 8: Kozyavkin mucked [As Jh]
Seat 9: theo0630 folded before Flop (didn't bet)



PokerStars Zoom Hand #84301180756:  Hold'em No Limit ($0.10/$0.25) - 2012/08/05 16:17:09 JST [2012/08/05 3:17:09 ET]
Table 'Whirlpool' 9-max Seat #1 is the button
Seat 1: Femali54 ($20.27 in chips) 
Seat 2: munky3 ($25.44 in chips) 
Seat 3: Dejacob ($32.53 in chips) 
Seat 4: chiyuki ($39.83 in chips) 
Seat 5: masterkoolb ($12.85 in chips) 
Seat 6: Loholov ($15 in chips) 
Seat 7: teaser07 ($25.50 in chips) 
Seat 8: roksmokndonk ($23.11 in chips) 
Seat 9: Vall179 ($23.34 in chips) 
munky3: posts small blind $0.10
Dejacob: posts big blind $0.25
*** HOLE CARDS ***
Dealt to chiyuki [2s Jc]
chiyuki: folds 
masterkoolb: folds 
Loholov: folds 
teaser07: raises $0.50 to $0.75
roksmokndonk: folds 
Vall179: folds 
Femali54: folds 
munky3: calls $0.65
Dejacob: folds 
*** FLOP *** [Ac 2h 5h]
munky3: checks 
teaser07: bets $1.10
munky3: folds 
Uncalled bet ($1.10) returned to teaser07
teaser07 collected $1.67 from pot
teaser07: doesn't show hand 
*** SUMMARY ***
Total pot $1.75 | Rake $0.08 
Board [Ac 2h 5h]
Seat 1: Femali54 (button) folded before Flop (didn't bet)
Seat 2: munky3 (small blind) folded on the Flop
Seat 3: Dejacob (big blind) folded before Flop
Seat 4: chiyuki folded before Flop (didn't bet)
Seat 5: masterkoolb folded before Flop (didn't bet)
Seat 6: Loholov folded before Flop (didn't bet)
Seat 7: teaser07 collected ($1.67)
Seat 8: roksmokndonk folded before Flop (didn't bet)
Seat 9: Vall179 folded before Flop (didn't bet)



PokerStars Zoom Hand #84301183152:  Hold'em No Limit ($0.10/$0.25) - 2012/08/05 16:17:18 JST [2012/08/05 3:17:18 ET]
Table 'Whirlpool' 9-max Seat #1 is the button
Seat 1: INSP!RON ($33.64 in chips) 
Seat 2: PPP7SSS ($40.32 in chips) 
Seat 3: chiyuki ($39.83 in chips) 
Seat 4: CrittHunter ($25.90 in chips) 
Seat 5: MurMurRu ($41.84 in chips) 
Seat 6: phate-1up ($55.98 in chips) 
Seat 7: mjmichi ($87.04 in chips) 
Seat 8: benjuer ($26.73 in chips) 
Seat 9: soul_5577 ($35.23 in chips) 
PPP7SSS: posts small blind $0.10
chiyuki: posts big blind $0.25
*** HOLE CARDS ***
Dealt to chiyuki [Qh 7d]
CrittHunter: folds 
MurMurRu: folds 
phate-1up: folds 
mjmichi: raises $0.50 to $0.75
benjuer: folds 
soul_5577: folds 
INSP!RON: folds 
PPP7SSS: folds 
chiyuki: folds 
Uncalled bet ($0.50) returned to mjmichi
mjmichi collected $0.60 from pot
mjmichi: doesn't show hand 
*** SUMMARY ***
Total pot $0.60 | Rake $0 
Seat 1: INSP!RON (button) folded before Flop (didn't bet)
Seat 2: PPP7SSS (small blind) folded before Flop
Seat 3: chiyuki (big blind) folded before Flop
Seat 4: CrittHunter folded before Flop (didn't bet)
Seat 5: MurMurRu folded before Flop (didn't bet)
Seat 6: phate-1up folded before Flop (didn't bet)
Seat 7: mjmichi collected ($0.60)
Seat 8: benjuer folded before Flop (didn't bet)
Seat 9: soul_5577 folded before Flop (didn't bet)



PokerStars Zoom Hand #84301176022:  Hold'em No Limit ($0.10/$0.25) - 2012/08/05 16:16:52 JST [2012/08/05 3:16:52 ET]
Table 'Whirlpool' 9-max Seat #1 is the button
Seat 1: olligol123 ($25.37 in chips) 
Seat 2: Ellen1947 ($23.35 in chips) 
Seat 3: INSP!RON ($27.18 in chips) 
Seat 4: men1989 ($25 in chips) 
Seat 5: chiyuki ($39.83 in chips) 
Seat 6: Perstenev ($9.04 in chips) 
Seat 7: Femali54 ($20.27 in chips) 
Seat 8: snejokCoxx ($26.35 in chips) 
Seat 9: 1Karina1 ($66.64 in chips) 
Ellen1947: posts small blind $0.10
INSP!RON: posts big blind $0.25
*** HOLE CARDS ***
Dealt to chiyuki [4h 5d]
men1989: raises $0.50 to $0.75
chiyuki: folds 
Perstenev: folds 
Femali54: folds 
snejokCoxx: folds 
1Karina1: folds 
olligol123: calls $0.75
Ellen1947: folds 
INSP!RON: folds 
*** FLOP *** [2d 9h Ac]
men1989: bets $1.23
olligol123: raises $1.27 to $2.50
men1989: folds 
Uncalled bet ($1.27) returned to olligol123
olligol123 collected $4.12 from pot
olligol123: doesn't show hand 
*** SUMMARY ***
Total pot $4.31 | Rake $0.19 
Board [2d 9h Ac]
Seat 1: olligol123 (button) collected ($4.12)
Seat 2: Ellen1947 (small blind) folded before Flop
Seat 3: INSP!RON (big blind) folded before Flop
Seat 4: men1989 folded on the Flop
Seat 5: chiyuki folded before Flop (didn't bet)
Seat 6: Perstenev folded before Flop (didn't bet)
Seat 7: Femali54 folded before Flop (didn't bet)
Seat 8: snejokCoxx folded before Flop (didn't bet)
Seat 9: 1Karina1 folded before Flop (didn't bet)



PokerStars Zoom Hand #84301190110:  Hold'em No Limit ($0.10/$0.25) - 2012/08/05 16:17:44 JST [2012/08/05 3:17:44 ET]
Table 'Whirlpool' 9-max Seat #1 is the button
Seat 1: chiyuki ($39.48 in chips) 
Seat 2: roksmokndonk ($22.86 in chips) 
Seat 3: Cripple86 ($26.81 in chips) 
Seat 4: Serge Claws ($65.16 in chips) 
Seat 5: d4dda ($19.50 in chips) 
Seat 6: teaser07 ($26.42 in chips) 
Seat 7: mungroo ($23.90 in chips) 
Seat 8: munky3 ($24.69 in chips) 
Seat 9: 19MJJ21 ($15.80 in chips) 
roksmokndonk: posts small blind $0.10
Cripple86: posts big blind $0.25
*** HOLE CARDS ***
Dealt to chiyuki [Qc 3h]
Serge Claws: folds 
d4dda: folds 
teaser07: folds 
mungroo: folds 
munky3: folds 
19MJJ21: raises $0.45 to $0.70
chiyuki: folds 
roksmokndonk: folds 
Cripple86: folds 
Uncalled bet ($0.45) returned to 19MJJ21
19MJJ21 collected $0.60 from pot
19MJJ21: doesn't show hand 
*** SUMMARY ***
Total pot $0.60 | Rake $0 
Seat 1: chiyuki (button) folded before Flop (didn't bet)
Seat 2: roksmokndonk (small blind) folded before Flop
Seat 3: Cripple86 (big blind) folded before Flop
Seat 4: Serge Claws folded before Flop (didn't bet)
Seat 5: d4dda folded before Flop (didn't bet)
Seat 6: teaser07 folded before Flop (didn't bet)
Seat 7: mungroo folded before Flop (didn't bet)
Seat 8: munky3 folded before Flop (didn't bet)
Seat 9: 19MJJ21 collected ($0.60)



PokerStars Zoom Hand #84301187560:  Hold'em No Limit ($0.10/$0.25) - 2012/08/05 16:17:34 JST [2012/08/05 3:17:34 ET]
Table 'Whirlpool' 9-max Seat #1 is the button
Seat 1: Serge Claws ($39.42 in chips) 
Seat 2: chiyuki ($39.58 in chips) 
Seat 3: Alvinpe85 ($31.12 in chips) 
Seat 4: benjuer ($26.73 in chips) 
Seat 5: munky3 ($24.69 in chips) 
Seat 6: nice.franki ($3.46 in chips) 
Seat 7: pandaaaaaa ($15.98 in chips) 
Seat 8: deepakmbh ($28.02 in chips) 
Seat 9: new85new85 ($24.65 in chips) 
chiyuki: posts small blind $0.10
Alvinpe85: posts big blind $0.25
*** HOLE CARDS ***
Dealt to chiyuki [9c 6s]
benjuer: folds 
munky3: folds 
nice.franki: folds 
pandaaaaaa: folds 
deepakmbh: folds 
new85new85 has timed out
new85new85: folds 
Serge Claws: folds 
chiyuki: folds 
Uncalled bet ($0.15) returned to Alvinpe85
Alvinpe85 collected $0.20 from pot
Alvinpe85: doesn't show hand 
*** SUMMARY ***
Total pot $0.20 | Rake $0 
Seat 1: Serge Claws (button) folded before Flop (didn't bet)
Seat 2: chiyuki (small blind) folded before Flop
Seat 3: Alvinpe85 (big blind) collected ($0.20)
Seat 4: benjuer folded before Flop (didn't bet)
Seat 5: munky3 folded before Flop (didn't bet)
Seat 6: nice.franki folded before Flop (didn't bet)
Seat 7: pandaaaaaa folded before Flop (didn't bet)
Seat 8: deepakmbh folded before Flop (didn't bet)
Seat 9: new85new85 folded before Flop (didn't bet)



PokerStars Zoom Hand #84301179639:  Hold'em No Limit ($0.10/$0.25) - 2012/08/05 16:17:05 JST [2012/08/05 3:17:05 ET]
Table 'Whirlpool' 9-max Seat #1 is the button
Seat 1: mungroo ($24.65 in chips) 
Seat 2: roksmokndonk ($23.21 in chips) 
Seat 3: 1Karina1 ($33.93 in chips) 
Seat 4: kwkim73 ($33.71 in chips) 
Seat 5: chiyuki ($39.83 in chips) 
Seat 6: DrunkTyphoon ($45.76 in chips) 
Seat 7: 280128si ($17.89 in chips) 
Seat 8: FoRlan77 ($26.10 in chips) 
Seat 9: Bahia gyn ($14.56 in chips) 
roksmokndonk: posts small blind $0.10
1Karina1: posts big blind $0.25
*** HOLE CARDS ***
Dealt to chiyuki [2c Ad]
kwkim73: folds 
chiyuki: folds 
DrunkTyphoon: folds 
280128si: folds 
FoRlan77: raises $0.50 to $0.75
Bahia gyn: raises $1.25 to $2
mungroo: folds 
roksmokndonk: folds 
1Karina1: calls $1.75
FoRlan77: folds 
*** FLOP *** [3h Kc Qh]
1Karina1: checks 
Bahia gyn: checks 
*** TURN *** [3h Kc Qh] [4h]
1Karina1: bets $3.25
Bahia gyn: calls $3.25
*** RIVER *** [3h Kc Qh 4h] [Ts]
1Karina1: bets $10.84
Bahia gyn: calls $9.31 and is all-in
Uncalled bet ($1.53) returned to 1Karina1
*** SHOW DOWN ***
1Karina1: shows [Ks Kd] (three of a kind, Kings)
Bahia gyn: shows [Ac Qs] (a pair of Queens)
1Karina1 collected $28.62 from pot
*** SUMMARY ***
Total pot $29.97 | Rake $1.35 
Board [3h Kc Qh 4h Ts]
Seat 1: mungroo (button) folded before Flop (didn't bet)
Seat 2: roksmokndonk (small blind) folded before Flop
Seat 3: 1Karina1 (big blind) showed [Ks Kd] and won ($28.62) with three of a kind, Kings
Seat 4: kwkim73 folded before Flop (didn't bet)
Seat 5: chiyuki folded before Flop (didn't bet)
Seat 6: DrunkTyphoon folded before Flop (didn't bet)
Seat 7: 280128si folded before Flop (didn't bet)
Seat 8: FoRlan77 folded before Flop
Seat 9: Bahia gyn showed [Ac Qs] and lost with a pair of Queens



PokerStars Zoom Hand #84301188704:  Hold'em No Limit ($0.10/$0.25) - 2012/08/05 16:17:39 JST [2012/08/05 3:17:39 ET]
Table 'Whirlpool' 9-max Seat #1 is the button
Seat 1: 19MJJ21 ($15.80 in chips) 
Seat 2: fwnaf ($26.69 in chips) 
Seat 3: Dejacob ($27.57 in chips) 
Seat 4: deepakmbh ($28.02 in chips) 
Seat 5: Loholov ($20.57 in chips) 
Seat 6: d4dda ($19.50 in chips) 
Seat 7: Ellen1947 ($23.60 in chips) 
Seat 8: mungroo ($23.90 in chips) 
Seat 9: chiyuki ($39.48 in chips) 
fwnaf: posts small blind $0.10
Dejacob: posts big blind $0.25
*** HOLE CARDS ***
Dealt to chiyuki [7s 9h]
deepakmbh: raises $0.55 to $0.80
Loholov: folds 
d4dda: folds 
Ellen1947: folds 
mungroo: folds 
chiyuki: folds 
19MJJ21: folds 
fwnaf: calls $0.70
Dejacob: folds 
*** FLOP *** [Jc Kc 2s]
fwnaf: checks 
deepakmbh: bets $1.20
fwnaf: calls $1.20
*** TURN *** [Jc Kc 2s] [7d]
fwnaf: checks 
deepakmbh: bets $3.20
fwnaf: folds 
Uncalled bet ($3.20) returned to deepakmbh
deepakmbh collected $4.06 from pot
deepakmbh: doesn't show hand 
*** SUMMARY ***
Total pot $4.25 | Rake $0.19 
Board [Jc Kc 2s 7d]
Seat 1: 19MJJ21 (button) folded before Flop (didn't bet)
Seat 2: fwnaf (small blind) folded on the Turn
Seat 3: Dejacob (big blind) folded before Flop
Seat 4: deepakmbh collected ($4.06)
Seat 5: Loholov folded before Flop (didn't bet)
Seat 6: d4dda folded before Flop (didn't bet)
Seat 7: Ellen1947 folded before Flop (didn't bet)
Seat 8: mungroo folded before Flop (didn't bet)
Seat 9: chiyuki folded before Flop (didn't bet)



PokerStars Zoom Hand #84301195961:  Hold'em No Limit ($0.10/$0.25) - 2012/08/05 16:18:05 JST [2012/08/05 3:18:05 ET]
Table 'Whirlpool' 9-max Seat #1 is the button
Seat 1: nice.franki ($3.21 in chips) 
Seat 2: Faantomace ($31.80 in chips) 
Seat 3: munky3 ($24.69 in chips) 
Seat 4: Dejacob ($28.63 in chips) 
Seat 5: GovGus ($25 in chips) 
Seat 6: chiyuki ($39.48 in chips) 
Seat 7: new85new85 ($24.40 in chips) 
Seat 8: Cripple86 ($26.56 in chips) 
Seat 9: Serge Claws ($39.17 in chips) 
Faantomace: posts small blind $0.10
munky3: posts big blind $0.25
*** HOLE CARDS ***
Dealt to chiyuki [4h 7s]
Dejacob: folds 
GovGus: raises $0.50 to $0.75
chiyuki: folds 
new85new85: folds 
Cripple86: folds 
Serge Claws: folds 
nice.franki: folds 
Faantomace: folds 
munky3: folds 
Uncalled bet ($0.50) returned to GovGus
GovGus collected $0.60 from pot
GovGus: doesn't show hand 
*** SUMMARY ***
Total pot $0.60 | Rake $0 
Seat 1: nice.franki (button) folded before Flop (didn't bet)
Seat 2: Faantomace (small blind) folded before Flop
Seat 3: munky3 (big blind) folded before Flop
Seat 4: Dejacob folded before Flop (didn't bet)
Seat 5: GovGus collected ($0.60)
Seat 6: chiyuki folded before Flop (didn't bet)
Seat 7: new85new85 folded before Flop (didn't bet)
Seat 8: Cripple86 folded before Flop (didn't bet)
Seat 9: Serge Claws folded before Flop (didn't bet)



PokerStars Zoom Hand #84301191783:  Hold'em No Limit ($0.10/$0.25) - 2012/08/05 16:17:50 JST [2012/08/05 3:17:50 ET]
Table 'Whirlpool' 9-max Seat #1 is the button
Seat 1: ivan130 ($29.26 in chips) 
Seat 2: TorTrade ($34.03 in chips) 
Seat 3: MurMurRu ($25.90 in chips) 
Seat 4: Loholov ($15 in chips) 
Seat 5: mungroo ($23.90 in chips) 
Seat 6: Dejacob ($32.28 in chips) 
Seat 7: chiyuki ($39.48 in chips) 
Seat 8: hldtom ($20.05 in chips) 
Seat 9: olligol123 ($26.28 in chips) 
TorTrade: posts small blind $0.10
MurMurRu: posts big blind $0.25
*** HOLE CARDS ***
Dealt to chiyuki [4c 6d]
Loholov: folds 
mungroo: folds 
Dejacob: folds 
chiyuki: folds 
hldtom: folds 
olligol123: raises $0.50 to $0.75
ivan130: calls $0.75
TorTrade: folds 
MurMurRu: calls $0.50
*** FLOP *** [7c 9h Jd]
MurMurRu: checks 
olligol123: bets $1.75
ivan130: folds 
MurMurRu: folds 
Uncalled bet ($1.75) returned to olligol123
olligol123 collected $2.24 from pot
olligol123: doesn't show hand 
*** SUMMARY ***
Total pot $2.35 | Rake $0.11 
Board [7c 9h Jd]
Seat 1: ivan130 (button) folded on the Flop
Seat 2: TorTrade (small blind) folded before Flop
Seat 3: MurMurRu (big blind) folded on the Flop
Seat 4: Loholov folded before Flop (didn't bet)
Seat 5: mungroo folded before Flop (didn't bet)
Seat 6: Dejacob folded before Flop (didn't bet)
Seat 7: chiyuki folded before Flop (didn't bet)
Seat 8: hldtom folded before Flop (didn't bet)
Seat 9: olligol123 collected ($2.24)



PokerStars Zoom Hand #84301172694:  Hold'em No Limit ($0.10/$0.25) - 2012/08/05 16:16:40 JST [2012/08/05 3:16:40 ET]
Table 'Whirlpool' 9-max Seat #1 is the button
Seat 1: Nerkit ($12.25 in chips) 
Seat 2: Lucky Maga ($13.10 in chips) 
Seat 3: roksmokndonk ($23.46 in chips) 
Seat 4: Grishukps ($12.50 in chips) 
Seat 5: Cripple86 ($25.84 in chips) 
Seat 6: xxx Spb xxx ($36.16 in chips) 
Seat 7: GSDP ($24.25 in chips) 
Seat 8: nice.franki ($12.38 in chips) 
Seat 9: chiyuki ($39.83 in chips) 
Lucky Maga: posts small blind $0.10
roksmokndonk: posts big blind $0.25
*** HOLE CARDS ***
Dealt to chiyuki [4s Kc]
Grishukps: raises $0.50 to $0.75
Cripple86: folds 
xxx Spb xxx: calls $0.75
GSDP: folds 
nice.franki: folds 
chiyuki: folds 
Nerkit: calls $0.75
Lucky Maga: folds 
roksmokndonk: folds 
*** FLOP *** [2d 5c Ac]
Grishukps: checks 
xxx Spb xxx: bets $1.30
Nerkit: calls $1.30
Grishukps: folds 
*** TURN *** [2d 5c Ac] [8h]
xxx Spb xxx: checks 
Nerkit: checks 
*** RIVER *** [2d 5c Ac 8h] [8d]
xxx Spb xxx: checks 
Nerkit: bets $3
xxx Spb xxx: folds 
Uncalled bet ($3) returned to Nerkit
Nerkit collected $4.97 from pot
Nerkit: doesn't show hand 
*** SUMMARY ***
Total pot $5.20 | Rake $0.23 
Board [2d 5c Ac 8h 8d]
Seat 1: Nerkit (button) collected ($4.97)
Seat 2: Lucky Maga (small blind) folded before Flop
Seat 3: roksmokndonk (big blind) folded before Flop
Seat 4: Grishukps folded on the Flop
Seat 5: Cripple86 folded before Flop (didn't bet)
Seat 6: xxx Spb xxx folded on the River
Seat 7: GSDP folded before Flop (didn't bet)
Seat 8: nice.franki folded before Flop (didn't bet)
Seat 9: chiyuki folded before Flop (didn't bet)



PokerStars Zoom Hand #84301194531:  Hold'em No Limit ($0.10/$0.25) - 2012/08/05 16:18:00 JST [2012/08/05 3:18:00 ET]
Table 'Whirlpool' 9-max Seat #1 is the button
Seat 1: Perstenev ($10.43 in chips) 
Seat 2: benjuer ($25.46 in chips) 
Seat 3: mamlind ($12.50 in chips) 
Seat 4: GovGus ($43.10 in chips) 
Seat 5: xxx Spb xxx ($28.12 in chips) 
Seat 6: Patient90122 ($26.87 in chips) 
Seat 7: Serge Claws ($39.17 in chips) 
Seat 8: chiyuki ($39.48 in chips) 
Seat 9: men1989 ($22.77 in chips) 
benjuer: posts small blind $0.10
mamlind: posts big blind $0.25
*** HOLE CARDS ***
Dealt to chiyuki [3h 5c]
GovGus: folds 
xxx Spb xxx: folds 
Patient90122: folds 
Serge Claws: folds 
chiyuki: folds 
men1989: folds 
Perstenev: calls $0.25
benjuer: folds 
mamlind: checks 
*** FLOP *** [9d Kc 8c]
mamlind: checks 
Perstenev: bets $0.25
mamlind: calls $0.25
*** TURN *** [9d Kc 8c] [Th]
mamlind: checks 
Perstenev: checks 
*** RIVER *** [9d Kc 8c Th] [Ah]
mamlind: bets $0.78
Perstenev: folds 
Uncalled bet ($0.78) returned to mamlind
mamlind collected $1.05 from pot
mamlind: doesn't show hand 
*** SUMMARY ***
Total pot $1.10 | Rake $0.05 
Board [9d Kc 8c Th Ah]
Seat 1: Perstenev (button) folded on the River
Seat 2: benjuer (small blind) folded before Flop
Seat 3: mamlind (big blind) collected ($1.05)
Seat 4: GovGus folded before Flop (didn't bet)
Seat 5: xxx Spb xxx folded before Flop (didn't bet)
Seat 6: Patient90122 folded before Flop (didn't bet)
Seat 7: Serge Claws folded before Flop (didn't bet)
Seat 8: chiyuki folded before Flop (didn't bet)
Seat 9: men1989 folded before Flop (didn't bet)



PokerStars Zoom Hand #84301198484:  Hold'em No Limit ($0.10/$0.25) - 2012/08/05 16:18:14 JST [2012/08/05 3:18:14 ET]
Table 'Whirlpool' 9-max Seat #1 is the button
Seat 1: nice.franki ($12.63 in chips) 
Seat 2: Lindikor ($13.37 in chips) 
Seat 3: chiyuki ($39.48 in chips) 
Seat 4: 1Karina1 ($47.99 in chips) 
Seat 5: Perstenev ($8.70 in chips) 
Seat 6: kwkim73 ($33.36 in chips) 
Seat 7: munky3 ($24.44 in chips) 
Seat 8: poorpoor6551 ($9.73 in chips) 
Seat 9: Limoilou ($31.21 in chips) 
Lindikor: posts small blind $0.10
chiyuki: posts big blind $0.25
*** HOLE CARDS ***
Dealt to chiyuki [8c 9c]
1Karina1: folds 
Perstenev: folds 
kwkim73: raises $0.50 to $0.75
munky3: folds 
poorpoor6551: folds 
Limoilou: folds 
nice.franki: folds 
Lindikor: folds 
chiyuki: folds 
Uncalled bet ($0.50) returned to kwkim73
kwkim73 collected $0.60 from pot
kwkim73: doesn't show hand 
*** SUMMARY ***
Total pot $0.60 | Rake $0 
Seat 1: nice.franki (button) folded before Flop (didn't bet)
Seat 2: Lindikor (small blind) folded before Flop
Seat 3: chiyuki (big blind) folded before Flop
Seat 4: 1Karina1 folded before Flop (didn't bet)
Seat 5: Perstenev folded before Flop (didn't bet)
Seat 6: kwkim73 collected ($0.60)
Seat 7: munky3 folded before Flop (didn't bet)
Seat 8: poorpoor6551 folded before Flop (didn't bet)
Seat 9: Limoilou folded before Flop (didn't bet)



PokerStars Zoom Hand #84301193708:  Hold'em No Limit ($0.10/$0.25) - 2012/08/05 16:17:57 JST [2012/08/05 3:17:57 ET]
Table 'Whirlpool' 9-max Seat #1 is the button
Seat 1: AntoineHunt ($14.62 in chips) 
Seat 2: MurMurRu ($27.28 in chips) 
Seat 3: Nerkit ($14.60 in chips) 
Seat 4: Lasutchik ($32.89 in chips) 
Seat 5: GSDP ($35.07 in chips) 
Seat 6: chiyuki ($39.48 in chips) 
Seat 7: Vall179 ($31.29 in chips) 
Seat 8: Spheroff ($20.77 in chips) 
Seat 9: kesstukas25 ($24.09 in chips) 
MurMurRu: posts small blind $0.10
Nerkit: posts big blind $0.25
*** HOLE CARDS ***
Dealt to chiyuki [6d Jh]
Lasutchik: folds 
GSDP: calls $0.25
chiyuki: folds 
Vall179: folds 
Spheroff: folds 
kesstukas25: folds 
AntoineHunt: folds 
MurMurRu: folds 
Nerkit: checks 
*** FLOP *** [5d 5s Qc]
Nerkit: checks 
GSDP: bets $0.25
Nerkit: calls $0.25
*** TURN *** [5d 5s Qc] [2h]
Nerkit: checks 
GSDP: bets $0.50
Nerkit: calls $0.50
*** RIVER *** [5d 5s Qc 2h] [4s]
Nerkit: checks 
GSDP: checks 
*** SHOW DOWN ***
Nerkit: shows [Qh 7h] (two pair, Queens and Fives)
GSDP: mucks hand 
Nerkit collected $2.01 from pot
*** SUMMARY ***
Total pot $2.10 | Rake $0.09 
Board [5d 5s Qc 2h 4s]
Seat 1: AntoineHunt (button) folded before Flop (didn't bet)
Seat 2: MurMurRu (small blind) folded before Flop
Seat 3: Nerkit (big blind) showed [Qh 7h] and won ($2.01) with two pair, Queens and Fives
Seat 4: Lasutchik folded before Flop (didn't bet)
Seat 5: GSDP mucked [2c Ac]
Seat 6: chiyuki folded before Flop (didn't bet)
Seat 7: Vall179 folded before Flop (didn't bet)
Seat 8: Spheroff folded before Flop (didn't bet)
Seat 9: kesstukas25 folded before Flop (didn't bet)



PokerStars Zoom Hand #84301205943:  Hold'em No Limit ($0.10/$0.25) - 2012/08/05 16:18:41 JST [2012/08/05 3:18:41 ET]
Table 'Whirlpool' 9-max Seat #1 is the button
Seat 1: mamlind ($12.95 in chips) 
Seat 2: Lucky Maga ($10 in chips) 
Seat 3: Vall179 ($37.40 in chips) 
Seat 4: benjuer ($29.86 in chips) 
Seat 5: chiyuki ($39.13 in chips) 
Seat 6: nice.franki ($4.21 in chips) 
Seat 7: 19MJJ21 ($16.05 in chips) 
Seat 8: Serge Claws ($65.59 in chips) 
Seat 9: Loholov ($15 in chips) 
Lucky Maga: posts small blind $0.10
Vall179: posts big blind $0.25
*** HOLE CARDS ***
Dealt to chiyuki [Td 2c]
benjuer: folds 
chiyuki: folds 
nice.franki: folds 
19MJJ21: raises $0.25 to $0.50
Serge Claws: folds 
Loholov: folds 
mamlind: folds 
Lucky Maga: folds 
Vall179: folds 
Uncalled bet ($0.25) returned to 19MJJ21
19MJJ21 collected $0.60 from pot
19MJJ21: doesn't show hand 
*** SUMMARY ***
Total pot $0.60 | Rake $0 
Seat 1: mamlind (button) folded before Flop (didn't bet)
Seat 2: Lucky Maga (small blind) folded before Flop
Seat 3: Vall179 (big blind) folded before Flop
Seat 4: benjuer folded before Flop (didn't bet)
Seat 5: chiyuki folded before Flop (didn't bet)
Seat 6: nice.franki folded before Flop (didn't bet)
Seat 7: 19MJJ21 collected ($0.60)
Seat 8: Serge Claws folded before Flop (didn't bet)
Seat 9: Loholov folded before Flop (didn't bet)



PokerStars Zoom Hand #84301204283:  Hold'em No Limit ($0.10/$0.25) - 2012/08/05 16:18:35 JST [2012/08/05 3:18:35 ET]
Table 'Whirlpool' 9-max Seat #1 is the button
Seat 1: phate-1up ($34.53 in chips) 
Seat 2: chiyuki ($39.23 in chips) 
Seat 3: new85new85 ($25 in chips) 
Seat 4: drunk_bender ($28.86 in chips) 
Seat 5: PPP7SSS ($38.72 in chips) 
Seat 6: Cripple86 ($26.46 in chips) 
Seat 7: MurMurRu ($34.48 in chips) 
Seat 8: Dejacob ($28.28 in chips) 
Seat 9: TorTrade ($33.93 in chips) 
chiyuki: posts small blind $0.10
new85new85: posts big blind $0.25
*** HOLE CARDS ***
Dealt to chiyuki [4h 8d]
drunk_bender: folds 
PPP7SSS: raises $0.25 to $0.50
Cripple86: folds 
MurMurRu: folds 
Dejacob: folds 
TorTrade: folds 
phate-1up: folds 
chiyuki: folds 
new85new85: folds 
Uncalled bet ($0.25) returned to PPP7SSS
PPP7SSS collected $0.60 from pot
PPP7SSS: doesn't show hand 
*** SUMMARY ***
Total pot $0.60 | Rake $0 
Seat 1: phate-1up (button) folded before Flop (didn't bet)
Seat 2: chiyuki (small blind) folded before Flop
Seat 3: new85new85 (big blind) folded before Flop
Seat 4: drunk_bender folded before Flop (didn't bet)
Seat 5: PPP7SSS collected ($0.60)
Seat 6: Cripple86 folded before Flop (didn't bet)
Seat 7: MurMurRu folded before Flop (didn't bet)
Seat 8: Dejacob folded before Flop (didn't bet)
Seat 9: TorTrade folded before Flop (didn't bet)



PokerStars Zoom Hand #84301207621:  Hold'em No Limit ($0.10/$0.25) - 2012/08/05 16:18:47 JST [2012/08/05 3:18:47 ET]
Table 'Whirlpool' 9-max Seat #1 is the button
Seat 1: Lucky Maga ($9.90 in chips) 
Seat 2: Grishukps ($12.50 in chips) 
Seat 3: DanielWhyte ($35.37 in chips) 
Seat 4: MurMurRu ($34.48 in chips) 
Seat 5: INSP!RON ($25.79 in chips) 
Seat 6: Serge Claws ($65.59 in chips) 
Seat 7: chiyuki ($39.13 in chips) 
Seat 8: xxx Spb xxx ($33.86 in chips) 
Seat 9: GovGus ($51.30 in chips) 
Grishukps: posts small blind $0.10
DanielWhyte: posts big blind $0.25
*** HOLE CARDS ***
Dealt to chiyuki [2s Kd]
MurMurRu: folds 
INSP!RON: raises $0.50 to $0.75
Serge Claws: folds 
chiyuki: folds 
xxx Spb xxx: folds 
GovGus: folds 
Lucky Maga: folds 
Grishukps: folds 
DanielWhyte: folds 
Uncalled bet ($0.50) returned to INSP!RON
INSP!RON collected $0.60 from pot
INSP!RON: doesn't show hand 
*** SUMMARY ***
Total pot $0.60 | Rake $0 
Seat 1: Lucky Maga (button) folded before Flop (didn't bet)
Seat 2: Grishukps (small blind) folded before Flop
Seat 3: DanielWhyte (big blind) folded before Flop
Seat 4: MurMurRu folded before Flop (didn't bet)
Seat 5: INSP!RON collected ($0.60)
Seat 6: Serge Claws folded before Flop (didn't bet)
Seat 7: chiyuki folded before Flop (didn't bet)
Seat 8: xxx Spb xxx folded before Flop (didn't bet)
Seat 9: GovGus folded before Flop (didn't bet)



PokerStars Zoom Hand #84301210362:  Hold'em No Limit ($0.10/$0.25) - 2012/08/05 16:18:58 JST [2012/08/05 3:18:58 ET]
Table 'Whirlpool' 9-max Seat #1 is the button
Seat 1: Dejacob ($26.32 in chips) 
Seat 2: Cripple86 ($25.80 in chips) 
Seat 3: 19MJJ21 ($16.40 in chips) 
Seat 4: kesstukas25 ($24.09 in chips) 
Seat 5: roksmokndonk ($16.08 in chips) 
Seat 6: Nerkit ($15.07 in chips) 
Seat 7: Grumpy as 2 ($8.78 in chips) 
Seat 8: mamlind ($12.95 in chips) 
Seat 9: chiyuki ($39.13 in chips) 
Cripple86: posts small blind $0.10
19MJJ21: posts big blind $0.25
*** HOLE CARDS ***
Dealt to chiyuki [9h 3c]
kesstukas25: folds 
roksmokndonk: folds 
Nerkit: folds 
Grumpy as 2: folds 
mamlind: folds 
chiyuki: folds 
Dejacob: folds 
Cripple86: folds 
Uncalled bet ($0.15) returned to 19MJJ21
19MJJ21 collected $0.20 from pot
19MJJ21: doesn't show hand 
*** SUMMARY ***
Total pot $0.20 | Rake $0 
Seat 1: Dejacob (button) folded before Flop (didn't bet)
Seat 2: Cripple86 (small blind) folded before Flop
Seat 3: 19MJJ21 (big blind) collected ($0.20)
Seat 4: kesstukas25 folded before Flop (didn't bet)
Seat 5: roksmokndonk folded before Flop (didn't bet)
Seat 6: Nerkit folded before Flop (didn't bet)
Seat 7: Grumpy as 2 folded before Flop (didn't bet)
Seat 8: mamlind folded before Flop (didn't bet)
Seat 9: chiyuki folded before Flop (didn't bet)



PokerStars Zoom Hand #84301211191:  Hold'em No Limit ($0.10/$0.25) - 2012/08/05 16:19:01 JST [2012/08/05 3:19:01 ET]
Table 'Whirlpool' 9-max Seat #1 is the button
Seat 1: RRMM_again ($24.65 in chips) 
Seat 2: Vall179 ($37.15 in chips) 
Seat 3: kwkim73 ($25.35 in chips) 
Seat 4: chiyuki ($39.13 in chips) 
Seat 5: GovGus ($51.30 in chips) 
Seat 6: mungroo ($23.55 in chips) 
Seat 7: Ih8niknames ($20 in chips) 
Seat 8: Grishukps ($13.18 in chips) 
Seat 9: Patient90122 ($26.52 in chips) 
Vall179: posts small blind $0.10
kwkim73: posts big blind $0.25
*** HOLE CARDS ***
Dealt to chiyuki [4h 7s]
chiyuki: folds 
GovGus: folds 
mungroo: folds 
Ih8niknames: raises $0.50 to $0.75
Grishukps: folds 
Patient90122: folds 
RRMM_again: folds 
Vall179: folds 
kwkim73: folds 
Uncalled bet ($0.50) returned to Ih8niknames
Ih8niknames collected $0.60 from pot
Ih8niknames: doesn't show hand 
Ih8niknames is disconnected 
*** SUMMARY ***
Total pot $0.60 | Rake $0 
Seat 1: RRMM_again (button) folded before Flop (didn't bet)
Seat 2: Vall179 (small blind) folded before Flop
Seat 3: kwkim73 (big blind) folded before Flop
Seat 4: chiyuki folded before Flop (didn't bet)
Seat 5: GovGus folded before Flop (didn't bet)
Seat 6: mungroo folded before Flop (didn't bet)
Seat 7: Ih8niknames collected ($0.60)
Seat 8: Grishukps folded before Flop (didn't bet)
Seat 9: Patient90122 folded before Flop (didn't bet)



PokerStars Zoom Hand #84301209267:  Hold'em No Limit ($0.10/$0.25) - 2012/08/05 16:18:54 JST [2012/08/05 3:18:54 ET]
Table 'Whirlpool' 9-max Seat #1 is the button
Seat 1: chiyuki ($39.13 in chips) 
Seat 2: poorpoor6551 ($11.84 in chips) 
Seat 3: tribunpdm ($76.48 in chips) 
Seat 4: Grumpy as 2 ($8.78 in chips) 
Seat 5: Perstenev ($8.45 in chips) 
Seat 6: Ih8niknames ($20 in chips) 
Seat 7: Nerkit ($15.07 in chips) 
Seat 8: Loholov ($15 in chips) 
Seat 9: men1989 ($23.02 in chips) 
poorpoor6551: posts small blind $0.10
tribunpdm: posts big blind $0.25
*** HOLE CARDS ***
Dealt to chiyuki [4d 3c]
Grumpy as 2: folds 
Perstenev: folds 
Ih8niknames: folds 
Nerkit: folds 
Loholov: raises $0.75 to $1
men1989: folds 
chiyuki: folds 
poorpoor6551: folds 
tribunpdm: calls $0.75
*** FLOP *** [3s 5d 6s]
tribunpdm: checks 
Loholov: bets $1.50
tribunpdm: folds 
Uncalled bet ($1.50) returned to Loholov
Loholov collected $2.01 from pot
Loholov: doesn't show hand 
*** SUMMARY ***
Total pot $2.10 | Rake $0.09 
Board [3s 5d 6s]
Seat 1: chiyuki (button) folded before Flop (didn't bet)
Seat 2: poorpoor6551 (small blind) folded before Flop
Seat 3: tribunpdm (big blind) folded on the Flop
Seat 4: Grumpy as 2 folded before Flop (didn't bet)
Seat 5: Perstenev folded before Flop (didn't bet)
Seat 6: Ih8niknames folded before Flop (didn't bet)
Seat 7: Nerkit folded before Flop (didn't bet)
Seat 8: Loholov collected ($2.01)
Seat 9: men1989 folded before Flop (didn't bet)



PokerStars Zoom Hand #84301212005:  Hold'em No Limit ($0.10/$0.25) - 2012/08/05 16:19:04 JST [2012/08/05 3:19:04 ET]
Table 'Whirlpool' 9-max Seat #1 is the button
Seat 1: Dejacob ($32.63 in chips) 
Seat 2: mungroo ($24.40 in chips) 
Seat 3: Spheroff ($22.50 in chips) 
Seat 4: Nerkit ($15.07 in chips) 
Seat 5: Grumpy as 2 ($8.78 in chips) 
Seat 6: mamlind ($12.95 in chips) 
Seat 7: MurMurRu ($41.49 in chips) 
Seat 8: chiyuki ($39.13 in chips) 
Seat 9: pikhtovnikov ($35.04 in chips) 
mungroo: posts small blind $0.10
Spheroff: posts big blind $0.25
*** HOLE CARDS ***
Dealt to chiyuki [6s 4s]
Nerkit: folds 
Grumpy as 2: folds 
mamlind: folds 
MurMurRu: folds 
chiyuki: folds 
pikhtovnikov: calls $0.25
Dejacob: raises $0.75 to $1
mungroo: folds 
Spheroff: folds 
pikhtovnikov: calls $0.75
*** FLOP *** [Jd Qc 6h]
pikhtovnikov: checks 
Dejacob: checks 
*** TURN *** [Jd Qc 6h] [Jc]
pikhtovnikov: checks 
Dejacob: bets $1.50
pikhtovnikov: folds 
Uncalled bet ($1.50) returned to Dejacob
Dejacob collected $2.24 from pot
Dejacob: doesn't show hand 
*** SUMMARY ***
Total pot $2.35 | Rake $0.11 
Board [Jd Qc 6h Jc]
Seat 1: Dejacob (button) collected ($2.24)
Seat 2: mungroo (small blind) folded before Flop
Seat 3: Spheroff (big blind) folded before Flop
Seat 4: Nerkit folded before Flop (didn't bet)
Seat 5: Grumpy as 2 folded before Flop (didn't bet)
Seat 6: mamlind folded before Flop (didn't bet)
Seat 7: MurMurRu folded before Flop (didn't bet)
Seat 8: chiyuki folded before Flop (didn't bet)
Seat 9: pikhtovnikov folded on the Turn



PokerStars Zoom Hand #84301213395:  Hold'em No Limit ($0.10/$0.25) - 2012/08/05 16:19:09 JST [2012/08/05 3:19:09 ET]
Table 'Whirlpool' 9-max Seat #1 is the button
Seat 1: Cripple86 ($25.70 in chips) 
Seat 2: DrunkTyphoon ($33.21 in chips) 
Seat 3: Serge Claws ($65.94 in chips) 
Seat 4: chiyuki ($39.13 in chips) 
Seat 5: 19MJJ21 ($16.50 in chips) 
Seat 6: kesstukas25 ($36.84 in chips) 
Seat 7: nice.franki ($12.17 in chips) 
Seat 8: 1Karina1 ($29.99 in chips) 
Seat 9: d4dda ($28.03 in chips) 
DrunkTyphoon: posts small blind $0.10
Serge Claws: posts big blind $0.25
*** HOLE CARDS ***
Dealt to chiyuki [4d Js]
chiyuki: folds 
19MJJ21: raises $0.45 to $0.70
kesstukas25: folds 
nice.franki: folds 
1Karina1: folds 
d4dda: folds 
Cripple86: calls $0.70
DrunkTyphoon: folds 
Serge Claws: folds 
*** FLOP *** [Qs Qc 2c]
19MJJ21: bets $1.25
Cripple86: calls $1.25
*** TURN *** [Qs Qc 2c] [Qd]
19MJJ21: bets $3.04
Cripple86: calls $3.04
*** RIVER *** [Qs Qc 2c Qd] [Jh]
19MJJ21: checks 
Cripple86: checks 
*** SHOW DOWN ***
19MJJ21: shows [9c 9d] (a full house, Queens full of Nines)
Cripple86: shows [9s 9h] (a full house, Queens full of Nines)
19MJJ21 collected $4.94 from pot
Cripple86 collected $4.93 from pot
*** SUMMARY ***
Total pot $10.33 | Rake $0.46 
Board [Qs Qc 2c Qd Jh]
Seat 1: Cripple86 (button) showed [9s 9h] and won ($4.93) with a full house, Queens full of Nines
Seat 2: DrunkTyphoon (small blind) folded before Flop
Seat 3: Serge Claws (big blind) folded before Flop
Seat 4: chiyuki folded before Flop (didn't bet)
Seat 5: 19MJJ21 showed [9c 9d] and won ($4.94) with a full house, Queens full of Nines
Seat 6: kesstukas25 folded before Flop (didn't bet)
Seat 7: nice.franki folded before Flop (didn't bet)
Seat 8: 1Karina1 folded before Flop (didn't bet)
Seat 9: d4dda folded before Flop (didn't bet)



PokerStars Zoom Hand #84301214215:  Hold'em No Limit ($0.10/$0.25) - 2012/08/05 16:19:12 JST [2012/08/05 3:19:12 ET]
Table 'Whirlpool' 9-max Seat #1 is the button
Seat 1: Bondvsta ($26.40 in chips) 
Seat 2: AAT Shark ($12.50 in chips) 
Seat 3: chiyuki ($39.13 in chips) 
Seat 4: Perstenev ($8.88 in chips) 
Seat 5: Lasutchik ($32.64 in chips) 
Seat 6: nice.franki ($11.80 in chips) 
Seat 7: GovGus ($51.30 in chips) 
Seat 8: mungroo ($12.90 in chips) 
Seat 9: Vall179 ($29.24 in chips) 
AAT Shark: posts small blind $0.10
chiyuki: posts big blind $0.25
*** HOLE CARDS ***
Dealt to chiyuki [7d 5s]
Perstenev: folds 
Lasutchik: folds 
nice.franki: folds 
GovGus: folds 
mungroo: raises $0.25 to $0.50
Vall179: folds 
Bondvsta: folds 
AAT Shark: folds 
chiyuki: calls $0.25
*** FLOP *** [2s 6h Jc]
chiyuki: checks 
mungroo: checks 
*** TURN *** [2s 6h Jc] [Jd]
chiyuki: checks 
mungroo: checks 
*** RIVER *** [2s 6h Jc Jd] [7c]
chiyuki: bets $0.75
mungroo: folds 
Uncalled bet ($0.75) returned to chiyuki
chiyuki collected $1.05 from pot
chiyuki: doesn't show hand 
*** SUMMARY ***
Total pot $1.10 | Rake $0.05 
Board [2s 6h Jc Jd 7c]
Seat 1: Bondvsta (button) folded before Flop (didn't bet)
Seat 2: AAT Shark (small blind) folded before Flop
Seat 3: chiyuki (big blind) collected ($1.05)
Seat 4: Perstenev folded before Flop (didn't bet)
Seat 5: Lasutchik folded before Flop (didn't bet)
Seat 6: nice.franki folded before Flop (didn't bet)
Seat 7: GovGus folded before Flop (didn't bet)
Seat 8: mungroo folded on the River
Seat 9: Vall179 folded before Flop (didn't bet)



PokerStars Zoom Hand #84301230024:  Hold'em No Limit ($0.10/$0.25) - 2012/08/05 16:20:10 JST [2012/08/05 3:20:10 ET]
Table 'Whirlpool' 9-max Seat #1 is the button
Seat 1: mamlind ($12.70 in chips) 
Seat 2: xxx Spb xxx ($29.37 in chips) 
Seat 3: RRMM_again ($21.64 in chips) 
Seat 4: Vall179 ($30.94 in chips) 
Seat 5: d4dda ($28.03 in chips) 
Seat 6: deepakmbh ($26.16 in chips) 
Seat 7: chiyuki ($39.58 in chips) 
Seat 8: GovGus ($41.46 in chips) 
Seat 9: Fructionar ($32.75 in chips) 
xxx Spb xxx: posts small blind $0.10
RRMM_again: posts big blind $0.25
*** HOLE CARDS ***
Dealt to chiyuki [Js Qs]
Vall179: raises $0.62 to $0.87
d4dda: folds 
deepakmbh: folds 
chiyuki: folds 
GovGus: folds 
Fructionar: folds 
mamlind: folds 
xxx Spb xxx: folds 
RRMM_again: folds 
Uncalled bet ($0.62) returned to Vall179
Vall179 collected $0.60 from pot
Vall179: doesn't show hand 
*** SUMMARY ***
Total pot $0.60 | Rake $0 
Seat 1: mamlind (button) folded before Flop (didn't bet)
Seat 2: xxx Spb xxx (small blind) folded before Flop
Seat 3: RRMM_again (big blind) folded before Flop
Seat 4: Vall179 collected ($0.60)
Seat 5: d4dda folded before Flop (didn't bet)
Seat 6: deepakmbh folded before Flop (didn't bet)
Seat 7: chiyuki folded before Flop (didn't bet)
Seat 8: GovGus folded before Flop (didn't bet)
Seat 9: Fructionar folded before Flop (didn't bet)



PokerStars Zoom Hand #84301228661:  Hold'em No Limit ($0.10/$0.25) - 2012/08/05 16:20:05 JST [2012/08/05 3:20:05 ET]
Table 'Whirlpool' 9-max Seat #1 is the button
Seat 1: a_tasmanian ($21.76 in chips) 
Seat 2: TorTrade ($32.03 in chips) 
Seat 3: AntoineHunt ($13.52 in chips) 
Seat 4: Bondvsta ($25.55 in chips) 
Seat 5: RRMM_again ($21.64 in chips) 
Seat 6: chiyuki ($39.58 in chips) 
Seat 7: Loholov ($15 in chips) 
Seat 8: top gun 2950 ($30.73 in chips) 
Seat 9: silvno31 ($66.29 in chips) 
TorTrade: posts small blind $0.10
AntoineHunt: posts big blind $0.25
*** HOLE CARDS ***
Dealt to chiyuki [9h 6d]
Bondvsta: folds 
RRMM_again: folds 
chiyuki: folds 
Loholov: folds 
top gun 2950: folds 
silvno31: raises $0.50 to $0.75
a_tasmanian: folds 
TorTrade: folds 
AntoineHunt: calls $0.50
*** FLOP *** [Js 9c Ks]
AntoineHunt: checks 
silvno31: checks 
*** TURN *** [Js 9c Ks] [3h]
AntoineHunt: bets $0.25
silvno31: raises $0.50 to $0.75
AntoineHunt: folds 
Uncalled bet ($0.50) returned to silvno31
silvno31 collected $2.01 from pot
silvno31: doesn't show hand 
*** SUMMARY ***
Total pot $2.10 | Rake $0.09 
Board [Js 9c Ks 3h]
Seat 1: a_tasmanian (button) folded before Flop (didn't bet)
Seat 2: TorTrade (small blind) folded before Flop
Seat 3: AntoineHunt (big blind) folded on the Turn
Seat 4: Bondvsta folded before Flop (didn't bet)
Seat 5: RRMM_again folded before Flop (didn't bet)
Seat 6: chiyuki folded before Flop (didn't bet)
Seat 7: Loholov folded before Flop (didn't bet)
Seat 8: top gun 2950 folded before Flop (didn't bet)
Seat 9: silvno31 collected ($2.01)



PokerStars Zoom Hand #84301227567:  Hold'em No Limit ($0.10/$0.25) - 2012/08/05 16:20:01 JST [2012/08/05 3:20:01 ET]
Table 'Whirlpool' 9-max Seat #1 is the button
Seat 1: MurMurRu ($29.84 in chips) 
Seat 2: chiyuki ($39.68 in chips) 
Seat 3: DrunkTyphoon ($33.11 in chips) 
Seat 4: Grishukps ($12.85 in chips) 
Seat 5: Ellen1947 ($21.07 in chips) 
Seat 6: olligol123 ($25 in chips) 
Seat 7: Alvinpe85 ($31.89 in chips) 
Seat 8: KeLevro0 ($12.15 in chips) 
Seat 9: Mytea88 ($8.19 in chips) 
chiyuki: posts small blind $0.10
DrunkTyphoon: posts big blind $0.25
*** HOLE CARDS ***
Dealt to chiyuki [3h Kd]
Grishukps: folds 
Ellen1947: raises $0.45 to $0.70
olligol123: folds 
Alvinpe85: folds 
KeLevro0: folds 
Mytea88: folds 
MurMurRu: calls $0.70
chiyuki: folds 
DrunkTyphoon: folds 
*** FLOP *** [5c Qc Td]
Ellen1947: bets $0.83
MurMurRu: calls $0.83
*** TURN *** [5c Qc Td] [8h]
Ellen1947: checks 
MurMurRu: bets $2.25
Ellen1947: folds 
Uncalled bet ($2.25) returned to MurMurRu
MurMurRu collected $3.26 from pot
MurMurRu: doesn't show hand 
*** SUMMARY ***
Total pot $3.41 | Rake $0.15 
Board [5c Qc Td 8h]
Seat 1: MurMurRu (button) collected ($3.26)
Seat 2: chiyuki (small blind) folded before Flop
Seat 3: DrunkTyphoon (big blind) folded before Flop
Seat 4: Grishukps folded before Flop (didn't bet)
Seat 5: Ellen1947 folded on the Turn
Seat 6: olligol123 folded before Flop (didn't bet)
Seat 7: Alvinpe85 folded before Flop (didn't bet)
Seat 8: KeLevro0 folded before Flop (didn't bet)
Seat 9: Mytea88 folded before Flop (didn't bet)



PokerStars Zoom Hand #84301232203:  Hold'em No Limit ($0.10/$0.25) - 2012/08/05 16:20:18 JST [2012/08/05 3:20:18 ET]
Table 'Whirlpool' 9-max Seat #1 is the button
Seat 1: Mytea88 ($8.19 in chips) 
Seat 2: Angi858 ($24.18 in chips) 
Seat 3: Bondvsta ($25.55 in chips) 
Seat 4: xxx Spb xxx ($34.11 in chips) 
Seat 5: chiyuki ($39.58 in chips) 
Seat 6: Lindikor ($13 in chips) 
Seat 7: GSDP ($24.28 in chips) 
Seat 8: drunk_bender ($28.51 in chips) 
Seat 9: new85new85 ($24.40 in chips) 
Angi858: posts small blind $0.10
Bondvsta: posts big blind $0.25
*** HOLE CARDS ***
Dealt to chiyuki [7h Kc]
xxx Spb xxx: folds 
chiyuki: folds 
Lindikor: raises $0.50 to $0.75
GSDP: folds 
drunk_bender: folds 
new85new85: calls $0.75
Mytea88: folds 
Angi858: folds 
Bondvsta: folds 
*** FLOP *** [7c 8c Ks]
Lindikor: checks 
new85new85: checks 
*** TURN *** [7c 8c Ks] [Jd]
Lindikor: bets $1.50
new85new85: folds 
Uncalled bet ($1.50) returned to Lindikor
Lindikor collected $1.77 from pot
Lindikor: doesn't show hand 
*** SUMMARY ***
Total pot $1.85 | Rake $0.08 
Board [7c 8c Ks Jd]
Seat 1: Mytea88 (button) folded before Flop (didn't bet)
Seat 2: Angi858 (small blind) folded before Flop
Seat 3: Bondvsta (big blind) folded before Flop
Seat 4: xxx Spb xxx folded before Flop (didn't bet)
Seat 5: chiyuki folded before Flop (didn't bet)
Seat 6: Lindikor collected ($1.77)
Seat 7: GSDP folded before Flop (didn't bet)
Seat 8: drunk_bender folded before Flop (didn't bet)
Seat 9: new85new85 folded on the Turn



PokerStars Zoom Hand #84301233049:  Hold'em No Limit ($0.10/$0.25) - 2012/08/05 16:20:21 JST [2012/08/05 3:20:21 ET]
Table 'Whirlpool' 9-max Seat #1 is the button
Seat 1: chiyuki ($39.58 in chips) 
Seat 2: Nerkit ($12.25 in chips) 
Seat 3: xxx Spb xxx ($34.11 in chips) 
Seat 4: Cripple86 ($25.36 in chips) 
Seat 5: scaredsare ($28 in chips) 
Seat 6: risekuku468 ($30.21 in chips) 
Seat 7: Grishukps ($12.50 in chips) 
Seat 8: top gun 2950 ($30.73 in chips) 
Seat 9: R033084 ($24.75 in chips) 
Nerkit: posts small blind $0.10
xxx Spb xxx: posts big blind $0.25
*** HOLE CARDS ***
Dealt to chiyuki [Qh Ac]
Cripple86: folds 
scaredsare: calls $0.25
risekuku468: folds 
Grishukps: folds 
top gun 2950: calls $0.25
R033084: folds 
chiyuki: raises $1 to $1.25
Nerkit: folds 
xxx Spb xxx: folds 
scaredsare: calls $1
top gun 2950: calls $1
*** FLOP *** [4c 9d Th]
scaredsare: bets $0.50
top gun 2950: calls $0.50
chiyuki: raises $1.50 to $2
scaredsare: calls $1.50
top gun 2950: folds 
*** TURN *** [4c 9d Th] [8h]
scaredsare: checks 
chiyuki: checks 
*** RIVER *** [4c 9d Th 8h] [3d]
scaredsare: checks 
chiyuki: checks 
*** SHOW DOWN ***
scaredsare: shows [Jh Jc] (a pair of Jacks)
chiyuki: mucks hand 
scaredsare collected $8.21 from pot
*** SUMMARY ***
Total pot $8.60 | Rake $0.39 
Board [4c 9d Th 8h 3d]
Seat 1: chiyuki (button) mucked [Qh Ac]
Seat 2: Nerkit (small blind) folded before Flop
Seat 3: xxx Spb xxx (big blind) folded before Flop
Seat 4: Cripple86 folded before Flop (didn't bet)
Seat 5: scaredsare showed [Jh Jc] and won ($8.21) with a pair of Jacks
Seat 6: risekuku468 folded before Flop (didn't bet)
Seat 7: Grishukps folded before Flop (didn't bet)
Seat 8: top gun 2950 folded on the Flop
Seat 9: R033084 folded before Flop (didn't bet)



PokerStars Zoom Hand #84301252738:  Hold'em No Limit ($0.10/$0.25) - 2012/08/05 16:21:33 JST [2012/08/05 3:21:33 ET]
Table 'Whirlpool' 9-max Seat #1 is the button
Seat 1: Serge Claws ($64.02 in chips) 
Seat 2: Alvinpe85 ($93.53 in chips) 
Seat 3: top gun 2950 ($28.98 in chips) 
Seat 4: Blue-GumBum ($8.99 in chips) 
Seat 5: 1Karina1 ($29.64 in chips) 
Seat 6: Grishukps ($17.71 in chips) 
Seat 7: soul_5577 ($41.06 in chips) 
Seat 8: chiyuki ($36.33 in chips) 
Seat 9: Gans1206 ($19.85 in chips) 
Alvinpe85: posts small blind $0.10
top gun 2950: posts big blind $0.25
*** HOLE CARDS ***
Dealt to chiyuki [4c 5d]
Blue-GumBum: folds 
1Karina1: folds 
Grishukps: raises $0.50 to $0.75
soul_5577: folds 
chiyuki: folds 
Gans1206: folds 
Serge Claws: folds 
Alvinpe85: folds 
top gun 2950: folds 
Uncalled bet ($0.50) returned to Grishukps
Grishukps collected $0.60 from pot
Grishukps: doesn't show hand 
*** SUMMARY ***
Total pot $0.60 | Rake $0 
Seat 1: Serge Claws (button) folded before Flop (didn't bet)
Seat 2: Alvinpe85 (small blind) folded before Flop
Seat 3: top gun 2950 (big blind) folded before Flop
Seat 4: Blue-GumBum folded before Flop (didn't bet)
Seat 5: 1Karina1 folded before Flop (didn't bet)
Seat 6: Grishukps collected ($0.60)
Seat 7: soul_5577 folded before Flop (didn't bet)
Seat 8: chiyuki folded before Flop (didn't bet)
Seat 9: Gans1206 folded before Flop (didn't bet)



PokerStars Zoom Hand #84301254714:  Hold'em No Limit ($0.10/$0.25) - 2012/08/05 16:21:40 JST [2012/08/05 3:21:40 ET]
Table 'Whirlpool' 9-max Seat #1 is the button
Seat 1: Nerkit ($12.15 in chips) 
Seat 2: kwkim73 ($45.47 in chips) 
Seat 3: snejokCoxx ($12.50 in chips) 
Seat 4: chiyuki ($36.33 in chips) 
Seat 5: CrittHunter ($28.34 in chips) 
Seat 6: Loholov ($15 in chips) 
Seat 7: FoRlan77 ($28.65 in chips) 
Seat 8: DrunkTyphoon ($51.21 in chips) 
Seat 9: nice.franki ($3.51 in chips) 
kwkim73: posts small blind $0.10
snejokCoxx: posts big blind $0.25
*** HOLE CARDS ***
Dealt to chiyuki [9c Jd]
chiyuki: folds 
CrittHunter: folds 
Loholov: folds 
FoRlan77: folds 
DrunkTyphoon: raises $0.50 to $0.75
nice.franki: folds 
Nerkit: folds 
kwkim73: folds 
snejokCoxx: folds 
Uncalled bet ($0.50) returned to DrunkTyphoon
DrunkTyphoon collected $0.60 from pot
DrunkTyphoon: doesn't show hand 
*** SUMMARY ***
Total pot $0.60 | Rake $0 
Seat 1: Nerkit (button) folded before Flop (didn't bet)
Seat 2: kwkim73 (small blind) folded before Flop
Seat 3: snejokCoxx (big blind) folded before Flop
Seat 4: chiyuki folded before Flop (didn't bet)
Seat 5: CrittHunter folded before Flop (didn't bet)
Seat 6: Loholov folded before Flop (didn't bet)
Seat 7: FoRlan77 folded before Flop (didn't bet)
Seat 8: DrunkTyphoon collected ($0.60)
Seat 9: nice.franki folded before Flop (didn't bet)



PokerStars Zoom Hand #84301255820:  Hold'em No Limit ($0.10/$0.25) - 2012/08/05 16:21:44 JST [2012/08/05 3:21:44 ET]
Table 'Whirlpool' 9-max Seat #1 is the button
Seat 1: Lindikor ($14.02 in chips) 
Seat 2: phate-1up ($50.57 in chips) 
Seat 3: Grumpy as 2 ($8.33 in chips) 
Seat 4: Patient90122 ($30.72 in chips) 
Seat 5: nice.franki ($15.14 in chips) 
Seat 6: chiyuki ($36.33 in chips) 
Seat 7: Bondvsta ($25 in chips) 
Seat 8: drunk_bender ($26.26 in chips) 
Seat 9: masterkoolb ($17.17 in chips) 
phate-1up: posts small blind $0.10
Grumpy as 2: posts big blind $0.25
*** HOLE CARDS ***
Dealt to chiyuki [6h 6c]
Patient90122: folds 
nice.franki: folds 
chiyuki: raises $0.50 to $0.75
Bondvsta: calls $0.75
drunk_bender: folds 
masterkoolb: folds 
Lindikor: folds 
phate-1up: folds 
Grumpy as 2: folds 
*** FLOP *** [Qs 8s 4c]
chiyuki: bets $1
Bondvsta: folds 
Uncalled bet ($1) returned to chiyuki
chiyuki collected $1.77 from pot
chiyuki: doesn't show hand 
*** SUMMARY ***
Total pot $1.85 | Rake $0.08 
Board [Qs 8s 4c]
Seat 1: Lindikor (button) folded before Flop (didn't bet)
Seat 2: phate-1up (small blind) folded before Flop
Seat 3: Grumpy as 2 (big blind) folded before Flop
Seat 4: Patient90122 folded before Flop (didn't bet)
Seat 5: nice.franki folded before Flop (didn't bet)
Seat 6: chiyuki collected ($1.77)
Seat 7: Bondvsta folded on the Flop
Seat 8: drunk_bender folded before Flop (didn't bet)
Seat 9: masterkoolb folded before Flop (didn't bet)



PokerStars Zoom Hand #84301265275:  Hold'em No Limit ($0.10/$0.25) - 2012/08/05 16:22:15 JST [2012/08/05 3:22:15 ET]
Table 'Whirlpool' 9-max Seat #1 is the button
Seat 1: Ellen1947 ($19.24 in chips) 
Seat 2: KeLevro0 ($9.50 in chips) 
Seat 3: werkl ($25 in chips) 
Seat 4: chiyuki ($37.35 in chips) 
Seat 5: Limoilou ($32.01 in chips) 
Seat 6: INSP!RON ($30.71 in chips) 
Seat 7: DanielWhyte ($32.72 in chips) 
Seat 8: Spheroff ($20.45 in chips) 
Seat 9: 19MJJ21 ($11.37 in chips) 
KeLevro0: posts small blind $0.10
werkl: posts big blind $0.25
*** HOLE CARDS ***
Dealt to chiyuki [9d 8c]
chiyuki: folds 
Limoilou: folds 
INSP!RON: folds 
DanielWhyte: folds 
Spheroff: folds 
19MJJ21: folds 
Ellen1947: folds 
KeLevro0: folds 
Uncalled bet ($0.15) returned to werkl
werkl collected $0.20 from pot
werkl: doesn't show hand 
*** SUMMARY ***
Total pot $0.20 | Rake $0 
Seat 1: Ellen1947 (button) folded before Flop (didn't bet)
Seat 2: KeLevro0 (small blind) folded before Flop
Seat 3: werkl (big blind) collected ($0.20)
Seat 4: chiyuki folded before Flop (didn't bet)
Seat 5: Limoilou folded before Flop (didn't bet)
Seat 6: INSP!RON folded before Flop (didn't bet)
Seat 7: DanielWhyte folded before Flop (didn't bet)
Seat 8: Spheroff folded before Flop (didn't bet)
Seat 9: 19MJJ21 folded before Flop (didn't bet)



PokerStars Zoom Hand #84301251593:  Hold'em No Limit ($0.10/$0.25) - 2012/08/05 16:21:29 JST [2012/08/05 3:21:29 ET]
Table 'Whirlpool' 9-max Seat #1 is the button
Seat 1: Gans1206 ($19.85 in chips) 
Seat 2: Vall179 ($34.90 in chips) 
Seat 3: MurMurRu ($31.57 in chips) 
Seat 4: top gun 2950 ($28.98 in chips) 
Seat 5: xxx Spb xxx ($29.82 in chips) 
Seat 6: seula i ($55.49 in chips) 
Seat 7: Loholov ($15 in chips) 
Seat 8: scaredsare ($32.96 in chips) 
Seat 9: chiyuki ($36.33 in chips) 
Vall179: posts small blind $0.10
MurMurRu: posts big blind $0.25
*** HOLE CARDS ***
Dealt to chiyuki [Th 7c]
top gun 2950: folds 
xxx Spb xxx: folds 
seula i: folds 
Loholov: folds 
scaredsare: calls $0.25
chiyuki: folds 
Gans1206: folds 
Vall179: raises $1 to $1.25
MurMurRu: folds 
scaredsare: calls $1
*** FLOP *** [Jh Qc 2s]
Vall179: bets $1.60
scaredsare: calls $1.60
*** TURN *** [Jh Qc 2s] [8h]
Vall179: bets $3.46
scaredsare: calls $3.46
*** RIVER *** [Jh Qc 2s 8h] [Js]
Vall179: checks 
scaredsare: checks 
*** SHOW DOWN ***
Vall179: shows [Qs Ah] (two pair, Queens and Jacks)
scaredsare: shows [Qd Ad] (two pair, Queens and Jacks)
Vall179 collected $6.15 from pot
scaredsare collected $6.14 from pot
*** SUMMARY ***
Total pot $12.87 | Rake $0.58 
Board [Jh Qc 2s 8h Js]
Seat 1: Gans1206 (button) folded before Flop (didn't bet)
Seat 2: Vall179 (small blind) showed [Qs Ah] and won ($6.15) with two pair, Queens and Jacks
Seat 3: MurMurRu (big blind) folded before Flop
Seat 4: top gun 2950 folded before Flop (didn't bet)
Seat 5: xxx Spb xxx folded before Flop (didn't bet)
Seat 6: seula i folded before Flop (didn't bet)
Seat 7: Loholov folded before Flop (didn't bet)
Seat 8: scaredsare showed [Qd Ad] and won ($6.14) with two pair, Queens and Jacks
Seat 9: chiyuki folded before Flop (didn't bet)



