PokerStars Zoom Hand #84298202058:  Hold'em No Limit ($0.10/$0.25) - 2012/08/05 13:00:17 JST [2012/08/05 0:00:17 ET]
Table 'Whirlpool' 9-max Seat #1 is the button
Seat 1: Lasutchik ($12 in chips) 
Seat 2: Catrban ($24.62 in chips) 
Seat 3: TErr18 ($21.09 in chips) 
Seat 4: jamielniak ($25.35 in chips) 
Seat 5: Medic8681 ($18.16 in chips) 
Seat 6: AndiM64 ($28.65 in chips) 
Seat 7: TraderYao ($29.15 in chips) 
Seat 8: gunbowler ($96.34 in chips) 
Seat 9: chiyuki ($23.81 in chips) 
Catrban: posts small blind $0.10
TErr18: posts big blind $0.25
*** HOLE CARDS ***
Dealt to chiyuki [3c Ks]
jamielniak: raises $0.50 to $0.75
Medic8681: folds 
AndiM64: folds 
TraderYao: folds 
gunbowler: folds 
chiyuki: folds 
Lasutchik: folds 
Catrban: calls $0.65
TErr18: folds 
*** FLOP *** [8c Qc 5d]
Catrban: checks 
jamielniak: bets $0.98
Catrban: folds 
Uncalled bet ($0.98) returned to jamielniak
jamielniak collected $1.67 from pot
jamielniak: doesn't show hand 
*** SUMMARY ***
Total pot $1.75 | Rake $0.08 
Board [8c Qc 5d]
Seat 1: Lasutchik (button) folded before Flop (didn't bet)
Seat 2: Catrban (small blind) folded on the Flop
Seat 3: TErr18 (big blind) folded before Flop
Seat 4: jamielniak collected ($1.67)
Seat 5: Medic8681 folded before Flop (didn't bet)
Seat 6: AndiM64 folded before Flop (didn't bet)
Seat 7: TraderYao folded before Flop (didn't bet)
Seat 8: gunbowler folded before Flop (didn't bet)
Seat 9: chiyuki folded before Flop (didn't bet)



PokerStars Zoom Hand #84298203952:  Hold'em No Limit ($0.10/$0.25) - 2012/08/05 13:00:25 JST [2012/08/05 0:00:25 ET]
Table 'Whirlpool' 9-max Seat #1 is the button
Seat 1: KINGKILERACE ($40.01 in chips) 
Seat 2: chiyuki ($23.81 in chips) 
Seat 3: KeLevro0 ($12.15 in chips) 
Seat 4: Lasutchik ($12 in chips) 
Seat 5: TErr18 ($20.84 in chips) 
Seat 6: seula i ($83.72 in chips) 
Seat 7: lolos21 ($19.43 in chips) 
Seat 8: wtu1986 ($24.65 in chips) 
Seat 9: BlOnDhOlIc ($33.10 in chips) 
chiyuki: posts small blind $0.10
KeLevro0: posts big blind $0.25
*** HOLE CARDS ***
Dealt to chiyuki [Tc Jh]
Lasutchik: folds 
TErr18: folds 
seula i: folds 
lolos21: folds 
wtu1986: raises $0.50 to $0.75
BlOnDhOlIc: folds 
KINGKILERACE: folds 
chiyuki: folds 
KeLevro0: folds 
Uncalled bet ($0.50) returned to wtu1986
wtu1986 collected $0.60 from pot
wtu1986: doesn't show hand 
*** SUMMARY ***
Total pot $0.60 | Rake $0 
Seat 1: KINGKILERACE (button) folded before Flop (didn't bet)
Seat 2: chiyuki (small blind) folded before Flop
Seat 3: KeLevro0 (big blind) folded before Flop
Seat 4: Lasutchik folded before Flop (didn't bet)
Seat 5: TErr18 folded before Flop (didn't bet)
Seat 6: seula i folded before Flop (didn't bet)
Seat 7: lolos21 folded before Flop (didn't bet)
Seat 8: wtu1986 collected ($0.60)
Seat 9: BlOnDhOlIc folded before Flop (didn't bet)



PokerStars Zoom Hand #84298210644:  Hold'em No Limit ($0.10/$0.25) - 2012/08/05 13:00:53 JST [2012/08/05 0:00:53 ET]
Table 'Whirlpool' 9-max Seat #1 is the button
Seat 1: KeLevro0 ($11.90 in chips) 
Seat 2: Medic8681 ($19.10 in chips) 
Seat 3: Th3Fog ($61.11 in chips) 
Seat 4: polk11 ($22.63 in chips) 
Seat 5: AndiM64 ($30.68 in chips) 
Seat 6: wtu1986 ($24.90 in chips) 
Seat 7: chiyuki ($23.71 in chips) 
Seat 8: MATT361 ($11.37 in chips) 
Seat 9: Lasutchik ($27.20 in chips) 
Medic8681: posts small blind $0.10
Th3Fog: posts big blind $0.25
*** HOLE CARDS ***
Dealt to chiyuki [4h 2c]
polk11: folds 
AndiM64: folds 
wtu1986: folds 
chiyuki: folds 
MATT361: folds 
Lasutchik: folds 
KeLevro0: folds 
Medic8681: raises $0.50 to $0.75
Th3Fog: folds 
Uncalled bet ($0.50) returned to Medic8681
Medic8681 collected $0.50 from pot
Medic8681: doesn't show hand 
*** SUMMARY ***
Total pot $0.50 | Rake $0 
Seat 1: KeLevro0 (button) folded before Flop (didn't bet)
Seat 2: Medic8681 (small blind) collected ($0.50)
Seat 3: Th3Fog (big blind) folded before Flop
Seat 4: polk11 folded before Flop (didn't bet)
Seat 5: AndiM64 folded before Flop (didn't bet)
Seat 6: wtu1986 folded before Flop (didn't bet)
Seat 7: chiyuki folded before Flop (didn't bet)
Seat 8: MATT361 folded before Flop (didn't bet)
Seat 9: Lasutchik folded before Flop (didn't bet)



PokerStars Zoom Hand #84298199102:  Hold'em No Limit ($0.10/$0.25) - 2012/08/05 13:00:04 JST [2012/08/05 0:00:04 ET]
Table 'Whirlpool' 9-max Seat #1 is the button
Seat 1: chiyuki ($23.81 in chips) 
Seat 2: gunbowler ($96.44 in chips) 
Seat 3: Anafim ($18.65 in chips) 
Seat 4: petersmiths ($25.70 in chips) 
Seat 5: TraderYao ($27.55 in chips) 
Seat 6: Th3Fog ($52.45 in chips) 
Seat 7: pyty_82 ($46.60 in chips) 
Seat 8: nice.franki ($4.82 in chips) 
Seat 9: AndiM64 ($77.13 in chips) 
gunbowler: posts small blind $0.10
Anafim: posts big blind $0.25
*** HOLE CARDS ***
Dealt to chiyuki [7d Ah]
petersmiths: raises $0.50 to $0.75
TraderYao: folds 
Th3Fog: calls $0.75
pyty_82: folds 
nice.franki: folds 
AndiM64: folds 
chiyuki: folds 
gunbowler: folds 
Anafim: calls $0.50
*** FLOP *** [Qs Qd Td]
Anafim: checks 
petersmiths: bets $1.56
Th3Fog: folds 
Anafim has timed out
Anafim: folds 
Uncalled bet ($1.56) returned to petersmiths
petersmiths collected $2.24 from pot
petersmiths: doesn't show hand 
*** SUMMARY ***
Total pot $2.35 | Rake $0.11 
Board [Qs Qd Td]
Seat 1: chiyuki (button) folded before Flop (didn't bet)
Seat 2: gunbowler (small blind) folded before Flop
Seat 3: Anafim (big blind) folded on the Flop
Seat 4: petersmiths collected ($2.24)
Seat 5: TraderYao folded before Flop (didn't bet)
Seat 6: Th3Fog folded on the Flop
Seat 7: pyty_82 folded before Flop (didn't bet)
Seat 8: nice.franki folded before Flop (didn't bet)
Seat 9: AndiM64 folded before Flop (didn't bet)



PokerStars Zoom Hand #84298214674:  Hold'em No Limit ($0.10/$0.25) - 2012/08/05 13:01:09 JST [2012/08/05 0:01:09 ET]
Table 'Whirlpool' 9-max Seat #1 is the button
Seat 1: 2997qwer ($12.15 in chips) 
Seat 2: vfo.pt ($12.25 in chips) 
Seat 3: Chevydale ($21.40 in chips) 
Seat 4: KrystalAA ($21.96 in chips) 
Seat 5: chiyuki ($23.71 in chips) 
Seat 6: nice.franki ($7.36 in chips) 
Seat 7: eagie20 ($139.99 in chips) 
Seat 8: Th3Fog ($60.86 in chips) 
Seat 9: ll_LaMeR_ll ($16.43 in chips) 
vfo.pt: posts small blind $0.10
Chevydale: posts big blind $0.25
*** HOLE CARDS ***
Dealt to chiyuki [3d Jd]
KrystalAA: folds 
chiyuki: folds 
nice.franki: folds 
eagie20: folds 
Th3Fog: raises $0.25 to $0.50
ll_LaMeR_ll: folds 
2997qwer: folds 
vfo.pt: folds 
Chevydale: folds 
Uncalled bet ($0.25) returned to Th3Fog
Th3Fog collected $0.60 from pot
Th3Fog: doesn't show hand 
*** SUMMARY ***
Total pot $0.60 | Rake $0 
Seat 1: 2997qwer (button) folded before Flop (didn't bet)
Seat 2: vfo.pt (small blind) folded before Flop
Seat 3: Chevydale (big blind) folded before Flop
Seat 4: KrystalAA folded before Flop (didn't bet)
Seat 5: chiyuki folded before Flop (didn't bet)
Seat 6: nice.franki folded before Flop (didn't bet)
Seat 7: eagie20 folded before Flop (didn't bet)
Seat 8: Th3Fog collected ($0.60)
Seat 9: ll_LaMeR_ll folded before Flop (didn't bet)



PokerStars Zoom Hand #84298215730:  Hold'em No Limit ($0.10/$0.25) - 2012/08/05 13:01:14 JST [2012/08/05 0:01:14 ET]
Table 'Whirlpool' 9-max Seat #1 is the button
Seat 1: chiyuki ($23.71 in chips) 
Seat 2: BlOnDhOlIc ($33.10 in chips) 
Seat 3: Lasutchik ($12 in chips) 
Seat 4: Medic8681 ($19.35 in chips) 
Seat 5: nice.franki ($7.36 in chips) 
Seat 6: taksist889 ($18 in chips) 
Seat 7: silvno31 ($30.13 in chips) 
Seat 8: DooMSDaY1337 ($37.94 in chips) 
Seat 9: a_tasmanian ($60.86 in chips) 
BlOnDhOlIc: posts small blind $0.10
Lasutchik: posts big blind $0.25
*** HOLE CARDS ***
Dealt to chiyuki [Th 6h]
Medic8681: folds 
nice.franki: folds 
taksist889: raises $0.50 to $0.75
silvno31: folds 
DooMSDaY1337: folds 
a_tasmanian: folds 
chiyuki: folds 
BlOnDhOlIc: folds 
Lasutchik: folds 
Uncalled bet ($0.50) returned to taksist889
taksist889 collected $0.60 from pot
taksist889: doesn't show hand 
*** SUMMARY ***
Total pot $0.60 | Rake $0 
Seat 1: chiyuki (button) folded before Flop (didn't bet)
Seat 2: BlOnDhOlIc (small blind) folded before Flop
Seat 3: Lasutchik (big blind) folded before Flop
Seat 4: Medic8681 folded before Flop (didn't bet)
Seat 5: nice.franki folded before Flop (didn't bet)
Seat 6: taksist889 collected ($0.60)
Seat 7: silvno31 folded before Flop (didn't bet)
Seat 8: DooMSDaY1337 folded before Flop (didn't bet)
Seat 9: a_tasmanian folded before Flop (didn't bet)



PokerStars Zoom Hand #84298213196:  Hold'em No Limit ($0.10/$0.25) - 2012/08/05 13:01:03 JST [2012/08/05 0:01:03 ET]
Table 'Whirlpool' 9-max Seat #1 is the button
Seat 1: leo2095 ($15.27 in chips) 
Seat 2: TErr18 ($20.84 in chips) 
Seat 3: doanut13 ($26.57 in chips) 
Seat 4: RomarioJa ($8.30 in chips) 
Seat 5: polk11 ($22.63 in chips) 
Seat 6: chiyuki ($23.71 in chips) 
Seat 7: Assassin365 ($30.23 in chips) 
Seat 8: jtedecaliss ($175.79 in chips) 
Seat 9: fwani ($28.28 in chips) 
TErr18: posts small blind $0.10
doanut13: posts big blind $0.25
*** HOLE CARDS ***
Dealt to chiyuki [9h Ac]
RomarioJa: folds 
polk11: raises $0.25 to $0.50
chiyuki: folds 
Assassin365: folds 
jtedecaliss: folds 
fwani: folds 
leo2095: folds 
TErr18: folds 
doanut13: calls $0.25
*** FLOP *** [4h Kd 8h]
doanut13: bets $0.75
polk11: raises $1 to $1.75
doanut13: calls $1
*** TURN *** [4h Kd 8h] [2d]
doanut13: checks 
polk11: checks 
*** RIVER *** [4h Kd 8h 2d] [Jc]
doanut13: checks 
polk11: checks 
*** SHOW DOWN ***
doanut13: shows [6s 8s] (a pair of Eights)
polk11: mucks hand 
doanut13 collected $4.39 from pot
*** SUMMARY ***
Total pot $4.60 | Rake $0.21 
Board [4h Kd 8h 2d Jc]
Seat 1: leo2095 (button) folded before Flop (didn't bet)
Seat 2: TErr18 (small blind) folded before Flop
Seat 3: doanut13 (big blind) showed [6s 8s] and won ($4.39) with a pair of Eights
Seat 4: RomarioJa folded before Flop (didn't bet)
Seat 5: polk11 mucked [As Qs]
Seat 6: chiyuki folded before Flop (didn't bet)
Seat 7: Assassin365 folded before Flop (didn't bet)
Seat 8: jtedecaliss folded before Flop (didn't bet)
Seat 9: fwani folded before Flop (didn't bet)



PokerStars Zoom Hand #84298209663:  Hold'em No Limit ($0.10/$0.25) - 2012/08/05 13:00:49 JST [2012/08/05 0:00:49 ET]
Table 'Whirlpool' 9-max Seat #1 is the button
Seat 1: 2997qwer ($10.15 in chips) 
Seat 2: AndiM64 ($30.78 in chips) 
Seat 3: jamielniak ($26.27 in chips) 
Seat 4: MATT361 ($11.37 in chips) 
Seat 5: Sharks_Nica ($25 in chips) 
Seat 6: KeLevro0 ($11.90 in chips) 
Seat 7: DooMSDaY1337 ($57.21 in chips) 
Seat 8: chiyuki ($23.71 in chips) 
Seat 9: vit 111 ($49 in chips) 
AndiM64: posts small blind $0.10
jamielniak: posts big blind $0.25
*** HOLE CARDS ***
Dealt to chiyuki [9s Qd]
MATT361: folds 
Sharks_Nica: raises $0.75 to $1
KeLevro0: folds 
DooMSDaY1337: folds 
chiyuki: folds 
vit 111: folds 
2997qwer: folds 
AndiM64: folds 
jamielniak: calls $0.75
*** FLOP *** [Td Ts 5c]
jamielniak: checks 
Sharks_Nica: checks 
*** TURN *** [Td Ts 5c] [Ks]
jamielniak: checks 
Sharks_Nica: bets $1.30
jamielniak: folds 
Uncalled bet ($1.30) returned to Sharks_Nica
Sharks_Nica collected $2.01 from pot
Sharks_Nica: doesn't show hand 
*** SUMMARY ***
Total pot $2.10 | Rake $0.09 
Board [Td Ts 5c Ks]
Seat 1: 2997qwer (button) folded before Flop (didn't bet)
Seat 2: AndiM64 (small blind) folded before Flop
Seat 3: jamielniak (big blind) folded on the Turn
Seat 4: MATT361 folded before Flop (didn't bet)
Seat 5: Sharks_Nica collected ($2.01)
Seat 6: KeLevro0 folded before Flop (didn't bet)
Seat 7: DooMSDaY1337 folded before Flop (didn't bet)
Seat 8: chiyuki folded before Flop (didn't bet)
Seat 9: vit 111 folded before Flop (didn't bet)



PokerStars Zoom Hand #84298220344:  Hold'em No Limit ($0.10/$0.25) - 2012/08/05 13:01:32 JST [2012/08/05 0:01:32 ET]
Table 'Whirlpool' 9-max Seat #1 is the button
Seat 1: DooMSDaY1337 ($56.86 in chips) 
Seat 2: nice.franki ($7.36 in chips) 
Seat 3: chiyuki ($23.71 in chips) 
Seat 4: softdesign ($45.04 in chips) 
Seat 5: KeLevro0 ($12.50 in chips) 
Seat 6: RomarioJa ($13.57 in chips) 
Seat 7: BlOnDhOlIc ($34.49 in chips) 
Seat 8: Sharks_Nica ($31.77 in chips) 
Seat 9: AndiM64 ($28.15 in chips) 
nice.franki: posts small blind $0.10
chiyuki: posts big blind $0.25
*** HOLE CARDS ***
Dealt to chiyuki [9s 6d]
softdesign: folds 
KeLevro0: folds 
RomarioJa: folds 
BlOnDhOlIc: folds 
Sharks_Nica: folds 
AndiM64: folds 
DooMSDaY1337: folds 
nice.franki: raises $0.50 to $0.75
chiyuki: folds 
Uncalled bet ($0.50) returned to nice.franki
nice.franki collected $0.50 from pot
nice.franki: doesn't show hand 
*** SUMMARY ***
Total pot $0.50 | Rake $0 
Seat 1: DooMSDaY1337 (button) folded before Flop (didn't bet)
Seat 2: nice.franki (small blind) collected ($0.50)
Seat 3: chiyuki (big blind) folded before Flop
Seat 4: softdesign folded before Flop (didn't bet)
Seat 5: KeLevro0 folded before Flop (didn't bet)
Seat 6: RomarioJa folded before Flop (didn't bet)
Seat 7: BlOnDhOlIc folded before Flop (didn't bet)
Seat 8: Sharks_Nica folded before Flop (didn't bet)
Seat 9: AndiM64 folded before Flop (didn't bet)



PokerStars Zoom Hand #84298218027:  Hold'em No Limit ($0.10/$0.25) - 2012/08/05 13:01:23 JST [2012/08/05 0:01:23 ET]
Table 'Whirlpool' 9-max Seat #1 is the button
Seat 1: wtu1986 ($24.90 in chips) 
Seat 2: Th3Fog ($52.80 in chips) 
Seat 3: mayathebee83 ($12.50 in chips) 
Seat 4: pyty_82 ($50.01 in chips) 
Seat 5: D@vidMed ($25.68 in chips) 
Seat 6: cR!Ma*aRm ($22.71 in chips) 
Seat 7: chiyuki ($23.71 in chips) 
Seat 8: KINGKILERACE ($41.57 in chips) 
Seat 9: mid22 ($16.16 in chips) 
Th3Fog: posts small blind $0.10
mayathebee83: posts big blind $0.25
*** HOLE CARDS ***
Dealt to chiyuki [3c 2s]
pyty_82: folds 
D@vidMed: raises $0.57 to $0.82
cR!Ma*aRm: folds 
chiyuki: folds 
KINGKILERACE: calls $0.82
mid22: folds 
wtu1986: folds 
Th3Fog: folds 
mayathebee83: folds 
*** FLOP *** [2h 7h Kh]
D@vidMed: checks 
KINGKILERACE: bets $0.50
D@vidMed: calls $0.50
*** TURN *** [2h 7h Kh] [Jc]
D@vidMed: checks 
KINGKILERACE: bets $1.25
D@vidMed: folds 
Uncalled bet ($1.25) returned to KINGKILERACE
KINGKILERACE collected $2.86 from pot
KINGKILERACE: doesn't show hand 
*** SUMMARY ***
Total pot $2.99 | Rake $0.13 
Board [2h 7h Kh Jc]
Seat 1: wtu1986 (button) folded before Flop (didn't bet)
Seat 2: Th3Fog (small blind) folded before Flop
Seat 3: mayathebee83 (big blind) folded before Flop
Seat 4: pyty_82 folded before Flop (didn't bet)
Seat 5: D@vidMed folded on the Turn
Seat 6: cR!Ma*aRm folded before Flop (didn't bet)
Seat 7: chiyuki folded before Flop (didn't bet)
Seat 8: KINGKILERACE collected ($2.86)
Seat 9: mid22 folded before Flop (didn't bet)



PokerStars Zoom Hand #84298226024:  Hold'em No Limit ($0.10/$0.25) - 2012/08/05 13:01:53 JST [2012/08/05 0:01:53 ET]
Table 'Whirlpool' 9-max Seat #1 is the button
Seat 1: Lasutchik ($11.65 in chips) 
Seat 2: RomarioJa ($8.40 in chips) 
Seat 3: deadmoneykid ($25 in chips) 
Seat 4: DooMSDaY1337 ($37.69 in chips) 
Seat 5: masterkoolb ($14.27 in chips) 
Seat 6: 2997qwer ($12.15 in chips) 
Seat 7: AndiM64 ($76.31 in chips) 
Seat 8: chiyuki ($23.46 in chips) 
Seat 9: Jippyflip ($18.86 in chips) 
RomarioJa: posts small blind $0.10
deadmoneykid: posts big blind $0.25
*** HOLE CARDS ***
Dealt to chiyuki [4d 3h]
DooMSDaY1337: folds 
masterkoolb: folds 
2997qwer: folds 
AndiM64: folds 
chiyuki: folds 
Jippyflip: folds 
Lasutchik: raises $0.50 to $0.75
RomarioJa: folds 
deadmoneykid: folds 
Uncalled bet ($0.50) returned to Lasutchik
Lasutchik collected $0.60 from pot
Lasutchik: doesn't show hand 
*** SUMMARY ***
Total pot $0.60 | Rake $0 
Seat 1: Lasutchik (button) collected ($0.60)
Seat 2: RomarioJa (small blind) folded before Flop
Seat 3: deadmoneykid (big blind) folded before Flop
Seat 4: DooMSDaY1337 folded before Flop (didn't bet)
Seat 5: masterkoolb folded before Flop (didn't bet)
Seat 6: 2997qwer folded before Flop (didn't bet)
Seat 7: AndiM64 folded before Flop (didn't bet)
Seat 8: chiyuki folded before Flop (didn't bet)
Seat 9: Jippyflip folded before Flop (didn't bet)



PokerStars Zoom Hand #84298231947:  Hold'em No Limit ($0.10/$0.25) - 2012/08/05 13:02:11 JST [2012/08/05 0:02:11 ET]
Table 'Whirlpool' 9-max Seat #1 is the button
Seat 1: pyty_82 ($49.41 in chips) 
Seat 2: AndiM64 ($28.15 in chips) 
Seat 3: TErr18 ($21.81 in chips) 
Seat 4: DooMSDaY1337 ($32.99 in chips) 
Seat 5: KINGKILERACE ($43.11 in chips) 
Seat 6: nice.franki ($7.61 in chips) 
Seat 7: mayathebee83 ($11.75 in chips) 
Seat 8: vfo.pt ($11.90 in chips) 
Seat 9: chiyuki ($23.36 in chips) 
AndiM64: posts small blind $0.10
TErr18: posts big blind $0.25
*** HOLE CARDS ***
Dealt to chiyuki [7h 4h]
DooMSDaY1337: folds 
KINGKILERACE: folds 
nice.franki: folds 
mayathebee83: folds 
vfo.pt: folds 
chiyuki: folds 
pyty_82: folds 
AndiM64: raises $0.50 to $0.75
TErr18: folds 
Uncalled bet ($0.50) returned to AndiM64
AndiM64 collected $0.50 from pot
AndiM64: doesn't show hand 
*** SUMMARY ***
Total pot $0.50 | Rake $0 
Seat 1: pyty_82 (button) folded before Flop (didn't bet)
Seat 2: AndiM64 (small blind) collected ($0.50)
Seat 3: TErr18 (big blind) folded before Flop
Seat 4: DooMSDaY1337 folded before Flop (didn't bet)
Seat 5: KINGKILERACE folded before Flop (didn't bet)
Seat 6: nice.franki folded before Flop (didn't bet)
Seat 7: mayathebee83 folded before Flop (didn't bet)
Seat 8: vfo.pt folded before Flop (didn't bet)
Seat 9: chiyuki folded before Flop (didn't bet)



PokerStars Zoom Hand #84298227484:  Hold'em No Limit ($0.10/$0.25) - 2012/08/05 13:01:58 JST [2012/08/05 0:01:58 ET]
Table 'Whirlpool' 9-max Seat #1 is the button
Seat 1: AndiM64 ($76.31 in chips) 
Seat 2: chiyuki ($23.46 in chips) 
Seat 3: fwani ($25 in chips) 
Seat 4: Sharks_Nica ($66.53 in chips) 
Seat 5: Sørbråten ($66.62 in chips) 
Seat 6: TraderYao ($25 in chips) 
Seat 7: Medic8681 ($20.45 in chips) 
Seat 8: Jippyflip ($18.86 in chips) 
Seat 9: KrystalAA ($21.71 in chips) 
chiyuki: posts small blind $0.10
fwani: posts big blind $0.25
*** HOLE CARDS ***
Dealt to chiyuki [9c Jd]
Sharks_Nica: folds 
Sørbråten: calls $0.25
TraderYao: folds 
Medic8681: folds 
Jippyflip: folds 
KrystalAA: raises $0.65 to $0.90
AndiM64: folds 
chiyuki: folds 
fwani: folds 
Sørbråten: calls $0.65
*** FLOP *** [6h Kh Jh]
Sørbråten: bets $1.02
KrystalAA: folds 
Uncalled bet ($1.02) returned to Sørbråten
Sørbråten collected $2.05 from pot
Sørbråten: doesn't show hand 
Sørbråten is disconnected 
*** SUMMARY ***
Total pot $2.15 | Rake $0.10 
Board [6h Kh Jh]
Seat 1: AndiM64 (button) folded before Flop (didn't bet)
Seat 2: chiyuki (small blind) folded before Flop
Seat 3: fwani (big blind) folded before Flop
Seat 4: Sharks_Nica folded before Flop (didn't bet)
Seat 5: Sørbråten collected ($2.05)
Seat 6: TraderYao folded before Flop (didn't bet)
Seat 7: Medic8681 folded before Flop (didn't bet)
Seat 8: Jippyflip folded before Flop (didn't bet)
Seat 9: KrystalAA folded on the Flop



PokerStars Zoom Hand #84298233311:  Hold'em No Limit ($0.10/$0.25) - 2012/08/05 13:02:16 JST [2012/08/05 0:02:16 ET]
Table 'Whirlpool' 9-max Seat #1 is the button
Seat 1: nice.franki ($7.61 in chips) 
Seat 2: deadmoneykid ($24.75 in chips) 
Seat 3: Sharks_Nica ($31.77 in chips) 
Seat 4: chiyuki ($23.36 in chips) 
Seat 5: TraderYao ($25.25 in chips) 
Seat 6: KrystalAA ($29.30 in chips) 
Seat 7: simonzez ($31.53 in chips) 
Seat 8: pyty_82 ($49.41 in chips) 
Seat 9: BlOnDhOlIc ($31.25 in chips) 
deadmoneykid: posts small blind $0.10
Sharks_Nica: posts big blind $0.25
*** HOLE CARDS ***
Dealt to chiyuki [Kd Kh]
chiyuki: raises $0.50 to $0.75
TraderYao has timed out
TraderYao: folds 
KrystalAA: calls $0.75
simonzez: folds 
pyty_82: folds 
BlOnDhOlIc: folds 
nice.franki: folds 
deadmoneykid: folds 
Sharks_Nica: folds 
*** FLOP *** [9h 7h As]
chiyuki: checks 
KrystalAA: checks 
*** TURN *** [9h 7h As] [2h]
chiyuki: bets $0.88
KrystalAA: folds 
Uncalled bet ($0.88) returned to chiyuki
chiyuki collected $1.77 from pot
chiyuki: doesn't show hand 
*** SUMMARY ***
Total pot $1.85 | Rake $0.08 
Board [9h 7h As 2h]
Seat 1: nice.franki (button) folded before Flop (didn't bet)
Seat 2: deadmoneykid (small blind) folded before Flop
Seat 3: Sharks_Nica (big blind) folded before Flop
Seat 4: chiyuki collected ($1.77)
Seat 5: TraderYao folded before Flop (didn't bet)
Seat 6: KrystalAA folded on the Turn
Seat 7: simonzez folded before Flop (didn't bet)
Seat 8: pyty_82 folded before Flop (didn't bet)
Seat 9: BlOnDhOlIc folded before Flop (didn't bet)



PokerStars Zoom Hand #84298248317:  Hold'em No Limit ($0.10/$0.25) - 2012/08/05 13:03:10 JST [2012/08/05 0:03:10 ET]
Table 'Whirlpool' 9-max Seat #1 is the button
Seat 1: RomarioJa ($13.01 in chips) 
Seat 2: Loholov ($15.10 in chips) 
Seat 3: AUGH-AUGH ($30.82 in chips) 
Seat 4: Oswulf ($14.23 in chips) 
Seat 5: chiyuki ($24.38 in chips) 
Seat 6: KrystalAA ($18.16 in chips) 
Seat 7: KeLevro0 ($11.65 in chips) 
Seat 8: fwani ($25 in chips) 
Seat 9: Th3Fog ($20.79 in chips) 
Loholov: posts small blind $0.10
AUGH-AUGH: posts big blind $0.25
*** HOLE CARDS ***
Dealt to chiyuki [7d 2c]
Oswulf: folds 
chiyuki: folds 
KrystalAA: folds 
KeLevro0: folds 
fwani: raises $0.35 to $0.60
Th3Fog: folds 
RomarioJa: folds 
Loholov: folds 
AUGH-AUGH: folds 
Uncalled bet ($0.35) returned to fwani
fwani collected $0.60 from pot
fwani: doesn't show hand 
*** SUMMARY ***
Total pot $0.60 | Rake $0 
Seat 1: RomarioJa (button) folded before Flop (didn't bet)
Seat 2: Loholov (small blind) folded before Flop
Seat 3: AUGH-AUGH (big blind) folded before Flop
Seat 4: Oswulf folded before Flop (didn't bet)
Seat 5: chiyuki folded before Flop (didn't bet)
Seat 6: KrystalAA folded before Flop (didn't bet)
Seat 7: KeLevro0 folded before Flop (didn't bet)
Seat 8: fwani collected ($0.60)
Seat 9: Th3Fog folded before Flop (didn't bet)



PokerStars Zoom Hand #84298249758:  Hold'em No Limit ($0.10/$0.25) - 2012/08/05 13:03:15 JST [2012/08/05 0:03:15 ET]
Table 'Whirlpool' 9-max Seat #1 is the button
Seat 1: chiyuki ($24.38 in chips) 
Seat 2: Seadogvcd ($5.33 in chips) 
Seat 3: Sharks_Nica ($66.43 in chips) 
Seat 4: TErr18 ($21.91 in chips) 
Seat 5: deadmoneykid ($24 in chips) 
Seat 6: 5zzzz33 ($18.30 in chips) 
Seat 7: Catrban ($24.05 in chips) 
Seat 8: nice.franki ($7.36 in chips) 
Seat 9: TraderYao ($25.25 in chips) 
Seadogvcd: posts small blind $0.10
Sharks_Nica: posts big blind $0.25
*** HOLE CARDS ***
Dealt to chiyuki [6d 5d]
TErr18: folds 
deadmoneykid: folds 
5zzzz33: folds 
Catrban: folds 
nice.franki: folds 
TraderYao: folds 
chiyuki: raises $0.50 to $0.75
Seadogvcd: folds 
Sharks_Nica: calls $0.50
*** FLOP *** [Ac 4s 6h]
Sharks_Nica: checks 
chiyuki: bets $0.76
Sharks_Nica: calls $0.76
*** TURN *** [Ac 4s 6h] [8h]
Sharks_Nica: checks 
chiyuki: checks 
*** RIVER *** [Ac 4s 6h 8h] [3d]
Sharks_Nica: bets $1.93
chiyuki: folds 
Uncalled bet ($1.93) returned to Sharks_Nica
Sharks_Nica collected $2.98 from pot
Sharks_Nica: doesn't show hand 
*** SUMMARY ***
Total pot $3.12 | Rake $0.14 
Board [Ac 4s 6h 8h 3d]
Seat 1: chiyuki (button) folded on the River
Seat 2: Seadogvcd (small blind) folded before Flop
Seat 3: Sharks_Nica (big blind) collected ($2.98)
Seat 4: TErr18 folded before Flop (didn't bet)
Seat 5: deadmoneykid folded before Flop (didn't bet)
Seat 6: 5zzzz33 folded before Flop (didn't bet)
Seat 7: Catrban folded before Flop (didn't bet)
Seat 8: nice.franki folded before Flop (didn't bet)
Seat 9: TraderYao folded before Flop (didn't bet)



PokerStars Zoom Hand #84298275784:  Hold'em No Limit ($0.10/$0.25) - 2012/08/05 13:04:44 JST [2012/08/05 0:04:44 ET]
Table 'Whirlpool' 9-max Seat #1 is the button
Seat 1: TErr18 ($18.89 in chips) 
Seat 2: deadmoneykid ($25.20 in chips) 
Seat 3: discomanbrad ($12.50 in chips) 
Seat 4: Loholov ($15 in chips) 
Seat 5: chiyuki ($22.87 in chips) 
Seat 6: DooMSDaY1337 ($63.45 in chips) 
Seat 7: BlOnDhOlIc ($28.90 in chips) 
Seat 8: Sharks_Nica ($29.80 in chips) 
Seat 9: Lasutchik ($10.40 in chips) 
deadmoneykid: posts small blind $0.10
discomanbrad: posts big blind $0.25
*** HOLE CARDS ***
Dealt to chiyuki [3d 7d]
Loholov: folds 
chiyuki: folds 
DooMSDaY1337: folds 
BlOnDhOlIc: folds 
Sharks_Nica: folds 
Lasutchik: folds 
TErr18: folds 
deadmoneykid: folds 
Uncalled bet ($0.15) returned to discomanbrad
discomanbrad collected $0.20 from pot
discomanbrad: doesn't show hand 
*** SUMMARY ***
Total pot $0.20 | Rake $0 
Seat 1: TErr18 (button) folded before Flop (didn't bet)
Seat 2: deadmoneykid (small blind) folded before Flop
Seat 3: discomanbrad (big blind) collected ($0.20)
Seat 4: Loholov folded before Flop (didn't bet)
Seat 5: chiyuki folded before Flop (didn't bet)
Seat 6: DooMSDaY1337 folded before Flop (didn't bet)
Seat 7: BlOnDhOlIc folded before Flop (didn't bet)
Seat 8: Sharks_Nica folded before Flop (didn't bet)
Seat 9: Lasutchik folded before Flop (didn't bet)



PokerStars Zoom Hand #84298278570:  Hold'em No Limit ($0.10/$0.25) - 2012/08/05 13:04:54 JST [2012/08/05 0:04:54 ET]
Table 'Whirlpool' 9-max Seat #1 is the button
Seat 1: masterkoolb ($30.36 in chips) 
Seat 2: jethaz ($73.05 in chips) 
Seat 3: chiyuki ($22.87 in chips) 
Seat 4: cR!Ma*aRm ($25.14 in chips) 
Seat 5: slickthis ($27.66 in chips) 
Seat 6: AUGH-AUGH ($25 in chips) 
Seat 7: wtu1986 ($26.38 in chips) 
Seat 8: deadmoneykid ($23.65 in chips) 
Seat 9: silvno31 ($44.48 in chips) 
jethaz: posts small blind $0.10
chiyuki: posts big blind $0.25
*** HOLE CARDS ***
Dealt to chiyuki [Tc 7c]
cR!Ma*aRm: folds 
slickthis: folds 
AUGH-AUGH: raises $0.50 to $0.75
wtu1986: folds 
deadmoneykid: folds 
silvno31: folds 
masterkoolb: folds 
jethaz: folds 
chiyuki: folds 
Uncalled bet ($0.50) returned to AUGH-AUGH
AUGH-AUGH collected $0.60 from pot
AUGH-AUGH: doesn't show hand 
*** SUMMARY ***
Total pot $0.60 | Rake $0 
Seat 1: masterkoolb (button) folded before Flop (didn't bet)
Seat 2: jethaz (small blind) folded before Flop
Seat 3: chiyuki (big blind) folded before Flop
Seat 4: cR!Ma*aRm folded before Flop (didn't bet)
Seat 5: slickthis folded before Flop (didn't bet)
Seat 6: AUGH-AUGH collected ($0.60)
Seat 7: wtu1986 folded before Flop (didn't bet)
Seat 8: deadmoneykid folded before Flop (didn't bet)
Seat 9: silvno31 folded before Flop (didn't bet)



PokerStars Zoom Hand #84298283220:  Hold'em No Limit ($0.10/$0.25) - 2012/08/05 13:05:10 JST [2012/08/05 0:05:10 ET]
Table 'Whirlpool' 9-max Seat #1 is the button
Seat 1: leo2095 ($15.08 in chips) 
Seat 2: Medic8681 ($12.50 in chips) 
Seat 3: JAMES3FINGER ($331.19 in chips) 
Seat 4: nice.franki ($17.42 in chips) 
Seat 5: mollybally1 ($14.97 in chips) 
Seat 6: 5zzzz33 ($17.30 in chips) 
Seat 7: chiyuki ($22.62 in chips) 
Seat 8: wtu1986 ($24.90 in chips) 
Seat 9: Anafim ($12.50 in chips) 
Medic8681: posts small blind $0.10
JAMES3FINGER: posts big blind $0.25
*** HOLE CARDS ***
Dealt to chiyuki [Kh As]
nice.franki: folds 
mollybally1: folds 
5zzzz33: folds 
chiyuki: raises $0.50 to $0.75
wtu1986: folds 
Anafim: folds 
leo2095: folds 
Medic8681: folds 
JAMES3FINGER: calls $0.50
*** FLOP *** [2c Jc 3d]
JAMES3FINGER: checks 
chiyuki: checks 
*** TURN *** [2c Jc 3d] [Qs]
JAMES3FINGER: bets $0.50
chiyuki: calls $0.50
*** RIVER *** [2c Jc 3d Qs] [6s]
JAMES3FINGER: bets $1
chiyuki: folds 
Uncalled bet ($1) returned to JAMES3FINGER
JAMES3FINGER collected $2.48 from pot
JAMES3FINGER: doesn't show hand 
*** SUMMARY ***
Total pot $2.60 | Rake $0.12 
Board [2c Jc 3d Qs 6s]
Seat 1: leo2095 (button) folded before Flop (didn't bet)
Seat 2: Medic8681 (small blind) folded before Flop
Seat 3: JAMES3FINGER (big blind) collected ($2.48)
Seat 4: nice.franki folded before Flop (didn't bet)
Seat 5: mollybally1 folded before Flop (didn't bet)
Seat 6: 5zzzz33 folded before Flop (didn't bet)
Seat 7: chiyuki folded on the River
Seat 8: wtu1986 folded before Flop (didn't bet)
Seat 9: Anafim folded before Flop (didn't bet)



PokerStars Zoom Hand #84298301579:  Hold'em No Limit ($0.10/$0.25) - 2012/08/05 13:06:13 JST [2012/08/05 0:06:13 ET]
Table 'Whirlpool' 9-max Seat #1 is the button
Seat 1: TErr18 ($18.29 in chips) 
Seat 2: chiyuki ($21.37 in chips) 
Seat 3: Seadogvcd ($6.06 in chips) 
Seat 4: DooMSDaY1337 ($32.64 in chips) 
Seat 5: mollybally1 ($14.47 in chips) 
Seat 6: gunbowler ($87.69 in chips) 
Seat 7: PetitAlejo ($25 in chips) 
Seat 8: Loholov ($15 in chips) 
Seat 9: BlOnDhOlIc ($27.24 in chips) 
chiyuki: posts small blind $0.10
Seadogvcd: posts big blind $0.25
*** HOLE CARDS ***
Dealt to chiyuki [Qc 2h]
DooMSDaY1337: folds 
mollybally1: folds 
gunbowler: raises $0.35 to $0.60
PetitAlejo: folds 
Loholov: folds 
BlOnDhOlIc: folds 
TErr18: folds 
chiyuki: folds 
Seadogvcd: folds 
Uncalled bet ($0.35) returned to gunbowler
gunbowler collected $0.60 from pot
gunbowler: doesn't show hand 
*** SUMMARY ***
Total pot $0.60 | Rake $0 
Seat 1: TErr18 (button) folded before Flop (didn't bet)
Seat 2: chiyuki (small blind) folded before Flop
Seat 3: Seadogvcd (big blind) folded before Flop
Seat 4: DooMSDaY1337 folded before Flop (didn't bet)
Seat 5: mollybally1 folded before Flop (didn't bet)
Seat 6: gunbowler collected ($0.60)
Seat 7: PetitAlejo folded before Flop (didn't bet)
Seat 8: Loholov folded before Flop (didn't bet)
Seat 9: BlOnDhOlIc folded before Flop (didn't bet)



PokerStars Zoom Hand #84298295944:  Hold'em No Limit ($0.10/$0.25) - 2012/08/05 13:05:53 JST [2012/08/05 0:05:53 ET]
Table 'Whirlpool' 9-max Seat #1 is the button
Seat 1: PetitAlejo ($25 in chips) 
Seat 2: nice.franki ($7.01 in chips) 
Seat 3: Th3Fog ($24 in chips) 
Seat 4: simonzez ($28.93 in chips) 
Seat 5: D@vidMed ($28.46 in chips) 
Seat 6: masterkoolb ($13.47 in chips) 
Seat 7: Loholov ($28.18 in chips) 
Seat 8: mayathebee83 ($8.75 in chips) 
Seat 9: chiyuki ($21.37 in chips) 
nice.franki: posts small blind $0.10
Th3Fog: posts big blind $0.25
*** HOLE CARDS ***
Dealt to chiyuki [Ts 9d]
simonzez: folds 
D@vidMed: folds 
masterkoolb: folds 
Loholov: raises $0.50 to $0.75
mayathebee83: folds 
chiyuki: folds 
PetitAlejo: raises $1.50 to $2.25
nice.franki: folds 
Th3Fog: folds 
Loholov: folds 
Uncalled bet ($1.50) returned to PetitAlejo
PetitAlejo collected $1.85 from pot
PetitAlejo: doesn't show hand 
*** SUMMARY ***
Total pot $1.85 | Rake $0 
Seat 1: PetitAlejo (button) collected ($1.85)
Seat 2: nice.franki (small blind) folded before Flop
Seat 3: Th3Fog (big blind) folded before Flop
Seat 4: simonzez folded before Flop (didn't bet)
Seat 5: D@vidMed folded before Flop (didn't bet)
Seat 6: masterkoolb folded before Flop (didn't bet)
Seat 7: Loholov folded before Flop
Seat 8: mayathebee83 folded before Flop (didn't bet)
Seat 9: chiyuki folded before Flop (didn't bet)



PokerStars Zoom Hand #84298304213:  Hold'em No Limit ($0.10/$0.25) - 2012/08/05 13:06:22 JST [2012/08/05 0:06:22 ET]
Table 'Whirlpool' 9-max Seat #1 is the button
Seat 1: PetitAlejo ($25 in chips) 
Seat 2: kamikkaze ($44.05 in chips) 
Seat 3: wtu1986 ($25.25 in chips) 
Seat 4: chiyuki ($21.27 in chips) 
Seat 5: jethaz ($27.42 in chips) 
Seat 6: BlOnDhOlIc ($45.31 in chips) 
Seat 7: mollybally1 ($14.47 in chips) 
Seat 8: Lab50att ($15.43 in chips) 
Seat 9: masterkoolb ($12.50 in chips) 
kamikkaze: posts small blind $0.10
wtu1986: posts big blind $0.25
*** HOLE CARDS ***
Dealt to chiyuki [As Qd]
chiyuki: raises $0.50 to $0.75
jethaz: folds 
BlOnDhOlIc: folds 
mollybally1: calls $0.75
Lab50att: folds 
masterkoolb: folds 
PetitAlejo: folds 
kamikkaze: folds 
wtu1986: folds 
*** FLOP *** [Qs 3c Ac]
chiyuki: bets $1
mollybally1: calls $1
*** TURN *** [Qs 3c Ac] [9d]
chiyuki: bets $2.25
mollybally1: folds 
Uncalled bet ($2.25) returned to chiyuki
chiyuki collected $3.68 from pot
chiyuki: doesn't show hand 
*** SUMMARY ***
Total pot $3.85 | Rake $0.17 
Board [Qs 3c Ac 9d]
Seat 1: PetitAlejo (button) folded before Flop (didn't bet)
Seat 2: kamikkaze (small blind) folded before Flop
Seat 3: wtu1986 (big blind) folded before Flop
Seat 4: chiyuki collected ($3.68)
Seat 5: jethaz folded before Flop (didn't bet)
Seat 6: BlOnDhOlIc folded before Flop (didn't bet)
Seat 7: mollybally1 folded on the Turn
Seat 8: Lab50att folded before Flop (didn't bet)
Seat 9: masterkoolb folded before Flop (didn't bet)



PokerStars Zoom Hand #84298314481:  Hold'em No Limit ($0.10/$0.25) - 2012/08/05 13:06:57 JST [2012/08/05 0:06:57 ET]
Table 'Whirlpool' 9-max Seat #1 is the button
Seat 1: Lasutchik ($12.15 in chips) 
Seat 2: MATT361 ($12.58 in chips) 
Seat 3: Loholov ($15 in chips) 
Seat 4: chiyuki ($23.20 in chips) 
Seat 5: PetitAlejo ($26 in chips) 
Seat 6: eagie20 ($148.90 in chips) 
Seat 7: Th3Fog ($53.60 in chips) 
Seat 8: THE_BIG_BOTT ($13.28 in chips) 
Seat 9: masterkoolb ($13.12 in chips) 
MATT361: posts small blind $0.10
Loholov: posts big blind $0.25
*** HOLE CARDS ***
Dealt to chiyuki [4c Kd]
chiyuki: folds 
PetitAlejo: folds 
eagie20: folds 
Th3Fog: raises $0.35 to $0.60
THE_BIG_BOTT: folds 
masterkoolb: folds 
Lasutchik: folds 
MATT361: folds 
Loholov: folds 
Uncalled bet ($0.35) returned to Th3Fog
Th3Fog collected $0.60 from pot
Th3Fog: doesn't show hand 
*** SUMMARY ***
Total pot $0.60 | Rake $0 
Seat 1: Lasutchik (button) folded before Flop (didn't bet)
Seat 2: MATT361 (small blind) folded before Flop
Seat 3: Loholov (big blind) folded before Flop
Seat 4: chiyuki folded before Flop (didn't bet)
Seat 5: PetitAlejo folded before Flop (didn't bet)
Seat 6: eagie20 folded before Flop (didn't bet)
Seat 7: Th3Fog collected ($0.60)
Seat 8: THE_BIG_BOTT folded before Flop (didn't bet)
Seat 9: masterkoolb folded before Flop (didn't bet)



PokerStars Zoom Hand #84298315669:  Hold'em No Limit ($0.10/$0.25) - 2012/08/05 13:07:01 JST [2012/08/05 0:07:01 ET]
Table 'Whirlpool' 9-max Seat #1 is the button
Seat 1: seula i ($26.03 in chips) 
Seat 2: 2997qwer ($8.57 in chips) 
Seat 3: RomarioJa ($14.34 in chips) 
Seat 4: fwani ($42.36 in chips) 
Seat 5: DooMSDaY1337 ($25.17 in chips) 
Seat 6: BlOnDhOlIc ($26.62 in chips) 
Seat 7: masterkoolb ($13.12 in chips) 
Seat 8: TErr18 ($22.33 in chips) 
Seat 9: chiyuki ($23.20 in chips) 
2997qwer: posts small blind $0.10
RomarioJa: posts big blind $0.25
*** HOLE CARDS ***
Dealt to chiyuki [Td Ts]
fwani: folds 
DooMSDaY1337: folds 
BlOnDhOlIc: folds 
masterkoolb: folds 
TErr18: folds 
chiyuki: raises $0.50 to $0.75
seula i: folds 
2997qwer: folds 
RomarioJa: folds 
Uncalled bet ($0.50) returned to chiyuki
chiyuki collected $0.60 from pot
chiyuki: doesn't show hand 
*** SUMMARY ***
Total pot $0.60 | Rake $0 
Seat 1: seula i (button) folded before Flop (didn't bet)
Seat 2: 2997qwer (small blind) folded before Flop
Seat 3: RomarioJa (big blind) folded before Flop
Seat 4: fwani folded before Flop (didn't bet)
Seat 5: DooMSDaY1337 folded before Flop (didn't bet)
Seat 6: BlOnDhOlIc folded before Flop (didn't bet)
Seat 7: masterkoolb folded before Flop (didn't bet)
Seat 8: TErr18 folded before Flop (didn't bet)
Seat 9: chiyuki collected ($0.60)



PokerStars Zoom Hand #84298296827:  Hold'em No Limit ($0.10/$0.25) - 2012/08/05 13:05:56 JST [2012/08/05 0:05:56 ET]
Table 'Whirlpool' 9-max Seat #1 is the button
Seat 1: KeLevro0 ($15.89 in chips) 
Seat 2: fwani ($36.80 in chips) 
Seat 3: seula i ($50.87 in chips) 
Seat 4: softdesign ($42.17 in chips) 
Seat 5: petersmiths ($29.43 in chips) 
Seat 6: AndiM64 ($40.70 in chips) 
Seat 7: TraderYao ($24.90 in chips) 
Seat 8: chiyuki ($21.37 in chips) 
Seat 9: Medic8681 ($14.09 in chips) 
fwani: posts small blind $0.10
seula i: posts big blind $0.25
*** HOLE CARDS ***
Dealt to chiyuki [8c Ac]
softdesign: folds 
petersmiths: raises $0.25 to $0.50
AndiM64: folds 
TraderYao: calls $0.50
chiyuki: folds 
Medic8681: folds 
KeLevro0: calls $0.50
fwani: calls $0.40
seula i: folds 
*** FLOP *** [2h 6s Td]
fwani: bets $1.10
petersmiths: folds 
TraderYao: folds 
KeLevro0: calls $1.10
*** TURN *** [2h 6s Td] [4s]
fwani: bets $2.10
KeLevro0: calls $2.10
*** RIVER *** [2h 6s Td 4s] [3h]
fwani: bets $3.70
KeLevro0: raises $5.30 to $9
fwani: folds 
Uncalled bet ($5.30) returned to KeLevro0
KeLevro0 collected $15.33 from pot
KeLevro0: doesn't show hand 
*** SUMMARY ***
Total pot $16.05 | Rake $0.72 
Board [2h 6s Td 4s 3h]
Seat 1: KeLevro0 (button) collected ($15.33)
Seat 2: fwani (small blind) folded on the River
Seat 3: seula i (big blind) folded before Flop
Seat 4: softdesign folded before Flop (didn't bet)
Seat 5: petersmiths folded on the Flop
Seat 6: AndiM64 folded before Flop (didn't bet)
Seat 7: TraderYao folded on the Flop
Seat 8: chiyuki folded before Flop (didn't bet)
Seat 9: Medic8681 folded before Flop (didn't bet)



PokerStars Zoom Hand #84298311846:  Hold'em No Limit ($0.10/$0.25) - 2012/08/05 13:06:48 JST [2012/08/05 0:06:48 ET]
Table 'Whirlpool' 9-max Seat #1 is the button
Seat 1: Zugrug ($25 in chips) 
Seat 2: Alvinpe85 ($26.68 in chips) 
Seat 3: jamielniak ($25 in chips) 
Seat 4: BlOnDhOlIc ($25.35 in chips) 
Seat 5: cR!Ma*aRm ($24.75 in chips) 
Seat 6: DooMSDaY1337 ($25.17 in chips) 
Seat 7: chiyuki ($23.20 in chips) 
Seat 8: nice.franki ($13.25 in chips) 
Seat 9: Jene4kaBest ($9.98 in chips) 
Alvinpe85: posts small blind $0.10
jamielniak: posts big blind $0.25
*** HOLE CARDS ***
Dealt to chiyuki [Ks 7c]
BlOnDhOlIc: folds 
cR!Ma*aRm: folds 
DooMSDaY1337: folds 
chiyuki: folds 
nice.franki: folds 
Jene4kaBest: folds 
Zugrug: folds 
Alvinpe85: raises $0.50 to $0.75
jamielniak: calls $0.50
*** FLOP *** [3s Kd 5s]
Alvinpe85: bets $0.85
jamielniak: calls $0.85
*** TURN *** [3s Kd 5s] [Jh]
Alvinpe85: checks 
jamielniak: bets $2.69
Alvinpe85: folds 
Uncalled bet ($2.69) returned to jamielniak
jamielniak collected $3.06 from pot
jamielniak: doesn't show hand 
*** SUMMARY ***
Total pot $3.20 | Rake $0.14 
Board [3s Kd 5s Jh]
Seat 1: Zugrug (button) folded before Flop (didn't bet)
Seat 2: Alvinpe85 (small blind) folded on the Turn
Seat 3: jamielniak (big blind) collected ($3.06)
Seat 4: BlOnDhOlIc folded before Flop (didn't bet)
Seat 5: cR!Ma*aRm folded before Flop (didn't bet)
Seat 6: DooMSDaY1337 folded before Flop (didn't bet)
Seat 7: chiyuki folded before Flop (didn't bet)
Seat 8: nice.franki folded before Flop (didn't bet)
Seat 9: Jene4kaBest folded before Flop (didn't bet)



PokerStars Zoom Hand #84298313632:  Hold'em No Limit ($0.10/$0.25) - 2012/08/05 13:06:54 JST [2012/08/05 0:06:54 ET]
Table 'Whirlpool' 9-max Seat #1 is the button
Seat 1: Zugrug ($25 in chips) 
Seat 2: TraderYao ($24.75 in chips) 
Seat 3: fwani ($42.62 in chips) 
Seat 4: slapshot2011 ($36.79 in chips) 
Seat 5: BlOnDhOlIc ($26.62 in chips) 
Seat 6: chiyuki ($23.20 in chips) 
Seat 7: DooMSDaY1337 ($25.17 in chips) 
Seat 8: masterkoolb ($13.12 in chips) 
Seat 9: KrystalAA ($34.26 in chips) 
TraderYao: posts small blind $0.10
fwani: posts big blind $0.25
*** HOLE CARDS ***
Dealt to chiyuki [Qh 3s]
slapshot2011: raises $0.50 to $0.75
BlOnDhOlIc: folds 
chiyuki: folds 
DooMSDaY1337: folds 
masterkoolb: folds 
KrystalAA: folds 
Zugrug: raises $1.50 to $2.25
TraderYao: folds 
fwani: folds 
slapshot2011: calls $1.50
*** FLOP *** [6s Ad 4h]
slapshot2011: checks 
Zugrug: bets $3
slapshot2011: calls $3
*** TURN *** [6s Ad 4h] [Jh]
slapshot2011: checks 
Zugrug: checks 
*** RIVER *** [6s Ad 4h Jh] [Qd]
slapshot2011: checks 
Zugrug: checks 
*** SHOW DOWN ***
slapshot2011: shows [Kc Ah] (a pair of Aces)
Zugrug: shows [Ac Kh] (a pair of Aces)
slapshot2011 collected $5.18 from pot
Zugrug collected $5.18 from pot
*** SUMMARY ***
Total pot $10.85 | Rake $0.49 
Board [6s Ad 4h Jh Qd]
Seat 1: Zugrug (button) showed [Ac Kh] and won ($5.18) with a pair of Aces
Seat 2: TraderYao (small blind) folded before Flop
Seat 3: fwani (big blind) folded before Flop
Seat 4: slapshot2011 showed [Kc Ah] and won ($5.18) with a pair of Aces
Seat 5: BlOnDhOlIc folded before Flop (didn't bet)
Seat 6: chiyuki folded before Flop (didn't bet)
Seat 7: DooMSDaY1337 folded before Flop (didn't bet)
Seat 8: masterkoolb folded before Flop (didn't bet)
Seat 9: KrystalAA folded before Flop (didn't bet)



PokerStars Zoom Hand #84298303032:  Hold'em No Limit ($0.10/$0.25) - 2012/08/05 13:06:18 JST [2012/08/05 0:06:18 ET]
Table 'Whirlpool' 9-max Seat #1 is the button
Seat 1: fwani ($25 in chips) 
Seat 2: Sharks_Nica ($67.90 in chips) 
Seat 3: silvno31 ($44.73 in chips) 
Seat 4: Lasutchik ($26.92 in chips) 
Seat 5: mid22 ($12.06 in chips) 
Seat 6: chiyuki ($21.27 in chips) 
Seat 7: 2997qwer ($8.57 in chips) 
Seat 8: Alvinpe85 ($26.68 in chips) 
Seat 9: DooMSDaY1337 ($32.64 in chips) 
Sharks_Nica: posts small blind $0.10
silvno31: posts big blind $0.25
*** HOLE CARDS ***
Dealt to chiyuki [8h 3h]
Lasutchik: folds 
mid22: folds 
chiyuki: folds 
2997qwer: folds 
Alvinpe85: folds 
DooMSDaY1337: raises $0.50 to $0.75
fwani: folds 
Sharks_Nica has timed out while being disconnected
Sharks_Nica: folds 
silvno31: folds 
Uncalled bet ($0.50) returned to DooMSDaY1337
DooMSDaY1337 collected $0.60 from pot
DooMSDaY1337: doesn't show hand 
*** SUMMARY ***
Total pot $0.60 | Rake $0 
Seat 1: fwani (button) folded before Flop (didn't bet)
Seat 2: Sharks_Nica (small blind) folded before Flop
Seat 3: silvno31 (big blind) folded before Flop
Seat 4: Lasutchik folded before Flop (didn't bet)
Seat 5: mid22 folded before Flop (didn't bet)
Seat 6: chiyuki folded before Flop (didn't bet)
Seat 7: 2997qwer folded before Flop (didn't bet)
Seat 8: Alvinpe85 folded before Flop (didn't bet)
Seat 9: DooMSDaY1337 collected ($0.60)



PokerStars Zoom Hand #84298321693:  Hold'em No Limit ($0.10/$0.25) - 2012/08/05 13:07:22 JST [2012/08/05 0:07:22 ET]
Table 'Whirlpool' 9-max Seat #1 is the button
Seat 1: TErr18 ($22.33 in chips) 
Seat 2: Roglus ($13.75 in chips) 
Seat 3: chiyuki ($23.55 in chips) 
Seat 4: seula i ($26.03 in chips) 
Seat 5: TraderYao ($25 in chips) 
Seat 6: TankAbbott1 ($38.13 in chips) 
Seat 7: KrystalAA ($20.49 in chips) 
Seat 8: simonzez ($27.36 in chips) 
Seat 9: Zugrug ($25 in chips) 
Roglus: posts small blind $0.10
chiyuki: posts big blind $0.25
*** HOLE CARDS ***
Dealt to chiyuki [Qd 5s]
seula i: folds 
TraderYao: folds 
TankAbbott1: folds 
KrystalAA: folds 
simonzez: calls $0.25
Zugrug: raises $0.50 to $0.75
TErr18: folds 
Roglus: folds 
chiyuki: folds 
simonzez: calls $0.50
*** FLOP *** [5c Ah Ts]
simonzez: checks 
Zugrug: bets $1.25
simonzez: calls $1.25
*** TURN *** [5c Ah Ts] [6d]
simonzez: checks 
Zugrug: checks 
*** RIVER *** [5c Ah Ts 6d] [7c]
simonzez: bets $2.50
Zugrug: folds 
Uncalled bet ($2.50) returned to simonzez
simonzez collected $4.15 from pot
simonzez: doesn't show hand 
*** SUMMARY ***
Total pot $4.35 | Rake $0.20 
Board [5c Ah Ts 6d 7c]
Seat 1: TErr18 (button) folded before Flop (didn't bet)
Seat 2: Roglus (small blind) folded before Flop
Seat 3: chiyuki (big blind) folded before Flop
Seat 4: seula i folded before Flop (didn't bet)
Seat 5: TraderYao folded before Flop (didn't bet)
Seat 6: TankAbbott1 folded before Flop (didn't bet)
Seat 7: KrystalAA folded before Flop (didn't bet)
Seat 8: simonzez collected ($4.15)
Seat 9: Zugrug folded on the River



PokerStars Zoom Hand #84298327888:  Hold'em No Limit ($0.10/$0.25) - 2012/08/05 13:07:43 JST [2012/08/05 0:07:43 ET]
Table 'Whirlpool' 9-max Seat #1 is the button
Seat 1: chiyuki ($23.30 in chips) 
Seat 2: deadmoneykid ($21.65 in chips) 
Seat 3: mikifeio ($33.80 in chips) 
Seat 4: Roglus ($5.04 in chips) 
Seat 5: RomarioJa ($13.99 in chips) 
Seat 6: jamielniak ($26.46 in chips) 
Seat 7: Zugrug ($25 in chips) 
Seat 8: fwani ($29.40 in chips) 
Seat 9: gunbowler ($93.59 in chips) 
deadmoneykid: posts small blind $0.10
mikifeio: posts big blind $0.25
*** HOLE CARDS ***
Dealt to chiyuki [2h Jd]
Roglus: folds 
RomarioJa: folds 
jamielniak: folds 
Zugrug: folds 
fwani: raises $0.35 to $0.60
gunbowler: calls $0.60
chiyuki: folds 
deadmoneykid: calls $0.50
mikifeio: calls $0.35
*** FLOP *** [7h 4d Qd]
deadmoneykid: checks 
mikifeio: checks 
fwani: bets $1.20
gunbowler: folds 
deadmoneykid: calls $1.20
mikifeio: folds 
*** TURN *** [7h 4d Qd] [Kc]
deadmoneykid: checks 
fwani: checks 
*** RIVER *** [7h 4d Qd Kc] [9h]
deadmoneykid: checks 
fwani: checks 
*** SHOW DOWN ***
deadmoneykid: shows [9d 8d] (a pair of Nines)
fwani: shows [Th Qs] (a pair of Queens)
fwani collected $4.58 from pot
*** SUMMARY ***
Total pot $4.80 | Rake $0.22 
Board [7h 4d Qd Kc 9h]
Seat 1: chiyuki (button) folded before Flop (didn't bet)
Seat 2: deadmoneykid (small blind) showed [9d 8d] and lost with a pair of Nines
Seat 3: mikifeio (big blind) folded on the Flop
Seat 4: Roglus folded before Flop (didn't bet)
Seat 5: RomarioJa folded before Flop (didn't bet)
Seat 6: jamielniak folded before Flop (didn't bet)
Seat 7: Zugrug folded before Flop (didn't bet)
Seat 8: fwani showed [Th Qs] and won ($4.58) with a pair of Queens
Seat 9: gunbowler folded on the Flop



PokerStars Zoom Hand #84298329948:  Hold'em No Limit ($0.10/$0.25) - 2012/08/05 13:07:50 JST [2012/08/05 0:07:50 ET]
Table 'Whirlpool' 9-max Seat #1 is the button
Seat 1: jamielniak ($25 in chips) 
Seat 2: chiyuki ($23.30 in chips) 
Seat 3: Th3Fog ($53.35 in chips) 
Seat 4: Zugrug ($25.35 in chips) 
Seat 5: monst3r4119 ($27.28 in chips) 
Seat 6: KrystalAA ($28.25 in chips) 
Seat 7: leo2095 ($16.95 in chips) 
Seat 8: TankAbbott1 ($38.03 in chips) 
Seat 9: PetitAlejo ($25.45 in chips) 
chiyuki: posts small blind $0.10
Th3Fog: posts big blind $0.25
*** HOLE CARDS ***
Dealt to chiyuki [8c 8d]
Zugrug: folds 
monst3r4119: folds 
KrystalAA: folds 
leo2095: folds 
TankAbbott1: raises $0.50 to $0.75
PetitAlejo: calls $0.75
jamielniak: folds 
chiyuki: calls $0.65
Th3Fog: calls $0.50
*** FLOP *** [Kd 4h 7h]
chiyuki: checks 
Th3Fog: checks 
TankAbbott1: checks 
PetitAlejo: checks 
*** TURN *** [Kd 4h 7h] [Kc]
chiyuki: bets $1.43
Th3Fog: calls $1.43
TankAbbott1: folds 
PetitAlejo: folds 
*** RIVER *** [Kd 4h 7h Kc] [Qs]
chiyuki: checks 
Th3Fog: bets $2.46
chiyuki: folds 
Uncalled bet ($2.46) returned to Th3Fog
Th3Fog collected $5.60 from pot
Th3Fog: doesn't show hand 
*** SUMMARY ***
Total pot $5.86 | Rake $0.26 
Board [Kd 4h 7h Kc Qs]
Seat 1: jamielniak (button) folded before Flop (didn't bet)
Seat 2: chiyuki (small blind) folded on the River
Seat 3: Th3Fog (big blind) collected ($5.60)
Seat 4: Zugrug folded before Flop (didn't bet)
Seat 5: monst3r4119 folded before Flop (didn't bet)
Seat 6: KrystalAA folded before Flop (didn't bet)
Seat 7: leo2095 folded before Flop (didn't bet)
Seat 8: TankAbbott1 folded on the Turn
Seat 9: PetitAlejo folded on the Turn



PokerStars Zoom Hand #84298354588:  Hold'em No Limit ($0.10/$0.25) - 2012/08/05 13:09:15 JST [2012/08/05 0:09:15 ET]
Table 'Whirlpool' 9-max Seat #1 is the button
Seat 1: JAMES3FINGER ($332.37 in chips) 
Seat 2: kamikkaze ($46.80 in chips) 
Seat 3: KeLevro0 ($10.95 in chips) 
Seat 4: Medic8681 ($12.50 in chips) 
Seat 5: deadmoneykid ($23.60 in chips) 
Seat 6: chiyuki ($21.12 in chips) 
Seat 7: monst3r4119 ($28.07 in chips) 
Seat 8: s9999999 ($14.67 in chips) 
Seat 9: Alvinpe85 ($25 in chips) 
kamikkaze: posts small blind $0.10
KeLevro0: posts big blind $0.25
*** HOLE CARDS ***
Dealt to chiyuki [Kh 7h]
Medic8681: folds 
deadmoneykid: folds 
chiyuki: folds 
monst3r4119: folds 
s9999999: folds 
Alvinpe85: folds 
JAMES3FINGER: folds 
kamikkaze: raises $0.50 to $0.75
KeLevro0: folds 
Uncalled bet ($0.50) returned to kamikkaze
kamikkaze collected $0.50 from pot
kamikkaze: doesn't show hand 
*** SUMMARY ***
Total pot $0.50 | Rake $0 
Seat 1: JAMES3FINGER (button) folded before Flop (didn't bet)
Seat 2: kamikkaze (small blind) collected ($0.50)
Seat 3: KeLevro0 (big blind) folded before Flop
Seat 4: Medic8681 folded before Flop (didn't bet)
Seat 5: deadmoneykid folded before Flop (didn't bet)
Seat 6: chiyuki folded before Flop (didn't bet)
Seat 7: monst3r4119 folded before Flop (didn't bet)
Seat 8: s9999999 folded before Flop (didn't bet)
Seat 9: Alvinpe85 folded before Flop (didn't bet)



PokerStars Zoom Hand #84298355755:  Hold'em No Limit ($0.10/$0.25) - 2012/08/05 13:09:19 JST [2012/08/05 0:09:19 ET]
Table 'Whirlpool' 9-max Seat #1 is the button
Seat 1: NastyMcNast ($30.97 in chips) 
Seat 2: 2997qwer ($8.22 in chips) 
Seat 3: TankAbbott1 ($25 in chips) 
Seat 4: TraderYao ($25 in chips) 
Seat 5: chiyuki ($21.12 in chips) 
Seat 6: seula i ($52.55 in chips) 
Seat 7: PetitAlejo ($40.62 in chips) 
Seat 8: envious_0007 ($16.80 in chips) 
Seat 9: Lasutchik ($11.90 in chips) 
2997qwer: posts small blind $0.10
TankAbbott1: posts big blind $0.25
*** HOLE CARDS ***
Dealt to chiyuki [3h Qh]
TraderYao: folds 
chiyuki: folds 
seula i: folds 
PetitAlejo: folds 
envious_0007: folds 
Lasutchik: folds 
NastyMcNast: folds 
2997qwer: folds 
Uncalled bet ($0.15) returned to TankAbbott1
TankAbbott1 collected $0.20 from pot
TankAbbott1: doesn't show hand 
*** SUMMARY ***
Total pot $0.20 | Rake $0 
Seat 1: NastyMcNast (button) folded before Flop (didn't bet)
Seat 2: 2997qwer (small blind) folded before Flop
Seat 3: TankAbbott1 (big blind) collected ($0.20)
Seat 4: TraderYao folded before Flop (didn't bet)
Seat 5: chiyuki folded before Flop (didn't bet)
Seat 6: seula i folded before Flop (didn't bet)
Seat 7: PetitAlejo folded before Flop (didn't bet)
Seat 8: envious_0007 folded before Flop (didn't bet)
Seat 9: Lasutchik folded before Flop (didn't bet)



PokerStars Zoom Hand #84298360719:  Hold'em No Limit ($0.10/$0.25) - 2012/08/05 13:09:37 JST [2012/08/05 0:09:37 ET]
Table 'Whirlpool' 9-max Seat #1 is the button
Seat 1: cR!Ma*aRm ($18.48 in chips) 
Seat 2: Medic8681 ($12.50 in chips) 
Seat 3: RomarioJa ($12.50 in chips) 
Seat 4: PetitAlejo ($26.05 in chips) 
Seat 5: BlOnDhOlIc ($36.98 in chips) 
Seat 6: Alvinpe85 ($25 in chips) 
Seat 7: chiyuki ($21.12 in chips) 
Seat 8: SlimeyGash ($22.65 in chips) 
Seat 9: nice.franki ($13.55 in chips) 
Medic8681: posts small blind $0.10
RomarioJa: posts big blind $0.25
*** HOLE CARDS ***
Dealt to chiyuki [7d 9s]
PetitAlejo: folds 
BlOnDhOlIc: folds 
Alvinpe85: raises $0.50 to $0.75
chiyuki: folds 
SlimeyGash: folds 
nice.franki: folds 
cR!Ma*aRm: folds 
Medic8681: folds 
RomarioJa: folds 
Uncalled bet ($0.50) returned to Alvinpe85
Alvinpe85 collected $0.60 from pot
Alvinpe85: doesn't show hand 
*** SUMMARY ***
Total pot $0.60 | Rake $0 
Seat 1: cR!Ma*aRm (button) folded before Flop (didn't bet)
Seat 2: Medic8681 (small blind) folded before Flop
Seat 3: RomarioJa (big blind) folded before Flop
Seat 4: PetitAlejo folded before Flop (didn't bet)
Seat 5: BlOnDhOlIc folded before Flop (didn't bet)
Seat 6: Alvinpe85 collected ($0.60)
Seat 7: chiyuki folded before Flop (didn't bet)
Seat 8: SlimeyGash folded before Flop (didn't bet)
Seat 9: nice.franki folded before Flop (didn't bet)



PokerStars Zoom Hand #84298352777:  Hold'em No Limit ($0.10/$0.25) - 2012/08/05 13:09:09 JST [2012/08/05 0:09:09 ET]
Table 'Whirlpool' 9-max Seat #1 is the button
Seat 1: nice.franki ($12.15 in chips) 
Seat 2: puffy5533 ($20.38 in chips) 
Seat 3: KeLevro0 ($12.40 in chips) 
Seat 4: Th3Fog ($56.77 in chips) 
Seat 5: jtedecaliss ($181.06 in chips) 
Seat 6: TraderYao ($25 in chips) 
Seat 7: D@vidMed ($23.62 in chips) 
Seat 8: chiyuki ($21.12 in chips) 
Seat 9: s9999999 ($14.67 in chips) 
puffy5533: posts small blind $0.10
KeLevro0: posts big blind $0.25
*** HOLE CARDS ***
Dealt to chiyuki [2c 5s]
Th3Fog: raises $0.47 to $0.72
jtedecaliss: calls $0.72
TraderYao: folds 
D@vidMed: folds 
chiyuki: folds 
s9999999: folds 
nice.franki: folds 
puffy5533: folds 
KeLevro0: folds 
*** FLOP *** [6d 7s 6h]
Th3Fog: bets $0.75
jtedecaliss: calls $0.75
*** TURN *** [6d 7s 6h] [Js]
Th3Fog: checks 
jtedecaliss: bets $1.88
Th3Fog: folds 
Uncalled bet ($1.88) returned to jtedecaliss
jtedecaliss collected $3.14 from pot
jtedecaliss: doesn't show hand 
*** SUMMARY ***
Total pot $3.29 | Rake $0.15 
Board [6d 7s 6h Js]
Seat 1: nice.franki (button) folded before Flop (didn't bet)
Seat 2: puffy5533 (small blind) folded before Flop
Seat 3: KeLevro0 (big blind) folded before Flop
Seat 4: Th3Fog folded on the Turn
Seat 5: jtedecaliss collected ($3.14)
Seat 6: TraderYao folded before Flop (didn't bet)
Seat 7: D@vidMed folded before Flop (didn't bet)
Seat 8: chiyuki folded before Flop (didn't bet)
Seat 9: s9999999 folded before Flop (didn't bet)



PokerStars Zoom Hand #84298361916:  Hold'em No Limit ($0.10/$0.25) - 2012/08/05 13:09:41 JST [2012/08/05 0:09:41 ET]
Table 'Whirlpool' 9-max Seat #1 is the button
Seat 1: Rodina-Kr ($25 in chips) 
Seat 2: PetitAlejo ($26.05 in chips) 
Seat 3: chiyuki ($21.12 in chips) 
Seat 4: pyty_82 ($57.24 in chips) 
Seat 5: SlimeyGash ($22.65 in chips) 
Seat 6: cR!Ma*aRm ($18.48 in chips) 
Seat 7: KrystalAA ($38.60 in chips) 
Seat 8: nice.franki ($13.55 in chips) 
Seat 9: Zugrug ($25.91 in chips) 
PetitAlejo: posts small blind $0.10
chiyuki: posts big blind $0.25
*** HOLE CARDS ***
Dealt to chiyuki [Kh 8c]
pyty_82: folds 
SlimeyGash: folds 
cR!Ma*aRm: folds 
KrystalAA: folds 
nice.franki: folds 
Zugrug: raises $0.37 to $0.62
Rodina-Kr: folds 
PetitAlejo: folds 
chiyuki: folds 
Uncalled bet ($0.37) returned to Zugrug
Zugrug collected $0.60 from pot
Zugrug: doesn't show hand 
*** SUMMARY ***
Total pot $0.60 | Rake $0 
Seat 1: Rodina-Kr (button) folded before Flop (didn't bet)
Seat 2: PetitAlejo (small blind) folded before Flop
Seat 3: chiyuki (big blind) folded before Flop
Seat 4: pyty_82 folded before Flop (didn't bet)
Seat 5: SlimeyGash folded before Flop (didn't bet)
Seat 6: cR!Ma*aRm folded before Flop (didn't bet)
Seat 7: KrystalAA folded before Flop (didn't bet)
Seat 8: nice.franki folded before Flop (didn't bet)
Seat 9: Zugrug collected ($0.60)



PokerStars Zoom Hand #84298359047:  Hold'em No Limit ($0.10/$0.25) - 2012/08/05 13:09:30 JST [2012/08/05 0:09:30 ET]
Table 'Whirlpool' 9-max Seat #1 is the button
Seat 1: wtu1986 ($24.65 in chips) 
Seat 2: bigrasbig ($20.37 in chips) 
Seat 3: fwani ($39.07 in chips) 
Seat 4: chiyuki ($21.12 in chips) 
Seat 5: NastyMcNast ($30.67 in chips) 
Seat 6: silvno31 ($42.16 in chips) 
Seat 7: jamielniak ($26.18 in chips) 
Seat 8: seula i ($84.24 in chips) 
Seat 9: Lasutchik ($26.17 in chips) 
bigrasbig: posts small blind $0.10
fwani: posts big blind $0.25
*** HOLE CARDS ***
Dealt to chiyuki [6d Ad]
chiyuki: folds 
NastyMcNast: raises $0.50 to $0.75
silvno31: folds 
jamielniak: folds 
seula i: folds 
Lasutchik has timed out
Lasutchik: folds 
wtu1986: calls $0.75
bigrasbig: folds 
fwani: folds 
*** FLOP *** [2c Td 8h]
NastyMcNast: bets $1.23
wtu1986: folds 
Uncalled bet ($1.23) returned to NastyMcNast
NastyMcNast collected $1.77 from pot
NastyMcNast: doesn't show hand 
*** SUMMARY ***
Total pot $1.85 | Rake $0.08 
Board [2c Td 8h]
Seat 1: wtu1986 (button) folded on the Flop
Seat 2: bigrasbig (small blind) folded before Flop
Seat 3: fwani (big blind) folded before Flop
Seat 4: chiyuki folded before Flop (didn't bet)
Seat 5: NastyMcNast collected ($1.77)
Seat 6: silvno31 folded before Flop (didn't bet)
Seat 7: jamielniak folded before Flop (didn't bet)
Seat 8: seula i folded before Flop (didn't bet)
Seat 9: Lasutchik folded before Flop (didn't bet)



PokerStars Zoom Hand #84298357842:  Hold'em No Limit ($0.10/$0.25) - 2012/08/05 13:09:26 JST [2012/08/05 0:09:26 ET]
Table 'Whirlpool' 9-max Seat #1 is the button
Seat 1: chiyuki ($21.12 in chips) 
Seat 2: Th3Fog ($61.21 in chips) 
Seat 3: TraderYao ($25 in chips) 
Seat 4: BlOnDhOlIc ($25.35 in chips) 
Seat 5: 2997qwer ($13.55 in chips) 
Seat 6: DooMSDaY1337 ($31.13 in chips) 
Seat 7: Lasutchik ($26.17 in chips) 
Seat 8: silvno31 ($42.16 in chips) 
Seat 9: DT_Jesus ($28.97 in chips) 
Th3Fog: posts small blind $0.10
TraderYao: posts big blind $0.25
*** HOLE CARDS ***
Dealt to chiyuki [Ts 5h]
BlOnDhOlIc: folds 
2997qwer: folds 
DooMSDaY1337: raises $0.50 to $0.75
Lasutchik: folds 
silvno31: folds 
DT_Jesus: calls $0.75
chiyuki: folds 
Th3Fog: folds 
TraderYao: calls $0.50
*** FLOP *** [7h 2c Qh]
TraderYao: checks 
DooMSDaY1337: bets $1.12
DT_Jesus: calls $1.12
TraderYao: folds 
*** TURN *** [7h 2c Qh] [Ah]
DooMSDaY1337: bets $2.19
DT_Jesus: raises $2.89 to $5.08
DooMSDaY1337: folds 
Uncalled bet ($2.89) returned to DT_Jesus
DT_Jesus collected $8.57 from pot
DT_Jesus: doesn't show hand 
*** SUMMARY ***
Total pot $8.97 | Rake $0.40 
Board [7h 2c Qh Ah]
Seat 1: chiyuki (button) folded before Flop (didn't bet)
Seat 2: Th3Fog (small blind) folded before Flop
Seat 3: TraderYao (big blind) folded on the Flop
Seat 4: BlOnDhOlIc folded before Flop (didn't bet)
Seat 5: 2997qwer folded before Flop (didn't bet)
Seat 6: DooMSDaY1337 folded on the Turn
Seat 7: Lasutchik folded before Flop (didn't bet)
Seat 8: silvno31 folded before Flop (didn't bet)
Seat 9: DT_Jesus collected ($8.57)



PokerStars Zoom Hand #84298367164:  Hold'em No Limit ($0.10/$0.25) - 2012/08/05 13:09:59 JST [2012/08/05 0:09:59 ET]
Table 'Whirlpool' 9-max Seat #1 is the button
Seat 1: 4ydo yogurt ($16.31 in chips) 
Seat 2: Medic8681 ($12.50 in chips) 
Seat 3: seula i ($63.82 in chips) 
Seat 4: D@vidMed ($25.14 in chips) 
Seat 5: chiyuki ($20.87 in chips) 
Seat 6: Zugrug ($25.45 in chips) 
Seat 7: wtu1986 ($25.95 in chips) 
Seat 8: BlOnDhOlIc ($25 in chips) 
Seat 9: Loholov ($15 in chips) 
Medic8681: posts small blind $0.10
seula i: posts big blind $0.25
*** HOLE CARDS ***
Dealt to chiyuki [As Ks]
D@vidMed: folds 
chiyuki: raises $0.50 to $0.75
Zugrug: folds 
wtu1986: folds 
BlOnDhOlIc: folds 
Loholov: folds 
4ydo yogurt: folds 
Medic8681: folds 
seula i: folds 
Uncalled bet ($0.50) returned to chiyuki
chiyuki collected $0.60 from pot
chiyuki: doesn't show hand 
*** SUMMARY ***
Total pot $0.60 | Rake $0 
Seat 1: 4ydo yogurt (button) folded before Flop (didn't bet)
Seat 2: Medic8681 (small blind) folded before Flop
Seat 3: seula i (big blind) folded before Flop
Seat 4: D@vidMed folded before Flop (didn't bet)
Seat 5: chiyuki collected ($0.60)
Seat 6: Zugrug folded before Flop (didn't bet)
Seat 7: wtu1986 folded before Flop (didn't bet)
Seat 8: BlOnDhOlIc folded before Flop (didn't bet)
Seat 9: Loholov folded before Flop (didn't bet)



PokerStars Zoom Hand #84298365427:  Hold'em No Limit ($0.10/$0.25) - 2012/08/05 13:09:53 JST [2012/08/05 0:09:53 ET]
Table 'Whirlpool' 9-max Seat #1 is the button
Seat 1: KrystalAA ($19.19 in chips) 
Seat 2: Lab50att ($16.67 in chips) 
Seat 3: pyty_82 ($57.24 in chips) 
Seat 4: puffy5533 ($20.03 in chips) 
Seat 5: Medic8681 ($12.50 in chips) 
Seat 6: KeLevro0 ($10.60 in chips) 
Seat 7: gunbowler ($91.79 in chips) 
Seat 8: chiyuki ($20.87 in chips) 
Seat 9: RomarioJa ($10.47 in chips) 
Lab50att: posts small blind $0.10
pyty_82: posts big blind $0.25
*** HOLE CARDS ***
Dealt to chiyuki [Qc 5h]
puffy5533: folds 
Medic8681: folds 
KeLevro0: folds 
gunbowler: raises $0.50 to $0.75
chiyuki: folds 
RomarioJa: folds 
KrystalAA: calls $0.75
Lab50att: folds 
pyty_82: folds 
*** FLOP *** [Kd 8s Ac]
gunbowler: bets $1
KrystalAA: folds 
Uncalled bet ($1) returned to gunbowler
gunbowler collected $1.77 from pot
gunbowler: doesn't show hand 
*** SUMMARY ***
Total pot $1.85 | Rake $0.08 
Board [Kd 8s Ac]
Seat 1: KrystalAA (button) folded on the Flop
Seat 2: Lab50att (small blind) folded before Flop
Seat 3: pyty_82 (big blind) folded before Flop
Seat 4: puffy5533 folded before Flop (didn't bet)
Seat 5: Medic8681 folded before Flop (didn't bet)
Seat 6: KeLevro0 folded before Flop (didn't bet)
Seat 7: gunbowler collected ($1.77)
Seat 8: chiyuki folded before Flop (didn't bet)
Seat 9: RomarioJa folded before Flop (didn't bet)



PokerStars Zoom Hand #84298377467:  Hold'em No Limit ($0.10/$0.25) - 2012/08/05 13:10:34 JST [2012/08/05 0:10:34 ET]
Table 'Whirlpool' 9-max Seat #1 is the button
Seat 1: BlOnDhOlIc ($49.70 in chips) 
Seat 2: bigrasbig ($20.62 in chips) 
Seat 3: Roglus ($22.29 in chips) 
Seat 4: mikifeio ($30.95 in chips) 
Seat 5: Zugrug ($25.10 in chips) 
Seat 6: TankAbbott1 ($25.92 in chips) 
Seat 7: KrystalAA ($14.59 in chips) 
Seat 8: Jippyflip ($24.42 in chips) 
Seat 9: chiyuki ($21.12 in chips) 
bigrasbig: posts small blind $0.10
Roglus: posts big blind $0.25
*** HOLE CARDS ***
Dealt to chiyuki [7c Jc]
mikifeio: raises $0.25 to $0.50
Zugrug: folds 
TankAbbott1: folds 
KrystalAA: folds 
Jippyflip: folds 
chiyuki: folds 
BlOnDhOlIc: folds 
bigrasbig: folds 
Roglus: folds 
Uncalled bet ($0.25) returned to mikifeio
mikifeio collected $0.60 from pot
mikifeio: doesn't show hand 
*** SUMMARY ***
Total pot $0.60 | Rake $0 
Seat 1: BlOnDhOlIc (button) folded before Flop (didn't bet)
Seat 2: bigrasbig (small blind) folded before Flop
Seat 3: Roglus (big blind) folded before Flop
Seat 4: mikifeio collected ($0.60)
Seat 5: Zugrug folded before Flop (didn't bet)
Seat 6: TankAbbott1 folded before Flop (didn't bet)
Seat 7: KrystalAA folded before Flop (didn't bet)
Seat 8: Jippyflip folded before Flop (didn't bet)
Seat 9: chiyuki folded before Flop (didn't bet)



PokerStars Zoom Hand #84298373569:  Hold'em No Limit ($0.10/$0.25) - 2012/08/05 13:10:21 JST [2012/08/05 0:10:21 ET]
Table 'Whirlpool' 9-max Seat #1 is the button
Seat 1: 2997qwer ($7.87 in chips) 
Seat 2: chiyuki ($21.22 in chips) 
Seat 3: RomarioJa ($7.83 in chips) 
Seat 4: jamielniak ($25.43 in chips) 
Seat 5: softdesign ($44.68 in chips) 
Seat 6: Loholov ($15 in chips) 
Seat 7: 4ydo yogurt ($16.21 in chips) 
Seat 8: PetitAlejo ($25 in chips) 
Seat 9: wtu1986 ($25 in chips) 
chiyuki: posts small blind $0.10
RomarioJa: posts big blind $0.25
*** HOLE CARDS ***
Dealt to chiyuki [Kd Jh]
jamielniak: folds 
softdesign: calls $0.25
Loholov: folds 
4ydo yogurt: folds 
PetitAlejo: folds 
wtu1986: raises $0.75 to $1
2997qwer: folds 
chiyuki: folds 
RomarioJa: folds 
softdesign: calls $0.75
*** FLOP *** [4c 9h 5s]
softdesign: checks 
wtu1986: checks 
*** TURN *** [4c 9h 5s] [4h]
softdesign: bets $2
wtu1986: folds 
Uncalled bet ($2) returned to softdesign
softdesign collected $2.24 from pot
softdesign: doesn't show hand 
*** SUMMARY ***
Total pot $2.35 | Rake $0.11 
Board [4c 9h 5s 4h]
Seat 1: 2997qwer (button) folded before Flop (didn't bet)
Seat 2: chiyuki (small blind) folded before Flop
Seat 3: RomarioJa (big blind) folded before Flop
Seat 4: jamielniak folded before Flop (didn't bet)
Seat 5: softdesign collected ($2.24)
Seat 6: Loholov folded before Flop (didn't bet)
Seat 7: 4ydo yogurt folded before Flop (didn't bet)
Seat 8: PetitAlejo folded before Flop (didn't bet)
Seat 9: wtu1986 folded on the Turn



PokerStars Zoom Hand #84298389975:  Hold'em No Limit ($0.10/$0.25) - 2012/08/05 13:11:18 JST [2012/08/05 0:11:18 ET]
Table 'Whirlpool' 9-max Seat #1 is the button
Seat 1: chiyuki ($20.87 in chips) 
Seat 2: PetitAlejo ($25 in chips) 
Seat 3: DanyArdaggo ($27.50 in chips) 
Seat 4: Th3Fog ($23.85 in chips) 
Seat 5: seula i ($63.82 in chips) 
Seat 6: Catrban ($20.28 in chips) 
Seat 7: SlimeyGash ($21.90 in chips) 
Seat 8: KrystalAA ($18.34 in chips) 
Seat 9: wtu1986 ($25.21 in chips) 
PetitAlejo: posts small blind $0.10
DanyArdaggo: posts big blind $0.25
*** HOLE CARDS ***
Dealt to chiyuki [2h 8h]
Th3Fog: folds 
seula i: folds 
Catrban: folds 
SlimeyGash: folds 
KrystalAA: folds 
wtu1986: raises $0.37 to $0.62
chiyuki: folds 
PetitAlejo: raises $1.38 to $2
DanyArdaggo: folds 
wtu1986: folds 
Uncalled bet ($1.38) returned to PetitAlejo
PetitAlejo collected $1.49 from pot
PetitAlejo: doesn't show hand 
*** SUMMARY ***
Total pot $1.49 | Rake $0 
Seat 1: chiyuki (button) folded before Flop (didn't bet)
Seat 2: PetitAlejo (small blind) collected ($1.49)
Seat 3: DanyArdaggo (big blind) folded before Flop
Seat 4: Th3Fog folded before Flop (didn't bet)
Seat 5: seula i folded before Flop (didn't bet)
Seat 6: Catrban folded before Flop (didn't bet)
Seat 7: SlimeyGash folded before Flop (didn't bet)
Seat 8: KrystalAA folded before Flop (didn't bet)
Seat 9: wtu1986 folded before Flop



PokerStars Zoom Hand #84298381825:  Hold'em No Limit ($0.10/$0.25) - 2012/08/05 13:10:49 JST [2012/08/05 0:10:49 ET]
Table 'Whirlpool' 9-max Seat #1 is the button
Seat 1: Jippyflip ($24.42 in chips) 
Seat 2: s9999999 ($29.36 in chips) 
Seat 3: DooMSDaY1337 ($67 in chips) 
Seat 4: chiyuki ($21.12 in chips) 
Seat 5: ll_LaMeR_ll ($38.25 in chips) 
Seat 6: KrystalAA ($14.59 in chips) 
Seat 7: RomarioJa ($12.50 in chips) 
Seat 8: luyifei ($22.91 in chips) 
Seat 9: bigrasbig ($20.52 in chips) 
s9999999: posts small blind $0.10
DooMSDaY1337: posts big blind $0.25
*** HOLE CARDS ***
Dealt to chiyuki [8s Qs]
chiyuki: folds 
ll_LaMeR_ll: raises $0.75 to $1
KrystalAA: folds 
RomarioJa: folds 
luyifei: calls $1
bigrasbig: folds 
Jippyflip: folds 
s9999999: calls $0.90
DooMSDaY1337: folds 
*** FLOP *** [6c 6s As]
s9999999: checks 
ll_LaMeR_ll: checks 
luyifei: bets $0.75
s9999999: calls $0.75
ll_LaMeR_ll: calls $0.75
*** TURN *** [6c 6s As] [4c]
s9999999: bets $1
ll_LaMeR_ll: calls $1
luyifei: calls $1
*** RIVER *** [6c 6s As 4c] [5d]
s9999999: bets $0.80
ll_LaMeR_ll: folds 
luyifei: calls $0.80
*** SHOW DOWN ***
s9999999: shows [Ad 4d] (two pair, Aces and Sixes)
luyifei: shows [Ah 5s] (two pair, Aces and Sixes)
s9999999 collected $4.83 from pot
luyifei collected $4.82 from pot
*** SUMMARY ***
Total pot $10.10 | Rake $0.45 
Board [6c 6s As 4c 5d]
Seat 1: Jippyflip (button) folded before Flop (didn't bet)
Seat 2: s9999999 (small blind) showed [Ad 4d] and won ($4.83) with two pair, Aces and Sixes
Seat 3: DooMSDaY1337 (big blind) folded before Flop
Seat 4: chiyuki folded before Flop (didn't bet)
Seat 5: ll_LaMeR_ll folded on the River
Seat 6: KrystalAA folded before Flop (didn't bet)
Seat 7: RomarioJa folded before Flop (didn't bet)
Seat 8: luyifei showed [Ah 5s] and won ($4.82) with two pair, Aces and Sixes
Seat 9: bigrasbig folded before Flop (didn't bet)



PokerStars Zoom Hand #84298385626:  Hold'em No Limit ($0.10/$0.25) - 2012/08/05 13:11:03 JST [2012/08/05 0:11:03 ET]
Table 'Whirlpool' 9-max Seat #1 is the button
Seat 1: Loholov ($18.97 in chips) 
Seat 2: TErr18 ($21.30 in chips) 
Seat 3: chiyuki ($21.12 in chips) 
Seat 4: Tasman007 ($22.86 in chips) 
Seat 5: fwani ($45.39 in chips) 
Seat 6: envious_0007 ($13.05 in chips) 
Seat 7: Jippyflip ($24.42 in chips) 
Seat 8: doanut13 ($46.03 in chips) 
Seat 9: KeLevro0 ($12.05 in chips) 
TErr18: posts small blind $0.10
chiyuki: posts big blind $0.25
*** HOLE CARDS ***
Dealt to chiyuki [Ks 9d]
Tasman007: raises $0.75 to $1
fwani: folds 
envious_0007: calls $1
Jippyflip: folds 
doanut13: calls $1
KeLevro0: folds 
Loholov: folds 
TErr18: calls $0.90
chiyuki: folds 
*** FLOP *** [Tc 4s 6s]
TErr18: checks 
Tasman007: checks 
envious_0007: checks 
doanut13: checks 
*** TURN *** [Tc 4s 6s] [9c]
TErr18: checks 
Tasman007: checks 
envious_0007: bets $2
doanut13: calls $2
TErr18: folds 
Tasman007: folds 
*** RIVER *** [Tc 4s 6s 9c] [8s]
envious_0007: checks 
doanut13: checks 
*** SHOW DOWN ***
envious_0007: shows [Qc Ac] (high card Ace)
doanut13: shows [7d 5c] (a straight, Six to Ten)
doanut13 collected $7.88 from pot
*** SUMMARY ***
Total pot $8.25 | Rake $0.37 
Board [Tc 4s 6s 9c 8s]
Seat 1: Loholov (button) folded before Flop (didn't bet)
Seat 2: TErr18 (small blind) folded on the Turn
Seat 3: chiyuki (big blind) folded before Flop
Seat 4: Tasman007 folded on the Turn
Seat 5: fwani folded before Flop (didn't bet)
Seat 6: envious_0007 showed [Qc Ac] and lost with high card Ace
Seat 7: Jippyflip folded before Flop (didn't bet)
Seat 8: doanut13 showed [7d 5c] and won ($7.88) with a straight, Six to Ten
Seat 9: KeLevro0 folded before Flop (didn't bet)



PokerStars Zoom Hand #84298394297:  Hold'em No Limit ($0.10/$0.25) - 2012/08/05 13:11:33 JST [2012/08/05 0:11:33 ET]
Table 'Whirlpool' 9-max Seat #1 is the button
Seat 1: puffy5533 ($19.68 in chips) 
Seat 2: lixilox ($22 in chips) 
Seat 3: Alvinpe85 ($25.40 in chips) 
Seat 4: deadmoneykid ($46.85 in chips) 
Seat 5: fwani ($31.23 in chips) 
Seat 6: chiyuki ($20.87 in chips) 
Seat 7: KeLevro0 ($11.68 in chips) 
Seat 8: Loholov ($18.22 in chips) 
Seat 9: Zugrug ($25.91 in chips) 
lixilox: posts small blind $0.10
Alvinpe85: posts big blind $0.25
*** HOLE CARDS ***
Dealt to chiyuki [2h Jh]
deadmoneykid: folds 
fwani: folds 
chiyuki: folds 
KeLevro0: folds 
Loholov: folds 
Zugrug: folds 
puffy5533: folds 
lixilox: calls $0.15
Alvinpe85: raises $0.75 to $1
lixilox: folds 
Uncalled bet ($0.75) returned to Alvinpe85
Alvinpe85 collected $0.50 from pot
Alvinpe85: doesn't show hand 
*** SUMMARY ***
Total pot $0.50 | Rake $0 
Seat 1: puffy5533 (button) folded before Flop (didn't bet)
Seat 2: lixilox (small blind) folded before Flop
Seat 3: Alvinpe85 (big blind) collected ($0.50)
Seat 4: deadmoneykid folded before Flop (didn't bet)
Seat 5: fwani folded before Flop (didn't bet)
Seat 6: chiyuki folded before Flop (didn't bet)
Seat 7: KeLevro0 folded before Flop (didn't bet)
Seat 8: Loholov folded before Flop (didn't bet)
Seat 9: Zugrug folded before Flop (didn't bet)



PokerStars Zoom Hand #84298397454:  Hold'em No Limit ($0.10/$0.25) - 2012/08/05 13:11:44 JST [2012/08/05 0:11:44 ET]
Table 'Whirlpool' 9-max Seat #1 is the button
Seat 1: Zugrug ($26.24 in chips) 
Seat 2: RomarioJa ($10.07 in chips) 
Seat 3: Roglus ($22.17 in chips) 
Seat 4: nice.franki ($12.95 in chips) 
Seat 5: Loholov ($18.22 in chips) 
Seat 6: chiyuki ($20.87 in chips) 
Seat 7: DooMSDaY1337 ($51.74 in chips) 
Seat 8: deadmoneykid ($24.74 in chips) 
Seat 9: Medic8681 ($12.50 in chips) 
RomarioJa: posts small blind $0.10
Roglus: posts big blind $0.25
*** HOLE CARDS ***
Dealt to chiyuki [As 9h]
nice.franki: folds 
Loholov: folds 
chiyuki: folds 
DooMSDaY1337: folds 
deadmoneykid: folds 
Medic8681: folds 
Zugrug: folds 
RomarioJa: folds 
Uncalled bet ($0.15) returned to Roglus
Roglus collected $0.20 from pot
Roglus: doesn't show hand 
*** SUMMARY ***
Total pot $0.20 | Rake $0 
Seat 1: Zugrug (button) folded before Flop (didn't bet)
Seat 2: RomarioJa (small blind) folded before Flop
Seat 3: Roglus (big blind) collected ($0.20)
Seat 4: nice.franki folded before Flop (didn't bet)
Seat 5: Loholov folded before Flop (didn't bet)
Seat 6: chiyuki folded before Flop (didn't bet)
Seat 7: DooMSDaY1337 folded before Flop (didn't bet)
Seat 8: deadmoneykid folded before Flop (didn't bet)
Seat 9: Medic8681 folded before Flop (didn't bet)



PokerStars Zoom Hand #84298396300:  Hold'em No Limit ($0.10/$0.25) - 2012/08/05 13:11:40 JST [2012/08/05 0:11:40 ET]
Table 'Whirlpool' 9-max Seat #1 is the button
Seat 1: DanyArdaggo ($27.25 in chips) 
Seat 2: Jippyflip ($24.17 in chips) 
Seat 3: PetitAlejo ($40.97 in chips) 
Seat 4: Medic8681 ($14.02 in chips) 
Seat 5: fwani ($45.29 in chips) 
Seat 6: DooMSDaY1337 ($51.74 in chips) 
Seat 7: KrystalAA ($14.34 in chips) 
Seat 8: wtu1986 ($25.85 in chips) 
Seat 9: chiyuki ($20.87 in chips) 
Jippyflip: posts small blind $0.10
PetitAlejo: posts big blind $0.25
*** HOLE CARDS ***
Dealt to chiyuki [8s 2s]
Medic8681: folds 
fwani: folds 
DooMSDaY1337: folds 
KrystalAA: folds 
wtu1986: folds 
chiyuki: folds 
DanyArdaggo: raises $0.75 to $1
Jippyflip: folds 
PetitAlejo: folds 
Uncalled bet ($0.75) returned to DanyArdaggo
DanyArdaggo collected $0.60 from pot
DanyArdaggo: doesn't show hand 
*** SUMMARY ***
Total pot $0.60 | Rake $0 
Seat 1: DanyArdaggo (button) collected ($0.60)
Seat 2: Jippyflip (small blind) folded before Flop
Seat 3: PetitAlejo (big blind) folded before Flop
Seat 4: Medic8681 folded before Flop (didn't bet)
Seat 5: fwani folded before Flop (didn't bet)
Seat 6: DooMSDaY1337 folded before Flop (didn't bet)
Seat 7: KrystalAA folded before Flop (didn't bet)
Seat 8: wtu1986 folded before Flop (didn't bet)
Seat 9: chiyuki folded before Flop (didn't bet)



PokerStars Zoom Hand #84298392516:  Hold'em No Limit ($0.10/$0.25) - 2012/08/05 13:11:27 JST [2012/08/05 0:11:27 ET]
Table 'Whirlpool' 9-max Seat #1 is the button
Seat 1: simonzez ($30.42 in chips) 
Seat 2: Th3Fog ($55.30 in chips) 
Seat 3: RomarioJa ($10.32 in chips) 
Seat 4: Lab50att ($14.32 in chips) 
Seat 5: 4ydo yogurt ($17.35 in chips) 
Seat 6: taksist889 ($34.40 in chips) 
Seat 7: chiyuki ($20.87 in chips) 
Seat 8: nice.franki ($11.80 in chips) 
Seat 9: seula i ($63.82 in chips) 
Th3Fog: posts small blind $0.10
RomarioJa: posts big blind $0.25
*** HOLE CARDS ***
Dealt to chiyuki [2s Jc]
Lab50att: folds 
4ydo yogurt: folds 
taksist889: folds 
chiyuki: folds 
nice.franki: folds 
seula i: folds 
simonzez: calls $0.25
Th3Fog: raises $0.60 to $0.85
RomarioJa: folds 
simonzez: calls $0.60
*** FLOP *** [8d 6d 5s]
Th3Fog: bets $1.09
simonzez: raises $1.09 to $2.18
Th3Fog: calls $1.09
*** TURN *** [8d 6d 5s] [7c]
Th3Fog: checks 
simonzez: bets $1.25
Th3Fog: calls $1.25
*** RIVER *** [8d 6d 5s 7c] [9s]
Th3Fog: checks 
simonzez: bets $1
Th3Fog: calls $1
*** SHOW DOWN ***
simonzez: shows [7h 5h] (a straight, Five to Nine)
Th3Fog: shows [Qd Kd] (a straight, Five to Nine)
Th3Fog collected $5.16 from pot
simonzez collected $5.16 from pot
*** SUMMARY ***
Total pot $10.81 | Rake $0.49 
Board [8d 6d 5s 7c 9s]
Seat 1: simonzez (button) showed [7h 5h] and won ($5.16) with a straight, Five to Nine
Seat 2: Th3Fog (small blind) showed [Qd Kd] and won ($5.16) with a straight, Five to Nine
Seat 3: RomarioJa (big blind) folded before Flop
Seat 4: Lab50att folded before Flop (didn't bet)
Seat 5: 4ydo yogurt folded before Flop (didn't bet)
Seat 6: taksist889 folded before Flop (didn't bet)
Seat 7: chiyuki folded before Flop (didn't bet)
Seat 8: nice.franki folded before Flop (didn't bet)
Seat 9: seula i folded before Flop (didn't bet)



PokerStars Zoom Hand #84298399512:  Hold'em No Limit ($0.10/$0.25) - 2012/08/05 13:11:51 JST [2012/08/05 0:11:51 ET]
Table 'Whirlpool' 9-max Seat #1 is the button
Seat 1: lixilox ($21.75 in chips) 
Seat 2: chiyuki ($20.87 in chips) 
Seat 3: ll_LaMeR_ll ($35.50 in chips) 
Seat 4: Zugrug ($26.24 in chips) 
Seat 5: Th3Fog ($23.60 in chips) 
Seat 6: deadmoneykid ($24.74 in chips) 
Seat 7: s9999999 ($30.64 in chips) 
Seat 8: DooMSDaY1337 ($28.87 in chips) 
Seat 9: KeLevro0 ($11.43 in chips) 
chiyuki: posts small blind $0.10
ll_LaMeR_ll: posts big blind $0.25
*** HOLE CARDS ***
Dealt to chiyuki [Ks As]
Zugrug: folds 
Th3Fog: raises $0.50 to $0.75
deadmoneykid: folds 
s9999999: folds 
DooMSDaY1337: folds 
KeLevro0: folds 
lixilox: folds 
chiyuki: raises $1.50 to $2.25
ll_LaMeR_ll: folds 
Th3Fog: folds 
Uncalled bet ($1.50) returned to chiyuki
chiyuki collected $1.75 from pot
chiyuki: doesn't show hand 
*** SUMMARY ***
Total pot $1.75 | Rake $0 
Seat 1: lixilox (button) folded before Flop (didn't bet)
Seat 2: chiyuki (small blind) collected ($1.75)
Seat 3: ll_LaMeR_ll (big blind) folded before Flop
Seat 4: Zugrug folded before Flop (didn't bet)
Seat 5: Th3Fog folded before Flop
Seat 6: deadmoneykid folded before Flop (didn't bet)
Seat 7: s9999999 folded before Flop (didn't bet)
Seat 8: DooMSDaY1337 folded before Flop (didn't bet)
Seat 9: KeLevro0 folded before Flop (didn't bet)



PokerStars Zoom Hand #84298407966:  Hold'em No Limit ($0.10/$0.25) - 2012/08/05 13:12:21 JST [2012/08/05 0:12:21 ET]
Table 'Whirlpool' 9-max Seat #1 is the button
Seat 1: PetitAlejo ($40.62 in chips) 
Seat 2: Lab50att ($13.70 in chips) 
Seat 3: seula i ($79.14 in chips) 
Seat 4: Loholov ($15.53 in chips) 
Seat 5: RomarioJa ($10.54 in chips) 
Seat 6: wtu1986 ($25.85 in chips) 
Seat 7: Rodina-Kr ($25 in chips) 
Seat 8: chiyuki ($21.87 in chips) 
Seat 9: DooMSDaY1337 ($51.39 in chips) 
Lab50att: posts small blind $0.10
seula i: posts big blind $0.25
*** HOLE CARDS ***
Dealt to chiyuki [Ks Jh]
Loholov: folds 
RomarioJa: folds 
wtu1986: folds 
Rodina-Kr: raises $0.45 to $0.70
chiyuki: folds 
DooMSDaY1337: folds 
PetitAlejo: folds 
Lab50att: folds 
seula i: raises $1.80 to $2.50
Rodina-Kr: folds 
Uncalled bet ($1.80) returned to seula i
seula i collected $1.50 from pot
seula i: doesn't show hand 
*** SUMMARY ***
Total pot $1.50 | Rake $0 
Seat 1: PetitAlejo (button) folded before Flop (didn't bet)
Seat 2: Lab50att (small blind) folded before Flop
Seat 3: seula i (big blind) collected ($1.50)
Seat 4: Loholov folded before Flop (didn't bet)
Seat 5: RomarioJa folded before Flop (didn't bet)
Seat 6: wtu1986 folded before Flop (didn't bet)
Seat 7: Rodina-Kr folded before Flop
Seat 8: chiyuki folded before Flop (didn't bet)
Seat 9: DooMSDaY1337 folded before Flop (didn't bet)



PokerStars Zoom Hand #84298415927:  Hold'em No Limit ($0.10/$0.25) - 2012/08/05 13:12:49 JST [2012/08/05 0:12:49 ET]
Table 'Whirlpool' 9-max Seat #1 is the button
Seat 1: kamikkaze ($49.83 in chips) 
Seat 2: ShevchukAI ($12.25 in chips) 
Seat 3: wtu1986 ($24.94 in chips) 
Seat 4: petersmiths ($33.66 in chips) 
Seat 5: chiyuki ($21.87 in chips) 
Seat 6: bigrasbig ($37.28 in chips) 
Seat 7: cR!Ma*aRm ($18.05 in chips) 
Seat 8: mikifeio ($49.74 in chips) 
Seat 9: DooMSDaY1337 ($67 in chips) 
ShevchukAI: posts small blind $0.10
wtu1986: posts big blind $0.25
*** HOLE CARDS ***
Dealt to chiyuki [2h Th]
petersmiths: folds 
chiyuki: folds 
bigrasbig: folds 
cR!Ma*aRm: folds 
mikifeio: folds 
DooMSDaY1337: folds 
kamikkaze: folds 
ShevchukAI: folds 
Uncalled bet ($0.15) returned to wtu1986
wtu1986 collected $0.20 from pot
wtu1986: doesn't show hand 
*** SUMMARY ***
Total pot $0.20 | Rake $0 
Seat 1: kamikkaze (button) folded before Flop (didn't bet)
Seat 2: ShevchukAI (small blind) folded before Flop
Seat 3: wtu1986 (big blind) collected ($0.20)
Seat 4: petersmiths folded before Flop (didn't bet)
Seat 5: chiyuki folded before Flop (didn't bet)
Seat 6: bigrasbig folded before Flop (didn't bet)
Seat 7: cR!Ma*aRm folded before Flop (didn't bet)
Seat 8: mikifeio folded before Flop (didn't bet)
Seat 9: DooMSDaY1337 folded before Flop (didn't bet)



PokerStars Zoom Hand #84298413942:  Hold'em No Limit ($0.10/$0.25) - 2012/08/05 13:12:42 JST [2012/08/05 0:12:42 ET]
Table 'Whirlpool' 9-max Seat #1 is the button
Seat 1: KeLevro0 ($9.47 in chips) 
Seat 2: fwani ($25 in chips) 
Seat 3: s9999999 ($30.64 in chips) 
Seat 4: chiyuki ($21.87 in chips) 
Seat 5: seula i ($25.13 in chips) 
Seat 6: masterkoolb ($12.50 in chips) 
Seat 7: a_tasmanian ($53.82 in chips) 
Seat 8: DooMSDaY1337 ($67 in chips) 
Seat 9: TraderYao ($36.02 in chips) 
fwani: posts small blind $0.10
s9999999: posts big blind $0.25
*** HOLE CARDS ***
Dealt to chiyuki [4c Kd]
chiyuki: folds 
seula i: folds 
masterkoolb: folds 
a_tasmanian: folds 
DooMSDaY1337: folds 
TraderYao: folds 
KeLevro0: folds 
fwani: raises $0.35 to $0.60
s9999999: calls $0.35
*** FLOP *** [7s Qd Jd]
fwani: bets $0.60
s9999999: raises $1.40 to $2
fwani: folds 
Uncalled bet ($1.40) returned to s9999999
s9999999 collected $2.29 from pot
s9999999: doesn't show hand 
*** SUMMARY ***
Total pot $2.40 | Rake $0.11 
Board [7s Qd Jd]
Seat 1: KeLevro0 (button) folded before Flop (didn't bet)
Seat 2: fwani (small blind) folded on the Flop
Seat 3: s9999999 (big blind) collected ($2.29)
Seat 4: chiyuki folded before Flop (didn't bet)
Seat 5: seula i folded before Flop (didn't bet)
Seat 6: masterkoolb folded before Flop (didn't bet)
Seat 7: a_tasmanian folded before Flop (didn't bet)
Seat 8: DooMSDaY1337 folded before Flop (didn't bet)
Seat 9: TraderYao folded before Flop (didn't bet)



PokerStars Zoom Hand #84298412529:  Hold'em No Limit ($0.10/$0.25) - 2012/08/05 13:12:37 JST [2012/08/05 0:12:37 ET]
Table 'Whirlpool' 9-max Seat #1 is the button
Seat 1: chiyuki ($21.87 in chips) 
Seat 2: 2997qwer ($13.20 in chips) 
Seat 3: KrystalAA ($17.63 in chips) 
Seat 4: TraderYao ($36.02 in chips) 
Seat 5: doanut13 ($49.66 in chips) 
Seat 6: PetitAlejo ($25.87 in chips) 
Seat 7: Zugrug ($40.58 in chips) 
Seat 8: Rodina-Kr ($25 in chips) 
Seat 9: BlOnDhOlIc ($25.25 in chips) 
2997qwer: posts small blind $0.10
KrystalAA: posts big blind $0.25
*** HOLE CARDS ***
Dealt to chiyuki [2d 9c]
TraderYao: folds 
doanut13: calls $0.25
PetitAlejo: folds 
Zugrug: folds 
Rodina-Kr: folds 
BlOnDhOlIc: folds 
chiyuki: folds 
2997qwer: folds 
KrystalAA: checks 
*** FLOP *** [5h 5s 4c]
KrystalAA: bets $0.43
doanut13: calls $0.43
*** TURN *** [5h 5s 4c] [2h]
KrystalAA: checks 
doanut13: checks 
*** RIVER *** [5h 5s 4c 2h] [4d]
KrystalAA: bets $1.07
doanut13: calls $1.07
*** SHOW DOWN ***
KrystalAA: shows [6s 4s] (a full house, Fours full of Fives)
doanut13: mucks hand 
KrystalAA collected $3.44 from pot
*** SUMMARY ***
Total pot $3.60 | Rake $0.16 
Board [5h 5s 4c 2h 4d]
Seat 1: chiyuki (button) folded before Flop (didn't bet)
Seat 2: 2997qwer (small blind) folded before Flop
Seat 3: KrystalAA (big blind) showed [6s 4s] and won ($3.44) with a full house, Fours full of Fives
Seat 4: TraderYao folded before Flop (didn't bet)
Seat 5: doanut13 mucked [As Tc]
Seat 6: PetitAlejo folded before Flop (didn't bet)
Seat 7: Zugrug folded before Flop (didn't bet)
Seat 8: Rodina-Kr folded before Flop (didn't bet)
Seat 9: BlOnDhOlIc folded before Flop (didn't bet)



PokerStars Zoom Hand #84298417070:  Hold'em No Limit ($0.10/$0.25) - 2012/08/05 13:12:53 JST [2012/08/05 0:12:53 ET]
Table 'Whirlpool' 9-max Seat #1 is the button
Seat 1: bigrasbig ($37.28 in chips) 
Seat 2: 4ydo yogurt ($19.77 in chips) 
Seat 3: chiyuki ($21.87 in chips) 
Seat 4: KeLevro0 ($8.55 in chips) 
Seat 5: Alvinpe85 ($25 in chips) 
Seat 6: cR!Ma*aRm ($18.05 in chips) 
Seat 7: Lab50att ($13.60 in chips) 
Seat 8: deadmoneykid ($20.75 in chips) 
Seat 9: DanyArdaggo ($27.85 in chips) 
4ydo yogurt: posts small blind $0.10
chiyuki: posts big blind $0.25
*** HOLE CARDS ***
Dealt to chiyuki [9s 2s]
KeLevro0: folds 
Alvinpe85: raises $0.50 to $0.75
cR!Ma*aRm: folds 
Lab50att: calls $0.75
deadmoneykid: folds 
DanyArdaggo: folds 
bigrasbig: folds 
4ydo yogurt: folds 
chiyuki: folds 
*** FLOP *** [Ad 5s 4h]
Alvinpe85: bets $1.06
Lab50att: calls $1.06
*** TURN *** [Ad 5s 4h] [6c]
Alvinpe85: checks 
Lab50att: bets $1.75
Alvinpe85: folds 
Uncalled bet ($1.75) returned to Lab50att
Lab50att collected $3.79 from pot
Lab50att: doesn't show hand 
*** SUMMARY ***
Total pot $3.97 | Rake $0.18 
Board [Ad 5s 4h 6c]
Seat 1: bigrasbig (button) folded before Flop (didn't bet)
Seat 2: 4ydo yogurt (small blind) folded before Flop
Seat 3: chiyuki (big blind) folded before Flop
Seat 4: KeLevro0 folded before Flop (didn't bet)
Seat 5: Alvinpe85 folded on the Turn
Seat 6: cR!Ma*aRm folded before Flop (didn't bet)
Seat 7: Lab50att collected ($3.79)
Seat 8: deadmoneykid folded before Flop (didn't bet)
Seat 9: DanyArdaggo folded before Flop (didn't bet)



PokerStars Zoom Hand #84298422296:  Hold'em No Limit ($0.10/$0.25) - 2012/08/05 13:13:11 JST [2012/08/05 0:13:11 ET]
Table 'Whirlpool' 9-max Seat #1 is the button
Seat 1: fwani ($45.29 in chips) 
Seat 2: gedavaca ($25 in chips) 
Seat 3: BlOnDhOlIc ($25.25 in chips) 
Seat 4: cR!Ma*aRm ($18.05 in chips) 
Seat 5: chiyuki ($21.62 in chips) 
Seat 6: Jippyflip ($23.39 in chips) 
Seat 7: deadmoneykid ($24.29 in chips) 
Seat 8: Th3Fog ($65.66 in chips) 
Seat 9: Zugrug ($25.56 in chips) 
gedavaca: posts small blind $0.10
BlOnDhOlIc: posts big blind $0.25
*** HOLE CARDS ***
Dealt to chiyuki [As Kh]
cR!Ma*aRm: calls $0.25
chiyuki: raises $0.75 to $1
Jippyflip: folds 
deadmoneykid: calls $1
Th3Fog: folds 
Zugrug: folds 
fwani: folds 
gedavaca: folds 
BlOnDhOlIc: folds 
cR!Ma*aRm: calls $0.75
*** FLOP *** [Qd 5s 9d]
cR!Ma*aRm: bets $1
chiyuki: folds 
deadmoneykid: folds 
Uncalled bet ($1) returned to cR!Ma*aRm
cR!Ma*aRm collected $3.20 from pot
cR!Ma*aRm: doesn't show hand 
*** SUMMARY ***
Total pot $3.35 | Rake $0.15 
Board [Qd 5s 9d]
Seat 1: fwani (button) folded before Flop (didn't bet)
Seat 2: gedavaca (small blind) folded before Flop
Seat 3: BlOnDhOlIc (big blind) folded before Flop
Seat 4: cR!Ma*aRm collected ($3.20)
Seat 5: chiyuki folded on the Flop
Seat 6: Jippyflip folded before Flop (didn't bet)
Seat 7: deadmoneykid folded on the Flop
Seat 8: Th3Fog folded before Flop (didn't bet)
Seat 9: Zugrug folded before Flop (didn't bet)



PokerStars Zoom Hand #84298437939:  Hold'em No Limit ($0.10/$0.25) - 2012/08/05 13:14:07 JST [2012/08/05 0:14:07 ET]
Table 'Whirlpool' 9-max Seat #1 is the button
Seat 1: deadmoneykid ($25.27 in chips) 
Seat 2: chiyuki ($20.62 in chips) 
Seat 3: nice.franki ($8.22 in chips) 
Seat 4: DooMSDaY1337 ($67.91 in chips) 
Seat 5: KeLevro0 ($8.20 in chips) 
Seat 6: Zugrug ($25 in chips) 
Seat 7: agurio ($25 in chips) 
Seat 8: Suhoff76 ($25 in chips) 
Seat 9: PetitAlejo ($25.52 in chips) 
chiyuki: posts small blind $0.10
nice.franki: posts big blind $0.25
*** HOLE CARDS ***
Dealt to chiyuki [2c 3h]
DooMSDaY1337: folds 
KeLevro0: folds 
Zugrug: folds 
agurio: folds 
Suhoff76: folds 
PetitAlejo: folds 
deadmoneykid: folds 
chiyuki: folds 
Uncalled bet ($0.15) returned to nice.franki
nice.franki collected $0.20 from pot
nice.franki: doesn't show hand 
*** SUMMARY ***
Total pot $0.20 | Rake $0 
Seat 1: deadmoneykid (button) folded before Flop (didn't bet)
Seat 2: chiyuki (small blind) folded before Flop
Seat 3: nice.franki (big blind) collected ($0.20)
Seat 4: DooMSDaY1337 folded before Flop (didn't bet)
Seat 5: KeLevro0 folded before Flop (didn't bet)
Seat 6: Zugrug folded before Flop (didn't bet)
Seat 7: agurio folded before Flop (didn't bet)
Seat 8: Suhoff76 folded before Flop (didn't bet)
Seat 9: PetitAlejo folded before Flop (didn't bet)



PokerStars Zoom Hand #84298441401:  Hold'em No Limit ($0.10/$0.25) - 2012/08/05 13:14:19 JST [2012/08/05 0:14:19 ET]
Table 'Whirlpool' 9-max Seat #1 is the button
Seat 1: simonzez ($38.34 in chips) 
Seat 2: TankAbbott1 ($40.84 in chips) 
Seat 3: masterkoolb ($12.50 in chips) 
Seat 4: RomarioJa ($9.44 in chips) 
Seat 5: Alvinpe85 ($27.86 in chips) 
Seat 6: Loholov ($15 in chips) 
Seat 7: eagie20 ($148.81 in chips) 
Seat 8: deadmoneykid ($25.27 in chips) 
Seat 9: chiyuki ($20.52 in chips) 
TankAbbott1: posts small blind $0.10
masterkoolb: posts big blind $0.25
*** HOLE CARDS ***
Dealt to chiyuki [Ac 8s]
RomarioJa: folds 
Alvinpe85: folds 
Loholov: raises $0.50 to $0.75
eagie20: folds 
deadmoneykid: raises $1.25 to $2
chiyuki: folds 
simonzez: folds 
TankAbbott1: folds 
masterkoolb: folds 
Loholov: calls $1.25
*** FLOP *** [6s 5h 6h]
Loholov: checks 
deadmoneykid: bets $3
Loholov: raises $4 to $7
deadmoneykid: raises $16.27 to $23.27 and is all-in
Loholov: calls $6 and is all-in
Uncalled bet ($10.27) returned to deadmoneykid
*** TURN *** [6s 5h 6h] [3s]
*** RIVER *** [6s 5h 6h 3s] [2d]
*** SHOW DOWN ***
Loholov: shows [Ts Td] (two pair, Tens and Sixes)
deadmoneykid: shows [Kd Kh] (two pair, Kings and Sixes)
deadmoneykid collected $28.98 from pot
*** SUMMARY ***
Total pot $30.35 | Rake $1.37 
Board [6s 5h 6h 3s 2d]
Seat 1: simonzez (button) folded before Flop (didn't bet)
Seat 2: TankAbbott1 (small blind) folded before Flop
Seat 3: masterkoolb (big blind) folded before Flop
Seat 4: RomarioJa folded before Flop (didn't bet)
Seat 5: Alvinpe85 folded before Flop (didn't bet)
Seat 6: Loholov showed [Ts Td] and lost with two pair, Tens and Sixes
Seat 7: eagie20 folded before Flop (didn't bet)
Seat 8: deadmoneykid showed [Kd Kh] and won ($28.98) with two pair, Kings and Sixes
Seat 9: chiyuki folded before Flop (didn't bet)



PokerStars Zoom Hand #84298445084:  Hold'em No Limit ($0.10/$0.25) - 2012/08/05 13:14:33 JST [2012/08/05 0:14:33 ET]
Table 'Whirlpool' 9-max Seat #1 is the button
Seat 1: slickthis ($23.35 in chips) 
Seat 2: wtu1986 ($25.35 in chips) 
Seat 3: Roglus ($11.27 in chips) 
Seat 4: luyifei ($22.68 in chips) 
Seat 5: BlOnDhOlIc ($25 in chips) 
Seat 6: SlimeyGash ($22.39 in chips) 
Seat 7: ryanjp2323 ($30.97 in chips) 
Seat 8: chiyuki ($20.52 in chips) 
Seat 9: TErr18 ($14.09 in chips) 
wtu1986: posts small blind $0.10
Roglus: posts big blind $0.25
*** HOLE CARDS ***
Dealt to chiyuki [3d 3h]
luyifei: folds 
BlOnDhOlIc: folds 
SlimeyGash: folds 
ryanjp2323: folds 
chiyuki: raises $0.50 to $0.75
TErr18: folds 
slickthis: folds 
wtu1986: folds 
Roglus: calls $0.50
*** FLOP *** [Ad 5s Ts]
Roglus: checks 
chiyuki: bets $0.76
Roglus: calls $0.76
*** TURN *** [Ad 5s Ts] [Js]
Roglus: checks 
chiyuki: checks 
*** RIVER *** [Ad 5s Ts Js] [8h]
Roglus: checks 
chiyuki: checks 
*** SHOW DOWN ***
Roglus: shows [Th Kh] (a pair of Tens)
chiyuki: mucks hand 
Roglus collected $2.98 from pot
*** SUMMARY ***
Total pot $3.12 | Rake $0.14 
Board [Ad 5s Ts Js 8h]
Seat 1: slickthis (button) folded before Flop (didn't bet)
Seat 2: wtu1986 (small blind) folded before Flop
Seat 3: Roglus (big blind) showed [Th Kh] and won ($2.98) with a pair of Tens
Seat 4: luyifei folded before Flop (didn't bet)
Seat 5: BlOnDhOlIc folded before Flop (didn't bet)
Seat 6: SlimeyGash folded before Flop (didn't bet)
Seat 7: ryanjp2323 folded before Flop (didn't bet)
Seat 8: chiyuki mucked [3d 3h]
Seat 9: TErr18 folded before Flop (didn't bet)



PokerStars Zoom Hand #84298459489:  Hold'em No Limit ($0.10/$0.25) - 2012/08/05 13:15:23 JST [2012/08/05 0:15:23 ET]
Table 'Whirlpool' 9-max Seat #1 is the button
Seat 1: chiyuki ($25 in chips) 
Seat 2: masterkoolb ($12.50 in chips) 
Seat 3: mikifeio ($47.99 in chips) 
Seat 4: Jippyflip ($26.11 in chips) 
Seat 5: PetitAlejo ($28.83 in chips) 
Seat 6: pyty_82 ($59.94 in chips) 
Seat 7: DooMSDaY1337 ($34.02 in chips) 
Seat 8: Suhoff76 ($25 in chips) 
Seat 9: softdesign ($52.92 in chips) 
masterkoolb: posts small blind $0.10
mikifeio: posts big blind $0.25
*** HOLE CARDS ***
Dealt to chiyuki [8c 3s]
Jippyflip: folds 
PetitAlejo: folds 
pyty_82: folds 
DooMSDaY1337: folds 
Suhoff76: raises $0.50 to $0.75
softdesign: folds 
chiyuki: folds 
masterkoolb: folds 
mikifeio: folds 
Uncalled bet ($0.50) returned to Suhoff76
Suhoff76 collected $0.60 from pot
Suhoff76: doesn't show hand 
*** SUMMARY ***
Total pot $0.60 | Rake $0 
Seat 1: chiyuki (button) folded before Flop (didn't bet)
Seat 2: masterkoolb (small blind) folded before Flop
Seat 3: mikifeio (big blind) folded before Flop
Seat 4: Jippyflip folded before Flop (didn't bet)
Seat 5: PetitAlejo folded before Flop (didn't bet)
Seat 6: pyty_82 folded before Flop (didn't bet)
Seat 7: DooMSDaY1337 folded before Flop (didn't bet)
Seat 8: Suhoff76 collected ($0.60)
Seat 9: softdesign folded before Flop (didn't bet)



PokerStars Zoom Hand #84298462381:  Hold'em No Limit ($0.10/$0.25) - 2012/08/05 13:15:33 JST [2012/08/05 0:15:33 ET]
Table 'Whirlpool' 9-max Seat #1 is the button
Seat 1: Roglus ($12.64 in chips) 
Seat 2: pyty_82 ($59.94 in chips) 
Seat 3: TraderYao ($24.90 in chips) 
Seat 4: PetitAlejo ($27.35 in chips) 
Seat 5: Zugrug ($26.85 in chips) 
Seat 6: chiyuki ($25 in chips) 
Seat 7: silvno31 ($18.63 in chips) 
Seat 8: Suhoff76 ($25 in chips) 
Seat 9: DonSimonUsa ($23.83 in chips) 
pyty_82: posts small blind $0.10
TraderYao: posts big blind $0.25
*** HOLE CARDS ***
Dealt to chiyuki [3d 2s]
PetitAlejo: folds 
Zugrug: folds 
chiyuki: folds 
silvno31: folds 
Suhoff76: folds 
DonSimonUsa: folds 
Roglus: raises $0.50 to $0.75
pyty_82: folds 
TraderYao: folds 
Uncalled bet ($0.50) returned to Roglus
Roglus collected $0.60 from pot
Roglus: doesn't show hand 
*** SUMMARY ***
Total pot $0.60 | Rake $0 
Seat 1: Roglus (button) collected ($0.60)
Seat 2: pyty_82 (small blind) folded before Flop
Seat 3: TraderYao (big blind) folded before Flop
Seat 4: PetitAlejo folded before Flop (didn't bet)
Seat 5: Zugrug folded before Flop (didn't bet)
Seat 6: chiyuki folded before Flop (didn't bet)
Seat 7: silvno31 folded before Flop (didn't bet)
Seat 8: Suhoff76 folded before Flop (didn't bet)
Seat 9: DonSimonUsa folded before Flop (didn't bet)



PokerStars Zoom Hand #84298458350:  Hold'em No Limit ($0.10/$0.25) - 2012/08/05 13:15:19 JST [2012/08/05 0:15:19 ET]
Table 'Whirlpool' 9-max Seat #1 is the button
Seat 1: Loholov ($20.67 in chips) 
Seat 2: 4ydo yogurt ($19.01 in chips) 
Seat 3: puffy5533 ($19.23 in chips) 
Seat 4: TraderYao ($24.90 in chips) 
Seat 5: Zugrug ($25.95 in chips) 
Seat 6: TankAbbott1 ($40.74 in chips) 
Seat 7: chiyuki ($25 in chips) 
Seat 8: nice.franki ($12.37 in chips) 
Seat 9: Th3Fog ($60.30 in chips) 
4ydo yogurt: posts small blind $0.10
puffy5533: posts big blind $0.25
*** HOLE CARDS ***
Dealt to chiyuki [8h 9c]
TraderYao: folds 
Zugrug: folds 
TankAbbott1: folds 
chiyuki: folds 
nice.franki: folds 
Th3Fog: folds 
Loholov: folds 
4ydo yogurt: raises $0.25 to $0.50
puffy5533: calls $0.25
*** FLOP *** [Ah 9s 3h]
4ydo yogurt: bets $0.50
puffy5533: folds 
Uncalled bet ($0.50) returned to 4ydo yogurt
4ydo yogurt collected $0.96 from pot
4ydo yogurt: doesn't show hand 
*** SUMMARY ***
Total pot $1 | Rake $0.04 
Board [Ah 9s 3h]
Seat 1: Loholov (button) folded before Flop (didn't bet)
Seat 2: 4ydo yogurt (small blind) collected ($0.96)
Seat 3: puffy5533 (big blind) folded on the Flop
Seat 4: TraderYao folded before Flop (didn't bet)
Seat 5: Zugrug folded before Flop (didn't bet)
Seat 6: TankAbbott1 folded before Flop (didn't bet)
Seat 7: chiyuki folded before Flop (didn't bet)
Seat 8: nice.franki folded before Flop (didn't bet)
Seat 9: Th3Fog folded before Flop (didn't bet)



PokerStars Zoom Hand #84298464396:  Hold'em No Limit ($0.10/$0.25) - 2012/08/05 13:15:41 JST [2012/08/05 0:15:41 ET]
Table 'Whirlpool' 9-max Seat #1 is the button
Seat 1: KINGKILERACE ($21.48 in chips) 
Seat 2: 5zzzz33 ($20.87 in chips) 
Seat 3: chiyuki ($25 in chips) 
Seat 4: DooMSDaY1337 ($34.02 in chips) 
Seat 5: BlOnDhOlIc ($50.68 in chips) 
Seat 6: KeLevro0 ($7.17 in chips) 
Seat 7: kamikkaze ($49.58 in chips) 
Seat 8: SlimeyGash ($23.62 in chips) 
Seat 9: Rsonal ($9.47 in chips) 
5zzzz33: posts small blind $0.10
chiyuki: posts big blind $0.25
*** HOLE CARDS ***
Dealt to chiyuki [7d Ad]
DooMSDaY1337: folds 
BlOnDhOlIc: folds 
KeLevro0: folds 
kamikkaze: folds 
SlimeyGash: folds 
Rsonal: raises $0.50 to $0.75
KINGKILERACE: folds 
5zzzz33: folds 
chiyuki: calls $0.50
*** FLOP *** [5h 3c 4s]
chiyuki: checks 
Rsonal: bets $8.72 and is all-in
chiyuki: folds 
Uncalled bet ($8.72) returned to Rsonal
Rsonal collected $1.53 from pot
Rsonal: doesn't show hand 
*** SUMMARY ***
Total pot $1.60 | Rake $0.07 
Board [5h 3c 4s]
Seat 1: KINGKILERACE (button) folded before Flop (didn't bet)
Seat 2: 5zzzz33 (small blind) folded before Flop
Seat 3: chiyuki (big blind) folded on the Flop
Seat 4: DooMSDaY1337 folded before Flop (didn't bet)
Seat 5: BlOnDhOlIc folded before Flop (didn't bet)
Seat 6: KeLevro0 folded before Flop (didn't bet)
Seat 7: kamikkaze folded before Flop (didn't bet)
Seat 8: SlimeyGash folded before Flop (didn't bet)
Seat 9: Rsonal collected ($1.53)



PokerStars Zoom Hand #84298480066:  Hold'em No Limit ($0.10/$0.25) - 2012/08/05 13:16:36 JST [2012/08/05 0:16:36 ET]
Table 'Whirlpool' 9-max Seat #1 is the button
Seat 1: mikifeio ($46.89 in chips) 
Seat 2: ShockLaMuc ($24.75 in chips) 
Seat 3: masterkoolb ($12.50 in chips) 
Seat 4: gedavaca ($27.53 in chips) 
Seat 5: PetitAlejo ($25 in chips) 
Seat 6: ll_LaMeR_ll ($13.65 in chips) 
Seat 7: RomarioJa ($9.54 in chips) 
Seat 8: slickthis ($24.35 in chips) 
Seat 9: chiyuki ($24.25 in chips) 
ShockLaMuc: posts small blind $0.10
masterkoolb: posts big blind $0.25
*** HOLE CARDS ***
Dealt to chiyuki [Qd Td]
gedavaca: folds 
PetitAlejo: folds 
ll_LaMeR_ll: folds 
RomarioJa: folds 
slickthis: folds 
chiyuki: raises $0.50 to $0.75
mikifeio: folds 
ShockLaMuc: folds 
masterkoolb: folds 
Uncalled bet ($0.50) returned to chiyuki
chiyuki collected $0.60 from pot
chiyuki: doesn't show hand 
*** SUMMARY ***
Total pot $0.60 | Rake $0 
Seat 1: mikifeio (button) folded before Flop (didn't bet)
Seat 2: ShockLaMuc (small blind) folded before Flop
Seat 3: masterkoolb (big blind) folded before Flop
Seat 4: gedavaca folded before Flop (didn't bet)
Seat 5: PetitAlejo folded before Flop (didn't bet)
Seat 6: ll_LaMeR_ll folded before Flop (didn't bet)
Seat 7: RomarioJa folded before Flop (didn't bet)
Seat 8: slickthis folded before Flop (didn't bet)
Seat 9: chiyuki collected ($0.60)



PokerStars Zoom Hand #84298473717:  Hold'em No Limit ($0.10/$0.25) - 2012/08/05 13:16:14 JST [2012/08/05 0:16:14 ET]
Table 'Whirlpool' 9-max Seat #1 is the button
Seat 1: Alvinpe85 ($25.86 in chips) 
Seat 2: BlOnDhOlIc ($25 in chips) 
Seat 3: kkbruins0408 ($11.88 in chips) 
Seat 4: hassantas ($24.50 in chips) 
Seat 5: wtu1986 ($25.99 in chips) 
Seat 6: DooMSDaY1337 ($70.56 in chips) 
Seat 7: chiyuki ($24.25 in chips) 
Seat 8: deadmoneykid ($20.40 in chips) 
Seat 9: TraderYao ($24.90 in chips) 
BlOnDhOlIc: posts small blind $0.10
kkbruins0408: posts big blind $0.25
*** HOLE CARDS ***
Dealt to chiyuki [4d 9h]
hassantas: folds 
wtu1986: folds 
DooMSDaY1337: raises $0.50 to $0.75
chiyuki: folds 
deadmoneykid: folds 
TraderYao: folds 
Alvinpe85: calls $0.75
BlOnDhOlIc: folds 
kkbruins0408: folds 
*** FLOP *** [4c 9d 7d]
DooMSDaY1337: checks 
Alvinpe85: bets $1.06
DooMSDaY1337: folds 
Uncalled bet ($1.06) returned to Alvinpe85
Alvinpe85 collected $1.77 from pot
Alvinpe85: doesn't show hand 
*** SUMMARY ***
Total pot $1.85 | Rake $0.08 
Board [4c 9d 7d]
Seat 1: Alvinpe85 (button) collected ($1.77)
Seat 2: BlOnDhOlIc (small blind) folded before Flop
Seat 3: kkbruins0408 (big blind) folded before Flop
Seat 4: hassantas folded before Flop (didn't bet)
Seat 5: wtu1986 folded before Flop (didn't bet)
Seat 6: DooMSDaY1337 folded on the Flop
Seat 7: chiyuki folded before Flop (didn't bet)
Seat 8: deadmoneykid folded before Flop (didn't bet)
Seat 9: TraderYao folded before Flop (didn't bet)



PokerStars Zoom Hand #84298475961:  Hold'em No Limit ($0.10/$0.25) - 2012/08/05 13:16:22 JST [2012/08/05 0:16:22 ET]
Table 'Whirlpool' 9-max Seat #1 is the button
Seat 1: nice.franki ($12.12 in chips) 
Seat 2: ShockLaMuc ($24.75 in chips) 
Seat 3: MibNe ($26.35 in chips) 
Seat 4: PetitAlejo ($25 in chips) 
Seat 5: seula i ($25.68 in chips) 
Seat 6: mikifeio ($46.89 in chips) 
Seat 7: softdesign ($52.17 in chips) 
Seat 8: chiyuki ($24.25 in chips) 
Seat 9: Suhoff76 ($25.10 in chips) 
ShockLaMuc: posts small blind $0.10
MibNe: posts big blind $0.25
*** HOLE CARDS ***
Dealt to chiyuki [4d 3d]
PetitAlejo: folds 
seula i: folds 
mikifeio: folds 
softdesign: folds 
chiyuki: folds 
Suhoff76: folds 
nice.franki: raises $0.37 to $0.62
ShockLaMuc: folds 
MibNe: calls $0.37
*** FLOP *** [3s Qs 9h]
MibNe: checks 
nice.franki: bets $0.75
MibNe: calls $0.75
*** TURN *** [3s Qs 9h] [8c]
MibNe: checks 
nice.franki: checks 
*** RIVER *** [3s Qs 9h 8c] [4h]
MibNe: checks 
nice.franki: checks 
*** SHOW DOWN ***
MibNe: shows [7h 7s] (a pair of Sevens)
nice.franki: mucks hand 
MibNe collected $2.71 from pot
*** SUMMARY ***
Total pot $2.84 | Rake $0.13 
Board [3s Qs 9h 8c 4h]
Seat 1: nice.franki (button) mucked [Kh As]
Seat 2: ShockLaMuc (small blind) folded before Flop
Seat 3: MibNe (big blind) showed [7h 7s] and won ($2.71) with a pair of Sevens
Seat 4: PetitAlejo folded before Flop (didn't bet)
Seat 5: seula i folded before Flop (didn't bet)
Seat 6: mikifeio folded before Flop (didn't bet)
Seat 7: softdesign folded before Flop (didn't bet)
Seat 8: chiyuki folded before Flop (didn't bet)
Seat 9: Suhoff76 folded before Flop (didn't bet)



PokerStars Zoom Hand #84298477139:  Hold'em No Limit ($0.10/$0.25) - 2012/08/05 13:16:26 JST [2012/08/05 0:16:26 ET]
Table 'Whirlpool' 9-max Seat #1 is the button
Seat 1: Medic8681 ($12.50 in chips) 
Seat 2: Loholov ($16.53 in chips) 
Seat 3: Th3Fog ($24.33 in chips) 
Seat 4: BlOnDhOlIc ($25 in chips) 
Seat 5: cR!Ma*aRm ($26.16 in chips) 
Seat 6: chiyuki ($24.25 in chips) 
Seat 7: deadmoneykid ($22.44 in chips) 
Seat 8: Suhoff76 ($25.10 in chips) 
Seat 9: Tasman007 ($8.08 in chips) 
Loholov: posts small blind $0.10
Th3Fog: posts big blind $0.25
*** HOLE CARDS ***
Dealt to chiyuki [9h Td]
BlOnDhOlIc: folds 
cR!Ma*aRm: calls $0.25
chiyuki: folds 
deadmoneykid: folds 
Suhoff76: folds 
Tasman007: folds 
Medic8681: folds 
Loholov: folds 
Th3Fog: checks 
*** FLOP *** [5c 4d Qh]
Th3Fog: bets $0.33
cR!Ma*aRm: calls $0.33
*** TURN *** [5c 4d Qh] [8s]
Th3Fog: bets $0.70
cR!Ma*aRm: calls $0.70
*** RIVER *** [5c 4d Qh 8s] [6c]
Th3Fog: bets $1.49
cR!Ma*aRm: calls $1.49
*** SHOW DOWN ***
Th3Fog: shows [Qd 6h] (two pair, Queens and Sixes)
cR!Ma*aRm: mucks hand 
Th3Fog collected $5.39 from pot
*** SUMMARY ***
Total pot $5.64 | Rake $0.25 
Board [5c 4d Qh 8s 6c]
Seat 1: Medic8681 (button) folded before Flop (didn't bet)
Seat 2: Loholov (small blind) folded before Flop
Seat 3: Th3Fog (big blind) showed [Qd 6h] and won ($5.39) with two pair, Queens and Sixes
Seat 4: BlOnDhOlIc folded before Flop (didn't bet)
Seat 5: cR!Ma*aRm mucked [Ac Qc]
Seat 6: chiyuki folded before Flop (didn't bet)
Seat 7: deadmoneykid folded before Flop (didn't bet)
Seat 8: Suhoff76 folded before Flop (didn't bet)
Seat 9: Tasman007 folded before Flop (didn't bet)



PokerStars Zoom Hand #84298489918:  Hold'em No Limit ($0.10/$0.25) - 2012/08/05 13:17:12 JST [2012/08/05 0:17:12 ET]
Table 'Whirlpool' 9-max Seat #1 is the button
Seat 1: SlimeyGash ($22.27 in chips) 
Seat 2: BlOnDhOlIc ($51.63 in chips) 
Seat 3: Zugrug ($26.50 in chips) 
Seat 4: Th3Fog ($68.92 in chips) 
Seat 5: jtedecaliss ($156.98 in chips) 
Seat 6: Suhoff76 ($26.12 in chips) 
Seat 7: chiyuki ($24.50 in chips) 
Seat 8: gedavaca ($27.18 in chips) 
Seat 9: PetitAlejo ($25 in chips) 
BlOnDhOlIc: posts small blind $0.10
Zugrug: posts big blind $0.25
*** HOLE CARDS ***
Dealt to chiyuki [2s 9d]
Th3Fog: folds 
jtedecaliss: folds 
Suhoff76: folds 
chiyuki: folds 
gedavaca: folds 
PetitAlejo: folds 
SlimeyGash: folds 
BlOnDhOlIc: folds 
Uncalled bet ($0.15) returned to Zugrug
Zugrug collected $0.20 from pot
Zugrug: doesn't show hand 
*** SUMMARY ***
Total pot $0.20 | Rake $0 
Seat 1: SlimeyGash (button) folded before Flop (didn't bet)
Seat 2: BlOnDhOlIc (small blind) folded before Flop
Seat 3: Zugrug (big blind) collected ($0.20)
Seat 4: Th3Fog folded before Flop (didn't bet)
Seat 5: jtedecaliss folded before Flop (didn't bet)
Seat 6: Suhoff76 folded before Flop (didn't bet)
Seat 7: chiyuki folded before Flop (didn't bet)
Seat 8: gedavaca folded before Flop (didn't bet)
Seat 9: PetitAlejo folded before Flop (didn't bet)



PokerStars Zoom Hand #84298488842:  Hold'em No Limit ($0.10/$0.25) - 2012/08/05 13:17:08 JST [2012/08/05 0:17:08 ET]
Table 'Whirlpool' 9-max Seat #1 is the button
Seat 1: Medic8681 ($14.14 in chips) 
Seat 2: DooMSDaY1337 ($25 in chips) 
Seat 3: 4ydo yogurt ($20.17 in chips) 
Seat 4: TErr18 ($26.67 in chips) 
Seat 5: chiyuki ($24.50 in chips) 
Seat 6: SlimeyGash ($22.27 in chips) 
Seat 7: Zugrug ($27.09 in chips) 
Seat 8: jtedecaliss ($156.98 in chips) 
Seat 9: TraderYao ($25.10 in chips) 
DooMSDaY1337: posts small blind $0.10
4ydo yogurt: posts big blind $0.25
*** HOLE CARDS ***
Dealt to chiyuki [6d Ah]
TErr18: folds 
chiyuki: folds 
SlimeyGash: folds 
Zugrug: folds 
jtedecaliss: folds 
TraderYao: raises $0.50 to $0.75
Medic8681: folds 
DooMSDaY1337: folds 
4ydo yogurt: calls $0.50
*** FLOP *** [2s Tc 9s]
4ydo yogurt: checks 
TraderYao: bets $0.94
4ydo yogurt: folds 
Uncalled bet ($0.94) returned to TraderYao
TraderYao collected $1.53 from pot
TraderYao: doesn't show hand 
*** SUMMARY ***
Total pot $1.60 | Rake $0.07 
Board [2s Tc 9s]
Seat 1: Medic8681 (button) folded before Flop (didn't bet)
Seat 2: DooMSDaY1337 (small blind) folded before Flop
Seat 3: 4ydo yogurt (big blind) folded on the Flop
Seat 4: TErr18 folded before Flop (didn't bet)
Seat 5: chiyuki folded before Flop (didn't bet)
Seat 6: SlimeyGash folded before Flop (didn't bet)
Seat 7: Zugrug folded before Flop (didn't bet)
Seat 8: jtedecaliss folded before Flop (didn't bet)
Seat 9: TraderYao collected ($1.53)



PokerStars Zoom Hand #84298484582:  Hold'em No Limit ($0.10/$0.25) - 2012/08/05 13:16:53 JST [2012/08/05 0:16:53 ET]
Table 'Whirlpool' 9-max Seat #1 is the button
Seat 1: goldstone ($24.75 in chips) 
Seat 2: chiyuki ($24.60 in chips) 
Seat 3: TraderYao ($25.35 in chips) 
Seat 4: DT_Jesus ($26.62 in chips) 
Seat 5: wtu1986 ($25.10 in chips) 
Seat 6: Medic8681 ($14.53 in chips) 
Seat 7: BlOnDhOlIc ($51.63 in chips) 
Seat 8: envious_0007 ($20.86 in chips) 
Seat 9: ll_LaMeR_ll ($13.65 in chips) 
chiyuki: posts small blind $0.10
TraderYao: posts big blind $0.25
*** HOLE CARDS ***
Dealt to chiyuki [8h 4s]
DT_Jesus: folds 
wtu1986: folds 
Medic8681: folds 
BlOnDhOlIc: folds 
envious_0007: calls $0.25
ll_LaMeR_ll: raises $0.75 to $1
goldstone: folds 
chiyuki: folds 
TraderYao: folds 
envious_0007: calls $0.75
*** FLOP *** [9h Qc 9d]
envious_0007: checks 
ll_LaMeR_ll: checks 
*** TURN *** [9h Qc 9d] [5c]
envious_0007: bets $1.75
ll_LaMeR_ll: calls $1.75
*** RIVER *** [9h Qc 9d 5c] [Th]
envious_0007: checks 
ll_LaMeR_ll: bets $2.62
envious_0007: calls $2.62
*** SHOW DOWN ***
ll_LaMeR_ll: shows [Jc 9c] (three of a kind, Nines)
envious_0007: mucks hand 
ll_LaMeR_ll collected $10.59 from pot
*** SUMMARY ***
Total pot $11.09 | Rake $0.50 
Board [9h Qc 9d 5c Th]
Seat 1: goldstone (button) folded before Flop (didn't bet)
Seat 2: chiyuki (small blind) folded before Flop
Seat 3: TraderYao (big blind) folded before Flop
Seat 4: DT_Jesus folded before Flop (didn't bet)
Seat 5: wtu1986 folded before Flop (didn't bet)
Seat 6: Medic8681 folded before Flop (didn't bet)
Seat 7: BlOnDhOlIc folded before Flop (didn't bet)
Seat 8: envious_0007 mucked [Ks Ad]
Seat 9: ll_LaMeR_ll showed [Jc 9c] and won ($10.59) with three of a kind, Nines



PokerStars Zoom Hand #84298492206:  Hold'em No Limit ($0.10/$0.25) - 2012/08/05 13:17:20 JST [2012/08/05 0:17:20 ET]
Table 'Whirlpool' 9-max Seat #1 is the button
Seat 1: chiyuki ($24.50 in chips) 
Seat 2: gunbowler ($97.46 in chips) 
Seat 3: Medic8681 ($14.53 in chips) 
Seat 4: MibNe ($27.69 in chips) 
Seat 5: jtedecaliss ($156.98 in chips) 
Seat 6: wtu1986 ($25.89 in chips) 
Seat 7: SlimeyGash ($22.27 in chips) 
Seat 8: Tasman007 ($6.27 in chips) 
Seat 9: KeLevro0 ($12.32 in chips) 
gunbowler: posts small blind $0.10
Medic8681: posts big blind $0.25
*** HOLE CARDS ***
Dealt to chiyuki [Tc 2d]
MibNe: raises $0.62 to $0.87
jtedecaliss: folds 
wtu1986: folds 
SlimeyGash: folds 
Tasman007: folds 
KeLevro0: folds 
chiyuki: folds 
gunbowler: folds 
Medic8681: folds 
Uncalled bet ($0.62) returned to MibNe
MibNe collected $0.60 from pot
MibNe: doesn't show hand 
*** SUMMARY ***
Total pot $0.60 | Rake $0 
Seat 1: chiyuki (button) folded before Flop (didn't bet)
Seat 2: gunbowler (small blind) folded before Flop
Seat 3: Medic8681 (big blind) folded before Flop
Seat 4: MibNe collected ($0.60)
Seat 5: jtedecaliss folded before Flop (didn't bet)
Seat 6: wtu1986 folded before Flop (didn't bet)
Seat 7: SlimeyGash folded before Flop (didn't bet)
Seat 8: Tasman007 folded before Flop (didn't bet)
Seat 9: KeLevro0 folded before Flop (didn't bet)



PokerStars Zoom Hand #84298491045:  Hold'em No Limit ($0.10/$0.25) - 2012/08/05 13:17:16 JST [2012/08/05 0:17:16 ET]
Table 'Whirlpool' 9-max Seat #1 is the button
Seat 1: DooMSDaY1337 ($25 in chips) 
Seat 2: masterkoolb ($12.85 in chips) 
Seat 3: Suhoff76 ($26.12 in chips) 
Seat 4: chiyuki ($24.50 in chips) 
Seat 5: deadmoneykid ($23.80 in chips) 
Seat 6: KeLevro0 ($12.32 in chips) 
Seat 7: silvno31 ($21.48 in chips) 
Seat 8: fwani ($29.12 in chips) 
Seat 9: nice.franki ($11.20 in chips) 
masterkoolb: posts small blind $0.10
Suhoff76: posts big blind $0.25
*** HOLE CARDS ***
Dealt to chiyuki [4h 9h]
chiyuki: folds 
deadmoneykid: folds 
KeLevro0: folds 
silvno31: folds 
fwani: folds 
nice.franki: folds 
DooMSDaY1337: raises $0.50 to $0.75
masterkoolb: folds 
Suhoff76: folds 
Uncalled bet ($0.50) returned to DooMSDaY1337
DooMSDaY1337 collected $0.60 from pot
DooMSDaY1337: doesn't show hand 
*** SUMMARY ***
Total pot $0.60 | Rake $0 
Seat 1: DooMSDaY1337 (button) collected ($0.60)
Seat 2: masterkoolb (small blind) folded before Flop
Seat 3: Suhoff76 (big blind) folded before Flop
Seat 4: chiyuki folded before Flop (didn't bet)
Seat 5: deadmoneykid folded before Flop (didn't bet)
Seat 6: KeLevro0 folded before Flop (didn't bet)
Seat 7: silvno31 folded before Flop (didn't bet)
Seat 8: fwani folded before Flop (didn't bet)
Seat 9: nice.franki folded before Flop (didn't bet)



PokerStars Zoom Hand #84298497540:  Hold'em No Limit ($0.10/$0.25) - 2012/08/05 13:17:39 JST [2012/08/05 0:17:39 ET]
Table 'Whirlpool' 9-max Seat #1 is the button
Seat 1: Loholov ($20.32 in chips) 
Seat 2: wtu1986 ($25.35 in chips) 
Seat 3: chiyuki ($24.50 in chips) 
Seat 4: Medic8681 ($14.14 in chips) 
Seat 5: TraderYao ($25.35 in chips) 
Seat 6: RomarioJa ($9.44 in chips) 
Seat 7: ShockLaMuc ($24.65 in chips) 
Seat 8: Roglus ($43.06 in chips) 
Seat 9: Th3Fog ($26.20 in chips) 
wtu1986: posts small blind $0.10
chiyuki: posts big blind $0.25
*** HOLE CARDS ***
Dealt to chiyuki [6c Kh]
Medic8681: folds 
TraderYao: folds 
RomarioJa: raises $0.37 to $0.62
ShockLaMuc: raises $1.65 to $2.27
Roglus: folds 
Th3Fog: folds 
Loholov: folds 
wtu1986: folds 
chiyuki: folds 
RomarioJa: folds 
Uncalled bet ($1.65) returned to ShockLaMuc
ShockLaMuc collected $1.59 from pot
ShockLaMuc: doesn't show hand 
*** SUMMARY ***
Total pot $1.59 | Rake $0 
Seat 1: Loholov (button) folded before Flop (didn't bet)
Seat 2: wtu1986 (small blind) folded before Flop
Seat 3: chiyuki (big blind) folded before Flop
Seat 4: Medic8681 folded before Flop (didn't bet)
Seat 5: TraderYao folded before Flop (didn't bet)
Seat 6: RomarioJa folded before Flop
Seat 7: ShockLaMuc collected ($1.59)
Seat 8: Roglus folded before Flop (didn't bet)
Seat 9: Th3Fog folded before Flop (didn't bet)



PokerStars Zoom Hand #84298503701:  Hold'em No Limit ($0.10/$0.25) - 2012/08/05 13:18:01 JST [2012/08/05 0:18:01 ET]
Table 'Whirlpool' 9-max Seat #1 is the button
Seat 1: NastyMcNast ($42.17 in chips) 
Seat 2: jtedecaliss ($156.73 in chips) 
Seat 3: masterkoolb ($12.75 in chips) 
Seat 4: chiyuki ($24.25 in chips) 
Seat 5: KeLevro0 ($12.57 in chips) 
Seat 6: BlOnDhOlIc ($51.28 in chips) 
Seat 7: Th3Fog ($55.68 in chips) 
Seat 8: nice.franki ($10.65 in chips) 
Seat 9: fwani ($42.08 in chips) 
jtedecaliss: posts small blind $0.10
masterkoolb: posts big blind $0.25
*** HOLE CARDS ***
Dealt to chiyuki [Tc 7d]
chiyuki: folds 
KeLevro0: raises $0.42 to $0.67
BlOnDhOlIc: folds 
Th3Fog: folds 
nice.franki: folds 
fwani: folds 
NastyMcNast: folds 
jtedecaliss: folds 
masterkoolb: folds 
Uncalled bet ($0.42) returned to KeLevro0
KeLevro0 collected $0.60 from pot
KeLevro0: doesn't show hand 
*** SUMMARY ***
Total pot $0.60 | Rake $0 
Seat 1: NastyMcNast (button) folded before Flop (didn't bet)
Seat 2: jtedecaliss (small blind) folded before Flop
Seat 3: masterkoolb (big blind) folded before Flop
Seat 4: chiyuki folded before Flop (didn't bet)
Seat 5: KeLevro0 collected ($0.60)
Seat 6: BlOnDhOlIc folded before Flop (didn't bet)
Seat 7: Th3Fog folded before Flop (didn't bet)
Seat 8: nice.franki folded before Flop (didn't bet)
Seat 9: fwani folded before Flop (didn't bet)



PokerStars Zoom Hand #84298495318:  Hold'em No Limit ($0.10/$0.25) - 2012/08/05 13:17:31 JST [2012/08/05 0:17:31 ET]
Table 'Whirlpool' 9-max Seat #1 is the button
Seat 1: DonSimonUsa ($20.22 in chips) 
Seat 2: Suhoff76 ($25 in chips) 
Seat 3: PetitAlejo ($25 in chips) 
Seat 4: NastyMcNast ($49.87 in chips) 
Seat 5: ShockLaMuc ($24.65 in chips) 
Seat 6: chiyuki ($24.50 in chips) 
Seat 7: Lasutchik ($26.17 in chips) 
Seat 8: goldstone ($24.65 in chips) 
Seat 9: Th3Fog ($68.82 in chips) 
Suhoff76: posts small blind $0.10
PetitAlejo: posts big blind $0.25
*** HOLE CARDS ***
Dealt to chiyuki [3s 7c]
NastyMcNast: folds 
ShockLaMuc: folds 
chiyuki: folds 
Lasutchik: folds 
goldstone: raises $0.30 to $0.55
Th3Fog: folds 
DonSimonUsa: calls $0.55
Suhoff76: folds 
PetitAlejo: raises $2.30 to $2.85
goldstone: folds 
DonSimonUsa: calls $2.30
*** FLOP *** [7d 4c Ad]
PetitAlejo: bets $3.43
DonSimonUsa: folds 
Uncalled bet ($3.43) returned to PetitAlejo
PetitAlejo collected $6.06 from pot
PetitAlejo: doesn't show hand 
*** SUMMARY ***
Total pot $6.35 | Rake $0.29 
Board [7d 4c Ad]
Seat 1: DonSimonUsa (button) folded on the Flop
Seat 2: Suhoff76 (small blind) folded before Flop
Seat 3: PetitAlejo (big blind) collected ($6.06)
Seat 4: NastyMcNast folded before Flop (didn't bet)
Seat 5: ShockLaMuc folded before Flop (didn't bet)
Seat 6: chiyuki folded before Flop (didn't bet)
Seat 7: Lasutchik folded before Flop (didn't bet)
Seat 8: goldstone folded before Flop
Seat 9: Th3Fog folded before Flop (didn't bet)



PokerStars Zoom Hand #84298507571:  Hold'em No Limit ($0.10/$0.25) - 2012/08/05 13:18:16 JST [2012/08/05 0:18:16 ET]
Table 'Whirlpool' 9-max Seat #1 is the button
Seat 1: BlackZafiro ($25 in chips) 
Seat 2: chiyuki ($24.25 in chips) 
Seat 3: polk11 ($20.62 in chips) 
Seat 4: nice.franki ($13.87 in chips) 
Seat 5: deadmoneykid ($25 in chips) 
Seat 6: PetitAlejo ($29.10 in chips) 
Seat 7: TErr18 ($12.50 in chips) 
Seat 8: Alvinpe85 ($25 in chips) 
Seat 9: Rodina-Kr ($25 in chips) 
chiyuki: posts small blind $0.10
polk11: posts big blind $0.25
*** HOLE CARDS ***
Dealt to chiyuki [Td 6c]
nice.franki: folds 
deadmoneykid: folds 
PetitAlejo: folds 
TErr18: folds 
Alvinpe85: folds 
Rodina-Kr: folds 
BlackZafiro: raises $0.37 to $0.62
chiyuki: folds 
polk11: folds 
Uncalled bet ($0.37) returned to BlackZafiro
BlackZafiro collected $0.60 from pot
BlackZafiro: doesn't show hand 
*** SUMMARY ***
Total pot $0.60 | Rake $0 
Seat 1: BlackZafiro (button) collected ($0.60)
Seat 2: chiyuki (small blind) folded before Flop
Seat 3: polk11 (big blind) folded before Flop
Seat 4: nice.franki folded before Flop (didn't bet)
Seat 5: deadmoneykid folded before Flop (didn't bet)
Seat 6: PetitAlejo folded before Flop (didn't bet)
Seat 7: TErr18 folded before Flop (didn't bet)
Seat 8: Alvinpe85 folded before Flop (didn't bet)
Seat 9: Rodina-Kr folded before Flop (didn't bet)



PokerStars Zoom Hand #84298510718:  Hold'em No Limit ($0.10/$0.25) - 2012/08/05 13:18:27 JST [2012/08/05 0:18:27 ET]
Table 'Whirlpool' 9-max Seat #1 is the button
Seat 1: slapshot2011 ($37.41 in chips) 
Seat 2: Jene4kaBest ($12.28 in chips) 
Seat 3: Suhoff76 ($25 in chips) 
Seat 4: Alvinpe85 ($25 in chips) 
Seat 5: Roglus ($43.94 in chips) 
Seat 6: RomarioJa ($8.66 in chips) 
Seat 7: goldstone ($24.10 in chips) 
Seat 8: chiyuki ($24.15 in chips) 
Seat 9: KeLevro0 ($12.92 in chips) 
Jene4kaBest: posts small blind $0.10
Suhoff76: posts big blind $0.25
*** HOLE CARDS ***
Dealt to chiyuki [5c 7d]
Alvinpe85: folds 
Roglus: folds 
RomarioJa: folds 
goldstone: folds 
chiyuki: folds 
KeLevro0: folds 
slapshot2011: calls $0.25
Jene4kaBest: folds 
Suhoff76: checks 
*** FLOP *** [2d Ad 3c]
Suhoff76: checks 
slapshot2011: bets $0.75
Suhoff76: folds 
Uncalled bet ($0.75) returned to slapshot2011
slapshot2011 collected $0.57 from pot
slapshot2011: doesn't show hand 
*** SUMMARY ***
Total pot $0.60 | Rake $0.03 
Board [2d Ad 3c]
Seat 1: slapshot2011 (button) collected ($0.57)
Seat 2: Jene4kaBest (small blind) folded before Flop
Seat 3: Suhoff76 (big blind) folded on the Flop
Seat 4: Alvinpe85 folded before Flop (didn't bet)
Seat 5: Roglus folded before Flop (didn't bet)
Seat 6: RomarioJa folded before Flop (didn't bet)
Seat 7: goldstone folded before Flop (didn't bet)
Seat 8: chiyuki folded before Flop (didn't bet)
Seat 9: KeLevro0 folded before Flop (didn't bet)



PokerStars Zoom Hand #84298505624:  Hold'em No Limit ($0.10/$0.25) - 2012/08/05 13:18:09 JST [2012/08/05 0:18:09 ET]
Table 'Whirlpool' 9-max Seat #1 is the button
Seat 1: DooMSDaY1337 ($72.06 in chips) 
Seat 2: BlackZafiro ($25 in chips) 
Seat 3: fwani ($42.08 in chips) 
Seat 4: seula i ($25.58 in chips) 
Seat 5: Loholov ($20.32 in chips) 
Seat 6: BlOnDhOlIc ($25.73 in chips) 
Seat 7: pyty_82 ($57.30 in chips) 
Seat 8: PetitAlejo ($27.70 in chips) 
Seat 9: chiyuki ($24.25 in chips) 
BlackZafiro: posts small blind $0.10
fwani: posts big blind $0.25
*** HOLE CARDS ***
Dealt to chiyuki [Qs 8s]
seula i: folds 
Loholov: folds 
BlOnDhOlIc: raises $0.25 to $0.50
pyty_82: folds 
PetitAlejo: folds 
chiyuki: folds 
DooMSDaY1337: folds 
BlackZafiro: folds 
fwani: folds 
Uncalled bet ($0.25) returned to BlOnDhOlIc
BlOnDhOlIc collected $0.60 from pot
BlOnDhOlIc: doesn't show hand 
*** SUMMARY ***
Total pot $0.60 | Rake $0 
Seat 1: DooMSDaY1337 (button) folded before Flop (didn't bet)
Seat 2: BlackZafiro (small blind) folded before Flop
Seat 3: fwani (big blind) folded before Flop
Seat 4: seula i folded before Flop (didn't bet)
Seat 5: Loholov folded before Flop (didn't bet)
Seat 6: BlOnDhOlIc collected ($0.60)
Seat 7: pyty_82 folded before Flop (didn't bet)
Seat 8: PetitAlejo folded before Flop (didn't bet)
Seat 9: chiyuki folded before Flop (didn't bet)



PokerStars Zoom Hand #84298511797:  Hold'em No Limit ($0.10/$0.25) - 2012/08/05 13:18:31 JST [2012/08/05 0:18:31 ET]
Table 'Whirlpool' 9-max Seat #1 is the button
Seat 1: nice.franki ($13.77 in chips) 
Seat 2: puffy5533 ($17.68 in chips) 
Seat 3: 5zzzz33 ($21.39 in chips) 
Seat 4: chiyuki ($24.15 in chips) 
Seat 5: RomarioJa ($8.66 in chips) 
Seat 6: Th3Fog ($55.68 in chips) 
Seat 7: KINGKILERACE ($30.63 in chips) 
Seat 8: gAm813r ($27.52 in chips) 
Seat 9: goldstone ($23.12 in chips) 
puffy5533: posts small blind $0.10
5zzzz33: posts big blind $0.25
*** HOLE CARDS ***
Dealt to chiyuki [Qh 8s]
chiyuki: folds 
RomarioJa: folds 
Th3Fog: raises $0.47 to $0.72
KINGKILERACE: folds 
gAm813r: folds 
goldstone: calls $0.72
nice.franki: folds 
puffy5533: folds 
5zzzz33: calls $0.47
*** FLOP *** [Kd Th 5d]
5zzzz33: checks 
Th3Fog: checks 
goldstone: bets $1.01
5zzzz33: calls $1.01
Th3Fog: folds 
*** TURN *** [Kd Th 5d] [Qs]
5zzzz33: checks 
goldstone: bets $1.92
5zzzz33: calls $1.92
*** RIVER *** [Kd Th 5d Qs] [Ah]
5zzzz33: checks 
goldstone: checks 
*** SHOW DOWN ***
5zzzz33: shows [4d Ad] (a pair of Aces)
goldstone: shows [Qd Td] (two pair, Queens and Tens)
goldstone collected $7.75 from pot
*** SUMMARY ***
Total pot $8.12 | Rake $0.37 
Board [Kd Th 5d Qs Ah]
Seat 1: nice.franki (button) folded before Flop (didn't bet)
Seat 2: puffy5533 (small blind) folded before Flop
Seat 3: 5zzzz33 (big blind) showed [4d Ad] and lost with a pair of Aces
Seat 4: chiyuki folded before Flop (didn't bet)
Seat 5: RomarioJa folded before Flop (didn't bet)
Seat 6: Th3Fog folded on the Flop
Seat 7: KINGKILERACE folded before Flop (didn't bet)
Seat 8: gAm813r folded before Flop (didn't bet)
Seat 9: goldstone showed [Qd Td] and won ($7.75) with two pair, Queens and Tens



PokerStars Zoom Hand #84298512624:  Hold'em No Limit ($0.10/$0.25) - 2012/08/05 13:18:34 JST [2012/08/05 0:18:34 ET]
Table 'Whirlpool' 9-max Seat #1 is the button
Seat 1: deadmoneykid ($25 in chips) 
Seat 2: seula i ($56.42 in chips) 
Seat 3: ryanjp2323 ($31.62 in chips) 
Seat 4: PetitAlejo ($28.05 in chips) 
Seat 5: chiyuki ($24.15 in chips) 
Seat 6: Loholov ($41.44 in chips) 
Seat 7: ShockLaMuc ($24.93 in chips) 
Seat 8: NastyMcNast ($42.07 in chips) 
Seat 9: RomarioJa ($10.17 in chips) 
seula i: posts small blind $0.10
ryanjp2323: posts big blind $0.25
*** HOLE CARDS ***
Dealt to chiyuki [7h 2s]
PetitAlejo: folds 
chiyuki: folds 
Loholov: folds 
ShockLaMuc: calls $0.25
NastyMcNast: folds 
RomarioJa: raises $0.75 to $1
deadmoneykid: folds 
seula i: folds 
ryanjp2323: folds 
ShockLaMuc: folds 
Uncalled bet ($0.75) returned to RomarioJa
RomarioJa collected $0.85 from pot
RomarioJa: doesn't show hand 
*** SUMMARY ***
Total pot $0.85 | Rake $0 
Seat 1: deadmoneykid (button) folded before Flop (didn't bet)
Seat 2: seula i (small blind) folded before Flop
Seat 3: ryanjp2323 (big blind) folded before Flop
Seat 4: PetitAlejo folded before Flop (didn't bet)
Seat 5: chiyuki folded before Flop (didn't bet)
Seat 6: Loholov folded before Flop (didn't bet)
Seat 7: ShockLaMuc folded before Flop
Seat 8: NastyMcNast folded before Flop (didn't bet)
Seat 9: RomarioJa collected ($0.85)



PokerStars Zoom Hand #84298514957:  Hold'em No Limit ($0.10/$0.25) - 2012/08/05 13:18:42 JST [2012/08/05 0:18:42 ET]
Table 'Whirlpool' 9-max Seat #1 is the button
Seat 1: TErr18 ($12.60 in chips) 
Seat 2: Zugrug ($36.52 in chips) 
Seat 3: Medic8681 ($14.10 in chips) 
Seat 4: Suhoff76 ($25 in chips) 
Seat 5: fwani ($28.77 in chips) 
Seat 6: chiyuki ($24.15 in chips) 
Seat 7: BlOnDhOlIc ($25.80 in chips) 
Seat 8: deadmoneykid ($25 in chips) 
Seat 9: wtu1986 ($25.25 in chips) 
Zugrug: posts small blind $0.10
Medic8681: posts big blind $0.25
*** HOLE CARDS ***
Dealt to chiyuki [Kh 4h]
Suhoff76: folds 
fwani: folds 
chiyuki: folds 
BlOnDhOlIc: folds 
deadmoneykid: raises $0.35 to $0.60
wtu1986: folds 
TErr18: calls $0.60
Zugrug: folds 
Medic8681: calls $0.35
*** FLOP *** [Th Qs 3h]
Medic8681: checks 
deadmoneykid: checks 
TErr18: checks 
*** TURN *** [Th Qs 3h] [Ts]
Medic8681: bets $1
deadmoneykid: folds 
TErr18: folds 
Uncalled bet ($1) returned to Medic8681
Medic8681 collected $1.81 from pot
Medic8681: doesn't show hand 
*** SUMMARY ***
Total pot $1.90 | Rake $0.09 
Board [Th Qs 3h Ts]
Seat 1: TErr18 (button) folded on the Turn
Seat 2: Zugrug (small blind) folded before Flop
Seat 3: Medic8681 (big blind) collected ($1.81)
Seat 4: Suhoff76 folded before Flop (didn't bet)
Seat 5: fwani folded before Flop (didn't bet)
Seat 6: chiyuki folded before Flop (didn't bet)
Seat 7: BlOnDhOlIc folded before Flop (didn't bet)
Seat 8: deadmoneykid folded on the Turn
Seat 9: wtu1986 folded before Flop (didn't bet)



PokerStars Zoom Hand #84298517673:  Hold'em No Limit ($0.10/$0.25) - 2012/08/05 13:18:52 JST [2012/08/05 0:18:52 ET]
Table 'Whirlpool' 9-max Seat #1 is the button
Seat 1: DooMSDaY1337 ($26.02 in chips) 
Seat 2: fwani ($28.77 in chips) 
Seat 3: chiyuki ($24.15 in chips) 
Seat 4: gAm813r ($27.52 in chips) 
Seat 5: NastyMcNast ($42.07 in chips) 
Seat 6: DonSimonUsa ($17.37 in chips) 
Seat 7: wtu1986 ($26.30 in chips) 
Seat 8: PetitAlejo ($28.21 in chips) 
Seat 9: masterkoolb ($14.39 in chips) 
fwani: posts small blind $0.10
chiyuki: posts big blind $0.25
*** HOLE CARDS ***
Dealt to chiyuki [2h 7h]
gAm813r: folds 
NastyMcNast: folds 
DonSimonUsa: folds 
wtu1986: folds 
PetitAlejo: raises $0.50 to $0.75
masterkoolb: folds 
DooMSDaY1337: calls $0.75
fwani: calls $0.65
chiyuki: folds 
*** FLOP *** [Ks Jd 8s]
fwani: checks 
PetitAlejo: checks 
DooMSDaY1337: checks 
*** TURN *** [Ks Jd 8s] [6c]
fwani: checks 
PetitAlejo: checks 
DooMSDaY1337: bets $1.50
fwani: folds 
PetitAlejo: folds 
Uncalled bet ($1.50) returned to DooMSDaY1337
DooMSDaY1337 collected $2.39 from pot
DooMSDaY1337: doesn't show hand 
*** SUMMARY ***
Total pot $2.50 | Rake $0.11 
Board [Ks Jd 8s 6c]
Seat 1: DooMSDaY1337 (button) collected ($2.39)
Seat 2: fwani (small blind) folded on the Turn
Seat 3: chiyuki (big blind) folded before Flop
Seat 4: gAm813r folded before Flop (didn't bet)
Seat 5: NastyMcNast folded before Flop (didn't bet)
Seat 6: DonSimonUsa folded before Flop (didn't bet)
Seat 7: wtu1986 folded before Flop (didn't bet)
Seat 8: PetitAlejo folded on the Turn
Seat 9: masterkoolb folded before Flop (didn't bet)



PokerStars Zoom Hand #84298528886:  Hold'em No Limit ($0.10/$0.25) - 2012/08/05 13:19:33 JST [2012/08/05 0:19:33 ET]
Table 'Whirlpool' 9-max Seat #1 is the button
Seat 1: KeLevro0 ($10.46 in chips) 
Seat 2: Roglus ($41.19 in chips) 
Seat 3: polk11 ($20.82 in chips) 
Seat 4: gedavaca ($31.35 in chips) 
Seat 5: fwani ($25.35 in chips) 
Seat 6: TErr18 ($11.92 in chips) 
Seat 7: Alvinpe85 ($25 in chips) 
Seat 8: chiyuki ($23.80 in chips) 
Seat 9: goldstone ($24.10 in chips) 
Roglus: posts small blind $0.10
polk11: posts big blind $0.25
*** HOLE CARDS ***
Dealt to chiyuki [Th 3c]
gedavaca: folds 
fwani: folds 
TErr18: raises $0.50 to $0.75
Alvinpe85: folds 
chiyuki: folds 
goldstone: folds 
KeLevro0: calls $0.75
Roglus: folds 
polk11: folds 
*** FLOP *** [2d 8d 5d]
TErr18: bets $1.25
KeLevro0: folds 
Uncalled bet ($1.25) returned to TErr18
TErr18 collected $1.77 from pot
TErr18: doesn't show hand 
*** SUMMARY ***
Total pot $1.85 | Rake $0.08 
Board [2d 8d 5d]
Seat 1: KeLevro0 (button) folded on the Flop
Seat 2: Roglus (small blind) folded before Flop
Seat 3: polk11 (big blind) folded before Flop
Seat 4: gedavaca folded before Flop (didn't bet)
Seat 5: fwani folded before Flop (didn't bet)
Seat 6: TErr18 collected ($1.77)
Seat 7: Alvinpe85 folded before Flop (didn't bet)
Seat 8: chiyuki folded before Flop (didn't bet)
Seat 9: goldstone folded before Flop (didn't bet)



PokerStars Zoom Hand #84298529743:  Hold'em No Limit ($0.10/$0.25) - 2012/08/05 13:19:36 JST [2012/08/05 0:19:36 ET]
Table 'Whirlpool' 9-max Seat #1 is the button
Seat 1: agurio ($25.25 in chips) 
Seat 2: ShockLaMuc ($24.43 in chips) 
Seat 3: Suhoff76 ($25 in chips) 
Seat 4: Zugrug ($25.25 in chips) 
Seat 5: RomarioJa ($8.82 in chips) 
Seat 6: softdesign ($49.32 in chips) 
Seat 7: nice.franki ($11.20 in chips) 
Seat 8: Roglus ($41.09 in chips) 
Seat 9: chiyuki ($23.80 in chips) 
ShockLaMuc: posts small blind $0.10
Suhoff76: posts big blind $0.25
*** HOLE CARDS ***
Dealt to chiyuki [5s Td]
Zugrug: folds 
RomarioJa: folds 
softdesign: folds 
nice.franki: folds 
Roglus: folds 
chiyuki: folds 
agurio: folds 
ShockLaMuc: calls $0.15
Suhoff76: checks 
*** FLOP *** [7h Jc 8c]
ShockLaMuc: checks 
Suhoff76: bets $0.36
ShockLaMuc: folds 
Uncalled bet ($0.36) returned to Suhoff76
Suhoff76 collected $0.48 from pot
Suhoff76: doesn't show hand 
*** SUMMARY ***
Total pot $0.50 | Rake $0.02 
Board [7h Jc 8c]
Seat 1: agurio (button) folded before Flop (didn't bet)
Seat 2: ShockLaMuc (small blind) folded on the Flop
Seat 3: Suhoff76 (big blind) collected ($0.48)
Seat 4: Zugrug folded before Flop (didn't bet)
Seat 5: RomarioJa folded before Flop (didn't bet)
Seat 6: softdesign folded before Flop (didn't bet)
Seat 7: nice.franki folded before Flop (didn't bet)
Seat 8: Roglus folded before Flop (didn't bet)
Seat 9: chiyuki folded before Flop (didn't bet)



PokerStars Zoom Hand #84298534274:  Hold'em No Limit ($0.10/$0.25) - 2012/08/05 13:19:52 JST [2012/08/05 0:19:52 ET]
Table 'Whirlpool' 9-max Seat #1 is the button
Seat 1: Suhoff76 ($25 in chips) 
Seat 2: polk11 ($20.57 in chips) 
Seat 3: fwani ($25.35 in chips) 
Seat 4: RomarioJa ($8.31 in chips) 
Seat 5: Roglus ($18.46 in chips) 
Seat 6: Alvinpe85 ($30.64 in chips) 
Seat 7: chiyuki ($23.80 in chips) 
Seat 8: Th3Fog ($30.75 in chips) 
Seat 9: BlOnDhOlIc ($36.07 in chips) 
polk11: posts small blind $0.10
fwani: posts big blind $0.25
*** HOLE CARDS ***
Dealt to chiyuki [4d 5s]
RomarioJa: folds 
Roglus: folds 
Alvinpe85: folds 
chiyuki: folds 
Th3Fog: folds 
BlOnDhOlIc: folds 
Suhoff76: folds 
polk11: folds 
Uncalled bet ($0.15) returned to fwani
fwani collected $0.20 from pot
fwani: doesn't show hand 
*** SUMMARY ***
Total pot $0.20 | Rake $0 
Seat 1: Suhoff76 (button) folded before Flop (didn't bet)
Seat 2: polk11 (small blind) folded before Flop
Seat 3: fwani (big blind) collected ($0.20)
Seat 4: RomarioJa folded before Flop (didn't bet)
Seat 5: Roglus folded before Flop (didn't bet)
Seat 6: Alvinpe85 folded before Flop (didn't bet)
Seat 7: chiyuki folded before Flop (didn't bet)
Seat 8: Th3Fog folded before Flop (didn't bet)
Seat 9: BlOnDhOlIc folded before Flop (didn't bet)



PokerStars Zoom Hand #84298526671:  Hold'em No Limit ($0.10/$0.25) - 2012/08/05 13:19:25 JST [2012/08/05 0:19:25 ET]
Table 'Whirlpool' 9-max Seat #1 is the button
Seat 1: 4ydo yogurt ($20.10 in chips) 
Seat 2: chiyuki ($23.90 in chips) 
Seat 3: Rodina-Kr ($25 in chips) 
Seat 4: PetitAlejo ($25 in chips) 
Seat 5: deadmoneykid ($22.41 in chips) 
Seat 6: puffy5533 ($16.93 in chips) 
Seat 7: mikifeio ($43.94 in chips) 
Seat 8: Suhoff76 ($25 in chips) 
Seat 9: bigrasbig ($69.22 in chips) 
chiyuki: posts small blind $0.10
Rodina-Kr: posts big blind $0.25
*** HOLE CARDS ***
Dealt to chiyuki [7s 4h]
PetitAlejo: folds 
deadmoneykid: folds 
puffy5533: raises $0.50 to $0.75
mikifeio: folds 
Suhoff76: folds 
bigrasbig: folds 
4ydo yogurt: folds 
chiyuki: folds 
Rodina-Kr: calls $0.50
*** FLOP *** [Qh Jc 3d]
Rodina-Kr: checks 
puffy5533: checks 
*** TURN *** [Qh Jc 3d] [9s]
Rodina-Kr: bets $1.10
puffy5533: folds 
Uncalled bet ($1.10) returned to Rodina-Kr
Rodina-Kr collected $1.53 from pot
Rodina-Kr: doesn't show hand 
*** SUMMARY ***
Total pot $1.60 | Rake $0.07 
Board [Qh Jc 3d 9s]
Seat 1: 4ydo yogurt (button) folded before Flop (didn't bet)
Seat 2: chiyuki (small blind) folded before Flop
Seat 3: Rodina-Kr (big blind) collected ($1.53)
Seat 4: PetitAlejo folded before Flop (didn't bet)
Seat 5: deadmoneykid folded before Flop (didn't bet)
Seat 6: puffy5533 folded on the Turn
Seat 7: mikifeio folded before Flop (didn't bet)
Seat 8: Suhoff76 folded before Flop (didn't bet)
Seat 9: bigrasbig folded before Flop (didn't bet)



PokerStars Zoom Hand #84298527491:  Hold'em No Limit ($0.10/$0.25) - 2012/08/05 13:19:28 JST [2012/08/05 0:19:28 ET]
Table 'Whirlpool' 9-max Seat #1 is the button
Seat 1: chiyuki ($23.80 in chips) 
Seat 2: Paranoix1990 ($23.71 in chips) 
Seat 3: BlOnDhOlIc ($26.08 in chips) 
Seat 4: polk11 ($20.82 in chips) 
Seat 5: Zugrug ($25.25 in chips) 
Seat 6: seula i ($25.23 in chips) 
Seat 7: RomarioJa ($8.31 in chips) 
Seat 8: petersmiths ($33.81 in chips) 
Seat 9: SlimeyGash ($22.76 in chips) 
Paranoix1990: posts small blind $0.10
BlOnDhOlIc: posts big blind $0.25
*** HOLE CARDS ***
Dealt to chiyuki [4h 8c]
polk11: folds 
Zugrug: folds 
seula i: folds 
RomarioJa: folds 
petersmiths: raises $0.25 to $0.50
SlimeyGash: folds 
chiyuki: folds 
Paranoix1990: calls $0.40
BlOnDhOlIc: folds 
*** FLOP *** [4d Ts 7d]
Paranoix1990: checks 
petersmiths: bets $0.47
Paranoix1990: calls $0.47
*** TURN *** [4d Ts 7d] [Js]
Paranoix1990: bets $0.25
petersmiths: calls $0.25
*** RIVER *** [4d Ts 7d Js] [Th]
Paranoix1990: bets $0.75
petersmiths: folds 
Uncalled bet ($0.75) returned to Paranoix1990
Paranoix1990 collected $2.57 from pot
Paranoix1990: doesn't show hand 
*** SUMMARY ***
Total pot $2.69 | Rake $0.12 
Board [4d Ts 7d Js Th]
Seat 1: chiyuki (button) folded before Flop (didn't bet)
Seat 2: Paranoix1990 (small blind) collected ($2.57)
Seat 3: BlOnDhOlIc (big blind) folded before Flop
Seat 4: polk11 folded before Flop (didn't bet)
Seat 5: Zugrug folded before Flop (didn't bet)
Seat 6: seula i folded before Flop (didn't bet)
Seat 7: RomarioJa folded before Flop (didn't bet)
Seat 8: petersmiths folded on the River
Seat 9: SlimeyGash folded before Flop (didn't bet)



PokerStars Zoom Hand #84298538116:  Hold'em No Limit ($0.10/$0.25) - 2012/08/05 13:20:06 JST [2012/08/05 0:20:06 ET]
Table 'Whirlpool' 9-max Seat #1 is the button
Seat 1: BlOnDhOlIc ($25.73 in chips) 
Seat 2: masterkoolb ($12.60 in chips) 
Seat 3: Loholov ($15 in chips) 
Seat 4: hirozo ($25 in chips) 
Seat 5: chiyuki ($23.80 in chips) 
Seat 6: RomarioJa ($8.31 in chips) 
Seat 7: TraderYao ($25.02 in chips) 
Seat 8: agurio ($25 in chips) 
Seat 9: Zugrug ($36.07 in chips) 
masterkoolb: posts small blind $0.10
Loholov: posts big blind $0.25
*** HOLE CARDS ***
Dealt to chiyuki [5d Ah]
hirozo: folds 
chiyuki: folds 
RomarioJa: folds 
TraderYao: raises $0.50 to $0.75
agurio: folds 
Zugrug: folds 
BlOnDhOlIc: folds 
masterkoolb: folds 
Loholov: folds 
Uncalled bet ($0.50) returned to TraderYao
TraderYao collected $0.60 from pot
TraderYao: doesn't show hand 
*** SUMMARY ***
Total pot $0.60 | Rake $0 
Seat 1: BlOnDhOlIc (button) folded before Flop (didn't bet)
Seat 2: masterkoolb (small blind) folded before Flop
Seat 3: Loholov (big blind) folded before Flop
Seat 4: hirozo folded before Flop (didn't bet)
Seat 5: chiyuki folded before Flop (didn't bet)
Seat 6: RomarioJa folded before Flop (didn't bet)
Seat 7: TraderYao collected ($0.60)
Seat 8: agurio folded before Flop (didn't bet)
Seat 9: Zugrug folded before Flop (didn't bet)



PokerStars Zoom Hand #84298540390:  Hold'em No Limit ($0.10/$0.25) - 2012/08/05 13:20:14 JST [2012/08/05 0:20:14 ET]
Table 'Whirlpool' 9-max Seat #1 is the button
Seat 1: chiyuki ($23.80 in chips) 
Seat 2: TraderYao ($25.10 in chips) 
Seat 3: Suhoff76 ($25 in chips) 
Seat 4: petersmiths ($32.59 in chips) 
Seat 5: Rodina-Kr ($25.68 in chips) 
Seat 6: DooMSDaY1337 ($27.41 in chips) 
Seat 7: KeLevro0 ($9.61 in chips) 
Seat 8: RomarioJa ($8.82 in chips) 
Seat 9: ll_LaMeR_ll ($25.16 in chips) 
TraderYao: posts small blind $0.10
Suhoff76: posts big blind $0.25
*** HOLE CARDS ***
Dealt to chiyuki [2s 7d]
petersmiths: raises $0.25 to $0.50
Rodina-Kr: folds 
DooMSDaY1337: folds 
KeLevro0: folds 
RomarioJa: folds 
ll_LaMeR_ll: folds 
chiyuki: folds 
TraderYao: folds 
Suhoff76: folds 
Uncalled bet ($0.25) returned to petersmiths
petersmiths collected $0.60 from pot
petersmiths: doesn't show hand 
*** SUMMARY ***
Total pot $0.60 | Rake $0 
Seat 1: chiyuki (button) folded before Flop (didn't bet)
Seat 2: TraderYao (small blind) folded before Flop
Seat 3: Suhoff76 (big blind) folded before Flop
Seat 4: petersmiths collected ($0.60)
Seat 5: Rodina-Kr folded before Flop (didn't bet)
Seat 6: DooMSDaY1337 folded before Flop (didn't bet)
Seat 7: KeLevro0 folded before Flop (didn't bet)
Seat 8: RomarioJa folded before Flop (didn't bet)
Seat 9: ll_LaMeR_ll folded before Flop (didn't bet)



PokerStars Zoom Hand #84298539223:  Hold'em No Limit ($0.10/$0.25) - 2012/08/05 13:20:10 JST [2012/08/05 0:20:10 ET]
Table 'Whirlpool' 9-max Seat #1 is the button
Seat 1: PetitAlejo ($25.10 in chips) 
Seat 2: a_tasmanian ($72.54 in chips) 
Seat 3: RomarioJa ($8.31 in chips) 
Seat 4: cR!Ma*aRm ($18.87 in chips) 
Seat 5: Suhoff76 ($25 in chips) 
Seat 6: chiyuki ($23.80 in chips) 
Seat 7: gAm813r ($26.92 in chips) 
Seat 8: DooMSDaY1337 ($71.71 in chips) 
Seat 9: Roglus ($18.46 in chips) 
a_tasmanian: posts small blind $0.10
RomarioJa: posts big blind $0.25
*** HOLE CARDS ***
Dealt to chiyuki [Jc 7h]
cR!Ma*aRm: calls $0.25
Suhoff76: folds 
chiyuki: folds 
gAm813r: folds 
DooMSDaY1337: folds 
Roglus: raises $0.62 to $0.87
PetitAlejo: folds 
a_tasmanian: folds 
RomarioJa: folds 
cR!Ma*aRm: calls $0.62
*** FLOP *** [As Qd 6d]
cR!Ma*aRm: checks 
Roglus: bets $1.25
cR!Ma*aRm: folds 
Uncalled bet ($1.25) returned to Roglus
Roglus collected $2 from pot
Roglus: doesn't show hand 
*** SUMMARY ***
Total pot $2.09 | Rake $0.09 
Board [As Qd 6d]
Seat 1: PetitAlejo (button) folded before Flop (didn't bet)
Seat 2: a_tasmanian (small blind) folded before Flop
Seat 3: RomarioJa (big blind) folded before Flop
Seat 4: cR!Ma*aRm folded on the Flop
Seat 5: Suhoff76 folded before Flop (didn't bet)
Seat 6: chiyuki folded before Flop (didn't bet)
Seat 7: gAm813r folded before Flop (didn't bet)
Seat 8: DooMSDaY1337 folded before Flop (didn't bet)
Seat 9: Roglus collected ($2)



PokerStars Zoom Hand #84298541537:  Hold'em No Limit ($0.10/$0.25) - 2012/08/05 13:20:18 JST [2012/08/05 0:20:18 ET]
Table 'Whirlpool' 9-max Seat #1 is the button
Seat 1: Zugrug ($29.29 in chips) 
Seat 2: NastyMcNast ($27.67 in chips) 
Seat 3: PetitAlejo ($27.46 in chips) 
Seat 4: Rodina-Kr ($25.68 in chips) 
Seat 5: chiyuki ($23.80 in chips) 
Seat 6: KeLevro0 ($9.61 in chips) 
Seat 7: RomarioJa ($8.82 in chips) 
Seat 8: ShockLaMuc ($24.18 in chips) 
Seat 9: nice.franki ($13.42 in chips) 
NastyMcNast: posts small blind $0.10
PetitAlejo: posts big blind $0.25
*** HOLE CARDS ***
Dealt to chiyuki [Ad Th]
Rodina-Kr: folds 
chiyuki: folds 
KeLevro0: folds 
RomarioJa: folds 
ShockLaMuc: folds 
nice.franki: raises $0.37 to $0.62
Zugrug: folds 
NastyMcNast: folds 
PetitAlejo: folds 
Uncalled bet ($0.37) returned to nice.franki
nice.franki collected $0.60 from pot
nice.franki: doesn't show hand 
*** SUMMARY ***
Total pot $0.60 | Rake $0 
Seat 1: Zugrug (button) folded before Flop (didn't bet)
Seat 2: NastyMcNast (small blind) folded before Flop
Seat 3: PetitAlejo (big blind) folded before Flop
Seat 4: Rodina-Kr folded before Flop (didn't bet)
Seat 5: chiyuki folded before Flop (didn't bet)
Seat 6: KeLevro0 folded before Flop (didn't bet)
Seat 7: RomarioJa folded before Flop (didn't bet)
Seat 8: ShockLaMuc folded before Flop (didn't bet)
Seat 9: nice.franki collected ($0.60)



PokerStars Zoom Hand #84298535674:  Hold'em No Limit ($0.10/$0.25) - 2012/08/05 13:19:57 JST [2012/08/05 0:19:57 ET]
Table 'Whirlpool' 9-max Seat #1 is the button
Seat 1: TraderYao ($25 in chips) 
Seat 2: munky3 ($24.50 in chips) 
Seat 3: Medic8681 ($14.79 in chips) 
Seat 4: chiyuki ($23.80 in chips) 
Seat 5: Alvinpe85 ($30.64 in chips) 
Seat 6: nice.franki ($11.10 in chips) 
Seat 7: TErr18 ($28.95 in chips) 
Seat 8: Suhoff76 ($25 in chips) 
Seat 9: BlackZafiro ($25.35 in chips) 
munky3: posts small blind $0.10
Medic8681: posts big blind $0.25
*** HOLE CARDS ***
Dealt to chiyuki [Jd 3d]
chiyuki: folds 
Alvinpe85: folds 
nice.franki: folds 
TErr18: folds 
Suhoff76: folds 
BlackZafiro: folds 
TraderYao: raises $0.37 to $0.62
munky3: calls $0.52
Medic8681: raises $1.88 to $2.50
TraderYao: folds 
munky3: calls $1.88
*** FLOP *** [Qc Ks 4h]
munky3: checks 
Medic8681: bets $3.50
munky3: calls $3.50
*** TURN *** [Qc Ks 4h] [2h]
munky3: checks 
Medic8681: bets $8.79 and is all-in
munky3: calls $8.79
*** RIVER *** [Qc Ks 4h 2h] [9h]
*** SHOW DOWN ***
munky3: shows [Qd As] (a pair of Queens)
Medic8681: shows [Kh Ad] (a pair of Kings)
Medic8681 collected $28.84 from pot
*** SUMMARY ***
Total pot $30.20 | Rake $1.36 
Board [Qc Ks 4h 2h 9h]
Seat 1: TraderYao (button) folded before Flop
Seat 2: munky3 (small blind) showed [Qd As] and lost with a pair of Queens
Seat 3: Medic8681 (big blind) showed [Kh Ad] and won ($28.84) with a pair of Kings
Seat 4: chiyuki folded before Flop (didn't bet)
Seat 5: Alvinpe85 folded before Flop (didn't bet)
Seat 6: nice.franki folded before Flop (didn't bet)
Seat 7: TErr18 folded before Flop (didn't bet)
Seat 8: Suhoff76 folded before Flop (didn't bet)
Seat 9: BlackZafiro folded before Flop (didn't bet)



PokerStars Zoom Hand #84298544135:  Hold'em No Limit ($0.10/$0.25) - 2012/08/05 13:20:28 JST [2012/08/05 0:20:28 ET]
Table 'Whirlpool' 9-max Seat #1 is the button
Seat 1: masterkoolb ($13.59 in chips) 
Seat 2: TErr18 ($28.70 in chips) 
Seat 3: chiyuki ($23.80 in chips) 
Seat 4: vit 111 ($40.58 in chips) 
Seat 5: a_tasmanian ($72.44 in chips) 
Seat 6: NastyMcNast ($42.42 in chips) 
Seat 7: PetitAlejo ($27.55 in chips) 
Seat 8: gedavaca ($32.82 in chips) 
Seat 9: bigrasbig ($68.87 in chips) 
TErr18: posts small blind $0.10
chiyuki: posts big blind $0.25
*** HOLE CARDS ***
Dealt to chiyuki [3c Ts]
vit 111: folds 
a_tasmanian: raises $0.25 to $0.50
NastyMcNast: folds 
PetitAlejo: folds 
gedavaca: folds 
bigrasbig: folds 
masterkoolb: folds 
TErr18: calls $0.40
chiyuki: folds 
*** FLOP *** [7c 9c Qs]
TErr18: checks 
a_tasmanian: bets $1
TErr18: folds 
Uncalled bet ($1) returned to a_tasmanian
a_tasmanian collected $1.19 from pot
a_tasmanian: doesn't show hand 
*** SUMMARY ***
Total pot $1.25 | Rake $0.06 
Board [7c 9c Qs]
Seat 1: masterkoolb (button) folded before Flop (didn't bet)
Seat 2: TErr18 (small blind) folded on the Flop
Seat 3: chiyuki (big blind) folded before Flop
Seat 4: vit 111 folded before Flop (didn't bet)
Seat 5: a_tasmanian collected ($1.19)
Seat 6: NastyMcNast folded before Flop (didn't bet)
Seat 7: PetitAlejo folded before Flop (didn't bet)
Seat 8: gedavaca folded before Flop (didn't bet)
Seat 9: bigrasbig folded before Flop (didn't bet)



PokerStars Zoom Hand #84298548834:  Hold'em No Limit ($0.10/$0.25) - 2012/08/05 13:20:45 JST [2012/08/05 0:20:45 ET]
Table 'Whirlpool' 9-max Seat #1 is the button
Seat 1: Th3Fog ($68.57 in chips) 
Seat 2: chiyuki ($23.55 in chips) 
Seat 3: BlackZafiro ($25.35 in chips) 
Seat 4: Suhoff76 ($25 in chips) 
Seat 5: Jene4kaBest ($12.18 in chips) 
Seat 6: jtedecaliss ($156.63 in chips) 
Seat 7: Loholov ($15.83 in chips) 
Seat 8: KeLevro0 ($13.32 in chips) 
Seat 9: goldstone ($26.80 in chips) 
chiyuki: posts small blind $0.10
BlackZafiro: posts big blind $0.25
*** HOLE CARDS ***
Dealt to chiyuki [5c 5h]
Suhoff76: folds 
Jene4kaBest: folds 
jtedecaliss: folds 
Loholov: raises $0.50 to $0.75
KeLevro0: folds 
goldstone: folds 
Th3Fog: calls $0.75
chiyuki: calls $0.65
BlackZafiro: folds 
*** FLOP *** [2c 2s As]
chiyuki: checks 
Loholov: checks 
Th3Fog: bets $1.05
chiyuki: folds 
Loholov: folds 
Uncalled bet ($1.05) returned to Th3Fog
Th3Fog collected $2.39 from pot
Th3Fog: doesn't show hand 
*** SUMMARY ***
Total pot $2.50 | Rake $0.11 
Board [2c 2s As]
Seat 1: Th3Fog (button) collected ($2.39)
Seat 2: chiyuki (small blind) folded on the Flop
Seat 3: BlackZafiro (big blind) folded before Flop
Seat 4: Suhoff76 folded before Flop (didn't bet)
Seat 5: Jene4kaBest folded before Flop (didn't bet)
Seat 6: jtedecaliss folded before Flop (didn't bet)
Seat 7: Loholov folded on the Flop
Seat 8: KeLevro0 folded before Flop (didn't bet)
Seat 9: goldstone folded before Flop (didn't bet)



PokerStars Zoom Hand #84298557832:  Hold'em No Limit ($0.10/$0.25) - 2012/08/05 13:21:17 JST [2012/08/05 0:21:17 ET]
Table 'Whirlpool' 9-max Seat #1 is the button
Seat 1: gedavaca ($32.47 in chips) 
Seat 2: slickthis ($34.49 in chips) 
Seat 3: TraderYao ($25 in chips) 
Seat 4: 5zzzz33 ($16.74 in chips) 
Seat 5: RomarioJa ($8.47 in chips) 
Seat 6: wtu1986 ($25.08 in chips) 
Seat 7: chiyuki ($22.80 in chips) 
Seat 8: deadmoneykid ($32.94 in chips) 
Seat 9: PetitAlejo ($27.11 in chips) 
slickthis: posts small blind $0.10
TraderYao: posts big blind $0.25
*** HOLE CARDS ***
Dealt to chiyuki [7s Kh]
5zzzz33: folds 
RomarioJa: raises $0.37 to $0.62
wtu1986: folds 
chiyuki: folds 
deadmoneykid: folds 
PetitAlejo: folds 
gedavaca: folds 
slickthis: folds 
TraderYao: folds 
Uncalled bet ($0.37) returned to RomarioJa
RomarioJa collected $0.60 from pot
RomarioJa: doesn't show hand 
*** SUMMARY ***
Total pot $0.60 | Rake $0 
Seat 1: gedavaca (button) folded before Flop (didn't bet)
Seat 2: slickthis (small blind) folded before Flop
Seat 3: TraderYao (big blind) folded before Flop
Seat 4: 5zzzz33 folded before Flop (didn't bet)
Seat 5: RomarioJa collected ($0.60)
Seat 6: wtu1986 folded before Flop (didn't bet)
Seat 7: chiyuki folded before Flop (didn't bet)
Seat 8: deadmoneykid folded before Flop (didn't bet)
Seat 9: PetitAlejo folded before Flop (didn't bet)



PokerStars Zoom Hand #84298560585:  Hold'em No Limit ($0.10/$0.25) - 2012/08/05 13:21:27 JST [2012/08/05 0:21:27 ET]
Table 'Whirlpool' 9-max Seat #1 is the button
Seat 1: Jippyflip ($19.80 in chips) 
Seat 2: PetitAlejo ($27.87 in chips) 
Seat 3: wtu1986 ($25.08 in chips) 
Seat 4: SlimeyGash ($22.31 in chips) 
Seat 5: hirozo ($25.35 in chips) 
Seat 6: MATT361 ($8.53 in chips) 
Seat 7: slapshot2011 ($36.69 in chips) 
Seat 8: Th3Fog ($56.38 in chips) 
Seat 9: chiyuki ($22.80 in chips) 
PetitAlejo: posts small blind $0.10
wtu1986: posts big blind $0.25
*** HOLE CARDS ***
Dealt to chiyuki [Ac 7s]
SlimeyGash: folds 
hirozo: folds 
MATT361: folds 
slapshot2011: folds 
Th3Fog: raises $0.35 to $0.60
chiyuki: folds 
Jippyflip: folds 
PetitAlejo: folds 
wtu1986: folds 
Uncalled bet ($0.35) returned to Th3Fog
Th3Fog collected $0.60 from pot
Th3Fog: doesn't show hand 
*** SUMMARY ***
Total pot $0.60 | Rake $0 
Seat 1: Jippyflip (button) folded before Flop (didn't bet)
Seat 2: PetitAlejo (small blind) folded before Flop
Seat 3: wtu1986 (big blind) folded before Flop
Seat 4: SlimeyGash folded before Flop (didn't bet)
Seat 5: hirozo folded before Flop (didn't bet)
Seat 6: MATT361 folded before Flop (didn't bet)
Seat 7: slapshot2011 folded before Flop (didn't bet)
Seat 8: Th3Fog collected ($0.60)
Seat 9: chiyuki folded before Flop (didn't bet)



PokerStars Zoom Hand #84298568722:  Hold'em No Limit ($0.10/$0.25) - 2012/08/05 13:21:57 JST [2012/08/05 0:21:57 ET]
Table 'Whirlpool' 9-max Seat #1 is the button
Seat 1: Suhoff76 ($25.40 in chips) 
Seat 2: ShockLaMuc ($26.88 in chips) 
Seat 3: cR!Ma*aRm ($14.25 in chips) 
Seat 4: chiyuki ($22.80 in chips) 
Seat 5: NastyMcNast ($42.07 in chips) 
Seat 6: Roglus ($18.84 in chips) 
Seat 7: silvno31 ($28.69 in chips) 
Seat 8: Paranoix1990 ($25.49 in chips) 
Seat 9: seula i ($54.72 in chips) 
ShockLaMuc: posts small blind $0.10
cR!Ma*aRm: posts big blind $0.25
*** HOLE CARDS ***
Dealt to chiyuki [2s Qh]
chiyuki: folds 
NastyMcNast: folds 
Roglus: folds 
silvno31: raises $0.50 to $0.75
Paranoix1990: folds 
seula i: folds 
Suhoff76: folds 
ShockLaMuc: folds 
cR!Ma*aRm: folds 
Uncalled bet ($0.50) returned to silvno31
silvno31 collected $0.60 from pot
silvno31: doesn't show hand 
*** SUMMARY ***
Total pot $0.60 | Rake $0 
Seat 1: Suhoff76 (button) folded before Flop (didn't bet)
Seat 2: ShockLaMuc (small blind) folded before Flop
Seat 3: cR!Ma*aRm (big blind) folded before Flop
Seat 4: chiyuki folded before Flop (didn't bet)
Seat 5: NastyMcNast folded before Flop (didn't bet)
Seat 6: Roglus folded before Flop (didn't bet)
Seat 7: silvno31 collected ($0.60)
Seat 8: Paranoix1990 folded before Flop (didn't bet)
Seat 9: seula i folded before Flop (didn't bet)



PokerStars Zoom Hand #84298569845:  Hold'em No Limit ($0.10/$0.25) - 2012/08/05 13:22:01 JST [2012/08/05 0:22:01 ET]
Table 'Whirlpool' 9-max Seat #1 is the button
Seat 1: chiyuki ($22.80 in chips) 
Seat 2: KeLevro0 ($8.65 in chips) 
Seat 3: fwani ($35.93 in chips) 
Seat 4: PetitAlejo ($25 in chips) 
Seat 5: RomarioJa ($11.62 in chips) 
Seat 6: Th3Fog ($28.62 in chips) 
Seat 7: Suhoff76 ($31.33 in chips) 
Seat 8: nice.franki ($10 in chips) 
Seat 9: Rodina-Kr ($25.33 in chips) 
KeLevro0: posts small blind $0.10
fwani: posts big blind $0.25
*** HOLE CARDS ***
Dealt to chiyuki [6d Kc]
PetitAlejo: folds 
RomarioJa: folds 
Th3Fog: folds 
Suhoff76: folds 
nice.franki: folds 
Rodina-Kr: folds 
chiyuki: folds 
KeLevro0: raises $0.42 to $0.67
fwani: folds 
Uncalled bet ($0.42) returned to KeLevro0
KeLevro0 collected $0.50 from pot
KeLevro0: doesn't show hand 
*** SUMMARY ***
Total pot $0.50 | Rake $0 
Seat 1: chiyuki (button) folded before Flop (didn't bet)
Seat 2: KeLevro0 (small blind) collected ($0.50)
Seat 3: fwani (big blind) folded before Flop
Seat 4: PetitAlejo folded before Flop (didn't bet)
Seat 5: RomarioJa folded before Flop (didn't bet)
Seat 6: Th3Fog folded before Flop (didn't bet)
Seat 7: Suhoff76 folded before Flop (didn't bet)
Seat 8: nice.franki folded before Flop (didn't bet)
Seat 9: Rodina-Kr folded before Flop (didn't bet)



PokerStars Zoom Hand #84298566519:  Hold'em No Limit ($0.10/$0.25) - 2012/08/05 13:21:49 JST [2012/08/05 0:21:49 ET]
Table 'Whirlpool' 9-max Seat #1 is the button
Seat 1: Lasutchik ($10.92 in chips) 
Seat 2: fwani ($25.35 in chips) 
Seat 3: softdesign ($55.70 in chips) 
Seat 4: Suhoff76 ($25.79 in chips) 
Seat 5: PetitAlejo ($27.77 in chips) 
Seat 6: KeLevro0 ($13.32 in chips) 
Seat 7: cR!Ma*aRm ($14.25 in chips) 
Seat 8: chiyuki ($22.80 in chips) 
Seat 9: KINGKILERACE ($21.69 in chips) 
fwani: posts small blind $0.10
softdesign: posts big blind $0.25
*** HOLE CARDS ***
Dealt to chiyuki [7c Tc]
Suhoff76: folds 
PetitAlejo: folds 
KeLevro0: folds 
cR!Ma*aRm: folds 
chiyuki: folds 
KINGKILERACE: raises $0.25 to $0.50
Lasutchik: folds 
fwani: folds 
softdesign: calls $0.25
*** FLOP *** [5h Ah 8c]
softdesign: bets $0.50
KINGKILERACE: calls $0.50
*** TURN *** [5h Ah 8c] [Ac]
softdesign: bets $0.50
KINGKILERACE: calls $0.50
*** RIVER *** [5h Ah 8c Ac] [Td]
softdesign: bets $0.50
KINGKILERACE: calls $0.50
*** SHOW DOWN ***
softdesign: shows [Kd 8s] (two pair, Aces and Eights)
KINGKILERACE: shows [Ks 8h] (two pair, Aces and Eights)
softdesign collected $1.96 from pot
KINGKILERACE collected $1.96 from pot
*** SUMMARY ***
Total pot $4.10 | Rake $0.18 
Board [5h Ah 8c Ac Td]
Seat 1: Lasutchik (button) folded before Flop (didn't bet)
Seat 2: fwani (small blind) folded before Flop
Seat 3: softdesign (big blind) showed [Kd 8s] and won ($1.96) with two pair, Aces and Eights
Seat 4: Suhoff76 folded before Flop (didn't bet)
Seat 5: PetitAlejo folded before Flop (didn't bet)
Seat 6: KeLevro0 folded before Flop (didn't bet)
Seat 7: cR!Ma*aRm folded before Flop (didn't bet)
Seat 8: chiyuki folded before Flop (didn't bet)
Seat 9: KINGKILERACE showed [Ks 8h] and won ($1.96) with two pair, Aces and Eights



PokerStars Zoom Hand #84298567659:  Hold'em No Limit ($0.10/$0.25) - 2012/08/05 13:21:53 JST [2012/08/05 0:21:53 ET]
Table 'Whirlpool' 9-max Seat #1 is the button
Seat 1: Rodina-Kr ($25.33 in chips) 
Seat 2: polk11 ($20.75 in chips) 
Seat 3: deadmoneykid ($27.09 in chips) 
Seat 4: gedavaca ($32.47 in chips) 
Seat 5: Th3Fog ($70.21 in chips) 
Seat 6: SlimeyGash ($22.31 in chips) 
Seat 7: chiyuki ($22.80 in chips) 
Seat 8: cR!Ma*aRm ($14.25 in chips) 
Seat 9: Suhoff76 ($25.40 in chips) 
polk11: posts small blind $0.10
deadmoneykid: posts big blind $0.25
*** HOLE CARDS ***
Dealt to chiyuki [Qd 9s]
gedavaca: calls $0.25
Th3Fog: folds 
SlimeyGash: folds 
chiyuki: folds 
cR!Ma*aRm: folds 
Suhoff76: folds 
Rodina-Kr: folds 
polk11: calls $0.15
deadmoneykid: checks 
*** FLOP *** [4h Js 5s]
polk11: checks 
deadmoneykid: checks 
gedavaca: bets $0.43
polk11: folds 
deadmoneykid: folds 
Uncalled bet ($0.43) returned to gedavaca
gedavaca collected $0.72 from pot
gedavaca: doesn't show hand 
*** SUMMARY ***
Total pot $0.75 | Rake $0.03 
Board [4h Js 5s]
Seat 1: Rodina-Kr (button) folded before Flop (didn't bet)
Seat 2: polk11 (small blind) folded on the Flop
Seat 3: deadmoneykid (big blind) folded on the Flop
Seat 4: gedavaca collected ($0.72)
Seat 5: Th3Fog folded before Flop (didn't bet)
Seat 6: SlimeyGash folded before Flop (didn't bet)
Seat 7: chiyuki folded before Flop (didn't bet)
Seat 8: cR!Ma*aRm folded before Flop (didn't bet)
Seat 9: Suhoff76 folded before Flop (didn't bet)



PokerStars Zoom Hand #84298572331:  Hold'em No Limit ($0.10/$0.25) - 2012/08/05 13:22:10 JST [2012/08/05 0:22:10 ET]
Table 'Whirlpool' 9-max Seat #1 is the button
Seat 1: D@vidMed ($33.33 in chips) 
Seat 2: 5zzzz33 ($16.74 in chips) 
Seat 3: chiyuki ($22.80 in chips) 
Seat 4: slapshot2011 ($36.79 in chips) 
Seat 5: Rodina-Kr ($25.33 in chips) 
Seat 6: PetitAlejo ($25 in chips) 
Seat 7: Medic8681 ($14.08 in chips) 
Seat 8: seula i ($74.27 in chips) 
Seat 9: nice.franki ($10 in chips) 
5zzzz33: posts small blind $0.10
chiyuki: posts big blind $0.25
*** HOLE CARDS ***
Dealt to chiyuki [2h 2s]
slapshot2011: folds 
Rodina-Kr: folds 
PetitAlejo: folds 
Medic8681: raises $0.50 to $0.75
seula i: folds 
nice.franki: folds 
D@vidMed: folds 
5zzzz33: folds 
chiyuki: folds 
Uncalled bet ($0.50) returned to Medic8681
Medic8681 collected $0.60 from pot
Medic8681: doesn't show hand 
*** SUMMARY ***
Total pot $0.60 | Rake $0 
Seat 1: D@vidMed (button) folded before Flop (didn't bet)
Seat 2: 5zzzz33 (small blind) folded before Flop
Seat 3: chiyuki (big blind) folded before Flop
Seat 4: slapshot2011 folded before Flop (didn't bet)
Seat 5: Rodina-Kr folded before Flop (didn't bet)
Seat 6: PetitAlejo folded before Flop (didn't bet)
Seat 7: Medic8681 collected ($0.60)
Seat 8: seula i folded before Flop (didn't bet)
Seat 9: nice.franki folded before Flop (didn't bet)



PokerStars Zoom Hand #84298578266:  Hold'em No Limit ($0.10/$0.25) - 2012/08/05 13:22:31 JST [2012/08/05 0:22:31 ET]
Table 'Whirlpool' 9-max Seat #1 is the button
Seat 1: wtu1986 ($25 in chips) 
Seat 2: DooMSDaY1337 ($25 in chips) 
Seat 3: Loholov ($15 in chips) 
Seat 4: Zugrug ($39.91 in chips) 
Seat 5: taksist889 ($36.74 in chips) 
Seat 6: chiyuki ($22.55 in chips) 
Seat 7: nice.franki ($9.90 in chips) 
Seat 8: Medic8681 ($12.50 in chips) 
Seat 9: TraderYao ($25 in chips) 
DooMSDaY1337: posts small blind $0.10
Loholov: posts big blind $0.25
*** HOLE CARDS ***
Dealt to chiyuki [Jc 7h]
Zugrug: folds 
taksist889: folds 
chiyuki: folds 
nice.franki: folds 
Medic8681: folds 
TraderYao: raises $0.50 to $0.75
wtu1986: folds 
DooMSDaY1337: folds 
Loholov: folds 
Uncalled bet ($0.50) returned to TraderYao
TraderYao collected $0.60 from pot
TraderYao: doesn't show hand 
*** SUMMARY ***
Total pot $0.60 | Rake $0 
Seat 1: wtu1986 (button) folded before Flop (didn't bet)
Seat 2: DooMSDaY1337 (small blind) folded before Flop
Seat 3: Loholov (big blind) folded before Flop
Seat 4: Zugrug folded before Flop (didn't bet)
Seat 5: taksist889 folded before Flop (didn't bet)
Seat 6: chiyuki folded before Flop (didn't bet)
Seat 7: nice.franki folded before Flop (didn't bet)
Seat 8: Medic8681 folded before Flop (didn't bet)
Seat 9: TraderYao collected ($0.60)



PokerStars Zoom Hand #84298581918:  Hold'em No Limit ($0.10/$0.25) - 2012/08/05 13:22:44 JST [2012/08/05 0:22:44 ET]
Table 'Whirlpool' 9-max Seat #1 is the button
Seat 1: DooMSDaY1337 ($25 in chips) 
Seat 2: Suhoff76 ($31.08 in chips) 
Seat 3: Zugrug ($33.59 in chips) 
Seat 4: ShockLaMuc ($23.08 in chips) 
Seat 5: D@vidMed ($33.33 in chips) 
Seat 6: nice.franki ($6.52 in chips) 
Seat 7: agurio ($25 in chips) 
Seat 8: RomarioJa ($7.61 in chips) 
Seat 9: chiyuki ($22.45 in chips) 
Suhoff76: posts small blind $0.10
Zugrug: posts big blind $0.25
*** HOLE CARDS ***
Dealt to chiyuki [Jd Qc]
ShockLaMuc: calls $0.25
D@vidMed: folds 
nice.franki: folds 
agurio: folds 
RomarioJa: folds 
chiyuki: folds 
DooMSDaY1337: folds 
Suhoff76: folds 
Zugrug: checks 
*** FLOP *** [5d 5h Qh]
Zugrug: bets $0.25
ShockLaMuc: folds 
Uncalled bet ($0.25) returned to Zugrug
Zugrug collected $0.57 from pot
Zugrug: doesn't show hand 
*** SUMMARY ***
Total pot $0.60 | Rake $0.03 
Board [5d 5h Qh]
Seat 1: DooMSDaY1337 (button) folded before Flop (didn't bet)
Seat 2: Suhoff76 (small blind) folded before Flop
Seat 3: Zugrug (big blind) collected ($0.57)
Seat 4: ShockLaMuc folded on the Flop
Seat 5: D@vidMed folded before Flop (didn't bet)
Seat 6: nice.franki folded before Flop (didn't bet)
Seat 7: agurio folded before Flop (didn't bet)
Seat 8: RomarioJa folded before Flop (didn't bet)
Seat 9: chiyuki folded before Flop (didn't bet)



PokerStars Zoom Hand #84298584119:  Hold'em No Limit ($0.10/$0.25) - 2012/08/05 13:22:53 JST [2012/08/05 0:22:53 ET]
Table 'Whirlpool' 9-max Seat #1 is the button
Seat 1: nice.franki ($9.90 in chips) 
Seat 2: TraderYao ($32.04 in chips) 
Seat 3: Suhoff76 ($25.25 in chips) 
Seat 4: puffy5533 ($15.18 in chips) 
Seat 5: goldstone ($26.21 in chips) 
Seat 6: RomarioJa ($5.74 in chips) 
Seat 7: DT_Jesus ($13.39 in chips) 
Seat 8: chiyuki ($22.45 in chips) 
Seat 9: munky3 ($5.86 in chips) 
TraderYao: posts small blind $0.10
Suhoff76: posts big blind $0.25
*** HOLE CARDS ***
Dealt to chiyuki [3c 6c]
puffy5533: folds 
goldstone: folds 
RomarioJa: raises $0.37 to $0.62
DT_Jesus: folds 
chiyuki: folds 
munky3: folds 
nice.franki: folds 
TraderYao: folds 
Suhoff76: folds 
Uncalled bet ($0.37) returned to RomarioJa
RomarioJa collected $0.60 from pot
RomarioJa: doesn't show hand 
*** SUMMARY ***
Total pot $0.60 | Rake $0 
Seat 1: nice.franki (button) folded before Flop (didn't bet)
Seat 2: TraderYao (small blind) folded before Flop
Seat 3: Suhoff76 (big blind) folded before Flop
Seat 4: puffy5533 folded before Flop (didn't bet)
Seat 5: goldstone folded before Flop (didn't bet)
Seat 6: RomarioJa collected ($0.60)
Seat 7: DT_Jesus folded before Flop (didn't bet)
Seat 8: chiyuki folded before Flop (didn't bet)
Seat 9: munky3 folded before Flop (didn't bet)



PokerStars Zoom Hand #84298585202:  Hold'em No Limit ($0.10/$0.25) - 2012/08/05 13:22:57 JST [2012/08/05 0:22:57 ET]
Table 'Whirlpool' 9-max Seat #1 is the button
Seat 1: fwani ($28.32 in chips) 
Seat 2: Th3Fog ($28.37 in chips) 
Seat 3: eagie20 ($138.01 in chips) 
Seat 4: munky3 ($5.86 in chips) 
Seat 5: chiyuki ($22.45 in chips) 
Seat 6: PetitAlejo ($26.76 in chips) 
Seat 7: Alvinpe85 ($26.77 in chips) 
Seat 8: ShockLaMuc ($28.27 in chips) 
Seat 9: DT_Jesus ($13.39 in chips) 
Th3Fog: posts small blind $0.10
eagie20: posts big blind $0.25
*** HOLE CARDS ***
Dealt to chiyuki [Qh Qc]
munky3: folds 
chiyuki: raises $0.50 to $0.75
PetitAlejo: folds 
Alvinpe85: folds 
ShockLaMuc: folds 
DT_Jesus: folds 
fwani: folds 
Th3Fog: folds 
eagie20: folds 
Uncalled bet ($0.50) returned to chiyuki
chiyuki collected $0.60 from pot
chiyuki: doesn't show hand 
*** SUMMARY ***
Total pot $0.60 | Rake $0 
Seat 1: fwani (button) folded before Flop (didn't bet)
Seat 2: Th3Fog (small blind) folded before Flop
Seat 3: eagie20 (big blind) folded before Flop
Seat 4: munky3 folded before Flop (didn't bet)
Seat 5: chiyuki collected ($0.60)
Seat 6: PetitAlejo folded before Flop (didn't bet)
Seat 7: Alvinpe85 folded before Flop (didn't bet)
Seat 8: ShockLaMuc folded before Flop (didn't bet)
Seat 9: DT_Jesus folded before Flop (didn't bet)



PokerStars Zoom Hand #84298580274:  Hold'em No Limit ($0.10/$0.25) - 2012/08/05 13:22:38 JST [2012/08/05 0:22:38 ET]
Table 'Whirlpool' 9-max Seat #1 is the button
Seat 1: NastyMcNast ($25.07 in chips) 
Seat 2: chiyuki ($22.55 in chips) 
Seat 3: Alvinpe85 ($27.02 in chips) 
Seat 4: taksist889 ($36.74 in chips) 
Seat 5: Lasutchik ($27.18 in chips) 
Seat 6: nice.franki ($9.90 in chips) 
Seat 7: eagie20 ($138.11 in chips) 
Seat 8: BlOnDhOlIc ($56.09 in chips) 
Seat 9: 5zzzz33 ($16.64 in chips) 
chiyuki: posts small blind $0.10
Alvinpe85: posts big blind $0.25
*** HOLE CARDS ***
Dealt to chiyuki [Kc 3h]
taksist889: folds 
Lasutchik: folds 
nice.franki: folds 
eagie20: folds 
BlOnDhOlIc: raises $0.37 to $0.62
5zzzz33: folds 
NastyMcNast: raises $1.63 to $2.25
chiyuki: folds 
Alvinpe85: folds 
BlOnDhOlIc: raises $2.50 to $4.75
NastyMcNast: folds 
Uncalled bet ($2.50) returned to BlOnDhOlIc
BlOnDhOlIc collected $4.85 from pot
BlOnDhOlIc: doesn't show hand 
*** SUMMARY ***
Total pot $4.85 | Rake $0 
Seat 1: NastyMcNast (button) folded before Flop
Seat 2: chiyuki (small blind) folded before Flop
Seat 3: Alvinpe85 (big blind) folded before Flop
Seat 4: taksist889 folded before Flop (didn't bet)
Seat 5: Lasutchik folded before Flop (didn't bet)
Seat 6: nice.franki folded before Flop (didn't bet)
Seat 7: eagie20 folded before Flop (didn't bet)
Seat 8: BlOnDhOlIc collected ($4.85)
Seat 9: 5zzzz33 folded before Flop (didn't bet)



PokerStars Zoom Hand #84298589688:  Hold'em No Limit ($0.10/$0.25) - 2012/08/05 13:23:13 JST [2012/08/05 0:23:13 ET]
Table 'Whirlpool' 9-max Seat #1 is the button
Seat 1: chiyuki ($22.80 in chips) 
Seat 2: puffy5533 ($15.18 in chips) 
Seat 3: PetitAlejo ($26.70 in chips) 
Seat 4: Alvinpe85 ($28.56 in chips) 
Seat 5: agurio ($25.35 in chips) 
Seat 6: wtu1986 ($24.73 in chips) 
Seat 7: MATT361 ($6.33 in chips) 
Seat 8: deadmoneykid ($27.19 in chips) 
Seat 9: Loholov ($15 in chips) 
puffy5533: posts small blind $0.10
PetitAlejo: posts big blind $0.25
*** HOLE CARDS ***
Dealt to chiyuki [2h Td]
Alvinpe85: folds 
agurio: folds 
wtu1986: folds 
MATT361: folds 
deadmoneykid: folds 
Loholov: folds 
chiyuki: folds 
puffy5533: folds 
Uncalled bet ($0.15) returned to PetitAlejo
PetitAlejo collected $0.20 from pot
PetitAlejo: doesn't show hand 
*** SUMMARY ***
Total pot $0.20 | Rake $0 
Seat 1: chiyuki (button) folded before Flop (didn't bet)
Seat 2: puffy5533 (small blind) folded before Flop
Seat 3: PetitAlejo (big blind) collected ($0.20)
Seat 4: Alvinpe85 folded before Flop (didn't bet)
Seat 5: agurio folded before Flop (didn't bet)
Seat 6: wtu1986 folded before Flop (didn't bet)
Seat 7: MATT361 folded before Flop (didn't bet)
Seat 8: deadmoneykid folded before Flop (didn't bet)
Seat 9: Loholov folded before Flop (didn't bet)



PokerStars Zoom Hand #84298596332:  Hold'em No Limit ($0.10/$0.25) - 2012/08/05 13:23:37 JST [2012/08/05 0:23:37 ET]
Table 'Whirlpool' 9-max Seat #1 is the button
Seat 1: goldstone ($25.46 in chips) 
Seat 2: agurio ($25.10 in chips) 
Seat 3: luyifei ($28.81 in chips) 
Seat 4: BlOnDhOlIc ($58.69 in chips) 
Seat 5: deadmoneykid ($27.19 in chips) 
Seat 6: Jippyflip ($19.05 in chips) 
Seat 7: chiyuki ($22.80 in chips) 
Seat 8: KeLevro0 ($40.38 in chips) 
Seat 9: TraderYao ($31.94 in chips) 
agurio: posts small blind $0.10
luyifei: posts big blind $0.25
*** HOLE CARDS ***
Dealt to chiyuki [6d 5h]
BlOnDhOlIc: folds 
deadmoneykid: folds 
Jippyflip: folds 
chiyuki: folds 
KeLevro0: folds 
TraderYao: folds 
goldstone: folds 
agurio: folds 
Uncalled bet ($0.15) returned to luyifei
luyifei collected $0.20 from pot
luyifei: doesn't show hand 
*** SUMMARY ***
Total pot $0.20 | Rake $0 
Seat 1: goldstone (button) folded before Flop (didn't bet)
Seat 2: agurio (small blind) folded before Flop
Seat 3: luyifei (big blind) collected ($0.20)
Seat 4: BlOnDhOlIc folded before Flop (didn't bet)
Seat 5: deadmoneykid folded before Flop (didn't bet)
Seat 6: Jippyflip folded before Flop (didn't bet)
Seat 7: chiyuki folded before Flop (didn't bet)
Seat 8: KeLevro0 folded before Flop (didn't bet)
Seat 9: TraderYao folded before Flop (didn't bet)



PokerStars Zoom Hand #84298597474:  Hold'em No Limit ($0.10/$0.25) - 2012/08/05 13:23:41 JST [2012/08/05 0:23:41 ET]
Table 'Whirlpool' 9-max Seat #1 is the button
Seat 1: RomarioJa ($5.99 in chips) 
Seat 2: goldstone ($25.46 in chips) 
Seat 3: fwani ($26.13 in chips) 
Seat 4: eagie20 ($135.26 in chips) 
Seat 5: chiyuki ($22.80 in chips) 
Seat 6: gedavaca ($36.11 in chips) 
Seat 7: hirozo ($25.35 in chips) 
Seat 8: cR!Ma*aRm ($13.25 in chips) 
Seat 9: nice.franki ($6.42 in chips) 
goldstone: posts small blind $0.10
fwani: posts big blind $0.25
*** HOLE CARDS ***
Dealt to chiyuki [8d Ac]
eagie20: folds 
chiyuki: folds 
gedavaca: folds 
hirozo: raises $0.50 to $0.75
cR!Ma*aRm: folds 
nice.franki: folds 
RomarioJa: raises $5.24 to $5.99 and is all-in
goldstone: folds 
fwani: folds 
hirozo: folds 
Uncalled bet ($5.24) returned to RomarioJa
RomarioJa collected $1.85 from pot
RomarioJa: doesn't show hand 
*** SUMMARY ***
Total pot $1.85 | Rake $0 
Seat 1: RomarioJa (button) collected ($1.85)
Seat 2: goldstone (small blind) folded before Flop
Seat 3: fwani (big blind) folded before Flop
Seat 4: eagie20 folded before Flop (didn't bet)
Seat 5: chiyuki folded before Flop (didn't bet)
Seat 6: gedavaca folded before Flop (didn't bet)
Seat 7: hirozo folded before Flop
Seat 8: cR!Ma*aRm folded before Flop (didn't bet)
Seat 9: nice.franki folded before Flop (didn't bet)



PokerStars Zoom Hand #84298598614:  Hold'em No Limit ($0.10/$0.25) - 2012/08/05 13:23:45 JST [2012/08/05 0:23:45 ET]
Table 'Whirlpool' 9-max Seat #1 is the button
Seat 1: Suhoff76 ($32.47 in chips) 
Seat 2: luyifei ($28.91 in chips) 
Seat 3: chiyuki ($22.80 in chips) 
Seat 4: ShockLaMuc ($27.92 in chips) 
Seat 5: masterkoolb ($12.50 in chips) 
Seat 6: gedavaca ($36.11 in chips) 
Seat 7: cR!Ma*aRm ($13.25 in chips) 
Seat 8: PetitAlejo ($26.80 in chips) 
Seat 9: eagie20 ($135.26 in chips) 
luyifei: posts small blind $0.10
chiyuki: posts big blind $0.25
*** HOLE CARDS ***
Dealt to chiyuki [6d Jh]
ShockLaMuc: folds 
masterkoolb: folds 
gedavaca: folds 
cR!Ma*aRm: folds 
PetitAlejo: folds 
eagie20: folds 
Suhoff76: folds 
luyifei: calls $0.15
chiyuki: checks 
*** FLOP *** [7h 6h Qd]
luyifei: bets $0.50
chiyuki: folds 
Uncalled bet ($0.50) returned to luyifei
luyifei collected $0.48 from pot
luyifei: doesn't show hand 
*** SUMMARY ***
Total pot $0.50 | Rake $0.02 
Board [7h 6h Qd]
Seat 1: Suhoff76 (button) folded before Flop (didn't bet)
Seat 2: luyifei (small blind) collected ($0.48)
Seat 3: chiyuki (big blind) folded on the Flop
Seat 4: ShockLaMuc folded before Flop (didn't bet)
Seat 5: masterkoolb folded before Flop (didn't bet)
Seat 6: gedavaca folded before Flop (didn't bet)
Seat 7: cR!Ma*aRm folded before Flop (didn't bet)
Seat 8: PetitAlejo folded before Flop (didn't bet)
Seat 9: eagie20 folded before Flop (didn't bet)



PokerStars Zoom Hand #84298606931:  Hold'em No Limit ($0.10/$0.25) - 2012/08/05 13:24:16 JST [2012/08/05 0:24:16 ET]
Table 'Whirlpool' 9-max Seat #1 is the button
Seat 1: BlackZafiro ($25 in chips) 
Seat 2: chiyuki ($22.55 in chips) 
Seat 3: KeLevro0 ($8.90 in chips) 
Seat 4: Medic8681 ($13.36 in chips) 
Seat 5: wtu1986 ($25.90 in chips) 
Seat 6: Zugrug ($35.41 in chips) 
Seat 7: polk11 ($20.60 in chips) 
Seat 8: TErr18 ($28.55 in chips) 
Seat 9: TraderYao ($25.60 in chips) 
chiyuki: posts small blind $0.10
KeLevro0: posts big blind $0.25
*** HOLE CARDS ***
Dealt to chiyuki [Kh As]
Medic8681: folds 
wtu1986: raises $0.50 to $0.75
Zugrug: folds 
polk11: folds 
TErr18: folds 
TraderYao: calls $0.75
BlackZafiro: folds 
chiyuki: raises $2 to $2.75
KeLevro0: folds 
wtu1986: folds 
TraderYao: folds 
Uncalled bet ($2) returned to chiyuki
chiyuki collected $2.50 from pot
chiyuki: doesn't show hand 
*** SUMMARY ***
Total pot $2.50 | Rake $0 
Seat 1: BlackZafiro (button) folded before Flop (didn't bet)
Seat 2: chiyuki (small blind) collected ($2.50)
Seat 3: KeLevro0 (big blind) folded before Flop
Seat 4: Medic8681 folded before Flop (didn't bet)
Seat 5: wtu1986 folded before Flop
Seat 6: Zugrug folded before Flop (didn't bet)
Seat 7: polk11 folded before Flop (didn't bet)
Seat 8: TErr18 folded before Flop (didn't bet)
Seat 9: TraderYao folded before Flop



PokerStars Zoom Hand #84298615213:  Hold'em No Limit ($0.10/$0.25) - 2012/08/05 13:24:46 JST [2012/08/05 0:24:46 ET]
Table 'Whirlpool' 9-max Seat #1 is the button
Seat 1: TErr18 ($28.55 in chips) 
Seat 2: wtu1986 ($25.15 in chips) 
Seat 3: Dejacob ($25 in chips) 
Seat 4: PetitAlejo ($25 in chips) 
Seat 5: Alvinpe85 ($29.75 in chips) 
Seat 6: ShockLaMuc ($27.77 in chips) 
Seat 7: RomarioJa ($6.84 in chips) 
Seat 8: chiyuki ($24.30 in chips) 
Seat 9: Pkdave ($22.74 in chips) 
wtu1986: posts small blind $0.10
Dejacob: posts big blind $0.25
*** HOLE CARDS ***
Dealt to chiyuki [7d 4d]
PetitAlejo: folds 
Alvinpe85: folds 
ShockLaMuc: folds 
RomarioJa: folds 
chiyuki: folds 
Pkdave: folds 
TErr18: folds 
wtu1986: raises $0.37 to $0.62
Dejacob: folds 
Uncalled bet ($0.37) returned to wtu1986
wtu1986 collected $0.50 from pot
wtu1986: doesn't show hand 
*** SUMMARY ***
Total pot $0.50 | Rake $0 
Seat 1: TErr18 (button) folded before Flop (didn't bet)
Seat 2: wtu1986 (small blind) collected ($0.50)
Seat 3: Dejacob (big blind) folded before Flop
Seat 4: PetitAlejo folded before Flop (didn't bet)
Seat 5: Alvinpe85 folded before Flop (didn't bet)
Seat 6: ShockLaMuc folded before Flop (didn't bet)
Seat 7: RomarioJa folded before Flop (didn't bet)
Seat 8: chiyuki folded before Flop (didn't bet)
Seat 9: Pkdave folded before Flop (didn't bet)



PokerStars Zoom Hand #84298617669:  Hold'em No Limit ($0.10/$0.25) - 2012/08/05 13:24:55 JST [2012/08/05 0:24:55 ET]
Table 'Whirlpool' 9-max Seat #1 is the button
Seat 1: polk11 ($20.70 in chips) 
Seat 2: BlOnDhOlIc ($25 in chips) 
Seat 3: nice.franki ($13.07 in chips) 
Seat 4: chiyuki ($24.30 in chips) 
Seat 5: fwani ($32.43 in chips) 
Seat 6: vit 111 ($36.77 in chips) 
Seat 7: hirozo ($26.04 in chips) 
Seat 8: Zugrug ($39.06 in chips) 
Seat 9: DooMSDaY1337 ($25 in chips) 
BlOnDhOlIc: posts small blind $0.10
nice.franki: posts big blind $0.25
*** HOLE CARDS ***
Dealt to chiyuki [Jd 9s]
chiyuki: folds 
fwani: folds 
vit 111: raises $0.50 to $0.75
hirozo: folds 
Zugrug: folds 
DooMSDaY1337: folds 
polk11: folds 
BlOnDhOlIc: folds 
nice.franki: folds 
Uncalled bet ($0.50) returned to vit 111
vit 111 collected $0.60 from pot
vit 111: doesn't show hand 
*** SUMMARY ***
Total pot $0.60 | Rake $0 
Seat 1: polk11 (button) folded before Flop (didn't bet)
Seat 2: BlOnDhOlIc (small blind) folded before Flop
Seat 3: nice.franki (big blind) folded before Flop
Seat 4: chiyuki folded before Flop (didn't bet)
Seat 5: fwani folded before Flop (didn't bet)
Seat 6: vit 111 collected ($0.60)
Seat 7: hirozo folded before Flop (didn't bet)
Seat 8: Zugrug folded before Flop (didn't bet)
Seat 9: DooMSDaY1337 folded before Flop (didn't bet)



PokerStars Zoom Hand #84298621005:  Hold'em No Limit ($0.10/$0.25) - 2012/08/05 13:25:07 JST [2012/08/05 0:25:07 ET]
Table 'Whirlpool' 9-max Seat #1 is the button
Seat 1: goldstone ($30.59 in chips) 
Seat 2: DooMSDaY1337 ($25 in chips) 
Seat 3: kamikkaze ($49.28 in chips) 
Seat 4: chiyuki ($24.30 in chips) 
Seat 5: KeLevro0 ($8.55 in chips) 
Seat 6: Zugrug ($39.06 in chips) 
Seat 7: MATT361 ($4.36 in chips) 
Seat 8: Dejacob ($25 in chips) 
Seat 9: BlackZafiro ($25 in chips) 
DooMSDaY1337: posts small blind $0.10
kamikkaze: posts big blind $0.25
*** HOLE CARDS ***
Dealt to chiyuki [8c Js]
chiyuki: folds 
KeLevro0: folds 
Zugrug: folds 
MATT361: folds 
Dejacob: raises $0.50 to $0.75
BlackZafiro: folds 
goldstone: folds 
DooMSDaY1337: folds 
kamikkaze: folds 
Uncalled bet ($0.50) returned to Dejacob
Dejacob collected $0.60 from pot
Dejacob: doesn't show hand 
*** SUMMARY ***
Total pot $0.60 | Rake $0 
Seat 1: goldstone (button) folded before Flop (didn't bet)
Seat 2: DooMSDaY1337 (small blind) folded before Flop
Seat 3: kamikkaze (big blind) folded before Flop
Seat 4: chiyuki folded before Flop (didn't bet)
Seat 5: KeLevro0 folded before Flop (didn't bet)
Seat 6: Zugrug folded before Flop (didn't bet)
Seat 7: MATT361 folded before Flop (didn't bet)
Seat 8: Dejacob collected ($0.60)
Seat 9: BlackZafiro folded before Flop (didn't bet)



PokerStars Zoom Hand #84298622961:  Hold'em No Limit ($0.10/$0.25) - 2012/08/05 13:25:14 JST [2012/08/05 0:25:14 ET]
Table 'Whirlpool' 9-max Seat #1 is the button
Seat 1: Suhoff76 ($25.99 in chips) 
Seat 2: PetitAlejo ($25 in chips) 
Seat 3: NastyMcNast ($28.62 in chips) 
Seat 4: nice.franki ($9.90 in chips) 
Seat 5: chiyuki ($24.30 in chips) 
Seat 6: goldstone ($30.59 in chips) 
Seat 7: deadmoneykid ($38.29 in chips) 
Seat 8: Th3Fog ($42.23 in chips) 
Seat 9: KeLevro0 ($8.55 in chips) 
PetitAlejo: posts small blind $0.10
NastyMcNast: posts big blind $0.25
*** HOLE CARDS ***
Dealt to chiyuki [Kc 8d]
nice.franki: folds 
chiyuki: folds 
goldstone: folds 
deadmoneykid: folds 
Th3Fog: folds 
KeLevro0: folds 
Suhoff76: folds 
PetitAlejo: raises $0.50 to $0.75
NastyMcNast: folds 
Uncalled bet ($0.50) returned to PetitAlejo
PetitAlejo collected $0.50 from pot
PetitAlejo: doesn't show hand 
*** SUMMARY ***
Total pot $0.50 | Rake $0 
Seat 1: Suhoff76 (button) folded before Flop (didn't bet)
Seat 2: PetitAlejo (small blind) collected ($0.50)
Seat 3: NastyMcNast (big blind) folded before Flop
Seat 4: nice.franki folded before Flop (didn't bet)
Seat 5: chiyuki folded before Flop (didn't bet)
Seat 6: goldstone folded before Flop (didn't bet)
Seat 7: deadmoneykid folded before Flop (didn't bet)
Seat 8: Th3Fog folded before Flop (didn't bet)
Seat 9: KeLevro0 folded before Flop (didn't bet)



PokerStars Zoom Hand #84298621864:  Hold'em No Limit ($0.10/$0.25) - 2012/08/05 13:25:10 JST [2012/08/05 0:25:10 ET]
Table 'Whirlpool' 9-max Seat #1 is the button
Seat 1: wtu1986 ($25.40 in chips) 
Seat 2: Zugrug ($35.16 in chips) 
Seat 3: Jippyflip ($18.70 in chips) 
Seat 4: PetitAlejo ($25.92 in chips) 
Seat 5: BlOnDhOlIc ($25 in chips) 
Seat 6: chiyuki ($24.30 in chips) 
Seat 7: hirozo ($25 in chips) 
Seat 8: Suhoff76 ($25.99 in chips) 
Seat 9: deadmoneykid ($38.29 in chips) 
Zugrug: posts small blind $0.10
Jippyflip: posts big blind $0.25
*** HOLE CARDS ***
Dealt to chiyuki [4h 5h]
PetitAlejo: folds 
BlOnDhOlIc: folds 
chiyuki: folds 
hirozo: folds 
Suhoff76: folds 
deadmoneykid: folds 
wtu1986: folds 
Zugrug: raises $0.25 to $0.50
Jippyflip: folds 
Uncalled bet ($0.25) returned to Zugrug
Zugrug collected $0.50 from pot
Zugrug: doesn't show hand 
*** SUMMARY ***
Total pot $0.50 | Rake $0 
Seat 1: wtu1986 (button) folded before Flop (didn't bet)
Seat 2: Zugrug (small blind) collected ($0.50)
Seat 3: Jippyflip (big blind) folded before Flop
Seat 4: PetitAlejo folded before Flop (didn't bet)
Seat 5: BlOnDhOlIc folded before Flop (didn't bet)
Seat 6: chiyuki folded before Flop (didn't bet)
Seat 7: hirozo folded before Flop (didn't bet)
Seat 8: Suhoff76 folded before Flop (didn't bet)
Seat 9: deadmoneykid folded before Flop (didn't bet)



PokerStars Zoom Hand #84298616838:  Hold'em No Limit ($0.10/$0.25) - 2012/08/05 13:24:52 JST [2012/08/05 0:24:52 ET]
Table 'Whirlpool' 9-max Seat #1 is the button
Seat 1: cR!Ma*aRm ($13.57 in chips) 
Seat 2: Medic8681 ($13.11 in chips) 
Seat 3: Lasutchik ($7.36 in chips) 
Seat 4: Th3Fog ($67.36 in chips) 
Seat 5: PetitAlejo ($25 in chips) 
Seat 6: chiyuki ($24.30 in chips) 
Seat 7: seula i ($62.93 in chips) 
Seat 8: Loholov ($15 in chips) 
Seat 9: kkbruins0408 ($21.47 in chips) 
Medic8681: posts small blind $0.10
Lasutchik: posts big blind $0.25
*** HOLE CARDS ***
Dealt to chiyuki [8c 9h]
Th3Fog: folds 
PetitAlejo: folds 
chiyuki: folds 
seula i: folds 
Loholov: raises $0.50 to $0.75
kkbruins0408: calls $0.75
cR!Ma*aRm: calls $0.75
Medic8681: folds 
Lasutchik: folds 
*** FLOP *** [Js 7d Kh]
Loholov: checks 
kkbruins0408: checks 
cR!Ma*aRm: bets $1.50
Loholov: folds 
kkbruins0408: calls $1.50
*** TURN *** [Js 7d Kh] [4d]
kkbruins0408: checks 
cR!Ma*aRm: checks 
*** RIVER *** [Js 7d Kh 4d] [Ts]
kkbruins0408: checks 
cR!Ma*aRm: checks 
*** SHOW DOWN ***
kkbruins0408: shows [Ac Tc] (a pair of Tens)
cR!Ma*aRm: mucks hand 
kkbruins0408 collected $5.35 from pot
*** SUMMARY ***
Total pot $5.60 | Rake $0.25 
Board [Js 7d Kh 4d Ts]
Seat 1: cR!Ma*aRm (button) mucked [As 9s]
Seat 2: Medic8681 (small blind) folded before Flop
Seat 3: Lasutchik (big blind) folded before Flop
Seat 4: Th3Fog folded before Flop (didn't bet)
Seat 5: PetitAlejo folded before Flop (didn't bet)
Seat 6: chiyuki folded before Flop (didn't bet)
Seat 7: seula i folded before Flop (didn't bet)
Seat 8: Loholov folded on the Flop
Seat 9: kkbruins0408 showed [Ac Tc] and won ($5.35) with a pair of Tens



PokerStars Zoom Hand #84298619908:  Hold'em No Limit ($0.10/$0.25) - 2012/08/05 13:25:03 JST [2012/08/05 0:25:03 ET]
Table 'Whirlpool' 9-max Seat #1 is the button
Seat 1: TraderYao ($27.82 in chips) 
Seat 2: RomarioJa ($6.84 in chips) 
Seat 3: fwani ($32.43 in chips) 
Seat 4: BlackZafiro ($25 in chips) 
Seat 5: PetitAlejo ($25.92 in chips) 
Seat 6: hirozo ($25 in chips) 
Seat 7: KeLevro0 ($8.55 in chips) 
Seat 8: wtu1986 ($24.75 in chips) 
Seat 9: chiyuki ($24.30 in chips) 
RomarioJa: posts small blind $0.10
fwani: posts big blind $0.25
*** HOLE CARDS ***
Dealt to chiyuki [9d 3c]
BlackZafiro: folds 
PetitAlejo: folds 
hirozo: folds 
KeLevro0: folds 
wtu1986: folds 
chiyuki: folds 
TraderYao: raises $0.37 to $0.62
RomarioJa: raises $1.23 to $1.85
fwani: raises $30.58 to $32.43 and is all-in
TraderYao: folds 
RomarioJa: folds 
Uncalled bet ($30.58) returned to fwani
fwani collected $4.32 from pot
fwani: doesn't show hand 
*** SUMMARY ***
Total pot $4.32 | Rake $0 
Seat 1: TraderYao (button) folded before Flop
Seat 2: RomarioJa (small blind) folded before Flop
Seat 3: fwani (big blind) collected ($4.32)
Seat 4: BlackZafiro folded before Flop (didn't bet)
Seat 5: PetitAlejo folded before Flop (didn't bet)
Seat 6: hirozo folded before Flop (didn't bet)
Seat 7: KeLevro0 folded before Flop (didn't bet)
Seat 8: wtu1986 folded before Flop (didn't bet)
Seat 9: chiyuki folded before Flop (didn't bet)



PokerStars Zoom Hand #84298624613:  Hold'em No Limit ($0.10/$0.25) - 2012/08/05 13:25:21 JST [2012/08/05 0:25:21 ET]
Table 'Whirlpool' 9-max Seat #1 is the button
Seat 1: nice.franki ($11.82 in chips) 
Seat 2: slapshot2011 ($36.82 in chips) 
Seat 3: chiyuki ($24.30 in chips) 
Seat 4: D@vidMed ($40.53 in chips) 
Seat 5: Th3Fog ($42.23 in chips) 
Seat 6: Suhoff76 ($25.99 in chips) 
Seat 7: Loholov ($15 in chips) 
Seat 8: vit 111 ($37.12 in chips) 
Seat 9: wtu1986 ($24.75 in chips) 
slapshot2011: posts small blind $0.10
chiyuki: posts big blind $0.25
*** HOLE CARDS ***
Dealt to chiyuki [Jc 4d]
D@vidMed: folds 
Th3Fog: raises $0.47 to $0.72
Suhoff76: folds 
Loholov: folds 
vit 111: folds 
wtu1986: folds 
nice.franki: folds 
slapshot2011: folds 
chiyuki: folds 
Uncalled bet ($0.47) returned to Th3Fog
Th3Fog collected $0.60 from pot
Th3Fog: doesn't show hand 
*** SUMMARY ***
Total pot $0.60 | Rake $0 
Seat 1: nice.franki (button) folded before Flop (didn't bet)
Seat 2: slapshot2011 (small blind) folded before Flop
Seat 3: chiyuki (big blind) folded before Flop
Seat 4: D@vidMed folded before Flop (didn't bet)
Seat 5: Th3Fog collected ($0.60)
Seat 6: Suhoff76 folded before Flop (didn't bet)
Seat 7: Loholov folded before Flop (didn't bet)
Seat 8: vit 111 folded before Flop (didn't bet)
Seat 9: wtu1986 folded before Flop (didn't bet)



PokerStars Zoom Hand #84298627145:  Hold'em No Limit ($0.10/$0.25) - 2012/08/05 13:25:30 JST [2012/08/05 0:25:30 ET]
Table 'Whirlpool' 9-max Seat #1 is the button
Seat 1: chiyuki ($24.05 in chips) 
Seat 2: agurio ($30.11 in chips) 
Seat 3: PetitAlejo ($34.98 in chips) 
Seat 4: Zugrug ($35.41 in chips) 
Seat 5: 5zzzz33 ($14.39 in chips) 
Seat 6: a_tasmanian ($88.26 in chips) 
Seat 7: fwani ($25 in chips) 
Seat 8: slapshot2011 ($36.72 in chips) 
Seat 9: Dejacob ($25 in chips) 
agurio: posts small blind $0.10
PetitAlejo: posts big blind $0.25
*** HOLE CARDS ***
Dealt to chiyuki [Kd Th]
Zugrug: folds 
5zzzz33: folds 
a_tasmanian: folds 
fwani: folds 
slapshot2011: folds 
Dejacob: folds 
chiyuki: raises $0.50 to $0.75
agurio: folds 
PetitAlejo: raises $1.50 to $2.25
chiyuki: folds 
Uncalled bet ($1.50) returned to PetitAlejo
PetitAlejo collected $1.60 from pot
PetitAlejo: doesn't show hand 
*** SUMMARY ***
Total pot $1.60 | Rake $0 
Seat 1: chiyuki (button) folded before Flop
Seat 2: agurio (small blind) folded before Flop
Seat 3: PetitAlejo (big blind) collected ($1.60)
Seat 4: Zugrug folded before Flop (didn't bet)
Seat 5: 5zzzz33 folded before Flop (didn't bet)
Seat 6: a_tasmanian folded before Flop (didn't bet)
Seat 7: fwani folded before Flop (didn't bet)
Seat 8: slapshot2011 folded before Flop (didn't bet)
Seat 9: Dejacob folded before Flop (didn't bet)



PokerStars Zoom Hand #84298643822:  Hold'em No Limit ($0.10/$0.25) - 2012/08/05 13:26:32 JST [2012/08/05 0:26:32 ET]
Table 'Whirlpool' 9-max Seat #1 is the button
Seat 1: munky3 ($8.88 in chips) 
Seat 2: seula i ($62.68 in chips) 
Seat 3: BlOnDhOlIc ($28.03 in chips) 
Seat 4: chiyuki ($23.20 in chips) 
Seat 5: polk11 ($20.25 in chips) 
Seat 6: Suhoff76 ($26.49 in chips) 
Seat 7: Medic8681 ($15.76 in chips) 
Seat 8: Rsonal ($23.89 in chips) 
Seat 9: TErr18 ($28.20 in chips) 
seula i: posts small blind $0.10
BlOnDhOlIc: posts big blind $0.25
*** HOLE CARDS ***
Dealt to chiyuki [Jc 9d]
chiyuki: folds 
polk11: folds 
Suhoff76: folds 
Medic8681: folds 
Rsonal: folds 
TErr18: folds 
munky3: folds 
seula i: folds 
Uncalled bet ($0.15) returned to BlOnDhOlIc
BlOnDhOlIc collected $0.20 from pot
BlOnDhOlIc: doesn't show hand 
*** SUMMARY ***
Total pot $0.20 | Rake $0 
Seat 1: munky3 (button) folded before Flop (didn't bet)
Seat 2: seula i (small blind) folded before Flop
Seat 3: BlOnDhOlIc (big blind) collected ($0.20)
Seat 4: chiyuki folded before Flop (didn't bet)
Seat 5: polk11 folded before Flop (didn't bet)
Seat 6: Suhoff76 folded before Flop (didn't bet)
Seat 7: Medic8681 folded before Flop (didn't bet)
Seat 8: Rsonal folded before Flop (didn't bet)
Seat 9: TErr18 folded before Flop (didn't bet)



PokerStars Zoom Hand #84298638062:  Hold'em No Limit ($0.10/$0.25) - 2012/08/05 13:26:10 JST [2012/08/05 0:26:10 ET]
Table 'Whirlpool' 9-max Seat #1 is the button
Seat 1: ShockLaMuc ($23.89 in chips) 
Seat 2: PetitAlejo ($35.83 in chips) 
Seat 3: munky3 ($9.23 in chips) 
Seat 4: deadmoneykid ($26.49 in chips) 
Seat 5: Roglus ($46.78 in chips) 
Seat 6: RomarioJa ($9.59 in chips) 
Seat 7: ll_LaMeR_ll ($46.87 in chips) 
Seat 8: chiyuki ($23.30 in chips) 
Seat 9: Jene4kaBest ($16.46 in chips) 
PetitAlejo: posts small blind $0.10
munky3: posts big blind $0.25
*** HOLE CARDS ***
Dealt to chiyuki [Jd As]
deadmoneykid: folds 
Roglus: raises $0.50 to $0.75
RomarioJa: folds 
ll_LaMeR_ll: folds 
chiyuki: folds 
Jene4kaBest: folds 
ShockLaMuc: calls $0.75
PetitAlejo: folds 
munky3: folds 
*** FLOP *** [Ks 4c 7c]
Roglus: bets $1
ShockLaMuc: calls $1
*** TURN *** [Ks 4c 7c] [2h]
Roglus: bets $2.25
ShockLaMuc: folds 
Uncalled bet ($2.25) returned to Roglus
Roglus collected $3.68 from pot
Roglus: doesn't show hand 
*** SUMMARY ***
Total pot $3.85 | Rake $0.17 
Board [Ks 4c 7c 2h]
Seat 1: ShockLaMuc (button) folded on the Turn
Seat 2: PetitAlejo (small blind) folded before Flop
Seat 3: munky3 (big blind) folded before Flop
Seat 4: deadmoneykid folded before Flop (didn't bet)
Seat 5: Roglus collected ($3.68)
Seat 6: RomarioJa folded before Flop (didn't bet)
Seat 7: ll_LaMeR_ll folded before Flop (didn't bet)
Seat 8: chiyuki folded before Flop (didn't bet)
Seat 9: Jene4kaBest folded before Flop (didn't bet)



PokerStars Zoom Hand #84298642218:  Hold'em No Limit ($0.10/$0.25) - 2012/08/05 13:26:25 JST [2012/08/05 0:26:25 ET]
Table 'Whirlpool' 9-max Seat #1 is the button
Seat 1: BlackZafiro ($25 in chips) 
Seat 2: chiyuki ($23.30 in chips) 
Seat 3: Alvinpe85 ($55.15 in chips) 
Seat 4: goldstone ($26.38 in chips) 
Seat 5: Suhoff76 ($31.82 in chips) 
Seat 6: BlOnDhOlIc ($54.96 in chips) 
Seat 7: PetitAlejo ($28.42 in chips) 
Seat 8: hirozo ($25 in chips) 
Seat 9: KeLevro0 ($9.99 in chips) 
chiyuki: posts small blind $0.10
Alvinpe85: posts big blind $0.25
*** HOLE CARDS ***
Dealt to chiyuki [Tc 9h]
goldstone: folds 
Suhoff76: folds 
BlOnDhOlIc: folds 
PetitAlejo: raises $0.50 to $0.75
hirozo: folds 
KeLevro0: folds 
BlackZafiro: folds 
chiyuki: folds 
Alvinpe85: folds 
Uncalled bet ($0.50) returned to PetitAlejo
PetitAlejo collected $0.60 from pot
PetitAlejo: doesn't show hand 
*** SUMMARY ***
Total pot $0.60 | Rake $0 
Seat 1: BlackZafiro (button) folded before Flop (didn't bet)
Seat 2: chiyuki (small blind) folded before Flop
Seat 3: Alvinpe85 (big blind) folded before Flop
Seat 4: goldstone folded before Flop (didn't bet)
Seat 5: Suhoff76 folded before Flop (didn't bet)
Seat 6: BlOnDhOlIc folded before Flop (didn't bet)
Seat 7: PetitAlejo collected ($0.60)
Seat 8: hirozo folded before Flop (didn't bet)
Seat 9: KeLevro0 folded before Flop (didn't bet)



PokerStars Zoom Hand #84298647449:  Hold'em No Limit ($0.10/$0.25) - 2012/08/05 13:26:45 JST [2012/08/05 0:26:45 ET]
Table 'Whirlpool' 9-max Seat #1 is the button
Seat 1: chiyuki ($23.20 in chips) 
Seat 2: seula i ($51.48 in chips) 
Seat 3: bernard35 ($12.50 in chips) 
Seat 4: TErr18 ($28.20 in chips) 
Seat 5: Medic8681 ($15.76 in chips) 
Seat 6: 4ydo yogurt ($5.93 in chips) 
Seat 7: masterkoolb ($13.37 in chips) 
Seat 8: deadmoneykid ($25.27 in chips) 
Seat 9: Suhoff76 ($25.97 in chips) 
seula i: posts small blind $0.10
bernard35: posts big blind $0.25
*** HOLE CARDS ***
Dealt to chiyuki [8s Jh]
TErr18: folds 
Medic8681: folds 
4ydo yogurt: folds 
masterkoolb: raises $0.60 to $0.85
deadmoneykid: folds 
Suhoff76: folds 
chiyuki: folds 
seula i: folds 
bernard35: folds 
Uncalled bet ($0.60) returned to masterkoolb
masterkoolb collected $0.60 from pot
masterkoolb: doesn't show hand 
*** SUMMARY ***
Total pot $0.60 | Rake $0 
Seat 1: chiyuki (button) folded before Flop (didn't bet)
Seat 2: seula i (small blind) folded before Flop
Seat 3: bernard35 (big blind) folded before Flop
Seat 4: TErr18 folded before Flop (didn't bet)
Seat 5: Medic8681 folded before Flop (didn't bet)
Seat 6: 4ydo yogurt folded before Flop (didn't bet)
Seat 7: masterkoolb collected ($0.60)
Seat 8: deadmoneykid folded before Flop (didn't bet)
Seat 9: Suhoff76 folded before Flop (didn't bet)



PokerStars Zoom Hand #84298651215:  Hold'em No Limit ($0.10/$0.25) - 2012/08/05 13:26:59 JST [2012/08/05 0:26:59 ET]
Table 'Whirlpool' 9-max Seat #1 is the button
Seat 1: Th3Fog ($26.97 in chips) 
Seat 2: Dejacob ($25 in chips) 
Seat 3: chiyuki ($23.20 in chips) 
Seat 4: a_tasmanian ($87.21 in chips) 
Seat 5: KeLevro0 ($11.80 in chips) 
Seat 6: Landybob ($25 in chips) 
Seat 7: ShockLaMuc ($36.50 in chips) 
Seat 8: Loholov ($15 in chips) 
Seat 9: nice.franki ($11.47 in chips) 
Dejacob: posts small blind $0.10
chiyuki: posts big blind $0.25
*** HOLE CARDS ***
Dealt to chiyuki [3c 5s]
a_tasmanian: folds 
KeLevro0: folds 
Landybob: folds 
ShockLaMuc: folds 
Loholov: folds 
nice.franki: folds 
Th3Fog: folds 
Dejacob: folds 
Uncalled bet ($0.15) returned to chiyuki
chiyuki collected $0.20 from pot
chiyuki: doesn't show hand 
*** SUMMARY ***
Total pot $0.20 | Rake $0 
Seat 1: Th3Fog (button) folded before Flop (didn't bet)
Seat 2: Dejacob (small blind) folded before Flop
Seat 3: chiyuki (big blind) collected ($0.20)
Seat 4: a_tasmanian folded before Flop (didn't bet)
Seat 5: KeLevro0 folded before Flop (didn't bet)
Seat 6: Landybob folded before Flop (didn't bet)
Seat 7: ShockLaMuc folded before Flop (didn't bet)
Seat 8: Loholov folded before Flop (didn't bet)
Seat 9: nice.franki folded before Flop (didn't bet)



PokerStars Zoom Hand #84298646699:  Hold'em No Limit ($0.10/$0.25) - 2012/08/05 13:26:42 JST [2012/08/05 0:26:42 ET]
Table 'Whirlpool' 9-max Seat #1 is the button
Seat 1: RomarioJa ($8.35 in chips) 
Seat 2: Zugrug ($34.68 in chips) 
Seat 3: KINGKILERACE ($23.54 in chips) 
Seat 4: KeLevro0 ($11.80 in chips) 
Seat 5: BlOnDhOlIc ($25.25 in chips) 
Seat 6: TErr18 ($28.20 in chips) 
Seat 7: chiyuki ($23.20 in chips) 
Seat 8: NastyMcNast ($56.26 in chips) 
Seat 9: TraderYao ($26.85 in chips) 
Zugrug: posts small blind $0.10
KINGKILERACE: posts big blind $0.25
*** HOLE CARDS ***
Dealt to chiyuki [Ac 3h]
KeLevro0: folds 
BlOnDhOlIc: folds 
TErr18: folds 
chiyuki: folds 
NastyMcNast: folds 
TraderYao: folds 
RomarioJa: raises $0.50 to $0.75
Zugrug: folds 
KINGKILERACE: calls $0.50
*** FLOP *** [4h Qh 9d]
KINGKILERACE: checks 
RomarioJa: bets $1.14
KINGKILERACE: folds 
Uncalled bet ($1.14) returned to RomarioJa
RomarioJa collected $1.53 from pot
RomarioJa: doesn't show hand 
*** SUMMARY ***
Total pot $1.60 | Rake $0.07 
Board [4h Qh 9d]
Seat 1: RomarioJa (button) collected ($1.53)
Seat 2: Zugrug (small blind) folded before Flop
Seat 3: KINGKILERACE (big blind) folded on the Flop
Seat 4: KeLevro0 folded before Flop (didn't bet)
Seat 5: BlOnDhOlIc folded before Flop (didn't bet)
Seat 6: TErr18 folded before Flop (didn't bet)
Seat 7: chiyuki folded before Flop (didn't bet)
Seat 8: NastyMcNast folded before Flop (didn't bet)
Seat 9: TraderYao folded before Flop (didn't bet)



PokerStars Zoom Hand #84298654952:  Hold'em No Limit ($0.10/$0.25) - 2012/08/05 13:27:13 JST [2012/08/05 0:27:13 ET]
Table 'Whirlpool' 9-max Seat #1 is the button
Seat 1: nice.franki ($3.57 in chips) 
Seat 2: Roglus ($48.46 in chips) 
Seat 3: DooMSDaY1337 ($95.36 in chips) 
Seat 4: fwani ($34.90 in chips) 
Seat 5: Medic8681 ($17.38 in chips) 
Seat 6: ShockLaMuc ($25.08 in chips) 
Seat 7: TraderYao ($27.03 in chips) 
Seat 8: BlOnDhOlIc ($54.61 in chips) 
Seat 9: chiyuki ($23.30 in chips) 
Roglus: posts small blind $0.10
DooMSDaY1337: posts big blind $0.25
*** HOLE CARDS ***
Dealt to chiyuki [Kd 5s]
fwani: folds 
Medic8681: folds 
ShockLaMuc: folds 
TraderYao: folds 
BlOnDhOlIc: folds 
chiyuki: folds 
nice.franki: folds 
Roglus: folds 
Uncalled bet ($0.15) returned to DooMSDaY1337
DooMSDaY1337 collected $0.20 from pot
DooMSDaY1337: doesn't show hand 
*** SUMMARY ***
Total pot $0.20 | Rake $0 
Seat 1: nice.franki (button) folded before Flop (didn't bet)
Seat 2: Roglus (small blind) folded before Flop
Seat 3: DooMSDaY1337 (big blind) collected ($0.20)
Seat 4: fwani folded before Flop (didn't bet)
Seat 5: Medic8681 folded before Flop (didn't bet)
Seat 6: ShockLaMuc folded before Flop (didn't bet)
Seat 7: TraderYao folded before Flop (didn't bet)
Seat 8: BlOnDhOlIc folded before Flop (didn't bet)
Seat 9: chiyuki folded before Flop (didn't bet)



PokerStars Zoom Hand #84298657397:  Hold'em No Limit ($0.10/$0.25) - 2012/08/05 13:27:22 JST [2012/08/05 0:27:22 ET]
Table 'Whirlpool' 9-max Seat #1 is the button
Seat 1: Roglus ($48.36 in chips) 
Seat 2: seula i ($25 in chips) 
Seat 3: Jene4kaBest ($15.21 in chips) 
Seat 4: BlackZafiro ($25 in chips) 
Seat 5: Medic8681 ($17.38 in chips) 
Seat 6: D@vidMed ($41.32 in chips) 
Seat 7: Zugrug ($39.06 in chips) 
Seat 8: chiyuki ($23.30 in chips) 
Seat 9: KeLevro0 ($9.99 in chips) 
seula i: posts small blind $0.10
Jene4kaBest: posts big blind $0.25
*** HOLE CARDS ***
Dealt to chiyuki [6d 2h]
BlackZafiro: folds 
Medic8681: folds 
D@vidMed: folds 
Zugrug: folds 
chiyuki: folds 
KeLevro0: raises $0.42 to $0.67
Roglus: calls $0.67
seula i: folds 
Jene4kaBest: folds 
*** FLOP *** [Jc 8s 7h]
KeLevro0: bets $0.90
Roglus: calls $0.90
*** TURN *** [Jc 8s 7h] [4c]
KeLevro0: checks 
Roglus: checks 
*** RIVER *** [Jc 8s 7h 4c] [6c]
KeLevro0: checks 
Roglus: checks 
*** SHOW DOWN ***
KeLevro0: shows [Ad Ks] (high card Ace)
Roglus: mucks hand 
KeLevro0 collected $3.33 from pot
*** SUMMARY ***
Total pot $3.49 | Rake $0.16 
Board [Jc 8s 7h 4c 6c]
Seat 1: Roglus (button) mucked [Td Kh]
Seat 2: seula i (small blind) folded before Flop
Seat 3: Jene4kaBest (big blind) folded before Flop
Seat 4: BlackZafiro folded before Flop (didn't bet)
Seat 5: Medic8681 folded before Flop (didn't bet)
Seat 6: D@vidMed folded before Flop (didn't bet)
Seat 7: Zugrug folded before Flop (didn't bet)
Seat 8: chiyuki folded before Flop (didn't bet)
Seat 9: KeLevro0 showed [Ad Ks] and won ($3.33) with high card Ace



PokerStars Zoom Hand #84298661781:  Hold'em No Limit ($0.10/$0.25) - 2012/08/05 13:27:38 JST [2012/08/05 0:27:38 ET]
Table 'Whirlpool' 9-max Seat #1 is the button
Seat 1: Lasutchik ($25.26 in chips) 
Seat 2: chiyuki ($23.30 in chips) 
Seat 3: Dejacob ($25 in chips) 
Seat 4: PetitAlejo ($36.08 in chips) 
Seat 5: goldstone ($34.88 in chips) 
Seat 6: a_tasmanian ($87.21 in chips) 
Seat 7: Loholov ($37.10 in chips) 
Seat 8: Suhoff76 ($25 in chips) 
Seat 9: wtu1986 ($25 in chips) 
chiyuki: posts small blind $0.10
Dejacob: posts big blind $0.25
*** HOLE CARDS ***
Dealt to chiyuki [9s 4c]
PetitAlejo: folds 
goldstone: folds 
a_tasmanian: folds 
Loholov: folds 
Suhoff76: folds 
wtu1986: raises $0.50 to $0.75
Lasutchik: folds 
chiyuki: folds 
Dejacob: folds 
Uncalled bet ($0.50) returned to wtu1986
wtu1986 collected $0.60 from pot
wtu1986: doesn't show hand 
*** SUMMARY ***
Total pot $0.60 | Rake $0 
Seat 1: Lasutchik (button) folded before Flop (didn't bet)
Seat 2: chiyuki (small blind) folded before Flop
Seat 3: Dejacob (big blind) folded before Flop
Seat 4: PetitAlejo folded before Flop (didn't bet)
Seat 5: goldstone folded before Flop (didn't bet)
Seat 6: a_tasmanian folded before Flop (didn't bet)
Seat 7: Loholov folded before Flop (didn't bet)
Seat 8: Suhoff76 folded before Flop (didn't bet)
Seat 9: wtu1986 collected ($0.60)



PokerStars Zoom Hand #84298656289:  Hold'em No Limit ($0.10/$0.25) - 2012/08/05 13:27:18 JST [2012/08/05 0:27:18 ET]
Table 'Whirlpool' 9-max Seat #1 is the button
Seat 1: BlOnDhOlIc ($54.61 in chips) 
Seat 2: KeLevro0 ($10.09 in chips) 
Seat 3: Nerkit ($12.50 in chips) 
Seat 4: masterkoolb ($12.85 in chips) 
Seat 5: PetitAlejo ($36.08 in chips) 
Seat 6: NastyMcNast ($37.98 in chips) 
Seat 7: chiyuki ($23.30 in chips) 
Seat 8: Roglus ($48.36 in chips) 
Seat 9: RomarioJa ($9.13 in chips) 
KeLevro0: posts small blind $0.10
Nerkit: posts big blind $0.25
*** HOLE CARDS ***
Dealt to chiyuki [Td Ks]
masterkoolb: folds 
PetitAlejo: folds 
NastyMcNast: raises $0.50 to $0.75
chiyuki: folds 
Roglus: folds 
RomarioJa: folds 
BlOnDhOlIc: raises $1.50 to $2.25
KeLevro0: folds 
Nerkit: folds 
NastyMcNast: calls $1.50
*** FLOP *** [6d 2c Jd]
NastyMcNast: checks 
BlOnDhOlIc: bets $3
NastyMcNast: folds 
Uncalled bet ($3) returned to BlOnDhOlIc
BlOnDhOlIc collected $4.63 from pot
BlOnDhOlIc: doesn't show hand 
*** SUMMARY ***
Total pot $4.85 | Rake $0.22 
Board [6d 2c Jd]
Seat 1: BlOnDhOlIc (button) collected ($4.63)
Seat 2: KeLevro0 (small blind) folded before Flop
Seat 3: Nerkit (big blind) folded before Flop
Seat 4: masterkoolb folded before Flop (didn't bet)
Seat 5: PetitAlejo folded before Flop (didn't bet)
Seat 6: NastyMcNast folded on the Flop
Seat 7: chiyuki folded before Flop (didn't bet)
Seat 8: Roglus folded before Flop (didn't bet)
Seat 9: RomarioJa folded before Flop (didn't bet)



PokerStars Zoom Hand #84298668370:  Hold'em No Limit ($0.10/$0.25) - 2012/08/05 13:28:03 JST [2012/08/05 0:28:03 ET]
Table 'Whirlpool' 9-max Seat #1 is the button
Seat 1: Jippyflip ($17.50 in chips) 
Seat 2: BlackZafiro ($25 in chips) 
Seat 3: hirozo ($25 in chips) 
Seat 4: Loholov ($37.10 in chips) 
Seat 5: silvno31 ($30.42 in chips) 
Seat 6: kamikkaze ($48.05 in chips) 
Seat 7: Th3Fog ($53.66 in chips) 
Seat 8: Zugrug ($33.96 in chips) 
Seat 9: chiyuki ($23.20 in chips) 
BlackZafiro: posts small blind $0.10
hirozo: posts big blind $0.25
*** HOLE CARDS ***
Dealt to chiyuki [3h 9c]
Loholov: folds 
silvno31: folds 
kamikkaze: folds 
Th3Fog: folds 
Zugrug: folds 
chiyuki: folds 
Jippyflip: folds 
BlackZafiro: folds 
Uncalled bet ($0.15) returned to hirozo
hirozo collected $0.20 from pot
hirozo: doesn't show hand 
*** SUMMARY ***
Total pot $0.20 | Rake $0 
Seat 1: Jippyflip (button) folded before Flop (didn't bet)
Seat 2: BlackZafiro (small blind) folded before Flop
Seat 3: hirozo (big blind) collected ($0.20)
Seat 4: Loholov folded before Flop (didn't bet)
Seat 5: silvno31 folded before Flop (didn't bet)
Seat 6: kamikkaze folded before Flop (didn't bet)
Seat 7: Th3Fog folded before Flop (didn't bet)
Seat 8: Zugrug folded before Flop (didn't bet)
Seat 9: chiyuki folded before Flop (didn't bet)



PokerStars Zoom Hand #84298667287:  Hold'em No Limit ($0.10/$0.25) - 2012/08/05 13:27:59 JST [2012/08/05 0:27:59 ET]
Table 'Whirlpool' 9-max Seat #1 is the button
Seat 1: ShockLaMuc ($36.25 in chips) 
Seat 2: Suhoff76 ($26.24 in chips) 
Seat 3: 5zzzz33 ($13.59 in chips) 
Seat 4: BlackZafiro ($25 in chips) 
Seat 5: chiyuki ($23.20 in chips) 
Seat 6: seula i ($25 in chips) 
Seat 7: simonzez ($63.57 in chips) 
Seat 8: Dejacob ($25 in chips) 
Seat 9: a_tasmanian ($87.31 in chips) 
Suhoff76: posts small blind $0.10
5zzzz33: posts big blind $0.25
*** HOLE CARDS ***
Dealt to chiyuki [3c Kd]
BlackZafiro: folds 
chiyuki: folds 
seula i: folds 
simonzez: raises $0.25 to $0.50
Dejacob: folds 
a_tasmanian: folds 
ShockLaMuc: folds 
Suhoff76: folds 
5zzzz33: folds 
Uncalled bet ($0.25) returned to simonzez
simonzez collected $0.60 from pot
simonzez: doesn't show hand 
*** SUMMARY ***
Total pot $0.60 | Rake $0 
Seat 1: ShockLaMuc (button) folded before Flop (didn't bet)
Seat 2: Suhoff76 (small blind) folded before Flop
Seat 3: 5zzzz33 (big blind) folded before Flop
Seat 4: BlackZafiro folded before Flop (didn't bet)
Seat 5: chiyuki folded before Flop (didn't bet)
Seat 6: seula i folded before Flop (didn't bet)
Seat 7: simonzez collected ($0.60)
Seat 8: Dejacob folded before Flop (didn't bet)
Seat 9: a_tasmanian folded before Flop (didn't bet)



PokerStars Zoom Hand #84298664818:  Hold'em No Limit ($0.10/$0.25) - 2012/08/05 13:27:50 JST [2012/08/05 0:27:50 ET]
Table 'Whirlpool' 9-max Seat #1 is the button
Seat 1: silvno31 ($30.42 in chips) 
Seat 2: fwani ($34.90 in chips) 
Seat 3: TraderYao ($31.94 in chips) 
Seat 4: jtedecaliss ($144.94 in chips) 
Seat 5: chiyuki ($23.20 in chips) 
Seat 6: BlackZafiro ($25 in chips) 
Seat 7: nice.franki ($12.37 in chips) 
Seat 8: Medic8681 ($16.11 in chips) 
Seat 9: seula i ($61.33 in chips) 
fwani: posts small blind $0.10
TraderYao: posts big blind $0.25
*** HOLE CARDS ***
Dealt to chiyuki [4c 2s]
jtedecaliss: folds 
chiyuki: folds 
BlackZafiro: folds 
nice.franki: folds 
Medic8681: raises $0.50 to $0.75
seula i: folds 
silvno31: folds 
fwani: raises $1.75 to $2.50
TraderYao: folds 
Medic8681: folds 
Uncalled bet ($1.75) returned to fwani
fwani collected $1.75 from pot
fwani: doesn't show hand 
*** SUMMARY ***
Total pot $1.75 | Rake $0 
Seat 1: silvno31 (button) folded before Flop (didn't bet)
Seat 2: fwani (small blind) collected ($1.75)
Seat 3: TraderYao (big blind) folded before Flop
Seat 4: jtedecaliss folded before Flop (didn't bet)
Seat 5: chiyuki folded before Flop (didn't bet)
Seat 6: BlackZafiro folded before Flop (didn't bet)
Seat 7: nice.franki folded before Flop (didn't bet)
Seat 8: Medic8681 folded before Flop
Seat 9: seula i folded before Flop (didn't bet)



PokerStars Zoom Hand #84298658213:  Hold'em No Limit ($0.10/$0.25) - 2012/08/05 13:27:25 JST [2012/08/05 0:27:25 ET]
Table 'Whirlpool' 9-max Seat #1 is the button
Seat 1: Lasutchik ($8.34 in chips) 
Seat 2: Pkdave ($26.70 in chips) 
Seat 3: ShockLaMuc ($25.08 in chips) 
Seat 4: SlimeyGash ($23.29 in chips) 
Seat 5: Loholov ($15 in chips) 
Seat 6: chiyuki ($23.30 in chips) 
Seat 7: munky3 ($18.67 in chips) 
Seat 8: RomarioJa ($5.74 in chips) 
Seat 9: nice.franki ($3.57 in chips) 
Pkdave: posts small blind $0.10
ShockLaMuc: posts big blind $0.25
*** HOLE CARDS ***
Dealt to chiyuki [Ks 3s]
SlimeyGash: calls $0.25
Loholov: folds 
chiyuki: folds 
munky3: calls $0.25
RomarioJa: folds 
nice.franki: folds 
Lasutchik: folds 
Pkdave: folds 
ShockLaMuc: checks 
*** FLOP *** [8d 9h 5d]
ShockLaMuc: checks 
SlimeyGash: bets $0.25
munky3: calls $0.25
ShockLaMuc: folds 
*** TURN *** [8d 9h 5d] [4s]
SlimeyGash: bets $0.80
munky3: folds 
Uncalled bet ($0.80) returned to SlimeyGash
SlimeyGash collected $1.29 from pot
SlimeyGash: doesn't show hand 
*** SUMMARY ***
Total pot $1.35 | Rake $0.06 
Board [8d 9h 5d 4s]
Seat 1: Lasutchik (button) folded before Flop (didn't bet)
Seat 2: Pkdave (small blind) folded before Flop
Seat 3: ShockLaMuc (big blind) folded on the Flop
Seat 4: SlimeyGash collected ($1.29)
Seat 5: Loholov folded before Flop (didn't bet)
Seat 6: chiyuki folded before Flop (didn't bet)
Seat 7: munky3 folded on the Turn
Seat 8: RomarioJa folded before Flop (didn't bet)
Seat 9: nice.franki folded before Flop (didn't bet)



PokerStars Zoom Hand #84298670249:  Hold'em No Limit ($0.10/$0.25) - 2012/08/05 13:28:10 JST [2012/08/05 0:28:10 ET]
Table 'Whirlpool' 9-max Seat #1 is the button
Seat 1: KeLevro0 ($11.80 in chips) 
Seat 2: Suhoff76 ($26.55 in chips) 
Seat 3: seula i ($51.38 in chips) 
Seat 4: NastyMcNast ($36.75 in chips) 
Seat 5: KINGKILERACE ($21.92 in chips) 
Seat 6: deadmoneykid ($29.28 in chips) 
Seat 7: Dejacob ($25 in chips) 
Seat 8: chiyuki ($23.20 in chips) 
Seat 9: fwani ($25 in chips) 
Suhoff76: posts small blind $0.10
seula i: posts big blind $0.25
*** HOLE CARDS ***
Dealt to chiyuki [2h Ad]
NastyMcNast: folds 
KINGKILERACE: raises $0.25 to $0.50
deadmoneykid: folds 
Dejacob: folds 
chiyuki: folds 
fwani: folds 
KeLevro0: folds 
Suhoff76: folds 
seula i: folds 
Uncalled bet ($0.25) returned to KINGKILERACE
KINGKILERACE collected $0.60 from pot
KINGKILERACE: doesn't show hand 
*** SUMMARY ***
Total pot $0.60 | Rake $0 
Seat 1: KeLevro0 (button) folded before Flop (didn't bet)
Seat 2: Suhoff76 (small blind) folded before Flop
Seat 3: seula i (big blind) folded before Flop
Seat 4: NastyMcNast folded before Flop (didn't bet)
Seat 5: KINGKILERACE collected ($0.60)
Seat 6: deadmoneykid folded before Flop (didn't bet)
Seat 7: Dejacob folded before Flop (didn't bet)
Seat 8: chiyuki folded before Flop (didn't bet)
Seat 9: fwani folded before Flop (didn't bet)



PokerStars Zoom Hand #84298672681:  Hold'em No Limit ($0.10/$0.25) - 2012/08/05 13:28:19 JST [2012/08/05 0:28:19 ET]
Table 'Whirlpool' 9-max Seat #1 is the button
Seat 1: ladymadon107 ($24.13 in chips) 
Seat 2: hirozo ($25.10 in chips) 
Seat 3: chiyuki ($23.20 in chips) 
Seat 4: nice.franki ($11.82 in chips) 
Seat 5: TraderYao ($31.69 in chips) 
Seat 6: DooMSDaY1337 ($95.71 in chips) 
Seat 7: NastyMcNast ($28.02 in chips) 
Seat 8: agurio ($27.62 in chips) 
Seat 9: Suhoff76 ($26.45 in chips) 
hirozo: posts small blind $0.10
chiyuki: posts big blind $0.25
*** HOLE CARDS ***
Dealt to chiyuki [2h 6s]
nice.franki: folds 
TraderYao: folds 
DooMSDaY1337: folds 
NastyMcNast: folds 
agurio: folds 
Suhoff76: folds 
ladymadon107: folds 
hirozo: raises $0.25 to $0.50
chiyuki: raises $1.25 to $1.75
hirozo: raises $3.50 to $5.25
chiyuki: raises $17.95 to $23.20 and is all-in
hirozo: calls $17.95
*** FLOP *** [Jd 6d Ah]
*** TURN *** [Jd 6d Ah] [7d]
*** RIVER *** [Jd 6d Ah 7d] [5c]
*** SHOW DOWN ***
hirozo: shows [Ad Ac] (three of a kind, Aces)
chiyuki: mucks hand 
hirozo collected $44.40 from pot
*** SUMMARY ***
Total pot $46.40 | Rake $2 
Board [Jd 6d Ah 7d 5c]
Seat 1: ladymadon107 (button) folded before Flop (didn't bet)
Seat 2: hirozo (small blind) showed [Ad Ac] and won ($44.40) with three of a kind, Aces
Seat 3: chiyuki (big blind) mucked [2h 6s]
Seat 4: nice.franki folded before Flop (didn't bet)
Seat 5: TraderYao folded before Flop (didn't bet)
Seat 6: DooMSDaY1337 folded before Flop (didn't bet)
Seat 7: NastyMcNast folded before Flop (didn't bet)
Seat 8: agurio folded before Flop (didn't bet)
Seat 9: Suhoff76 folded before Flop (didn't bet)



PokerStars Zoom Hand #84298688685:  Hold'em No Limit ($0.10/$0.25) - 2012/08/05 13:29:19 JST [2012/08/05 0:29:19 ET]
Table 'Whirlpool' 9-max Seat #1 is the button
Seat 1: chiyuki ($25 in chips) 
Seat 2: NastyMcNast ($55.66 in chips) 
Seat 3: KeLevro0 ($11.80 in chips) 
Seat 4: carlosrbr ($12 in chips) 
Seat 5: TraderYao ($25.75 in chips) 
Seat 6: diez007 ($25.80 in chips) 
Seat 7: PetitAlejo ($25 in chips) 
Seat 8: nice.franki ($8.45 in chips) 
Seat 9: wtu1986 ($26.50 in chips) 
NastyMcNast: posts small blind $0.10
KeLevro0: posts big blind $0.25
*** HOLE CARDS ***
Dealt to chiyuki [Ks 4s]
carlosrbr: raises $0.50 to $0.75
TraderYao: folds 
diez007: folds 
PetitAlejo: folds 
nice.franki: folds 
wtu1986: folds 
chiyuki: folds 
NastyMcNast: folds 
KeLevro0: folds 
Uncalled bet ($0.50) returned to carlosrbr
carlosrbr collected $0.60 from pot
carlosrbr: doesn't show hand 
*** SUMMARY ***
Total pot $0.60 | Rake $0 
Seat 1: chiyuki (button) folded before Flop (didn't bet)
Seat 2: NastyMcNast (small blind) folded before Flop
Seat 3: KeLevro0 (big blind) folded before Flop
Seat 4: carlosrbr collected ($0.60)
Seat 5: TraderYao folded before Flop (didn't bet)
Seat 6: diez007 folded before Flop (didn't bet)
Seat 7: PetitAlejo folded before Flop (didn't bet)
Seat 8: nice.franki folded before Flop (didn't bet)
Seat 9: wtu1986 folded before Flop (didn't bet)



PokerStars Zoom Hand #84298687369:  Hold'em No Limit ($0.10/$0.25) - 2012/08/05 13:29:14 JST [2012/08/05 0:29:14 ET]
Table 'Whirlpool' 9-max Seat #1 is the button
Seat 1: hirozo ($46.30 in chips) 
Seat 2: RomarioJa ($8.20 in chips) 
Seat 3: de harlekijn ($14.79 in chips) 
Seat 4: chiyuki ($25 in chips) 
Seat 5: diez007 ($25.80 in chips) 
Seat 6: carlosrbr ($12 in chips) 
Seat 7: KeLevro0 ($13.74 in chips) 
Seat 8: fwani ($30.91 in chips) 
Seat 9: PetitAlejo ($25 in chips) 
RomarioJa: posts small blind $0.10
de harlekijn: posts big blind $0.25
*** HOLE CARDS ***
Dealt to chiyuki [7s Kd]
chiyuki: folds 
diez007: folds 
carlosrbr: folds 
KeLevro0: folds 
fwani: folds 
PetitAlejo: folds 
hirozo: raises $0.25 to $0.50
RomarioJa: raises $1.60 to $2.10
de harlekijn: folds 
hirozo: folds 
Uncalled bet ($1.60) returned to RomarioJa
RomarioJa collected $1.25 from pot
RomarioJa: doesn't show hand 
*** SUMMARY ***
Total pot $1.25 | Rake $0 
Seat 1: hirozo (button) folded before Flop
Seat 2: RomarioJa (small blind) collected ($1.25)
Seat 3: de harlekijn (big blind) folded before Flop
Seat 4: chiyuki folded before Flop (didn't bet)
Seat 5: diez007 folded before Flop (didn't bet)
Seat 6: carlosrbr folded before Flop (didn't bet)
Seat 7: KeLevro0 folded before Flop (didn't bet)
Seat 8: fwani folded before Flop (didn't bet)
Seat 9: PetitAlejo folded before Flop (didn't bet)



PokerStars Zoom Hand #84298695984:  Hold'em No Limit ($0.10/$0.25) - 2012/08/05 13:29:46 JST [2012/08/05 0:29:46 ET]
Table 'Whirlpool' 9-max Seat #1 is the button
Seat 1: ShockLaMuc ($36.50 in chips) 
Seat 2: peng2astic ($12.25 in chips) 
Seat 3: MATT361 ($7.90 in chips) 
Seat 4: chiyuki ($24.90 in chips) 
Seat 5: hirozo ($35.99 in chips) 
Seat 6: masterkoolb ($12.72 in chips) 
Seat 7: BlackZafiro ($26.55 in chips) 
Seat 8: gedavaca ($41.14 in chips) 
Seat 9: wtu1986 ($25 in chips) 
peng2astic: posts small blind $0.10
MATT361: posts big blind $0.25
*** HOLE CARDS ***
Dealt to chiyuki [Ad 4c]
chiyuki: folds 
hirozo: folds 
masterkoolb: raises $0.60 to $0.85
BlackZafiro: folds 
gedavaca: folds 
wtu1986: folds 
ShockLaMuc: folds 
peng2astic: folds 
MATT361: folds 
Uncalled bet ($0.60) returned to masterkoolb
masterkoolb collected $0.60 from pot
masterkoolb: doesn't show hand 
*** SUMMARY ***
Total pot $0.60 | Rake $0 
Seat 1: ShockLaMuc (button) folded before Flop (didn't bet)
Seat 2: peng2astic (small blind) folded before Flop
Seat 3: MATT361 (big blind) folded before Flop
Seat 4: chiyuki folded before Flop (didn't bet)
Seat 5: hirozo folded before Flop (didn't bet)
Seat 6: masterkoolb collected ($0.60)
Seat 7: BlackZafiro folded before Flop (didn't bet)
Seat 8: gedavaca folded before Flop (didn't bet)
Seat 9: wtu1986 folded before Flop (didn't bet)



PokerStars Zoom Hand #84298695146:  Hold'em No Limit ($0.10/$0.25) - 2012/08/05 13:29:43 JST [2012/08/05 0:29:43 ET]
Table 'Whirlpool' 9-max Seat #1 is the button
Seat 1: agurio ($27.98 in chips) 
Seat 2: slapshot2011 ($44.71 in chips) 
Seat 3: jtedecaliss ($144.19 in chips) 
Seat 4: leo2095 ($16.52 in chips) 
Seat 5: KeLevro0 ($15.06 in chips) 
Seat 6: BlOnDhOlIc ($26.47 in chips) 
Seat 7: chiyuki ($24.90 in chips) 
Seat 8: seula i ($46.02 in chips) 
Seat 9: Lasutchik ($8.34 in chips) 
slapshot2011: posts small blind $0.10
jtedecaliss: posts big blind $0.25
*** HOLE CARDS ***
Dealt to chiyuki [Ks 3c]
leo2095: folds 
KeLevro0: folds 
BlOnDhOlIc: raises $0.25 to $0.50
chiyuki: folds 
seula i: folds 
Lasutchik: folds 
agurio: folds 
slapshot2011: folds 
jtedecaliss: folds 
Uncalled bet ($0.25) returned to BlOnDhOlIc
BlOnDhOlIc collected $0.60 from pot
BlOnDhOlIc: doesn't show hand 
*** SUMMARY ***
Total pot $0.60 | Rake $0 
Seat 1: agurio (button) folded before Flop (didn't bet)
Seat 2: slapshot2011 (small blind) folded before Flop
Seat 3: jtedecaliss (big blind) folded before Flop
Seat 4: leo2095 folded before Flop (didn't bet)
Seat 5: KeLevro0 folded before Flop (didn't bet)
Seat 6: BlOnDhOlIc collected ($0.60)
Seat 7: chiyuki folded before Flop (didn't bet)
Seat 8: seula i folded before Flop (didn't bet)
Seat 9: Lasutchik folded before Flop (didn't bet)



PokerStars Zoom Hand #84298694081:  Hold'em No Limit ($0.10/$0.25) - 2012/08/05 13:29:39 JST [2012/08/05 0:29:39 ET]
Table 'Whirlpool' 9-max Seat #1 is the button
Seat 1: PetitAlejo ($28.74 in chips) 
Seat 2: ShockLaMuc ($36.60 in chips) 
Seat 3: luyifei ($22.67 in chips) 
Seat 4: jtedecaliss ($144.19 in chips) 
Seat 5: RomarioJa ($8.95 in chips) 
Seat 6: chiyuki ($24.90 in chips) 
Seat 7: Suhoff76 ($25 in chips) 
Seat 8: NastyMcNast ($55.56 in chips) 
Seat 9: gedavaca ($41.14 in chips) 
ShockLaMuc: posts small blind $0.10
luyifei: posts big blind $0.25
*** HOLE CARDS ***
Dealt to chiyuki [7s Qs]
jtedecaliss: folds 
RomarioJa: folds 
chiyuki: folds 
Suhoff76: raises $0.50 to $0.75
NastyMcNast: folds 
gedavaca: folds 
PetitAlejo: folds 
ShockLaMuc: folds 
luyifei: calls $0.50
*** FLOP *** [5s Jc 3c]
luyifei: bets $0.25
Suhoff76: raises $0.75 to $1
luyifei: folds 
Uncalled bet ($0.75) returned to Suhoff76
Suhoff76 collected $2.01 from pot
Suhoff76: doesn't show hand 
*** SUMMARY ***
Total pot $2.10 | Rake $0.09 
Board [5s Jc 3c]
Seat 1: PetitAlejo (button) folded before Flop (didn't bet)
Seat 2: ShockLaMuc (small blind) folded before Flop
Seat 3: luyifei (big blind) folded on the Flop
Seat 4: jtedecaliss folded before Flop (didn't bet)
Seat 5: RomarioJa folded before Flop (didn't bet)
Seat 6: chiyuki folded before Flop (didn't bet)
Seat 7: Suhoff76 collected ($2.01)
Seat 8: NastyMcNast folded before Flop (didn't bet)
Seat 9: gedavaca folded before Flop (didn't bet)



PokerStars Zoom Hand #84298699390:  Hold'em No Limit ($0.10/$0.25) - 2012/08/05 13:29:58 JST [2012/08/05 0:29:58 ET]
Table 'Whirlpool' 9-max Seat #1 is the button
Seat 1: DooMSDaY1337 ($62.66 in chips) 
Seat 2: wtu1986 ($25 in chips) 
Seat 3: chiyuki ($24.90 in chips) 
Seat 4: hirozo ($35.99 in chips) 
Seat 5: vit 111 ($34.62 in chips) 
Seat 6: Dejacob ($25.97 in chips) 
Seat 7: Lasutchik ($8.34 in chips) 
Seat 8: RomarioJa ($8.95 in chips) 
Seat 9: PetitAlejo ($28.74 in chips) 
wtu1986: posts small blind $0.10
chiyuki: posts big blind $0.25
*** HOLE CARDS ***
Dealt to chiyuki [9h Qd]
hirozo: raises $0.50 to $0.75
vit 111: folds 
Dejacob: folds 
Lasutchik: folds 
RomarioJa: folds 
PetitAlejo: folds 
DooMSDaY1337: folds 
wtu1986: folds 
chiyuki: folds 
Uncalled bet ($0.50) returned to hirozo
hirozo collected $0.60 from pot
hirozo: doesn't show hand 
*** SUMMARY ***
Total pot $0.60 | Rake $0 
Seat 1: DooMSDaY1337 (button) folded before Flop (didn't bet)
Seat 2: wtu1986 (small blind) folded before Flop
Seat 3: chiyuki (big blind) folded before Flop
Seat 4: hirozo collected ($0.60)
Seat 5: vit 111 folded before Flop (didn't bet)
Seat 6: Dejacob folded before Flop (didn't bet)
Seat 7: Lasutchik folded before Flop (didn't bet)
Seat 8: RomarioJa folded before Flop (didn't bet)
Seat 9: PetitAlejo folded before Flop (didn't bet)



PokerStars Zoom Hand #84298703501:  Hold'em No Limit ($0.10/$0.25) - 2012/08/05 13:30:14 JST [2012/08/05 0:30:14 ET]
Table 'Whirlpool' 9-max Seat #1 is the button
Seat 1: fwani ($31.51 in chips) 
Seat 2: Lasutchik ($26.03 in chips) 
Seat 3: deadmoneykid ($25 in chips) 
Seat 4: PetitAlejo ($25 in chips) 
Seat 5: BlackZafiro ($25 in chips) 
Seat 6: chiyuki ($24.65 in chips) 
Seat 7: 4ydo yogurt ($9.67 in chips) 
Seat 8: DooMSDaY1337 ($95.26 in chips) 
Seat 9: agurio ($27.98 in chips) 
Lasutchik: posts small blind $0.10
deadmoneykid: posts big blind $0.25
*** HOLE CARDS ***
Dealt to chiyuki [Qc 4c]
PetitAlejo: folds 
BlackZafiro: folds 
chiyuki: folds 
4ydo yogurt: folds 
DooMSDaY1337: folds 
agurio: folds 
fwani: folds 
Lasutchik: calls $0.15
deadmoneykid: checks 
*** FLOP *** [Ks Kc Tc]
Lasutchik: bets $0.25
deadmoneykid: raises $0.25 to $0.50
Lasutchik: folds 
Uncalled bet ($0.25) returned to deadmoneykid
deadmoneykid collected $0.96 from pot
deadmoneykid: doesn't show hand 
*** SUMMARY ***
Total pot $1 | Rake $0.04 
Board [Ks Kc Tc]
Seat 1: fwani (button) folded before Flop (didn't bet)
Seat 2: Lasutchik (small blind) folded on the Flop
Seat 3: deadmoneykid (big blind) collected ($0.96)
Seat 4: PetitAlejo folded before Flop (didn't bet)
Seat 5: BlackZafiro folded before Flop (didn't bet)
Seat 6: chiyuki folded before Flop (didn't bet)
Seat 7: 4ydo yogurt folded before Flop (didn't bet)
Seat 8: DooMSDaY1337 folded before Flop (didn't bet)
Seat 9: agurio folded before Flop (didn't bet)



PokerStars Zoom Hand #84298709501:  Hold'em No Limit ($0.10/$0.25) - 2012/08/05 13:30:36 JST [2012/08/05 0:30:36 ET]
Table 'Whirlpool' 9-max Seat #1 is the button
Seat 1: diez007 ($12.43 in chips) 
Seat 2: Paranoix1990 ($25.45 in chips) 
Seat 3: Th3Fog ($54.42 in chips) 
Seat 4: eagie20 ($126.55 in chips) 
Seat 5: deadmoneykid ($23.55 in chips) 
Seat 6: BlackZafiro ($25 in chips) 
Seat 7: PetitAlejo ($25 in chips) 
Seat 8: chiyuki ($24.65 in chips) 
Seat 9: Landybob ($25.43 in chips) 
Paranoix1990: posts small blind $0.10
Th3Fog: posts big blind $0.25
*** HOLE CARDS ***
Dealt to chiyuki [2c Ac]
eagie20: raises $0.25 to $0.50
deadmoneykid: folds 
BlackZafiro: folds 
PetitAlejo: folds 
chiyuki: folds 
Landybob: folds 
diez007: folds 
Paranoix1990: folds 
Th3Fog: folds 
Uncalled bet ($0.25) returned to eagie20
eagie20 collected $0.60 from pot
eagie20: doesn't show hand 
*** SUMMARY ***
Total pot $0.60 | Rake $0 
Seat 1: diez007 (button) folded before Flop (didn't bet)
Seat 2: Paranoix1990 (small blind) folded before Flop
Seat 3: Th3Fog (big blind) folded before Flop
Seat 4: eagie20 collected ($0.60)
Seat 5: deadmoneykid folded before Flop (didn't bet)
Seat 6: BlackZafiro folded before Flop (didn't bet)
Seat 7: PetitAlejo folded before Flop (didn't bet)
Seat 8: chiyuki folded before Flop (didn't bet)
Seat 9: Landybob folded before Flop (didn't bet)



PokerStars Zoom Hand #84298706974:  Hold'em No Limit ($0.10/$0.25) - 2012/08/05 13:30:27 JST [2012/08/05 0:30:27 ET]
Table 'Whirlpool' 9-max Seat #1 is the button
Seat 1: Dejacob ($26.47 in chips) 
Seat 2: Catrban ($38.09 in chips) 
Seat 3: SlimeyGash ($4.56 in chips) 
Seat 4: Rsonal ($27.70 in chips) 
Seat 5: seula i ($46.02 in chips) 
Seat 6: TraderYao ($29.34 in chips) 
Seat 7: PetitAlejo ($28.64 in chips) 
Seat 8: 4ydo yogurt ($9.67 in chips) 
Seat 9: chiyuki ($24.65 in chips) 
Catrban: posts small blind $0.10
SlimeyGash: posts big blind $0.25
*** HOLE CARDS ***
Dealt to chiyuki [5c 9h]
Rsonal: calls $0.25
seula i: folds 
TraderYao: folds 
PetitAlejo: folds 
4ydo yogurt: folds 
chiyuki: folds 
Dejacob: folds 
Catrban: folds 
SlimeyGash: checks 
*** FLOP *** [Ac 5s Ts]
SlimeyGash: checks 
Rsonal: bets $0.75
SlimeyGash: folds 
Uncalled bet ($0.75) returned to Rsonal
Rsonal collected $0.57 from pot
Rsonal: doesn't show hand 
*** SUMMARY ***
Total pot $0.60 | Rake $0.03 
Board [Ac 5s Ts]
Seat 1: Dejacob (button) folded before Flop (didn't bet)
Seat 2: Catrban (small blind) folded before Flop
Seat 3: SlimeyGash (big blind) folded on the Flop
Seat 4: Rsonal collected ($0.57)
Seat 5: seula i folded before Flop (didn't bet)
Seat 6: TraderYao folded before Flop (didn't bet)
Seat 7: PetitAlejo folded before Flop (didn't bet)
Seat 8: 4ydo yogurt folded before Flop (didn't bet)
Seat 9: chiyuki folded before Flop (didn't bet)



PokerStars Zoom Hand #84298692143:  Hold'em No Limit ($0.10/$0.25) - 2012/08/05 13:29:32 JST [2012/08/05 0:29:32 ET]
Table 'Whirlpool' 9-max Seat #1 is the button
Seat 1: D@vidMed ($40.15 in chips) 
Seat 2: chiyuki ($25 in chips) 
Seat 3: peng2astic ($12.50 in chips) 
Seat 4: a_tasmanian ($87.82 in chips) 
Seat 5: seula i ($61.93 in chips) 
Seat 6: Dejacob ($25 in chips) 
Seat 7: fwani ($35.65 in chips) 
Seat 8: agurio ($27.98 in chips) 
Seat 9: Medic8681 ($20.93 in chips) 
chiyuki: posts small blind $0.10
peng2astic: posts big blind $0.25
*** HOLE CARDS ***
Dealt to chiyuki [8c 6h]
a_tasmanian: raises $0.50 to $0.75
seula i: folds 
Dejacob: calls $0.75
fwani: folds 
agurio: folds 
Medic8681: calls $0.75
D@vidMed: raises $1.75 to $2.50
chiyuki: folds 
peng2astic: folds 
a_tasmanian: calls $1.75
Dejacob: calls $1.75
Medic8681: calls $1.75
*** FLOP *** [3d Jh 7d]
a_tasmanian: checks 
Dejacob: checks 
Medic8681: bets $6
D@vidMed: raises $6 to $12
a_tasmanian: folds 
Dejacob: folds 
Medic8681: raises $6.43 to $18.43 and is all-in
D@vidMed: calls $6.43
*** TURN *** [3d Jh 7d] [5s]
*** RIVER *** [3d Jh 7d 5s] [Ad]
*** SHOW DOWN ***
Medic8681: shows [Kd Jd] (a flush, Ace high)
D@vidMed: mucks hand 
Medic8681 collected $45.21 from pot
*** SUMMARY ***
Total pot $47.21 | Rake $2 
Board [3d Jh 7d 5s Ad]
Seat 1: D@vidMed (button) mucked [Jc Js]
Seat 2: chiyuki (small blind) folded before Flop
Seat 3: peng2astic (big blind) folded before Flop
Seat 4: a_tasmanian folded on the Flop
Seat 5: seula i folded before Flop (didn't bet)
Seat 6: Dejacob folded on the Flop
Seat 7: fwani folded before Flop (didn't bet)
Seat 8: agurio folded before Flop (didn't bet)
Seat 9: Medic8681 showed [Kd Jd] and won ($45.21) with a flush, Ace high



PokerStars Zoom Hand #84298710560:  Hold'em No Limit ($0.10/$0.25) - 2012/08/05 13:30:40 JST [2012/08/05 0:30:40 ET]
Table 'Whirlpool' 9-max Seat #1 is the button
Seat 1: Medic8681 ($16.08 in chips) 
Seat 2: Loholov ($22.20 in chips) 
Seat 3: PetitAlejo ($25 in chips) 
Seat 4: taksist889 ($24.46 in chips) 
Seat 5: Suhoff76 ($25 in chips) 
Seat 6: peng2astic ($9.65 in chips) 
Seat 7: chiyuki ($24.65 in chips) 
Seat 8: NastyMcNast ($55.31 in chips) 
Seat 9: silvno31 ($29.38 in chips) 
Loholov: posts small blind $0.10
PetitAlejo: posts big blind $0.25
*** HOLE CARDS ***
Dealt to chiyuki [Js 8s]
taksist889: folds 
Suhoff76: folds 
peng2astic: calls $0.25
chiyuki: folds 
NastyMcNast: raises $0.75 to $1
silvno31: folds 
Medic8681: folds 
Loholov: folds 
PetitAlejo: folds 
peng2astic: folds 
Uncalled bet ($0.75) returned to NastyMcNast
NastyMcNast collected $0.85 from pot
NastyMcNast: doesn't show hand 
*** SUMMARY ***
Total pot $0.85 | Rake $0 
Seat 1: Medic8681 (button) folded before Flop (didn't bet)
Seat 2: Loholov (small blind) folded before Flop
Seat 3: PetitAlejo (big blind) folded before Flop
Seat 4: taksist889 folded before Flop (didn't bet)
Seat 5: Suhoff76 folded before Flop (didn't bet)
Seat 6: peng2astic folded before Flop
Seat 7: chiyuki folded before Flop (didn't bet)
Seat 8: NastyMcNast collected ($0.85)
Seat 9: silvno31 folded before Flop (didn't bet)



PokerStars Zoom Hand #84298705905:  Hold'em No Limit ($0.10/$0.25) - 2012/08/05 13:30:23 JST [2012/08/05 0:30:23 ET]
Table 'Whirlpool' 9-max Seat #1 is the button
Seat 1: chiyuki ($24.65 in chips) 
Seat 2: NastyMcNast ($27.67 in chips) 
Seat 3: wtu1986 ($25.25 in chips) 
Seat 4: Alvinpe85 ($58.09 in chips) 
Seat 5: DooMSDaY1337 ($50.69 in chips) 
Seat 6: SlimeyGash ($4.56 in chips) 
Seat 7: KINGKILERACE ($20.09 in chips) 
Seat 8: de harlekijn ($16.27 in chips) 
Seat 9: seula i ($46.02 in chips) 
NastyMcNast: posts small blind $0.10
wtu1986: posts big blind $0.25
*** HOLE CARDS ***
Dealt to chiyuki [9s 2c]
Alvinpe85: raises $0.25 to $0.50
DooMSDaY1337: folds 
SlimeyGash: folds 
KINGKILERACE: calls $0.50
de harlekijn: calls $0.50
seula i: folds 
chiyuki: folds 
NastyMcNast: folds 
wtu1986: folds 
*** FLOP *** [5c Jc 2d]
Alvinpe85: checks 
KINGKILERACE: checks 
de harlekijn: bets $1
Alvinpe85: folds 
KINGKILERACE: folds 
Uncalled bet ($1) returned to de harlekijn
de harlekijn collected $1.77 from pot
de harlekijn: doesn't show hand 
*** SUMMARY ***
Total pot $1.85 | Rake $0.08 
Board [5c Jc 2d]
Seat 1: chiyuki (button) folded before Flop (didn't bet)
Seat 2: NastyMcNast (small blind) folded before Flop
Seat 3: wtu1986 (big blind) folded before Flop
Seat 4: Alvinpe85 folded on the Flop
Seat 5: DooMSDaY1337 folded before Flop (didn't bet)
Seat 6: SlimeyGash folded before Flop (didn't bet)
Seat 7: KINGKILERACE folded on the Flop
Seat 8: de harlekijn collected ($1.77)
Seat 9: seula i folded before Flop (didn't bet)



PokerStars Zoom Hand #84298713070:  Hold'em No Limit ($0.10/$0.25) - 2012/08/05 13:30:49 JST [2012/08/05 0:30:49 ET]
Table 'Whirlpool' 9-max Seat #1 is the button
Seat 1: hirozo ($36.34 in chips) 
Seat 2: chiyuki ($24.65 in chips) 
Seat 3: PetitAlejo ($28.64 in chips) 
Seat 4: wtu1986 ($25 in chips) 
Seat 5: Rsonal ($28.02 in chips) 
Seat 6: ll_LaMeR_ll ($37.05 in chips) 
Seat 7: Roglus ($11.56 in chips) 
Seat 8: Suhoff76 ($26.20 in chips) 
Seat 9: Nerkit ($11.65 in chips) 
chiyuki: posts small blind $0.10
PetitAlejo: posts big blind $0.25
*** HOLE CARDS ***
Dealt to chiyuki [3h Th]
wtu1986: folds 
Rsonal: calls $0.25
ll_LaMeR_ll: folds 
Roglus: folds 
Suhoff76: folds 
Nerkit: folds 
hirozo: folds 
chiyuki: folds 
PetitAlejo: checks 
*** FLOP *** [Js 3d Kc]
PetitAlejo: checks 
Rsonal: bets $0.50
PetitAlejo: folds 
Uncalled bet ($0.50) returned to Rsonal
Rsonal collected $0.57 from pot
Rsonal: doesn't show hand 
*** SUMMARY ***
Total pot $0.60 | Rake $0.03 
Board [Js 3d Kc]
Seat 1: hirozo (button) folded before Flop (didn't bet)
Seat 2: chiyuki (small blind) folded before Flop
Seat 3: PetitAlejo (big blind) folded on the Flop
Seat 4: wtu1986 folded before Flop (didn't bet)
Seat 5: Rsonal collected ($0.57)
Seat 6: ll_LaMeR_ll folded before Flop (didn't bet)
Seat 7: Roglus folded before Flop (didn't bet)
Seat 8: Suhoff76 folded before Flop (didn't bet)
Seat 9: Nerkit folded before Flop (didn't bet)



PokerStars Zoom Hand #84298719383:  Hold'em No Limit ($0.10/$0.25) - 2012/08/05 13:31:12 JST [2012/08/05 0:31:12 ET]
Table 'Whirlpool' 9-max Seat #1 is the button
Seat 1: Ellen1947 ($28.05 in chips) 
Seat 2: Alvinpe85 ($57.34 in chips) 
Seat 3: masterkoolb ($12.50 in chips) 
Seat 4: PetitAlejo ($28.39 in chips) 
Seat 5: Suhoff76 ($25.66 in chips) 
Seat 6: leo2095 ($16.17 in chips) 
Seat 7: deadmoneykid ($23.97 in chips) 
Seat 8: TraderYao ($28.27 in chips) 
Seat 9: chiyuki ($24.55 in chips) 
Alvinpe85: posts small blind $0.10
masterkoolb: posts big blind $0.25
*** HOLE CARDS ***
Dealt to chiyuki [Ks 4d]
PetitAlejo: folds 
Suhoff76: folds 
leo2095: folds 
deadmoneykid: folds 
TraderYao: folds 
chiyuki: folds 
Ellen1947: folds 
Alvinpe85: folds 
Uncalled bet ($0.15) returned to masterkoolb
masterkoolb collected $0.20 from pot
masterkoolb: doesn't show hand 
*** SUMMARY ***
Total pot $0.20 | Rake $0 
Seat 1: Ellen1947 (button) folded before Flop (didn't bet)
Seat 2: Alvinpe85 (small blind) folded before Flop
Seat 3: masterkoolb (big blind) collected ($0.20)
Seat 4: PetitAlejo folded before Flop (didn't bet)
Seat 5: Suhoff76 folded before Flop (didn't bet)
Seat 6: leo2095 folded before Flop (didn't bet)
Seat 7: deadmoneykid folded before Flop (didn't bet)
Seat 8: TraderYao folded before Flop (didn't bet)
Seat 9: chiyuki folded before Flop (didn't bet)



PokerStars Zoom Hand #84298715281:  Hold'em No Limit ($0.10/$0.25) - 2012/08/05 13:30:57 JST [2012/08/05 0:30:57 ET]
Table 'Whirlpool' 9-max Seat #1 is the button
Seat 1: Loholov ($22.10 in chips) 
Seat 2: deadmoneykid ($25.46 in chips) 
Seat 3: Roglus ($11.56 in chips) 
Seat 4: ShockLaMuc ($37.52 in chips) 
Seat 5: chiyuki ($24.55 in chips) 
Seat 6: Suhoff76 ($26.20 in chips) 
Seat 7: wtu1986 ($25 in chips) 
Seat 8: jtedecaliss ($141.69 in chips) 
Seat 9: TErr18 ($26 in chips) 
deadmoneykid: posts small blind $0.10
Roglus: posts big blind $0.25
*** HOLE CARDS ***
Dealt to chiyuki [Js Kc]
ShockLaMuc: folds 
chiyuki: folds 
Suhoff76: folds 
wtu1986: folds 
jtedecaliss: folds 
TErr18: folds 
Loholov: folds 
deadmoneykid: folds 
Uncalled bet ($0.15) returned to Roglus
Roglus collected $0.20 from pot
Roglus: doesn't show hand 
*** SUMMARY ***
Total pot $0.20 | Rake $0 
Seat 1: Loholov (button) folded before Flop (didn't bet)
Seat 2: deadmoneykid (small blind) folded before Flop
Seat 3: Roglus (big blind) collected ($0.20)
Seat 4: ShockLaMuc folded before Flop (didn't bet)
Seat 5: chiyuki folded before Flop (didn't bet)
Seat 6: Suhoff76 folded before Flop (didn't bet)
Seat 7: wtu1986 folded before Flop (didn't bet)
Seat 8: jtedecaliss folded before Flop (didn't bet)
Seat 9: TErr18 folded before Flop (didn't bet)



PokerStars Zoom Hand #84298720395:  Hold'em No Limit ($0.10/$0.25) - 2012/08/05 13:31:16 JST [2012/08/05 0:31:16 ET]
Table 'Whirlpool' 9-max Seat #1 is the button
Seat 1: chiyuki ($24.55 in chips) 
Seat 2: wtu1986 ($25 in chips) 
Seat 3: Anafim ($12.50 in chips) 
Seat 4: deadmoneykid ($23.97 in chips) 
Seat 5: KeLevro0 ($11.45 in chips) 
Seat 6: softdesign ($54.01 in chips) 
Seat 7: BlOnDhOlIc ($26.48 in chips) 
Seat 8: Alvinpe85 ($57.24 in chips) 
Seat 9: PetitAlejo ($28.39 in chips) 
wtu1986: posts small blind $0.10
Anafim: posts big blind $0.25
*** HOLE CARDS ***
Dealt to chiyuki [5d 8d]
deadmoneykid: folds 
KeLevro0: folds 
softdesign: folds 
BlOnDhOlIc: folds 
Alvinpe85: raises $0.50 to $0.75
PetitAlejo: folds 
chiyuki: folds 
wtu1986: folds 
Anafim: folds 
Uncalled bet ($0.50) returned to Alvinpe85
Alvinpe85 collected $0.60 from pot
Alvinpe85: doesn't show hand 
*** SUMMARY ***
Total pot $0.60 | Rake $0 
Seat 1: chiyuki (button) folded before Flop (didn't bet)
Seat 2: wtu1986 (small blind) folded before Flop
Seat 3: Anafim (big blind) folded before Flop
Seat 4: deadmoneykid folded before Flop (didn't bet)
Seat 5: KeLevro0 folded before Flop (didn't bet)
Seat 6: softdesign folded before Flop (didn't bet)
Seat 7: BlOnDhOlIc folded before Flop (didn't bet)
Seat 8: Alvinpe85 collected ($0.60)
Seat 9: PetitAlejo folded before Flop (didn't bet)



PokerStars Zoom Hand #84298714456:  Hold'em No Limit ($0.10/$0.25) - 2012/08/05 13:30:54 JST [2012/08/05 0:30:54 ET]
Table 'Whirlpool' 9-max Seat #1 is the button
Seat 1: agurio ($32.05 in chips) 
Seat 2: vit 111 ($35.31 in chips) 
Seat 3: ll_LaMeR_ll ($37.05 in chips) 
Seat 4: chiyuki ($24.55 in chips) 
Seat 5: Lasutchik ($25.53 in chips) 
Seat 6: Roglus ($11.56 in chips) 
Seat 7: Medic8681 ($45.21 in chips) 
Seat 8: BlOnDhOlIc ($33.18 in chips) 
Seat 9: Dejacob ($26.37 in chips) 
vit 111: posts small blind $0.10
ll_LaMeR_ll: posts big blind $0.25
*** HOLE CARDS ***
Dealt to chiyuki [Qd 7h]
chiyuki: folds 
Lasutchik: folds 
Roglus: folds 
Medic8681: folds 
BlOnDhOlIc: folds 
Dejacob: folds 
agurio: folds 
vit 111: calls $0.15
ll_LaMeR_ll: raises $0.75 to $1
vit 111: calls $0.75
*** FLOP *** [9h 6c 3c]
vit 111: checks 
ll_LaMeR_ll: bets $1.25
vit 111: calls $1.25
*** TURN *** [9h 6c 3c] [4d]
vit 111: checks 
ll_LaMeR_ll: bets $2.50
vit 111: calls $2.50
*** RIVER *** [9h 6c 3c 4d] [8d]
vit 111: checks 
ll_LaMeR_ll: checks 
*** SHOW DOWN ***
vit 111: shows [Tc 8s] (a pair of Eights)
ll_LaMeR_ll: shows [9d Jd] (a pair of Nines)
ll_LaMeR_ll collected $9.07 from pot
*** SUMMARY ***
Total pot $9.50 | Rake $0.43 
Board [9h 6c 3c 4d 8d]
Seat 1: agurio (button) folded before Flop (didn't bet)
Seat 2: vit 111 (small blind) showed [Tc 8s] and lost with a pair of Eights
Seat 3: ll_LaMeR_ll (big blind) showed [9d Jd] and won ($9.07) with a pair of Nines
Seat 4: chiyuki folded before Flop (didn't bet)
Seat 5: Lasutchik folded before Flop (didn't bet)
Seat 6: Roglus folded before Flop (didn't bet)
Seat 7: Medic8681 folded before Flop (didn't bet)
Seat 8: BlOnDhOlIc folded before Flop (didn't bet)
Seat 9: Dejacob folded before Flop (didn't bet)



PokerStars Zoom Hand #84298721513:  Hold'em No Limit ($0.10/$0.25) - 2012/08/05 13:31:21 JST [2012/08/05 0:31:21 ET]
Table 'Whirlpool' 9-max Seat #1 is the button
Seat 1: TErr18 ($26 in chips) 
Seat 2: masterkoolb ($12.60 in chips) 
Seat 3: chiyuki ($24.55 in chips) 
Seat 4: BlOnDhOlIc ($26.48 in chips) 
Seat 5: Dejacob ($26.37 in chips) 
Seat 6: RomarioJa ($7.79 in chips) 
Seat 7: seula i ($25.25 in chips) 
Seat 8: TraderYao ($29.24 in chips) 
Seat 9: KeLevro0 ($11.45 in chips) 
masterkoolb: posts small blind $0.10
chiyuki: posts big blind $0.25
*** HOLE CARDS ***
Dealt to chiyuki [3s Jh]
BlOnDhOlIc: folds 
Dejacob: folds 
RomarioJa: folds 
seula i: folds 
TraderYao: folds 
KeLevro0: folds 
TErr18: folds 
masterkoolb: folds 
Uncalled bet ($0.15) returned to chiyuki
chiyuki collected $0.20 from pot
chiyuki: doesn't show hand 
*** SUMMARY ***
Total pot $0.20 | Rake $0 
Seat 1: TErr18 (button) folded before Flop (didn't bet)
Seat 2: masterkoolb (small blind) folded before Flop
Seat 3: chiyuki (big blind) collected ($0.20)
Seat 4: BlOnDhOlIc folded before Flop (didn't bet)
Seat 5: Dejacob folded before Flop (didn't bet)
Seat 6: RomarioJa folded before Flop (didn't bet)
Seat 7: seula i folded before Flop (didn't bet)
Seat 8: TraderYao folded before Flop (didn't bet)
Seat 9: KeLevro0 folded before Flop (didn't bet)



PokerStars Zoom Hand #84298716673:  Hold'em No Limit ($0.10/$0.25) - 2012/08/05 13:31:02 JST [2012/08/05 0:31:02 ET]
Table 'Whirlpool' 9-max Seat #1 is the button
Seat 1: KeLevro0 ($11.45 in chips) 
Seat 2: hirozo ($45.55 in chips) 
Seat 3: RomarioJa ($8.04 in chips) 
Seat 4: chiyuki ($24.55 in chips) 
Seat 5: masterkoolb ($12.72 in chips) 
Seat 6: BlOnDhOlIc ($67.11 in chips) 
Seat 7: TErr18 ($26 in chips) 
Seat 8: Dejacob ($26.37 in chips) 
Seat 9: NastyMcNast ($27.57 in chips) 
hirozo: posts small blind $0.10
RomarioJa: posts big blind $0.25
*** HOLE CARDS ***
Dealt to chiyuki [Qd 5c]
chiyuki: folds 
masterkoolb: folds 
BlOnDhOlIc: folds 
TErr18: folds 
Dejacob: folds 
NastyMcNast: raises $0.50 to $0.75
KeLevro0: folds 
hirozo: raises $1.60 to $2.35
RomarioJa: folds 
NastyMcNast: calls $1.60
*** FLOP *** [Jc Th 7d]
hirozo: bets $2.37
NastyMcNast: calls $2.37
*** TURN *** [Jc Th 7d] [2c]
hirozo: checks 
NastyMcNast: bets $5.08
hirozo: folds 
Uncalled bet ($5.08) returned to NastyMcNast
NastyMcNast collected $9.25 from pot
NastyMcNast: doesn't show hand 
*** SUMMARY ***
Total pot $9.69 | Rake $0.44 
Board [Jc Th 7d 2c]
Seat 1: KeLevro0 (button) folded before Flop (didn't bet)
Seat 2: hirozo (small blind) folded on the Turn
Seat 3: RomarioJa (big blind) folded before Flop
Seat 4: chiyuki folded before Flop (didn't bet)
Seat 5: masterkoolb folded before Flop (didn't bet)
Seat 6: BlOnDhOlIc folded before Flop (didn't bet)
Seat 7: TErr18 folded before Flop (didn't bet)
Seat 8: Dejacob folded before Flop (didn't bet)
Seat 9: NastyMcNast collected ($9.25)



PokerStars Zoom Hand #84298726908:  Hold'em No Limit ($0.10/$0.25) - 2012/08/05 13:31:41 JST [2012/08/05 0:31:41 ET]
Table 'Whirlpool' 9-max Seat #1 is the button
Seat 1: Roglus ($45.99 in chips) 
Seat 2: silvno31 ($28.88 in chips) 
Seat 3: wtu1986 ($26.50 in chips) 
Seat 4: RomarioJa ($5.51 in chips) 
Seat 5: Jippyflip ($19.85 in chips) 
Seat 6: chiyuki ($24.65 in chips) 
Seat 7: Alvinpe85 ($57.59 in chips) 
Seat 8: Th3Fog ($65.81 in chips) 
Seat 9: Anafim ($12.50 in chips) 
silvno31: posts small blind $0.10
wtu1986: posts big blind $0.25
*** HOLE CARDS ***
Dealt to chiyuki [7h 2h]
RomarioJa: folds 
Jippyflip: folds 
chiyuki: folds 
Alvinpe85: folds 
Th3Fog: raises $0.47 to $0.72
Anafim: folds 
Roglus: calls $0.72
silvno31: folds 
wtu1986: folds 
*** FLOP *** [4d 3s 8c]
Th3Fog: bets $1
Roglus: folds 
Uncalled bet ($1) returned to Th3Fog
Th3Fog collected $1.71 from pot
Th3Fog: doesn't show hand 
*** SUMMARY ***
Total pot $1.79 | Rake $0.08 
Board [4d 3s 8c]
Seat 1: Roglus (button) folded on the Flop
Seat 2: silvno31 (small blind) folded before Flop
Seat 3: wtu1986 (big blind) folded before Flop
Seat 4: RomarioJa folded before Flop (didn't bet)
Seat 5: Jippyflip folded before Flop (didn't bet)
Seat 6: chiyuki folded before Flop (didn't bet)
Seat 7: Alvinpe85 folded before Flop (didn't bet)
Seat 8: Th3Fog collected ($1.71)
Seat 9: Anafim folded before Flop (didn't bet)



PokerStars Zoom Hand #84298729319:  Hold'em No Limit ($0.10/$0.25) - 2012/08/05 13:31:50 JST [2012/08/05 0:31:50 ET]
Table 'Whirlpool' 9-max Seat #1 is the button
Seat 1: Alvinpe85 ($57.59 in chips) 
Seat 2: chiyuki ($24.65 in chips) 
Seat 3: masterkoolb ($12.62 in chips) 
Seat 4: deadmoneykid ($23.72 in chips) 
Seat 5: silvno31 ($28.78 in chips) 
Seat 6: Anafim ($12.50 in chips) 
Seat 7: TraderYao ($28.49 in chips) 
Seat 8: gedavaca ($42.47 in chips) 
Seat 9: TErr18 ($25.65 in chips) 
chiyuki: posts small blind $0.10
masterkoolb: posts big blind $0.25
*** HOLE CARDS ***
Dealt to chiyuki [Ad 5d]
deadmoneykid: folds 
silvno31: folds 
Anafim: folds 
TraderYao: folds 
gedavaca: folds 
TErr18: folds 
Alvinpe85: folds 
chiyuki: raises $0.50 to $0.75
masterkoolb: folds 
Uncalled bet ($0.50) returned to chiyuki
chiyuki collected $0.50 from pot
chiyuki: doesn't show hand 
*** SUMMARY ***
Total pot $0.50 | Rake $0 
Seat 1: Alvinpe85 (button) folded before Flop (didn't bet)
Seat 2: chiyuki (small blind) collected ($0.50)
Seat 3: masterkoolb (big blind) folded before Flop
Seat 4: deadmoneykid folded before Flop (didn't bet)
Seat 5: silvno31 folded before Flop (didn't bet)
Seat 6: Anafim folded before Flop (didn't bet)
Seat 7: TraderYao folded before Flop (didn't bet)
Seat 8: gedavaca folded before Flop (didn't bet)
Seat 9: TErr18 folded before Flop (didn't bet)



PokerStars Zoom Hand #84298728254:  Hold'em No Limit ($0.10/$0.25) - 2012/08/05 13:31:46 JST [2012/08/05 0:31:46 ET]
Table 'Whirlpool' 9-max Seat #1 is the button
Seat 1: ygoegoe ($25 in chips) 
Seat 2: a_tasmanian ($77.37 in chips) 
Seat 3: DooMSDaY1337 ($92.91 in chips) 
Seat 4: Loholov ($22.45 in chips) 
Seat 5: masterkoolb ($12.62 in chips) 
Seat 6: ShockLaMuc ($37.27 in chips) 
Seat 7: fwani ($32.84 in chips) 
Seat 8: chiyuki ($24.65 in chips) 
Seat 9: BlOnDhOlIc ($67.01 in chips) 
a_tasmanian: posts small blind $0.10
DooMSDaY1337: posts big blind $0.25
*** HOLE CARDS ***
Dealt to chiyuki [6s Qc]
Loholov: folds 
masterkoolb: folds 
ShockLaMuc: folds 
fwani: folds 
chiyuki: folds 
BlOnDhOlIc: raises $0.37 to $0.62
ygoegoe: folds 
a_tasmanian: calls $0.52
DooMSDaY1337: folds 
*** FLOP *** [Kc 9c 4s]
a_tasmanian: checks 
BlOnDhOlIc: bets $0.71
a_tasmanian: calls $0.71
*** TURN *** [Kc 9c 4s] [6c]
a_tasmanian: checks 
BlOnDhOlIc: checks 
*** RIVER *** [Kc 9c 4s 6c] [3d]
a_tasmanian: bets $0.75
BlOnDhOlIc: folds 
Uncalled bet ($0.75) returned to a_tasmanian
a_tasmanian collected $2.78 from pot
a_tasmanian: doesn't show hand 
*** SUMMARY ***
Total pot $2.91 | Rake $0.13 
Board [Kc 9c 4s 6c 3d]
Seat 1: ygoegoe (button) folded before Flop (didn't bet)
Seat 2: a_tasmanian (small blind) collected ($2.78)
Seat 3: DooMSDaY1337 (big blind) folded before Flop
Seat 4: Loholov folded before Flop (didn't bet)
Seat 5: masterkoolb folded before Flop (didn't bet)
Seat 6: ShockLaMuc folded before Flop (didn't bet)
Seat 7: fwani folded before Flop (didn't bet)
Seat 8: chiyuki folded before Flop (didn't bet)
Seat 9: BlOnDhOlIc folded on the River



PokerStars Zoom Hand #84298736258:  Hold'em No Limit ($0.10/$0.25) - 2012/08/05 13:32:16 JST [2012/08/05 0:32:16 ET]
Table 'Whirlpool' 9-max Seat #1 is the button
Seat 1: TErr18 ($25.65 in chips) 
Seat 2: ygoegoe ($25 in chips) 
Seat 3: fwani ($29.58 in chips) 
Seat 4: BlOnDhOlIc ($34.51 in chips) 
Seat 5: 5zzzz33 ($14 in chips) 
Seat 6: Jippyflip ($19.85 in chips) 
Seat 7: chiyuki ($24.90 in chips) 
Seat 8: KeLevro0 ($11.20 in chips) 
Seat 9: deadmoneykid ($25.57 in chips) 
ygoegoe: posts small blind $0.10
fwani: posts big blind $0.25
*** HOLE CARDS ***
Dealt to chiyuki [As 8s]
BlOnDhOlIc: folds 
5zzzz33: folds 
Jippyflip: folds 
chiyuki: folds 
KeLevro0: folds 
deadmoneykid: raises $0.25 to $0.50
TErr18: folds 
ygoegoe: folds 
fwani: folds 
Uncalled bet ($0.25) returned to deadmoneykid
deadmoneykid collected $0.60 from pot
deadmoneykid: doesn't show hand 
*** SUMMARY ***
Total pot $0.60 | Rake $0 
Seat 1: TErr18 (button) folded before Flop (didn't bet)
Seat 2: ygoegoe (small blind) folded before Flop
Seat 3: fwani (big blind) folded before Flop
Seat 4: BlOnDhOlIc folded before Flop (didn't bet)
Seat 5: 5zzzz33 folded before Flop (didn't bet)
Seat 6: Jippyflip folded before Flop (didn't bet)
Seat 7: chiyuki folded before Flop (didn't bet)
Seat 8: KeLevro0 folded before Flop (didn't bet)
Seat 9: deadmoneykid collected ($0.60)



PokerStars Zoom Hand #84298740108:  Hold'em No Limit ($0.10/$0.25) - 2012/08/05 13:32:30 JST [2012/08/05 0:32:30 ET]
Table 'Whirlpool' 9-max Seat #1 is the button
Seat 1: deadmoneykid ($23.62 in chips) 
Seat 2: masterkoolb ($12.50 in chips) 
Seat 3: TErr18 ($25.65 in chips) 
Seat 4: Catrban ($37.14 in chips) 
Seat 5: chiyuki ($24.90 in chips) 
Seat 6: PetitAlejo ($29.79 in chips) 
Seat 7: seula i ($50.68 in chips) 
Seat 8: Th3Fog ($66.80 in chips) 
Seat 9: RomarioJa ($9.17 in chips) 
masterkoolb: posts small blind $0.10
TErr18: posts big blind $0.25
*** HOLE CARDS ***
Dealt to chiyuki [Jh 8h]
Catrban: folds 
chiyuki: folds 
PetitAlejo: folds 
seula i: folds 
Th3Fog: folds 
RomarioJa: raises $0.37 to $0.62
deadmoneykid: folds 
masterkoolb: folds 
TErr18 is disconnected 
TErr18 has timed out while disconnected
TErr18: folds 
Uncalled bet ($0.37) returned to RomarioJa
RomarioJa collected $0.60 from pot
RomarioJa: doesn't show hand 
*** SUMMARY ***
Total pot $0.60 | Rake $0 
Seat 1: deadmoneykid (button) folded before Flop (didn't bet)
Seat 2: masterkoolb (small blind) folded before Flop
Seat 3: TErr18 (big blind) folded before Flop
Seat 4: Catrban folded before Flop (didn't bet)
Seat 5: chiyuki folded before Flop (didn't bet)
Seat 6: PetitAlejo folded before Flop (didn't bet)
Seat 7: seula i folded before Flop (didn't bet)
Seat 8: Th3Fog folded before Flop (didn't bet)
Seat 9: RomarioJa collected ($0.60)



PokerStars Zoom Hand #84298748189:  Hold'em No Limit ($0.10/$0.25) - 2012/08/05 13:33:01 JST [2012/08/05 0:33:01 ET]
Table 'Whirlpool' 9-max Seat #1 is the button
Seat 1: eagie20 ($120.15 in chips) 
Seat 2: BlOnDhOlIc ($65.43 in chips) 
Seat 3: ll_LaMeR_ll ($40.87 in chips) 
Seat 4: chiyuki ($24.65 in chips) 
Seat 5: deadmoneykid ($25.71 in chips) 
Seat 6: PetitAlejo ($27.79 in chips) 
Seat 7: ShockLaMuc ($19.54 in chips) 
Seat 8: DooMSDaY1337 ($59.66 in chips) 
Seat 9: petersmiths ($23.11 in chips) 
BlOnDhOlIc: posts small blind $0.10
ll_LaMeR_ll: posts big blind $0.25
*** HOLE CARDS ***
Dealt to chiyuki [Jh 9s]
chiyuki: folds 
deadmoneykid: folds 
PetitAlejo: folds 
ShockLaMuc: folds 
DooMSDaY1337: raises $0.50 to $0.75
petersmiths: folds 
eagie20: folds 
BlOnDhOlIc: folds 
ll_LaMeR_ll: folds 
Uncalled bet ($0.50) returned to DooMSDaY1337
DooMSDaY1337 collected $0.60 from pot
DooMSDaY1337: doesn't show hand 
*** SUMMARY ***
Total pot $0.60 | Rake $0 
Seat 1: eagie20 (button) folded before Flop (didn't bet)
Seat 2: BlOnDhOlIc (small blind) folded before Flop
Seat 3: ll_LaMeR_ll (big blind) folded before Flop
Seat 4: chiyuki folded before Flop (didn't bet)
Seat 5: deadmoneykid folded before Flop (didn't bet)
Seat 6: PetitAlejo folded before Flop (didn't bet)
Seat 7: ShockLaMuc folded before Flop (didn't bet)
Seat 8: DooMSDaY1337 collected ($0.60)
Seat 9: petersmiths folded before Flop (didn't bet)



PokerStars Zoom Hand #84298742734:  Hold'em No Limit ($0.10/$0.25) - 2012/08/05 13:32:41 JST [2012/08/05 0:32:41 ET]
Table 'Whirlpool' 9-max Seat #1 is the button
Seat 1: diez007 ($14.16 in chips) 
Seat 2: simonzez ($57.94 in chips) 
Seat 3: BlOnDhOlIc ($25.38 in chips) 
Seat 4: DooMSDaY1337 ($92.91 in chips) 
Seat 5: RomarioJa ($7.69 in chips) 
Seat 6: Pkdave ($33.78 in chips) 
Seat 7: KeLevro0 ($12.50 in chips) 
Seat 8: deadmoneykid ($25.92 in chips) 
Seat 9: chiyuki ($24.90 in chips) 
simonzez: posts small blind $0.10
BlOnDhOlIc: posts big blind $0.25
*** HOLE CARDS ***
Dealt to chiyuki [Ts 7d]
DooMSDaY1337: folds 
RomarioJa: folds 
Pkdave: folds 
KeLevro0: folds 
deadmoneykid: folds 
chiyuki: folds 
diez007: folds 
simonzez: calls $0.15
BlOnDhOlIc: checks 
*** FLOP *** [5s Td 5d]
simonzez: bets $0.25
BlOnDhOlIc: raises $1 to $1.25
simonzez: calls $1
*** TURN *** [5s Td 5d] [6s]
simonzez: checks 
BlOnDhOlIc: checks 
*** RIVER *** [5s Td 5d 6s] [3h]
simonzez: bets $0.75
BlOnDhOlIc: calls $0.75
*** SHOW DOWN ***
simonzez: shows [7h Kc] (a pair of Fives)
BlOnDhOlIc: shows [6c 9d] (two pair, Sixes and Fives)
BlOnDhOlIc collected $4.30 from pot
*** SUMMARY ***
Total pot $4.50 | Rake $0.20 
Board [5s Td 5d 6s 3h]
Seat 1: diez007 (button) folded before Flop (didn't bet)
Seat 2: simonzez (small blind) showed [7h Kc] and lost with a pair of Fives
Seat 3: BlOnDhOlIc (big blind) showed [6c 9d] and won ($4.30) with two pair, Sixes and Fives
Seat 4: DooMSDaY1337 folded before Flop (didn't bet)
Seat 5: RomarioJa folded before Flop (didn't bet)
Seat 6: Pkdave folded before Flop (didn't bet)
Seat 7: KeLevro0 folded before Flop (didn't bet)
Seat 8: deadmoneykid folded before Flop (didn't bet)
Seat 9: chiyuki folded before Flop (didn't bet)



PokerStars Zoom Hand #84298749517:  Hold'em No Limit ($0.10/$0.25) - 2012/08/05 13:33:06 JST [2012/08/05 0:33:06 ET]
Table 'Whirlpool' 9-max Seat #1 is the button
Seat 1: PetitAlejo ($36.33 in chips) 
Seat 2: taksist889 ($24.21 in chips) 
Seat 3: BlOnDhOlIc ($34.41 in chips) 
Seat 4: DooMSDaY1337 ($52.74 in chips) 
Seat 5: wtu1986 ($25.50 in chips) 
Seat 6: ShockLaMuc ($16.43 in chips) 
Seat 7: BlackZafiro ($25 in chips) 
Seat 8: chiyuki ($24.65 in chips) 
Seat 9: Roglus ($39.27 in chips) 
taksist889: posts small blind $0.10
BlOnDhOlIc: posts big blind $0.25
*** HOLE CARDS ***
Dealt to chiyuki [3c 3h]
DooMSDaY1337: folds 
wtu1986: folds 
ShockLaMuc: folds 
BlackZafiro: raises $0.50 to $0.75
chiyuki: folds 
Roglus: folds 
PetitAlejo: folds 
taksist889: folds 
BlOnDhOlIc: folds 
Uncalled bet ($0.50) returned to BlackZafiro
BlackZafiro collected $0.60 from pot
BlackZafiro: doesn't show hand 
*** SUMMARY ***
Total pot $0.60 | Rake $0 
Seat 1: PetitAlejo (button) folded before Flop (didn't bet)
Seat 2: taksist889 (small blind) folded before Flop
Seat 3: BlOnDhOlIc (big blind) folded before Flop
Seat 4: DooMSDaY1337 folded before Flop (didn't bet)
Seat 5: wtu1986 folded before Flop (didn't bet)
Seat 6: ShockLaMuc folded before Flop (didn't bet)
Seat 7: BlackZafiro collected ($0.60)
Seat 8: chiyuki folded before Flop (didn't bet)
Seat 9: Roglus folded before Flop (didn't bet)



PokerStars Zoom Hand #84298752467:  Hold'em No Limit ($0.10/$0.25) - 2012/08/05 13:33:17 JST [2012/08/05 0:33:17 ET]
Table 'Whirlpool' 9-max Seat #1 is the button
Seat 1: cR!Ma*aRm ($30.25 in chips) 
Seat 2: deadmoneykid ($25.71 in chips) 
Seat 3: de harlekijn ($13.36 in chips) 
Seat 4: RomarioJa ($9.52 in chips) 
Seat 5: masterkoolb ($12.50 in chips) 
Seat 6: eagie20 ($120.15 in chips) 
Seat 7: chiyuki ($24.65 in chips) 
Seat 8: Roglus ($39.27 in chips) 
Seat 9: Loholov ($15 in chips) 
deadmoneykid: posts small blind $0.10
de harlekijn: posts big blind $0.25
*** HOLE CARDS ***
Dealt to chiyuki [Ts 4h]
RomarioJa: folds 
masterkoolb: folds 
eagie20: folds 
chiyuki: folds 
Roglus: folds 
Loholov: folds 
cR!Ma*aRm: folds 
deadmoneykid: folds 
Uncalled bet ($0.15) returned to de harlekijn
de harlekijn collected $0.20 from pot
de harlekijn: doesn't show hand 
*** SUMMARY ***
Total pot $0.20 | Rake $0 
Seat 1: cR!Ma*aRm (button) folded before Flop (didn't bet)
Seat 2: deadmoneykid (small blind) folded before Flop
Seat 3: de harlekijn (big blind) collected ($0.20)
Seat 4: RomarioJa folded before Flop (didn't bet)
Seat 5: masterkoolb folded before Flop (didn't bet)
Seat 6: eagie20 folded before Flop (didn't bet)
Seat 7: chiyuki folded before Flop (didn't bet)
Seat 8: Roglus folded before Flop (didn't bet)
Seat 9: Loholov folded before Flop (didn't bet)



PokerStars Zoom Hand #84298751379:  Hold'em No Limit ($0.10/$0.25) - 2012/08/05 13:33:13 JST [2012/08/05 0:33:13 ET]
Table 'Whirlpool' 9-max Seat #1 is the button
Seat 1: chiyuki ($24.65 in chips) 
Seat 2: eduvazsilva ($14.90 in chips) 
Seat 3: NastyMcNast ($30.85 in chips) 
Seat 4: wtu1986 ($25.50 in chips) 
Seat 5: Rsonal ($22.78 in chips) 
Seat 6: DooMSDaY1337 ($93.75 in chips) 
Seat 7: Roglus ($39.27 in chips) 
Seat 8: Lasutchik ($31.32 in chips) 
Seat 9: carlosrbr ($12.60 in chips) 
eduvazsilva: posts small blind $0.10
NastyMcNast: posts big blind $0.25
*** HOLE CARDS ***
Dealt to chiyuki [Qh 2c]
wtu1986: folds 
Rsonal: folds 
DooMSDaY1337: folds 
Roglus: folds 
Lasutchik: folds 
carlosrbr: folds 
chiyuki: folds 
eduvazsilva: folds 
Uncalled bet ($0.15) returned to NastyMcNast
NastyMcNast collected $0.20 from pot
NastyMcNast: doesn't show hand 
*** SUMMARY ***
Total pot $0.20 | Rake $0 
Seat 1: chiyuki (button) folded before Flop (didn't bet)
Seat 2: eduvazsilva (small blind) folded before Flop
Seat 3: NastyMcNast (big blind) collected ($0.20)
Seat 4: wtu1986 folded before Flop (didn't bet)
Seat 5: Rsonal folded before Flop (didn't bet)
Seat 6: DooMSDaY1337 folded before Flop (didn't bet)
Seat 7: Roglus folded before Flop (didn't bet)
Seat 8: Lasutchik folded before Flop (didn't bet)
Seat 9: carlosrbr folded before Flop (didn't bet)



PokerStars Zoom Hand #84298754082:  Hold'em No Limit ($0.10/$0.25) - 2012/08/05 13:33:23 JST [2012/08/05 0:33:23 ET]
Table 'Whirlpool' 9-max Seat #1 is the button
Seat 1: TraderYao ($26.60 in chips) 
Seat 2: BlackZafiro ($25 in chips) 
Seat 3: eagie20 ($120.15 in chips) 
Seat 4: masterkoolb ($12.50 in chips) 
Seat 5: gedavaca ($44.96 in chips) 
Seat 6: chiyuki ($24.65 in chips) 
Seat 7: kamikkaze ($48.44 in chips) 
Seat 8: Loholov ($15 in chips) 
Seat 9: BlOnDhOlIc ($65.33 in chips) 
BlackZafiro: posts small blind $0.10
eagie20: posts big blind $0.25
*** HOLE CARDS ***
Dealt to chiyuki [3d 9d]
masterkoolb: folds 
gedavaca: folds 
chiyuki: folds 
kamikkaze: folds 
Loholov: folds 
BlOnDhOlIc: folds 
TraderYao: folds 
BlackZafiro: folds 
Uncalled bet ($0.15) returned to eagie20
eagie20 collected $0.20 from pot
eagie20: doesn't show hand 
*** SUMMARY ***
Total pot $0.20 | Rake $0 
Seat 1: TraderYao (button) folded before Flop (didn't bet)
Seat 2: BlackZafiro (small blind) folded before Flop
Seat 3: eagie20 (big blind) collected ($0.20)
Seat 4: masterkoolb folded before Flop (didn't bet)
Seat 5: gedavaca folded before Flop (didn't bet)
Seat 6: chiyuki folded before Flop (didn't bet)
Seat 7: kamikkaze folded before Flop (didn't bet)
Seat 8: Loholov folded before Flop (didn't bet)
Seat 9: BlOnDhOlIc folded before Flop (didn't bet)



PokerStars Zoom Hand #84298743811:  Hold'em No Limit ($0.10/$0.25) - 2012/08/05 13:32:45 JST [2012/08/05 0:32:45 ET]
Table 'Whirlpool' 9-max Seat #1 is the button
Seat 1: fwani ($29.33 in chips) 
Seat 2: Suhoff76 ($27.92 in chips) 
Seat 3: chiyuki ($24.90 in chips) 
Seat 4: seula i ($46.69 in chips) 
Seat 5: gedavaca ($44.96 in chips) 
Seat 6: trusbi_na_go ($11.39 in chips) 
Seat 7: Alvinpe85 ($57.24 in chips) 
Seat 8: KeLevro0 ($12.50 in chips) 
Seat 9: RomarioJa ($5.61 in chips) 
Suhoff76: posts small blind $0.10
chiyuki: posts big blind $0.25
*** HOLE CARDS ***
Dealt to chiyuki [Qd Js]
seula i: folds 
gedavaca: folds 
trusbi_na_go: folds 
Alvinpe85: folds 
KeLevro0: folds 
RomarioJa: folds 
fwani: raises $0.35 to $0.60
Suhoff76: raises $1.30 to $1.90
chiyuki: folds 
fwani: calls $1.30
*** FLOP *** [Jh 8c 9h]
Suhoff76: bets $2.55
fwani: calls $2.55
*** TURN *** [Jh 8c 9h] [6c]
Suhoff76: bets $5.76
fwani: calls $5.76
*** RIVER *** [Jh 8c 9h 6c] [5d]
Suhoff76: bets $17.71 and is all-in
fwani: calls $17.71
*** SHOW DOWN ***
Suhoff76: shows [Kd Ks] (a pair of Kings)
fwani: mucks hand 
Suhoff76 collected $54.09 from pot
*** SUMMARY ***
Total pot $56.09 | Rake $2 
Board [Jh 8c 9h 6c 5d]
Seat 1: fwani (button) mucked [As Jd]
Seat 2: Suhoff76 (small blind) showed [Kd Ks] and won ($54.09) with a pair of Kings
Seat 3: chiyuki (big blind) folded before Flop
Seat 4: seula i folded before Flop (didn't bet)
Seat 5: gedavaca folded before Flop (didn't bet)
Seat 6: trusbi_na_go folded before Flop (didn't bet)
Seat 7: Alvinpe85 folded before Flop (didn't bet)
Seat 8: KeLevro0 folded before Flop (didn't bet)
Seat 9: RomarioJa folded before Flop (didn't bet)



PokerStars Zoom Hand #84298758904:  Hold'em No Limit ($0.10/$0.25) - 2012/08/05 13:33:41 JST [2012/08/05 0:33:41 ET]
Table 'Whirlpool' 9-max Seat #1 is the button
Seat 1: Th3Fog ($16.42 in chips) 
Seat 2: chiyuki ($24.65 in chips) 
Seat 3: TraderYao ($27.44 in chips) 
Seat 4: PetitAlejo ($25 in chips) 
Seat 5: seula i ($62.04 in chips) 
Seat 6: Suhoff76 ($25 in chips) 
Seat 7: Dejacob ($25.79 in chips) 
Seat 8: Loholov ($18.18 in chips) 
Seat 9: ll_LaMeR_ll ($40.62 in chips) 
chiyuki: posts small blind $0.10
TraderYao: posts big blind $0.25
*** HOLE CARDS ***
Dealt to chiyuki [8c Qh]
PetitAlejo: folds 
seula i: folds 
Suhoff76: folds 
Dejacob: folds 
Loholov: folds 
ll_LaMeR_ll: folds 
Th3Fog: folds 
chiyuki: folds 
Uncalled bet ($0.15) returned to TraderYao
TraderYao collected $0.20 from pot
TraderYao: doesn't show hand 
*** SUMMARY ***
Total pot $0.20 | Rake $0 
Seat 1: Th3Fog (button) folded before Flop (didn't bet)
Seat 2: chiyuki (small blind) folded before Flop
Seat 3: TraderYao (big blind) collected ($0.20)
Seat 4: PetitAlejo folded before Flop (didn't bet)
Seat 5: seula i folded before Flop (didn't bet)
Seat 6: Suhoff76 folded before Flop (didn't bet)
Seat 7: Dejacob folded before Flop (didn't bet)
Seat 8: Loholov folded before Flop (didn't bet)
Seat 9: ll_LaMeR_ll folded before Flop (didn't bet)



PokerStars Zoom Hand #84298756725:  Hold'em No Limit ($0.10/$0.25) - 2012/08/05 13:33:33 JST [2012/08/05 0:33:33 ET]
Table 'Whirlpool' 9-max Seat #1 is the button
Seat 1: macr11111111 ($12.50 in chips) 
Seat 2: trusbi_na_go ($10.14 in chips) 
Seat 3: deadmoneykid ($23.62 in chips) 
Seat 4: fwani ($34 in chips) 
Seat 5: chiyuki ($24.65 in chips) 
Seat 6: ll_LaMeR_ll ($40.62 in chips) 
Seat 7: gedavaca ($44.96 in chips) 
Seat 8: Loholov ($22 in chips) 
Seat 9: softdesign ($49.26 in chips) 
trusbi_na_go: posts small blind $0.10
deadmoneykid: posts big blind $0.25
*** HOLE CARDS ***
Dealt to chiyuki [4h 7s]
fwani: folds 
chiyuki: folds 
ll_LaMeR_ll: folds 
gedavaca: folds 
Loholov: folds 
softdesign: folds 
macr11111111: raises $0.50 to $0.75
trusbi_na_go: folds 
deadmoneykid: folds 
Uncalled bet ($0.50) returned to macr11111111
macr11111111 collected $0.60 from pot
macr11111111: doesn't show hand 
*** SUMMARY ***
Total pot $0.60 | Rake $0 
Seat 1: macr11111111 (button) collected ($0.60)
Seat 2: trusbi_na_go (small blind) folded before Flop
Seat 3: deadmoneykid (big blind) folded before Flop
Seat 4: fwani folded before Flop (didn't bet)
Seat 5: chiyuki folded before Flop (didn't bet)
Seat 6: ll_LaMeR_ll folded before Flop (didn't bet)
Seat 7: gedavaca folded before Flop (didn't bet)
Seat 8: Loholov folded before Flop (didn't bet)
Seat 9: softdesign folded before Flop (didn't bet)



PokerStars Zoom Hand #84298762066:  Hold'em No Limit ($0.10/$0.25) - 2012/08/05 13:33:54 JST [2012/08/05 0:33:54 ET]
Table 'Whirlpool' 9-max Seat #1 is the button
Seat 1: deadmoneykid ($26.01 in chips) 
Seat 2: Roglus ($39.02 in chips) 
Seat 3: fwani ($34 in chips) 
Seat 4: wtu1986 ($25.35 in chips) 
Seat 5: chiyuki ($24.55 in chips) 
Seat 6: BlOnDhOlIc ($26.73 in chips) 
Seat 7: BlackZafiro ($25.35 in chips) 
Seat 8: PetitAlejo ($29.39 in chips) 
Seat 9: hirozo ($40.83 in chips) 
Roglus: posts small blind $0.10
fwani: posts big blind $0.25
*** HOLE CARDS ***
Dealt to chiyuki [Qh Qd]
wtu1986: folds 
chiyuki: raises $0.50 to $0.75
BlOnDhOlIc: calls $0.75
BlackZafiro: folds 
PetitAlejo: folds 
hirozo: folds 
deadmoneykid: folds 
Roglus: folds 
fwani: calls $0.50
*** FLOP *** [3d Jh 7s]
fwani: checks 
chiyuki: bets $1.25
BlOnDhOlIc: raises $1.25 to $2.50
fwani: folds 
chiyuki: calls $1.25
*** TURN *** [3d Jh 7s] [2h]
chiyuki: checks 
BlOnDhOlIc: checks 
*** RIVER *** [3d Jh 7s 2h] [5c]
chiyuki: checks 
BlOnDhOlIc: checks 
*** SHOW DOWN ***
chiyuki: shows [Qh Qd] (a pair of Queens)
BlOnDhOlIc: mucks hand 
chiyuki collected $7.02 from pot
*** SUMMARY ***
Total pot $7.35 | Rake $0.33 
Board [3d Jh 7s 2h 5c]
Seat 1: deadmoneykid (button) folded before Flop (didn't bet)
Seat 2: Roglus (small blind) folded before Flop
Seat 3: fwani (big blind) folded on the Flop
Seat 4: wtu1986 folded before Flop (didn't bet)
Seat 5: chiyuki showed [Qh Qd] and won ($7.02) with a pair of Queens
Seat 6: BlOnDhOlIc mucked [9c 9d]
Seat 7: BlackZafiro folded before Flop (didn't bet)
Seat 8: PetitAlejo folded before Flop (didn't bet)
Seat 9: hirozo folded before Flop (didn't bet)



PokerStars Zoom Hand #84298782805:  Hold'em No Limit ($0.10/$0.25) - 2012/08/05 13:35:13 JST [2012/08/05 0:35:13 ET]
Table 'Whirlpool' 9-max Seat #1 is the button
Seat 1: stankfist420 ($10.44 in chips) 
Seat 2: Roglus ($17.98 in chips) 
Seat 3: Ellen1947 ($26.95 in chips) 
Seat 4: TamiKarpen13 ($16.51 in chips) 
Seat 5: seula i ($34.08 in chips) 
Seat 6: jtedecaliss ($136.75 in chips) 
Seat 7: ShockLaMuc ($16.43 in chips) 
Seat 8: Landybob ($32.34 in chips) 
Seat 9: chiyuki ($28.32 in chips) 
Roglus: posts small blind $0.10
Ellen1947: posts big blind $0.25
*** HOLE CARDS ***
Dealt to chiyuki [Jd 3h]
TamiKarpen13: folds 
seula i: raises $0.75 to $1
jtedecaliss: folds 
ShockLaMuc: folds 
Landybob: folds 
chiyuki: folds 
stankfist420: folds 
Roglus: folds 
Ellen1947: folds 
Uncalled bet ($0.75) returned to seula i
seula i collected $0.60 from pot
seula i: doesn't show hand 
*** SUMMARY ***
Total pot $0.60 | Rake $0 
Seat 1: stankfist420 (button) folded before Flop (didn't bet)
Seat 2: Roglus (small blind) folded before Flop
Seat 3: Ellen1947 (big blind) folded before Flop
Seat 4: TamiKarpen13 folded before Flop (didn't bet)
Seat 5: seula i collected ($0.60)
Seat 6: jtedecaliss folded before Flop (didn't bet)
Seat 7: ShockLaMuc folded before Flop (didn't bet)
Seat 8: Landybob folded before Flop (didn't bet)
Seat 9: chiyuki folded before Flop (didn't bet)



PokerStars Zoom Hand #84298781255:  Hold'em No Limit ($0.10/$0.25) - 2012/08/05 13:35:07 JST [2012/08/05 0:35:07 ET]
Table 'Whirlpool' 9-max Seat #1 is the button
Seat 1: chiyuki ($28.32 in chips) 
Seat 2: fwani ($33.25 in chips) 
Seat 3: TErr18 ($25.30 in chips) 
Seat 4: Ellen1947 ($26.95 in chips) 
Seat 5: TamiKarpen13 ($16.51 in chips) 
Seat 6: BlackZafiro ($25.35 in chips) 
Seat 7: Roglus ($39.94 in chips) 
Seat 8: deadmoneykid ($23.27 in chips) 
Seat 9: BlOnDhOlIc ($25 in chips) 
fwani: posts small blind $0.10
TErr18: posts big blind $0.25
*** HOLE CARDS ***
Dealt to chiyuki [4h 9h]
Ellen1947: folds 
TamiKarpen13: folds 
BlackZafiro: folds 
Roglus: folds 
deadmoneykid: raises $0.35 to $0.60
BlOnDhOlIc: raises $1.65 to $2.25
chiyuki: folds 
fwani: folds 
TErr18: folds 
deadmoneykid: folds 
Uncalled bet ($1.65) returned to BlOnDhOlIc
BlOnDhOlIc collected $1.55 from pot
BlOnDhOlIc: doesn't show hand 
*** SUMMARY ***
Total pot $1.55 | Rake $0 
Seat 1: chiyuki (button) folded before Flop (didn't bet)
Seat 2: fwani (small blind) folded before Flop
Seat 3: TErr18 (big blind) folded before Flop
Seat 4: Ellen1947 folded before Flop (didn't bet)
Seat 5: TamiKarpen13 folded before Flop (didn't bet)
Seat 6: BlackZafiro folded before Flop (didn't bet)
Seat 7: Roglus folded before Flop (didn't bet)
Seat 8: deadmoneykid folded before Flop
Seat 9: BlOnDhOlIc collected ($1.55)



PokerStars Zoom Hand #84298788590:  Hold'em No Limit ($0.10/$0.25) - 2012/08/05 13:35:35 JST [2012/08/05 0:35:35 ET]
Table 'Whirlpool' 9-max Seat #1 is the button
Seat 1: a_tasmanian ($82.81 in chips) 
Seat 2: BlOnDhOlIc ($64.73 in chips) 
Seat 3: ShockLaMuc ($17.91 in chips) 
Seat 4: Roglus ($17.88 in chips) 
Seat 5: fwani ($29.65 in chips) 
Seat 6: TraderYao ($26.69 in chips) 
Seat 7: KeLevro0 ($10.75 in chips) 
Seat 8: chiyuki ($28.07 in chips) 
Seat 9: BlackZafiro ($26.20 in chips) 
BlOnDhOlIc: posts small blind $0.10
ShockLaMuc: posts big blind $0.25
*** HOLE CARDS ***
Dealt to chiyuki [Td 4s]
Roglus: folds 
fwani: folds 
TraderYao: folds 
KeLevro0: raises $0.42 to $0.67
chiyuki: folds 
BlackZafiro: folds 
a_tasmanian: folds 
BlOnDhOlIc: folds 
ShockLaMuc: folds 
Uncalled bet ($0.42) returned to KeLevro0
KeLevro0 collected $0.60 from pot
KeLevro0: doesn't show hand 
*** SUMMARY ***
Total pot $0.60 | Rake $0 
Seat 1: a_tasmanian (button) folded before Flop (didn't bet)
Seat 2: BlOnDhOlIc (small blind) folded before Flop
Seat 3: ShockLaMuc (big blind) folded before Flop
Seat 4: Roglus folded before Flop (didn't bet)
Seat 5: fwani folded before Flop (didn't bet)
Seat 6: TraderYao folded before Flop (didn't bet)
Seat 7: KeLevro0 collected ($0.60)
Seat 8: chiyuki folded before Flop (didn't bet)
Seat 9: BlackZafiro folded before Flop (didn't bet)



PokerStars Zoom Hand #84298790970:  Hold'em No Limit ($0.10/$0.25) - 2012/08/05 13:35:44 JST [2012/08/05 0:35:44 ET]
Table 'Whirlpool' 9-max Seat #1 is the button
Seat 1: trusbi_na_go ($9.05 in chips) 
Seat 2: DooMSDaY1337 ($98.80 in chips) 
Seat 3: Suhoff76 ($25 in chips) 
Seat 4: Landybob ($32.09 in chips) 
Seat 5: taksist889 ($25.13 in chips) 
Seat 6: chiyuki ($28.07 in chips) 
Seat 7: eduvazsilva ($14.10 in chips) 
Seat 8: wtu1986 ($25.75 in chips) 
Seat 9: Lasutchik ($31.68 in chips) 
DooMSDaY1337: posts small blind $0.10
Suhoff76: posts big blind $0.25
*** HOLE CARDS ***
Dealt to chiyuki [Qs 8s]
Landybob: folds 
taksist889: raises $0.50 to $0.75
chiyuki: folds 
eduvazsilva: folds 
wtu1986: folds 
Lasutchik: folds 
trusbi_na_go: folds 
DooMSDaY1337: folds 
Suhoff76: folds 
Uncalled bet ($0.50) returned to taksist889
taksist889 collected $0.60 from pot
taksist889: doesn't show hand 
*** SUMMARY ***
Total pot $0.60 | Rake $0 
Seat 1: trusbi_na_go (button) folded before Flop (didn't bet)
Seat 2: DooMSDaY1337 (small blind) folded before Flop
Seat 3: Suhoff76 (big blind) folded before Flop
Seat 4: Landybob folded before Flop (didn't bet)
Seat 5: taksist889 collected ($0.60)
Seat 6: chiyuki folded before Flop (didn't bet)
Seat 7: eduvazsilva folded before Flop (didn't bet)
Seat 8: wtu1986 folded before Flop (didn't bet)
Seat 9: Lasutchik folded before Flop (didn't bet)



PokerStars Zoom Hand #84298792291:  Hold'em No Limit ($0.10/$0.25) - 2012/08/05 13:35:49 JST [2012/08/05 0:35:49 ET]
Table 'Whirlpool' 9-max Seat #1 is the button
Seat 1: DooMSDaY1337 ($98.70 in chips) 
Seat 2: trusbi_na_go ($9.05 in chips) 
Seat 3: Alvinpe85 ($26.84 in chips) 
Seat 4: Landybob ($32.09 in chips) 
Seat 5: softdesign ($44.01 in chips) 
Seat 6: Ellen1947 ($25.75 in chips) 
Seat 7: chiyuki ($28.07 in chips) 
Seat 8: KeLevro0 ($11.10 in chips) 
Seat 9: silvno31 ($27.70 in chips) 
trusbi_na_go: posts small blind $0.10
Alvinpe85: posts big blind $0.25
*** HOLE CARDS ***
Dealt to chiyuki [Jc 7s]
Landybob: folds 
softdesign: calls $0.25
Ellen1947: folds 
chiyuki: folds 
KeLevro0: folds 
silvno31: folds 
DooMSDaY1337: folds 
trusbi_na_go: folds 
Alvinpe85: checks 
*** FLOP *** [Tc 8h 5d]
Alvinpe85: checks 
softdesign: bets $1
Alvinpe85: folds 
Uncalled bet ($1) returned to softdesign
softdesign collected $0.57 from pot
softdesign: doesn't show hand 
*** SUMMARY ***
Total pot $0.60 | Rake $0.03 
Board [Tc 8h 5d]
Seat 1: DooMSDaY1337 (button) folded before Flop (didn't bet)
Seat 2: trusbi_na_go (small blind) folded before Flop
Seat 3: Alvinpe85 (big blind) folded on the Flop
Seat 4: Landybob folded before Flop (didn't bet)
Seat 5: softdesign collected ($0.57)
Seat 6: Ellen1947 folded before Flop (didn't bet)
Seat 7: chiyuki folded before Flop (didn't bet)
Seat 8: KeLevro0 folded before Flop (didn't bet)
Seat 9: silvno31 folded before Flop (didn't bet)



PokerStars Zoom Hand #84298793811:  Hold'em No Limit ($0.10/$0.25) - 2012/08/05 13:35:55 JST [2012/08/05 0:35:55 ET]
Table 'Whirlpool' 9-max Seat #1 is the button
Seat 1: solawind ($25.10 in chips) 
Seat 2: ll_LaMeR_ll ($33.02 in chips) 
Seat 3: ygoegoe ($26.85 in chips) 
Seat 4: chiyuki ($28.07 in chips) 
Seat 5: fwani ($32.59 in chips) 
Seat 6: ShockLaMuc ($17.66 in chips) 
Seat 7: Dejacob ($38.96 in chips) 
Seat 8: seula i ($47.02 in chips) 
Seat 9: stankfist420 ($9.69 in chips) 
ll_LaMeR_ll: posts small blind $0.10
ygoegoe: posts big blind $0.25
*** HOLE CARDS ***
Dealt to chiyuki [As 7c]
chiyuki: folds 
fwani: folds 
ShockLaMuc: folds 
Dejacob: folds 
seula i: folds 
stankfist420: folds 
solawind: folds 
ll_LaMeR_ll: raises $0.50 to $0.75
ygoegoe: folds 
Uncalled bet ($0.50) returned to ll_LaMeR_ll
ll_LaMeR_ll collected $0.50 from pot
ll_LaMeR_ll: doesn't show hand 
*** SUMMARY ***
Total pot $0.50 | Rake $0 
Seat 1: solawind (button) folded before Flop (didn't bet)
Seat 2: ll_LaMeR_ll (small blind) collected ($0.50)
Seat 3: ygoegoe (big blind) folded before Flop
Seat 4: chiyuki folded before Flop (didn't bet)
Seat 5: fwani folded before Flop (didn't bet)
Seat 6: ShockLaMuc folded before Flop (didn't bet)
Seat 7: Dejacob folded before Flop (didn't bet)
Seat 8: seula i folded before Flop (didn't bet)
Seat 9: stankfist420 folded before Flop (didn't bet)



PokerStars Zoom Hand #84298785913:  Hold'em No Limit ($0.10/$0.25) - 2012/08/05 13:35:25 JST [2012/08/05 0:35:25 ET]
Table 'Whirlpool' 9-max Seat #1 is the button
Seat 1: cR!Ma*aRm ($30.41 in chips) 
Seat 2: Th3Fog ($55.10 in chips) 
Seat 3: chiyuki ($28.32 in chips) 
Seat 4: jtedecaliss ($136.75 in chips) 
Seat 5: peng2astic ($10.13 in chips) 
Seat 6: NastyMcNast ($31.55 in chips) 
Seat 7: Roglus ($17.88 in chips) 
Seat 8: Anafim ($14.09 in chips) 
Seat 9: jethaz ($71.50 in chips) 
Th3Fog: posts small blind $0.10
chiyuki: posts big blind $0.25
*** HOLE CARDS ***
Dealt to chiyuki [7d 9h]
jtedecaliss: folds 
peng2astic: raises $1.25 to $1.50
NastyMcNast: folds 
Roglus: folds 
Anafim: folds 
jethaz: calls $1.50
cR!Ma*aRm: folds 
Th3Fog: folds 
chiyuki: folds 
*** FLOP *** [3d 2d 4h]
peng2astic: bets $3
jethaz: calls $3
*** TURN *** [3d 2d 4h] [Td]
peng2astic: bets $5.63 and is all-in
jethaz: folds 
Uncalled bet ($5.63) returned to peng2astic
peng2astic collected $8.93 from pot
peng2astic: doesn't show hand 
*** SUMMARY ***
Total pot $9.35 | Rake $0.42 
Board [3d 2d 4h Td]
Seat 1: cR!Ma*aRm (button) folded before Flop (didn't bet)
Seat 2: Th3Fog (small blind) folded before Flop
Seat 3: chiyuki (big blind) folded before Flop
Seat 4: jtedecaliss folded before Flop (didn't bet)
Seat 5: peng2astic collected ($8.93)
Seat 6: NastyMcNast folded before Flop (didn't bet)
Seat 7: Roglus folded before Flop (didn't bet)
Seat 8: Anafim folded before Flop (didn't bet)
Seat 9: jethaz folded on the Turn



PokerStars Zoom Hand #84298796401:  Hold'em No Limit ($0.10/$0.25) - 2012/08/05 13:36:05 JST [2012/08/05 0:36:05 ET]
Table 'Whirlpool' 9-max Seat #1 is the button
Seat 1: gedavaca ($43.78 in chips) 
Seat 2: chiyuki ($28.07 in chips) 
Seat 3: timburonps ($25 in chips) 
Seat 4: DooMSDaY1337 ($83.01 in chips) 
Seat 5: NastyMcNast ($31.30 in chips) 
Seat 6: a_tasmanian ($83.16 in chips) 
Seat 7: Anafim ($13.74 in chips) 
Seat 8: munky3 ($34.15 in chips) 
Seat 9: D@vidMed ($12.35 in chips) 
chiyuki: posts small blind $0.10
timburonps: posts big blind $0.25
*** HOLE CARDS ***
Dealt to chiyuki [7c 3d]
DooMSDaY1337: folds 
NastyMcNast: folds 
a_tasmanian: folds 
Anafim: folds 
munky3: raises $0.47 to $0.72
D@vidMed: folds 
gedavaca: folds 
chiyuki: folds 
timburonps: folds 
Uncalled bet ($0.47) returned to munky3
munky3 collected $0.60 from pot
munky3: doesn't show hand 
*** SUMMARY ***
Total pot $0.60 | Rake $0 
Seat 1: gedavaca (button) folded before Flop (didn't bet)
Seat 2: chiyuki (small blind) folded before Flop
Seat 3: timburonps (big blind) folded before Flop
Seat 4: DooMSDaY1337 folded before Flop (didn't bet)
Seat 5: NastyMcNast folded before Flop (didn't bet)
Seat 6: a_tasmanian folded before Flop (didn't bet)
Seat 7: Anafim folded before Flop (didn't bet)
Seat 8: munky3 collected ($0.60)
Seat 9: D@vidMed folded before Flop (didn't bet)



PokerStars Zoom Hand #84298797468:  Hold'em No Limit ($0.10/$0.25) - 2012/08/05 13:36:10 JST [2012/08/05 0:36:10 ET]
Table 'Whirlpool' 9-max Seat #1 is the button
Seat 1: ShockLaMuc ($16.43 in chips) 
Seat 2: gedavaca ($43.78 in chips) 
Seat 3: Anafim ($14.81 in chips) 
Seat 4: silvno31 ($27.70 in chips) 
Seat 5: hirozo ($35.99 in chips) 
Seat 6: petersmiths ($25 in chips) 
Seat 7: Suhoff76 ($25 in chips) 
Seat 8: BlOnDhOlIc ($25.33 in chips) 
Seat 9: chiyuki ($27.97 in chips) 
gedavaca: posts small blind $0.10
Anafim: posts big blind $0.25
*** HOLE CARDS ***
Dealt to chiyuki [Ts Ac]
silvno31: folds 
hirozo: folds 
petersmiths: folds 
Suhoff76: folds 
BlOnDhOlIc: raises $0.37 to $0.62
chiyuki: folds 
ShockLaMuc: calls $0.62
gedavaca: folds 
Anafim: folds 
*** FLOP *** [Th 3c 7d]
BlOnDhOlIc: bets $1.14
ShockLaMuc: calls $1.14
*** TURN *** [Th 3c 7d] [7s]
BlOnDhOlIc: bets $2.75
ShockLaMuc: folds 
Uncalled bet ($2.75) returned to BlOnDhOlIc
BlOnDhOlIc collected $3.70 from pot
BlOnDhOlIc: doesn't show hand 
*** SUMMARY ***
Total pot $3.87 | Rake $0.17 
Board [Th 3c 7d 7s]
Seat 1: ShockLaMuc (button) folded on the Turn
Seat 2: gedavaca (small blind) folded before Flop
Seat 3: Anafim (big blind) folded before Flop
Seat 4: silvno31 folded before Flop (didn't bet)
Seat 5: hirozo folded before Flop (didn't bet)
Seat 6: petersmiths folded before Flop (didn't bet)
Seat 7: Suhoff76 folded before Flop (didn't bet)
Seat 8: BlOnDhOlIc collected ($3.70)
Seat 9: chiyuki folded before Flop (didn't bet)



PokerStars Zoom Hand #84298800628:  Hold'em No Limit ($0.10/$0.25) - 2012/08/05 13:36:22 JST [2012/08/05 0:36:22 ET]
Table 'Whirlpool' 9-max Seat #1 is the button
Seat 1: deadmoneykid ($23.36 in chips) 
Seat 2: agurio ($25 in chips) 
Seat 3: chiyuki ($27.97 in chips) 
Seat 4: leo2095 ($13.82 in chips) 
Seat 5: Anafim ($14.56 in chips) 
Seat 6: jethaz ($53.15 in chips) 
Seat 7: KeLevro0 ($15.92 in chips) 
Seat 8: gedavaca ($43.68 in chips) 
Seat 9: vit 111 ($34.56 in chips) 
agurio: posts small blind $0.10
chiyuki: posts big blind $0.25
*** HOLE CARDS ***
Dealt to chiyuki [3d 3s]
leo2095: folds 
Anafim: folds 
jethaz: folds 
KeLevro0: folds 
gedavaca: folds 
vit 111: folds 
deadmoneykid: folds 
agurio: raises $0.50 to $0.75
chiyuki: calls $0.50
*** FLOP *** [As 7d Ts]
agurio: bets $1
chiyuki: folds 
Uncalled bet ($1) returned to agurio
agurio collected $1.43 from pot
agurio: doesn't show hand 
*** SUMMARY ***
Total pot $1.50 | Rake $0.07 
Board [As 7d Ts]
Seat 1: deadmoneykid (button) folded before Flop (didn't bet)
Seat 2: agurio (small blind) collected ($1.43)
Seat 3: chiyuki (big blind) folded on the Flop
Seat 4: leo2095 folded before Flop (didn't bet)
Seat 5: Anafim folded before Flop (didn't bet)
Seat 6: jethaz folded before Flop (didn't bet)
Seat 7: KeLevro0 folded before Flop (didn't bet)
Seat 8: gedavaca folded before Flop (didn't bet)
Seat 9: vit 111 folded before Flop (didn't bet)



PokerStars Zoom Hand #84298795147:  Hold'em No Limit ($0.10/$0.25) - 2012/08/05 13:36:00 JST [2012/08/05 0:36:00 ET]
Table 'Whirlpool' 9-max Seat #1 is the button
Seat 1: Suhoff76 ($25 in chips) 
Seat 2: stankfist420 ($9.69 in chips) 
Seat 3: wildy29 ($15 in chips) 
Seat 4: Jippyflip ($17.15 in chips) 
Seat 5: Dejacob ($38.96 in chips) 
Seat 6: chiyuki ($28.07 in chips) 
Seat 7: KeLevro0 ($9.33 in chips) 
Seat 8: petersmiths ($25 in chips) 
Seat 9: agurio ($30.05 in chips) 
stankfist420: posts small blind $0.10
wildy29: posts big blind $0.25
*** HOLE CARDS ***
Dealt to chiyuki [2h Kc]
Jippyflip: folds 
Dejacob: raises $0.50 to $0.75
chiyuki: folds 
KeLevro0: folds 
petersmiths: folds 
agurio: folds 
Suhoff76: folds 
stankfist420: folds 
wildy29: calls $0.50
*** FLOP *** [4c 3h 5d]
wildy29: checks 
Dejacob: bets $1
wildy29: calls $1
*** TURN *** [4c 3h 5d] [Th]
wildy29: bets $1.25
Dejacob: folds 
Uncalled bet ($1.25) returned to wildy29
wildy29 collected $3.44 from pot
wildy29: doesn't show hand 
*** SUMMARY ***
Total pot $3.60 | Rake $0.16 
Board [4c 3h 5d Th]
Seat 1: Suhoff76 (button) folded before Flop (didn't bet)
Seat 2: stankfist420 (small blind) folded before Flop
Seat 3: wildy29 (big blind) collected ($3.44)
Seat 4: Jippyflip folded before Flop (didn't bet)
Seat 5: Dejacob folded on the Turn
Seat 6: chiyuki folded before Flop (didn't bet)
Seat 7: KeLevro0 folded before Flop (didn't bet)
Seat 8: petersmiths folded before Flop (didn't bet)
Seat 9: agurio folded before Flop (didn't bet)



PokerStars Zoom Hand #84298808172:  Hold'em No Limit ($0.10/$0.25) - 2012/08/05 13:36:50 JST [2012/08/05 0:36:50 ET]
Table 'Whirlpool' 9-max Seat #1 is the button
Seat 1: chiyuki ($27.22 in chips) 
Seat 2: Alvinpe85 ($53.43 in chips) 
Seat 3: Th3Fog ($55 in chips) 
Seat 4: Dejacob ($26.70 in chips) 
Seat 5: ll_LaMeR_ll ($34 in chips) 
Seat 6: goldstone ($37.77 in chips) 
Seat 7: Paranoix1990 ($21.62 in chips) 
Seat 8: Nerkit ($11.65 in chips) 
Seat 9: BlOnDhOlIc ($35.73 in chips) 
Alvinpe85: posts small blind $0.10
Th3Fog: posts big blind $0.25
*** HOLE CARDS ***
Dealt to chiyuki [7h Jd]
Dejacob: folds 
ll_LaMeR_ll: raises $0.50 to $0.75
goldstone: folds 
Paranoix1990: calls $0.75
Nerkit: folds 
BlOnDhOlIc: folds 
chiyuki: folds 
Alvinpe85: folds 
Th3Fog: folds 
*** FLOP *** [7s 8d Ks]
ll_LaMeR_ll: bets $1
Paranoix1990: folds 
Uncalled bet ($1) returned to ll_LaMeR_ll
ll_LaMeR_ll collected $1.77 from pot
ll_LaMeR_ll: doesn't show hand 
*** SUMMARY ***
Total pot $1.85 | Rake $0.08 
Board [7s 8d Ks]
Seat 1: chiyuki (button) folded before Flop (didn't bet)
Seat 2: Alvinpe85 (small blind) folded before Flop
Seat 3: Th3Fog (big blind) folded before Flop
Seat 4: Dejacob folded before Flop (didn't bet)
Seat 5: ll_LaMeR_ll collected ($1.77)
Seat 6: goldstone folded before Flop (didn't bet)
Seat 7: Paranoix1990 folded on the Flop
Seat 8: Nerkit folded before Flop (didn't bet)
Seat 9: BlOnDhOlIc folded before Flop (didn't bet)



PokerStars Zoom Hand #84298810918:  Hold'em No Limit ($0.10/$0.25) - 2012/08/05 13:37:00 JST [2012/08/05 0:37:00 ET]
Table 'Whirlpool' 9-max Seat #1 is the button
Seat 1: ygoegoe ($26.50 in chips) 
Seat 2: Suhoff76 ($25 in chips) 
Seat 3: Loholov ($15 in chips) 
Seat 4: jeff0923 ($26.12 in chips) 
Seat 5: Jippyflip ($16.80 in chips) 
Seat 6: TraderYao ($28.47 in chips) 
Seat 7: PetitAlejo ($36.61 in chips) 
Seat 8: chiyuki ($27.22 in chips) 
Seat 9: ShockLaMuc ($17.56 in chips) 
Suhoff76: posts small blind $0.10
Loholov: posts big blind $0.25
*** HOLE CARDS ***
Dealt to chiyuki [Th 3d]
jeff0923: folds 
Jippyflip: folds 
TraderYao: folds 
PetitAlejo: raises $0.50 to $0.75
chiyuki: folds 
ShockLaMuc: folds 
ygoegoe: folds 
Suhoff76: folds 
Loholov: calls $0.50
*** FLOP *** [9h Ts 7s]
Loholov: checks 
PetitAlejo: bets $1
Loholov: folds 
Uncalled bet ($1) returned to PetitAlejo
PetitAlejo collected $1.53 from pot
PetitAlejo: doesn't show hand 
*** SUMMARY ***
Total pot $1.60 | Rake $0.07 
Board [9h Ts 7s]
Seat 1: ygoegoe (button) folded before Flop (didn't bet)
Seat 2: Suhoff76 (small blind) folded before Flop
Seat 3: Loholov (big blind) folded on the Flop
Seat 4: jeff0923 folded before Flop (didn't bet)
Seat 5: Jippyflip folded before Flop (didn't bet)
Seat 6: TraderYao folded before Flop (didn't bet)
Seat 7: PetitAlejo collected ($1.53)
Seat 8: chiyuki folded before Flop (didn't bet)
Seat 9: ShockLaMuc folded before Flop (didn't bet)



PokerStars Zoom Hand #84298813339:  Hold'em No Limit ($0.10/$0.25) - 2012/08/05 13:37:09 JST [2012/08/05 0:37:09 ET]
Table 'Whirlpool' 9-max Seat #1 is the button
Seat 1: jeff0923 ($26.12 in chips) 
Seat 2: BlackZafiro ($25.10 in chips) 
Seat 3: Nerkit ($11.65 in chips) 
Seat 4: TamiKarpen13 ($16.78 in chips) 
Seat 5: PetitAlejo ($26.96 in chips) 
Seat 6: Landybob ($31.64 in chips) 
Seat 7: chiyuki ($27.22 in chips) 
Seat 8: wtu1986 ($24.65 in chips) 
Seat 9: DooMSDaY1337 ($99.38 in chips) 
BlackZafiro: posts small blind $0.10
Nerkit: posts big blind $0.25
*** HOLE CARDS ***
Dealt to chiyuki [8d 3d]
TamiKarpen13: folds 
PetitAlejo: folds 
Landybob: folds 
chiyuki: folds 
wtu1986: folds 
DooMSDaY1337: raises $0.50 to $0.75
jeff0923: folds 
BlackZafiro: folds 
Nerkit: folds 
Uncalled bet ($0.50) returned to DooMSDaY1337
DooMSDaY1337 collected $0.60 from pot
DooMSDaY1337: doesn't show hand 
*** SUMMARY ***
Total pot $0.60 | Rake $0 
Seat 1: jeff0923 (button) folded before Flop (didn't bet)
Seat 2: BlackZafiro (small blind) folded before Flop
Seat 3: Nerkit (big blind) folded before Flop
Seat 4: TamiKarpen13 folded before Flop (didn't bet)
Seat 5: PetitAlejo folded before Flop (didn't bet)
Seat 6: Landybob folded before Flop (didn't bet)
Seat 7: chiyuki folded before Flop (didn't bet)
Seat 8: wtu1986 folded before Flop (didn't bet)
Seat 9: DooMSDaY1337 collected ($0.60)



PokerStars Zoom Hand #84298815801:  Hold'em No Limit ($0.10/$0.25) - 2012/08/05 13:37:18 JST [2012/08/05 0:37:18 ET]
Table 'Whirlpool' 9-max Seat #1 is the button
Seat 1: BlOnDhOlIc ($31.30 in chips) 
Seat 2: chiyuki ($27.22 in chips) 
Seat 3: hirozo ($26.90 in chips) 
Seat 4: Suhoff76 ($25 in chips) 
Seat 5: wtu1986 ($24.65 in chips) 
Seat 6: jethaz ($64.52 in chips) 
Seat 7: taiali ($16.62 in chips) 
Seat 8: Th3Fog ($65.18 in chips) 
Seat 9: BlackZafiro ($25 in chips) 
chiyuki: posts small blind $0.10
hirozo: posts big blind $0.25
*** HOLE CARDS ***
Dealt to chiyuki [Ts 5c]
Suhoff76: folds 
wtu1986: folds 
jethaz: folds 
taiali: folds 
Th3Fog: raises $0.47 to $0.72
BlackZafiro: folds 
BlOnDhOlIc: folds 
chiyuki: folds 
hirozo: folds 
Uncalled bet ($0.47) returned to Th3Fog
Th3Fog collected $0.60 from pot
Th3Fog: doesn't show hand 
*** SUMMARY ***
Total pot $0.60 | Rake $0 
Seat 1: BlOnDhOlIc (button) folded before Flop (didn't bet)
Seat 2: chiyuki (small blind) folded before Flop
Seat 3: hirozo (big blind) folded before Flop
Seat 4: Suhoff76 folded before Flop (didn't bet)
Seat 5: wtu1986 folded before Flop (didn't bet)
Seat 6: jethaz folded before Flop (didn't bet)
Seat 7: taiali folded before Flop (didn't bet)
Seat 8: Th3Fog collected ($0.60)
Seat 9: BlackZafiro folded before Flop (didn't bet)



PokerStars Zoom Hand #84298818456:  Hold'em No Limit ($0.10/$0.25) - 2012/08/05 13:37:29 JST [2012/08/05 0:37:29 ET]
Table 'Whirlpool' 9-max Seat #1 is the button
Seat 1: stankfist420 ($14.81 in chips) 
Seat 2: wtu1986 ($24.65 in chips) 
Seat 3: DooMSDaY1337 ($99.73 in chips) 
Seat 4: Anafim ($14.46 in chips) 
Seat 5: hirozo ($25 in chips) 
Seat 6: chiyuki ($27.12 in chips) 
Seat 7: Roglus ($11.13 in chips) 
Seat 8: Suhoff76 ($25 in chips) 
Seat 9: TraderYao ($28.47 in chips) 
wtu1986: posts small blind $0.10
DooMSDaY1337: posts big blind $0.25
*** HOLE CARDS ***
Dealt to chiyuki [3h Qc]
Anafim: folds 
hirozo: folds 
chiyuki: folds 
Roglus: folds 
Suhoff76: folds 
TraderYao: folds 
stankfist420: folds 
wtu1986: folds 
Uncalled bet ($0.15) returned to DooMSDaY1337
DooMSDaY1337 collected $0.20 from pot
DooMSDaY1337: doesn't show hand 
*** SUMMARY ***
Total pot $0.20 | Rake $0 
Seat 1: stankfist420 (button) folded before Flop (didn't bet)
Seat 2: wtu1986 (small blind) folded before Flop
Seat 3: DooMSDaY1337 (big blind) collected ($0.20)
Seat 4: Anafim folded before Flop (didn't bet)
Seat 5: hirozo folded before Flop (didn't bet)
Seat 6: chiyuki folded before Flop (didn't bet)
Seat 7: Roglus folded before Flop (didn't bet)
Seat 8: Suhoff76 folded before Flop (didn't bet)
Seat 9: TraderYao folded before Flop (didn't bet)



PokerStars Zoom Hand #84298807367:  Hold'em No Limit ($0.10/$0.25) - 2012/08/05 13:36:47 JST [2012/08/05 0:36:47 ET]
Table 'Whirlpool' 9-max Seat #1 is the button
Seat 1: Landybob ($31.64 in chips) 
Seat 2: DooMSDaY1337 ($82.26 in chips) 
Seat 3: BlackZafiro ($25 in chips) 
Seat 4: Nerkit ($11.65 in chips) 
Seat 5: chiyuki ($27.22 in chips) 
Seat 6: eduvazsilva ($13.75 in chips) 
Seat 7: Pkdave ($39.20 in chips) 
Seat 8: Jippyflip ($16.80 in chips) 
Seat 9: carlosrbr ($17.05 in chips) 
DooMSDaY1337: posts small blind $0.10
BlackZafiro: posts big blind $0.25
*** HOLE CARDS ***
Dealt to chiyuki [4h Js]
Nerkit: folds 
chiyuki: folds 
eduvazsilva: folds 
Pkdave: calls $0.25
Jippyflip: folds 
carlosrbr: raises $0.75 to $1
Landybob: folds 
DooMSDaY1337: folds 
BlackZafiro: folds 
Pkdave: calls $0.75
*** FLOP *** [4d 8c 7c]
Pkdave: checks 
carlosrbr: bets $1
Pkdave: calls $1
*** TURN *** [4d 8c 7c] [6h]
Pkdave: bets $2
carlosrbr: folds 
Uncalled bet ($2) returned to Pkdave
Pkdave collected $4.15 from pot
Pkdave: doesn't show hand 
*** SUMMARY ***
Total pot $4.35 | Rake $0.20 
Board [4d 8c 7c 6h]
Seat 1: Landybob (button) folded before Flop (didn't bet)
Seat 2: DooMSDaY1337 (small blind) folded before Flop
Seat 3: BlackZafiro (big blind) folded before Flop
Seat 4: Nerkit folded before Flop (didn't bet)
Seat 5: chiyuki folded before Flop (didn't bet)
Seat 6: eduvazsilva folded before Flop (didn't bet)
Seat 7: Pkdave collected ($4.15)
Seat 8: Jippyflip folded before Flop (didn't bet)
Seat 9: carlosrbr folded on the Turn



PokerStars Zoom Hand #84298817386:  Hold'em No Limit ($0.10/$0.25) - 2012/08/05 13:37:25 JST [2012/08/05 0:37:25 ET]
Table 'Whirlpool' 9-max Seat #1 is the button
Seat 1: PetitAlejo ($27.59 in chips) 
Seat 2: NastyMcNast ($63.39 in chips) 
Seat 3: Landybob ($31.64 in chips) 
Seat 4: ygoegoe ($27.47 in chips) 
Seat 5: fwani ($25 in chips) 
Seat 6: Suhoff76 ($25 in chips) 
Seat 7: kamikkaze ($55.32 in chips) 
Seat 8: BlOnDhOlIc ($31.30 in chips) 
Seat 9: chiyuki ($27.12 in chips) 
NastyMcNast: posts small blind $0.10
Landybob: posts big blind $0.25
*** HOLE CARDS ***
Dealt to chiyuki [3s 5s]
ygoegoe: folds 
fwani: folds 
Suhoff76: folds 
kamikkaze: folds 
BlOnDhOlIc: folds 
chiyuki: folds 
PetitAlejo: folds 
NastyMcNast: raises $0.50 to $0.75
Landybob: folds 
Uncalled bet ($0.50) returned to NastyMcNast
NastyMcNast collected $0.50 from pot
NastyMcNast: doesn't show hand 
*** SUMMARY ***
Total pot $0.50 | Rake $0 
Seat 1: PetitAlejo (button) folded before Flop (didn't bet)
Seat 2: NastyMcNast (small blind) collected ($0.50)
Seat 3: Landybob (big blind) folded before Flop
Seat 4: ygoegoe folded before Flop (didn't bet)
Seat 5: fwani folded before Flop (didn't bet)
Seat 6: Suhoff76 folded before Flop (didn't bet)
Seat 7: kamikkaze folded before Flop (didn't bet)
Seat 8: BlOnDhOlIc folded before Flop (didn't bet)
Seat 9: chiyuki folded before Flop (didn't bet)



PokerStars Zoom Hand #84298812538:  Hold'em No Limit ($0.10/$0.25) - 2012/08/05 13:37:06 JST [2012/08/05 0:37:06 ET]
Table 'Whirlpool' 9-max Seat #1 is the button
Seat 1: TraderYao ($25.15 in chips) 
Seat 2: Ellen1947 ($27.52 in chips) 
Seat 3: silvno31 ($27.30 in chips) 
Seat 4: Lasutchik ($12.11 in chips) 
Seat 5: chiyuki ($27.22 in chips) 
Seat 6: Alvinpe85 ($27.41 in chips) 
Seat 7: Anafim ($14.46 in chips) 
Seat 8: ShockLaMuc ($17.56 in chips) 
Seat 9: Th3Fog ($65.18 in chips) 
Ellen1947: posts small blind $0.10
silvno31: posts big blind $0.25
*** HOLE CARDS ***
Dealt to chiyuki [Js Td]
Lasutchik: folds 
chiyuki: folds 
Alvinpe85: raises $0.50 to $0.75
Anafim: folds 
ShockLaMuc: folds 
Th3Fog: folds 
TraderYao: folds 
Ellen1947: folds 
silvno31: calls $0.50
*** FLOP *** [2c Jh 8c]
silvno31: checks 
Alvinpe85: bets $1
silvno31: calls $1
*** TURN *** [2c Jh 8c] [6h]
silvno31: checks 
Alvinpe85: checks 
*** RIVER *** [2c Jh 8c 6h] [5c]
silvno31: bets $2.25
Alvinpe85: folds 
Uncalled bet ($2.25) returned to silvno31
silvno31 collected $3.44 from pot
silvno31: doesn't show hand 
*** SUMMARY ***
Total pot $3.60 | Rake $0.16 
Board [2c Jh 8c 6h 5c]
Seat 1: TraderYao (button) folded before Flop (didn't bet)
Seat 2: Ellen1947 (small blind) folded before Flop
Seat 3: silvno31 (big blind) collected ($3.44)
Seat 4: Lasutchik folded before Flop (didn't bet)
Seat 5: chiyuki folded before Flop (didn't bet)
Seat 6: Alvinpe85 folded on the River
Seat 7: Anafim folded before Flop (didn't bet)
Seat 8: ShockLaMuc folded before Flop (didn't bet)
Seat 9: Th3Fog folded before Flop (didn't bet)



PokerStars Zoom Hand #84298819970:  Hold'em No Limit ($0.10/$0.25) - 2012/08/05 13:37:35 JST [2012/08/05 0:37:35 ET]
Table 'Whirlpool' 9-max Seat #1 is the button
Seat 1: Th3Fog ($54.65 in chips) 
Seat 2: TamiKarpen13 ($16.88 in chips) 
Seat 3: TErr18 ($31.60 in chips) 
Seat 4: chiyuki ($27.12 in chips) 
Seat 5: DooMSDaY1337 ($49.49 in chips) 
Seat 6: Dejacob ($26.27 in chips) 
Seat 7: PetitAlejo ($27.59 in chips) 
Seat 8: hirozo ($35.64 in chips) 
Seat 9: taiali ($16.37 in chips) 
TamiKarpen13: posts small blind $0.10
TErr18: posts big blind $0.25
*** HOLE CARDS ***
Dealt to chiyuki [Ah Ad]
chiyuki: raises $0.50 to $0.75
DooMSDaY1337: folds 
Dejacob: folds 
PetitAlejo: calls $0.75
hirozo: calls $0.75
taiali: folds 
Th3Fog: folds 
TamiKarpen13: folds 
TErr18: calls $0.50
*** FLOP *** [4d 4s 2c]
TErr18: checks 
chiyuki: bets $2
PetitAlejo: folds 
hirozo: calls $2
TErr18: folds 
*** TURN *** [4d 4s 2c] [2d]
chiyuki: bets $6.78
hirozo: raises $26.11 to $32.89 and is all-in
chiyuki: calls $17.59 and is all-in
Uncalled bet ($8.52) returned to hirozo
*** RIVER *** [4d 4s 2c 2d] [8s]
*** SHOW DOWN ***
chiyuki: shows [Ah Ad] (two pair, Aces and Fours)
hirozo: mucks hand 
chiyuki collected $53.84 from pot
*** SUMMARY ***
Total pot $55.84 | Rake $2 
Board [4d 4s 2c 2d 8s]
Seat 1: Th3Fog (button) folded before Flop (didn't bet)
Seat 2: TamiKarpen13 (small blind) folded before Flop
Seat 3: TErr18 (big blind) folded on the Flop
Seat 4: chiyuki showed [Ah Ad] and won ($53.84) with two pair, Aces and Fours
Seat 5: DooMSDaY1337 folded before Flop (didn't bet)
Seat 6: Dejacob folded before Flop (didn't bet)
Seat 7: PetitAlejo folded on the Flop
Seat 8: hirozo mucked [9h 9c]
Seat 9: taiali folded before Flop (didn't bet)



PokerStars Zoom Hand #84298834519:  Hold'em No Limit ($0.10/$0.25) - 2012/08/05 13:38:32 JST [2012/08/05 0:38:32 ET]
Table 'Whirlpool' 9-max Seat #1 is the button
Seat 1: TraderYao ($25.15 in chips) 
Seat 2: ZSIDD ($36.97 in chips) 
Seat 3: chiyuki ($53.84 in chips) 
Seat 4: Th3Fog ($23.36 in chips) 
Seat 5: ladymadon107 ($25.38 in chips) 
Seat 6: PetitAlejo ($25 in chips) 
Seat 7: gunbowler ($137.88 in chips) 
Seat 8: Anafim ($15 in chips) 
Seat 9: BlOnDhOlIc ($35.73 in chips) 
ZSIDD: posts small blind $0.10
chiyuki: posts big blind $0.25
*** HOLE CARDS ***
Dealt to chiyuki [6c 6d]
Th3Fog: folds 
ladymadon107: folds 
PetitAlejo: folds 
gunbowler: raises $0.50 to $0.75
Anafim: folds 
BlOnDhOlIc: folds 
TraderYao: folds 
ZSIDD: folds 
chiyuki: calls $0.50
*** FLOP *** [4h 4d Ks]
chiyuki: checks 
gunbowler: bets $1
chiyuki: folds 
Uncalled bet ($1) returned to gunbowler
gunbowler collected $1.53 from pot
gunbowler: doesn't show hand 
gunbowler is disconnected 
*** SUMMARY ***
Total pot $1.60 | Rake $0.07 
Board [4h 4d Ks]
Seat 1: TraderYao (button) folded before Flop (didn't bet)
Seat 2: ZSIDD (small blind) folded before Flop
Seat 3: chiyuki (big blind) folded on the Flop
Seat 4: Th3Fog folded before Flop (didn't bet)
Seat 5: ladymadon107 folded before Flop (didn't bet)
Seat 6: PetitAlejo folded before Flop (didn't bet)
Seat 7: gunbowler collected ($1.53)
Seat 8: Anafim folded before Flop (didn't bet)
Seat 9: BlOnDhOlIc folded before Flop (didn't bet)



PokerStars Zoom Hand #84298841855:  Hold'em No Limit ($0.10/$0.25) - 2012/08/05 13:39:00 JST [2012/08/05 0:39:00 ET]
Table 'Whirlpool' 9-max Seat #1 is the button
Seat 1: carlosrbr ($15.40 in chips) 
Seat 2: Dejacob ($26.12 in chips) 
Seat 3: agurio ($33.56 in chips) 
Seat 4: solawind ($24.55 in chips) 
Seat 5: taiali ($14.90 in chips) 
Seat 6: BlOnDhOlIc ($67.46 in chips) 
Seat 7: chiyuki ($53.09 in chips) 
Seat 8: KeLevro0 ($15.50 in chips) 
Seat 9: wtu1986 ($27.84 in chips) 
Dejacob: posts small blind $0.10
agurio: posts big blind $0.25
*** HOLE CARDS ***
Dealt to chiyuki [5d 5s]
solawind: folds 
taiali: raises $0.37 to $0.62
BlOnDhOlIc: folds 
chiyuki: folds 
KeLevro0: folds 
wtu1986: folds 
carlosrbr: folds 
Dejacob: folds 
agurio: folds 
Uncalled bet ($0.37) returned to taiali
taiali collected $0.60 from pot
taiali: doesn't show hand 
*** SUMMARY ***
Total pot $0.60 | Rake $0 
Seat 1: carlosrbr (button) folded before Flop (didn't bet)
Seat 2: Dejacob (small blind) folded before Flop
Seat 3: agurio (big blind) folded before Flop
Seat 4: solawind folded before Flop (didn't bet)
Seat 5: taiali collected ($0.60)
Seat 6: BlOnDhOlIc folded before Flop (didn't bet)
Seat 7: chiyuki folded before Flop (didn't bet)
Seat 8: KeLevro0 folded before Flop (didn't bet)
Seat 9: wtu1986 folded before Flop (didn't bet)



PokerStars Zoom Hand #84298845457:  Hold'em No Limit ($0.10/$0.25) - 2012/08/05 13:39:14 JST [2012/08/05 0:39:14 ET]
Table 'Whirlpool' 9-max Seat #1 is the button
Seat 1: chiyuki ($53.09 in chips) 
Seat 2: TraderYao ($28.22 in chips) 
Seat 3: NastyMcNast ($36.50 in chips) 
Seat 4: fwani ($25 in chips) 
Seat 5: agurio ($25.28 in chips) 
Seat 6: Loholov ($15 in chips) 
Seat 7: Anafim ($14.65 in chips) 
Seat 8: cr0lox ($26.14 in chips) 
Seat 9: Nerkit ($14.34 in chips) 
TraderYao: posts small blind $0.10
NastyMcNast: posts big blind $0.25
*** HOLE CARDS ***
Dealt to chiyuki [Kh Js]
fwani: folds 
agurio: folds 
Loholov: folds 
Anafim: raises $0.25 to $0.50
cr0lox: folds 
Nerkit: folds 
chiyuki: folds 
TraderYao: calls $0.40
NastyMcNast: folds 
*** FLOP *** [3s Ad 5c]
TraderYao: checks 
Anafim: bets $0.50
TraderYao: folds 
Uncalled bet ($0.50) returned to Anafim
Anafim collected $1.19 from pot
Anafim: doesn't show hand 
*** SUMMARY ***
Total pot $1.25 | Rake $0.06 
Board [3s Ad 5c]
Seat 1: chiyuki (button) folded before Flop (didn't bet)
Seat 2: TraderYao (small blind) folded on the Flop
Seat 3: NastyMcNast (big blind) folded before Flop
Seat 4: fwani folded before Flop (didn't bet)
Seat 5: agurio folded before Flop (didn't bet)
Seat 6: Loholov folded before Flop (didn't bet)
Seat 7: Anafim collected ($1.19)
Seat 8: cr0lox folded before Flop (didn't bet)
Seat 9: Nerkit folded before Flop (didn't bet)



PokerStars Zoom Hand #84298848922:  Hold'em No Limit ($0.10/$0.25) - 2012/08/05 13:39:27 JST [2012/08/05 0:39:27 ET]
Table 'Whirlpool' 9-max Seat #1 is the button
Seat 1: deadmoneykid ($35.04 in chips) 
Seat 2: 4ydo yogurt ($7.13 in chips) 
Seat 3: kamikkaze ($54.10 in chips) 
Seat 4: wtu1986 ($27.48 in chips) 
Seat 5: Alvinpe85 ($25 in chips) 
Seat 6: BlOnDhOlIc ($27.82 in chips) 
Seat 7: jethaz ($49.48 in chips) 
Seat 8: chiyuki ($53.09 in chips) 
Seat 9: Lasutchik ($12.15 in chips) 
4ydo yogurt: posts small blind $0.10
kamikkaze: posts big blind $0.25
*** HOLE CARDS ***
Dealt to chiyuki [Ts Kd]
wtu1986: folds 
Alvinpe85: folds 
BlOnDhOlIc: folds 
jethaz: raises $0.50 to $0.75
chiyuki: folds 
Lasutchik: folds 
deadmoneykid: folds 
4ydo yogurt: calls $0.65
kamikkaze: folds 
*** FLOP *** [7h Kc Jd]
4ydo yogurt: bets $0.83
jethaz: folds 
Uncalled bet ($0.83) returned to 4ydo yogurt
4ydo yogurt collected $1.67 from pot
4ydo yogurt: doesn't show hand 
*** SUMMARY ***
Total pot $1.75 | Rake $0.08 
Board [7h Kc Jd]
Seat 1: deadmoneykid (button) folded before Flop (didn't bet)
Seat 2: 4ydo yogurt (small blind) collected ($1.67)
Seat 3: kamikkaze (big blind) folded before Flop
Seat 4: wtu1986 folded before Flop (didn't bet)
Seat 5: Alvinpe85 folded before Flop (didn't bet)
Seat 6: BlOnDhOlIc folded before Flop (didn't bet)
Seat 7: jethaz folded on the Flop
Seat 8: chiyuki folded before Flop (didn't bet)
Seat 9: Lasutchik folded before Flop (didn't bet)



PokerStars Zoom Hand #84298851749:  Hold'em No Limit ($0.10/$0.25) - 2012/08/05 13:39:38 JST [2012/08/05 0:39:38 ET]
Table 'Whirlpool' 9-max Seat #1 is the button
Seat 1: Dejacob ($36.10 in chips) 
Seat 2: chiyuki ($53.09 in chips) 
Seat 3: Nerkit ($14.34 in chips) 
Seat 4: BlOnDhOlIc ($27.82 in chips) 
Seat 5: kamikkaze ($53.85 in chips) 
Seat 6: BlackZafiro ($28.71 in chips) 
Seat 7: wildy29 ($16.99 in chips) 
Seat 8: kkbruins0408 ($10.93 in chips) 
Seat 9: carlosrbr ($11.32 in chips) 
chiyuki: posts small blind $0.10
Nerkit: posts big blind $0.25
*** HOLE CARDS ***
Dealt to chiyuki [As Js]
BlOnDhOlIc: raises $0.37 to $0.62
kamikkaze: folds 
BlackZafiro: folds 
wildy29: folds 
kkbruins0408: folds 
carlosrbr: folds 
Dejacob: folds 
chiyuki: calls $0.52
Nerkit: folds 
*** FLOP *** [3h 2h 8c]
chiyuki: checks 
BlOnDhOlIc: checks 
*** TURN *** [3h 2h 8c] [Jh]
chiyuki: bets $0.75
BlOnDhOlIc: calls $0.75
*** RIVER *** [3h 2h 8c Jh] [2d]
chiyuki: bets $2
BlOnDhOlIc: folds 
Uncalled bet ($2) returned to chiyuki
chiyuki collected $2.86 from pot
chiyuki: doesn't show hand 
*** SUMMARY ***
Total pot $2.99 | Rake $0.13 
Board [3h 2h 8c Jh 2d]
Seat 1: Dejacob (button) folded before Flop (didn't bet)
Seat 2: chiyuki (small blind) collected ($2.86)
Seat 3: Nerkit (big blind) folded before Flop
Seat 4: BlOnDhOlIc folded on the River
Seat 5: kamikkaze folded before Flop (didn't bet)
Seat 6: BlackZafiro folded before Flop (didn't bet)
Seat 7: wildy29 folded before Flop (didn't bet)
Seat 8: kkbruins0408 folded before Flop (didn't bet)
Seat 9: carlosrbr folded before Flop (didn't bet)



PokerStars Zoom Hand #84298862485:  Hold'em No Limit ($0.10/$0.25) - 2012/08/05 13:40:21 JST [2012/08/05 0:40:21 ET]
Table 'Whirlpool' 9-max Seat #1 is the button
Seat 1: NastyMcNast ($36.15 in chips) 
Seat 2: BlOnDhOlIc ($26.45 in chips) 
Seat 3: Lasutchik ($29.96 in chips) 
Seat 4: seula i ($52.24 in chips) 
Seat 5: TraderYao ($27.47 in chips) 
Seat 6: chiyuki ($54.58 in chips) 
Seat 7: fwani ($25.35 in chips) 
Seat 8: Tom1999 ($5.70 in chips) 
Seat 9: Alvinpe85 ($25 in chips) 
BlOnDhOlIc: posts small blind $0.10
Lasutchik: posts big blind $0.25
*** HOLE CARDS ***
Dealt to chiyuki [7s 3c]
seula i: folds 
TraderYao: folds 
chiyuki: folds 
fwani: folds 
Tom1999: folds 
Alvinpe85: folds 
NastyMcNast: folds 
BlOnDhOlIc: folds 
Uncalled bet ($0.15) returned to Lasutchik
Lasutchik collected $0.20 from pot
Lasutchik: doesn't show hand 
*** SUMMARY ***
Total pot $0.20 | Rake $0 
Seat 1: NastyMcNast (button) folded before Flop (didn't bet)
Seat 2: BlOnDhOlIc (small blind) folded before Flop
Seat 3: Lasutchik (big blind) collected ($0.20)
Seat 4: seula i folded before Flop (didn't bet)
Seat 5: TraderYao folded before Flop (didn't bet)
Seat 6: chiyuki folded before Flop (didn't bet)
Seat 7: fwani folded before Flop (didn't bet)
Seat 8: Tom1999 folded before Flop (didn't bet)
Seat 9: Alvinpe85 folded before Flop (didn't bet)



PokerStars Zoom Hand #84298861467:  Hold'em No Limit ($0.10/$0.25) - 2012/08/05 13:40:17 JST [2012/08/05 0:40:17 ET]
Table 'Whirlpool' 9-max Seat #1 is the button
Seat 1: PetitAlejo ($25.99 in chips) 
Seat 2: munky3 ($41.89 in chips) 
Seat 3: Landybob ($37.07 in chips) 
Seat 4: chiyuki ($54.58 in chips) 
Seat 5: isti2 ($14.85 in chips) 
Seat 6: Dejacob ($36 in chips) 
Seat 7: cR!Ma*aRm ($32.42 in chips) 
Seat 8: BlOnDhOlIc ($26.45 in chips) 
Seat 9: cr0lox ($25.54 in chips) 
munky3: posts small blind $0.10
Landybob: posts big blind $0.25
*** HOLE CARDS ***
Dealt to chiyuki [Td Kc]
chiyuki: folds 
isti2: folds 
Dejacob: folds 
cR!Ma*aRm: folds 
BlOnDhOlIc: folds 
cr0lox: folds 
PetitAlejo: raises $0.50 to $0.75
munky3: folds 
Landybob: folds 
Uncalled bet ($0.50) returned to PetitAlejo
PetitAlejo collected $0.60 from pot
PetitAlejo: doesn't show hand 
*** SUMMARY ***
Total pot $0.60 | Rake $0 
Seat 1: PetitAlejo (button) collected ($0.60)
Seat 2: munky3 (small blind) folded before Flop
Seat 3: Landybob (big blind) folded before Flop
Seat 4: chiyuki folded before Flop (didn't bet)
Seat 5: isti2 folded before Flop (didn't bet)
Seat 6: Dejacob folded before Flop (didn't bet)
Seat 7: cR!Ma*aRm folded before Flop (didn't bet)
Seat 8: BlOnDhOlIc folded before Flop (didn't bet)
Seat 9: cr0lox folded before Flop (didn't bet)



PokerStars Zoom Hand #84298859738:  Hold'em No Limit ($0.10/$0.25) - 2012/08/05 13:40:10 JST [2012/08/05 0:40:10 ET]
Table 'Whirlpool' 9-max Seat #1 is the button
Seat 1: Suhoff76 ($25 in chips) 
Seat 2: cR!Ma*aRm ($32.52 in chips) 
Seat 3: BlackZafiro ($25 in chips) 
Seat 4: Dejacob ($36 in chips) 
Seat 5: TraderYao ($27.47 in chips) 
Seat 6: timburonps ($33.42 in chips) 
Seat 7: kkbruins0408 ($10.93 in chips) 
Seat 8: KeLevro0 ($12.20 in chips) 
Seat 9: chiyuki ($54.58 in chips) 
cR!Ma*aRm: posts small blind $0.10
BlackZafiro: posts big blind $0.25
*** HOLE CARDS ***
Dealt to chiyuki [7h Qd]
Dejacob: folds 
TraderYao: folds 
timburonps: folds 
kkbruins0408: folds 
KeLevro0: folds 
chiyuki: folds 
Suhoff76: folds 
cR!Ma*aRm: folds 
Uncalled bet ($0.15) returned to BlackZafiro
BlackZafiro collected $0.20 from pot
BlackZafiro: doesn't show hand 
*** SUMMARY ***
Total pot $0.20 | Rake $0 
Seat 1: Suhoff76 (button) folded before Flop (didn't bet)
Seat 2: cR!Ma*aRm (small blind) folded before Flop
Seat 3: BlackZafiro (big blind) collected ($0.20)
Seat 4: Dejacob folded before Flop (didn't bet)
Seat 5: TraderYao folded before Flop (didn't bet)
Seat 6: timburonps folded before Flop (didn't bet)
Seat 7: kkbruins0408 folded before Flop (didn't bet)
Seat 8: KeLevro0 folded before Flop (didn't bet)
Seat 9: chiyuki folded before Flop (didn't bet)



PokerStars Zoom Hand #84298864124:  Hold'em No Limit ($0.10/$0.25) - 2012/08/05 13:40:27 JST [2012/08/05 0:40:27 ET]
Table 'Whirlpool' 9-max Seat #1 is the button
Seat 1: cR!Ma*aRm ($32.42 in chips) 
Seat 2: ShockLaMuc ($44.27 in chips) 
Seat 3: solawind ($24.55 in chips) 
Seat 4: Anafim ($15.34 in chips) 
Seat 5: chiyuki ($54.58 in chips) 
Seat 6: fwani ($25.75 in chips) 
Seat 7: KAKamiro ($12.50 in chips) 
Seat 8: TraderYao ($27.47 in chips) 
Seat 9: seula i ($52.24 in chips) 
ShockLaMuc: posts small blind $0.10
solawind: posts big blind $0.25
*** HOLE CARDS ***
Dealt to chiyuki [9c 8c]
Anafim: folds 
chiyuki: folds 
fwani: folds 
KAKamiro: calls $0.25
TraderYao: folds 
seula i: folds 
cR!Ma*aRm: raises $0.50 to $0.75
ShockLaMuc: folds 
solawind: folds 
KAKamiro: calls $0.50
*** FLOP *** [2c Ad Td]
KAKamiro: checks 
cR!Ma*aRm: bets $0.75
KAKamiro: folds 
Uncalled bet ($0.75) returned to cR!Ma*aRm
cR!Ma*aRm collected $1.77 from pot
cR!Ma*aRm: doesn't show hand 
*** SUMMARY ***
Total pot $1.85 | Rake $0.08 
Board [2c Ad Td]
Seat 1: cR!Ma*aRm (button) collected ($1.77)
Seat 2: ShockLaMuc (small blind) folded before Flop
Seat 3: solawind (big blind) folded before Flop
Seat 4: Anafim folded before Flop (didn't bet)
Seat 5: chiyuki folded before Flop (didn't bet)
Seat 6: fwani folded before Flop (didn't bet)
Seat 7: KAKamiro folded on the Flop
Seat 8: TraderYao folded before Flop (didn't bet)
Seat 9: seula i folded before Flop (didn't bet)



PokerStars Zoom Hand #84298865115:  Hold'em No Limit ($0.10/$0.25) - 2012/08/05 13:40:31 JST [2012/08/05 0:40:31 ET]
Table 'Whirlpool' 9-max Seat #1 is the button
Seat 1: hirozo ($25 in chips) 
Seat 2: NastyMcNast ($25 in chips) 
Seat 3: PetitAlejo ($37.04 in chips) 
Seat 4: TraderYao ($27.47 in chips) 
Seat 5: Dejacob ($36 in chips) 
Seat 6: Anafim ($15.34 in chips) 
Seat 7: timburonps ($33.42 in chips) 
Seat 8: chiyuki ($54.58 in chips) 
Seat 9: fwani ($25.25 in chips) 
NastyMcNast: posts small blind $0.10
PetitAlejo: posts big blind $0.25
*** HOLE CARDS ***
Dealt to chiyuki [3h 2h]
TraderYao: folds 
Dejacob: folds 
Anafim: folds 
timburonps: folds 
chiyuki: folds 
fwani: raises $0.35 to $0.60
hirozo: folds 
NastyMcNast: folds 
PetitAlejo: folds 
Uncalled bet ($0.35) returned to fwani
fwani collected $0.60 from pot
fwani: doesn't show hand 
*** SUMMARY ***
Total pot $0.60 | Rake $0 
Seat 1: hirozo (button) folded before Flop (didn't bet)
Seat 2: NastyMcNast (small blind) folded before Flop
Seat 3: PetitAlejo (big blind) folded before Flop
Seat 4: TraderYao folded before Flop (didn't bet)
Seat 5: Dejacob folded before Flop (didn't bet)
Seat 6: Anafim folded before Flop (didn't bet)
Seat 7: timburonps folded before Flop (didn't bet)
Seat 8: chiyuki folded before Flop (didn't bet)
Seat 9: fwani collected ($0.60)



PokerStars Zoom Hand #84298866609:  Hold'em No Limit ($0.10/$0.25) - 2012/08/05 13:40:37 JST [2012/08/05 0:40:37 ET]
Table 'Whirlpool' 9-max Seat #1 is the button
Seat 1: kamikkaze ($12.25 in chips) 
Seat 2: Nerkit ($13.27 in chips) 
Seat 3: chiyuki ($54.58 in chips) 
Seat 4: timburonps ($33.42 in chips) 
Seat 5: deadmoneykid ($35.04 in chips) 
Seat 6: Dejacob ($36 in chips) 
Seat 7: D@vidMed ($10.53 in chips) 
Seat 8: Suhoff76 ($25 in chips) 
Seat 9: BlOnDhOlIc ($65.82 in chips) 
Nerkit: posts small blind $0.10
chiyuki: posts big blind $0.25
*** HOLE CARDS ***
Dealt to chiyuki [Qd 5d]
timburonps: folds 
deadmoneykid: folds 
Dejacob: folds 
D@vidMed: raises $0.57 to $0.82
Suhoff76: folds 
BlOnDhOlIc: folds 
kamikkaze: calls $0.82
Nerkit: folds 
chiyuki: calls $0.57
*** FLOP *** [2d 7d Js]
chiyuki: checks 
D@vidMed: bets $1.58
kamikkaze: raises $3.64 to $5.22
chiyuki: folds 
D@vidMed: folds 
Uncalled bet ($3.64) returned to kamikkaze
kamikkaze collected $5.46 from pot
kamikkaze: doesn't show hand 
*** SUMMARY ***
Total pot $5.72 | Rake $0.26 
Board [2d 7d Js]
Seat 1: kamikkaze (button) collected ($5.46)
Seat 2: Nerkit (small blind) folded before Flop
Seat 3: chiyuki (big blind) folded on the Flop
Seat 4: timburonps folded before Flop (didn't bet)
Seat 5: deadmoneykid folded before Flop (didn't bet)
Seat 6: Dejacob folded before Flop (didn't bet)
Seat 7: D@vidMed folded on the Flop
Seat 8: Suhoff76 folded before Flop (didn't bet)
Seat 9: BlOnDhOlIc folded before Flop (didn't bet)



PokerStars Zoom Hand #84298879926:  Hold'em No Limit ($0.10/$0.25) - 2012/08/05 13:41:30 JST [2012/08/05 0:41:30 ET]
Table 'Whirlpool' 9-max Seat #1 is the button
Seat 1: chiyuki ($53.76 in chips) 
Seat 2: Alvinpe85 ($48.75 in chips) 
Seat 3: PetitAlejo ($26.34 in chips) 
Seat 4: Dejacob ($25 in chips) 
Seat 5: kkbruins0408 ($11.62 in chips) 
Seat 6: a_tasmanian ($105.29 in chips) 
Seat 7: Suhoff76 ($36.99 in chips) 
Seat 8: gunbowler ($140.35 in chips) 
Seat 9: petersmiths ($44.33 in chips) 
Alvinpe85: posts small blind $0.10
PetitAlejo: posts big blind $0.25
*** HOLE CARDS ***
Dealt to chiyuki [6d Ad]
Dejacob: folds 
kkbruins0408: folds 
a_tasmanian: folds 
Suhoff76: folds 
gunbowler: folds 
petersmiths: folds 
chiyuki: raises $0.50 to $0.75
Alvinpe85: raises $1.50 to $2.25
PetitAlejo: folds 
chiyuki: folds 
Uncalled bet ($1.50) returned to Alvinpe85
Alvinpe85 collected $1.75 from pot
Alvinpe85: doesn't show hand 
*** SUMMARY ***
Total pot $1.75 | Rake $0 
Seat 1: chiyuki (button) folded before Flop
Seat 2: Alvinpe85 (small blind) collected ($1.75)
Seat 3: PetitAlejo (big blind) folded before Flop
Seat 4: Dejacob folded before Flop (didn't bet)
Seat 5: kkbruins0408 folded before Flop (didn't bet)
Seat 6: a_tasmanian folded before Flop (didn't bet)
Seat 7: Suhoff76 folded before Flop (didn't bet)
Seat 8: gunbowler folded before Flop (didn't bet)
Seat 9: petersmiths folded before Flop (didn't bet)



PokerStars Zoom Hand #84298889997:  Hold'em No Limit ($0.10/$0.25) - 2012/08/05 13:42:09 JST [2012/08/05 0:42:09 ET]
Table 'Whirlpool' 9-max Seat #1 is the button
Seat 1: fwani ($25 in chips) 
Seat 2: jtedecaliss ($159.41 in chips) 
Seat 3: jethaz ($73.04 in chips) 
Seat 4: cR!Ma*aRm ($30.04 in chips) 
Seat 5: BlackZafiro ($25 in chips) 
Seat 6: BlOnDhOlIc ($35.48 in chips) 
Seat 7: chiyuki ($53.01 in chips) 
Seat 8: Jippyflip ($19.76 in chips) 
Seat 9: timburonps ($28.65 in chips) 
jtedecaliss: posts small blind $0.10
jethaz: posts big blind $0.25
*** HOLE CARDS ***
Dealt to chiyuki [4h Jh]
cR!Ma*aRm: folds 
BlackZafiro: folds 
BlOnDhOlIc: folds 
chiyuki: folds 
Jippyflip: folds 
timburonps: folds 
fwani: folds 
jtedecaliss: folds 
Uncalled bet ($0.15) returned to jethaz
jethaz collected $0.20 from pot
jethaz: doesn't show hand 
*** SUMMARY ***
Total pot $0.20 | Rake $0 
Seat 1: fwani (button) folded before Flop (didn't bet)
Seat 2: jtedecaliss (small blind) folded before Flop
Seat 3: jethaz (big blind) collected ($0.20)
Seat 4: cR!Ma*aRm folded before Flop (didn't bet)
Seat 5: BlackZafiro folded before Flop (didn't bet)
Seat 6: BlOnDhOlIc folded before Flop (didn't bet)
Seat 7: chiyuki folded before Flop (didn't bet)
Seat 8: Jippyflip folded before Flop (didn't bet)
Seat 9: timburonps folded before Flop (didn't bet)



PokerStars Zoom Hand #84298888967:  Hold'em No Limit ($0.10/$0.25) - 2012/08/05 13:42:04 JST [2012/08/05 0:42:04 ET]
Table 'Whirlpool' 9-max Seat #1 is the button
Seat 1: kkbruins0408 ($11.62 in chips) 
Seat 2: Ellen1947 ($30.44 in chips) 
Seat 3: a_tasmanian ($105.29 in chips) 
Seat 4: chiyuki ($53.01 in chips) 
Seat 5: Dejacob ($43.55 in chips) 
Seat 6: BlackZafiro ($25 in chips) 
Seat 7: hirozo ($25 in chips) 
Seat 8: BlOnDhOlIc ($35.48 in chips) 
Seat 9: jtedecaliss ($159.41 in chips) 
Ellen1947: posts small blind $0.10
a_tasmanian: posts big blind $0.25
*** HOLE CARDS ***
Dealt to chiyuki [Qd 5c]
chiyuki: folds 
Dejacob: folds 
BlackZafiro: folds 
hirozo: raises $0.50 to $0.75
BlOnDhOlIc: folds 
jtedecaliss: folds 
kkbruins0408: folds 
Ellen1947: folds 
a_tasmanian: folds 
Uncalled bet ($0.50) returned to hirozo
hirozo collected $0.60 from pot
hirozo: doesn't show hand 
*** SUMMARY ***
Total pot $0.60 | Rake $0 
Seat 1: kkbruins0408 (button) folded before Flop (didn't bet)
Seat 2: Ellen1947 (small blind) folded before Flop
Seat 3: a_tasmanian (big blind) folded before Flop
Seat 4: chiyuki folded before Flop (didn't bet)
Seat 5: Dejacob folded before Flop (didn't bet)
Seat 6: BlackZafiro folded before Flop (didn't bet)
Seat 7: hirozo collected ($0.60)
Seat 8: BlOnDhOlIc folded before Flop (didn't bet)
Seat 9: jtedecaliss folded before Flop (didn't bet)



PokerStars Zoom Hand #84298891856:  Hold'em No Limit ($0.10/$0.25) - 2012/08/05 13:42:16 JST [2012/08/05 0:42:16 ET]
Table 'Whirlpool' 9-max Seat #1 is the button
Seat 1: D@vidMed ($12.25 in chips) 
Seat 2: chiyuki ($53.01 in chips) 
Seat 3: ygoegoe ($29.68 in chips) 
Seat 4: wtu1986 ($27.18 in chips) 
Seat 5: stankfist420 ($24.94 in chips) 
Seat 6: Landybob ($34.97 in chips) 
Seat 7: Ellen1947 ($30.34 in chips) 
Seat 8: BlOnDhOlIc ($25.35 in chips) 
Seat 9: munky3 ($45.60 in chips) 
chiyuki: posts small blind $0.10
ygoegoe: posts big blind $0.25
*** HOLE CARDS ***
Dealt to chiyuki [As Ad]
wtu1986: folds 
stankfist420: folds 
Landybob: folds 
Ellen1947: folds 
BlOnDhOlIc: folds 
munky3: folds 
D@vidMed: folds 
chiyuki: raises $0.50 to $0.75
ygoegoe: calls $0.50
*** FLOP *** [Tc 5c Qd]
chiyuki: bets $1.43
ygoegoe: folds 
Uncalled bet ($1.43) returned to chiyuki
chiyuki collected $1.43 from pot
chiyuki: doesn't show hand 
*** SUMMARY ***
Total pot $1.50 | Rake $0.07 
Board [Tc 5c Qd]
Seat 1: D@vidMed (button) folded before Flop (didn't bet)
Seat 2: chiyuki (small blind) collected ($1.43)
Seat 3: ygoegoe (big blind) folded on the Flop
Seat 4: wtu1986 folded before Flop (didn't bet)
Seat 5: stankfist420 folded before Flop (didn't bet)
Seat 6: Landybob folded before Flop (didn't bet)
Seat 7: Ellen1947 folded before Flop (didn't bet)
Seat 8: BlOnDhOlIc folded before Flop (didn't bet)
Seat 9: munky3 folded before Flop (didn't bet)



PokerStars Zoom Hand #84298891074:  Hold'em No Limit ($0.10/$0.25) - 2012/08/05 13:42:13 JST [2012/08/05 0:42:13 ET]
Table 'Whirlpool' 9-max Seat #1 is the button
Seat 1: Dejacob ($25.35 in chips) 
Seat 2: BlOnDhOlIc ($35.48 in chips) 
Seat 3: kkbruins0408 ($11.62 in chips) 
Seat 4: chiyuki ($53.01 in chips) 
Seat 5: Jippyflip ($19.76 in chips) 
Seat 6: ygoegoe ($26.47 in chips) 
Seat 7: PetitAlejo ($37.04 in chips) 
Seat 8: wtu1986 ($26.74 in chips) 
Seat 9: cR!Ma*aRm ($30.04 in chips) 
BlOnDhOlIc: posts small blind $0.10
kkbruins0408: posts big blind $0.25
*** HOLE CARDS ***
Dealt to chiyuki [Jc 9c]
chiyuki: folds 
Jippyflip: folds 
ygoegoe: folds 
PetitAlejo: folds 
wtu1986: folds 
cR!Ma*aRm: folds 
Dejacob: folds 
BlOnDhOlIc: raises $0.25 to $0.50
kkbruins0408: calls $0.25
*** FLOP *** [3c Td Tc]
BlOnDhOlIc: checks 
kkbruins0408: bets $2
BlOnDhOlIc: calls $2
*** TURN *** [3c Td Tc] [3h]
BlOnDhOlIc: checks 
kkbruins0408: bets $3
BlOnDhOlIc: calls $3
*** RIVER *** [3c Td Tc 3h] [6c]
BlOnDhOlIc: checks 
kkbruins0408: bets $6.12 and is all-in
BlOnDhOlIc: calls $6.12
*** SHOW DOWN ***
kkbruins0408: shows [4d Ac] (two pair, Tens and Threes)
BlOnDhOlIc: shows [Jh Ts] (a full house, Tens full of Threes)
BlOnDhOlIc collected $22.19 from pot
*** SUMMARY ***
Total pot $23.24 | Rake $1.05 
Board [3c Td Tc 3h 6c]
Seat 1: Dejacob (button) folded before Flop (didn't bet)
Seat 2: BlOnDhOlIc (small blind) showed [Jh Ts] and won ($22.19) with a full house, Tens full of Threes
Seat 3: kkbruins0408 (big blind) showed [4d Ac] and lost with two pair, Tens and Threes
Seat 4: chiyuki folded before Flop (didn't bet)
Seat 5: Jippyflip folded before Flop (didn't bet)
Seat 6: ygoegoe folded before Flop (didn't bet)
Seat 7: PetitAlejo folded before Flop (didn't bet)
Seat 8: wtu1986 folded before Flop (didn't bet)
Seat 9: cR!Ma*aRm folded before Flop (didn't bet)



PokerStars Zoom Hand #84298903086:  Hold'em No Limit ($0.10/$0.25) - 2012/08/05 13:42:59 JST [2012/08/05 0:42:59 ET]
Table 'Whirlpool' 9-max Seat #1 is the button
Seat 1: jtedecaliss ($158.96 in chips) 
Seat 2: Tuan0109 ($14.75 in chips) 
Seat 3: kamikkaze ($15.56 in chips) 
Seat 4: Loholov ($16.02 in chips) 
Seat 5: gunbowler ($151.01 in chips) 
Seat 6: Suhoff76 ($28.84 in chips) 
Seat 7: NastyMcNast ($25.35 in chips) 
Seat 8: eduvazsilva ($10.35 in chips) 
Seat 9: chiyuki ($53.69 in chips) 
Tuan0109: posts small blind $0.10
kamikkaze: posts big blind $0.25
*** HOLE CARDS ***
Dealt to chiyuki [Kc Js]
Loholov: folds 
gunbowler: raises $0.35 to $0.60
Suhoff76: folds 
NastyMcNast: folds 
eduvazsilva: folds 
chiyuki: folds 
jtedecaliss: folds 
Tuan0109: folds 
kamikkaze: folds 
Uncalled bet ($0.35) returned to gunbowler
gunbowler collected $0.60 from pot
gunbowler: doesn't show hand 
*** SUMMARY ***
Total pot $0.60 | Rake $0 
Seat 1: jtedecaliss (button) folded before Flop (didn't bet)
Seat 2: Tuan0109 (small blind) folded before Flop
Seat 3: kamikkaze (big blind) folded before Flop
Seat 4: Loholov folded before Flop (didn't bet)
Seat 5: gunbowler collected ($0.60)
Seat 6: Suhoff76 folded before Flop (didn't bet)
Seat 7: NastyMcNast folded before Flop (didn't bet)
Seat 8: eduvazsilva folded before Flop (didn't bet)
Seat 9: chiyuki folded before Flop (didn't bet)



PokerStars Zoom Hand #84298907769:  Hold'em No Limit ($0.10/$0.25) - 2012/08/05 13:43:17 JST [2012/08/05 0:43:17 ET]
Table 'Whirlpool' 9-max Seat #1 is the button
Seat 1: KeLevro0 ($13.16 in chips) 
Seat 2: wtu1986 ($26.49 in chips) 
Seat 3: Roglus ($69.39 in chips) 
Seat 4: solawind ($19.58 in chips) 
Seat 5: TErr18 ($13.46 in chips) 
Seat 6: seula i ($26.14 in chips) 
Seat 7: lovinlife5 ($21.65 in chips) 
Seat 8: chiyuki ($53.69 in chips) 
Seat 9: Nerkit ($13.17 in chips) 
wtu1986: posts small blind $0.10
Roglus: posts big blind $0.25
*** HOLE CARDS ***
Dealt to chiyuki [6s Kh]
solawind: folds 
TErr18: raises $0.50 to $0.75
seula i: folds 
lovinlife5: folds 
chiyuki: folds 
Nerkit: folds 
KeLevro0: folds 
wtu1986: folds 
Roglus: folds 
Uncalled bet ($0.50) returned to TErr18
TErr18 collected $0.60 from pot
TErr18: doesn't show hand 
*** SUMMARY ***
Total pot $0.60 | Rake $0 
Seat 1: KeLevro0 (button) folded before Flop (didn't bet)
Seat 2: wtu1986 (small blind) folded before Flop
Seat 3: Roglus (big blind) folded before Flop
Seat 4: solawind folded before Flop (didn't bet)
Seat 5: TErr18 collected ($0.60)
Seat 6: seula i folded before Flop (didn't bet)
Seat 7: lovinlife5 folded before Flop (didn't bet)
Seat 8: chiyuki folded before Flop (didn't bet)
Seat 9: Nerkit folded before Flop (didn't bet)



PokerStars Zoom Hand #84298909618:  Hold'em No Limit ($0.10/$0.25) - 2012/08/05 13:43:25 JST [2012/08/05 0:43:25 ET]
Table 'Whirlpool' 9-max Seat #1 is the button
Seat 1: fwani ($26.43 in chips) 
Seat 2: KeLevro0 ($13.16 in chips) 
Seat 3: NastyMcNast ($64.14 in chips) 
Seat 4: ShockLaMuc ($28.25 in chips) 
Seat 5: lovinlife5 ($21.65 in chips) 
Seat 6: chiyuki ($53.69 in chips) 
Seat 7: deadmoneykid ($45.04 in chips) 
Seat 8: PetitAlejo ($36.69 in chips) 
Seat 9: agurio ($25.60 in chips) 
KeLevro0: posts small blind $0.10
NastyMcNast: posts big blind $0.25
*** HOLE CARDS ***
Dealt to chiyuki [Qs 2c]
ShockLaMuc: raises $0.50 to $0.75
lovinlife5: folds 
chiyuki: folds 
deadmoneykid: calls $0.75
PetitAlejo: folds 
agurio: calls $0.75
fwani: calls $0.75
KeLevro0: folds 
NastyMcNast: folds 
*** FLOP *** [4d 5s Td]
ShockLaMuc: checks 
deadmoneykid: checks 
agurio: bets $2.50
fwani: raises $8.20 to $10.70
ShockLaMuc: folds 
deadmoneykid: folds 
agurio: folds 
Uncalled bet ($8.20) returned to fwani
fwani collected $7.97 from pot
fwani: doesn't show hand 
*** SUMMARY ***
Total pot $8.35 | Rake $0.38 
Board [4d 5s Td]
Seat 1: fwani (button) collected ($7.97)
Seat 2: KeLevro0 (small blind) folded before Flop
Seat 3: NastyMcNast (big blind) folded before Flop
Seat 4: ShockLaMuc folded on the Flop
Seat 5: lovinlife5 folded before Flop (didn't bet)
Seat 6: chiyuki folded before Flop (didn't bet)
Seat 7: deadmoneykid folded on the Flop
Seat 8: PetitAlejo folded before Flop (didn't bet)
Seat 9: agurio folded on the Flop



PokerStars Zoom Hand #84298911152:  Hold'em No Limit ($0.10/$0.25) - 2012/08/05 13:43:31 JST [2012/08/05 0:43:31 ET]
Table 'Whirlpool' 9-max Seat #1 is the button
Seat 1: seula i ($35.64 in chips) 
Seat 2: hirozo ($28.35 in chips) 
Seat 3: chiyuki ($53.69 in chips) 
Seat 4: Loholov ($19.18 in chips) 
Seat 5: jethaz ($49.70 in chips) 
Seat 6: Ellen1947 ($25.64 in chips) 
Seat 7: TraderYao ($26.27 in chips) 
Seat 8: Dejacob ($30.69 in chips) 
Seat 9: Tuan0109 ($15.57 in chips) 
hirozo: posts small blind $0.10
chiyuki: posts big blind $0.25
*** HOLE CARDS ***
Dealt to chiyuki [Qh Ah]
Loholov: folds 
jethaz: folds 
Ellen1947: calls $0.25
TraderYao: folds 
Dejacob: folds 
Tuan0109: folds 
seula i: raises $1 to $1.25
hirozo: folds 
chiyuki: calls $1
Ellen1947: calls $1
*** FLOP *** [Kc 9d 2c]
chiyuki: checks 
Ellen1947: checks 
seula i: bets $2.25
chiyuki: folds 
Ellen1947: raises $4.09 to $6.34
seula i: folds 
Uncalled bet ($4.09) returned to Ellen1947
Ellen1947 collected $7.97 from pot
Ellen1947: doesn't show hand 
*** SUMMARY ***
Total pot $8.35 | Rake $0.38 
Board [Kc 9d 2c]
Seat 1: seula i (button) folded on the Flop
Seat 2: hirozo (small blind) folded before Flop
Seat 3: chiyuki (big blind) folded on the Flop
Seat 4: Loholov folded before Flop (didn't bet)
Seat 5: jethaz folded before Flop (didn't bet)
Seat 6: Ellen1947 collected ($7.97)
Seat 7: TraderYao folded before Flop (didn't bet)
Seat 8: Dejacob folded before Flop (didn't bet)
Seat 9: Tuan0109 folded before Flop (didn't bet)



PokerStars Zoom Hand #84298924889:  Hold'em No Limit ($0.10/$0.25) - 2012/08/05 13:44:24 JST [2012/08/05 0:44:24 ET]
Table 'Whirlpool' 9-max Seat #1 is the button
Seat 1: chiyuki ($52.44 in chips) 
Seat 2: hirozo ($25 in chips) 
Seat 3: TErr18 ($13.81 in chips) 
Seat 4: NastyMcNast ($63.79 in chips) 
Seat 5: Loholov ($15 in chips) 
Seat 6: slapshot2011 ($45.80 in chips) 
Seat 7: softdesign ($77.24 in chips) 
Seat 8: ygoegoe ($29.80 in chips) 
Seat 9: wtu1986 ($24.65 in chips) 
hirozo: posts small blind $0.10
TErr18: posts big blind $0.25
*** HOLE CARDS ***
Dealt to chiyuki [7d 5c]
NastyMcNast: folds 
Loholov: folds 
slapshot2011: calls $0.25
softdesign: folds 
ygoegoe: folds 
wtu1986: folds 
chiyuki: folds 
hirozo: folds 
TErr18: checks 
*** FLOP *** [8d 2d Ts]
TErr18: checks 
slapshot2011: bets $0.50
TErr18: folds 
Uncalled bet ($0.50) returned to slapshot2011
slapshot2011 collected $0.57 from pot
slapshot2011: doesn't show hand 
*** SUMMARY ***
Total pot $0.60 | Rake $0.03 
Board [8d 2d Ts]
Seat 1: chiyuki (button) folded before Flop (didn't bet)
Seat 2: hirozo (small blind) folded before Flop
Seat 3: TErr18 (big blind) folded on the Flop
Seat 4: NastyMcNast folded before Flop (didn't bet)
Seat 5: Loholov folded before Flop (didn't bet)
Seat 6: slapshot2011 collected ($0.57)
Seat 7: softdesign folded before Flop (didn't bet)
Seat 8: ygoegoe folded before Flop (didn't bet)
Seat 9: wtu1986 folded before Flop (didn't bet)



PokerStars Zoom Hand #84298927003:  Hold'em No Limit ($0.10/$0.25) - 2012/08/05 13:44:33 JST [2012/08/05 0:44:33 ET]
Table 'Whirlpool' 9-max Seat #1 is the button
Seat 1: ll_LaMeR_ll ($48.61 in chips) 
Seat 2: jethaz ($51.30 in chips) 
Seat 3: petersmiths ($44.11 in chips) 
Seat 4: BlOnDhOlIc ($43.80 in chips) 
Seat 5: Dejacob ($34.36 in chips) 
Seat 6: timburonps ($25 in chips) 
Seat 7: chiyuki ($52.44 in chips) 
Seat 8: NastyMcNast ($29.60 in chips) 
Seat 9: PetitAlejo ($25.67 in chips) 
jethaz: posts small blind $0.10
petersmiths: posts big blind $0.25
*** HOLE CARDS ***
Dealt to chiyuki [Qc Qh]
BlOnDhOlIc: folds 
Dejacob: folds 
timburonps: folds 
chiyuki: raises $0.50 to $0.75
NastyMcNast: folds 
PetitAlejo: folds 
ll_LaMeR_ll: folds 
jethaz: folds 
petersmiths: calls $0.50
*** FLOP *** [Kc 8h 3s]
petersmiths: checks 
chiyuki: bets $1
petersmiths: calls $1
*** TURN *** [Kc 8h 3s] [8s]
petersmiths: checks 
chiyuki: checks 
*** RIVER *** [Kc 8h 3s 8s] [9h]
petersmiths: checks 
chiyuki: checks 
*** SHOW DOWN ***
petersmiths: shows [Ts Ks] (two pair, Kings and Eights)
chiyuki: mucks hand 
petersmiths collected $3.44 from pot
*** SUMMARY ***
Total pot $3.60 | Rake $0.16 
Board [Kc 8h 3s 8s 9h]
Seat 1: ll_LaMeR_ll (button) folded before Flop (didn't bet)
Seat 2: jethaz (small blind) folded before Flop
Seat 3: petersmiths (big blind) showed [Ts Ks] and won ($3.44) with two pair, Kings and Eights
Seat 4: BlOnDhOlIc folded before Flop (didn't bet)
Seat 5: Dejacob folded before Flop (didn't bet)
Seat 6: timburonps folded before Flop (didn't bet)
Seat 7: chiyuki mucked [Qc Qh]
Seat 8: NastyMcNast folded before Flop (didn't bet)
Seat 9: PetitAlejo folded before Flop (didn't bet)



PokerStars Zoom Hand #84298937171:  Hold'em No Limit ($0.10/$0.25) - 2012/08/05 13:45:12 JST [2012/08/05 0:45:12 ET]
Table 'Whirlpool' 9-max Seat #1 is the button
Seat 1: cR!Ma*aRm ($42.56 in chips) 
Seat 2: petersmiths ($45.80 in chips) 
Seat 3: KeLevro0 ($12.50 in chips) 
Seat 4: kamikkaze ($14.39 in chips) 
Seat 5: chiyuki ($50.69 in chips) 
Seat 6: Rudolf ($25.35 in chips) 
Seat 7: ShockLaMuc ($23.55 in chips) 
Seat 8: Suhoff76 ($34.88 in chips) 
Seat 9: TErr18 ($13.46 in chips) 
petersmiths: posts small blind $0.10
KeLevro0: posts big blind $0.25
*** HOLE CARDS ***
Dealt to chiyuki [3d Ks]
kamikkaze: folds 
chiyuki: folds 
Rudolf: folds 
ShockLaMuc: folds 
Suhoff76: folds 
TErr18: folds 
cR!Ma*aRm: raises $0.50 to $0.75
petersmiths: calls $0.65
KeLevro0: raises $2.50 to $3.25
cR!Ma*aRm: calls $2.50
petersmiths: folds 
*** FLOP *** [7c 3s 9h]
KeLevro0: bets $3.50
cR!Ma*aRm: folds 
Uncalled bet ($3.50) returned to KeLevro0
KeLevro0 collected $6.92 from pot
KeLevro0: doesn't show hand 
*** SUMMARY ***
Total pot $7.25 | Rake $0.33 
Board [7c 3s 9h]
Seat 1: cR!Ma*aRm (button) folded on the Flop
Seat 2: petersmiths (small blind) folded before Flop
Seat 3: KeLevro0 (big blind) collected ($6.92)
Seat 4: kamikkaze folded before Flop (didn't bet)
Seat 5: chiyuki folded before Flop (didn't bet)
Seat 6: Rudolf folded before Flop (didn't bet)
Seat 7: ShockLaMuc folded before Flop (didn't bet)
Seat 8: Suhoff76 folded before Flop (didn't bet)
Seat 9: TErr18 folded before Flop (didn't bet)



PokerStars Zoom Hand #84298946793:  Hold'em No Limit ($0.10/$0.25) - 2012/08/05 13:45:50 JST [2012/08/05 0:45:50 ET]
Table 'Whirlpool' 9-max Seat #1 is the button
Seat 1: KeLevro0 ($10.53 in chips) 
Seat 2: BlackZafiro ($25 in chips) 
Seat 3: chiyuki ($50.59 in chips) 
Seat 4: carlosrbr ($15.63 in chips) 
Seat 5: ll_LaMeR_ll ($49.96 in chips) 
Seat 6: Lasutchik ($36.52 in chips) 
Seat 7: Tom1999 ($29.80 in chips) 
Seat 8: ChrisCDee ($25.73 in chips) 
Seat 9: Wilcox76607 ($19.50 in chips) 
BlackZafiro: posts small blind $0.10
chiyuki: posts big blind $0.25
*** HOLE CARDS ***
Dealt to chiyuki [Ts 9h]
carlosrbr: folds 
ll_LaMeR_ll: folds 
Lasutchik: folds 
Tom1999: folds 
ChrisCDee: folds 
Wilcox76607: folds 
KeLevro0: folds 
BlackZafiro: folds 
Uncalled bet ($0.15) returned to chiyuki
chiyuki collected $0.20 from pot
chiyuki: doesn't show hand 
*** SUMMARY ***
Total pot $0.20 | Rake $0 
Seat 1: KeLevro0 (button) folded before Flop (didn't bet)
Seat 2: BlackZafiro (small blind) folded before Flop
Seat 3: chiyuki (big blind) collected ($0.20)
Seat 4: carlosrbr folded before Flop (didn't bet)
Seat 5: ll_LaMeR_ll folded before Flop (didn't bet)
Seat 6: Lasutchik folded before Flop (didn't bet)
Seat 7: Tom1999 folded before Flop (didn't bet)
Seat 8: ChrisCDee folded before Flop (didn't bet)
Seat 9: Wilcox76607 folded before Flop (didn't bet)



PokerStars Zoom Hand #84298945044:  Hold'em No Limit ($0.10/$0.25) - 2012/08/05 13:45:43 JST [2012/08/05 0:45:43 ET]
Table 'Whirlpool' 9-max Seat #1 is the button
Seat 1: Dejacob ($38.45 in chips) 
Seat 2: simonzez ($35.09 in chips) 
Seat 3: PetitAlejo ($35.94 in chips) 
Seat 4: KeLevro0 ($13.41 in chips) 
Seat 5: silvno31 ($40.12 in chips) 
Seat 6: wtu1986 ($26.21 in chips) 
Seat 7: TraderYao ($25 in chips) 
Seat 8: chiyuki ($50.59 in chips) 
Seat 9: cR!Ma*aRm ($39.31 in chips) 
simonzez: posts small blind $0.10
PetitAlejo: posts big blind $0.25
*** HOLE CARDS ***
Dealt to chiyuki [6c 3s]
KeLevro0: folds 
silvno31: folds 
wtu1986: folds 
TraderYao: folds 
chiyuki: folds 
cR!Ma*aRm: folds 
Dejacob: folds 
simonzez: calls $0.15
PetitAlejo: checks 
*** FLOP *** [7c 3h Qc]
simonzez: bets $0.25
PetitAlejo: folds 
Uncalled bet ($0.25) returned to simonzez
simonzez collected $0.48 from pot
simonzez: doesn't show hand 
*** SUMMARY ***
Total pot $0.50 | Rake $0.02 
Board [7c 3h Qc]
Seat 1: Dejacob (button) folded before Flop (didn't bet)
Seat 2: simonzez (small blind) collected ($0.48)
Seat 3: PetitAlejo (big blind) folded on the Flop
Seat 4: KeLevro0 folded before Flop (didn't bet)
Seat 5: silvno31 folded before Flop (didn't bet)
Seat 6: wtu1986 folded before Flop (didn't bet)
Seat 7: TraderYao folded before Flop (didn't bet)
Seat 8: chiyuki folded before Flop (didn't bet)
Seat 9: cR!Ma*aRm folded before Flop (didn't bet)



PokerStars Zoom Hand #84298938490:  Hold'em No Limit ($0.10/$0.25) - 2012/08/05 13:45:17 JST [2012/08/05 0:45:17 ET]
Table 'Whirlpool' 9-max Seat #1 is the button
Seat 1: Nerkit ($12.69 in chips) 
Seat 2: Loholov ($18.93 in chips) 
Seat 3: goldstone ($39.78 in chips) 
Seat 4: BlackZafiro ($25 in chips) 
Seat 5: deadmoneykid ($44.19 in chips) 
Seat 6: chiyuki ($50.69 in chips) 
Seat 7: PetitAlejo ($25 in chips) 
Seat 8: wtu1986 ($26.21 in chips) 
Seat 9: Suhoff76 ($31.30 in chips) 
Loholov: posts small blind $0.10
goldstone: posts big blind $0.25
*** HOLE CARDS ***
Dealt to chiyuki [5s 9c]
BlackZafiro: folds 
deadmoneykid: folds 
chiyuki: folds 
PetitAlejo: folds 
wtu1986: folds 
Suhoff76: folds 
Nerkit: raises $0.50 to $0.75
Loholov: folds 
goldstone: calls $0.50
*** FLOP *** [8h 3c As]
goldstone: checks 
Nerkit: checks 
*** TURN *** [8h 3c As] [Ks]
goldstone: bets $1.05
Nerkit: folds 
Uncalled bet ($1.05) returned to goldstone
goldstone collected $1.53 from pot
goldstone: doesn't show hand 
*** SUMMARY ***
Total pot $1.60 | Rake $0.07 
Board [8h 3c As Ks]
Seat 1: Nerkit (button) folded on the Turn
Seat 2: Loholov (small blind) folded before Flop
Seat 3: goldstone (big blind) collected ($1.53)
Seat 4: BlackZafiro folded before Flop (didn't bet)
Seat 5: deadmoneykid folded before Flop (didn't bet)
Seat 6: chiyuki folded before Flop (didn't bet)
Seat 7: PetitAlejo folded before Flop (didn't bet)
Seat 8: wtu1986 folded before Flop (didn't bet)
Seat 9: Suhoff76 folded before Flop (didn't bet)



PokerStars Zoom Hand #84298941402:  Hold'em No Limit ($0.10/$0.25) - 2012/08/05 13:45:28 JST [2012/08/05 0:45:28 ET]
Table 'Whirlpool' 9-max Seat #1 is the button
Seat 1: cr0lox ($26.37 in chips) 
Seat 2: chiyuki ($50.69 in chips) 
Seat 3: leo2095 ($14.68 in chips) 
Seat 4: jeff0923 ($24.92 in chips) 
Seat 5: slapshot2011 ($46.12 in chips) 
Seat 6: Suhoff76 ($34.88 in chips) 
Seat 7: BlOnDhOlIc ($25 in chips) 
Seat 8: Dejacob ($38.45 in chips) 
Seat 9: Rsonal ($9.43 in chips) 
chiyuki: posts small blind $0.10
leo2095: posts big blind $0.25
*** HOLE CARDS ***
Dealt to chiyuki [7d Kc]
jeff0923: calls $0.25
slapshot2011: folds 
Suhoff76: folds 
BlOnDhOlIc: folds 
Dejacob: folds 
Rsonal: folds 
cr0lox: raises $0.75 to $1
chiyuki: folds 
leo2095: folds 
jeff0923: calls $0.75
*** FLOP *** [Jh Ah Th]
jeff0923: checks 
cr0lox: bets $1.12
jeff0923: raises $2.13 to $3.25
cr0lox: folds 
Uncalled bet ($2.13) returned to jeff0923
jeff0923 collected $4.38 from pot
jeff0923: doesn't show hand 
*** SUMMARY ***
Total pot $4.59 | Rake $0.21 
Board [Jh Ah Th]
Seat 1: cr0lox (button) folded on the Flop
Seat 2: chiyuki (small blind) folded before Flop
Seat 3: leo2095 (big blind) folded before Flop
Seat 4: jeff0923 collected ($4.38)
Seat 5: slapshot2011 folded before Flop (didn't bet)
Seat 6: Suhoff76 folded before Flop (didn't bet)
Seat 7: BlOnDhOlIc folded before Flop (didn't bet)
Seat 8: Dejacob folded before Flop (didn't bet)
Seat 9: Rsonal folded before Flop (didn't bet)



PokerStars Zoom Hand #84298953252:  Hold'em No Limit ($0.10/$0.25) - 2012/08/05 13:46:15 JST [2012/08/05 0:46:15 ET]
Table 'Whirlpool' 9-max Seat #1 is the button
Seat 1: chiyuki ($50.69 in chips) 
Seat 2: hirozo ($28.35 in chips) 
Seat 3: Lasutchik ($36.52 in chips) 
Seat 4: TraderYao ($27.37 in chips) 
Seat 5: BlOnDhOlIc ($25 in chips) 
Seat 6: KeLevro0 ($16.07 in chips) 
Seat 7: Nerkit ($13.57 in chips) 
Seat 8: NastyMcNast ($64.22 in chips) 
Seat 9: Dejacob ($28.59 in chips) 
hirozo: posts small blind $0.10
Lasutchik: posts big blind $0.25
*** HOLE CARDS ***
Dealt to chiyuki [2c 2d]
TraderYao: folds 
BlOnDhOlIc: raises $0.37 to $0.62
KeLevro0: folds 
Nerkit: folds 
NastyMcNast: folds 
Dejacob: folds 
chiyuki: folds 
hirozo: folds 
Lasutchik: folds 
Uncalled bet ($0.37) returned to BlOnDhOlIc
BlOnDhOlIc collected $0.60 from pot
BlOnDhOlIc: doesn't show hand 
*** SUMMARY ***
Total pot $0.60 | Rake $0 
Seat 1: chiyuki (button) folded before Flop (didn't bet)
Seat 2: hirozo (small blind) folded before Flop
Seat 3: Lasutchik (big blind) folded before Flop
Seat 4: TraderYao folded before Flop (didn't bet)
Seat 5: BlOnDhOlIc collected ($0.60)
Seat 6: KeLevro0 folded before Flop (didn't bet)
Seat 7: Nerkit folded before Flop (didn't bet)
Seat 8: NastyMcNast folded before Flop (didn't bet)
Seat 9: Dejacob folded before Flop (didn't bet)



PokerStars Zoom Hand #84298943492:  Hold'em No Limit ($0.10/$0.25) - 2012/08/05 13:45:36 JST [2012/08/05 0:45:36 ET]
Table 'Whirlpool' 9-max Seat #1 is the button
Seat 1: ygoegoe ($26.21 in chips) 
Seat 2: Suhoff76 ($34.88 in chips) 
Seat 3: hirozo ($28.87 in chips) 
Seat 4: Loholov ($34.26 in chips) 
Seat 5: seula i ($25.04 in chips) 
Seat 6: Th3Fog ($22.61 in chips) 
Seat 7: deadmoneykid ($44.19 in chips) 
Seat 8: jethaz ($67.02 in chips) 
Seat 9: chiyuki ($50.59 in chips) 
Suhoff76: posts small blind $0.10
hirozo: posts big blind $0.25
*** HOLE CARDS ***
Dealt to chiyuki [9s 2c]
Loholov: raises $0.75 to $1
seula i: folds 
Th3Fog: folds 
deadmoneykid: calls $1
jethaz: calls $1
chiyuki: folds 
ygoegoe: folds 
Suhoff76: folds 
hirozo: folds 
*** FLOP *** [Jh 8h 2h]
Loholov: checks 
deadmoneykid: checks 
jethaz: checks 
*** TURN *** [Jh 8h 2h] [8c]
Loholov: checks 
deadmoneykid: checks 
jethaz: checks 
*** RIVER *** [Jh 8h 2h 8c] [4c]
Loholov: checks 
deadmoneykid: checks 
jethaz: checks 
*** SHOW DOWN ***
Loholov: shows [Kd Kh] (two pair, Kings and Eights)
deadmoneykid: mucks hand 
jethaz: mucks hand 
Loholov collected $3.20 from pot
*** SUMMARY ***
Total pot $3.35 | Rake $0.15 
Board [Jh 8h 2h 8c 4c]
Seat 1: ygoegoe (button) folded before Flop (didn't bet)
Seat 2: Suhoff76 (small blind) folded before Flop
Seat 3: hirozo (big blind) folded before Flop
Seat 4: Loholov showed [Kd Kh] and won ($3.20) with two pair, Kings and Eights
Seat 5: seula i folded before Flop (didn't bet)
Seat 6: Th3Fog folded before Flop (didn't bet)
Seat 7: deadmoneykid mucked [As Qs]
Seat 8: jethaz mucked [Ad 2d]
Seat 9: chiyuki folded before Flop (didn't bet)



PokerStars Zoom Hand #84298949361:  Hold'em No Limit ($0.10/$0.25) - 2012/08/05 13:46:00 JST [2012/08/05 0:46:00 ET]
Table 'Whirlpool' 9-max Seat #1 is the button
Seat 1: TraderYao ($27.37 in chips) 
Seat 2: seula i ($31.89 in chips) 
Seat 3: Rudolf ($24.10 in chips) 
Seat 4: Lasutchik ($9.40 in chips) 
Seat 5: chiyuki ($50.69 in chips) 
Seat 6: BlackValaR ($6.58 in chips) 
Seat 7: Wilcox76607 ($19.50 in chips) 
Seat 8: PetitAlejo ($25.25 in chips) 
Seat 9: a_tasmanian ($84.89 in chips) 
seula i: posts small blind $0.10
Rudolf: posts big blind $0.25
*** HOLE CARDS ***
Dealt to chiyuki [9h 3s]
Lasutchik: folds 
chiyuki: folds 
BlackValaR: raises $0.50 to $0.75
Wilcox76607: folds 
PetitAlejo: folds 
a_tasmanian: calls $0.75
TraderYao: folds 
seula i: raises $1.75 to $2.50
Rudolf: folds 
BlackValaR: calls $1.75
a_tasmanian: calls $1.75
*** FLOP *** [4s Ac 3c]
seula i: bets $3.50
BlackValaR: calls $3.50
a_tasmanian: folds 
*** TURN *** [4s Ac 3c] [Ts]
seula i: bets $3
BlackValaR: calls $0.58 and is all-in
Uncalled bet ($2.42) returned to seula i
*** RIVER *** [4s Ac 3c Ts] [6d]
*** SHOW DOWN ***
seula i: shows [Qh Ad] (a pair of Aces)
BlackValaR: shows [Qc Qs] (a pair of Queens)
seula i collected $15.19 from pot
*** SUMMARY ***
Total pot $15.91 | Rake $0.72 
Board [4s Ac 3c Ts 6d]
Seat 1: TraderYao (button) folded before Flop (didn't bet)
Seat 2: seula i (small blind) showed [Qh Ad] and won ($15.19) with a pair of Aces
Seat 3: Rudolf (big blind) folded before Flop
Seat 4: Lasutchik folded before Flop (didn't bet)
Seat 5: chiyuki folded before Flop (didn't bet)
Seat 6: BlackValaR showed [Qc Qs] and lost with a pair of Queens
Seat 7: Wilcox76607 folded before Flop (didn't bet)
Seat 8: PetitAlejo folded before Flop (didn't bet)
Seat 9: a_tasmanian folded on the Flop



PokerStars Zoom Hand #84298950164:  Hold'em No Limit ($0.10/$0.25) - 2012/08/05 13:46:03 JST [2012/08/05 0:46:03 ET]
Table 'Whirlpool' 9-max Seat #1 is the button
Seat 1: Landybob ($35.10 in chips) 
Seat 2: Loholov ($24.70 in chips) 
Seat 3: DjJooni ($12 in chips) 
Seat 4: NastyMcNast ($31.73 in chips) 
Seat 5: fwani ($30.10 in chips) 
Seat 6: TamiKarpen13 ($15.96 in chips) 
Seat 7: chiyuki ($50.69 in chips) 
Seat 8: KeLevro0 ($16.07 in chips) 
Seat 9: wtu1986 ($26.11 in chips) 
Loholov: posts small blind $0.10
DjJooni: posts big blind $0.25
*** HOLE CARDS ***
Dealt to chiyuki [7d Tc]
NastyMcNast: folds 
fwani: folds 
TamiKarpen13: folds 
chiyuki: folds 
KeLevro0: folds 
wtu1986: raises $0.50 to $0.75
Landybob: folds 
Loholov: calls $0.65
DjJooni: folds 
*** FLOP *** [6h 7h 6s]
Loholov: checks 
wtu1986: bets $1.08
Loholov: calls $1.08
*** TURN *** [6h 7h 6s] [2s]
Loholov: checks 
wtu1986: checks 
*** RIVER *** [6h 7h 6s 2s] [As]
Loholov: bets $2.75
wtu1986: folds 
Uncalled bet ($2.75) returned to Loholov
Loholov collected $3.73 from pot
Loholov: doesn't show hand 
*** SUMMARY ***
Total pot $3.91 | Rake $0.18 
Board [6h 7h 6s 2s As]
Seat 1: Landybob (button) folded before Flop (didn't bet)
Seat 2: Loholov (small blind) collected ($3.73)
Seat 3: DjJooni (big blind) folded before Flop
Seat 4: NastyMcNast folded before Flop (didn't bet)
Seat 5: fwani folded before Flop (didn't bet)
Seat 6: TamiKarpen13 folded before Flop (didn't bet)
Seat 7: chiyuki folded before Flop (didn't bet)
Seat 8: KeLevro0 folded before Flop (didn't bet)
Seat 9: wtu1986 folded on the River



PokerStars Zoom Hand #84298960613:  Hold'em No Limit ($0.10/$0.25) - 2012/08/05 13:46:44 JST [2012/08/05 0:46:44 ET]
Table 'Whirlpool' 9-max Seat #1 is the button
Seat 1: Anafim ($21.71 in chips) 
Seat 2: Dejacob ($38.55 in chips) 
Seat 3: BlOnDhOlIc ($25.25 in chips) 
Seat 4: Landybob ($35 in chips) 
Seat 5: KAKamiro ($35.36 in chips) 
Seat 6: jethaz ($66.02 in chips) 
Seat 7: ChrisCDee ($25.63 in chips) 
Seat 8: stankfist420 ($21.31 in chips) 
Seat 9: chiyuki ($50.69 in chips) 
Dejacob: posts small blind $0.10
BlOnDhOlIc: posts big blind $0.25
*** HOLE CARDS ***
Dealt to chiyuki [6c Kc]
Landybob: folds 
KAKamiro: folds 
jethaz: folds 
ChrisCDee: folds 
stankfist420: raises $0.50 to $0.75
chiyuki: folds 
Anafim: folds 
Dejacob: folds 
BlOnDhOlIc: folds 
Uncalled bet ($0.50) returned to stankfist420
stankfist420 collected $0.60 from pot
stankfist420: doesn't show hand 
*** SUMMARY ***
Total pot $0.60 | Rake $0 
Seat 1: Anafim (button) folded before Flop (didn't bet)
Seat 2: Dejacob (small blind) folded before Flop
Seat 3: BlOnDhOlIc (big blind) folded before Flop
Seat 4: Landybob folded before Flop (didn't bet)
Seat 5: KAKamiro folded before Flop (didn't bet)
Seat 6: jethaz folded before Flop (didn't bet)
Seat 7: ChrisCDee folded before Flop (didn't bet)
Seat 8: stankfist420 collected ($0.60)
Seat 9: chiyuki folded before Flop (didn't bet)



PokerStars Zoom Hand #84298956576:  Hold'em No Limit ($0.10/$0.25) - 2012/08/05 13:46:28 JST [2012/08/05 0:46:28 ET]
Table 'Whirlpool' 9-max Seat #1 is the button
Seat 1: NastyMcNast ($64.22 in chips) 
Seat 2: kamikkaze ($14.04 in chips) 
Seat 3: munky3 ($48.62 in chips) 
Seat 4: fwani ($26.61 in chips) 
Seat 5: chiyuki ($50.69 in chips) 
Seat 6: wtu1986 ($26.74 in chips) 
Seat 7: ygoegoe ($30.47 in chips) 
Seat 8: BlackZafiro ($25 in chips) 
Seat 9: Alvinpe85 ($27.31 in chips) 
kamikkaze: posts small blind $0.10
munky3: posts big blind $0.25
*** HOLE CARDS ***
Dealt to chiyuki [3d 3c]
fwani: raises $0.35 to $0.60
chiyuki: folds 
wtu1986: folds 
ygoegoe: calls $0.60
BlackZafiro: raises $2.15 to $2.75
Alvinpe85: folds 
NastyMcNast: folds 
kamikkaze: folds 
munky3: folds 
fwani: folds 
ygoegoe: folds 
Uncalled bet ($2.15) returned to BlackZafiro
BlackZafiro collected $2.15 from pot
BlackZafiro: doesn't show hand 
*** SUMMARY ***
Total pot $2.15 | Rake $0 
Seat 1: NastyMcNast (button) folded before Flop (didn't bet)
Seat 2: kamikkaze (small blind) folded before Flop
Seat 3: munky3 (big blind) folded before Flop
Seat 4: fwani folded before Flop
Seat 5: chiyuki folded before Flop (didn't bet)
Seat 6: wtu1986 folded before Flop (didn't bet)
Seat 7: ygoegoe folded before Flop
Seat 8: BlackZafiro collected ($2.15)
Seat 9: Alvinpe85 folded before Flop (didn't bet)



PokerStars Zoom Hand #84298965824:  Hold'em No Limit ($0.10/$0.25) - 2012/08/05 13:47:05 JST [2012/08/05 0:47:05 ET]
Table 'Whirlpool' 9-max Seat #1 is the button
Seat 1: agurio ($31.46 in chips) 
Seat 2: Suhoff76 ($27.80 in chips) 
Seat 3: PetitAlejo ($35.59 in chips) 
Seat 4: chiyuki ($50.69 in chips) 
Seat 5: Tom1999 ($26.17 in chips) 
Seat 6: TraderYao ($29.45 in chips) 
Seat 7: KeLevro0 ($10.18 in chips) 
Seat 8: slapshot2011 ($45.27 in chips) 
Seat 9: softdesign ($78.03 in chips) 
Suhoff76: posts small blind $0.10
PetitAlejo: posts big blind $0.25
*** HOLE CARDS ***
Dealt to chiyuki [Td 4h]
chiyuki: folds 
Tom1999: folds 
TraderYao: folds 
KeLevro0: folds 
slapshot2011: folds 
softdesign: folds 
agurio: raises $0.50 to $0.75
Suhoff76: calls $0.65
PetitAlejo: folds 
*** FLOP *** [2s 2c 5c]
Suhoff76: checks 
agurio: bets $1
Suhoff76: folds 
Uncalled bet ($1) returned to agurio
agurio collected $1.67 from pot
agurio: doesn't show hand 
*** SUMMARY ***
Total pot $1.75 | Rake $0.08 
Board [2s 2c 5c]
Seat 1: agurio (button) collected ($1.67)
Seat 2: Suhoff76 (small blind) folded on the Flop
Seat 3: PetitAlejo (big blind) folded before Flop
Seat 4: chiyuki folded before Flop (didn't bet)
Seat 5: Tom1999 folded before Flop (didn't bet)
Seat 6: TraderYao folded before Flop (didn't bet)
Seat 7: KeLevro0 folded before Flop (didn't bet)
Seat 8: slapshot2011 folded before Flop (didn't bet)
Seat 9: softdesign folded before Flop (didn't bet)



PokerStars Zoom Hand #84298967084:  Hold'em No Limit ($0.10/$0.25) - 2012/08/05 13:47:10 JST [2012/08/05 0:47:10 ET]
Table 'Whirlpool' 9-max Seat #1 is the button
Seat 1: roksmokndonk ($37.87 in chips) 
Seat 2: chiyuki ($50.69 in chips) 
Seat 3: NastyMcNast ($64.22 in chips) 
Seat 4: timburonps ($25 in chips) 
Seat 5: BlOnDhOlIc ($33.33 in chips) 
Seat 6: stankfist420 ($21.66 in chips) 
Seat 7: ll_LaMeR_ll ($61.53 in chips) 
Seat 8: gunbowler ($147.15 in chips) 
Seat 9: KAKamiro ($35.36 in chips) 
chiyuki: posts small blind $0.10
NastyMcNast: posts big blind $0.25
*** HOLE CARDS ***
Dealt to chiyuki [Jd Ac]
timburonps: folds 
BlOnDhOlIc: folds 
stankfist420: folds 
ll_LaMeR_ll: folds 
gunbowler: folds 
KAKamiro: calls $0.25
roksmokndonk: folds 
chiyuki: raises $0.75 to $1
NastyMcNast: folds 
KAKamiro: calls $0.75
*** FLOP *** [Tc 2s 6h]
chiyuki: bets $1.25
KAKamiro: calls $1.25
*** TURN *** [Tc 2s 6h] [2c]
chiyuki: checks 
KAKamiro: bets $1.50
chiyuki: folds 
Uncalled bet ($1.50) returned to KAKamiro
KAKamiro collected $4.54 from pot
KAKamiro: doesn't show hand 
*** SUMMARY ***
Total pot $4.75 | Rake $0.21 
Board [Tc 2s 6h 2c]
Seat 1: roksmokndonk (button) folded before Flop (didn't bet)
Seat 2: chiyuki (small blind) folded on the Turn
Seat 3: NastyMcNast (big blind) folded before Flop
Seat 4: timburonps folded before Flop (didn't bet)
Seat 5: BlOnDhOlIc folded before Flop (didn't bet)
Seat 6: stankfist420 folded before Flop (didn't bet)
Seat 7: ll_LaMeR_ll folded before Flop (didn't bet)
Seat 8: gunbowler folded before Flop (didn't bet)
Seat 9: KAKamiro collected ($4.54)



PokerStars Zoom Hand #84298978104:  Hold'em No Limit ($0.10/$0.25) - 2012/08/05 13:47:53 JST [2012/08/05 0:47:53 ET]
Table 'Whirlpool' 9-max Seat #1 is the button
Seat 1: RomarioJa ($4.38 in chips) 
Seat 2: ygoegoe ($25.61 in chips) 
Seat 3: ChrisCDee ($25 in chips) 
Seat 4: hirozo ($25 in chips) 
Seat 5: agurio ($32.28 in chips) 
Seat 6: chiyuki ($48.44 in chips) 
Seat 7: cR!Ma*aRm ($38.51 in chips) 
Seat 8: roksmokndonk ($37.12 in chips) 
Seat 9: fwani ($38.34 in chips) 
ygoegoe: posts small blind $0.10
ChrisCDee: posts big blind $0.25
*** HOLE CARDS ***
Dealt to chiyuki [8d 9c]
hirozo: folds 
agurio: folds 
chiyuki: folds 
cR!Ma*aRm: folds 
roksmokndonk: folds 
fwani: raises $0.35 to $0.60
RomarioJa: raises $3.78 to $4.38 and is all-in
ygoegoe: folds 
ChrisCDee: folds 
fwani: folds 
Uncalled bet ($3.78) returned to RomarioJa
RomarioJa collected $1.55 from pot
RomarioJa: doesn't show hand 
*** SUMMARY ***
Total pot $1.55 | Rake $0 
Seat 1: RomarioJa (button) collected ($1.55)
Seat 2: ygoegoe (small blind) folded before Flop
Seat 3: ChrisCDee (big blind) folded before Flop
Seat 4: hirozo folded before Flop (didn't bet)
Seat 5: agurio folded before Flop (didn't bet)
Seat 6: chiyuki folded before Flop (didn't bet)
Seat 7: cR!Ma*aRm folded before Flop (didn't bet)
Seat 8: roksmokndonk folded before Flop (didn't bet)
Seat 9: fwani folded before Flop



PokerStars Zoom Hand #84298983465:  Hold'em No Limit ($0.10/$0.25) - 2012/08/05 13:48:15 JST [2012/08/05 0:48:15 ET]
Table 'Whirlpool' 9-max Seat #1 is the button
Seat 1: NastyMcNast ($25 in chips) 
Seat 2: BlOnDhOlIc ($46.95 in chips) 
Seat 3: seula i ($40.40 in chips) 
Seat 4: chiyuki ($48.44 in chips) 
Seat 5: peng2astic ($10.86 in chips) 
Seat 6: ladymadon107 ($20.69 in chips) 
Seat 7: Lasutchik ($33.94 in chips) 
Seat 8: Anafim ($14.58 in chips) 
Seat 9: hirozo ($25.48 in chips) 
BlOnDhOlIc: posts small blind $0.10
seula i: posts big blind $0.25
*** HOLE CARDS ***
Dealt to chiyuki [8s 2s]
chiyuki: folds 
peng2astic: folds 
ladymadon107: folds 
Lasutchik: folds 
Anafim: folds 
hirozo: folds 
NastyMcNast: folds 
BlOnDhOlIc: folds 
Uncalled bet ($0.15) returned to seula i
seula i collected $0.20 from pot
seula i: doesn't show hand 
*** SUMMARY ***
Total pot $0.20 | Rake $0 
Seat 1: NastyMcNast (button) folded before Flop (didn't bet)
Seat 2: BlOnDhOlIc (small blind) folded before Flop
Seat 3: seula i (big blind) collected ($0.20)
Seat 4: chiyuki folded before Flop (didn't bet)
Seat 5: peng2astic folded before Flop (didn't bet)
Seat 6: ladymadon107 folded before Flop (didn't bet)
Seat 7: Lasutchik folded before Flop (didn't bet)
Seat 8: Anafim folded before Flop (didn't bet)
Seat 9: hirozo folded before Flop (didn't bet)



PokerStars Zoom Hand #84298979660:  Hold'em No Limit ($0.10/$0.25) - 2012/08/05 13:47:59 JST [2012/08/05 0:47:59 ET]
Table 'Whirlpool' 9-max Seat #1 is the button
Seat 1: chiyuki ($48.44 in chips) 
Seat 2: ygoegoe ($30.22 in chips) 
Seat 3: wtu1986 ($25.48 in chips) 
Seat 4: TraderYao ($26.73 in chips) 
Seat 5: BlOnDhOlIc ($33.43 in chips) 
Seat 6: KeLevro0 ($20.40 in chips) 
Seat 7: KAKamiro ($37.65 in chips) 
Seat 8: Wilcox76607 ($15.75 in chips) 
Seat 9: 123progress ($26.85 in chips) 
ygoegoe: posts small blind $0.10
wtu1986: posts big blind $0.25
*** HOLE CARDS ***
Dealt to chiyuki [Ah 5s]
TraderYao: folds 
BlOnDhOlIc: raises $0.25 to $0.50
KeLevro0: folds 
KAKamiro: calls $0.50
Wilcox76607: folds 
123progress: folds 
chiyuki: folds 
ygoegoe: calls $0.40
wtu1986: folds 
*** FLOP *** [Jd Qs 7d]
ygoegoe: checks 
BlOnDhOlIc: checks 
KAKamiro: bets $0.75
ygoegoe: folds 
BlOnDhOlIc: folds 
Uncalled bet ($0.75) returned to KAKamiro
KAKamiro collected $1.67 from pot
KAKamiro: doesn't show hand 
*** SUMMARY ***
Total pot $1.75 | Rake $0.08 
Board [Jd Qs 7d]
Seat 1: chiyuki (button) folded before Flop (didn't bet)
Seat 2: ygoegoe (small blind) folded on the Flop
Seat 3: wtu1986 (big blind) folded before Flop
Seat 4: TraderYao folded before Flop (didn't bet)
Seat 5: BlOnDhOlIc folded on the Flop
Seat 6: KeLevro0 folded before Flop (didn't bet)
Seat 7: KAKamiro collected ($1.67)
Seat 8: Wilcox76607 folded before Flop (didn't bet)
Seat 9: 123progress folded before Flop (didn't bet)



PokerStars Zoom Hand #84298984259:  Hold'em No Limit ($0.10/$0.25) - 2012/08/05 13:48:18 JST [2012/08/05 0:48:18 ET]
Table 'Whirlpool' 9-max Seat #1 is the button
Seat 1: TraderYao ($29.10 in chips) 
Seat 2: roksmokndonk ($37.12 in chips) 
Seat 3: chiyuki ($48.44 in chips) 
Seat 4: gunbowler ($146.80 in chips) 
Seat 5: vit 111 ($9.31 in chips) 
Seat 6: wtu1986 ($24.90 in chips) 
Seat 7: Ellen1947 ($32.76 in chips) 
Seat 8: wildy29 ($15.90 in chips) 
Seat 9: Nerkit ($13.22 in chips) 
roksmokndonk: posts small blind $0.10
chiyuki: posts big blind $0.25
*** HOLE CARDS ***
Dealt to chiyuki [Kd 7d]
gunbowler: folds 
vit 111: folds 
wtu1986: folds 
Ellen1947: folds 
wildy29: folds 
Nerkit: folds 
TraderYao: raises $0.37 to $0.62
roksmokndonk: calls $0.52
chiyuki: calls $0.37
*** FLOP *** [5c 8h Tc]
roksmokndonk: checks 
chiyuki: checks 
TraderYao: checks 
*** TURN *** [5c 8h Tc] [Jh]
roksmokndonk: checks 
chiyuki: checks 
TraderYao: checks 
*** RIVER *** [5c 8h Tc Jh] [Qh]
roksmokndonk: bets $0.75
chiyuki: folds 
TraderYao: folds 
Uncalled bet ($0.75) returned to roksmokndonk
roksmokndonk collected $1.78 from pot
roksmokndonk: doesn't show hand 
*** SUMMARY ***
Total pot $1.86 | Rake $0.08 
Board [5c 8h Tc Jh Qh]
Seat 1: TraderYao (button) folded on the River
Seat 2: roksmokndonk (small blind) collected ($1.78)
Seat 3: chiyuki (big blind) folded on the River
Seat 4: gunbowler folded before Flop (didn't bet)
Seat 5: vit 111 folded before Flop (didn't bet)
Seat 6: wtu1986 folded before Flop (didn't bet)
Seat 7: Ellen1947 folded before Flop (didn't bet)
Seat 8: wildy29 folded before Flop (didn't bet)
Seat 9: Nerkit folded before Flop (didn't bet)



PokerStars Zoom Hand #84298982175:  Hold'em No Limit ($0.10/$0.25) - 2012/08/05 13:48:10 JST [2012/08/05 0:48:10 ET]
Table 'Whirlpool' 9-max Seat #1 is the button
Seat 1: simonzez ($36.04 in chips) 
Seat 2: jeff0923 ($26.83 in chips) 
Seat 3: TErr18 ($13.64 in chips) 
Seat 4: jethaz ($45.74 in chips) 
Seat 5: mariuka1 ($6.29 in chips) 
Seat 6: Anafim ($14.58 in chips) 
Seat 7: Th3Fog ($22.46 in chips) 
Seat 8: chiyuki ($48.44 in chips) 
Seat 9: PetitAlejo ($25 in chips) 
jeff0923: posts small blind $0.10
TErr18: posts big blind $0.25
*** HOLE CARDS ***
Dealt to chiyuki [6d 7c]
jethaz: folds 
mariuka1: raises $0.25 to $0.50
Anafim: folds 
Th3Fog: folds 
chiyuki: folds 
PetitAlejo: folds 
simonzez: calls $0.50
jeff0923: folds 
TErr18: folds 
*** FLOP *** [6c Th 3c]
mariuka1: bets $0.70
simonzez: calls $0.70
*** TURN *** [6c Th 3c] [3h]
mariuka1: checks 
simonzez: bets $1.50
mariuka1: calls $1.50
*** RIVER *** [6c Th 3c 3h] [3d]
mariuka1: checks 
simonzez: checks 
*** SHOW DOWN ***
mariuka1: shows [4d 4s] (a full house, Threes full of Fours)
simonzez: mucks hand 
mariuka1 collected $5.49 from pot
*** SUMMARY ***
Total pot $5.75 | Rake $0.26 
Board [6c Th 3c 3h 3d]
Seat 1: simonzez (button) mucked [9h Qh]
Seat 2: jeff0923 (small blind) folded before Flop
Seat 3: TErr18 (big blind) folded before Flop
Seat 4: jethaz folded before Flop (didn't bet)
Seat 5: mariuka1 showed [4d 4s] and won ($5.49) with a full house, Threes full of Fours
Seat 6: Anafim folded before Flop (didn't bet)
Seat 7: Th3Fog folded before Flop (didn't bet)
Seat 8: chiyuki folded before Flop (didn't bet)
Seat 9: PetitAlejo folded before Flop (didn't bet)



PokerStars Zoom Hand #84298996616:  Hold'em No Limit ($0.10/$0.25) - 2012/08/05 13:49:06 JST [2012/08/05 0:49:06 ET]
Table 'Whirlpool' 9-max Seat #1 is the button
Seat 1: kamikkaze ($14.39 in chips) 
Seat 2: BlackZafiro ($46.13 in chips) 
Seat 3: roksmokndonk ($38.28 in chips) 
Seat 4: cr0lox ($25.25 in chips) 
Seat 5: NastyMcNast ($25.76 in chips) 
Seat 6: TraderYao ($44.54 in chips) 
Seat 7: Suhoff76 ($29.53 in chips) 
Seat 8: chiyuki ($47.82 in chips) 
Seat 9: PetitAlejo ($32.24 in chips) 
BlackZafiro: posts small blind $0.10
roksmokndonk: posts big blind $0.25
*** HOLE CARDS ***
Dealt to chiyuki [5c Ac]
cr0lox: folds 
NastyMcNast: folds 
TraderYao: folds 
Suhoff76: folds 
chiyuki: raises $0.50 to $0.75
PetitAlejo: folds 
kamikkaze: folds 
BlackZafiro: folds 
roksmokndonk: folds 
Uncalled bet ($0.50) returned to chiyuki
chiyuki collected $0.60 from pot
chiyuki: doesn't show hand 
*** SUMMARY ***
Total pot $0.60 | Rake $0 
Seat 1: kamikkaze (button) folded before Flop (didn't bet)
Seat 2: BlackZafiro (small blind) folded before Flop
Seat 3: roksmokndonk (big blind) folded before Flop
Seat 4: cr0lox folded before Flop (didn't bet)
Seat 5: NastyMcNast folded before Flop (didn't bet)
Seat 6: TraderYao folded before Flop (didn't bet)
Seat 7: Suhoff76 folded before Flop (didn't bet)
Seat 8: chiyuki collected ($0.60)
Seat 9: PetitAlejo folded before Flop (didn't bet)



PokerStars Zoom Hand #84298995328:  Hold'em No Limit ($0.10/$0.25) - 2012/08/05 13:49:01 JST [2012/08/05 0:49:01 ET]
Table 'Whirlpool' 9-max Seat #1 is the button
Seat 1: Ellen1947 ($32.76 in chips) 
Seat 2: RomarioJa ($5.08 in chips) 
Seat 3: Anafim ($15.36 in chips) 
Seat 4: timburonps ($28.08 in chips) 
Seat 5: NastyMcNast ($63.25 in chips) 
Seat 6: Rudolf ($53.06 in chips) 
Seat 7: chiyuki ($47.82 in chips) 
Seat 8: fwani ($26.89 in chips) 
Seat 9: Loholov ($17.73 in chips) 
RomarioJa: posts small blind $0.10
Anafim: posts big blind $0.25
*** HOLE CARDS ***
Dealt to chiyuki [7s Tc]
timburonps: folds 
NastyMcNast: folds 
Rudolf: raises $0.50 to $0.75
chiyuki: folds 
fwani: folds 
Loholov: folds 
Ellen1947: calls $0.75
RomarioJa: folds 
Anafim: folds 
*** FLOP *** [9d Qc 4s]
Rudolf: bets $0.75
Ellen1947: calls $0.75
*** TURN *** [9d Qc 4s] [4d]
Rudolf: checks 
Ellen1947: bets $1.10
Rudolf: calls $1.10
*** RIVER *** [9d Qc 4s 4d] [8h]
Rudolf: checks 
Ellen1947: bets $1.40
Rudolf: folds 
Uncalled bet ($1.40) returned to Ellen1947
Ellen1947 collected $5.30 from pot
Ellen1947: doesn't show hand 
*** SUMMARY ***
Total pot $5.55 | Rake $0.25 
Board [9d Qc 4s 4d 8h]
Seat 1: Ellen1947 (button) collected ($5.30)
Seat 2: RomarioJa (small blind) folded before Flop
Seat 3: Anafim (big blind) folded before Flop
Seat 4: timburonps folded before Flop (didn't bet)
Seat 5: NastyMcNast folded before Flop (didn't bet)
Seat 6: Rudolf folded on the River
Seat 7: chiyuki folded before Flop (didn't bet)
Seat 8: fwani folded before Flop (didn't bet)
Seat 9: Loholov folded before Flop (didn't bet)



PokerStars Zoom Hand #84299002457:  Hold'em No Limit ($0.10/$0.25) - 2012/08/05 13:49:30 JST [2012/08/05 0:49:30 ET]
Table 'Whirlpool' 9-max Seat #1 is the button
Seat 1: NastyMcNast ($25 in chips) 
Seat 2: chiyuki ($48.17 in chips) 
Seat 3: timburonps ($29 in chips) 
Seat 4: ShockLaMuc ($25.19 in chips) 
Seat 5: cR!Ma*aRm ($39.88 in chips) 
Seat 6: Ellen1947 ($34.15 in chips) 
Seat 7: petersmiths ($44.35 in chips) 
Seat 8: ll_LaMeR_ll ($67.73 in chips) 
Seat 9: TErr18 ($13.04 in chips) 
chiyuki: posts small blind $0.10
timburonps: posts big blind $0.25
*** HOLE CARDS ***
Dealt to chiyuki [Qc 7d]
ShockLaMuc: folds 
cR!Ma*aRm: raises $0.50 to $0.75
Ellen1947: folds 
petersmiths: calls $0.75
ll_LaMeR_ll: folds 
TErr18: calls $0.75
NastyMcNast: folds 
chiyuki: folds 
timburonps: folds 
*** FLOP *** [Ks Js 9c]
cR!Ma*aRm: checks 
petersmiths: checks 
TErr18: checks 
*** TURN *** [Ks Js 9c] [4s]
cR!Ma*aRm: checks 
petersmiths: checks 
TErr18: checks 
*** RIVER *** [Ks Js 9c 4s] [Td]
cR!Ma*aRm: checks 
petersmiths: checks 
TErr18: checks 
*** SHOW DOWN ***
cR!Ma*aRm: shows [Ad 2d] (high card Ace)
petersmiths: shows [3h 3c] (a pair of Threes)
TErr18: shows [Jd Ac] (a pair of Jacks)
TErr18 collected $2.48 from pot
*** SUMMARY ***
Total pot $2.60 | Rake $0.12 
Board [Ks Js 9c 4s Td]
Seat 1: NastyMcNast (button) folded before Flop (didn't bet)
Seat 2: chiyuki (small blind) folded before Flop
Seat 3: timburonps (big blind) folded before Flop
Seat 4: ShockLaMuc folded before Flop (didn't bet)
Seat 5: cR!Ma*aRm showed [Ad 2d] and lost with high card Ace
Seat 6: Ellen1947 folded before Flop (didn't bet)
Seat 7: petersmiths showed [3h 3c] and lost with a pair of Threes
Seat 8: ll_LaMeR_ll folded before Flop (didn't bet)
Seat 9: TErr18 showed [Jd Ac] and won ($2.48) with a pair of Jacks



PokerStars Zoom Hand #84299003645:  Hold'em No Limit ($0.10/$0.25) - 2012/08/05 13:49:35 JST [2012/08/05 0:49:35 ET]
Table 'Whirlpool' 9-max Seat #1 is the button
Seat 1: ChrisCDee ($25 in chips) 
Seat 2: Loholov ($15 in chips) 
Seat 3: Ellen1947 ($34.15 in chips) 
Seat 4: Th3Fog ($55.77 in chips) 
Seat 5: chiyuki ($48.07 in chips) 
Seat 6: jethaz ($59.34 in chips) 
Seat 7: RomarioJa ($8.82 in chips) 
Seat 8: Alvinpe85 ($30.13 in chips) 
Seat 9: KeLevro0 ($13.25 in chips) 
Loholov: posts small blind $0.10
Ellen1947: posts big blind $0.25
*** HOLE CARDS ***
Dealt to chiyuki [6h As]
Th3Fog: folds 
chiyuki: folds 
jethaz: folds 
RomarioJa: folds 
Alvinpe85: folds 
KeLevro0: folds 
ChrisCDee: raises $0.50 to $0.75
Loholov: raises $1.75 to $2.50
Ellen1947: folds 
ChrisCDee: calls $1.75
*** FLOP *** [8c Th 3s]
Loholov: bets $3.75
ChrisCDee: folds 
Uncalled bet ($3.75) returned to Loholov
Loholov collected $5.01 from pot
Loholov: doesn't show hand 
*** SUMMARY ***
Total pot $5.25 | Rake $0.24 
Board [8c Th 3s]
Seat 1: ChrisCDee (button) folded on the Flop
Seat 2: Loholov (small blind) collected ($5.01)
Seat 3: Ellen1947 (big blind) folded before Flop
Seat 4: Th3Fog folded before Flop (didn't bet)
Seat 5: chiyuki folded before Flop (didn't bet)
Seat 6: jethaz folded before Flop (didn't bet)
Seat 7: RomarioJa folded before Flop (didn't bet)
Seat 8: Alvinpe85 folded before Flop (didn't bet)
Seat 9: KeLevro0 folded before Flop (didn't bet)



PokerStars Zoom Hand #84299006431:  Hold'em No Limit ($0.10/$0.25) - 2012/08/05 13:49:46 JST [2012/08/05 0:49:46 ET]
Table 'Whirlpool' 9-max Seat #1 is the button
Seat 1: solawind ($14.72 in chips) 
Seat 2: hirozo ($26.10 in chips) 
Seat 3: KAKamiro ($37.82 in chips) 
Seat 4: Dejacob ($32.61 in chips) 
Seat 5: jethaz ($59.34 in chips) 
Seat 6: PetitAlejo ($25.40 in chips) 
Seat 7: NastyMcNast ($25 in chips) 
Seat 8: Suhoff76 ($34.53 in chips) 
Seat 9: chiyuki ($48.07 in chips) 
hirozo: posts small blind $0.10
KAKamiro: posts big blind $0.25
*** HOLE CARDS ***
Dealt to chiyuki [8c 4c]
Dejacob: folds 
jethaz: folds 
PetitAlejo: raises $0.50 to $0.75
NastyMcNast: folds 
Suhoff76: folds 
chiyuki: folds 
solawind: calls $0.75
hirozo: folds 
KAKamiro: calls $0.50
*** FLOP *** [4s 7c 5d]
KAKamiro: checks 
PetitAlejo: bets $1.50
solawind: folds 
KAKamiro: calls $1.50
*** TURN *** [4s 7c 5d] [6c]
KAKamiro: checks 
PetitAlejo: bets $2.50
KAKamiro: calls $2.50
*** RIVER *** [4s 7c 5d 6c] [8s]
KAKamiro: checks 
PetitAlejo: bets $7.89
KAKamiro: calls $7.89
*** SHOW DOWN ***
PetitAlejo: shows [Ah Ac] (a straight, Four to Eight)
KAKamiro: shows [2s 2d] (a straight, Four to Eight)
KAKamiro collected $12.48 from pot
PetitAlejo collected $12.47 from pot
*** SUMMARY ***
Total pot $26.13 | Rake $1.18 
Board [4s 7c 5d 6c 8s]
Seat 1: solawind (button) folded on the Flop
Seat 2: hirozo (small blind) folded before Flop
Seat 3: KAKamiro (big blind) showed [2s 2d] and won ($12.48) with a straight, Four to Eight
Seat 4: Dejacob folded before Flop (didn't bet)
Seat 5: jethaz folded before Flop (didn't bet)
Seat 6: PetitAlejo showed [Ah Ac] and won ($12.47) with a straight, Four to Eight
Seat 7: NastyMcNast folded before Flop (didn't bet)
Seat 8: Suhoff76 folded before Flop (didn't bet)
Seat 9: chiyuki folded before Flop (didn't bet)



PokerStars Zoom Hand #84299007437:  Hold'em No Limit ($0.10/$0.25) - 2012/08/05 13:49:50 JST [2012/08/05 0:49:50 ET]
Table 'Whirlpool' 9-max Seat #1 is the button
Seat 1: taksist889 ($18.42 in chips) 
Seat 2: TraderYao ($29.04 in chips) 
Seat 3: chiyuki ($48.07 in chips) 
Seat 4: RomarioJa ($6.99 in chips) 
Seat 5: NastyMcNast ($25 in chips) 
Seat 6: RikkStroken ($15 in chips) 
Seat 7: wtu1986 ($25 in chips) 
Seat 8: Nerkit ($11.50 in chips) 
Seat 9: 123progress ($24.90 in chips) 
TraderYao: posts small blind $0.10
chiyuki: posts big blind $0.25
*** HOLE CARDS ***
Dealt to chiyuki [8d 6d]
RomarioJa: folds 
NastyMcNast: folds 
RikkStroken: folds 
wtu1986: folds 
Nerkit: folds 
123progress: raises $0.37 to $0.62
taksist889: folds 
TraderYao: folds 
chiyuki: calls $0.37
*** FLOP *** [7c 9h Qh]
chiyuki: checks 
123progress: bets $0.75
chiyuki: calls $0.75
*** TURN *** [7c 9h Qh] [Js]
chiyuki: checks 
123progress: checks 
*** RIVER *** [7c 9h Qh Js] [2s]
chiyuki: bets $1.50
123progress: calls $1.50
*** SHOW DOWN ***
chiyuki: shows [8d 6d] (high card Queen)
123progress: shows [Ad 2h] (a pair of Deuces)
123progress collected $5.58 from pot
*** SUMMARY ***
Total pot $5.84 | Rake $0.26 
Board [7c 9h Qh Js 2s]
Seat 1: taksist889 (button) folded before Flop (didn't bet)
Seat 2: TraderYao (small blind) folded before Flop
Seat 3: chiyuki (big blind) showed [8d 6d] and lost with high card Queen
Seat 4: RomarioJa folded before Flop (didn't bet)
Seat 5: NastyMcNast folded before Flop (didn't bet)
Seat 6: RikkStroken folded before Flop (didn't bet)
Seat 7: wtu1986 folded before Flop (didn't bet)
Seat 8: Nerkit folded before Flop (didn't bet)
Seat 9: 123progress showed [Ad 2h] and won ($5.58) with a pair of Deuces



PokerStars Zoom Hand #84299022722:  Hold'em No Limit ($0.10/$0.25) - 2012/08/05 13:50:52 JST [2012/08/05 0:50:52 ET]
Table 'Whirlpool' 9-max Seat #1 is the button
Seat 1: Anafim ($15.46 in chips) 
Seat 2: KeLevro0 ($13.16 in chips) 
Seat 3: puffy5533 ($22.20 in chips) 
Seat 4: timburonps ($28.65 in chips) 
Seat 5: Rudolf ($48.79 in chips) 
Seat 6: chiyuki ($45.20 in chips) 
Seat 7: Nerkit ($12.60 in chips) 
Seat 8: ll_LaMeR_ll ($67.73 in chips) 
Seat 9: Loholov ($15.96 in chips) 
KeLevro0: posts small blind $0.10
puffy5533: posts big blind $0.25
*** HOLE CARDS ***
Dealt to chiyuki [Kc 3h]
timburonps: folds 
Rudolf: folds 
chiyuki: folds 
Nerkit: folds 
ll_LaMeR_ll: raises $0.50 to $0.75
Loholov: raises $2 to $2.75
Anafim: folds 
KeLevro0: folds 
puffy5533: folds 
ll_LaMeR_ll: calls $2
*** FLOP *** [Tc 6d 7s]
ll_LaMeR_ll: checks 
Loholov: bets $3.50
ll_LaMeR_ll: folds 
Uncalled bet ($3.50) returned to Loholov
Loholov collected $5.59 from pot
Loholov: doesn't show hand 
*** SUMMARY ***
Total pot $5.85 | Rake $0.26 
Board [Tc 6d 7s]
Seat 1: Anafim (button) folded before Flop (didn't bet)
Seat 2: KeLevro0 (small blind) folded before Flop
Seat 3: puffy5533 (big blind) folded before Flop
Seat 4: timburonps folded before Flop (didn't bet)
Seat 5: Rudolf folded before Flop (didn't bet)
Seat 6: chiyuki folded before Flop (didn't bet)
Seat 7: Nerkit folded before Flop (didn't bet)
Seat 8: ll_LaMeR_ll folded on the Flop
Seat 9: Loholov collected ($5.59)



PokerStars Zoom Hand #84299024243:  Hold'em No Limit ($0.10/$0.25) - 2012/08/05 13:50:58 JST [2012/08/05 0:50:58 ET]
Table 'Whirlpool' 9-max Seat #1 is the button
Seat 1: Jippyflip ($9.23 in chips) 
Seat 2: hirozo ($26.60 in chips) 
Seat 3: Suhoff76 ($29.18 in chips) 
Seat 4: chiyuki ($45.20 in chips) 
Seat 5: PetitAlejo ($25.35 in chips) 
Seat 6: Lasutchik ($11.08 in chips) 
Seat 7: Rudolf ($48.79 in chips) 
Seat 8: Wilcox76607 ($17.20 in chips) 
Seat 9: wtu1986 ($25.25 in chips) 
hirozo: posts small blind $0.10
Suhoff76: posts big blind $0.25
*** HOLE CARDS ***
Dealt to chiyuki [7d 5h]
chiyuki: folds 
PetitAlejo: folds 
Lasutchik: raises $0.27 to $0.52
Rudolf: folds 
Wilcox76607: calls $0.52
wtu1986: folds 
Jippyflip: folds 
hirozo: folds 
Suhoff76: folds 
*** FLOP *** [4d 4s Kh]
Lasutchik: checks 
Wilcox76607: checks 
*** TURN *** [4d 4s Kh] [Jd]
Lasutchik: bets $0.93
Wilcox76607: calls $0.93
*** RIVER *** [4d 4s Kh Jd] [8h]
Lasutchik: checks 
Wilcox76607: bets $2.50
Lasutchik: folds 
Uncalled bet ($2.50) returned to Wilcox76607
Wilcox76607 collected $3.10 from pot
Wilcox76607: doesn't show hand 
*** SUMMARY ***
Total pot $3.25 | Rake $0.15 
Board [4d 4s Kh Jd 8h]
Seat 1: Jippyflip (button) folded before Flop (didn't bet)
Seat 2: hirozo (small blind) folded before Flop
Seat 3: Suhoff76 (big blind) folded before Flop
Seat 4: chiyuki folded before Flop (didn't bet)
Seat 5: PetitAlejo folded before Flop (didn't bet)
Seat 6: Lasutchik folded on the River
Seat 7: Rudolf folded before Flop (didn't bet)
Seat 8: Wilcox76607 collected ($3.10)
Seat 9: wtu1986 folded before Flop (didn't bet)



PokerStars Zoom Hand #84299027497:  Hold'em No Limit ($0.10/$0.25) - 2012/08/05 13:51:11 JST [2012/08/05 0:51:11 ET]
Table 'Whirlpool' 9-max Seat #1 is the button
Seat 1: KeLevro0 ($11.90 in chips) 
Seat 2: ChrisCDee ($25 in chips) 
Seat 3: RikkStroken ($14.25 in chips) 
Seat 4: NastyMcNast ($25.01 in chips) 
Seat 5: chiyuki ($45.20 in chips) 
Seat 6: Alvinpe85 ($27.97 in chips) 
Seat 7: Nerkit ($13.57 in chips) 
Seat 8: RomarioJa ($16.54 in chips) 
Seat 9: PetitAlejo ($29.99 in chips) 
ChrisCDee: posts small blind $0.10
RikkStroken: posts big blind $0.25
*** HOLE CARDS ***
Dealt to chiyuki [Jc Js]
NastyMcNast: folds 
chiyuki: raises $0.50 to $0.75
Alvinpe85: folds 
Nerkit: folds 
RomarioJa: folds 
PetitAlejo: folds 
KeLevro0: raises $1.75 to $2.50
ChrisCDee: folds 
RikkStroken: folds 
chiyuki: calls $1.75
*** FLOP *** [Ks 9h 5h]
chiyuki: checks 
KeLevro0: bets $2.86
chiyuki: folds 
Uncalled bet ($2.86) returned to KeLevro0
KeLevro0 collected $5.11 from pot
KeLevro0: doesn't show hand 
*** SUMMARY ***
Total pot $5.35 | Rake $0.24 
Board [Ks 9h 5h]
Seat 1: KeLevro0 (button) collected ($5.11)
Seat 2: ChrisCDee (small blind) folded before Flop
Seat 3: RikkStroken (big blind) folded before Flop
Seat 4: NastyMcNast folded before Flop (didn't bet)
Seat 5: chiyuki folded on the Flop
Seat 6: Alvinpe85 folded before Flop (didn't bet)
Seat 7: Nerkit folded before Flop (didn't bet)
Seat 8: RomarioJa folded before Flop (didn't bet)
Seat 9: PetitAlejo folded before Flop (didn't bet)



PokerStars Zoom Hand #84299025226:  Hold'em No Limit ($0.10/$0.25) - 2012/08/05 13:51:02 JST [2012/08/05 0:51:02 ET]
Table 'Whirlpool' 9-max Seat #1 is the button
Seat 1: chiyuki ($45.20 in chips) 
Seat 2: puffy5533 ($21.95 in chips) 
Seat 3: ygoegoe ($31.29 in chips) 
Seat 4: BlackZafiro ($25.35 in chips) 
Seat 5: Rudolf ($48.79 in chips) 
Seat 6: NastyMcNast ($25.01 in chips) 
Seat 7: Jippyflip ($9.23 in chips) 
Seat 8: fwani ($40.59 in chips) 
Seat 9: goldstone ($13.75 in chips) 
puffy5533: posts small blind $0.10
ygoegoe: posts big blind $0.25
*** HOLE CARDS ***
Dealt to chiyuki [3h 5h]
BlackZafiro: folds 
Rudolf: folds 
NastyMcNast: folds 
Jippyflip: folds 
fwani: raises $0.35 to $0.60
goldstone: folds 
chiyuki: folds 
puffy5533: folds 
ygoegoe: calls $0.35
*** FLOP *** [Kh 9c Jd]
ygoegoe: checks 
fwani: checks 
*** TURN *** [Kh 9c Jd] [Js]
ygoegoe: bets $0.83
fwani: calls $0.83
*** RIVER *** [Kh 9c Jd Js] [2c]
ygoegoe: bets $1.55
fwani: folds 
Uncalled bet ($1.55) returned to ygoegoe
ygoegoe collected $2.83 from pot
ygoegoe: doesn't show hand 
*** SUMMARY ***
Total pot $2.96 | Rake $0.13 
Board [Kh 9c Jd Js 2c]
Seat 1: chiyuki (button) folded before Flop (didn't bet)
Seat 2: puffy5533 (small blind) folded before Flop
Seat 3: ygoegoe (big blind) collected ($2.83)
Seat 4: BlackZafiro folded before Flop (didn't bet)
Seat 5: Rudolf folded before Flop (didn't bet)
Seat 6: NastyMcNast folded before Flop (didn't bet)
Seat 7: Jippyflip folded before Flop (didn't bet)
Seat 8: fwani folded on the River
Seat 9: goldstone folded before Flop (didn't bet)



PokerStars Zoom Hand #84299042981:  Hold'em No Limit ($0.10/$0.25) - 2012/08/05 13:52:13 JST [2012/08/05 0:52:13 ET]
Table 'Whirlpool' 9-max Seat #1 is the button
Seat 1: Ellen1947 ($34.36 in chips) 
Seat 2: chiyuki ($42.70 in chips) 
Seat 3: Loholov ($18.98 in chips) 
Seat 4: Wilcox76607 ($18.85 in chips) 
Seat 5: Rudolf ($48.44 in chips) 
Seat 6: RomarioJa ($17.46 in chips) 
Seat 7: RikkStroken ($13.50 in chips) 
Seat 8: Dejacob ($30.58 in chips) 
Seat 9: gunbowler ($154.28 in chips) 
chiyuki: posts small blind $0.10
Loholov: posts big blind $0.25
*** HOLE CARDS ***
Dealt to chiyuki [9h 5d]
Wilcox76607: folds 
Rudolf: folds 
RomarioJa: folds 
RikkStroken: folds 
Dejacob: folds 
gunbowler: raises $0.35 to $0.60
Ellen1947: folds 
chiyuki: folds 
Loholov: folds 
Uncalled bet ($0.35) returned to gunbowler
gunbowler collected $0.60 from pot
gunbowler: doesn't show hand 
*** SUMMARY ***
Total pot $0.60 | Rake $0 
Seat 1: Ellen1947 (button) folded before Flop (didn't bet)
Seat 2: chiyuki (small blind) folded before Flop
Seat 3: Loholov (big blind) folded before Flop
Seat 4: Wilcox76607 folded before Flop (didn't bet)
Seat 5: Rudolf folded before Flop (didn't bet)
Seat 6: RomarioJa folded before Flop (didn't bet)
Seat 7: RikkStroken folded before Flop (didn't bet)
Seat 8: Dejacob folded before Flop (didn't bet)
Seat 9: gunbowler collected ($0.60)



PokerStars Zoom Hand #84299041967:  Hold'em No Limit ($0.10/$0.25) - 2012/08/05 13:52:09 JST [2012/08/05 0:52:09 ET]
Table 'Whirlpool' 9-max Seat #1 is the button
Seat 1: KeLevro0 ($12.81 in chips) 
Seat 2: 2997qwer ($11.15 in chips) 
Seat 3: timburonps ($40.53 in chips) 
Seat 4: BlOnDhOlIc ($45.53 in chips) 
Seat 5: wtu1986 ($25.39 in chips) 
Seat 6: Wilcox76607 ($18.85 in chips) 
Seat 7: chiyuki ($42.70 in chips) 
Seat 8: Suhoff76 ($27.53 in chips) 
Seat 9: BlackZafiro ($42.68 in chips) 
2997qwer: posts small blind $0.10
timburonps: posts big blind $0.25
*** HOLE CARDS ***
Dealt to chiyuki [7c Jd]
BlOnDhOlIc: folds 
wtu1986: folds 
Wilcox76607: folds 
chiyuki: folds 
Suhoff76: folds 
BlackZafiro: raises $0.37 to $0.62
KeLevro0: raises $2.13 to $2.75
2997qwer: folds 
timburonps: folds 
BlackZafiro: folds 
Uncalled bet ($2.13) returned to KeLevro0
KeLevro0 collected $1.59 from pot
KeLevro0: doesn't show hand 
*** SUMMARY ***
Total pot $1.59 | Rake $0 
Seat 1: KeLevro0 (button) collected ($1.59)
Seat 2: 2997qwer (small blind) folded before Flop
Seat 3: timburonps (big blind) folded before Flop
Seat 4: BlOnDhOlIc folded before Flop (didn't bet)
Seat 5: wtu1986 folded before Flop (didn't bet)
Seat 6: Wilcox76607 folded before Flop (didn't bet)
Seat 7: chiyuki folded before Flop (didn't bet)
Seat 8: Suhoff76 folded before Flop (didn't bet)
Seat 9: BlackZafiro folded before Flop



PokerStars Zoom Hand #84299043986:  Hold'em No Limit ($0.10/$0.25) - 2012/08/05 13:52:17 JST [2012/08/05 0:52:17 ET]
Table 'Whirlpool' 9-max Seat #1 is the button
Seat 1: Th3Fog ($80.06 in chips) 
Seat 2: taksist889 ($15.22 in chips) 
Seat 3: jeff0923 ($24.88 in chips) 
Seat 4: hirozo ($26.77 in chips) 
Seat 5: PetitAlejo ($29.64 in chips) 
Seat 6: ll_LaMeR_ll ($66.42 in chips) 
Seat 7: mariuka1 ($10.96 in chips) 
Seat 8: NastyMcNast ($36.92 in chips) 
Seat 9: chiyuki ($42.60 in chips) 
taksist889: posts small blind $0.10
jeff0923: posts big blind $0.25
*** HOLE CARDS ***
Dealt to chiyuki [Jd Ts]
hirozo: folds 
PetitAlejo: raises $0.50 to $0.75
ll_LaMeR_ll: folds 
mariuka1: folds 
NastyMcNast: folds 
chiyuki: folds 
Th3Fog: folds 
taksist889: folds 
jeff0923: folds 
Uncalled bet ($0.50) returned to PetitAlejo
PetitAlejo collected $0.60 from pot
PetitAlejo: doesn't show hand 
*** SUMMARY ***
Total pot $0.60 | Rake $0 
Seat 1: Th3Fog (button) folded before Flop (didn't bet)
Seat 2: taksist889 (small blind) folded before Flop
Seat 3: jeff0923 (big blind) folded before Flop
Seat 4: hirozo folded before Flop (didn't bet)
Seat 5: PetitAlejo collected ($0.60)
Seat 6: ll_LaMeR_ll folded before Flop (didn't bet)
Seat 7: mariuka1 folded before Flop (didn't bet)
Seat 8: NastyMcNast folded before Flop (didn't bet)
Seat 9: chiyuki folded before Flop (didn't bet)



PokerStars Zoom Hand #84299047093:  Hold'em No Limit ($0.10/$0.25) - 2012/08/05 13:52:29 JST [2012/08/05 0:52:29 ET]
Table 'Whirlpool' 9-max Seat #1 is the button
Seat 1: NastyMcNast ($36.92 in chips) 
Seat 2: RikkStroken ($13.50 in chips) 
Seat 3: chiyuki ($42.60 in chips) 
Seat 4: RomarioJa ($8.45 in chips) 
Seat 5: deadmoneykid ($27.74 in chips) 
Seat 6: timburonps ($27.38 in chips) 
Seat 7: gandalfs9 ($21 in chips) 
Seat 8: Jippyflip ($8.88 in chips) 
Seat 9: flyinprits ($44.87 in chips) 
RikkStroken: posts small blind $0.10
chiyuki: posts big blind $0.25
*** HOLE CARDS ***
Dealt to chiyuki [7s Ts]
RomarioJa: folds 
deadmoneykid: folds 
timburonps: folds 
gandalfs9: folds 
Jippyflip: folds 
flyinprits: folds 
NastyMcNast: folds 
RikkStroken: folds 
Uncalled bet ($0.15) returned to chiyuki
chiyuki collected $0.20 from pot
chiyuki: doesn't show hand 
*** SUMMARY ***
Total pot $0.20 | Rake $0 
Seat 1: NastyMcNast (button) folded before Flop (didn't bet)
Seat 2: RikkStroken (small blind) folded before Flop
Seat 3: chiyuki (big blind) collected ($0.20)
Seat 4: RomarioJa folded before Flop (didn't bet)
Seat 5: deadmoneykid folded before Flop (didn't bet)
Seat 6: timburonps folded before Flop (didn't bet)
Seat 7: gandalfs9 folded before Flop (didn't bet)
Seat 8: Jippyflip folded before Flop (didn't bet)
Seat 9: flyinprits folded before Flop (didn't bet)



PokerStars Zoom Hand #84299045034:  Hold'em No Limit ($0.10/$0.25) - 2012/08/05 13:52:21 JST [2012/08/05 0:52:21 ET]
Table 'Whirlpool' 9-max Seat #1 is the button
Seat 1: wtu1986 ($25.40 in chips) 
Seat 2: deadmoneykid ($44.44 in chips) 
Seat 3: Nerkit ($14.35 in chips) 
Seat 4: mariuka1 ($10.96 in chips) 
Seat 5: ll_LaMeR_ll ($66.42 in chips) 
Seat 6: Anafim ($15.38 in chips) 
Seat 7: timburonps ($27.38 in chips) 
Seat 8: chiyuki ($42.60 in chips) 
Seat 9: KeLevro0 ($14.41 in chips) 
deadmoneykid: posts small blind $0.10
Nerkit: posts big blind $0.25
*** HOLE CARDS ***
Dealt to chiyuki [2c Td]
mariuka1: folds 
ll_LaMeR_ll: folds 
Anafim: folds 
timburonps: folds 
chiyuki: folds 
KeLevro0: folds 
wtu1986: folds 
deadmoneykid: folds 
Uncalled bet ($0.15) returned to Nerkit
Nerkit collected $0.20 from pot
Nerkit: doesn't show hand 
*** SUMMARY ***
Total pot $0.20 | Rake $0 
Seat 1: wtu1986 (button) folded before Flop (didn't bet)
Seat 2: deadmoneykid (small blind) folded before Flop
Seat 3: Nerkit (big blind) collected ($0.20)
Seat 4: mariuka1 folded before Flop (didn't bet)
Seat 5: ll_LaMeR_ll folded before Flop (didn't bet)
Seat 6: Anafim folded before Flop (didn't bet)
Seat 7: timburonps folded before Flop (didn't bet)
Seat 8: chiyuki folded before Flop (didn't bet)
Seat 9: KeLevro0 folded before Flop (didn't bet)



PokerStars Zoom Hand #84299046033:  Hold'em No Limit ($0.10/$0.25) - 2012/08/05 13:52:25 JST [2012/08/05 0:52:25 ET]
Table 'Whirlpool' 9-max Seat #1 is the button
Seat 1: Dejacob ($25.22 in chips) 
Seat 2: BlOnDhOlIc ($45.53 in chips) 
Seat 3: ygoegoe ($27.80 in chips) 
Seat 4: petersmiths ($49.17 in chips) 
Seat 5: silvno31 ($46.70 in chips) 
Seat 6: KeLevro0 ($14.41 in chips) 
Seat 7: chiyuki ($42.60 in chips) 
Seat 8: hirozo ($26.77 in chips) 
Seat 9: peng2astic ($9.96 in chips) 
BlOnDhOlIc: posts small blind $0.10
ygoegoe: posts big blind $0.25
*** HOLE CARDS ***
Dealt to chiyuki [5d 4d]
petersmiths: folds 
silvno31: raises $0.25 to $0.50
KeLevro0: folds 
chiyuki: folds 
hirozo: folds 
peng2astic: calls $0.50
Dejacob: calls $0.50
BlOnDhOlIc: calls $0.40
ygoegoe: calls $0.25
*** FLOP *** [Kd 6c 2d]
BlOnDhOlIc: checks 
ygoegoe: checks 
silvno31: checks 
peng2astic: checks 
Dejacob: checks 
*** TURN *** [Kd 6c 2d] [Jh]
BlOnDhOlIc: checks 
ygoegoe: bets $1.31
silvno31: folds 
peng2astic: folds 
Dejacob: calls $1.31
BlOnDhOlIc: folds 
*** RIVER *** [Kd 6c 2d Jh] [8d]
ygoegoe: checks 
Dejacob: bets $3.25
ygoegoe: calls $3.25
*** SHOW DOWN ***
Dejacob: shows [Ad Th] (high card Ace)
ygoegoe: shows [Ac Js] (a pair of Jacks)
ygoegoe collected $11.10 from pot
*** SUMMARY ***
Total pot $11.62 | Rake $0.52 
Board [Kd 6c 2d Jh 8d]
Seat 1: Dejacob (button) showed [Ad Th] and lost with high card Ace
Seat 2: BlOnDhOlIc (small blind) folded on the Turn
Seat 3: ygoegoe (big blind) showed [Ac Js] and won ($11.10) with a pair of Jacks
Seat 4: petersmiths folded before Flop (didn't bet)
Seat 5: silvno31 folded on the Turn
Seat 6: KeLevro0 folded before Flop (didn't bet)
Seat 7: chiyuki folded before Flop (didn't bet)
Seat 8: hirozo folded before Flop (didn't bet)
Seat 9: peng2astic folded on the Turn



PokerStars Zoom Hand #84299051052:  Hold'em No Limit ($0.10/$0.25) - 2012/08/05 13:52:45 JST [2012/08/05 0:52:45 ET]
Table 'Whirlpool' 9-max Seat #1 is the button
Seat 1: chiyuki ($42.70 in chips) 
Seat 2: 2997qwer ($10.35 in chips) 
Seat 3: timburonps ($27.38 in chips) 
Seat 4: KeLevro0 ($13.68 in chips) 
Seat 5: D@vidMed ($24.40 in chips) 
Seat 6: Loholov ($17.84 in chips) 
Seat 7: Anafim ($15.38 in chips) 
Seat 8: Roglus ($70.47 in chips) 
Seat 9: Alvinpe85 ($48.56 in chips) 
2997qwer: posts small blind $0.10
timburonps: posts big blind $0.25
*** HOLE CARDS ***
Dealt to chiyuki [Qc As]
KeLevro0: folds 
D@vidMed: raises $0.57 to $0.82
Loholov: raises $0.93 to $1.75
Anafim: folds 
Roglus: folds 
Alvinpe85: folds 
chiyuki: raises $2.75 to $4.50
2997qwer: folds 
timburonps: folds 
D@vidMed: calls $3.68
Loholov: calls $2.75
*** FLOP *** [Jh 7s Ad]
D@vidMed: checks 
Loholov: checks 
chiyuki: bets $6
D@vidMed: calls $6
Loholov: raises $7.34 to $13.34 and is all-in
chiyuki: folds 
D@vidMed: calls $7.34
*** TURN *** [Jh 7s Ad] [5d]
*** RIVER *** [Jh 7s Ad 5d] [6h]
*** SHOW DOWN ***
D@vidMed: shows [Ah Ac] (three of a kind, Aces)
Loholov: mucks hand 
D@vidMed collected $44.53 from pot
*** SUMMARY ***
Total pot $46.53 | Rake $2 
Board [Jh 7s Ad 5d 6h]
Seat 1: chiyuki (button) folded on the Flop
Seat 2: 2997qwer (small blind) folded before Flop
Seat 3: timburonps (big blind) folded before Flop
Seat 4: KeLevro0 folded before Flop (didn't bet)
Seat 5: D@vidMed showed [Ah Ac] and won ($44.53) with three of a kind, Aces
Seat 6: Loholov mucked [Jc Jd]
Seat 7: Anafim folded before Flop (didn't bet)
Seat 8: Roglus folded before Flop (didn't bet)
Seat 9: Alvinpe85 folded before Flop (didn't bet)



PokerStars Zoom Hand #84299074769:  Hold'em No Limit ($0.10/$0.25) - 2012/08/05 13:54:21 JST [2012/08/05 0:54:21 ET]
Table 'Whirlpool' 9-max Seat #1 is the button
Seat 1: NastyMcNast ($25 in chips) 
Seat 2: munky3 ($28.46 in chips) 
Seat 3: roksmokndonk ($37.46 in chips) 
Seat 4: BlackZafiro ($27.42 in chips) 
Seat 5: KeLevro0 ($13.01 in chips) 
Seat 6: chiyuki ($32.20 in chips) 
Seat 7: Nerkit ($11.56 in chips) 
Seat 8: Wilcox76607 ($18.96 in chips) 
Seat 9: petersmiths ($49.73 in chips) 
munky3: posts small blind $0.10
roksmokndonk: posts big blind $0.25
*** HOLE CARDS ***
Dealt to chiyuki [Td 8d]
BlackZafiro: folds 
KeLevro0: folds 
chiyuki: folds 
Nerkit: folds 
Wilcox76607: folds 
petersmiths: raises $0.25 to $0.50
NastyMcNast: folds 
munky3: calls $0.40
roksmokndonk: folds 
*** FLOP *** [9h Js 2d]
munky3: checks 
petersmiths: checks 
*** TURN *** [9h Js 2d] [Th]
munky3: bets $0.50
petersmiths: calls $0.50
*** RIVER *** [9h Js 2d Th] [9c]
munky3: bets $0.75
petersmiths: folds 
Uncalled bet ($0.75) returned to munky3
munky3 collected $2.15 from pot
munky3: doesn't show hand 
munky3 is disconnected 
*** SUMMARY ***
Total pot $2.25 | Rake $0.10 
Board [9h Js 2d Th 9c]
Seat 1: NastyMcNast (button) folded before Flop (didn't bet)
Seat 2: munky3 (small blind) collected ($2.15)
Seat 3: roksmokndonk (big blind) folded before Flop
Seat 4: BlackZafiro folded before Flop (didn't bet)
Seat 5: KeLevro0 folded before Flop (didn't bet)
Seat 6: chiyuki folded before Flop (didn't bet)
Seat 7: Nerkit folded before Flop (didn't bet)
Seat 8: Wilcox76607 folded before Flop (didn't bet)
Seat 9: petersmiths folded on the River



PokerStars Zoom Hand #84299076779:  Hold'em No Limit ($0.10/$0.25) - 2012/08/05 13:54:29 JST [2012/08/05 0:54:29 ET]
Table 'Whirlpool' 9-max Seat #1 is the button
Seat 1: leo2095 ($17.06 in chips) 
Seat 2: chiyuki ($32.20 in chips) 
Seat 3: Lasutchik ($7.63 in chips) 
Seat 4: ChrisCDee ($40.44 in chips) 
Seat 5: KeLevro0 ($8.93 in chips) 
Seat 6: 123progress ($25 in chips) 
Seat 7: cr0lox ($20.43 in chips) 
Seat 8: fwani ($29.84 in chips) 
Seat 9: carlosrbr ($22.11 in chips) 
chiyuki: posts small blind $0.10
Lasutchik: posts big blind $0.25
*** HOLE CARDS ***
Dealt to chiyuki [3d 9h]
ChrisCDee: folds 
KeLevro0: folds 
123progress: folds 
cr0lox: folds 
fwani: raises $0.35 to $0.60
carlosrbr: folds 
leo2095: folds 
chiyuki: folds 
Lasutchik: folds 
Uncalled bet ($0.35) returned to fwani
fwani collected $0.60 from pot
fwani: doesn't show hand 
*** SUMMARY ***
Total pot $0.60 | Rake $0 
Seat 1: leo2095 (button) folded before Flop (didn't bet)
Seat 2: chiyuki (small blind) folded before Flop
Seat 3: Lasutchik (big blind) folded before Flop
Seat 4: ChrisCDee folded before Flop (didn't bet)
Seat 5: KeLevro0 folded before Flop (didn't bet)
Seat 6: 123progress folded before Flop (didn't bet)
Seat 7: cr0lox folded before Flop (didn't bet)
Seat 8: fwani collected ($0.60)
Seat 9: carlosrbr folded before Flop (didn't bet)



PokerStars Zoom Hand #84299075764:  Hold'em No Limit ($0.10/$0.25) - 2012/08/05 13:54:25 JST [2012/08/05 0:54:25 ET]
Table 'Whirlpool' 9-max Seat #1 is the button
Seat 1: RomarioJa ($5.33 in chips) 
Seat 2: hirozo ($25 in chips) 
Seat 3: Wilcox76607 ($18.96 in chips) 
Seat 4: 2997qwer ($10 in chips) 
Seat 5: Loholov ($17.90 in chips) 
Seat 6: chiyuki ($32.20 in chips) 
Seat 7: RikkStroken ($14.75 in chips) 
Seat 8: carlosrbr ($22.11 in chips) 
Seat 9: BlOnDhOlIc ($57.80 in chips) 
hirozo: posts small blind $0.10
Wilcox76607: posts big blind $0.25
*** HOLE CARDS ***
Dealt to chiyuki [8s Kc]
2997qwer: folds 
Loholov: folds 
chiyuki: folds 
RikkStroken: folds 
carlosrbr: folds 
BlOnDhOlIc: folds 
RomarioJa: folds 
hirozo: raises $0.25 to $0.50
Wilcox76607: calls $0.25
*** FLOP *** [As 6s 5c]
hirozo: checks 
Wilcox76607: bets $0.50
hirozo: raises $0.98 to $1.48
Wilcox76607: calls $0.98
*** TURN *** [As 6s 5c] [6d]
hirozo: checks 
Wilcox76607: checks 
*** RIVER *** [As 6s 5c 6d] [2c]
hirozo: checks 
Wilcox76607: bets $3
hirozo: folds 
Uncalled bet ($3) returned to Wilcox76607
Wilcox76607 collected $3.78 from pot
Wilcox76607: doesn't show hand 
*** SUMMARY ***
Total pot $3.96 | Rake $0.18 
Board [As 6s 5c 6d 2c]
Seat 1: RomarioJa (button) folded before Flop (didn't bet)
Seat 2: hirozo (small blind) folded on the River
Seat 3: Wilcox76607 (big blind) collected ($3.78)
Seat 4: 2997qwer folded before Flop (didn't bet)
Seat 5: Loholov folded before Flop (didn't bet)
Seat 6: chiyuki folded before Flop (didn't bet)
Seat 7: RikkStroken folded before Flop (didn't bet)
Seat 8: carlosrbr folded before Flop (didn't bet)
Seat 9: BlOnDhOlIc folded before Flop (didn't bet)



PokerStars Zoom Hand #84299083641:  Hold'em No Limit ($0.10/$0.25) - 2012/08/05 13:54:56 JST [2012/08/05 0:54:56 ET]
Table 'Whirlpool' 9-max Seat #1 is the button
Seat 1: Vahe50 ($29.75 in chips) 
Seat 2: BlOnDhOlIc ($45.68 in chips) 
Seat 3: NastyMcNast ($27.43 in chips) 
Seat 4: timburonps ($39.18 in chips) 
Seat 5: Dejacob ($34.05 in chips) 
Seat 6: Roglus ($15.88 in chips) 
Seat 7: ChrisCDee ($28.32 in chips) 
Seat 8: chiyuki ($32.10 in chips) 
Seat 9: 123progress ($38.69 in chips) 
BlOnDhOlIc: posts small blind $0.10
NastyMcNast: posts big blind $0.25
*** HOLE CARDS ***
Dealt to chiyuki [Qd Tc]
timburonps: folds 
Dejacob: folds 
Roglus: folds 
ChrisCDee: folds 
chiyuki: folds 
123progress: raises $0.37 to $0.62
Vahe50: folds 
BlOnDhOlIc: folds 
NastyMcNast: raises $1.63 to $2.25
123progress: folds 
Uncalled bet ($1.63) returned to NastyMcNast
NastyMcNast collected $1.34 from pot
NastyMcNast: doesn't show hand 
*** SUMMARY ***
Total pot $1.34 | Rake $0 
Seat 1: Vahe50 (button) folded before Flop (didn't bet)
Seat 2: BlOnDhOlIc (small blind) folded before Flop
Seat 3: NastyMcNast (big blind) collected ($1.34)
Seat 4: timburonps folded before Flop (didn't bet)
Seat 5: Dejacob folded before Flop (didn't bet)
Seat 6: Roglus folded before Flop (didn't bet)
Seat 7: ChrisCDee folded before Flop (didn't bet)
Seat 8: chiyuki folded before Flop (didn't bet)
Seat 9: 123progress folded before Flop



PokerStars Zoom Hand #84299081318:  Hold'em No Limit ($0.10/$0.25) - 2012/08/05 13:54:47 JST [2012/08/05 0:54:47 ET]
Table 'Whirlpool' 9-max Seat #1 is the button
Seat 1: mariuka1 ($12.97 in chips) 
Seat 2: PetitAlejo ($29.04 in chips) 
Seat 3: ChrisCDee ($40.44 in chips) 
Seat 4: chiyuki ($32.10 in chips) 
Seat 5: Paranoix1990 ($20.41 in chips) 
Seat 6: GoldNutter ($15.34 in chips) 
Seat 7: fwani ($36.85 in chips) 
Seat 8: cR!Ma*aRm ($32.35 in chips) 
Seat 9: NastyMcNast ($25 in chips) 
PetitAlejo: posts small blind $0.10
ChrisCDee: posts big blind $0.25
*** HOLE CARDS ***
Dealt to chiyuki [7d 4s]
chiyuki: folds 
Paranoix1990: folds 
GoldNutter: folds 
fwani: raises $0.35 to $0.60
cR!Ma*aRm: folds 
NastyMcNast: folds 
mariuka1: folds 
PetitAlejo: folds 
ChrisCDee: folds 
Uncalled bet ($0.35) returned to fwani
fwani collected $0.60 from pot
fwani: doesn't show hand 
*** SUMMARY ***
Total pot $0.60 | Rake $0 
Seat 1: mariuka1 (button) folded before Flop (didn't bet)
Seat 2: PetitAlejo (small blind) folded before Flop
Seat 3: ChrisCDee (big blind) folded before Flop
Seat 4: chiyuki folded before Flop (didn't bet)
Seat 5: Paranoix1990 folded before Flop (didn't bet)
Seat 6: GoldNutter folded before Flop (didn't bet)
Seat 7: fwani collected ($0.60)
Seat 8: cR!Ma*aRm folded before Flop (didn't bet)
Seat 9: NastyMcNast folded before Flop (didn't bet)



PokerStars Zoom Hand #84299087351:  Hold'em No Limit ($0.10/$0.25) - 2012/08/05 13:55:11 JST [2012/08/05 0:55:11 ET]
Table 'Whirlpool' 9-max Seat #1 is the button
Seat 1: Roglus ($15.63 in chips) 
Seat 2: agurio ($25 in chips) 
Seat 3: chiyuki ($32.10 in chips) 
Seat 4: PetitAlejo ($26.58 in chips) 
Seat 5: hirozo ($29.37 in chips) 
Seat 6: Nerkit ($12.65 in chips) 
Seat 7: KeLevro0 ($10.98 in chips) 
Seat 8: D@vidMed ($52.44 in chips) 
Seat 9: flyinprits ($34.96 in chips) 
agurio: posts small blind $0.10
chiyuki: posts big blind $0.25
*** HOLE CARDS ***
Dealt to chiyuki [Kc 2h]
PetitAlejo: folds 
hirozo: folds 
Nerkit: folds 
KeLevro0: folds 
D@vidMed: folds 
flyinprits: raises $0.50 to $0.75
Roglus: folds 
agurio: folds 
chiyuki: folds 
Uncalled bet ($0.50) returned to flyinprits
flyinprits collected $0.60 from pot
flyinprits: doesn't show hand 
*** SUMMARY ***
Total pot $0.60 | Rake $0 
Seat 1: Roglus (button) folded before Flop (didn't bet)
Seat 2: agurio (small blind) folded before Flop
Seat 3: chiyuki (big blind) folded before Flop
Seat 4: PetitAlejo folded before Flop (didn't bet)
Seat 5: hirozo folded before Flop (didn't bet)
Seat 6: Nerkit folded before Flop (didn't bet)
Seat 7: KeLevro0 folded before Flop (didn't bet)
Seat 8: D@vidMed folded before Flop (didn't bet)
Seat 9: flyinprits collected ($0.60)



PokerStars Zoom Hand #84299084354:  Hold'em No Limit ($0.10/$0.25) - 2012/08/05 13:54:59 JST [2012/08/05 0:54:59 ET]
Table 'Whirlpool' 9-max Seat #1 is the button
Seat 1: chiyuki ($32.10 in chips) 
Seat 2: Dafleche ($14.38 in chips) 
Seat 3: Roglus ($15.88 in chips) 
Seat 4: Jippyflip ($7.60 in chips) 
Seat 5: PetitAlejo ($28.94 in chips) 
Seat 6: RomarioJa ($14.30 in chips) 
Seat 7: Suhoff76 ($55.31 in chips) 
Seat 8: Loholov ($16.76 in chips) 
Seat 9: wtu1986 ($26.15 in chips) 
Dafleche: posts small blind $0.10
Roglus: posts big blind $0.25
*** HOLE CARDS ***
Dealt to chiyuki [4s Js]
Jippyflip: folds 
PetitAlejo: folds 
RomarioJa: folds 
Suhoff76: folds 
Loholov: raises $0.50 to $0.75
wtu1986: folds 
chiyuki: folds 
Dafleche: folds 
Roglus: folds 
Uncalled bet ($0.50) returned to Loholov
Loholov collected $0.60 from pot
Loholov: doesn't show hand 
*** SUMMARY ***
Total pot $0.60 | Rake $0 
Seat 1: chiyuki (button) folded before Flop (didn't bet)
Seat 2: Dafleche (small blind) folded before Flop
Seat 3: Roglus (big blind) folded before Flop
Seat 4: Jippyflip folded before Flop (didn't bet)
Seat 5: PetitAlejo folded before Flop (didn't bet)
Seat 6: RomarioJa folded before Flop (didn't bet)
Seat 7: Suhoff76 folded before Flop (didn't bet)
Seat 8: Loholov collected ($0.60)
Seat 9: wtu1986 folded before Flop (didn't bet)



PokerStars Zoom Hand #84299080591:  Hold'em No Limit ($0.10/$0.25) - 2012/08/05 13:54:44 JST [2012/08/05 0:54:44 ET]
Table 'Whirlpool' 9-max Seat #1 is the button
Seat 1: seula i ($59.50 in chips) 
Seat 2: 2997qwer ($10.05 in chips) 
Seat 3: carlosrbr ($22.11 in chips) 
Seat 4: flyinprits ($44.87 in chips) 
Seat 5: Suhoff76 ($38.93 in chips) 
Seat 6: hirozo ($29.37 in chips) 
Seat 7: giorgos_k ($14.97 in chips) 
Seat 8: timburonps ($29.47 in chips) 
Seat 9: chiyuki ($32.10 in chips) 
2997qwer: posts small blind $0.10
carlosrbr: posts big blind $0.25
*** HOLE CARDS ***
Dealt to chiyuki [Ks 3c]
flyinprits: raises $0.25 to $0.50
Suhoff76: folds 
hirozo: folds 
giorgos_k: calls $0.50
timburonps: folds 
chiyuki: folds 
seula i: folds 
2997qwer: folds 
carlosrbr: calls $0.25
*** FLOP *** [9h Td 3d]
carlosrbr: checks 
flyinprits: checks 
giorgos_k: checks 
*** TURN *** [9h Td 3d] [6c]
carlosrbr: checks 
flyinprits: checks 
giorgos_k: bets $0.75
carlosrbr: raises $1.50 to $2.25
flyinprits: folds 
giorgos_k: calls $1.50
*** RIVER *** [9h Td 3d 6c] [Tc]
carlosrbr: bets $2.75
giorgos_k: calls $2.75
*** SHOW DOWN ***
carlosrbr: shows [8d Jd] (a pair of Tens)
giorgos_k: shows [3s 4s] (two pair, Tens and Threes)
giorgos_k collected $11.08 from pot
*** SUMMARY ***
Total pot $11.60 | Rake $0.52 
Board [9h Td 3d 6c Tc]
Seat 1: seula i (button) folded before Flop (didn't bet)
Seat 2: 2997qwer (small blind) folded before Flop
Seat 3: carlosrbr (big blind) showed [8d Jd] and lost with a pair of Tens
Seat 4: flyinprits folded on the Turn
Seat 5: Suhoff76 folded before Flop (didn't bet)
Seat 6: hirozo folded before Flop (didn't bet)
Seat 7: giorgos_k showed [3s 4s] and won ($11.08) with two pair, Tens and Threes
Seat 8: timburonps folded before Flop (didn't bet)
Seat 9: chiyuki folded before Flop (didn't bet)



PokerStars Zoom Hand #84299092069:  Hold'em No Limit ($0.10/$0.25) - 2012/08/05 13:55:34 JST [2012/08/05 0:55:34 ET]
Table 'Whirlpool' 9-max Seat #1 is the button
Seat 1: TErr18 ($16.85 in chips) 
Seat 2: Suhoff76 ($55.06 in chips) 
Seat 3: Noviekid ($25 in chips) 
Seat 4: Vahe50 ($15.70 in chips) 
Seat 5: chiyuki ($31.75 in chips) 
Seat 6: Nerkit ($15.50 in chips) 
Seat 7: seula i ($59.85 in chips) 
Seat 8: timburonps ($42.39 in chips) 
Seat 9: KeLevro0 ($12.50 in chips) 
Suhoff76: posts small blind $0.10
Noviekid: posts big blind $0.25
*** HOLE CARDS ***
Dealt to chiyuki [Ad Qs]
Vahe50: folds 
chiyuki: raises $0.50 to $0.75
Nerkit: folds 
seula i: folds 
timburonps: folds 
KeLevro0: folds 
TErr18: folds 
Suhoff76: folds 
Noviekid: folds 
Uncalled bet ($0.50) returned to chiyuki
chiyuki collected $0.60 from pot
chiyuki: doesn't show hand 
*** SUMMARY ***
Total pot $0.60 | Rake $0 
Seat 1: TErr18 (button) folded before Flop (didn't bet)
Seat 2: Suhoff76 (small blind) folded before Flop
Seat 3: Noviekid (big blind) folded before Flop
Seat 4: Vahe50 folded before Flop (didn't bet)
Seat 5: chiyuki collected ($0.60)
Seat 6: Nerkit folded before Flop (didn't bet)
Seat 7: seula i folded before Flop (didn't bet)
Seat 8: timburonps folded before Flop (didn't bet)
Seat 9: KeLevro0 folded before Flop (didn't bet)



PokerStars Zoom Hand #84299090820:  Hold'em No Limit ($0.10/$0.25) - 2012/08/05 13:55:28 JST [2012/08/05 0:55:28 ET]
Table 'Whirlpool' 9-max Seat #1 is the button
Seat 1: 2997qwer ($14.77 in chips) 
Seat 2: chiyuki ($31.85 in chips) 
Seat 3: hirozo ($29.37 in chips) 
Seat 4: Anafim ($12.50 in chips) 
Seat 5: fwani ($30.54 in chips) 
Seat 6: Alvinpe85 ($49.99 in chips) 
Seat 7: timburonps ($42.39 in chips) 
Seat 8: Dejacob ($31.80 in chips) 
Seat 9: deadmoneykid ($36 in chips) 
chiyuki: posts small blind $0.10
hirozo: posts big blind $0.25
*** HOLE CARDS ***
Dealt to chiyuki [3s 5c]
Anafim: folds 
fwani: folds 
Alvinpe85: folds 
timburonps: folds 
Dejacob: raises $0.50 to $0.75
deadmoneykid: folds 
2997qwer: folds 
chiyuki: folds 
hirozo: folds 
Uncalled bet ($0.50) returned to Dejacob
Dejacob collected $0.60 from pot
Dejacob: doesn't show hand 
*** SUMMARY ***
Total pot $0.60 | Rake $0 
Seat 1: 2997qwer (button) folded before Flop (didn't bet)
Seat 2: chiyuki (small blind) folded before Flop
Seat 3: hirozo (big blind) folded before Flop
Seat 4: Anafim folded before Flop (didn't bet)
Seat 5: fwani folded before Flop (didn't bet)
Seat 6: Alvinpe85 folded before Flop (didn't bet)
Seat 7: timburonps folded before Flop (didn't bet)
Seat 8: Dejacob collected ($0.60)
Seat 9: deadmoneykid folded before Flop (didn't bet)



PokerStars Zoom Hand #84299096705:  Hold'em No Limit ($0.10/$0.25) - 2012/08/05 13:55:57 JST [2012/08/05 0:55:57 ET]
Table 'Whirlpool' 9-max Seat #1 is the button
Seat 1: KeLevro0 ($12.15 in chips) 
Seat 2: kamikkaze ($11.90 in chips) 
Seat 3: Lasutchik ($7.63 in chips) 
Seat 4: BlOnDhOlIc ($45.33 in chips) 
Seat 5: Anafim ($15.55 in chips) 
Seat 6: timburonps ($28.37 in chips) 
Seat 7: chiyuki ($32.10 in chips) 
Seat 8: Suhoff76 ($54.96 in chips) 
Seat 9: RomarioJa ($4.98 in chips) 
kamikkaze: posts small blind $0.10
Lasutchik: posts big blind $0.25
*** HOLE CARDS ***
Dealt to chiyuki [Ac 8c]
BlOnDhOlIc: folds 
Anafim: folds 
timburonps: folds 
chiyuki: folds 
Suhoff76: folds 
RomarioJa: folds 
KeLevro0: folds 
kamikkaze: folds 
Uncalled bet ($0.15) returned to Lasutchik
Lasutchik collected $0.20 from pot
Lasutchik: doesn't show hand 
*** SUMMARY ***
Total pot $0.20 | Rake $0 
Seat 1: KeLevro0 (button) folded before Flop (didn't bet)
Seat 2: kamikkaze (small blind) folded before Flop
Seat 3: Lasutchik (big blind) collected ($0.20)
Seat 4: BlOnDhOlIc folded before Flop (didn't bet)
Seat 5: Anafim folded before Flop (didn't bet)
Seat 6: timburonps folded before Flop (didn't bet)
Seat 7: chiyuki folded before Flop (didn't bet)
Seat 8: Suhoff76 folded before Flop (didn't bet)
Seat 9: RomarioJa folded before Flop (didn't bet)



PokerStars Zoom Hand #84299099820:  Hold'em No Limit ($0.10/$0.25) - 2012/08/05 13:56:12 JST [2012/08/05 0:56:12 ET]
Table 'Whirlpool' 9-max Seat #1 is the button
Seat 1: cR!Ma*aRm ($32.35 in chips) 
Seat 2: leo2095 ($14.71 in chips) 
Seat 3: NastyMcNast ($36 in chips) 
Seat 4: chiyuki ($32.10 in chips) 
Seat 5: Vahe50 ($30.10 in chips) 
Seat 6: ladymadon107 ($15.45 in chips) 
Seat 7: Suhoff76 ($26.78 in chips) 
Seat 8: Nerkit ($12.30 in chips) 
Seat 9: mariuka1 ($12.62 in chips) 
leo2095: posts small blind $0.10
NastyMcNast: posts big blind $0.25
*** HOLE CARDS ***
Dealt to chiyuki [7h 5h]
chiyuki: folds 
Vahe50: folds 
ladymadon107: folds 
Suhoff76: folds 
Nerkit: folds 
mariuka1: folds 
cR!Ma*aRm: folds 
leo2095: folds 
Uncalled bet ($0.15) returned to NastyMcNast
NastyMcNast collected $0.20 from pot
NastyMcNast: doesn't show hand 
*** SUMMARY ***
Total pot $0.20 | Rake $0 
Seat 1: cR!Ma*aRm (button) folded before Flop (didn't bet)
Seat 2: leo2095 (small blind) folded before Flop
Seat 3: NastyMcNast (big blind) collected ($0.20)
Seat 4: chiyuki folded before Flop (didn't bet)
Seat 5: Vahe50 folded before Flop (didn't bet)
Seat 6: ladymadon107 folded before Flop (didn't bet)
Seat 7: Suhoff76 folded before Flop (didn't bet)
Seat 8: Nerkit folded before Flop (didn't bet)
Seat 9: mariuka1 folded before Flop (didn't bet)



PokerStars Zoom Hand #84299101054:  Hold'em No Limit ($0.10/$0.25) - 2012/08/05 13:56:18 JST [2012/08/05 0:56:18 ET]
Table 'Whirlpool' 9-max Seat #1 is the button
Seat 1: PetitAlejo ($30.62 in chips) 
Seat 2: giorgos_k ($16.61 in chips) 
Seat 3: kamikkaze ($15 in chips) 
Seat 4: Loholov ($15.35 in chips) 
Seat 5: ladymadon107 ($15.45 in chips) 
Seat 6: chiyuki ($32.10 in chips) 
Seat 7: Alvinpe85 ($47.99 in chips) 
Seat 8: Anafim ($15.55 in chips) 
Seat 9: cR!Ma*aRm ($32.35 in chips) 
giorgos_k: posts small blind $0.10
kamikkaze: posts big blind $0.25
*** HOLE CARDS ***
Dealt to chiyuki [Ad Qs]
Loholov: folds 
ladymadon107: folds 
chiyuki: raises $0.50 to $0.75
Alvinpe85: folds 
Anafim: folds 
cR!Ma*aRm: folds 
PetitAlejo: folds 
giorgos_k: folds 
kamikkaze: folds 
Uncalled bet ($0.50) returned to chiyuki
chiyuki collected $0.60 from pot
chiyuki: doesn't show hand 
*** SUMMARY ***
Total pot $0.60 | Rake $0 
Seat 1: PetitAlejo (button) folded before Flop (didn't bet)
Seat 2: giorgos_k (small blind) folded before Flop
Seat 3: kamikkaze (big blind) folded before Flop
Seat 4: Loholov folded before Flop (didn't bet)
Seat 5: ladymadon107 folded before Flop (didn't bet)
Seat 6: chiyuki collected ($0.60)
Seat 7: Alvinpe85 folded before Flop (didn't bet)
Seat 8: Anafim folded before Flop (didn't bet)
Seat 9: cR!Ma*aRm folded before Flop (didn't bet)



PokerStars Zoom Hand #84299098602:  Hold'em No Limit ($0.10/$0.25) - 2012/08/05 13:56:06 JST [2012/08/05 0:56:06 ET]
Table 'Whirlpool' 9-max Seat #1 is the button
Seat 1: Dejacob ($49.23 in chips) 
Seat 2: BlOnDhOlIc ($62.02 in chips) 
Seat 3: JAMESOZZY ($13.29 in chips) 
Seat 4: 2997qwer ($9.60 in chips) 
Seat 5: RomarioJa ($14.54 in chips) 
Seat 6: Faraz ($28.75 in chips) 
Seat 7: NastyMcNast ($36 in chips) 
Seat 8: deadmoneykid ($36.10 in chips) 
Seat 9: chiyuki ($32.10 in chips) 
BlOnDhOlIc: posts small blind $0.10
JAMESOZZY: posts big blind $0.25
*** HOLE CARDS ***
Dealt to chiyuki [2d Kc]
2997qwer: folds 
RomarioJa: raises $0.50 to $0.75
Faraz: folds 
NastyMcNast: folds 
deadmoneykid: folds 
chiyuki: folds 
Dejacob: folds 
BlOnDhOlIc: folds 
JAMESOZZY: calls $0.50
*** FLOP *** [Kd 9d Tc]
JAMESOZZY: checks 
RomarioJa: bets $1.14
JAMESOZZY: folds 
Uncalled bet ($1.14) returned to RomarioJa
RomarioJa collected $1.53 from pot
RomarioJa: doesn't show hand 
*** SUMMARY ***
Total pot $1.60 | Rake $0.07 
Board [Kd 9d Tc]
Seat 1: Dejacob (button) folded before Flop (didn't bet)
Seat 2: BlOnDhOlIc (small blind) folded before Flop
Seat 3: JAMESOZZY (big blind) folded on the Flop
Seat 4: 2997qwer folded before Flop (didn't bet)
Seat 5: RomarioJa collected ($1.53)
Seat 6: Faraz folded before Flop (didn't bet)
Seat 7: NastyMcNast folded before Flop (didn't bet)
Seat 8: deadmoneykid folded before Flop (didn't bet)
Seat 9: chiyuki folded before Flop (didn't bet)



PokerStars Zoom Hand #84299106265:  Hold'em No Limit ($0.10/$0.25) - 2012/08/05 13:56:44 JST [2012/08/05 0:56:44 ET]
Table 'Whirlpool' 9-max Seat #1 is the button
Seat 1: chiyuki ($32.45 in chips) 
Seat 2: timburonps ($39.18 in chips) 
Seat 3: Faraz ($29.10 in chips) 
Seat 4: RikkStroken ($14.65 in chips) 
Seat 5: Nerkit ($15.15 in chips) 
Seat 6: Ellen1947 ($38.33 in chips) 
Seat 7: RomarioJa ($7.13 in chips) 
Seat 8: wtu1986 ($24.90 in chips) 
Seat 9: Csabee21 ($26.03 in chips) 
timburonps: posts small blind $0.10
Faraz: posts big blind $0.25
*** HOLE CARDS ***
Dealt to chiyuki [Jd Th]
RikkStroken: folds 
Nerkit: folds 
Ellen1947: folds 
RomarioJa: folds 
wtu1986: folds 
Csabee21: raises $0.50 to $0.75
chiyuki: folds 
timburonps: folds 
Faraz: folds 
Uncalled bet ($0.50) returned to Csabee21
Csabee21 collected $0.60 from pot
Csabee21: doesn't show hand 
*** SUMMARY ***
Total pot $0.60 | Rake $0 
Seat 1: chiyuki (button) folded before Flop (didn't bet)
Seat 2: timburonps (small blind) folded before Flop
Seat 3: Faraz (big blind) folded before Flop
Seat 4: RikkStroken folded before Flop (didn't bet)
Seat 5: Nerkit folded before Flop (didn't bet)
Seat 6: Ellen1947 folded before Flop (didn't bet)
Seat 7: RomarioJa folded before Flop (didn't bet)
Seat 8: wtu1986 folded before Flop (didn't bet)
Seat 9: Csabee21 collected ($0.60)



PokerStars Zoom Hand #84299104980:  Hold'em No Limit ($0.10/$0.25) - 2012/08/05 13:56:38 JST [2012/08/05 0:56:38 ET]
Table 'Whirlpool' 9-max Seat #1 is the button
Seat 1: giorgos_k ($16.70 in chips) 
Seat 2: KAKamiro ($39.06 in chips) 
Seat 3: KeLevro0 ($10.63 in chips) 
Seat 4: deadmoneykid ($27.39 in chips) 
Seat 5: leo2095 ($14.61 in chips) 
Seat 6: Rudolf ($54.87 in chips) 
Seat 7: seula i ($25.35 in chips) 
Seat 8: chiyuki ($32.45 in chips) 
Seat 9: simonzez ($36.28 in chips) 
KAKamiro: posts small blind $0.10
KeLevro0: posts big blind $0.25
*** HOLE CARDS ***
Dealt to chiyuki [7c 6d]
deadmoneykid: folds 
leo2095: folds 
Rudolf: folds 
seula i: folds 
chiyuki: folds 
simonzez: calls $0.25
giorgos_k: folds 
KAKamiro: calls $0.15
KeLevro0: raises $0.75 to $1
simonzez: calls $0.75
KAKamiro: calls $0.75
*** FLOP *** [Th 3s As]
KAKamiro: checks 
KeLevro0: checks 
simonzez: checks 
*** TURN *** [Th 3s As] [Ad]
KAKamiro: checks 
KeLevro0: checks 
simonzez: checks 
*** RIVER *** [Th 3s As Ad] [3c]
KAKamiro: bets $0.50
KeLevro0: folds 
simonzez: calls $0.50
*** SHOW DOWN ***
KAKamiro: shows [Tc 6c] (two pair, Aces and Tens)
simonzez: mucks hand 
KAKamiro collected $3.82 from pot
*** SUMMARY ***
Total pot $4 | Rake $0.18 
Board [Th 3s As Ad 3c]
Seat 1: giorgos_k (button) folded before Flop (didn't bet)
Seat 2: KAKamiro (small blind) showed [Tc 6c] and won ($3.82) with two pair, Aces and Tens
Seat 3: KeLevro0 (big blind) folded on the River
Seat 4: deadmoneykid folded before Flop (didn't bet)
Seat 5: leo2095 folded before Flop (didn't bet)
Seat 6: Rudolf folded before Flop (didn't bet)
Seat 7: seula i folded before Flop (didn't bet)
Seat 8: chiyuki folded before Flop (didn't bet)
Seat 9: simonzez mucked [Jd Qh]



PokerStars Zoom Hand #84299110338:  Hold'em No Limit ($0.10/$0.25) - 2012/08/05 13:57:04 JST [2012/08/05 0:57:04 ET]
Table 'Whirlpool' 9-max Seat #1 is the button
Seat 1: hirozo ($26.42 in chips) 
Seat 2: RikkStroken ($14.65 in chips) 
Seat 3: timburonps ($44.61 in chips) 
Seat 4: Landybob ($35 in chips) 
Seat 5: chiyuki ($32.45 in chips) 
Seat 6: petersmiths ($30.02 in chips) 
Seat 7: agurio ($25 in chips) 
Seat 8: 2997qwer ($12.25 in chips) 
Seat 9: deadmoneykid ($36 in chips) 
RikkStroken: posts small blind $0.10
timburonps: posts big blind $0.25
*** HOLE CARDS ***
Dealt to chiyuki [5h Qc]
Landybob: folds 
chiyuki: folds 
petersmiths: folds 
agurio: folds 
2997qwer: raises $0.50 to $0.75
deadmoneykid: calls $0.75
hirozo: folds 
RikkStroken: raises $2.25 to $3
timburonps: folds 
2997qwer: folds 
deadmoneykid: folds 
Uncalled bet ($2.25) returned to RikkStroken
RikkStroken collected $2.50 from pot
RikkStroken: doesn't show hand 
*** SUMMARY ***
Total pot $2.50 | Rake $0 
Seat 1: hirozo (button) folded before Flop (didn't bet)
Seat 2: RikkStroken (small blind) collected ($2.50)
Seat 3: timburonps (big blind) folded before Flop
Seat 4: Landybob folded before Flop (didn't bet)
Seat 5: chiyuki folded before Flop (didn't bet)
Seat 6: petersmiths folded before Flop (didn't bet)
Seat 7: agurio folded before Flop (didn't bet)
Seat 8: 2997qwer folded before Flop
Seat 9: deadmoneykid folded before Flop



PokerStars Zoom Hand #84299116829:  Hold'em No Limit ($0.10/$0.25) - 2012/08/05 13:57:35 JST [2012/08/05 0:57:35 ET]
Table 'Whirlpool' 9-max Seat #1 is the button
Seat 1: NastyMcNast ($36 in chips) 
Seat 2: DjJooni ($41.80 in chips) 
Seat 3: 123progress ($37.57 in chips) 
Seat 4: PetitAlejo ($26.92 in chips) 
Seat 5: BlOnDhOlIc ($57.45 in chips) 
Seat 6: chiyuki ($32.20 in chips) 
Seat 7: Suhoff76 ($37.96 in chips) 
Seat 8: KeLevro0 ($12.15 in chips) 
Seat 9: zaffaroots ($25.35 in chips) 
DjJooni: posts small blind $0.10
123progress: posts big blind $0.25
*** HOLE CARDS ***
Dealt to chiyuki [4c Qs]
PetitAlejo: raises $0.50 to $0.75
BlOnDhOlIc: folds 
chiyuki: folds 
Suhoff76: folds 
KeLevro0: folds 
zaffaroots: folds 
NastyMcNast: folds 
DjJooni: folds 
123progress: folds 
Uncalled bet ($0.50) returned to PetitAlejo
PetitAlejo collected $0.60 from pot
PetitAlejo: doesn't show hand 
*** SUMMARY ***
Total pot $0.60 | Rake $0 
Seat 1: NastyMcNast (button) folded before Flop (didn't bet)
Seat 2: DjJooni (small blind) folded before Flop
Seat 3: 123progress (big blind) folded before Flop
Seat 4: PetitAlejo collected ($0.60)
Seat 5: BlOnDhOlIc folded before Flop (didn't bet)
Seat 6: chiyuki folded before Flop (didn't bet)
Seat 7: Suhoff76 folded before Flop (didn't bet)
Seat 8: KeLevro0 folded before Flop (didn't bet)
Seat 9: zaffaroots folded before Flop (didn't bet)



PokerStars Zoom Hand #84299118865:  Hold'em No Limit ($0.10/$0.25) - 2012/08/05 13:57:45 JST [2012/08/05 0:57:45 ET]
Table 'Whirlpool' 9-max Seat #1 is the button
Seat 1: Nerkit ($12.15 in chips) 
Seat 2: Dejacob ($48.23 in chips) 
Seat 3: Vahe50 ($15 in chips) 
Seat 4: Loholov ($15 in chips) 
Seat 5: chiyuki ($32.10 in chips) 
Seat 6: Th3Fog ($64.64 in chips) 
Seat 7: hirozo ($26.42 in chips) 
Seat 8: Roglus ($73.30 in chips) 
Seat 9: seula i ($65.52 in chips) 
Dejacob: posts small blind $0.10
Vahe50: posts big blind $0.25
*** HOLE CARDS ***
Dealt to chiyuki [Kc 7d]
Loholov: folds 
chiyuki: folds 
Th3Fog: folds 
hirozo: folds 
Roglus: folds 
seula i: folds 
Nerkit: folds 
Dejacob: folds 
Uncalled bet ($0.15) returned to Vahe50
Vahe50 collected $0.20 from pot
Vahe50: doesn't show hand 
*** SUMMARY ***
Total pot $0.20 | Rake $0 
Seat 1: Nerkit (button) folded before Flop (didn't bet)
Seat 2: Dejacob (small blind) folded before Flop
Seat 3: Vahe50 (big blind) collected ($0.20)
Seat 4: Loholov folded before Flop (didn't bet)
Seat 5: chiyuki folded before Flop (didn't bet)
Seat 6: Th3Fog folded before Flop (didn't bet)
Seat 7: hirozo folded before Flop (didn't bet)
Seat 8: Roglus folded before Flop (didn't bet)
Seat 9: seula i folded before Flop (didn't bet)



PokerStars Zoom Hand #84299111153:  Hold'em No Limit ($0.10/$0.25) - 2012/08/05 13:57:08 JST [2012/08/05 0:57:08 ET]
Table 'Whirlpool' 9-max Seat #1 is the button
Seat 1: silvno31 ($45.69 in chips) 
Seat 2: wtu1986 ($25 in chips) 
Seat 3: chiyuki ($32.45 in chips) 
Seat 4: Nerkit ($12.30 in chips) 
Seat 5: giorgos_k ($16.70 in chips) 
Seat 6: agurio ($25 in chips) 
Seat 7: fwani ($32.23 in chips) 
Seat 8: BlackZafiro ($47.44 in chips) 
Seat 9: DanielWhyte ($19.68 in chips) 
wtu1986: posts small blind $0.10
chiyuki: posts big blind $0.25
*** HOLE CARDS ***
Dealt to chiyuki [5s 6d]
Nerkit: folds 
giorgos_k: folds 
agurio: raises $0.75 to $1
fwani: calls $1
BlackZafiro: calls $1
DanielWhyte: folds 
silvno31: folds 
wtu1986: folds 
chiyuki: folds 
*** FLOP *** [Qc 9h 4s]
agurio: bets $2
fwani: folds 
BlackZafiro: folds 
Uncalled bet ($2) returned to agurio
agurio collected $3.20 from pot
agurio: doesn't show hand 
*** SUMMARY ***
Total pot $3.35 | Rake $0.15 
Board [Qc 9h 4s]
Seat 1: silvno31 (button) folded before Flop (didn't bet)
Seat 2: wtu1986 (small blind) folded before Flop
Seat 3: chiyuki (big blind) folded before Flop
Seat 4: Nerkit folded before Flop (didn't bet)
Seat 5: giorgos_k folded before Flop (didn't bet)
Seat 6: agurio collected ($3.20)
Seat 7: fwani folded on the Flop
Seat 8: BlackZafiro folded on the Flop
Seat 9: DanielWhyte folded before Flop (didn't bet)



PokerStars Zoom Hand #84299120924:  Hold'em No Limit ($0.10/$0.25) - 2012/08/05 13:57:56 JST [2012/08/05 0:57:56 ET]
Table 'Whirlpool' 9-max Seat #1 is the button
Seat 1: chiyuki ($32.10 in chips) 
Seat 2: Nerkit ($15.50 in chips) 
Seat 3: wtu1986 ($24.90 in chips) 
Seat 4: Loholov ($15 in chips) 
Seat 5: giorgos_k ($15.16 in chips) 
Seat 6: KeLevro0 ($12.15 in chips) 
Seat 7: Tom1999 ($15.35 in chips) 
Seat 8: seula i ($41.70 in chips) 
Seat 9: roksmokndonk ($37.18 in chips) 
Nerkit: posts small blind $0.10
wtu1986: posts big blind $0.25
*** HOLE CARDS ***
Dealt to chiyuki [4d Kh]
Loholov: folds 
giorgos_k: folds 
KeLevro0: folds 
Tom1999: folds 
seula i: folds 
roksmokndonk: folds 
chiyuki: folds 
Nerkit: folds 
Uncalled bet ($0.15) returned to wtu1986
wtu1986 collected $0.20 from pot
wtu1986: doesn't show hand 
*** SUMMARY ***
Total pot $0.20 | Rake $0 
Seat 1: chiyuki (button) folded before Flop (didn't bet)
Seat 2: Nerkit (small blind) folded before Flop
Seat 3: wtu1986 (big blind) collected ($0.20)
Seat 4: Loholov folded before Flop (didn't bet)
Seat 5: giorgos_k folded before Flop (didn't bet)
Seat 6: KeLevro0 folded before Flop (didn't bet)
Seat 7: Tom1999 folded before Flop (didn't bet)
Seat 8: seula i folded before Flop (didn't bet)
Seat 9: roksmokndonk folded before Flop (didn't bet)



PokerStars Zoom Hand #84299117679:  Hold'em No Limit ($0.10/$0.25) - 2012/08/05 13:57:39 JST [2012/08/05 0:57:39 ET]
Table 'Whirlpool' 9-max Seat #1 is the button
Seat 1: Dejacob ($48.23 in chips) 
Seat 2: chiyuki ($32.20 in chips) 
Seat 3: Dafleche ($15.29 in chips) 
Seat 4: seula i ($65.52 in chips) 
Seat 5: Loholov ($15 in chips) 
Seat 6: fwani ($34.95 in chips) 
Seat 7: Tom1999 ($15 in chips) 
Seat 8: ChrisCDee ($25.79 in chips) 
Seat 9: Suhoff76 ($52.14 in chips) 
chiyuki: posts small blind $0.10
Dafleche: posts big blind $0.25
*** HOLE CARDS ***
Dealt to chiyuki [4h 5d]
seula i: folds 
Loholov: folds 
fwani: raises $0.35 to $0.60
Tom1999: folds 
ChrisCDee: calls $0.60
Suhoff76: folds 
Dejacob: folds 
chiyuki: folds 
Dafleche: folds 
*** FLOP *** [Ah 7d 7c]
fwani: bets $1.10
ChrisCDee: folds 
Uncalled bet ($1.10) returned to fwani
fwani collected $1.48 from pot
fwani: doesn't show hand 
*** SUMMARY ***
Total pot $1.55 | Rake $0.07 
Board [Ah 7d 7c]
Seat 1: Dejacob (button) folded before Flop (didn't bet)
Seat 2: chiyuki (small blind) folded before Flop
Seat 3: Dafleche (big blind) folded before Flop
Seat 4: seula i folded before Flop (didn't bet)
Seat 5: Loholov folded before Flop (didn't bet)
Seat 6: fwani collected ($1.48)
Seat 7: Tom1999 folded before Flop (didn't bet)
Seat 8: ChrisCDee folded on the Flop
Seat 9: Suhoff76 folded before Flop (didn't bet)



PokerStars Zoom Hand #84299119904:  Hold'em No Limit ($0.10/$0.25) - 2012/08/05 13:57:51 JST [2012/08/05 0:57:51 ET]
Table 'Whirlpool' 9-max Seat #1 is the button
Seat 1: 2997qwer ($11.50 in chips) 
Seat 2: fezman ($12.25 in chips) 
Seat 3: PetitAlejo ($31.22 in chips) 
Seat 4: Alvinpe85 ($37.48 in chips) 
Seat 5: BlOnDhOlIc ($62.37 in chips) 
Seat 6: 123progress ($30 in chips) 
Seat 7: wtu1986 ($25.80 in chips) 
Seat 8: Dejacob ($48.13 in chips) 
Seat 9: chiyuki ($32.10 in chips) 
fezman: posts small blind $0.10
PetitAlejo: posts big blind $0.25
*** HOLE CARDS ***
Dealt to chiyuki [Kc 2h]
Alvinpe85: folds 
BlOnDhOlIc: folds 
123progress: folds 
wtu1986: folds 
Dejacob: folds 
chiyuki: folds 
2997qwer: raises $0.50 to $0.75
fezman: calls $0.65
PetitAlejo: folds 
*** FLOP *** [Js 2s Kd]
fezman: bets $1
2997qwer: folds 
Uncalled bet ($1) returned to fezman
fezman collected $1.67 from pot
fezman: doesn't show hand 
*** SUMMARY ***
Total pot $1.75 | Rake $0.08 
Board [Js 2s Kd]
Seat 1: 2997qwer (button) folded on the Flop
Seat 2: fezman (small blind) collected ($1.67)
Seat 3: PetitAlejo (big blind) folded before Flop
Seat 4: Alvinpe85 folded before Flop (didn't bet)
Seat 5: BlOnDhOlIc folded before Flop (didn't bet)
Seat 6: 123progress folded before Flop (didn't bet)
Seat 7: wtu1986 folded before Flop (didn't bet)
Seat 8: Dejacob folded before Flop (didn't bet)
Seat 9: chiyuki folded before Flop (didn't bet)



PokerStars Zoom Hand #84299123169:  Hold'em No Limit ($0.10/$0.25) - 2012/08/05 13:58:07 JST [2012/08/05 0:58:07 ET]
Table 'Whirlpool' 9-max Seat #1 is the button
Seat 1: Dejacob ($32.25 in chips) 
Seat 2: agurio ($25.56 in chips) 
Seat 3: munky3 ($37.14 in chips) 
Seat 4: giorgos_k ($15.16 in chips) 
Seat 5: seula i ($65.52 in chips) 
Seat 6: Lasutchik ($34.01 in chips) 
Seat 7: kamikkaze ($17.96 in chips) 
Seat 8: chiyuki ($32.10 in chips) 
Seat 9: puffy5533 ($22.60 in chips) 
agurio: posts small blind $0.10
munky3: posts big blind $0.25
*** HOLE CARDS ***
Dealt to chiyuki [3h Ah]
giorgos_k: folds 
seula i: folds 
Lasutchik: folds 
kamikkaze: folds 
chiyuki: folds 
puffy5533: folds 
Dejacob: folds 
agurio: folds 
Uncalled bet ($0.15) returned to munky3
munky3 collected $0.20 from pot
munky3: doesn't show hand 
*** SUMMARY ***
Total pot $0.20 | Rake $0 
Seat 1: Dejacob (button) folded before Flop (didn't bet)
Seat 2: agurio (small blind) folded before Flop
Seat 3: munky3 (big blind) collected ($0.20)
Seat 4: giorgos_k folded before Flop (didn't bet)
Seat 5: seula i folded before Flop (didn't bet)
Seat 6: Lasutchik folded before Flop (didn't bet)
Seat 7: kamikkaze folded before Flop (didn't bet)
Seat 8: chiyuki folded before Flop (didn't bet)
Seat 9: puffy5533 folded before Flop (didn't bet)



PokerStars Zoom Hand #84299125021:  Hold'em No Limit ($0.10/$0.25) - 2012/08/05 13:58:16 JST [2012/08/05 0:58:16 ET]
Table 'Whirlpool' 9-max Seat #1 is the button
Seat 1: kamikkaze ($14.30 in chips) 
Seat 2: KeLevro0 ($12.25 in chips) 
Seat 3: timburonps ($39.78 in chips) 
Seat 4: agurio ($27.20 in chips) 
Seat 5: chiyuki ($32.10 in chips) 
Seat 6: silvno31 ($44.59 in chips) 
Seat 7: Suhoff76 ($52.14 in chips) 
Seat 8: Dejacob ($48.13 in chips) 
Seat 9: ygoegoe ($38.88 in chips) 
KeLevro0: posts small blind $0.10
timburonps: posts big blind $0.25
*** HOLE CARDS ***
Dealt to chiyuki [2c 7c]
agurio: folds 
chiyuki: folds 
silvno31: folds 
Suhoff76: folds 
Dejacob: folds 
ygoegoe: folds 
kamikkaze: folds 
KeLevro0: folds 
Uncalled bet ($0.15) returned to timburonps
timburonps collected $0.20 from pot
timburonps: doesn't show hand 
*** SUMMARY ***
Total pot $0.20 | Rake $0 
Seat 1: kamikkaze (button) folded before Flop (didn't bet)
Seat 2: KeLevro0 (small blind) folded before Flop
Seat 3: timburonps (big blind) collected ($0.20)
Seat 4: agurio folded before Flop (didn't bet)
Seat 5: chiyuki folded before Flop (didn't bet)
Seat 6: silvno31 folded before Flop (didn't bet)
Seat 7: Suhoff76 folded before Flop (didn't bet)
Seat 8: Dejacob folded before Flop (didn't bet)
Seat 9: ygoegoe folded before Flop (didn't bet)



PokerStars Zoom Hand #84299125823:  Hold'em No Limit ($0.10/$0.25) - 2012/08/05 13:58:20 JST [2012/08/05 0:58:20 ET]
Table 'Whirlpool' 9-max Seat #1 is the button
Seat 1: KeLevro0 ($13.53 in chips) 
Seat 2: Alvinpe85 ($58.67 in chips) 
Seat 3: chiyuki ($32.10 in chips) 
Seat 4: Lasutchik ($7.98 in chips) 
Seat 5: silvno31 ($44.59 in chips) 
Seat 6: leo2095 ($13.76 in chips) 
Seat 7: Suhoff76 ($25 in chips) 
Seat 8: flyinprits ($24.02 in chips) 
Seat 9: fwani ($42.44 in chips) 
Alvinpe85: posts small blind $0.10
chiyuki: posts big blind $0.25
*** HOLE CARDS ***
Dealt to chiyuki [Jc 4c]
Lasutchik: folds 
silvno31: raises $0.50 to $0.75
leo2095: folds 
Suhoff76: folds 
flyinprits: folds 
fwani: folds 
KeLevro0: folds 
Alvinpe85: folds 
chiyuki: folds 
Uncalled bet ($0.50) returned to silvno31
silvno31 collected $0.60 from pot
silvno31: doesn't show hand 
*** SUMMARY ***
Total pot $0.60 | Rake $0 
Seat 1: KeLevro0 (button) folded before Flop (didn't bet)
Seat 2: Alvinpe85 (small blind) folded before Flop
Seat 3: chiyuki (big blind) folded before Flop
Seat 4: Lasutchik folded before Flop (didn't bet)
Seat 5: silvno31 collected ($0.60)
Seat 6: leo2095 folded before Flop (didn't bet)
Seat 7: Suhoff76 folded before Flop (didn't bet)
Seat 8: flyinprits folded before Flop (didn't bet)
Seat 9: fwani folded before Flop (didn't bet)



PokerStars Zoom Hand #84299127720:  Hold'em No Limit ($0.10/$0.25) - 2012/08/05 13:58:29 JST [2012/08/05 0:58:29 ET]
Table 'Whirlpool' 9-max Seat #1 is the button
Seat 1: KAKamiro ($42.97 in chips) 
Seat 2: 2997qwer ($11.55 in chips) 
Seat 3: MrJarte ($25 in chips) 
Seat 4: seula i ($25 in chips) 
Seat 5: NastyMcNast ($26.24 in chips) 
Seat 6: Loholov ($19.20 in chips) 
Seat 7: agurio ($25.46 in chips) 
Seat 8: chiyuki ($31.85 in chips) 
Seat 9: leo2095 ($13.76 in chips) 
2997qwer: posts small blind $0.10
MrJarte: posts big blind $0.25
*** HOLE CARDS ***
Dealt to chiyuki [Kh Tc]
seula i: folds 
NastyMcNast: folds 
Loholov: folds 
agurio: folds 
chiyuki: folds 
leo2095: folds 
KAKamiro: folds 
2997qwer: folds 
Uncalled bet ($0.15) returned to MrJarte
MrJarte collected $0.20 from pot
MrJarte: doesn't show hand 
*** SUMMARY ***
Total pot $0.20 | Rake $0 
Seat 1: KAKamiro (button) folded before Flop (didn't bet)
Seat 2: 2997qwer (small blind) folded before Flop
Seat 3: MrJarte (big blind) collected ($0.20)
Seat 4: seula i folded before Flop (didn't bet)
Seat 5: NastyMcNast folded before Flop (didn't bet)
Seat 6: Loholov folded before Flop (didn't bet)
Seat 7: agurio folded before Flop (didn't bet)
Seat 8: chiyuki folded before Flop (didn't bet)
Seat 9: leo2095 folded before Flop (didn't bet)



PokerStars Zoom Hand #84299116176:  Hold'em No Limit ($0.10/$0.25) - 2012/08/05 13:57:32 JST [2012/08/05 0:57:32 ET]
Table 'Whirlpool' 9-max Seat #1 is the button
Seat 1: TErr18 ($16.15 in chips) 
Seat 2: solawind ($13.92 in chips) 
Seat 3: GoldNutter ($15.91 in chips) 
Seat 4: ChrisCDee ($25.79 in chips) 
Seat 5: flyinprits ($44.82 in chips) 
Seat 6: Dejacob ($32.15 in chips) 
Seat 7: chiyuki ($32.20 in chips) 
Seat 8: DanielWhyte ($19.68 in chips) 
Seat 9: RikkStroken ($18.07 in chips) 
solawind: posts small blind $0.10
GoldNutter: posts big blind $0.25
*** HOLE CARDS ***
Dealt to chiyuki [7s Qh]
ChrisCDee: folds 
flyinprits: folds 
Dejacob: folds 
chiyuki: folds 
DanielWhyte: raises $0.50 to $0.75
RikkStroken: calls $0.75
TErr18: folds 
solawind: folds 
GoldNutter: calls $0.50
*** FLOP *** [9c 9d Ad]
GoldNutter: checks 
DanielWhyte: bets $0.50
RikkStroken: calls $0.50
GoldNutter: folds 
*** TURN *** [9c 9d Ad] [7c]
DanielWhyte: checks 
RikkStroken: bets $2
DanielWhyte: calls $2
*** RIVER *** [9c 9d Ad 7c] [Kd]
DanielWhyte: checks 
RikkStroken: checks 
*** SHOW DOWN ***
DanielWhyte: shows [Ks Ah] (two pair, Aces and Kings)
RikkStroken: mucks hand 
DanielWhyte collected $7.02 from pot
*** SUMMARY ***
Total pot $7.35 | Rake $0.33 
Board [9c 9d Ad 7c Kd]
Seat 1: TErr18 (button) folded before Flop (didn't bet)
Seat 2: solawind (small blind) folded before Flop
Seat 3: GoldNutter (big blind) folded on the Flop
Seat 4: ChrisCDee folded before Flop (didn't bet)
Seat 5: flyinprits folded before Flop (didn't bet)
Seat 6: Dejacob folded before Flop (didn't bet)
Seat 7: chiyuki folded before Flop (didn't bet)
Seat 8: DanielWhyte showed [Ks Ah] and won ($7.02) with two pair, Aces and Kings
Seat 9: RikkStroken mucked [4h 4d]



PokerStars Zoom Hand #84299123813:  Hold'em No Limit ($0.10/$0.25) - 2012/08/05 13:58:10 JST [2012/08/05 0:58:10 ET]
Table 'Whirlpool' 9-max Seat #1 is the button
Seat 1: hirozo ($25.25 in chips) 
Seat 2: BlOnDhOlIc ($57.20 in chips) 
Seat 3: NastyMcNast ($26.49 in chips) 
Seat 4: carlosrbr ($16.61 in chips) 
Seat 5: ChrisCDee ($38.19 in chips) 
Seat 6: chiyuki ($32.10 in chips) 
Seat 7: wtu1986 ($24.55 in chips) 
Seat 8: Suhoff76 ($41.73 in chips) 
Seat 9: giorgos_k ($15.16 in chips) 
BlOnDhOlIc: posts small blind $0.10
NastyMcNast: posts big blind $0.25
*** HOLE CARDS ***
Dealt to chiyuki [Jd Th]
carlosrbr: raises $0.50 to $0.75
ChrisCDee: folds 
chiyuki: folds 
wtu1986: folds 
Suhoff76: folds 
giorgos_k: calls $0.75
hirozo: calls $0.75
BlOnDhOlIc: folds 
NastyMcNast: folds 
*** FLOP *** [9c 6s 2c]
carlosrbr: bets $1.50
giorgos_k: calls $1.50
hirozo: folds 
*** TURN *** [9c 6s 2c] [8h]
carlosrbr: bets $2.75
giorgos_k: calls $2.75
*** RIVER *** [9c 6s 2c 8h] [7s]
carlosrbr: checks 
giorgos_k: checks 
*** SHOW DOWN ***
carlosrbr: shows [Qd Kc] (high card King)
giorgos_k: shows [8d 7d] (two pair, Eights and Sevens)
giorgos_k collected $10.60 from pot
*** SUMMARY ***
Total pot $11.10 | Rake $0.50 
Board [9c 6s 2c 8h 7s]
Seat 1: hirozo (button) folded on the Flop
Seat 2: BlOnDhOlIc (small blind) folded before Flop
Seat 3: NastyMcNast (big blind) folded before Flop
Seat 4: carlosrbr showed [Qd Kc] and lost with high card King
Seat 5: ChrisCDee folded before Flop (didn't bet)
Seat 6: chiyuki folded before Flop (didn't bet)
Seat 7: wtu1986 folded before Flop (didn't bet)
Seat 8: Suhoff76 folded before Flop (didn't bet)
Seat 9: giorgos_k showed [8d 7d] and won ($10.60) with two pair, Eights and Sevens



PokerStars Zoom Hand #84299129762:  Hold'em No Limit ($0.10/$0.25) - 2012/08/05 13:58:39 JST [2012/08/05 0:58:39 ET]
Table 'Whirlpool' 9-max Seat #1 is the button
Seat 1: Th3Fog ($21.29 in chips) 
Seat 2: chiyuki ($31.85 in chips) 
Seat 3: fwani ($35.83 in chips) 
Seat 4: Suhoff76 ($25 in chips) 
Seat 5: Loholov ($19.20 in chips) 
Seat 6: kamikkaze ($13.55 in chips) 
Seat 7: Dafleche ($14.94 in chips) 
Seat 8: kkbruins0408 ($12.74 in chips) 
Seat 9: 2997qwer ($11.45 in chips) 
chiyuki: posts small blind $0.10
fwani: posts big blind $0.25
*** HOLE CARDS ***
Dealt to chiyuki [6d 6c]
Suhoff76: folds 
Loholov: folds 
kamikkaze: folds 
Dafleche: folds 
kkbruins0408 has timed out
kkbruins0408: folds 
2997qwer: folds 
Th3Fog: folds 
chiyuki: raises $0.50 to $0.75
fwani: folds 
Uncalled bet ($0.50) returned to chiyuki
chiyuki collected $0.50 from pot
chiyuki: doesn't show hand 
*** SUMMARY ***
Total pot $0.50 | Rake $0 
Seat 1: Th3Fog (button) folded before Flop (didn't bet)
Seat 2: chiyuki (small blind) collected ($0.50)
Seat 3: fwani (big blind) folded before Flop
Seat 4: Suhoff76 folded before Flop (didn't bet)
Seat 5: Loholov folded before Flop (didn't bet)
Seat 6: kamikkaze folded before Flop (didn't bet)
Seat 7: Dafleche folded before Flop (didn't bet)
Seat 8: kkbruins0408 folded before Flop (didn't bet)
Seat 9: 2997qwer folded before Flop (didn't bet)



PokerStars Zoom Hand #84299128779:  Hold'em No Limit ($0.10/$0.25) - 2012/08/05 13:58:34 JST [2012/08/05 0:58:34 ET]
Table 'Whirlpool' 9-max Seat #1 is the button
Seat 1: ll_LaMeR_ll ($74.56 in chips) 
Seat 2: Tom1999 ($15.10 in chips) 
Seat 3: silvno31 ($44.94 in chips) 
Seat 4: wtu1986 ($25.55 in chips) 
Seat 5: KAKamiro ($42.97 in chips) 
Seat 6: hirozo ($28.27 in chips) 
Seat 7: chiyuki ($31.85 in chips) 
Seat 8: cr0lox ($14.52 in chips) 
Seat 9: Nerkit ($12.05 in chips) 
Tom1999: posts small blind $0.10
silvno31: posts big blind $0.25
*** HOLE CARDS ***
Dealt to chiyuki [7c 4s]
wtu1986: folds 
KAKamiro: calls $0.25
hirozo: folds 
chiyuki: folds 
cr0lox: folds 
Nerkit: calls $0.25
ll_LaMeR_ll: folds 
Tom1999: folds 
silvno31: checks 
*** FLOP *** [Js Ac Qd]
silvno31: checks 
KAKamiro: checks 
Nerkit: checks 
*** TURN *** [Js Ac Qd] [3d]
silvno31: checks 
KAKamiro: checks 
Nerkit: bets $0.50
silvno31: folds 
KAKamiro: folds 
Uncalled bet ($0.50) returned to Nerkit
Nerkit collected $0.81 from pot
Nerkit: doesn't show hand 
*** SUMMARY ***
Total pot $0.85 | Rake $0.04 
Board [Js Ac Qd 3d]
Seat 1: ll_LaMeR_ll (button) folded before Flop (didn't bet)
Seat 2: Tom1999 (small blind) folded before Flop
Seat 3: silvno31 (big blind) folded on the Turn
Seat 4: wtu1986 folded before Flop (didn't bet)
Seat 5: KAKamiro folded on the Turn
Seat 6: hirozo folded before Flop (didn't bet)
Seat 7: chiyuki folded before Flop (didn't bet)
Seat 8: cr0lox folded before Flop (didn't bet)
Seat 9: Nerkit collected ($0.81)



PokerStars Zoom Hand #84299138131:  Hold'em No Limit ($0.10/$0.25) - 2012/08/05 13:59:21 JST [2012/08/05 0:59:21 ET]
Table 'Whirlpool' 9-max Seat #1 is the button
Seat 1: carlosrbr ($11.51 in chips) 
Seat 2: KeLevro0 ($13.18 in chips) 
Seat 3: 2997qwer ($10.65 in chips) 
Seat 4: RomarioJa ($13.06 in chips) 
Seat 5: softdesign ($75.03 in chips) 
Seat 6: PetitAlejo ($27.37 in chips) 
Seat 7: seula i ($25.10 in chips) 
Seat 8: fezman ($18.18 in chips) 
Seat 9: chiyuki ($32.10 in chips) 
KeLevro0: posts small blind $0.10
2997qwer: posts big blind $0.25
*** HOLE CARDS ***
Dealt to chiyuki [2d 7c]
RomarioJa: folds 
softdesign: folds 
PetitAlejo: folds 
seula i: folds 
fezman: raises $0.25 to $0.50
chiyuki: folds 
carlosrbr: folds 
KeLevro0: folds 
2997qwer: folds 
Uncalled bet ($0.25) returned to fezman
fezman collected $0.60 from pot
fezman: doesn't show hand 
*** SUMMARY ***
Total pot $0.60 | Rake $0 
Seat 1: carlosrbr (button) folded before Flop (didn't bet)
Seat 2: KeLevro0 (small blind) folded before Flop
Seat 3: 2997qwer (big blind) folded before Flop
Seat 4: RomarioJa folded before Flop (didn't bet)
Seat 5: softdesign folded before Flop (didn't bet)
Seat 6: PetitAlejo folded before Flop (didn't bet)
Seat 7: seula i folded before Flop (didn't bet)
Seat 8: fezman collected ($0.60)
Seat 9: chiyuki folded before Flop (didn't bet)



PokerStars Zoom Hand #84299137300:  Hold'em No Limit ($0.10/$0.25) - 2012/08/05 13:59:17 JST [2012/08/05 0:59:17 ET]
Table 'Whirlpool' 9-max Seat #1 is the button
Seat 1: silvno31 ($44.69 in chips) 
Seat 2: DanielWhyte ($23.20 in chips) 
Seat 3: PetitAlejo ($28.62 in chips) 
Seat 4: chiyuki ($32.10 in chips) 
Seat 5: BlackZafiro ($25 in chips) 
Seat 6: Nerkit ($15.85 in chips) 
Seat 7: Vahe50 ($13.08 in chips) 
Seat 8: BlOnDhOlIc ($62.02 in chips) 
Seat 9: seula i ($39.45 in chips) 
DanielWhyte: posts small blind $0.10
PetitAlejo: posts big blind $0.25
*** HOLE CARDS ***
Dealt to chiyuki [2h 8s]
chiyuki: folds 
BlackZafiro: folds 
Nerkit: folds 
Vahe50: folds 
BlOnDhOlIc: folds 
seula i: folds 
silvno31: folds 
DanielWhyte: raises $0.50 to $0.75
PetitAlejo: folds 
Uncalled bet ($0.50) returned to DanielWhyte
DanielWhyte collected $0.50 from pot
DanielWhyte: doesn't show hand 
*** SUMMARY ***
Total pot $0.50 | Rake $0 
Seat 1: silvno31 (button) folded before Flop (didn't bet)
Seat 2: DanielWhyte (small blind) collected ($0.50)
Seat 3: PetitAlejo (big blind) folded before Flop
Seat 4: chiyuki folded before Flop (didn't bet)
Seat 5: BlackZafiro folded before Flop (didn't bet)
Seat 6: Nerkit folded before Flop (didn't bet)
Seat 7: Vahe50 folded before Flop (didn't bet)
Seat 8: BlOnDhOlIc folded before Flop (didn't bet)
Seat 9: seula i folded before Flop (didn't bet)



PokerStars Zoom Hand #84299140784:  Hold'em No Limit ($0.10/$0.25) - 2012/08/05 13:59:34 JST [2012/08/05 0:59:34 ET]
Table 'Whirlpool' 9-max Seat #1 is the button
Seat 1: cR!Ma*aRm ($12.68 in chips) 
Seat 2: BlackZafiro ($25 in chips) 
Seat 3: puffy5533 ($21.85 in chips) 
Seat 4: chiyuki ($32.10 in chips) 
Seat 5: Rudolf ($52.12 in chips) 
Seat 6: softdesign ($75.03 in chips) 
Seat 7: zaffaroots ($18.69 in chips) 
Seat 8: agurio ($25.11 in chips) 
Seat 9: NastyMcNast ($26.14 in chips) 
BlackZafiro: posts small blind $0.10
puffy5533: posts big blind $0.25
*** HOLE CARDS ***
Dealt to chiyuki [8h 9h]
chiyuki: folds 
Rudolf: folds 
softdesign: folds 
zaffaroots: raises $0.50 to $0.75
agurio: folds 
NastyMcNast: folds 
cR!Ma*aRm: folds 
BlackZafiro: folds 
puffy5533: folds 
Uncalled bet ($0.50) returned to zaffaroots
zaffaroots collected $0.60 from pot
zaffaroots: doesn't show hand 
*** SUMMARY ***
Total pot $0.60 | Rake $0 
Seat 1: cR!Ma*aRm (button) folded before Flop (didn't bet)
Seat 2: BlackZafiro (small blind) folded before Flop
Seat 3: puffy5533 (big blind) folded before Flop
Seat 4: chiyuki folded before Flop (didn't bet)
Seat 5: Rudolf folded before Flop (didn't bet)
Seat 6: softdesign folded before Flop (didn't bet)
Seat 7: zaffaroots collected ($0.60)
Seat 8: agurio folded before Flop (didn't bet)
Seat 9: NastyMcNast folded before Flop (didn't bet)



PokerStars Zoom Hand #84299141985:  Hold'em No Limit ($0.10/$0.25) - 2012/08/05 13:59:40 JST [2012/08/05 0:59:40 ET]
Table 'Whirlpool' 9-max Seat #1 is the button
Seat 1: wtu1986 ($31.13 in chips) 
Seat 2: Landybob ($36.89 in chips) 
Seat 3: Faraz ($29.54 in chips) 
Seat 4: hirozo ($28.02 in chips) 
Seat 5: chiyuki ($32.10 in chips) 
Seat 6: D@vidMed ($52.44 in chips) 
Seat 7: deadmoneykid ($28.14 in chips) 
Seat 8: kamikkaze ($10.82 in chips) 
Seat 9: Ellen1947 ($32.25 in chips) 
Landybob: posts small blind $0.10
Faraz: posts big blind $0.25
*** HOLE CARDS ***
Dealt to chiyuki [6d As]
hirozo: folds 
chiyuki: folds 
D@vidMed: folds 
deadmoneykid: folds 
kamikkaze: folds 
Ellen1947: folds 
wtu1986: folds 
Landybob: folds 
Uncalled bet ($0.15) returned to Faraz
Faraz collected $0.20 from pot
Faraz: doesn't show hand 
*** SUMMARY ***
Total pot $0.20 | Rake $0 
Seat 1: wtu1986 (button) folded before Flop (didn't bet)
Seat 2: Landybob (small blind) folded before Flop
Seat 3: Faraz (big blind) collected ($0.20)
Seat 4: hirozo folded before Flop (didn't bet)
Seat 5: chiyuki folded before Flop (didn't bet)
Seat 6: D@vidMed folded before Flop (didn't bet)
Seat 7: deadmoneykid folded before Flop (didn't bet)
Seat 8: kamikkaze folded before Flop (didn't bet)
Seat 9: Ellen1947 folded before Flop (didn't bet)



PokerStars Zoom Hand #84299139801:  Hold'em No Limit ($0.10/$0.25) - 2012/08/05 13:59:29 JST [2012/08/05 0:59:29 ET]
Table 'Whirlpool' 9-max Seat #1 is the button
Seat 1: chiyuki ($32.10 in chips) 
Seat 2: silvno31 ($44.69 in chips) 
Seat 3: Suhoff76 ($25 in chips) 
Seat 4: seula i ($25 in chips) 
Seat 5: RikkStroken ($16.40 in chips) 
Seat 6: Anafim ($12.50 in chips) 
Seat 7: deadmoneykid ($20.60 in chips) 
Seat 8: softdesign ($75.03 in chips) 
Seat 9: KAKamiro ($42.72 in chips) 
silvno31: posts small blind $0.10
Suhoff76: posts big blind $0.25
*** HOLE CARDS ***
Dealt to chiyuki [Ts 3h]
seula i: folds 
RikkStroken: folds 
Anafim: raises $0.25 to $0.50
deadmoneykid: folds 
softdesign: folds 
KAKamiro: calls $0.50
chiyuki: folds 
silvno31: calls $0.40
Suhoff76: folds 
*** FLOP *** [Jd 9d Ac]
silvno31: checks 
Anafim: checks 
KAKamiro: bets $0.50
silvno31: folds 
Anafim: folds 
Uncalled bet ($0.50) returned to KAKamiro
KAKamiro collected $1.67 from pot
KAKamiro: doesn't show hand 
*** SUMMARY ***
Total pot $1.75 | Rake $0.08 
Board [Jd 9d Ac]
Seat 1: chiyuki (button) folded before Flop (didn't bet)
Seat 2: silvno31 (small blind) folded on the Flop
Seat 3: Suhoff76 (big blind) folded before Flop
Seat 4: seula i folded before Flop (didn't bet)
Seat 5: RikkStroken folded before Flop (didn't bet)
Seat 6: Anafim folded on the Flop
Seat 7: deadmoneykid folded before Flop (didn't bet)
Seat 8: softdesign folded before Flop (didn't bet)
Seat 9: KAKamiro collected ($1.67)



PokerStars Zoom Hand #84299142984:  Hold'em No Limit ($0.10/$0.25) - 2012/08/05 13:59:45 JST [2012/08/05 0:59:45 ET]
Table 'Whirlpool' 9-max Seat #1 is the button
Seat 1: Alvinpe85 ($37.13 in chips) 
Seat 2: 2997qwer ($9.20 in chips) 
Seat 3: chiyuki ($32.10 in chips) 
Seat 4: hirozo ($28.92 in chips) 
Seat 5: fezman ($18.53 in chips) 
Seat 6: deadmoneykid ($28.14 in chips) 
Seat 7: kamikkaze ($10.82 in chips) 
Seat 8: timburonps ($28.02 in chips) 
Seat 9: Dafleche ($14.59 in chips) 
2997qwer: posts small blind $0.10
chiyuki: posts big blind $0.25
*** HOLE CARDS ***
Dealt to chiyuki [8s Th]
hirozo: folds 
fezman: folds 
deadmoneykid: folds 
kamikkaze: folds 
timburonps: folds 
Dafleche: raises $0.25 to $0.50
Alvinpe85: calls $0.50
2997qwer: folds 
chiyuki: calls $0.25
*** FLOP *** [4d Qh 6s]
chiyuki: checks 
Dafleche: bets $1
Alvinpe85: folds 
chiyuki: folds 
Uncalled bet ($1) returned to Dafleche
Dafleche collected $1.53 from pot
Dafleche: doesn't show hand 
*** SUMMARY ***
Total pot $1.60 | Rake $0.07 
Board [4d Qh 6s]
Seat 1: Alvinpe85 (button) folded on the Flop
Seat 2: 2997qwer (small blind) folded before Flop
Seat 3: chiyuki (big blind) folded on the Flop
Seat 4: hirozo folded before Flop (didn't bet)
Seat 5: fezman folded before Flop (didn't bet)
Seat 6: deadmoneykid folded before Flop (didn't bet)
Seat 7: kamikkaze folded before Flop (didn't bet)
Seat 8: timburonps folded before Flop (didn't bet)
Seat 9: Dafleche collected ($1.53)



PokerStars Zoom Hand #84299149370:  Hold'em No Limit ($0.10/$0.25) - 2012/08/05 14:00:11 JST [2012/08/05 1:00:11 ET]
Table 'Whirlpool' 9-max Seat #1 is the button
Seat 1: ChrisCDee ($37.09 in chips) 
Seat 2: RikkStroken ($14.60 in chips) 
Seat 3: 123progress ($39.28 in chips) 
Seat 4: agurio ($25.11 in chips) 
Seat 5: Paranoix1990 ($16.39 in chips) 
Seat 6: hirozo ($26.20 in chips) 
Seat 7: 2997qwer ($10.30 in chips) 
Seat 8: Dejacob ($41.89 in chips) 
Seat 9: chiyuki ($31.60 in chips) 
RikkStroken: posts small blind $0.10
123progress: posts big blind $0.25
*** HOLE CARDS ***
Dealt to chiyuki [Ah Jc]
agurio: folds 
Paranoix1990: folds 
hirozo: folds 
2997qwer: folds 
Dejacob: folds 
chiyuki: raises $0.50 to $0.75
ChrisCDee: folds 
RikkStroken: folds 
123progress: folds 
Uncalled bet ($0.50) returned to chiyuki
chiyuki collected $0.60 from pot
chiyuki: doesn't show hand 
*** SUMMARY ***
Total pot $0.60 | Rake $0 
Seat 1: ChrisCDee (button) folded before Flop (didn't bet)
Seat 2: RikkStroken (small blind) folded before Flop
Seat 3: 123progress (big blind) folded before Flop
Seat 4: agurio folded before Flop (didn't bet)
Seat 5: Paranoix1990 folded before Flop (didn't bet)
Seat 6: hirozo folded before Flop (didn't bet)
Seat 7: 2997qwer folded before Flop (didn't bet)
Seat 8: Dejacob folded before Flop (didn't bet)
Seat 9: chiyuki collected ($0.60)



PokerStars Zoom Hand #84299152876:  Hold'em No Limit ($0.10/$0.25) - 2012/08/05 14:00:28 JST [2012/08/05 1:00:28 ET]
Table 'Whirlpool' 9-max Seat #1 is the button
Seat 1: RikkStroken ($16.15 in chips) 
Seat 2: Anafim ($14.45 in chips) 
Seat 3: hirozo ($29.17 in chips) 
Seat 4: Csabee21 ($26.94 in chips) 
Seat 5: wtu1986 ($25.25 in chips) 
Seat 6: Roglus ($18.41 in chips) 
Seat 7: chiyuki ($31.95 in chips) 
Seat 8: agurio ($27.20 in chips) 
Seat 9: Dejacob ($28.30 in chips) 
Anafim: posts small blind $0.10
hirozo: posts big blind $0.25
*** HOLE CARDS ***
Dealt to chiyuki [6h Jd]
Csabee21: folds 
wtu1986: folds 
Roglus: folds 
chiyuki: folds 
agurio: folds 
Dejacob: folds 
RikkStroken: folds 
Anafim: folds 
Uncalled bet ($0.15) returned to hirozo
hirozo collected $0.20 from pot
hirozo: doesn't show hand 
*** SUMMARY ***
Total pot $0.20 | Rake $0 
Seat 1: RikkStroken (button) folded before Flop (didn't bet)
Seat 2: Anafim (small blind) folded before Flop
Seat 3: hirozo (big blind) collected ($0.20)
Seat 4: Csabee21 folded before Flop (didn't bet)
Seat 5: wtu1986 folded before Flop (didn't bet)
Seat 6: Roglus folded before Flop (didn't bet)
Seat 7: chiyuki folded before Flop (didn't bet)
Seat 8: agurio folded before Flop (didn't bet)
Seat 9: Dejacob folded before Flop (didn't bet)



PokerStars Zoom Hand #84299155819:  Hold'em No Limit ($0.10/$0.25) - 2012/08/05 14:00:41 JST [2012/08/05 1:00:41 ET]
Table 'Whirlpool' 9-max Seat #1 is the button
Seat 1: agurio ($25 in chips) 
Seat 2: chiyuki ($31.95 in chips) 
Seat 3: jeff0923 ($24.42 in chips) 
Seat 4: ygoegoe ($35.91 in chips) 
Seat 5: Anafim ($14.35 in chips) 
Seat 6: seula i ($65.02 in chips) 
Seat 7: Suhoff76 ($25 in chips) 
Seat 8: flyinprits ($46.64 in chips) 
Seat 9: wtu1986 ($25 in chips) 
chiyuki: posts small blind $0.10
jeff0923: posts big blind $0.25
*** HOLE CARDS ***
Dealt to chiyuki [4c 8h]
ygoegoe: folds 
Anafim: folds 
seula i: folds 
Suhoff76: folds 
flyinprits: folds 
wtu1986: folds 
agurio: folds 
chiyuki: folds 
Uncalled bet ($0.15) returned to jeff0923
jeff0923 collected $0.20 from pot
jeff0923: doesn't show hand 
*** SUMMARY ***
Total pot $0.20 | Rake $0 
Seat 1: agurio (button) folded before Flop (didn't bet)
Seat 2: chiyuki (small blind) folded before Flop
Seat 3: jeff0923 (big blind) collected ($0.20)
Seat 4: ygoegoe folded before Flop (didn't bet)
Seat 5: Anafim folded before Flop (didn't bet)
Seat 6: seula i folded before Flop (didn't bet)
Seat 7: Suhoff76 folded before Flop (didn't bet)
Seat 8: flyinprits folded before Flop (didn't bet)
Seat 9: wtu1986 folded before Flop (didn't bet)



PokerStars Zoom Hand #84299154903:  Hold'em No Limit ($0.10/$0.25) - 2012/08/05 14:00:37 JST [2012/08/05 1:00:37 ET]
Table 'Whirlpool' 9-max Seat #1 is the button
Seat 1: KeLevro0 ($13.18 in chips) 
Seat 2: Th3Fog ($76.87 in chips) 
Seat 3: DanielWhyte ($22.78 in chips) 
Seat 4: chiyuki ($31.95 in chips) 
Seat 5: Suhoff76 ($25 in chips) 
Seat 6: Nerkit ($12.11 in chips) 
Seat 7: BlOnDhOlIc ($61.67 in chips) 
Seat 8: Ellen1947 ($38.78 in chips) 
Seat 9: cR!Ma*aRm ($13.69 in chips) 
Th3Fog: posts small blind $0.10
DanielWhyte: posts big blind $0.25
*** HOLE CARDS ***
Dealt to chiyuki [2c 9h]
chiyuki: folds 
Suhoff76: folds 
Nerkit: folds 
BlOnDhOlIc: folds 
Ellen1947: folds 
cR!Ma*aRm: calls $0.25
KeLevro0: raises $0.75 to $1
Th3Fog: folds 
DanielWhyte: folds 
cR!Ma*aRm: folds 
Uncalled bet ($0.75) returned to KeLevro0
KeLevro0 collected $0.85 from pot
KeLevro0: doesn't show hand 
*** SUMMARY ***
Total pot $0.85 | Rake $0 
Seat 1: KeLevro0 (button) collected ($0.85)
Seat 2: Th3Fog (small blind) folded before Flop
Seat 3: DanielWhyte (big blind) folded before Flop
Seat 4: chiyuki folded before Flop (didn't bet)
Seat 5: Suhoff76 folded before Flop (didn't bet)
Seat 6: Nerkit folded before Flop (didn't bet)
Seat 7: BlOnDhOlIc folded before Flop (didn't bet)
Seat 8: Ellen1947 folded before Flop (didn't bet)
Seat 9: cR!Ma*aRm folded before Flop



PokerStars Zoom Hand #84299157012:  Hold'em No Limit ($0.10/$0.25) - 2012/08/05 14:00:46 JST [2012/08/05 1:00:46 ET]
Table 'Whirlpool' 9-max Seat #1 is the button
Seat 1: chiyuki ($31.85 in chips) 
Seat 2: BlOnDhOlIc ($61.67 in chips) 
Seat 3: ygoegoe ($35.91 in chips) 
Seat 4: D@vidMed ($52.79 in chips) 
Seat 5: simonzez ($35.97 in chips) 
Seat 6: wtu1986 ($25.55 in chips) 
Seat 7: Lasutchik ($33.14 in chips) 
Seat 8: ChrisCDee ($31.73 in chips) 
Seat 9: Anafim ($14.35 in chips) 
BlOnDhOlIc: posts small blind $0.10
ygoegoe: posts big blind $0.25
*** HOLE CARDS ***
Dealt to chiyuki [6c Ad]
D@vidMed: folds 
simonzez: folds 
wtu1986: folds 
Lasutchik: folds 
ChrisCDee: folds 
Anafim: folds 
chiyuki: raises $0.50 to $0.75
BlOnDhOlIc: raises $1.25 to $2
ygoegoe: folds 
chiyuki: folds 
Uncalled bet ($1.25) returned to BlOnDhOlIc
BlOnDhOlIc collected $1.75 from pot
BlOnDhOlIc: doesn't show hand 
*** SUMMARY ***
Total pot $1.75 | Rake $0 
Seat 1: chiyuki (button) folded before Flop
Seat 2: BlOnDhOlIc (small blind) collected ($1.75)
Seat 3: ygoegoe (big blind) folded before Flop
Seat 4: D@vidMed folded before Flop (didn't bet)
Seat 5: simonzez folded before Flop (didn't bet)
Seat 6: wtu1986 folded before Flop (didn't bet)
Seat 7: Lasutchik folded before Flop (didn't bet)
Seat 8: ChrisCDee folded before Flop (didn't bet)
Seat 9: Anafim folded before Flop (didn't bet)



PokerStars Zoom Hand #84299163988:  Hold'em No Limit ($0.10/$0.25) - 2012/08/05 14:01:15 JST [2012/08/05 1:01:15 ET]
Table 'Whirlpool' 9-max Seat #1 is the button
Seat 1: Perstenev ($12.65 in chips) 
Seat 2: Nerkit ($16.07 in chips) 
Seat 3: chiyuki ($31.10 in chips) 
Seat 4: RomarioJa ($6.40 in chips) 
Seat 5: hirozo ($26.85 in chips) 
Seat 6: 123progress ($39.63 in chips) 
Seat 7: KeLevro0 ($9.53 in chips) 
Seat 8: PetitAlejo ($35.62 in chips) 
Seat 9: wtu1986 ($30.78 in chips) 
Nerkit: posts small blind $0.10
chiyuki: posts big blind $0.25
*** HOLE CARDS ***
Dealt to chiyuki [As 3d]
RomarioJa: folds 
hirozo: folds 
123progress: folds 
KeLevro0: folds 
PetitAlejo: folds 
wtu1986: folds 
Perstenev: folds 
Nerkit: folds 
Uncalled bet ($0.15) returned to chiyuki
chiyuki collected $0.20 from pot
chiyuki: doesn't show hand 
*** SUMMARY ***
Total pot $0.20 | Rake $0 
Seat 1: Perstenev (button) folded before Flop (didn't bet)
Seat 2: Nerkit (small blind) folded before Flop
Seat 3: chiyuki (big blind) collected ($0.20)
Seat 4: RomarioJa folded before Flop (didn't bet)
Seat 5: hirozo folded before Flop (didn't bet)
Seat 6: 123progress folded before Flop (didn't bet)
Seat 7: KeLevro0 folded before Flop (didn't bet)
Seat 8: PetitAlejo folded before Flop (didn't bet)
Seat 9: wtu1986 folded before Flop (didn't bet)



PokerStars Zoom Hand #84299163034:  Hold'em No Limit ($0.10/$0.25) - 2012/08/05 14:01:11 JST [2012/08/05 1:01:11 ET]
Table 'Whirlpool' 9-max Seat #1 is the button
Seat 1: Dejacob ($51 in chips) 
Seat 2: giorgos_k ($9.75 in chips) 
Seat 3: puffy5533 ($22.60 in chips) 
Seat 4: fwani ($25.25 in chips) 
Seat 5: jeff0923 ($24.52 in chips) 
Seat 6: Faraz ($30.32 in chips) 
Seat 7: chiyuki ($31.10 in chips) 
Seat 8: Nerkit ($12.40 in chips) 
Seat 9: KeLevro0 ($9.53 in chips) 
giorgos_k: posts small blind $0.10
puffy5533: posts big blind $0.25
*** HOLE CARDS ***
Dealt to chiyuki [Js 3c]
fwani: folds 
jeff0923: folds 
Faraz: folds 
chiyuki: folds 
Nerkit: folds 
KeLevro0: folds 
Dejacob: raises $0.50 to $0.75
giorgos_k: folds 
puffy5533: raises $1.75 to $2.50
Dejacob: folds 
Uncalled bet ($1.75) returned to puffy5533
puffy5533 collected $1.60 from pot
puffy5533: doesn't show hand 
*** SUMMARY ***
Total pot $1.60 | Rake $0 
Seat 1: Dejacob (button) folded before Flop
Seat 2: giorgos_k (small blind) folded before Flop
Seat 3: puffy5533 (big blind) collected ($1.60)
Seat 4: fwani folded before Flop (didn't bet)
Seat 5: jeff0923 folded before Flop (didn't bet)
Seat 6: Faraz folded before Flop (didn't bet)
Seat 7: chiyuki folded before Flop (didn't bet)
Seat 8: Nerkit folded before Flop (didn't bet)
Seat 9: KeLevro0 folded before Flop (didn't bet)



PokerStars Zoom Hand #84299170020:  Hold'em No Limit ($0.10/$0.25) - 2012/08/05 14:01:40 JST [2012/08/05 1:01:40 ET]
Table 'Whirlpool' 9-max Seat #1 is the button
Seat 1: Th3Fog ($18.14 in chips) 
Seat 2: RikkStroken ($25.10 in chips) 
Seat 3: Leftymouse ($25 in chips) 
Seat 4: PetitAlejo ($28.02 in chips) 
Seat 5: DanielWhyte ($26.11 in chips) 
Seat 6: KeLevro0 ($12.48 in chips) 
Seat 7: Perstenev ($12.65 in chips) 
Seat 8: chiyuki ($31.20 in chips) 
Seat 9: Nec Arg ($24.75 in chips) 
RikkStroken: posts small blind $0.10
Leftymouse: posts big blind $0.25
*** HOLE CARDS ***
Dealt to chiyuki [8c As]
PetitAlejo: folds 
DanielWhyte: folds 
KeLevro0: folds 
Perstenev: folds 
chiyuki: folds 
Nec Arg: folds 
Th3Fog: folds 
RikkStroken: folds 
Uncalled bet ($0.15) returned to Leftymouse
Leftymouse collected $0.20 from pot
Leftymouse: doesn't show hand 
*** SUMMARY ***
Total pot $0.20 | Rake $0 
Seat 1: Th3Fog (button) folded before Flop (didn't bet)
Seat 2: RikkStroken (small blind) folded before Flop
Seat 3: Leftymouse (big blind) collected ($0.20)
Seat 4: PetitAlejo folded before Flop (didn't bet)
Seat 5: DanielWhyte folded before Flop (didn't bet)
Seat 6: KeLevro0 folded before Flop (didn't bet)
Seat 7: Perstenev folded before Flop (didn't bet)
Seat 8: chiyuki folded before Flop (didn't bet)
Seat 9: Nec Arg folded before Flop (didn't bet)



PokerStars Zoom Hand #84299167696:  Hold'em No Limit ($0.10/$0.25) - 2012/08/05 14:01:31 JST [2012/08/05 1:01:31 ET]
Table 'Whirlpool' 9-max Seat #1 is the button
Seat 1: PetitAlejo ($34.73 in chips) 
Seat 2: Perstenev ($12.65 in chips) 
Seat 3: RomarioJa ($12.15 in chips) 
Seat 4: ChrisCDee ($37.44 in chips) 
Seat 5: kamikkaze ($16.06 in chips) 
Seat 6: chiyuki ($31.20 in chips) 
Seat 7: BlOnDhOlIc ($48.13 in chips) 
Seat 8: fezman ($14.43 in chips) 
Seat 9: Roglus ($17.56 in chips) 
Perstenev: posts small blind $0.10
RomarioJa: posts big blind $0.25
*** HOLE CARDS ***
Dealt to chiyuki [Jh 6c]
ChrisCDee: raises $0.50 to $0.75
kamikkaze: folds 
chiyuki: folds 
BlOnDhOlIc: folds 
fezman: folds 
Roglus: folds 
PetitAlejo: folds 
Perstenev: folds 
RomarioJa: folds 
Uncalled bet ($0.50) returned to ChrisCDee
ChrisCDee collected $0.60 from pot
ChrisCDee: doesn't show hand 
*** SUMMARY ***
Total pot $0.60 | Rake $0 
Seat 1: PetitAlejo (button) folded before Flop (didn't bet)
Seat 2: Perstenev (small blind) folded before Flop
Seat 3: RomarioJa (big blind) folded before Flop
Seat 4: ChrisCDee collected ($0.60)
Seat 5: kamikkaze folded before Flop (didn't bet)
Seat 6: chiyuki folded before Flop (didn't bet)
Seat 7: BlOnDhOlIc folded before Flop (didn't bet)
Seat 8: fezman folded before Flop (didn't bet)
Seat 9: Roglus folded before Flop (didn't bet)



PokerStars Zoom Hand #84299171367:  Hold'em No Limit ($0.10/$0.25) - 2012/08/05 14:01:45 JST [2012/08/05 1:01:45 ET]
Table 'Whirlpool' 9-max Seat #1 is the button
Seat 1: DanielWhyte ($26.11 in chips) 
Seat 2: BlackZafiro ($25.10 in chips) 
Seat 3: Noviekid ($29.54 in chips) 
Seat 4: chiyuki ($31.20 in chips) 
Seat 5: KeLevro0 ($12.48 in chips) 
Seat 6: Perstenev ($12.65 in chips) 
Seat 7: PetitAlejo ($34.73 in chips) 
Seat 8: Th3Fog ($65.29 in chips) 
Seat 9: munky3 ($33.78 in chips) 
BlackZafiro: posts small blind $0.10
Noviekid: posts big blind $0.25
*** HOLE CARDS ***
Dealt to chiyuki [7s 3d]
chiyuki: folds 
KeLevro0: folds 
Perstenev: folds 
PetitAlejo: folds 
Th3Fog: raises $0.35 to $0.60
munky3: folds 
DanielWhyte: folds 
BlackZafiro: folds 
Noviekid: folds 
Uncalled bet ($0.35) returned to Th3Fog
Th3Fog collected $0.60 from pot
Th3Fog: doesn't show hand 
*** SUMMARY ***
Total pot $0.60 | Rake $0 
Seat 1: DanielWhyte (button) folded before Flop (didn't bet)
Seat 2: BlackZafiro (small blind) folded before Flop
Seat 3: Noviekid (big blind) folded before Flop
Seat 4: chiyuki folded before Flop (didn't bet)
Seat 5: KeLevro0 folded before Flop (didn't bet)
Seat 6: Perstenev folded before Flop (didn't bet)
Seat 7: PetitAlejo folded before Flop (didn't bet)
Seat 8: Th3Fog collected ($0.60)
Seat 9: munky3 folded before Flop (didn't bet)



PokerStars Zoom Hand #84299168994:  Hold'em No Limit ($0.10/$0.25) - 2012/08/05 14:01:36 JST [2012/08/05 1:01:36 ET]
Table 'Whirlpool' 9-max Seat #1 is the button
Seat 1: KeLevro0 ($12.48 in chips) 
Seat 2: simonzez ($37.13 in chips) 
Seat 3: silvno31 ($48.29 in chips) 
Seat 4: kamikkaze ($16.06 in chips) 
Seat 5: Rudolf ($46.77 in chips) 
Seat 6: Loholov ($16.65 in chips) 
Seat 7: 123progress ($28.23 in chips) 
Seat 8: taksist889 ($14.80 in chips) 
Seat 9: chiyuki ($31.20 in chips) 
simonzez: posts small blind $0.10
silvno31: posts big blind $0.25
*** HOLE CARDS ***
Dealt to chiyuki [5h 2s]
kamikkaze: folds 
Rudolf: folds 
Loholov: folds 
123progress: folds 
taksist889: folds 
chiyuki: folds 
KeLevro0: folds 
simonzez: raises $0.25 to $0.50
silvno31: calls $0.25
*** FLOP *** [3h 9c Js]
simonzez: bets $0.50
silvno31: calls $0.50
*** TURN *** [3h 9c Js] [As]
simonzez: bets $0.50
silvno31: calls $0.50
*** RIVER *** [3h 9c Js As] [9d]
simonzez: bets $1.25
silvno31: folds 
Uncalled bet ($1.25) returned to simonzez
simonzez collected $2.86 from pot
simonzez: doesn't show hand 
*** SUMMARY ***
Total pot $3 | Rake $0.14 
Board [3h 9c Js As 9d]
Seat 1: KeLevro0 (button) folded before Flop (didn't bet)
Seat 2: simonzez (small blind) collected ($2.86)
Seat 3: silvno31 (big blind) folded on the River
Seat 4: kamikkaze folded before Flop (didn't bet)
Seat 5: Rudolf folded before Flop (didn't bet)
Seat 6: Loholov folded before Flop (didn't bet)
Seat 7: 123progress folded before Flop (didn't bet)
Seat 8: taksist889 folded before Flop (didn't bet)
Seat 9: chiyuki folded before Flop (didn't bet)



PokerStars Zoom Hand #84299172385:  Hold'em No Limit ($0.10/$0.25) - 2012/08/05 14:01:49 JST [2012/08/05 1:01:49 ET]
Table 'Whirlpool' 9-max Seat #1 is the button
Seat 1: ygoegoe ($34.04 in chips) 
Seat 2: chiyuki ($31.20 in chips) 
Seat 3: Loholov ($15 in chips) 
Seat 4: 2997qwer ($13.25 in chips) 
Seat 5: KeLevro0 ($12.48 in chips) 
Seat 6: seula i ($38.85 in chips) 
Seat 7: hirozo ($29.27 in chips) 
Seat 8: RikkStroken ($25 in chips) 
Seat 9: Nerkit ($15.97 in chips) 
chiyuki: posts small blind $0.10
Loholov: posts big blind $0.25
*** HOLE CARDS ***
Dealt to chiyuki [4c Ac]
2997qwer: folds 
KeLevro0: folds 
seula i: folds 
hirozo: folds 
RikkStroken: folds 
Nerkit: folds 
ygoegoe: calls $0.25
chiyuki: calls $0.15
Loholov: checks 
*** FLOP *** [6h Qh Qc]
chiyuki: checks 
Loholov: checks 
ygoegoe: bets $1
chiyuki: folds 
Loholov: folds 
Uncalled bet ($1) returned to ygoegoe
ygoegoe collected $0.72 from pot
ygoegoe: doesn't show hand 
*** SUMMARY ***
Total pot $0.75 | Rake $0.03 
Board [6h Qh Qc]
Seat 1: ygoegoe (button) collected ($0.72)
Seat 2: chiyuki (small blind) folded on the Flop
Seat 3: Loholov (big blind) folded on the Flop
Seat 4: 2997qwer folded before Flop (didn't bet)
Seat 5: KeLevro0 folded before Flop (didn't bet)
Seat 6: seula i folded before Flop (didn't bet)
Seat 7: hirozo folded before Flop (didn't bet)
Seat 8: RikkStroken folded before Flop (didn't bet)
Seat 9: Nerkit folded before Flop (didn't bet)



PokerStars Zoom Hand #84299166714:  Hold'em No Limit ($0.10/$0.25) - 2012/08/05 14:01:27 JST [2012/08/05 1:01:27 ET]
Table 'Whirlpool' 9-max Seat #1 is the button
Seat 1: Th3Fog ($77.12 in chips) 
Seat 2: Tom1999 ($20.30 in chips) 
Seat 3: Suhoff76 ($25 in chips) 
Seat 4: KeLevro0 ($9.53 in chips) 
Seat 5: 2997qwer ($13.25 in chips) 
Seat 6: fezman ($14.43 in chips) 
Seat 7: sparky5224 ($15.14 in chips) 
Seat 8: chiyuki ($31.20 in chips) 
Seat 9: americoluz ($27.38 in chips) 
Tom1999: posts small blind $0.10
Suhoff76: posts big blind $0.25
*** HOLE CARDS ***
Dealt to chiyuki [5d 3d]
KeLevro0: folds 
2997qwer: folds 
fezman: folds 
sparky5224: calls $0.25
chiyuki: folds 
americoluz: calls $0.25
Th3Fog: folds 
Tom1999: raises $0.75 to $1
Suhoff76: calls $0.75
sparky5224: calls $0.75
americoluz: calls $0.75
*** FLOP *** [5h Ks 8c]
Tom1999: checks 
Suhoff76: checks 
sparky5224: bets $0.25
americoluz: calls $0.25
Tom1999: raises $1 to $1.25
Suhoff76: folds 
sparky5224: raises $1 to $2.25
americoluz: folds 
Tom1999: calls $1
*** TURN *** [5h Ks 8c] [7d]
Tom1999: checks 
sparky5224: bets $1.25
Tom1999: calls $1.25
*** RIVER *** [5h Ks 8c 7d] [Qc]
Tom1999: checks 
sparky5224: bets $5.25
Tom1999: folds 
Uncalled bet ($5.25) returned to sparky5224
sparky5224 collected $10.74 from pot
sparky5224: doesn't show hand 
*** SUMMARY ***
Total pot $11.25 | Rake $0.51 
Board [5h Ks 8c 7d Qc]
Seat 1: Th3Fog (button) folded before Flop (didn't bet)
Seat 2: Tom1999 (small blind) folded on the River
Seat 3: Suhoff76 (big blind) folded on the Flop
Seat 4: KeLevro0 folded before Flop (didn't bet)
Seat 5: 2997qwer folded before Flop (didn't bet)
Seat 6: fezman folded before Flop (didn't bet)
Seat 7: sparky5224 collected ($10.74)
Seat 8: chiyuki folded before Flop (didn't bet)
Seat 9: americoluz folded on the Flop



PokerStars Zoom Hand #84299184512:  Hold'em No Limit ($0.10/$0.25) - 2012/08/05 14:02:36 JST [2012/08/05 1:02:36 ET]
Table 'Whirlpool' 9-max Seat #1 is the button
Seat 1: wtu1986 ($30.78 in chips) 
Seat 2: agurio ($27.15 in chips) 
Seat 3: Dejacob ($50.25 in chips) 
Seat 4: Loholov ($23.86 in chips) 
Seat 5: hirozo ($30.40 in chips) 
Seat 6: puffy5533 ($23.05 in chips) 
Seat 7: chiyuki ($30.95 in chips) 
Seat 8: flyinprits ($46.29 in chips) 
Seat 9: ygoegoe ($34.51 in chips) 
agurio: posts small blind $0.10
Dejacob: posts big blind $0.25
*** HOLE CARDS ***
Dealt to chiyuki [Ac Qh]
Loholov: raises $0.50 to $0.75
hirozo: folds 
puffy5533: folds 
chiyuki: raises $1.50 to $2.25
flyinprits: calls $2.25
ygoegoe: folds 
wtu1986: folds 
agurio: folds 
Dejacob: folds 
Loholov: calls $1.50
*** FLOP *** [5s 9c 2s]
Loholov: checks 
chiyuki: bets $4.25
flyinprits: folds 
Loholov: raises $17.36 to $21.61 and is all-in
chiyuki: folds 
Uncalled bet ($17.36) returned to Loholov
Loholov collected $14.90 from pot
Loholov: doesn't show hand 
*** SUMMARY ***
Total pot $15.60 | Rake $0.70 
Board [5s 9c 2s]
Seat 1: wtu1986 (button) folded before Flop (didn't bet)
Seat 2: agurio (small blind) folded before Flop
Seat 3: Dejacob (big blind) folded before Flop
Seat 4: Loholov collected ($14.90)
Seat 5: hirozo folded before Flop (didn't bet)
Seat 6: puffy5533 folded before Flop (didn't bet)
Seat 7: chiyuki folded on the Flop
Seat 8: flyinprits folded on the Flop
Seat 9: ygoegoe folded before Flop (didn't bet)



PokerStars Zoom Hand #84299203124:  Hold'em No Limit ($0.10/$0.25) - 2012/08/05 14:03:48 JST [2012/08/05 1:03:48 ET]
Table 'Whirlpool' 9-max Seat #1 is the button
Seat 1: chiyuki ($24.45 in chips) 
Seat 2: wtu1986 ($30.53 in chips) 
Seat 3: KeLevro0 ($8.83 in chips) 
Seat 4: Loholov ($32.26 in chips) 
Seat 5: Anafim ($12.85 in chips) 
Seat 6: RikkStroken ($23.80 in chips) 
Seat 7: RomarioJa ($5.70 in chips) 
Seat 8: mariuka1 ($8.84 in chips) 
Seat 9: 123progress ($26.86 in chips) 
wtu1986: posts small blind $0.10
KeLevro0: posts big blind $0.25
*** HOLE CARDS ***
Dealt to chiyuki [2h 2d]
Loholov: folds 
Anafim: folds 
RikkStroken: folds 
RomarioJa: raises $0.37 to $0.62
mariuka1: folds 
123progress: folds 
chiyuki: folds 
wtu1986: folds 
KeLevro0: folds 
Uncalled bet ($0.37) returned to RomarioJa
RomarioJa collected $0.60 from pot
RomarioJa: doesn't show hand 
*** SUMMARY ***
Total pot $0.60 | Rake $0 
Seat 1: chiyuki (button) folded before Flop (didn't bet)
Seat 2: wtu1986 (small blind) folded before Flop
Seat 3: KeLevro0 (big blind) folded before Flop
Seat 4: Loholov folded before Flop (didn't bet)
Seat 5: Anafim folded before Flop (didn't bet)
Seat 6: RikkStroken folded before Flop (didn't bet)
Seat 7: RomarioJa collected ($0.60)
Seat 8: mariuka1 folded before Flop (didn't bet)
Seat 9: 123progress folded before Flop (didn't bet)



PokerStars Zoom Hand #84299202086:  Hold'em No Limit ($0.10/$0.25) - 2012/08/05 14:03:44 JST [2012/08/05 1:03:44 ET]
Table 'Whirlpool' 9-max Seat #1 is the button
Seat 1: Perstenev ($12.27 in chips) 
Seat 2: Rudolf ($46.02 in chips) 
Seat 3: ygoegoe ($34.41 in chips) 
Seat 4: mariuka1 ($8.84 in chips) 
Seat 5: BlOnDhOlIc ($58.70 in chips) 
Seat 6: chiyuki ($24.45 in chips) 
Seat 7: hirozo ($30.40 in chips) 
Seat 8: deadmoneykid ($24.65 in chips) 
Seat 9: carlosrbr ($18.02 in chips) 
Rudolf: posts small blind $0.10
ygoegoe: posts big blind $0.25
*** HOLE CARDS ***
Dealt to chiyuki [4c Th]
mariuka1: folds 
BlOnDhOlIc: folds 
chiyuki: folds 
hirozo: raises $0.50 to $0.75
deadmoneykid: folds 
carlosrbr: calls $0.75
Perstenev: calls $0.75
Rudolf: folds 
ygoegoe: folds 
*** FLOP *** [Qs Ts 6c]
hirozo: bets $1.65
carlosrbr: folds 
Perstenev: calls $1.65
*** TURN *** [Qs Ts 6c] [Ks]
hirozo: bets $3.76
Perstenev: calls $3.76
*** RIVER *** [Qs Ts 6c Ks] [4s]
hirozo: checks 
Perstenev: checks 
*** SHOW DOWN ***
hirozo: shows [Ah Jh] (a straight, Ten to Ace)
Perstenev: shows [Ac Jc] (a straight, Ten to Ace)
hirozo collected $6.41 from pot
Perstenev collected $6.41 from pot
*** SUMMARY ***
Total pot $13.42 | Rake $0.60 
Board [Qs Ts 6c Ks 4s]
Seat 1: Perstenev (button) showed [Ac Jc] and won ($6.41) with a straight, Ten to Ace
Seat 2: Rudolf (small blind) folded before Flop
Seat 3: ygoegoe (big blind) folded before Flop
Seat 4: mariuka1 folded before Flop (didn't bet)
Seat 5: BlOnDhOlIc folded before Flop (didn't bet)
Seat 6: chiyuki folded before Flop (didn't bet)
Seat 7: hirozo showed [Ah Jh] and won ($6.41) with a straight, Ten to Ace
Seat 8: deadmoneykid folded before Flop (didn't bet)
Seat 9: carlosrbr folded on the Flop



PokerStars Zoom Hand #84299210448:  Hold'em No Limit ($0.10/$0.25) - 2012/08/05 14:04:17 JST [2012/08/05 1:04:17 ET]
Table 'Whirlpool' 9-max Seat #1 is the button
Seat 1: taksist889 ($18.25 in chips) 
Seat 2: BlOnDhOlIc ($61.72 in chips) 
Seat 3: chiyuki ($24.45 in chips) 
Seat 4: Dejacob ($37.79 in chips) 
Seat 5: Perstenev ($12.57 in chips) 
Seat 6: silvno31 ($42.74 in chips) 
Seat 7: Th3Fog ($17.04 in chips) 
Seat 8: Leftymouse ($21.50 in chips) 
Seat 9: Dafleche ($16.69 in chips) 
BlOnDhOlIc: posts small blind $0.10
chiyuki: posts big blind $0.25
*** HOLE CARDS ***
Dealt to chiyuki [Kh Ts]
Dejacob: folds 
Perstenev: folds 
silvno31: folds 
Th3Fog: folds 
Leftymouse: folds 
Dafleche: folds 
taksist889: raises $0.50 to $0.75
BlOnDhOlIc: folds 
chiyuki: folds 
Uncalled bet ($0.50) returned to taksist889
taksist889 collected $0.60 from pot
taksist889: doesn't show hand 
*** SUMMARY ***
Total pot $0.60 | Rake $0 
Seat 1: taksist889 (button) collected ($0.60)
Seat 2: BlOnDhOlIc (small blind) folded before Flop
Seat 3: chiyuki (big blind) folded before Flop
Seat 4: Dejacob folded before Flop (didn't bet)
Seat 5: Perstenev folded before Flop (didn't bet)
Seat 6: silvno31 folded before Flop (didn't bet)
Seat 7: Th3Fog folded before Flop (didn't bet)
Seat 8: Leftymouse folded before Flop (didn't bet)
Seat 9: Dafleche folded before Flop (didn't bet)



PokerStars Zoom Hand #84299218004:  Hold'em No Limit ($0.10/$0.25) - 2012/08/05 14:04:46 JST [2012/08/05 1:04:46 ET]
Table 'Whirlpool' 9-max Seat #1 is the button
Seat 1: RikkStroken ($23.15 in chips) 
Seat 2: Perstenev ($12.32 in chips) 
Seat 3: Loholov ($15.25 in chips) 
Seat 4: hirozo ($30.65 in chips) 
Seat 5: chiyuki ($24.20 in chips) 
Seat 6: BlOnDhOlIc ($25.45 in chips) 
Seat 7: Tom1999 ($11.38 in chips) 
Seat 8: 123progress ($41.30 in chips) 
Seat 9: agurio ($25 in chips) 
Perstenev: posts small blind $0.10
Loholov: posts big blind $0.25
*** HOLE CARDS ***
Dealt to chiyuki [7d Kh]
hirozo: folds 
chiyuki: folds 
BlOnDhOlIc: raises $0.37 to $0.62
Tom1999: folds 
123progress: folds 
agurio: folds 
RikkStroken: folds 
Perstenev: folds 
Loholov: folds 
Uncalled bet ($0.37) returned to BlOnDhOlIc
BlOnDhOlIc collected $0.60 from pot
BlOnDhOlIc: doesn't show hand 
*** SUMMARY ***
Total pot $0.60 | Rake $0 
Seat 1: RikkStroken (button) folded before Flop (didn't bet)
Seat 2: Perstenev (small blind) folded before Flop
Seat 3: Loholov (big blind) folded before Flop
Seat 4: hirozo folded before Flop (didn't bet)
Seat 5: chiyuki folded before Flop (didn't bet)
Seat 6: BlOnDhOlIc collected ($0.60)
Seat 7: Tom1999 folded before Flop (didn't bet)
Seat 8: 123progress folded before Flop (didn't bet)
Seat 9: agurio folded before Flop (didn't bet)



PokerStars Zoom Hand #84299219846:  Hold'em No Limit ($0.10/$0.25) - 2012/08/05 14:04:53 JST [2012/08/05 1:04:53 ET]
Table 'Whirlpool' 9-max Seat #1 is the button
Seat 1: silvno31 ($41.99 in chips) 
Seat 2: Suhoff76 ($34.96 in chips) 
Seat 3: giorgos_k ($14.93 in chips) 
Seat 4: KeLevro0 ($14.20 in chips) 
Seat 5: sparky5224 ($24.88 in chips) 
Seat 6: hirozo ($30.27 in chips) 
Seat 7: RomarioJa ($10.55 in chips) 
Seat 8: Tom1999 ($11.28 in chips) 
Seat 9: chiyuki ($24.20 in chips) 
Suhoff76: posts small blind $0.10
giorgos_k: posts big blind $0.25
*** HOLE CARDS ***
Dealt to chiyuki [4h 3d]
KeLevro0: folds 
sparky5224: folds 
hirozo: folds 
RomarioJa: folds 
Tom1999: raises $0.50 to $0.75
chiyuki: folds 
silvno31: folds 
Suhoff76: folds 
giorgos_k: folds 
Uncalled bet ($0.50) returned to Tom1999
Tom1999 collected $0.60 from pot
Tom1999: doesn't show hand 
*** SUMMARY ***
Total pot $0.60 | Rake $0 
Seat 1: silvno31 (button) folded before Flop (didn't bet)
Seat 2: Suhoff76 (small blind) folded before Flop
Seat 3: giorgos_k (big blind) folded before Flop
Seat 4: KeLevro0 folded before Flop (didn't bet)
Seat 5: sparky5224 folded before Flop (didn't bet)
Seat 6: hirozo folded before Flop (didn't bet)
Seat 7: RomarioJa folded before Flop (didn't bet)
Seat 8: Tom1999 collected ($0.60)
Seat 9: chiyuki folded before Flop (didn't bet)



PokerStars Zoom Hand #84299224836:  Hold'em No Limit ($0.10/$0.25) - 2012/08/05 14:05:13 JST [2012/08/05 1:05:13 ET]
Table 'Whirlpool' 9-max Seat #1 is the button
Seat 1: Dejacob ($52.74 in chips) 
Seat 2: Loholov ($15 in chips) 
Seat 3: Ellen1947 ($29.90 in chips) 
Seat 4: deadmoneykid ($24.15 in chips) 
Seat 5: RomarioJa ($11.61 in chips) 
Seat 6: softdesign ($74.71 in chips) 
Seat 7: chiyuki ($24.10 in chips) 
Seat 8: kamikkaze ($10.61 in chips) 
Seat 9: 2997qwer ($8.85 in chips) 
Loholov: posts small blind $0.10
Ellen1947: posts big blind $0.25
*** HOLE CARDS ***
Dealt to chiyuki [9c 6h]
deadmoneykid: folds 
RomarioJa: folds 
softdesign: folds 
chiyuki: folds 
kamikkaze: folds 
2997qwer: folds 
Dejacob: folds 
Loholov: folds 
Uncalled bet ($0.15) returned to Ellen1947
Ellen1947 collected $0.20 from pot
Ellen1947: doesn't show hand 
*** SUMMARY ***
Total pot $0.20 | Rake $0 
Seat 1: Dejacob (button) folded before Flop (didn't bet)
Seat 2: Loholov (small blind) folded before Flop
Seat 3: Ellen1947 (big blind) collected ($0.20)
Seat 4: deadmoneykid folded before Flop (didn't bet)
Seat 5: RomarioJa folded before Flop (didn't bet)
Seat 6: softdesign folded before Flop (didn't bet)
Seat 7: chiyuki folded before Flop (didn't bet)
Seat 8: kamikkaze folded before Flop (didn't bet)
Seat 9: 2997qwer folded before Flop (didn't bet)



PokerStars Zoom Hand #84299222224:  Hold'em No Limit ($0.10/$0.25) - 2012/08/05 14:05:02 JST [2012/08/05 1:05:02 ET]
Table 'Whirlpool' 9-max Seat #1 is the button
Seat 1: wtu1986 ($24.65 in chips) 
Seat 2: chiyuki ($24.20 in chips) 
Seat 3: hirozo ($26.17 in chips) 
Seat 4: Déculotter69 ($15.92 in chips) 
Seat 5: ygoegoe ($34.94 in chips) 
Seat 6: KeLevro0 ($11.81 in chips) 
Seat 7: puffy5533 ($21.45 in chips) 
Seat 8: Perstenev ($12.65 in chips) 
Seat 9: Dejacob ($25.08 in chips) 
chiyuki: posts small blind $0.10
hirozo: posts big blind $0.25
*** HOLE CARDS ***
Dealt to chiyuki [6d 2h]
Déculotter69: folds 
ygoegoe: folds 
KeLevro0: folds 
puffy5533: folds 
Perstenev: folds 
Dejacob: folds 
wtu1986: folds 
chiyuki: folds 
Uncalled bet ($0.15) returned to hirozo
hirozo collected $0.20 from pot
hirozo: doesn't show hand 
*** SUMMARY ***
Total pot $0.20 | Rake $0 
Seat 1: wtu1986 (button) folded before Flop (didn't bet)
Seat 2: chiyuki (small blind) folded before Flop
Seat 3: hirozo (big blind) collected ($0.20)
Seat 4: Déculotter69 folded before Flop (didn't bet)
Seat 5: ygoegoe folded before Flop (didn't bet)
Seat 6: KeLevro0 folded before Flop (didn't bet)
Seat 7: puffy5533 folded before Flop (didn't bet)
Seat 8: Perstenev folded before Flop (didn't bet)
Seat 9: Dejacob folded before Flop (didn't bet)



PokerStars Zoom Hand #84299229889:  Hold'em No Limit ($0.10/$0.25) - 2012/08/05 14:05:32 JST [2012/08/05 1:05:32 ET]
Table 'Whirlpool' 9-max Seat #1 is the button
Seat 1: Suhoff76 ($34.86 in chips) 
Seat 2: Dejacob ($25.10 in chips) 
Seat 3: ll_LaMeR_ll ($61.79 in chips) 
Seat 4: chiyuki ($24.10 in chips) 
Seat 5: Wilcox76607 ($17.95 in chips) 
Seat 6: kamikkaze ($10.61 in chips) 
Seat 7: Vahe50 ($10.87 in chips) 
Seat 8: D@vidMed ($57.50 in chips) 
Seat 9: mariuka1 ($8.14 in chips) 
Dejacob: posts small blind $0.10
ll_LaMeR_ll: posts big blind $0.25
*** HOLE CARDS ***
Dealt to chiyuki [3s 4s]
chiyuki: folds 
Wilcox76607: folds 
kamikkaze: folds 
Vahe50: folds 
D@vidMed: folds 
mariuka1: folds 
Suhoff76: folds 
Dejacob: folds 
Uncalled bet ($0.15) returned to ll_LaMeR_ll
ll_LaMeR_ll collected $0.20 from pot
ll_LaMeR_ll: doesn't show hand 
*** SUMMARY ***
Total pot $0.20 | Rake $0 
Seat 1: Suhoff76 (button) folded before Flop (didn't bet)
Seat 2: Dejacob (small blind) folded before Flop
Seat 3: ll_LaMeR_ll (big blind) collected ($0.20)
Seat 4: chiyuki folded before Flop (didn't bet)
Seat 5: Wilcox76607 folded before Flop (didn't bet)
Seat 6: kamikkaze folded before Flop (didn't bet)
Seat 7: Vahe50 folded before Flop (didn't bet)
Seat 8: D@vidMed folded before Flop (didn't bet)
Seat 9: mariuka1 folded before Flop (didn't bet)



PokerStars Zoom Hand #84299226180:  Hold'em No Limit ($0.10/$0.25) - 2012/08/05 14:05:18 JST [2012/08/05 1:05:18 ET]
Table 'Whirlpool' 9-max Seat #1 is the button
Seat 1: 2997qwer ($8.85 in chips) 
Seat 2: PetitAlejo ($35.91 in chips) 
Seat 3: BlOnDhOlIc ($25.80 in chips) 
Seat 4: Roglus ($11.77 in chips) 
Seat 5: Loholov ($16.73 in chips) 
Seat 6: chiyuki ($24.10 in chips) 
Seat 7: softdesign ($74.71 in chips) 
Seat 8: Perstenev ($12.87 in chips) 
Seat 9: kamikkaze ($37 in chips) 
PetitAlejo: posts small blind $0.10
BlOnDhOlIc: posts big blind $0.25
*** HOLE CARDS ***
Dealt to chiyuki [2h 9c]
Roglus: raises $0.50 to $0.75
Loholov: folds 
chiyuki: folds 
softdesign: calls $0.75
Perstenev: folds 
kamikkaze: folds 
2997qwer: folds 
PetitAlejo: folds 
BlOnDhOlIc: folds 
*** FLOP *** [As 7s 8h]
Roglus: checks 
softdesign: bets $1.75
Roglus: calls $1.75
*** TURN *** [As 7s 8h] [Qc]
Roglus: checks 
softdesign: checks 
*** RIVER *** [As 7s 8h Qc] [Th]
Roglus: bets $3.47
softdesign: folds 
Uncalled bet ($3.47) returned to Roglus
Roglus collected $5.11 from pot
Roglus: doesn't show hand 
*** SUMMARY ***
Total pot $5.35 | Rake $0.24 
Board [As 7s 8h Qc Th]
Seat 1: 2997qwer (button) folded before Flop (didn't bet)
Seat 2: PetitAlejo (small blind) folded before Flop
Seat 3: BlOnDhOlIc (big blind) folded before Flop
Seat 4: Roglus collected ($5.11)
Seat 5: Loholov folded before Flop (didn't bet)
Seat 6: chiyuki folded before Flop (didn't bet)
Seat 7: softdesign folded on the River
Seat 8: Perstenev folded before Flop (didn't bet)
Seat 9: kamikkaze folded before Flop (didn't bet)



PokerStars Zoom Hand #84299223565:  Hold'em No Limit ($0.10/$0.25) - 2012/08/05 14:05:08 JST [2012/08/05 1:05:08 ET]
Table 'Whirlpool' 9-max Seat #1 is the button
Seat 1: Dan Royal ($22.85 in chips) 
Seat 2: Th3Fog ($51.81 in chips) 
Seat 3: Roglus ($97.53 in chips) 
Seat 4: cR!Ma*aRm ($21.30 in chips) 
Seat 5: giorgos_k ($38.46 in chips) 
Seat 6: 123progress ($41.30 in chips) 
Seat 7: Perstenev ($12.65 in chips) 
Seat 8: chiyuki ($24.10 in chips) 
Seat 9: softdesign ($74.71 in chips) 
Th3Fog: posts small blind $0.10
Roglus: posts big blind $0.25
*** HOLE CARDS ***
Dealt to chiyuki [Qh 5h]
cR!Ma*aRm: folds 
giorgos_k: calls $0.25
123progress: calls $0.25
Perstenev: folds 
chiyuki: folds 
softdesign: folds 
Dan Royal: folds 
Th3Fog: raises $1 to $1.25
Roglus: folds 
giorgos_k: calls $1
123progress: calls $1
*** FLOP *** [5d Th Tc]
Th3Fog: bets $1.50
giorgos_k: calls $1.50
123progress: folds 
*** TURN *** [5d Th Tc] [6s]
Th3Fog: checks 
giorgos_k: checks 
*** RIVER *** [5d Th Tc 6s] [Ah]
Th3Fog: checks 
giorgos_k: bets $4.75
Th3Fog: folds 
Uncalled bet ($4.75) returned to giorgos_k
giorgos_k collected $6.68 from pot
giorgos_k: doesn't show hand 
*** SUMMARY ***
Total pot $7 | Rake $0.32 
Board [5d Th Tc 6s Ah]
Seat 1: Dan Royal (button) folded before Flop (didn't bet)
Seat 2: Th3Fog (small blind) folded on the River
Seat 3: Roglus (big blind) folded before Flop
Seat 4: cR!Ma*aRm folded before Flop (didn't bet)
Seat 5: giorgos_k collected ($6.68)
Seat 6: 123progress folded on the Flop
Seat 7: Perstenev folded before Flop (didn't bet)
Seat 8: chiyuki folded before Flop (didn't bet)
Seat 9: softdesign folded before Flop (didn't bet)



PokerStars Zoom Hand #84299231745:  Hold'em No Limit ($0.10/$0.25) - 2012/08/05 14:05:39 JST [2012/08/05 1:05:39 ET]
Table 'Whirlpool' 9-max Seat #1 is the button
Seat 1: chiyuki ($24.10 in chips) 
Seat 2: jallu435 ($25.10 in chips) 
Seat 3: PetitAlejo ($30.43 in chips) 
Seat 4: kamikkaze ($10.61 in chips) 
Seat 5: Loholov ($15.25 in chips) 
Seat 6: cR!Ma*aRm ($20.55 in chips) 
Seat 7: ChrisCDee ($53.29 in chips) 
Seat 8: wtu1986 ($24.65 in chips) 
Seat 9: RomarioJa ($10.30 in chips) 
jallu435: posts small blind $0.10
PetitAlejo: posts big blind $0.25
*** HOLE CARDS ***
Dealt to chiyuki [9h Ac]
kamikkaze: folds 
Loholov: folds 
cR!Ma*aRm: folds 
ChrisCDee: folds 
wtu1986: folds 
RomarioJa: folds 
chiyuki: raises $0.50 to $0.75
jallu435: folds 
PetitAlejo: folds 
Uncalled bet ($0.50) returned to chiyuki
chiyuki collected $0.60 from pot
chiyuki: doesn't show hand 
*** SUMMARY ***
Total pot $0.60 | Rake $0 
Seat 1: chiyuki (button) collected ($0.60)
Seat 2: jallu435 (small blind) folded before Flop
Seat 3: PetitAlejo (big blind) folded before Flop
Seat 4: kamikkaze folded before Flop (didn't bet)
Seat 5: Loholov folded before Flop (didn't bet)
Seat 6: cR!Ma*aRm folded before Flop (didn't bet)
Seat 7: ChrisCDee folded before Flop (didn't bet)
Seat 8: wtu1986 folded before Flop (didn't bet)
Seat 9: RomarioJa folded before Flop (didn't bet)



PokerStars Zoom Hand #84299227514:  Hold'em No Limit ($0.10/$0.25) - 2012/08/05 14:05:23 JST [2012/08/05 1:05:23 ET]
Table 'Whirlpool' 9-max Seat #1 is the button
Seat 1: Loholov ($15 in chips) 
Seat 2: munky3 ($35.12 in chips) 
Seat 3: puffy5533 ($21.45 in chips) 
Seat 4: ygoegoe ($35.74 in chips) 
Seat 5: chiyuki ($24.10 in chips) 
Seat 6: kamikkaze ($37 in chips) 
Seat 7: silvno31 ($41.89 in chips) 
Seat 8: seula i ($65.45 in chips) 
Seat 9: Wilcox76607 ($17.95 in chips) 
munky3: posts small blind $0.10
puffy5533: posts big blind $0.25
*** HOLE CARDS ***
Dealt to chiyuki [Qh 7c]
ygoegoe: folds 
chiyuki: folds 
kamikkaze: folds 
silvno31: folds 
seula i: raises $0.50 to $0.75
Wilcox76607: folds 
Loholov: folds 
munky3: calls $0.65
puffy5533: folds 
*** FLOP *** [9d Ac 4d]
munky3: checks 
seula i: checks 
*** TURN *** [9d Ac 4d] [9s]
munky3: checks 
seula i: bets $1.25
munky3: folds 
Uncalled bet ($1.25) returned to seula i
seula i collected $1.67 from pot
seula i: doesn't show hand 
*** SUMMARY ***
Total pot $1.75 | Rake $0.08 
Board [9d Ac 4d 9s]
Seat 1: Loholov (button) folded before Flop (didn't bet)
Seat 2: munky3 (small blind) folded on the Turn
Seat 3: puffy5533 (big blind) folded before Flop
Seat 4: ygoegoe folded before Flop (didn't bet)
Seat 5: chiyuki folded before Flop (didn't bet)
Seat 6: kamikkaze folded before Flop (didn't bet)
Seat 7: silvno31 folded before Flop (didn't bet)
Seat 8: seula i collected ($1.67)
Seat 9: Wilcox76607 folded before Flop (didn't bet)



PokerStars Zoom Hand #84299237502:  Hold'em No Limit ($0.10/$0.25) - 2012/08/05 14:06:01 JST [2012/08/05 1:06:01 ET]
Table 'Whirlpool' 9-max Seat #1 is the button
Seat 1: Nerkit ($14.55 in chips) 
Seat 2: PetitAlejo ($25.64 in chips) 
Seat 3: chiyuki ($24.45 in chips) 
Seat 4: giorgos_k ($42.39 in chips) 
Seat 5: Perstenev ($12.17 in chips) 
Seat 6: Rudolf ($45.07 in chips) 
Seat 7: mariuka1 ($8.24 in chips) 
Seat 8: Suhoff76 ($42.66 in chips) 
Seat 9: ygoegoe ($35.49 in chips) 
PetitAlejo: posts small blind $0.10
chiyuki: posts big blind $0.25
*** HOLE CARDS ***
Dealt to chiyuki [Qd Jh]
giorgos_k: folds 
Perstenev: folds 
Rudolf: folds 
mariuka1: folds 
Suhoff76: folds 
ygoegoe: folds 
Nerkit: raises $0.37 to $0.62
PetitAlejo: folds 
chiyuki: calls $0.37
*** FLOP *** [8s Ac 9h]
chiyuki: checks 
Nerkit: bets $0.65
chiyuki: calls $0.65
*** TURN *** [8s Ac 9h] [Ah]
chiyuki: checks 
Nerkit: checks 
*** RIVER *** [8s Ac 9h Ah] [5h]
chiyuki: checks 
Nerkit: checks 
*** SHOW DOWN ***
chiyuki: shows [Qd Jh] (a pair of Aces)
Nerkit: shows [6c 5d] (two pair, Aces and Fives)
Nerkit collected $2.52 from pot
*** SUMMARY ***
Total pot $2.64 | Rake $0.12 
Board [8s Ac 9h Ah 5h]
Seat 1: Nerkit (button) showed [6c 5d] and won ($2.52) with two pair, Aces and Fives
Seat 2: PetitAlejo (small blind) folded before Flop
Seat 3: chiyuki (big blind) showed [Qd Jh] and lost with a pair of Aces
Seat 4: giorgos_k folded before Flop (didn't bet)
Seat 5: Perstenev folded before Flop (didn't bet)
Seat 6: Rudolf folded before Flop (didn't bet)
Seat 7: mariuka1 folded before Flop (didn't bet)
Seat 8: Suhoff76 folded before Flop (didn't bet)
Seat 9: ygoegoe folded before Flop (didn't bet)



PokerStars Zoom Hand #84299252794:  Hold'em No Limit ($0.10/$0.25) - 2012/08/05 14:07:00 JST [2012/08/05 1:07:00 ET]
Table 'Whirlpool' 9-max Seat #1 is the button
Seat 1: 2997qwer ($12.40 in chips) 
Seat 2: Loholov ($16.02 in chips) 
Seat 3: Dafleche ($16.91 in chips) 
Seat 4: deadmoneykid ($21.73 in chips) 
Seat 5: fezman ($15.54 in chips) 
Seat 6: Perstenev ($13.44 in chips) 
Seat 7: PetitAlejo ($31.58 in chips) 
Seat 8: zaffaroots ($20.57 in chips) 
Seat 9: chiyuki ($23.18 in chips) 
Loholov: posts small blind $0.10
Dafleche: posts big blind $0.25
*** HOLE CARDS ***
Dealt to chiyuki [Qc Ts]
deadmoneykid: folds 
fezman: folds 
Perstenev: folds 
PetitAlejo: folds 
zaffaroots: folds 
chiyuki: folds 
2997qwer: folds 
Loholov: raises $0.50 to $0.75
Dafleche: folds 
Uncalled bet ($0.50) returned to Loholov
Loholov collected $0.50 from pot
Loholov: doesn't show hand 
*** SUMMARY ***
Total pot $0.50 | Rake $0 
Seat 1: 2997qwer (button) folded before Flop (didn't bet)
Seat 2: Loholov (small blind) collected ($0.50)
Seat 3: Dafleche (big blind) folded before Flop
Seat 4: deadmoneykid folded before Flop (didn't bet)
Seat 5: fezman folded before Flop (didn't bet)
Seat 6: Perstenev folded before Flop (didn't bet)
Seat 7: PetitAlejo folded before Flop (didn't bet)
Seat 8: zaffaroots folded before Flop (didn't bet)
Seat 9: chiyuki folded before Flop (didn't bet)



PokerStars Zoom Hand #84299251474:  Hold'em No Limit ($0.10/$0.25) - 2012/08/05 14:06:55 JST [2012/08/05 1:06:55 ET]
Table 'Whirlpool' 9-max Seat #1 is the button
Seat 1: jallu435 ($24.25 in chips) 
Seat 2: Th3Fog ($16.04 in chips) 
Seat 3: ll_LaMeR_ll ($62.84 in chips) 
Seat 4: wildy29 ($38.63 in chips) 
Seat 5: fezman ($15.54 in chips) 
Seat 6: chiyuki ($23.18 in chips) 
Seat 7: jeff0923 ($24.68 in chips) 
Seat 8: KeLevro0 ($12.53 in chips) 
Seat 9: zaffaroots ($20.57 in chips) 
Th3Fog: posts small blind $0.10
ll_LaMeR_ll: posts big blind $0.25
*** HOLE CARDS ***
Dealt to chiyuki [6h 2d]
wildy29: calls $0.25
fezman: folds 
chiyuki: folds 
jeff0923: folds 
KeLevro0: folds 
zaffaroots: folds 
jallu435: folds 
Th3Fog: raises $0.47 to $0.72
ll_LaMeR_ll: folds 
wildy29: calls $0.47
*** FLOP *** [5d 6d As]
Th3Fog: bets $0.94
wildy29: folds 
Uncalled bet ($0.94) returned to Th3Fog
Th3Fog collected $1.61 from pot
Th3Fog: doesn't show hand 
*** SUMMARY ***
Total pot $1.69 | Rake $0.08 
Board [5d 6d As]
Seat 1: jallu435 (button) folded before Flop (didn't bet)
Seat 2: Th3Fog (small blind) collected ($1.61)
Seat 3: ll_LaMeR_ll (big blind) folded before Flop
Seat 4: wildy29 folded on the Flop
Seat 5: fezman folded before Flop (didn't bet)
Seat 6: chiyuki folded before Flop (didn't bet)
Seat 7: jeff0923 folded before Flop (didn't bet)
Seat 8: KeLevro0 folded before Flop (didn't bet)
Seat 9: zaffaroots folded before Flop (didn't bet)



PokerStars Zoom Hand #84299254407:  Hold'em No Limit ($0.10/$0.25) - 2012/08/05 14:07:06 JST [2012/08/05 1:07:06 ET]
Table 'Whirlpool' 9-max Seat #1 is the button
Seat 1: Vahe50 ($13.15 in chips) 
Seat 2: chiyuki ($23.18 in chips) 
Seat 3: BlackZafiro ($45.61 in chips) 
Seat 4: RomarioJa ($9.95 in chips) 
Seat 5: giorgos_k ($38.64 in chips) 
Seat 6: 2997qwer ($12.15 in chips) 
Seat 7: seula i ($27.61 in chips) 
Seat 8: hirozo ($35.59 in chips) 
Seat 9: simonzez ($44.26 in chips) 
chiyuki: posts small blind $0.10
BlackZafiro: posts big blind $0.25
*** HOLE CARDS ***
Dealt to chiyuki [7s 9c]
RomarioJa: folds 
giorgos_k: calls $0.25
2997qwer: folds 
seula i: folds 
hirozo: folds 
simonzez: folds 
Vahe50: folds 
chiyuki: folds 
BlackZafiro: checks 
*** FLOP *** [Jh Ts 4d]
BlackZafiro: checks 
giorgos_k: bets $1.25
BlackZafiro: folds 
Uncalled bet ($1.25) returned to giorgos_k
giorgos_k collected $0.57 from pot
giorgos_k: doesn't show hand 
*** SUMMARY ***
Total pot $0.60 | Rake $0.03 
Board [Jh Ts 4d]
Seat 1: Vahe50 (button) folded before Flop (didn't bet)
Seat 2: chiyuki (small blind) folded before Flop
Seat 3: BlackZafiro (big blind) folded on the Flop
Seat 4: RomarioJa folded before Flop (didn't bet)
Seat 5: giorgos_k collected ($0.57)
Seat 6: 2997qwer folded before Flop (didn't bet)
Seat 7: seula i folded before Flop (didn't bet)
Seat 8: hirozo folded before Flop (didn't bet)
Seat 9: simonzez folded before Flop (didn't bet)



PokerStars Zoom Hand #84299260884:  Hold'em No Limit ($0.10/$0.25) - 2012/08/05 14:07:32 JST [2012/08/05 1:07:32 ET]
Table 'Whirlpool' 9-max Seat #1 is the button
Seat 1: chiyuki ($23.08 in chips) 
Seat 2: KeLevro0 ($12.25 in chips) 
Seat 3: Nerkit ($12.50 in chips) 
Seat 4: PetitAlejo ($35.46 in chips) 
Seat 5: seula i ($27.61 in chips) 
Seat 6: 2997qwer ($8.85 in chips) 
Seat 7: kamikkaze ($18.38 in chips) 
Seat 8: Dejacob ($53.76 in chips) 
Seat 9: Déculotter69 ($18.55 in chips) 
KeLevro0: posts small blind $0.10
Nerkit: posts big blind $0.25
*** HOLE CARDS ***
Dealt to chiyuki [7h 2d]
PetitAlejo: folds 
seula i: folds 
2997qwer: folds 
kamikkaze: folds 
Dejacob: folds 
Déculotter69: folds 
chiyuki: folds 
KeLevro0: folds 
Uncalled bet ($0.15) returned to Nerkit
Nerkit collected $0.20 from pot
Nerkit: doesn't show hand 
*** SUMMARY ***
Total pot $0.20 | Rake $0 
Seat 1: chiyuki (button) folded before Flop (didn't bet)
Seat 2: KeLevro0 (small blind) folded before Flop
Seat 3: Nerkit (big blind) collected ($0.20)
Seat 4: PetitAlejo folded before Flop (didn't bet)
Seat 5: seula i folded before Flop (didn't bet)
Seat 6: 2997qwer folded before Flop (didn't bet)
Seat 7: kamikkaze folded before Flop (didn't bet)
Seat 8: Dejacob folded before Flop (didn't bet)
Seat 9: Déculotter69 folded before Flop (didn't bet)



PokerStars Zoom Hand #84299256932:  Hold'em No Limit ($0.10/$0.25) - 2012/08/05 14:07:16 JST [2012/08/05 1:07:16 ET]
Table 'Whirlpool' 9-max Seat #1 is the button
Seat 1: agurio ($25.68 in chips) 
Seat 2: Dejacob ($25.60 in chips) 
Seat 3: deadmoneykid ($24.15 in chips) 
Seat 4: seula i ($26.81 in chips) 
Seat 5: chiyuki ($23.08 in chips) 
Seat 6: wtu1986 ($24.65 in chips) 
Seat 7: Ellen1947 ($36.86 in chips) 
Seat 8: RikkStroken ($30.83 in chips) 
Seat 9: kamikkaze ($10.71 in chips) 
Dejacob: posts small blind $0.10
deadmoneykid: posts big blind $0.25
*** HOLE CARDS ***
Dealt to chiyuki [7s As]
seula i: folds 
chiyuki: folds 
wtu1986: folds 
Ellen1947: folds 
RikkStroken: raises $0.50 to $0.75
kamikkaze: folds 
agurio: folds 
Dejacob: folds 
deadmoneykid: folds 
Uncalled bet ($0.50) returned to RikkStroken
RikkStroken collected $0.60 from pot
RikkStroken: doesn't show hand 
*** SUMMARY ***
Total pot $0.60 | Rake $0 
Seat 1: agurio (button) folded before Flop (didn't bet)
Seat 2: Dejacob (small blind) folded before Flop
Seat 3: deadmoneykid (big blind) folded before Flop
Seat 4: seula i folded before Flop (didn't bet)
Seat 5: chiyuki folded before Flop (didn't bet)
Seat 6: wtu1986 folded before Flop (didn't bet)
Seat 7: Ellen1947 folded before Flop (didn't bet)
Seat 8: RikkStroken collected ($0.60)
Seat 9: kamikkaze folded before Flop (didn't bet)



PokerStars Zoom Hand #84299262176:  Hold'em No Limit ($0.10/$0.25) - 2012/08/05 14:07:37 JST [2012/08/05 1:07:37 ET]
Table 'Whirlpool' 9-max Seat #1 is the button
Seat 1: kamikkaze ($12.32 in chips) 
Seat 2: BlOnDhOlIc ($25 in chips) 
Seat 3: Déculotter69 ($18.55 in chips) 
Seat 4: RikkStroken ($21.22 in chips) 
Seat 5: RomarioJa ($5.35 in chips) 
Seat 6: peng2astic ($18.01 in chips) 
Seat 7: Th3Fog ($16.93 in chips) 
Seat 8: chiyuki ($23.08 in chips) 
Seat 9: 2997qwer ($8.85 in chips) 
BlOnDhOlIc: posts small blind $0.10
Déculotter69: posts big blind $0.25
*** HOLE CARDS ***
Dealt to chiyuki [Ks 2s]
RikkStroken: folds 
RomarioJa: folds 
peng2astic: folds 
Th3Fog: folds 
chiyuki: folds 
2997qwer: folds 
kamikkaze: folds 
BlOnDhOlIc: folds 
Uncalled bet ($0.15) returned to Déculotter69
Déculotter69 collected $0.20 from pot
Déculotter69: doesn't show hand 
*** SUMMARY ***
Total pot $0.20 | Rake $0 
Seat 1: kamikkaze (button) folded before Flop (didn't bet)
Seat 2: BlOnDhOlIc (small blind) folded before Flop
Seat 3: Déculotter69 (big blind) collected ($0.20)
Seat 4: RikkStroken folded before Flop (didn't bet)
Seat 5: RomarioJa folded before Flop (didn't bet)
Seat 6: peng2astic folded before Flop (didn't bet)
Seat 7: Th3Fog folded before Flop (didn't bet)
Seat 8: chiyuki folded before Flop (didn't bet)
Seat 9: 2997qwer folded before Flop (didn't bet)



PokerStars Zoom Hand #84299255404:  Hold'em No Limit ($0.10/$0.25) - 2012/08/05 14:07:10 JST [2012/08/05 1:07:10 ET]
Table 'Whirlpool' 9-max Seat #1 is the button
Seat 1: troms20 ($24.65 in chips) 
Seat 2: RomarioJa ($9.95 in chips) 
Seat 3: agurio ($25 in chips) 
Seat 4: BlOnDhOlIc ($62.31 in chips) 
Seat 5: simonzez ($44.26 in chips) 
Seat 6: RikkStroken ($21.22 in chips) 
Seat 7: chiyuki ($23.08 in chips) 
Seat 8: DanielWhyte ($23.41 in chips) 
Seat 9: Dejacob ($53.76 in chips) 
RomarioJa: posts small blind $0.10
agurio: posts big blind $0.25
*** HOLE CARDS ***
Dealt to chiyuki [8d Kh]
BlOnDhOlIc: folds 
simonzez: folds 
RikkStroken: folds 
chiyuki: folds 
DanielWhyte: folds 
Dejacob: folds 
troms20: raises $0.50 to $0.75
RomarioJa: folds 
agurio: raises $1.25 to $2
troms20: calls $1.25
*** FLOP *** [6c 6s Qh]
agurio: bets $2.50
troms20: folds 
Uncalled bet ($2.50) returned to agurio
agurio collected $3.92 from pot
agurio: doesn't show hand 
*** SUMMARY ***
Total pot $4.10 | Rake $0.18 
Board [6c 6s Qh]
Seat 1: troms20 (button) folded on the Flop
Seat 2: RomarioJa (small blind) folded before Flop
Seat 3: agurio (big blind) collected ($3.92)
Seat 4: BlOnDhOlIc folded before Flop (didn't bet)
Seat 5: simonzez folded before Flop (didn't bet)
Seat 6: RikkStroken folded before Flop (didn't bet)
Seat 7: chiyuki folded before Flop (didn't bet)
Seat 8: DanielWhyte folded before Flop (didn't bet)
Seat 9: Dejacob folded before Flop (didn't bet)



PokerStars Zoom Hand #84299264266:  Hold'em No Limit ($0.10/$0.25) - 2012/08/05 14:07:45 JST [2012/08/05 1:07:45 ET]
Table 'Whirlpool' 9-max Seat #1 is the button
Seat 1: hirozo ($29.22 in chips) 
Seat 2: Roglus ($81.56 in chips) 
Seat 3: chiyuki ($23.08 in chips) 
Seat 4: Anafim ($12.50 in chips) 
Seat 5: RikkStroken ($31.18 in chips) 
Seat 6: Tom1999 ($21.41 in chips) 
Seat 7: Faraz ($23.17 in chips) 
Seat 8: deadmoneykid ($23.90 in chips) 
Seat 9: agurio ($25.68 in chips) 
Roglus: posts small blind $0.10
chiyuki: posts big blind $0.25
*** HOLE CARDS ***
Dealt to chiyuki [6d 3c]
Anafim: folds 
RikkStroken: folds 
Tom1999: folds 
Faraz: folds 
deadmoneykid: folds 
agurio: folds 
hirozo: raises $0.25 to $0.50
Roglus: folds 
chiyuki: folds 
Uncalled bet ($0.25) returned to hirozo
hirozo collected $0.60 from pot
hirozo: doesn't show hand 
*** SUMMARY ***
Total pot $0.60 | Rake $0 
Seat 1: hirozo (button) collected ($0.60)
Seat 2: Roglus (small blind) folded before Flop
Seat 3: chiyuki (big blind) folded before Flop
Seat 4: Anafim folded before Flop (didn't bet)
Seat 5: RikkStroken folded before Flop (didn't bet)
Seat 6: Tom1999 folded before Flop (didn't bet)
Seat 7: Faraz folded before Flop (didn't bet)
Seat 8: deadmoneykid folded before Flop (didn't bet)
Seat 9: agurio folded before Flop (didn't bet)



PokerStars Zoom Hand #84299258784:  Hold'em No Limit ($0.10/$0.25) - 2012/08/05 14:07:23 JST [2012/08/05 1:07:23 ET]
Table 'Whirlpool' 9-max Seat #1 is the button
Seat 1: seula i ($27.61 in chips) 
Seat 2: BlOnDhOlIc ($58.30 in chips) 
Seat 3: wtu1986 ($25.29 in chips) 
Seat 4: RikkStroken ($19.18 in chips) 
Seat 5: chiyuki ($23.08 in chips) 
Seat 6: leo2095 ($15.83 in chips) 
Seat 7: ygoegoe ($35.14 in chips) 
Seat 8: ChrisCDee ($52.94 in chips) 
Seat 9: Vahe50 ($13.15 in chips) 
BlOnDhOlIc: posts small blind $0.10
wtu1986: posts big blind $0.25
*** HOLE CARDS ***
Dealt to chiyuki [Kc 8d]
RikkStroken: raises $0.50 to $0.75
chiyuki: folds 
leo2095: folds 
ygoegoe: folds 
ChrisCDee: calls $0.75
Vahe50: folds 
seula i: folds 
BlOnDhOlIc: folds 
wtu1986: folds 
*** FLOP *** [Qc Qs 9c]
RikkStroken: bets $1
ChrisCDee: calls $1
*** TURN *** [Qc Qs 9c] [6c]
RikkStroken: checks 
ChrisCDee: checks 
*** RIVER *** [Qc Qs 9c 6c] [5s]
RikkStroken: checks 
ChrisCDee: checks 
*** SHOW DOWN ***
RikkStroken: shows [Ah Jd] (a pair of Queens)
ChrisCDee: shows [7s 9s] (two pair, Queens and Nines)
ChrisCDee collected $3.68 from pot
*** SUMMARY ***
Total pot $3.85 | Rake $0.17 
Board [Qc Qs 9c 6c 5s]
Seat 1: seula i (button) folded before Flop (didn't bet)
Seat 2: BlOnDhOlIc (small blind) folded before Flop
Seat 3: wtu1986 (big blind) folded before Flop
Seat 4: RikkStroken showed [Ah Jd] and lost with a pair of Queens
Seat 5: chiyuki folded before Flop (didn't bet)
Seat 6: leo2095 folded before Flop (didn't bet)
Seat 7: ygoegoe folded before Flop (didn't bet)
Seat 8: ChrisCDee showed [7s 9s] and won ($3.68) with two pair, Queens and Nines
Seat 9: Vahe50 folded before Flop (didn't bet)



PokerStars Zoom Hand #84299273960:  Hold'em No Limit ($0.10/$0.25) - 2012/08/05 14:08:23 JST [2012/08/05 1:08:23 ET]
Table 'Whirlpool' 9-max Seat #1 is the button
Seat 1: Perstenev ($11.87 in chips) 
Seat 2: kamikkaze ($12.42 in chips) 
Seat 3: BlOnDhOlIc ($45.47 in chips) 
Seat 4: RomarioJa ($6.25 in chips) 
Seat 5: PetitAlejo ($35.46 in chips) 
Seat 6: D@vidMed ($61.95 in chips) 
Seat 7: chiyuki ($22.73 in chips) 
Seat 8: RikkStroken ($17.43 in chips) 
Seat 9: ChrisCDee ($54.87 in chips) 
kamikkaze: posts small blind $0.10
BlOnDhOlIc: posts big blind $0.25
*** HOLE CARDS ***
Dealt to chiyuki [3c 9h]
RomarioJa: folds 
PetitAlejo: folds 
D@vidMed: folds 
chiyuki: folds 
RikkStroken: folds 
ChrisCDee: raises $0.50 to $0.75
Perstenev: folds 
kamikkaze: folds 
BlOnDhOlIc: folds 
Uncalled bet ($0.50) returned to ChrisCDee
ChrisCDee collected $0.60 from pot
ChrisCDee: doesn't show hand 
*** SUMMARY ***
Total pot $0.60 | Rake $0 
Seat 1: Perstenev (button) folded before Flop (didn't bet)
Seat 2: kamikkaze (small blind) folded before Flop
Seat 3: BlOnDhOlIc (big blind) folded before Flop
Seat 4: RomarioJa folded before Flop (didn't bet)
Seat 5: PetitAlejo folded before Flop (didn't bet)
Seat 6: D@vidMed folded before Flop (didn't bet)
Seat 7: chiyuki folded before Flop (didn't bet)
Seat 8: RikkStroken folded before Flop (didn't bet)
Seat 9: ChrisCDee collected ($0.60)



PokerStars Zoom Hand #84299270391:  Hold'em No Limit ($0.10/$0.25) - 2012/08/05 14:08:09 JST [2012/08/05 1:08:09 ET]
Table 'Whirlpool' 9-max Seat #1 is the button
Seat 1: Perstenev ($12.17 in chips) 
Seat 2: wildy29 ($37.66 in chips) 
Seat 3: slapshot2011 ($31.75 in chips) 
Seat 4: DanielWhyte ($21.91 in chips) 
Seat 5: Déculotter69 ($18.55 in chips) 
Seat 6: chiyuki ($22.83 in chips) 
Seat 7: 2997qwer ($8.50 in chips) 
Seat 8: PakisR ($11.65 in chips) 
Seat 9: munky3 ($38.54 in chips) 
wildy29: posts small blind $0.10
slapshot2011: posts big blind $0.25
*** HOLE CARDS ***
Dealt to chiyuki [Qd 9h]
DanielWhyte: folds 
Déculotter69: folds 
chiyuki: folds 
2997qwer: folds 
PakisR: folds 
munky3: folds 
Perstenev: folds 
wildy29: calls $0.15
slapshot2011: checks 
*** FLOP *** [9s Kc 2h]
wildy29: bets $0.25
slapshot2011: calls $0.25
*** TURN *** [9s Kc 2h] [6d]
wildy29: bets $0.25
slapshot2011: calls $0.25
*** RIVER *** [9s Kc 2h 6d] [6c]
wildy29: bets $0.25
slapshot2011: calls $0.25
*** SHOW DOWN ***
wildy29: shows [3c Kh] (two pair, Kings and Sixes)
slapshot2011: mucks hand 
wildy29 collected $1.91 from pot
*** SUMMARY ***
Total pot $2 | Rake $0.09 
Board [9s Kc 2h 6d 6c]
Seat 1: Perstenev (button) folded before Flop (didn't bet)
Seat 2: wildy29 (small blind) showed [3c Kh] and won ($1.91) with two pair, Kings and Sixes
Seat 3: slapshot2011 (big blind) mucked [5c Ah]
Seat 4: DanielWhyte folded before Flop (didn't bet)
Seat 5: Déculotter69 folded before Flop (didn't bet)
Seat 6: chiyuki folded before Flop (didn't bet)
Seat 7: 2997qwer folded before Flop (didn't bet)
Seat 8: PakisR folded before Flop (didn't bet)
Seat 9: munky3 folded before Flop (didn't bet)



PokerStars Zoom Hand #84299272186:  Hold'em No Limit ($0.10/$0.25) - 2012/08/05 14:08:16 JST [2012/08/05 1:08:16 ET]
Table 'Whirlpool' 9-max Seat #1 is the button
Seat 1: Rudolf ($44.17 in chips) 
Seat 2: chiyuki ($22.83 in chips) 
Seat 3: craden500 ($12.50 in chips) 
Seat 4: BlOnDhOlIc ($45.47 in chips) 
Seat 5: Perstenev ($11.50 in chips) 
Seat 6: hirozo ($30.72 in chips) 
Seat 7: ygoegoe ($27.61 in chips) 
Seat 8: 2997qwer ($8.50 in chips) 
Seat 9: kamikkaze ($35.05 in chips) 
chiyuki: posts small blind $0.10
craden500: posts big blind $0.25
*** HOLE CARDS ***
Dealt to chiyuki [4h Qd]
BlOnDhOlIc: folds 
Perstenev: folds 
hirozo: raises $0.50 to $0.75
ygoegoe: folds 
2997qwer: folds 
kamikkaze: folds 
Rudolf: calls $0.75
chiyuki: folds 
craden500: calls $0.50
*** FLOP *** [Ad 7s Ks]
craden500: checks 
hirozo: checks 
Rudolf: checks 
*** TURN *** [Ad 7s Ks] [3h]
craden500: checks 
hirozo: checks 
Rudolf: checks 
*** RIVER *** [Ad 7s Ks 3h] [4s]
craden500: checks 
hirozo: checks 
Rudolf: checks 
*** SHOW DOWN ***
craden500: shows [2h Ts] (high card Ace)
hirozo: shows [9c 9h] (a pair of Nines)
Rudolf: mucks hand 
hirozo collected $2.24 from pot
hirozo is disconnected 
*** SUMMARY ***
Total pot $2.35 | Rake $0.11 
Board [Ad 7s Ks 3h 4s]
Seat 1: Rudolf (button) mucked [6d 6h]
Seat 2: chiyuki (small blind) folded before Flop
Seat 3: craden500 (big blind) showed [2h Ts] and lost with high card Ace
Seat 4: BlOnDhOlIc folded before Flop (didn't bet)
Seat 5: Perstenev folded before Flop (didn't bet)
Seat 6: hirozo showed [9c 9h] and won ($2.24) with a pair of Nines
Seat 7: ygoegoe folded before Flop (didn't bet)
Seat 8: 2997qwer folded before Flop (didn't bet)
Seat 9: kamikkaze folded before Flop (didn't bet)



PokerStars Zoom Hand #84299269110:  Hold'em No Limit ($0.10/$0.25) - 2012/08/05 14:08:04 JST [2012/08/05 1:08:04 ET]
Table 'Whirlpool' 9-max Seat #1 is the button
Seat 1: silvno31 ($39.54 in chips) 
Seat 2: 2997qwer ($8.60 in chips) 
Seat 3: RomarioJa ($10.14 in chips) 
Seat 4: Déculotter69 ($18.55 in chips) 
Seat 5: Dan Royal ($29.36 in chips) 
Seat 6: flyinprits ($43.69 in chips) 
Seat 7: KeLevro0 ($12.50 in chips) 
Seat 8: 123progress ($39.55 in chips) 
Seat 9: chiyuki ($22.83 in chips) 
2997qwer: posts small blind $0.10
RomarioJa: posts big blind $0.25
*** HOLE CARDS ***
Dealt to chiyuki [Qc 7d]
Déculotter69: folds 
Dan Royal: folds 
flyinprits: folds 
KeLevro0: raises $0.42 to $0.67
123progress: calls $0.67
chiyuki: folds 
silvno31: calls $0.67
2997qwer: folds 
RomarioJa: calls $0.42
*** FLOP *** [2c Qd Tc]
RomarioJa: checks 
KeLevro0: bets $1.48
123progress: folds 
silvno31: calls $1.48
RomarioJa: folds 
*** TURN *** [2c Qd Tc] [Qh]
KeLevro0: bets $3.06
silvno31: folds 
Uncalled bet ($3.06) returned to KeLevro0
KeLevro0 collected $5.48 from pot
KeLevro0: doesn't show hand 
*** SUMMARY ***
Total pot $5.74 | Rake $0.26 
Board [2c Qd Tc Qh]
Seat 1: silvno31 (button) folded on the Turn
Seat 2: 2997qwer (small blind) folded before Flop
Seat 3: RomarioJa (big blind) folded on the Flop
Seat 4: Déculotter69 folded before Flop (didn't bet)
Seat 5: Dan Royal folded before Flop (didn't bet)
Seat 6: flyinprits folded before Flop (didn't bet)
Seat 7: KeLevro0 collected ($5.48)
Seat 8: 123progress folded on the Flop
Seat 9: chiyuki folded before Flop (didn't bet)



PokerStars Zoom Hand #84299277619:  Hold'em No Limit ($0.10/$0.25) - 2012/08/05 14:08:37 JST [2012/08/05 1:08:37 ET]
Table 'Whirlpool' 9-max Seat #1 is the button
Seat 1: BlOnDhOlIc ($45.22 in chips) 
Seat 2: eyesJeJa ($25.32 in chips) 
Seat 3: Faraz ($23.17 in chips) 
Seat 4: troms20 ($22.65 in chips) 
Seat 5: simonzez ($49.88 in chips) 
Seat 6: chiyuki ($22.73 in chips) 
Seat 7: ladymadon107 ($7.83 in chips) 
Seat 8: jallu435 ($14.15 in chips) 
Seat 9: Perstenev ($11.60 in chips) 
eyesJeJa: posts small blind $0.10
Faraz: posts big blind $0.25
*** HOLE CARDS ***
Dealt to chiyuki [5d 6h]
troms20: folds 
simonzez: raises $0.25 to $0.50
chiyuki: folds 
ladymadon107: calls $0.50
jallu435: folds 
Perstenev: folds 
BlOnDhOlIc: folds 
eyesJeJa: folds 
Faraz: folds 
*** FLOP *** [5c 7d 6s]
simonzez: bets $0.25
ladymadon107: calls $0.25
*** TURN *** [5c 7d 6s] [4h]
simonzez: bets $0.50
ladymadon107: calls $0.50
*** RIVER *** [5c 7d 6s 4h] [5s]
simonzez: bets $1.25
ladymadon107: folds 
Uncalled bet ($1.25) returned to simonzez
simonzez collected $2.72 from pot
simonzez: doesn't show hand 
*** SUMMARY ***
Total pot $2.85 | Rake $0.13 
Board [5c 7d 6s 4h 5s]
Seat 1: BlOnDhOlIc (button) folded before Flop (didn't bet)
Seat 2: eyesJeJa (small blind) folded before Flop
Seat 3: Faraz (big blind) folded before Flop
Seat 4: troms20 folded before Flop (didn't bet)
Seat 5: simonzez collected ($2.72)
Seat 6: chiyuki folded before Flop (didn't bet)
Seat 7: ladymadon107 folded on the River
Seat 8: jallu435 folded before Flop (didn't bet)
Seat 9: Perstenev folded before Flop (didn't bet)



PokerStars Zoom Hand #84299288374:  Hold'em No Limit ($0.10/$0.25) - 2012/08/05 14:09:19 JST [2012/08/05 1:09:19 ET]
Table 'Whirlpool' 9-max Seat #1 is the button
Seat 1: americoluz ($23.83 in chips) 
Seat 2: Roglus ($80.96 in chips) 
Seat 3: chiyuki ($22.73 in chips) 
Seat 4: kamikkaze ($14.82 in chips) 
Seat 5: ladymadon107 ($6.58 in chips) 
Seat 6: Tom1999 ($20.31 in chips) 
Seat 7: flyinprits ($40.84 in chips) 
Seat 8: PetitAlejo ($32.25 in chips) 
Seat 9: 4thepeople ($24.15 in chips) 
Roglus: posts small blind $0.10
chiyuki: posts big blind $0.25
*** HOLE CARDS ***
Dealt to chiyuki [4d Kh]
kamikkaze: folds 
ladymadon107: raises $0.50 to $0.75
Tom1999: folds 
flyinprits: folds 
PetitAlejo: folds 
4thepeople: folds 
americoluz: folds 
Roglus: folds 
chiyuki: folds 
Uncalled bet ($0.50) returned to ladymadon107
ladymadon107 collected $0.60 from pot
ladymadon107: doesn't show hand 
*** SUMMARY ***
Total pot $0.60 | Rake $0 
Seat 1: americoluz (button) folded before Flop (didn't bet)
Seat 2: Roglus (small blind) folded before Flop
Seat 3: chiyuki (big blind) folded before Flop
Seat 4: kamikkaze folded before Flop (didn't bet)
Seat 5: ladymadon107 collected ($0.60)
Seat 6: Tom1999 folded before Flop (didn't bet)
Seat 7: flyinprits folded before Flop (didn't bet)
Seat 8: PetitAlejo folded before Flop (didn't bet)
Seat 9: 4thepeople folded before Flop (didn't bet)



PokerStars Zoom Hand #84299278679:  Hold'em No Limit ($0.10/$0.25) - 2012/08/05 14:08:42 JST [2012/08/05 1:08:42 ET]
Table 'Whirlpool' 9-max Seat #1 is the button
Seat 1: RikkStroken ($17.43 in chips) 
Seat 2: Perstenev ($11.60 in chips) 
Seat 3: softdesign ($73.11 in chips) 
Seat 4: Noviekid ($45.86 in chips) 
Seat 5: wtu1986 ($29.33 in chips) 
Seat 6: troms20 ($24.65 in chips) 
Seat 7: RomarioJa ($6.25 in chips) 
Seat 8: chiyuki ($22.73 in chips) 
Seat 9: BlOnDhOlIc ($45.22 in chips) 
Perstenev: posts small blind $0.10
softdesign: posts big blind $0.25
*** HOLE CARDS ***
Dealt to chiyuki [Th 2c]
Noviekid: raises $0.25 to $0.50
wtu1986: folds 
troms20: raises $1.50 to $2
RomarioJa: folds 
chiyuki: folds 
BlOnDhOlIc: folds 
RikkStroken: folds 
Perstenev: folds 
softdesign: folds 
Noviekid: calls $1.50
*** FLOP *** [Qc 9h 8s]
Noviekid: checks 
troms20: bets $3
Noviekid: calls $3
*** TURN *** [Qc 9h 8s] [Kh]
Noviekid: checks 
troms20: bets $5.25
Noviekid: folds 
Uncalled bet ($5.25) returned to troms20
troms20 collected $9.88 from pot
troms20: doesn't show hand 
*** SUMMARY ***
Total pot $10.35 | Rake $0.47 
Board [Qc 9h 8s Kh]
Seat 1: RikkStroken (button) folded before Flop (didn't bet)
Seat 2: Perstenev (small blind) folded before Flop
Seat 3: softdesign (big blind) folded before Flop
Seat 4: Noviekid folded on the Turn
Seat 5: wtu1986 folded before Flop (didn't bet)
Seat 6: troms20 collected ($9.88)
Seat 7: RomarioJa folded before Flop (didn't bet)
Seat 8: chiyuki folded before Flop (didn't bet)
Seat 9: BlOnDhOlIc folded before Flop (didn't bet)



PokerStars Zoom Hand #84299276062:  Hold'em No Limit ($0.10/$0.25) - 2012/08/05 14:08:31 JST [2012/08/05 1:08:31 ET]
Table 'Whirlpool' 9-max Seat #1 is the button
Seat 1: Landybob ($37.16 in chips) 
Seat 2: eyesJeJa ($25 in chips) 
Seat 3: giorgos_k ($38.93 in chips) 
Seat 4: chiyuki ($22.73 in chips) 
Seat 5: Perstenev ($13.09 in chips) 
Seat 6: leo2095 ($15.48 in chips) 
Seat 7: ChrisCDee ($28.83 in chips) 
Seat 8: peng2astic ($16.76 in chips) 
Seat 9: PetitAlejo ($35.46 in chips) 
eyesJeJa: posts small blind $0.10
giorgos_k: posts big blind $0.25
*** HOLE CARDS ***
Dealt to chiyuki [5s Td]
chiyuki: folds 
Perstenev: folds 
leo2095: raises $0.25 to $0.50
ChrisCDee: calls $0.50
peng2astic: calls $0.50
PetitAlejo: folds 
Landybob: folds 
eyesJeJa: folds 
giorgos_k: calls $0.25
*** FLOP *** [Tc 8h Ad]
giorgos_k: checks 
leo2095: checks 
ChrisCDee: checks 
peng2astic: checks 
*** TURN *** [Tc 8h Ad] [8d]
giorgos_k: checks 
leo2095: checks 
ChrisCDee: checks 
peng2astic: bets $1
giorgos_k: folds 
leo2095: folds 
ChrisCDee: folds 
Uncalled bet ($1) returned to peng2astic
peng2astic collected $2.01 from pot
peng2astic: doesn't show hand 
*** SUMMARY ***
Total pot $2.10 | Rake $0.09 
Board [Tc 8h Ad 8d]
Seat 1: Landybob (button) folded before Flop (didn't bet)
Seat 2: eyesJeJa (small blind) folded before Flop
Seat 3: giorgos_k (big blind) folded on the Turn
Seat 4: chiyuki folded before Flop (didn't bet)
Seat 5: Perstenev folded before Flop (didn't bet)
Seat 6: leo2095 folded on the Turn
Seat 7: ChrisCDee folded on the Turn
Seat 8: peng2astic collected ($2.01)
Seat 9: PetitAlejo folded before Flop (didn't bet)



PokerStars Zoom Hand #84299292502:  Hold'em No Limit ($0.10/$0.25) - 2012/08/05 14:09:35 JST [2012/08/05 1:09:35 ET]
Table 'Whirlpool' 9-max Seat #1 is the button
Seat 1: BlackZafiro ($25 in chips) 
Seat 2: chiyuki ($22.48 in chips) 
Seat 3: Perstenev ($16.88 in chips) 
Seat 4: Noviekid ($40.86 in chips) 
Seat 5: troms20 ($24.65 in chips) 
Seat 6: ygoegoe ($38.89 in chips) 
Seat 7: Tom1999 ($20.06 in chips) 
Seat 8: giorgos_k ($28.41 in chips) 
Seat 9: 2997qwer ($12.15 in chips) 
chiyuki: posts small blind $0.10
Perstenev: posts big blind $0.25
*** HOLE CARDS ***
Dealt to chiyuki [Kh 5c]
Noviekid: folds 
troms20: folds 
ygoegoe: folds 
Tom1999: folds 
giorgos_k: folds 
2997qwer: folds 
BlackZafiro: folds 
chiyuki: folds 
Uncalled bet ($0.15) returned to Perstenev
Perstenev collected $0.20 from pot
Perstenev: doesn't show hand 
*** SUMMARY ***
Total pot $0.20 | Rake $0 
Seat 1: BlackZafiro (button) folded before Flop (didn't bet)
Seat 2: chiyuki (small blind) folded before Flop
Seat 3: Perstenev (big blind) collected ($0.20)
Seat 4: Noviekid folded before Flop (didn't bet)
Seat 5: troms20 folded before Flop (didn't bet)
Seat 6: ygoegoe folded before Flop (didn't bet)
Seat 7: Tom1999 folded before Flop (didn't bet)
Seat 8: giorgos_k folded before Flop (didn't bet)
Seat 9: 2997qwer folded before Flop (didn't bet)



PokerStars Zoom Hand #84299294814:  Hold'em No Limit ($0.10/$0.25) - 2012/08/05 14:09:44 JST [2012/08/05 1:09:44 ET]
Table 'Whirlpool' 9-max Seat #1 is the button
Seat 1: BlOnDhOlIc ($58.52 in chips) 
Seat 2: KeLevro0 ($12.25 in chips) 
Seat 3: Perstenev ($12.75 in chips) 
Seat 4: eyesJeJa ($25 in chips) 
Seat 5: RomarioJa ($9.37 in chips) 
Seat 6: Loholov ($17.84 in chips) 
Seat 7: chiyuki ($22.38 in chips) 
Seat 8: Dejacob ($25 in chips) 
Seat 9: troms20 ($29.53 in chips) 
KeLevro0: posts small blind $0.10
Perstenev: posts big blind $0.25
*** HOLE CARDS ***
Dealt to chiyuki [Qd 3d]
eyesJeJa: folds 
RomarioJa: folds 
Loholov: folds 
chiyuki: folds 
Dejacob: folds 
troms20: folds 
BlOnDhOlIc: folds 
KeLevro0: folds 
Uncalled bet ($0.15) returned to Perstenev
Perstenev collected $0.20 from pot
Perstenev: doesn't show hand 
*** SUMMARY ***
Total pot $0.20 | Rake $0 
Seat 1: BlOnDhOlIc (button) folded before Flop (didn't bet)
Seat 2: KeLevro0 (small blind) folded before Flop
Seat 3: Perstenev (big blind) collected ($0.20)
Seat 4: eyesJeJa folded before Flop (didn't bet)
Seat 5: RomarioJa folded before Flop (didn't bet)
Seat 6: Loholov folded before Flop (didn't bet)
Seat 7: chiyuki folded before Flop (didn't bet)
Seat 8: Dejacob folded before Flop (didn't bet)
Seat 9: troms20 folded before Flop (didn't bet)



PokerStars Zoom Hand #84299283347:  Hold'em No Limit ($0.10/$0.25) - 2012/08/05 14:09:00 JST [2012/08/05 1:09:00 ET]
Table 'Whirlpool' 9-max Seat #1 is the button
Seat 1: Lasutchik ($34.11 in chips) 
Seat 2: wtu1986 ($28.10 in chips) 
Seat 3: 2997qwer ($12.50 in chips) 
Seat 4: chiyuki ($22.73 in chips) 
Seat 5: Nerkit ($27.19 in chips) 
Seat 6: eyesJeJa ($25 in chips) 
Seat 7: softdesign ($72.86 in chips) 
Seat 8: Anafim ($12.50 in chips) 
Seat 9: seula i ($65.67 in chips) 
wtu1986: posts small blind $0.10
2997qwer: posts big blind $0.25
*** HOLE CARDS ***
Dealt to chiyuki [7c 3h]
chiyuki: folds 
Nerkit: folds 
eyesJeJa: raises $0.50 to $0.75
softdesign: folds 
Anafim: folds 
seula i: calls $0.75
Lasutchik: folds 
wtu1986: folds 
2997qwer: folds 
*** FLOP *** [3s Qd Kc]
eyesJeJa: bets $1.25
seula i: calls $1.25
*** TURN *** [3s Qd Kc] [Jc]
eyesJeJa: checks 
seula i: checks 
*** RIVER *** [3s Qd Kc Jc] [Ks]
eyesJeJa: checks 
seula i: checks 
*** SHOW DOWN ***
eyesJeJa: shows [Jh Ah] (two pair, Kings and Jacks)
seula i: mucks hand 
eyesJeJa collected $4.15 from pot
*** SUMMARY ***
Total pot $4.35 | Rake $0.20 
Board [3s Qd Kc Jc Ks]
Seat 1: Lasutchik (button) folded before Flop (didn't bet)
Seat 2: wtu1986 (small blind) folded before Flop
Seat 3: 2997qwer (big blind) folded before Flop
Seat 4: chiyuki folded before Flop (didn't bet)
Seat 5: Nerkit folded before Flop (didn't bet)
Seat 6: eyesJeJa showed [Jh Ah] and won ($4.15) with two pair, Kings and Jacks
Seat 7: softdesign folded before Flop (didn't bet)
Seat 8: Anafim folded before Flop (didn't bet)
Seat 9: seula i mucked [Js Ts]



PokerStars Zoom Hand #84299296390:  Hold'em No Limit ($0.10/$0.25) - 2012/08/05 14:09:50 JST [2012/08/05 1:09:50 ET]
Table 'Whirlpool' 9-max Seat #1 is the button
Seat 1: kkbruins0408 ($20.72 in chips) 
Seat 2: wtu1986 ($28.92 in chips) 
Seat 3: eyesJeJa ($25 in chips) 
Seat 4: giorgos_k ($28.41 in chips) 
Seat 5: carlosrbr ($50.37 in chips) 
Seat 6: ChrisCDee ($28.33 in chips) 
Seat 7: Dejacob ($25.50 in chips) 
Seat 8: chiyuki ($22.38 in chips) 
Seat 9: BlOnDhOlIc ($58.52 in chips) 
wtu1986: posts small blind $0.10
eyesJeJa: posts big blind $0.25
*** HOLE CARDS ***
Dealt to chiyuki [7d 5s]
giorgos_k: folds 
carlosrbr: folds 
ChrisCDee: folds 
Dejacob: folds 
chiyuki: folds 
BlOnDhOlIc: folds 
kkbruins0408: folds 
wtu1986: raises $0.37 to $0.62
eyesJeJa: folds 
Uncalled bet ($0.37) returned to wtu1986
wtu1986 collected $0.50 from pot
wtu1986: doesn't show hand 
*** SUMMARY ***
Total pot $0.50 | Rake $0 
Seat 1: kkbruins0408 (button) folded before Flop (didn't bet)
Seat 2: wtu1986 (small blind) collected ($0.50)
Seat 3: eyesJeJa (big blind) folded before Flop
Seat 4: giorgos_k folded before Flop (didn't bet)
Seat 5: carlosrbr folded before Flop (didn't bet)
Seat 6: ChrisCDee folded before Flop (didn't bet)
Seat 7: Dejacob folded before Flop (didn't bet)
Seat 8: chiyuki folded before Flop (didn't bet)
Seat 9: BlOnDhOlIc folded before Flop (didn't bet)



PokerStars Zoom Hand #84299297683:  Hold'em No Limit ($0.10/$0.25) - 2012/08/05 14:09:56 JST [2012/08/05 1:09:56 ET]
Table 'Whirlpool' 9-max Seat #1 is the button
Seat 1: chiyuki ($22.38 in chips) 
Seat 2: Th3Fog ($22.78 in chips) 
Seat 3: troms20 ($22.30 in chips) 
Seat 4: kkbruins0408 ($20.72 in chips) 
Seat 5: seula i ($31.65 in chips) 
Seat 6: KeLevro0 ($12.15 in chips) 
Seat 7: 2997qwer ($12.62 in chips) 
Seat 8: Perstenev ($11.15 in chips) 
Seat 9: ygoegoe ($38.89 in chips) 
Th3Fog: posts small blind $0.10
troms20: posts big blind $0.25
*** HOLE CARDS ***
Dealt to chiyuki [Ah Td]
kkbruins0408: folds 
seula i: folds 
KeLevro0: folds 
2997qwer: folds 
Perstenev: folds 
ygoegoe: folds 
chiyuki: raises $0.50 to $0.75
Th3Fog: folds 
troms20: folds 
Uncalled bet ($0.50) returned to chiyuki
chiyuki collected $0.60 from pot
chiyuki: doesn't show hand 
*** SUMMARY ***
Total pot $0.60 | Rake $0 
Seat 1: chiyuki (button) collected ($0.60)
Seat 2: Th3Fog (small blind) folded before Flop
Seat 3: troms20 (big blind) folded before Flop
Seat 4: kkbruins0408 folded before Flop (didn't bet)
Seat 5: seula i folded before Flop (didn't bet)
Seat 6: KeLevro0 folded before Flop (didn't bet)
Seat 7: 2997qwer folded before Flop (didn't bet)
Seat 8: Perstenev folded before Flop (didn't bet)
Seat 9: ygoegoe folded before Flop (didn't bet)



PokerStars Zoom Hand #84299284363:  Hold'em No Limit ($0.10/$0.25) - 2012/08/05 14:09:04 JST [2012/08/05 1:09:04 ET]
Table 'Whirlpool' 9-max Seat #1 is the button
Seat 1: chiyuki ($22.73 in chips) 
Seat 2: 4thepeople ($24.25 in chips) 
Seat 3: cr0lox ($20.65 in chips) 
Seat 4: softdesign ($72.86 in chips) 
Seat 5: Dejacob ($25 in chips) 
Seat 6: Dan Royal ($31.31 in chips) 
Seat 7: RikkStroken ($17.43 in chips) 
Seat 8: troms20 ($22.30 in chips) 
Seat 9: roksmokndonk ($31.93 in chips) 
4thepeople: posts small blind $0.10
cr0lox: posts big blind $0.25
*** HOLE CARDS ***
Dealt to chiyuki [Qh Th]
softdesign: raises $0.75 to $1
Dejacob: folds 
Dan Royal: folds 
RikkStroken: calls $1
troms20: folds 
roksmokndonk: folds 
chiyuki: folds 
4thepeople: folds 
cr0lox: folds 
*** FLOP *** [As Kh 7d]
softdesign: checks 
RikkStroken: bets $1.25
softdesign: calls $1.25
*** TURN *** [As Kh 7d] [Ks]
softdesign: checks 
RikkStroken: checks 
*** RIVER *** [As Kh 7d Ks] [3h]
softdesign: checks 
RikkStroken: checks 
*** SHOW DOWN ***
softdesign: shows [Jh Jd] (two pair, Kings and Jacks)
RikkStroken: mucks hand 
softdesign collected $4.63 from pot
*** SUMMARY ***
Total pot $4.85 | Rake $0.22 
Board [As Kh 7d Ks 3h]
Seat 1: chiyuki (button) folded before Flop (didn't bet)
Seat 2: 4thepeople (small blind) folded before Flop
Seat 3: cr0lox (big blind) folded before Flop
Seat 4: softdesign showed [Jh Jd] and won ($4.63) with two pair, Kings and Jacks
Seat 5: Dejacob folded before Flop (didn't bet)
Seat 6: Dan Royal folded before Flop (didn't bet)
Seat 7: RikkStroken mucked [4h 5h]
Seat 8: troms20 folded before Flop (didn't bet)
Seat 9: roksmokndonk folded before Flop (didn't bet)



PokerStars Zoom Hand #84299291448:  Hold'em No Limit ($0.10/$0.25) - 2012/08/05 14:09:31 JST [2012/08/05 1:09:31 ET]
Table 'Whirlpool' 9-max Seat #1 is the button
Seat 1: KeLevro0 ($10.40 in chips) 
Seat 2: 2997qwer ($12.25 in chips) 
Seat 3: deadmoneykid ($20.63 in chips) 
Seat 4: jallu435 ($11.40 in chips) 
Seat 5: seula i ($26.26 in chips) 
Seat 6: Perstenev ($16.88 in chips) 
Seat 7: Loholov ($15 in chips) 
Seat 8: taksist889 ($34.39 in chips) 
Seat 9: chiyuki ($22.48 in chips) 
2997qwer: posts small blind $0.10
deadmoneykid: posts big blind $0.25
*** HOLE CARDS ***
Dealt to chiyuki [7s 5c]
jallu435: raises $0.50 to $0.75
seula i: folds 
Perstenev: folds 
Loholov: folds 
taksist889: folds 
chiyuki: folds 
KeLevro0: folds 
2997qwer: folds 
deadmoneykid: calls $0.50
*** FLOP *** [3h Ad 6h]
deadmoneykid: checks 
jallu435: bets $2
deadmoneykid: calls $2
*** TURN *** [3h Ad 6h] [9d]
deadmoneykid: checks 
jallu435: bets $8.65 and is all-in
deadmoneykid: calls $8.65
*** RIVER *** [3h Ad 6h 9d] [4d]
*** SHOW DOWN ***
deadmoneykid: shows [As Qs] (a pair of Aces)
jallu435: shows [Jh Qh] (high card Ace)
deadmoneykid collected $21.87 from pot
*** SUMMARY ***
Total pot $22.90 | Rake $1.03 
Board [3h Ad 6h 9d 4d]
Seat 1: KeLevro0 (button) folded before Flop (didn't bet)
Seat 2: 2997qwer (small blind) folded before Flop
Seat 3: deadmoneykid (big blind) showed [As Qs] and won ($21.87) with a pair of Aces
Seat 4: jallu435 showed [Jh Qh] and lost with high card Ace
Seat 5: seula i folded before Flop (didn't bet)
Seat 6: Perstenev folded before Flop (didn't bet)
Seat 7: Loholov folded before Flop (didn't bet)
Seat 8: taksist889 folded before Flop (didn't bet)
Seat 9: chiyuki folded before Flop (didn't bet)



PokerStars Zoom Hand #84299302614:  Hold'em No Limit ($0.10/$0.25) - 2012/08/05 14:10:15 JST [2012/08/05 1:10:15 ET]
Table 'Whirlpool' 9-max Seat #1 is the button
Seat 1: silvno31 ($36.64 in chips) 
Seat 2: troms20 ($22.05 in chips) 
Seat 3: Anafim ($12.50 in chips) 
Seat 4: flyinprits ($37.59 in chips) 
Seat 5: chiyuki ($22.73 in chips) 
Seat 6: Dejacob ($39.30 in chips) 
Seat 7: seula i ($25 in chips) 
Seat 8: KeLevro0 ($10.30 in chips) 
Seat 9: Loholov ($19.44 in chips) 
troms20: posts small blind $0.10
Anafim: posts big blind $0.25
*** HOLE CARDS ***
Dealt to chiyuki [9c 9h]
flyinprits: folds 
chiyuki: raises $0.50 to $0.75
Dejacob: folds 
seula i: folds 
KeLevro0: folds 
Loholov: calls $0.75
silvno31: folds 
troms20: folds 
Anafim: folds 
*** FLOP *** [7d Qd 2s]
chiyuki: checks 
Loholov: bets $1
chiyuki: folds 
Uncalled bet ($1) returned to Loholov
Loholov collected $1.77 from pot
Loholov: doesn't show hand 
*** SUMMARY ***
Total pot $1.85 | Rake $0.08 
Board [7d Qd 2s]
Seat 1: silvno31 (button) folded before Flop (didn't bet)
Seat 2: troms20 (small blind) folded before Flop
Seat 3: Anafim (big blind) folded before Flop
Seat 4: flyinprits folded before Flop (didn't bet)
Seat 5: chiyuki folded on the Flop
Seat 6: Dejacob folded before Flop (didn't bet)
Seat 7: seula i folded before Flop (didn't bet)
Seat 8: KeLevro0 folded before Flop (didn't bet)
Seat 9: Loholov collected ($1.77)



PokerStars Zoom Hand #84299316790:  Hold'em No Limit ($0.10/$0.25) - 2012/08/05 14:11:12 JST [2012/08/05 1:11:12 ET]
Table 'Whirlpool' 9-max Seat #1 is the button
Seat 1: KeLevro0 ($11.80 in chips) 
Seat 2: Loholov ($20.46 in chips) 
Seat 3: troms20 ($27.10 in chips) 
Seat 4: simonzez ($50.99 in chips) 
Seat 5: chiyuki ($21.98 in chips) 
Seat 6: Scruf13 ($12.69 in chips) 
Seat 7: seula i ($25 in chips) 
Seat 8: BlOnDhOlIc ($88.02 in chips) 
Seat 9: phate-1up ($25 in chips) 
Loholov: posts small blind $0.10
troms20: posts big blind $0.25
*** HOLE CARDS ***
Dealt to chiyuki [3s 3h]
simonzez: calls $0.25
chiyuki: folds 
Scruf13: folds 
seula i: folds 
BlOnDhOlIc: folds 
phate-1up: raises $0.75 to $1
KeLevro0: folds 
Loholov: folds 
troms20: folds 
simonzez: calls $0.75
*** FLOP *** [Qs 2s 6h]
simonzez: bets $1
phate-1up: folds 
Uncalled bet ($1) returned to simonzez
simonzez collected $2.24 from pot
simonzez: doesn't show hand 
*** SUMMARY ***
Total pot $2.35 | Rake $0.11 
Board [Qs 2s 6h]
Seat 1: KeLevro0 (button) folded before Flop (didn't bet)
Seat 2: Loholov (small blind) folded before Flop
Seat 3: troms20 (big blind) folded before Flop
Seat 4: simonzez collected ($2.24)
Seat 5: chiyuki folded before Flop (didn't bet)
Seat 6: Scruf13 folded before Flop (didn't bet)
Seat 7: seula i folded before Flop (didn't bet)
Seat 8: BlOnDhOlIc folded before Flop (didn't bet)
Seat 9: phate-1up folded on the Flop



PokerStars Zoom Hand #84299324204:  Hold'em No Limit ($0.10/$0.25) - 2012/08/05 14:11:41 JST [2012/08/05 1:11:41 ET]
Table 'Whirlpool' 9-max Seat #1 is the button
Seat 1: deadmoneykid ($24.65 in chips) 
Seat 2: Th3Fog ($74.20 in chips) 
Seat 3: WARIBANA7777 ($15 in chips) 
Seat 4: Nerkit ($11.80 in chips) 
Seat 5: acamrash ($14.35 in chips) 
Seat 6: eyesJeJa ($27.40 in chips) 
Seat 7: flyinprits ($38.46 in chips) 
Seat 8: Perstenev ($13.87 in chips) 
Seat 9: chiyuki ($21.73 in chips) 
Th3Fog: posts small blind $0.10
WARIBANA7777: posts big blind $0.25
*** HOLE CARDS ***
Dealt to chiyuki [9h 7c]
Nerkit: folds 
acamrash: folds 
eyesJeJa: raises $0.50 to $0.75
flyinprits: folds 
Perstenev: folds 
chiyuki: folds 
deadmoneykid: folds 
Th3Fog: folds 
WARIBANA7777: folds 
Uncalled bet ($0.50) returned to eyesJeJa
eyesJeJa collected $0.60 from pot
eyesJeJa: doesn't show hand 
*** SUMMARY ***
Total pot $0.60 | Rake $0 
Seat 1: deadmoneykid (button) folded before Flop (didn't bet)
Seat 2: Th3Fog (small blind) folded before Flop
Seat 3: WARIBANA7777 (big blind) folded before Flop
Seat 4: Nerkit folded before Flop (didn't bet)
Seat 5: acamrash folded before Flop (didn't bet)
Seat 6: eyesJeJa collected ($0.60)
Seat 7: flyinprits folded before Flop (didn't bet)
Seat 8: Perstenev folded before Flop (didn't bet)
Seat 9: chiyuki folded before Flop (didn't bet)



PokerStars Zoom Hand #84299315784:  Hold'em No Limit ($0.10/$0.25) - 2012/08/05 14:11:08 JST [2012/08/05 1:11:08 ET]
Table 'Whirlpool' 9-max Seat #1 is the button
Seat 1: deadmoneykid ($31.10 in chips) 
Seat 2: KeLevro0 ($11.90 in chips) 
Seat 3: Csabee21 ($21.89 in chips) 
Seat 4: Roglus ($80.21 in chips) 
Seat 5: chiyuki ($21.98 in chips) 
Seat 6: Perstenev ($14.46 in chips) 
Seat 7: hirozo ($29.36 in chips) 
Seat 8: kkbruins0408 ($19.12 in chips) 
Seat 9: mariuka1 ($14.19 in chips) 
KeLevro0: posts small blind $0.10
Csabee21: posts big blind $0.25
*** HOLE CARDS ***
Dealt to chiyuki [3c 3d]
Roglus: folds 
chiyuki: folds 
Perstenev: folds 
hirozo: folds 
kkbruins0408: folds 
mariuka1: folds 
deadmoneykid: raises $0.25 to $0.50
KeLevro0: folds 
Csabee21: calls $0.25
*** FLOP *** [4c 2s 9s]
Csabee21: bets $1
deadmoneykid: calls $1
*** TURN *** [4c 2s 9s] [Jc]
Csabee21: checks 
deadmoneykid: checks 
*** RIVER *** [4c 2s 9s Jc] [Td]
Csabee21: checks 
deadmoneykid: bets $3.50
Csabee21: calls $3.50
*** SHOW DOWN ***
deadmoneykid: shows [6s 8s] (high card Jack)
Csabee21: shows [4h 6d] (a pair of Fours)
Csabee21 collected $9.65 from pot
*** SUMMARY ***
Total pot $10.10 | Rake $0.45 
Board [4c 2s 9s Jc Td]
Seat 1: deadmoneykid (button) showed [6s 8s] and lost with high card Jack
Seat 2: KeLevro0 (small blind) folded before Flop
Seat 3: Csabee21 (big blind) showed [4h 6d] and won ($9.65) with a pair of Fours
Seat 4: Roglus folded before Flop (didn't bet)
Seat 5: chiyuki folded before Flop (didn't bet)
Seat 6: Perstenev folded before Flop (didn't bet)
Seat 7: hirozo folded before Flop (didn't bet)
Seat 8: kkbruins0408 folded before Flop (didn't bet)
Seat 9: mariuka1 folded before Flop (didn't bet)



PokerStars Zoom Hand #84299327331:  Hold'em No Limit ($0.10/$0.25) - 2012/08/05 14:11:53 JST [2012/08/05 1:11:53 ET]
Table 'Whirlpool' 9-max Seat #1 is the button
Seat 1: johnbaco1209 ($22 in chips) 
Seat 2: chiyuki ($21.73 in chips) 
Seat 3: KeLevro0 ($12.15 in chips) 
Seat 4: BlOnDhOlIc ($25 in chips) 
Seat 5: fezman ($15.16 in chips) 
Seat 6: kamikkaze ($31.04 in chips) 
Seat 7: PetitAlejo ($31.92 in chips) 
Seat 8: seula i ($25 in chips) 
Seat 9: DONK1967 ($24.63 in chips) 
chiyuki: posts small blind $0.10
KeLevro0: posts big blind $0.25
*** HOLE CARDS ***
Dealt to chiyuki [Kh 5h]
BlOnDhOlIc: folds 
fezman: folds 
kamikkaze: folds 
PetitAlejo: folds 
seula i: folds 
DONK1967: folds 
johnbaco1209: folds 
chiyuki: folds 
Uncalled bet ($0.15) returned to KeLevro0
KeLevro0 collected $0.20 from pot
KeLevro0: doesn't show hand 
*** SUMMARY ***
Total pot $0.20 | Rake $0 
Seat 1: johnbaco1209 (button) folded before Flop (didn't bet)
Seat 2: chiyuki (small blind) folded before Flop
Seat 3: KeLevro0 (big blind) collected ($0.20)
Seat 4: BlOnDhOlIc folded before Flop (didn't bet)
Seat 5: fezman folded before Flop (didn't bet)
Seat 6: kamikkaze folded before Flop (didn't bet)
Seat 7: PetitAlejo folded before Flop (didn't bet)
Seat 8: seula i folded before Flop (didn't bet)
Seat 9: DONK1967 folded before Flop (didn't bet)



PokerStars Zoom Hand #84299331104:  Hold'em No Limit ($0.10/$0.25) - 2012/08/05 14:12:08 JST [2012/08/05 1:12:08 ET]
Table 'Whirlpool' 9-max Seat #1 is the button
Seat 1: phate-1up ($25 in chips) 
Seat 2: Spartacus675 ($25.42 in chips) 
Seat 3: rellik1981 ($26.10 in chips) 
Seat 4: BlOnDhOlIc ($25 in chips) 
Seat 5: Nerkit ($10.94 in chips) 
Seat 6: DanielWhyte ($22.98 in chips) 
Seat 7: Roglus ($81 in chips) 
Seat 8: chiyuki ($21.63 in chips) 
Seat 9: wildy29 ($31.80 in chips) 
Spartacus675: posts small blind $0.10
rellik1981: posts big blind $0.25
*** HOLE CARDS ***
Dealt to chiyuki [2d Jh]
BlOnDhOlIc: folds 
Nerkit: folds 
DanielWhyte: calls $0.25
Roglus: folds 
chiyuki: folds 
wildy29: folds 
phate-1up: folds 
Spartacus675: folds 
rellik1981: checks 
*** FLOP *** [3c Tc 6c]
rellik1981: checks 
DanielWhyte: bets $0.25
rellik1981: folds 
Uncalled bet ($0.25) returned to DanielWhyte
DanielWhyte collected $0.57 from pot
DanielWhyte: doesn't show hand 
*** SUMMARY ***
Total pot $0.60 | Rake $0.03 
Board [3c Tc 6c]
Seat 1: phate-1up (button) folded before Flop (didn't bet)
Seat 2: Spartacus675 (small blind) folded before Flop
Seat 3: rellik1981 (big blind) folded on the Flop
Seat 4: BlOnDhOlIc folded before Flop (didn't bet)
Seat 5: Nerkit folded before Flop (didn't bet)
Seat 6: DanielWhyte collected ($0.57)
Seat 7: Roglus folded before Flop (didn't bet)
Seat 8: chiyuki folded before Flop (didn't bet)
Seat 9: wildy29 folded before Flop (didn't bet)



PokerStars Zoom Hand #84299318593:  Hold'em No Limit ($0.10/$0.25) - 2012/08/05 14:11:19 JST [2012/08/05 1:11:19 ET]
Table 'Whirlpool' 9-max Seat #1 is the button
Seat 1: Spartacus675 ($25.42 in chips) 
Seat 2: Landybob ($38.96 in chips) 
Seat 3: chiyuki ($21.98 in chips) 
Seat 4: GoldNutter ($24.09 in chips) 
Seat 5: Scruf13 ($12.69 in chips) 
Seat 6: Loholov ($19.26 in chips) 
Seat 7: BlOnDhOlIc ($88.02 in chips) 
Seat 8: peng2astic ($17.02 in chips) 
Seat 9: RomarioJa ($9.02 in chips) 
Landybob: posts small blind $0.10
chiyuki: posts big blind $0.25
*** HOLE CARDS ***
Dealt to chiyuki [Js Qh]
GoldNutter: folds 
Scruf13: folds 
Loholov: folds 
BlOnDhOlIc: folds 
peng2astic: raises $0.50 to $0.75
RomarioJa: raises $1.10 to $1.85
Spartacus675: folds 
Landybob: folds 
chiyuki: folds 
peng2astic: calls $1.10
*** FLOP *** [2h 4d 3h]
peng2astic: bets $3.25
RomarioJa: raises $3.92 to $7.17 and is all-in
peng2astic: calls $3.92
*** TURN *** [2h 4d 3h] [Kc]
*** RIVER *** [2h 4d 3h Kc] [Qc]
*** SHOW DOWN ***
peng2astic: shows [Ah Th] (high card Ace)
RomarioJa: shows [Ac As] (a pair of Aces)
RomarioJa collected $17.56 from pot
*** SUMMARY ***
Total pot $18.39 | Rake $0.83 
Board [2h 4d 3h Kc Qc]
Seat 1: Spartacus675 (button) folded before Flop (didn't bet)
Seat 2: Landybob (small blind) folded before Flop
Seat 3: chiyuki (big blind) folded before Flop
Seat 4: GoldNutter folded before Flop (didn't bet)
Seat 5: Scruf13 folded before Flop (didn't bet)
Seat 6: Loholov folded before Flop (didn't bet)
Seat 7: BlOnDhOlIc folded before Flop (didn't bet)
Seat 8: peng2astic showed [Ah Th] and lost with high card Ace
Seat 9: RomarioJa showed [Ac As] and won ($17.56) with a pair of Aces



PokerStars Zoom Hand #84299332392:  Hold'em No Limit ($0.10/$0.25) - 2012/08/05 14:12:13 JST [2012/08/05 1:12:13 ET]
Table 'Whirlpool' 9-max Seat #1 is the button
Seat 1: Loholov ($18.91 in chips) 
Seat 2: acamrash ($14.10 in chips) 
Seat 3: Dejacob ($25 in chips) 
Seat 4: wtu1986 ($31.62 in chips) 
Seat 5: flyinprits ($33.89 in chips) 
Seat 6: PetitAlejo ($35.11 in chips) 
Seat 7: chiyuki ($21.63 in chips) 
Seat 8: BlOnDhOlIc ($51.60 in chips) 
Seat 9: 2997qwer ($11.80 in chips) 
acamrash: posts small blind $0.10
Dejacob: posts big blind $0.25
*** HOLE CARDS ***
Dealt to chiyuki [2h Kh]
wtu1986: folds 
flyinprits: folds 
PetitAlejo: raises $0.50 to $0.75
chiyuki: folds 
BlOnDhOlIc: folds 
2997qwer: folds 
Loholov: folds 
acamrash: folds 
Dejacob: folds 
Uncalled bet ($0.50) returned to PetitAlejo
PetitAlejo collected $0.60 from pot
PetitAlejo: doesn't show hand 
*** SUMMARY ***
Total pot $0.60 | Rake $0 
Seat 1: Loholov (button) folded before Flop (didn't bet)
Seat 2: acamrash (small blind) folded before Flop
Seat 3: Dejacob (big blind) folded before Flop
Seat 4: wtu1986 folded before Flop (didn't bet)
Seat 5: flyinprits folded before Flop (didn't bet)
Seat 6: PetitAlejo collected ($0.60)
Seat 7: chiyuki folded before Flop (didn't bet)
Seat 8: BlOnDhOlIc folded before Flop (didn't bet)
Seat 9: 2997qwer folded before Flop (didn't bet)



PokerStars Zoom Hand #84299334959:  Hold'em No Limit ($0.10/$0.25) - 2012/08/05 14:12:24 JST [2012/08/05 1:12:24 ET]
Table 'Whirlpool' 9-max Seat #1 is the button
Seat 1: seula i ($31.20 in chips) 
Seat 2: Wilcox76607 ($24.10 in chips) 
Seat 3: silvno31 ($44.92 in chips) 
Seat 4: chiyuki ($21.63 in chips) 
Seat 5: leo2095 ($13.62 in chips) 
Seat 6: kamikkaze ($14.85 in chips) 
Seat 7: slapshot2011 ($33.22 in chips) 
Seat 8: hirozo ($33.08 in chips) 
Seat 9: KeLevro0 ($11.55 in chips) 
Wilcox76607: posts small blind $0.10
silvno31: posts big blind $0.25
*** HOLE CARDS ***
Dealt to chiyuki [Qs 7s]
chiyuki: folds 
leo2095: folds 
kamikkaze: raises $0.38 to $0.63
slapshot2011: folds 
hirozo: folds 
KeLevro0: folds 
seula i: folds 
Wilcox76607: folds 
silvno31: folds 
Uncalled bet ($0.38) returned to kamikkaze
kamikkaze collected $0.60 from pot
kamikkaze: doesn't show hand 
*** SUMMARY ***
Total pot $0.60 | Rake $0 
Seat 1: seula i (button) folded before Flop (didn't bet)
Seat 2: Wilcox76607 (small blind) folded before Flop
Seat 3: silvno31 (big blind) folded before Flop
Seat 4: chiyuki folded before Flop (didn't bet)
Seat 5: leo2095 folded before Flop (didn't bet)
Seat 6: kamikkaze collected ($0.60)
Seat 7: slapshot2011 folded before Flop (didn't bet)
Seat 8: hirozo folded before Flop (didn't bet)
Seat 9: KeLevro0 folded before Flop (didn't bet)



PokerStars Zoom Hand #84299325227:  Hold'em No Limit ($0.10/$0.25) - 2012/08/05 14:11:45 JST [2012/08/05 1:11:45 ET]
Table 'Whirlpool' 9-max Seat #1 is the button
Seat 1: RomarioJa ($12.60 in chips) 
Seat 2: kkbruins0408 ($19.22 in chips) 
Seat 3: flyinprits ($38.46 in chips) 
Seat 4: seula i ($31.30 in chips) 
Seat 5: RikkStroken ($16.47 in chips) 
Seat 6: chiyuki ($21.73 in chips) 
Seat 7: kamikkaze ($15.10 in chips) 
Seat 8: BlOnDhOlIc ($25 in chips) 
Seat 9: Loholov ($19.10 in chips) 
kkbruins0408: posts small blind $0.10
flyinprits: posts big blind $0.25
*** HOLE CARDS ***
Dealt to chiyuki [6d Jd]
seula i: folds 
RikkStroken: folds 
chiyuki: folds 
kamikkaze: folds 
BlOnDhOlIc: folds 
Loholov: raises $0.50 to $0.75
RomarioJa: folds 
kkbruins0408: calls $0.65
flyinprits: folds 
*** FLOP *** [9h 3d 2d]
kkbruins0408: checks 
Loholov: checks 
*** TURN *** [9h 3d 2d] [4c]
kkbruins0408: checks 
Loholov: checks 
*** RIVER *** [9h 3d 2d 4c] [9c]
kkbruins0408: bets $1
Loholov: folds 
Uncalled bet ($1) returned to kkbruins0408
kkbruins0408 collected $1.67 from pot
kkbruins0408: doesn't show hand 
*** SUMMARY ***
Total pot $1.75 | Rake $0.08 
Board [9h 3d 2d 4c 9c]
Seat 1: RomarioJa (button) folded before Flop (didn't bet)
Seat 2: kkbruins0408 (small blind) collected ($1.67)
Seat 3: flyinprits (big blind) folded before Flop
Seat 4: seula i folded before Flop (didn't bet)
Seat 5: RikkStroken folded before Flop (didn't bet)
Seat 6: chiyuki folded before Flop (didn't bet)
Seat 7: kamikkaze folded before Flop (didn't bet)
Seat 8: BlOnDhOlIc folded before Flop (didn't bet)
Seat 9: Loholov folded on the River



PokerStars Zoom Hand #84299335726:  Hold'em No Limit ($0.10/$0.25) - 2012/08/05 14:12:27 JST [2012/08/05 1:12:27 ET]
Table 'Whirlpool' 9-max Seat #1 is the button
Seat 1: chiyuki ($21.63 in chips) 
Seat 2: rellik1981 ($25.85 in chips) 
Seat 3: 4ydo yogurt ($23.74 in chips) 
Seat 4: BlOnDhOlIc ($51.60 in chips) 
Seat 5: phate-1up ($25 in chips) 
Seat 6: 2997qwer ($11.40 in chips) 
Seat 7: Perstenev ($14.11 in chips) 
Seat 8: acamrash ($14.54 in chips) 
Seat 9: KeLevro0 ($14.07 in chips) 
rellik1981: posts small blind $0.10
4ydo yogurt: posts big blind $0.25
*** HOLE CARDS ***
Dealt to chiyuki [2d Jd]
BlOnDhOlIc: folds 
phate-1up: folds 
2997qwer: folds 
Perstenev: folds 
acamrash: folds 
KeLevro0: folds 
chiyuki: folds 
rellik1981: raises $0.50 to $0.75
4ydo yogurt: calls $0.50
*** FLOP *** [Ac 2c Qc]
rellik1981: checks 
4ydo yogurt: bets $0.40
rellik1981: folds 
Uncalled bet ($0.40) returned to 4ydo yogurt
4ydo yogurt collected $1.43 from pot
4ydo yogurt: doesn't show hand 
*** SUMMARY ***
Total pot $1.50 | Rake $0.07 
Board [Ac 2c Qc]
Seat 1: chiyuki (button) folded before Flop (didn't bet)
Seat 2: rellik1981 (small blind) folded on the Flop
Seat 3: 4ydo yogurt (big blind) collected ($1.43)
Seat 4: BlOnDhOlIc folded before Flop (didn't bet)
Seat 5: phate-1up folded before Flop (didn't bet)
Seat 6: 2997qwer folded before Flop (didn't bet)
Seat 7: Perstenev folded before Flop (didn't bet)
Seat 8: acamrash folded before Flop (didn't bet)
Seat 9: KeLevro0 folded before Flop (didn't bet)



PokerStars Zoom Hand #84299336686:  Hold'em No Limit ($0.10/$0.25) - 2012/08/05 14:12:31 JST [2012/08/05 1:12:31 ET]
Table 'Whirlpool' 9-max Seat #1 is the button
Seat 1: Tom1999 ($11.98 in chips) 
Seat 2: Déculotter69 ($16.77 in chips) 
Seat 3: RomarioJa ($17.56 in chips) 
Seat 4: agurio ($28.96 in chips) 
Seat 5: ChrisCDee ($30.43 in chips) 
Seat 6: chiyuki ($21.63 in chips) 
Seat 7: seula i ($63.89 in chips) 
Seat 8: mariuka1 ($13.59 in chips) 
Seat 9: phate-1up ($26.75 in chips) 
Déculotter69: posts small blind $0.10
RomarioJa: posts big blind $0.25
*** HOLE CARDS ***
Dealt to chiyuki [Ah Jh]
agurio: folds 
ChrisCDee: folds 
chiyuki: raises $0.50 to $0.75
seula i: folds 
mariuka1: folds 
phate-1up: folds 
Tom1999: folds 
Déculotter69: raises $1.50 to $2.25
RomarioJa: folds 
chiyuki: folds 
Uncalled bet ($1.50) returned to Déculotter69
Déculotter69 collected $1.75 from pot
Déculotter69: doesn't show hand 
*** SUMMARY ***
Total pot $1.75 | Rake $0 
Seat 1: Tom1999 (button) folded before Flop (didn't bet)
Seat 2: Déculotter69 (small blind) collected ($1.75)
Seat 3: RomarioJa (big blind) folded before Flop
Seat 4: agurio folded before Flop (didn't bet)
Seat 5: ChrisCDee folded before Flop (didn't bet)
Seat 6: chiyuki folded before Flop
Seat 7: seula i folded before Flop (didn't bet)
Seat 8: mariuka1 folded before Flop (didn't bet)
Seat 9: phate-1up folded before Flop (didn't bet)



PokerStars Zoom Hand #84299344439:  Hold'em No Limit ($0.10/$0.25) - 2012/08/05 14:13:02 JST [2012/08/05 1:13:02 ET]
Table 'Whirlpool' 9-max Seat #1 is the button
Seat 1: RomarioJa ($11.61 in chips) 
Seat 2: hirozo ($34.50 in chips) 
Seat 3: chiyuki ($20.88 in chips) 
Seat 4: kamikkaze ($14.22 in chips) 
Seat 5: phate-1up ($26.75 in chips) 
Seat 6: Dejacob ($36.98 in chips) 
Seat 7: BlOnDhOlIc ($60.66 in chips) 
Seat 8: acamrash ($14.19 in chips) 
Seat 9: softdesign ($73.82 in chips) 
hirozo: posts small blind $0.10
chiyuki: posts big blind $0.25
*** HOLE CARDS ***
Dealt to chiyuki [Tc 8h]
kamikkaze: folds 
phate-1up: folds 
Dejacob: folds 
BlOnDhOlIc: folds 
acamrash: raises $0.50 to $0.75
softdesign: folds 
RomarioJa: folds 
hirozo: folds 
chiyuki: folds 
Uncalled bet ($0.50) returned to acamrash
acamrash collected $0.60 from pot
acamrash: doesn't show hand 
*** SUMMARY ***
Total pot $0.60 | Rake $0 
Seat 1: RomarioJa (button) folded before Flop (didn't bet)
Seat 2: hirozo (small blind) folded before Flop
Seat 3: chiyuki (big blind) folded before Flop
Seat 4: kamikkaze folded before Flop (didn't bet)
Seat 5: phate-1up folded before Flop (didn't bet)
Seat 6: Dejacob folded before Flop (didn't bet)
Seat 7: BlOnDhOlIc folded before Flop (didn't bet)
Seat 8: acamrash collected ($0.60)
Seat 9: softdesign folded before Flop (didn't bet)



PokerStars Zoom Hand #84299333936:  Hold'em No Limit ($0.10/$0.25) - 2012/08/05 14:12:20 JST [2012/08/05 1:12:20 ET]
Table 'Whirlpool' 9-max Seat #1 is the button
Seat 1: phate-1up ($26.75 in chips) 
Seat 2: Anafim ($12.50 in chips) 
Seat 3: jeff0923 ($25.25 in chips) 
Seat 4: chiyuki ($21.63 in chips) 
Seat 5: RomarioJa ($9.55 in chips) 
Seat 6: BlOnDhOlIc ($89.02 in chips) 
Seat 7: ll_LaMeR_ll ($47.62 in chips) 
Seat 8: ygoegoe ($28.21 in chips) 
Seat 9: ChrisCDee ($30.43 in chips) 
Anafim: posts small blind $0.10
jeff0923: posts big blind $0.25
*** HOLE CARDS ***
Dealt to chiyuki [9c 3s]
chiyuki: folds 
RomarioJa: raises $0.50 to $0.75
BlOnDhOlIc: folds 
ll_LaMeR_ll: raises $1.25 to $2
ygoegoe: folds 
ChrisCDee: folds 
phate-1up: folds 
Anafim: folds 
jeff0923: folds 
RomarioJa: calls $1.25
*** FLOP *** [2c 3c As]
RomarioJa: checks 
ll_LaMeR_ll: bets $2.25
RomarioJa: calls $2.25
*** TURN *** [2c 3c As] [Ah]
RomarioJa: checks 
ll_LaMeR_ll: bets $4
RomarioJa: raises $1.30 to $5.30 and is all-in
ll_LaMeR_ll: calls $1.30
*** RIVER *** [2c 3c As Ah] [8h]
*** SHOW DOWN ***
RomarioJa: shows [Jh Js] (two pair, Aces and Jacks)
ll_LaMeR_ll: mucks hand 
RomarioJa collected $18.57 from pot
*** SUMMARY ***
Total pot $19.45 | Rake $0.88 
Board [2c 3c As Ah 8h]
Seat 1: phate-1up (button) folded before Flop (didn't bet)
Seat 2: Anafim (small blind) folded before Flop
Seat 3: jeff0923 (big blind) folded before Flop
Seat 4: chiyuki folded before Flop (didn't bet)
Seat 5: RomarioJa showed [Jh Js] and won ($18.57) with two pair, Aces and Jacks
Seat 6: BlOnDhOlIc folded before Flop (didn't bet)
Seat 7: ll_LaMeR_ll mucked [Kd 6d]
Seat 8: ygoegoe folded before Flop (didn't bet)
Seat 9: ChrisCDee folded before Flop (didn't bet)



PokerStars Zoom Hand #84299350474:  Hold'em No Limit ($0.10/$0.25) - 2012/08/05 14:13:26 JST [2012/08/05 1:13:26 ET]
Table 'Whirlpool' 9-max Seat #1 is the button
Seat 1: JLajoie ($24.50 in chips) 
Seat 2: chiyuki ($20.63 in chips) 
Seat 3: troms20 ($29.59 in chips) 
Seat 4: Loholov ($17.11 in chips) 
Seat 5: rellik1981 ($25.45 in chips) 
Seat 6: RomarioJa ($11.61 in chips) 
Seat 7: carlosrbr ($51.97 in chips) 
Seat 8: PetitAlejo ($30.44 in chips) 
Seat 9: WARIBANA7777 ($13.80 in chips) 
chiyuki: posts small blind $0.10
troms20: posts big blind $0.25
*** HOLE CARDS ***
Dealt to chiyuki [5h 9h]
Loholov: folds 
rellik1981: folds 
RomarioJa: folds 
carlosrbr: raises $0.50 to $0.75
PetitAlejo: folds 
WARIBANA7777: folds 
JLajoie: folds 
chiyuki: folds 
troms20: folds 
Uncalled bet ($0.50) returned to carlosrbr
carlosrbr collected $0.60 from pot
carlosrbr: doesn't show hand 
*** SUMMARY ***
Total pot $0.60 | Rake $0 
Seat 1: JLajoie (button) folded before Flop (didn't bet)
Seat 2: chiyuki (small blind) folded before Flop
Seat 3: troms20 (big blind) folded before Flop
Seat 4: Loholov folded before Flop (didn't bet)
Seat 5: rellik1981 folded before Flop (didn't bet)
Seat 6: RomarioJa folded before Flop (didn't bet)
Seat 7: carlosrbr collected ($0.60)
Seat 8: PetitAlejo folded before Flop (didn't bet)
Seat 9: WARIBANA7777 folded before Flop (didn't bet)



PokerStars Zoom Hand #84299349712:  Hold'em No Limit ($0.10/$0.25) - 2012/08/05 14:13:23 JST [2012/08/05 1:13:23 ET]
Table 'Whirlpool' 9-max Seat #1 is the button
Seat 1: Dan Royal ($31.99 in chips) 
Seat 2: Ellen1947 ($29.95 in chips) 
Seat 3: troms20 ($26.40 in chips) 
Seat 4: chiyuki ($20.63 in chips) 
Seat 5: Loholov ($18.41 in chips) 
Seat 6: Anafim ($13.29 in chips) 
Seat 7: Vahe50 ($7.35 in chips) 
Seat 8: GoldNutter ($24.54 in chips) 
Seat 9: ygoegoe ($33.75 in chips) 
Ellen1947: posts small blind $0.10
troms20: posts big blind $0.25
*** HOLE CARDS ***
Dealt to chiyuki [4c 3d]
chiyuki: folds 
Loholov: folds 
Anafim: folds 
Vahe50: raises $0.25 to $0.50
GoldNutter: folds 
ygoegoe: folds 
Dan Royal: folds 
Ellen1947: folds 
troms20: folds 
Uncalled bet ($0.25) returned to Vahe50
Vahe50 collected $0.60 from pot
Vahe50: doesn't show hand 
*** SUMMARY ***
Total pot $0.60 | Rake $0 
Seat 1: Dan Royal (button) folded before Flop (didn't bet)
Seat 2: Ellen1947 (small blind) folded before Flop
Seat 3: troms20 (big blind) folded before Flop
Seat 4: chiyuki folded before Flop (didn't bet)
Seat 5: Loholov folded before Flop (didn't bet)
Seat 6: Anafim folded before Flop (didn't bet)
Seat 7: Vahe50 collected ($0.60)
Seat 8: GoldNutter folded before Flop (didn't bet)
Seat 9: ygoegoe folded before Flop (didn't bet)



PokerStars Zoom Hand #84299354306:  Hold'em No Limit ($0.10/$0.25) - 2012/08/05 14:13:42 JST [2012/08/05 1:13:42 ET]
Table 'Whirlpool' 9-max Seat #1 is the button
Seat 1: RikkStroken ($23.08 in chips) 
Seat 2: gunbowler ($152.85 in chips) 
Seat 3: mariuka1 ($13.82 in chips) 
Seat 4: WARIBANA7777 ($13.80 in chips) 
Seat 5: acamrash ($13.65 in chips) 
Seat 6: KeLevro0 ($11.47 in chips) 
Seat 7: KAKamiro ($62.56 in chips) 
Seat 8: chiyuki ($20.53 in chips) 
Seat 9: Dan Royal ($31.89 in chips) 
gunbowler: posts small blind $0.10
mariuka1: posts big blind $0.25
*** HOLE CARDS ***
Dealt to chiyuki [Qd Jh]
WARIBANA7777: folds 
acamrash: folds 
KeLevro0: folds 
KAKamiro: folds 
chiyuki: folds 
Dan Royal: folds 
RikkStroken: folds 
gunbowler: raises $0.35 to $0.60
mariuka1: folds 
Uncalled bet ($0.35) returned to gunbowler
gunbowler collected $0.50 from pot
gunbowler: doesn't show hand 
*** SUMMARY ***
Total pot $0.50 | Rake $0 
Seat 1: RikkStroken (button) folded before Flop (didn't bet)
Seat 2: gunbowler (small blind) collected ($0.50)
Seat 3: mariuka1 (big blind) folded before Flop
Seat 4: WARIBANA7777 folded before Flop (didn't bet)
Seat 5: acamrash folded before Flop (didn't bet)
Seat 6: KeLevro0 folded before Flop (didn't bet)
Seat 7: KAKamiro folded before Flop (didn't bet)
Seat 8: chiyuki folded before Flop (didn't bet)
Seat 9: Dan Royal folded before Flop (didn't bet)



PokerStars Zoom Hand #84299348647:  Hold'em No Limit ($0.10/$0.25) - 2012/08/05 14:13:19 JST [2012/08/05 1:13:19 ET]
Table 'Whirlpool' 9-max Seat #1 is the button
Seat 1: D@vidMed ($70.14 in chips) 
Seat 2: Th3Fog ($14.77 in chips) 
Seat 3: KeLevro0 ($12.15 in chips) 
Seat 4: Lasutchik ($11.53 in chips) 
Seat 5: phate-1up ($25.35 in chips) 
Seat 6: rellik1981 ($25.45 in chips) 
Seat 7: 4ydo yogurt ($23.67 in chips) 
Seat 8: seula i ($25.10 in chips) 
Seat 9: chiyuki ($20.63 in chips) 
Th3Fog: posts small blind $0.10
KeLevro0: posts big blind $0.25
*** HOLE CARDS ***
Dealt to chiyuki [6c 9s]
Lasutchik: folds 
phate-1up: raises $0.50 to $0.75
rellik1981: folds 
4ydo yogurt: folds 
seula i: folds 
chiyuki: folds 
D@vidMed: raises $1.05 to $1.80
Th3Fog: folds 
KeLevro0: folds 
phate-1up: folds 
Uncalled bet ($1.05) returned to D@vidMed
D@vidMed collected $1.85 from pot
D@vidMed: doesn't show hand 
*** SUMMARY ***
Total pot $1.85 | Rake $0 
Seat 1: D@vidMed (button) collected ($1.85)
Seat 2: Th3Fog (small blind) folded before Flop
Seat 3: KeLevro0 (big blind) folded before Flop
Seat 4: Lasutchik folded before Flop (didn't bet)
Seat 5: phate-1up folded before Flop
Seat 6: rellik1981 folded before Flop (didn't bet)
Seat 7: 4ydo yogurt folded before Flop (didn't bet)
Seat 8: seula i folded before Flop (didn't bet)
Seat 9: chiyuki folded before Flop (didn't bet)



PokerStars Zoom Hand #84299357519:  Hold'em No Limit ($0.10/$0.25) - 2012/08/05 14:13:55 JST [2012/08/05 1:13:55 ET]
Table 'Whirlpool' 9-max Seat #1 is the button
Seat 1: chiyuki ($20.53 in chips) 
Seat 2: giorgos_k ($15.48 in chips) 
Seat 3: WARIBANA7777 ($13.80 in chips) 
Seat 4: kamikkaze ($30.44 in chips) 
Seat 5: 4ydo yogurt ($24.02 in chips) 
Seat 6: Dan Royal ($31.89 in chips) 
Seat 7: Nerkit ($10.59 in chips) 
Seat 8: Wilcox76607 ($21.73 in chips) 
Seat 9: acamrash ($12.50 in chips) 
giorgos_k: posts small blind $0.10
WARIBANA7777: posts big blind $0.25
*** HOLE CARDS ***
Dealt to chiyuki [3s As]
kamikkaze: folds 
4ydo yogurt: folds 
Dan Royal: folds 
Nerkit: folds 
Wilcox76607: folds 
acamrash: raises $0.36 to $0.61
chiyuki: folds 
giorgos_k: folds 
WARIBANA7777: folds 
Uncalled bet ($0.36) returned to acamrash
acamrash collected $0.60 from pot
acamrash: doesn't show hand 
*** SUMMARY ***
Total pot $0.60 | Rake $0 
Seat 1: chiyuki (button) folded before Flop (didn't bet)
Seat 2: giorgos_k (small blind) folded before Flop
Seat 3: WARIBANA7777 (big blind) folded before Flop
Seat 4: kamikkaze folded before Flop (didn't bet)
Seat 5: 4ydo yogurt folded before Flop (didn't bet)
Seat 6: Dan Royal folded before Flop (didn't bet)
Seat 7: Nerkit folded before Flop (didn't bet)
Seat 8: Wilcox76607 folded before Flop (didn't bet)
Seat 9: acamrash collected ($0.60)



PokerStars Zoom Hand #84299356763:  Hold'em No Limit ($0.10/$0.25) - 2012/08/05 14:13:52 JST [2012/08/05 1:13:52 ET]
Table 'Whirlpool' 9-max Seat #1 is the button
Seat 1: eyesJeJa ($25.20 in chips) 
Seat 2: roksmokndonk ($33.21 in chips) 
Seat 3: Dejacob ($36.88 in chips) 
Seat 4: KAKamiro ($62.56 in chips) 
Seat 5: ladymadon107 ($8.86 in chips) 
Seat 6: seula i ($25 in chips) 
Seat 7: Spartacus675 ($29.17 in chips) 
Seat 8: Anafim ($13.04 in chips) 
Seat 9: chiyuki ($20.53 in chips) 
roksmokndonk: posts small blind $0.10
Dejacob: posts big blind $0.25
*** HOLE CARDS ***
Dealt to chiyuki [8c Qs]
KAKamiro: folds 
ladymadon107: raises $0.25 to $0.50
seula i: raises $1 to $1.50
Spartacus675: folds 
Anafim: folds 
chiyuki: folds 
eyesJeJa: folds 
roksmokndonk: folds 
Dejacob: folds 
ladymadon107: calls $1
*** FLOP *** [4h Ks 5h]
ladymadon107: checks 
seula i: bets $1.75
ladymadon107: folds 
Uncalled bet ($1.75) returned to seula i
seula i collected $3.20 from pot
seula i: doesn't show hand 
*** SUMMARY ***
Total pot $3.35 | Rake $0.15 
Board [4h Ks 5h]
Seat 1: eyesJeJa (button) folded before Flop (didn't bet)
Seat 2: roksmokndonk (small blind) folded before Flop
Seat 3: Dejacob (big blind) folded before Flop
Seat 4: KAKamiro folded before Flop (didn't bet)
Seat 5: ladymadon107 folded on the Flop
Seat 6: seula i collected ($3.20)
Seat 7: Spartacus675 folded before Flop (didn't bet)
Seat 8: Anafim folded before Flop (didn't bet)
Seat 9: chiyuki folded before Flop (didn't bet)



PokerStars Zoom Hand #84299361276:  Hold'em No Limit ($0.10/$0.25) - 2012/08/05 14:14:10 JST [2012/08/05 1:14:10 ET]
Table 'Whirlpool' 9-max Seat #1 is the button
Seat 1: Loholov ($18.06 in chips) 
Seat 2: RomarioJa ($11.36 in chips) 
Seat 3: chiyuki ($20.53 in chips) 
Seat 4: acamrash ($14.54 in chips) 
Seat 5: BlOnDhOlIc ($25 in chips) 
Seat 6: Perstenev ($20.17 in chips) 
Seat 7: giorgos_k ($15.38 in chips) 
Seat 8: Th3Fog ($74.88 in chips) 
Seat 9: phate-1up ($27.15 in chips) 
RomarioJa: posts small blind $0.10
chiyuki: posts big blind $0.25
*** HOLE CARDS ***
Dealt to chiyuki [5c 2d]
acamrash: folds 
BlOnDhOlIc: raises $0.37 to $0.62
Perstenev: folds 
giorgos_k: folds 
Th3Fog: folds 
phate-1up: folds 
Loholov: raises $1.13 to $1.75
RomarioJa: folds 
chiyuki: folds 
BlOnDhOlIc: calls $1.13
*** FLOP *** [Ad 5s 4s]
BlOnDhOlIc: checks 
Loholov: checks 
*** TURN *** [Ad 5s 4s] [Ac]
BlOnDhOlIc: checks 
Loholov: checks 
*** RIVER *** [Ad 5s 4s Ac] [8s]
BlOnDhOlIc: bets $0.75
Loholov: calls $0.75
*** SHOW DOWN ***
BlOnDhOlIc: shows [Js Jd] (two pair, Aces and Jacks)
Loholov: shows [Ks Kc] (two pair, Aces and Kings)
Loholov collected $5.11 from pot
*** SUMMARY ***
Total pot $5.35 | Rake $0.24 
Board [Ad 5s 4s Ac 8s]
Seat 1: Loholov (button) showed [Ks Kc] and won ($5.11) with two pair, Aces and Kings
Seat 2: RomarioJa (small blind) folded before Flop
Seat 3: chiyuki (big blind) folded before Flop
Seat 4: acamrash folded before Flop (didn't bet)
Seat 5: BlOnDhOlIc showed [Js Jd] and lost with two pair, Aces and Jacks
Seat 6: Perstenev folded before Flop (didn't bet)
Seat 7: giorgos_k folded before Flop (didn't bet)
Seat 8: Th3Fog folded before Flop (didn't bet)
Seat 9: phate-1up folded before Flop (didn't bet)



PokerStars Zoom Hand #84299359822:  Hold'em No Limit ($0.10/$0.25) - 2012/08/05 14:14:06 JST [2012/08/05 1:14:06 ET]
Table 'Whirlpool' 9-max Seat #1 is the button
Seat 1: ygoegoe ($33.65 in chips) 
Seat 2: Lasutchik ($52.95 in chips) 
Seat 3: wtu1986 ($33.22 in chips) 
Seat 4: Vahe50 ($32.65 in chips) 
Seat 5: BlOnDhOlIc ($78.79 in chips) 
Seat 6: chiyuki ($20.53 in chips) 
Seat 7: cr0lox ($20.22 in chips) 
Seat 8: giorgos_k ($15.38 in chips) 
Seat 9: Suhoff76 ($25.25 in chips) 
Lasutchik: posts small blind $0.10
wtu1986: posts big blind $0.25
*** HOLE CARDS ***
Dealt to chiyuki [6h 3s]
Vahe50: folds 
BlOnDhOlIc: folds 
chiyuki: folds 
cr0lox: folds 
giorgos_k: folds 
Suhoff76: folds 
ygoegoe: folds 
Lasutchik: calls $0.15
wtu1986: raises $0.65 to $0.90
Lasutchik: raises $2.10 to $3
wtu1986: folds 
Uncalled bet ($2.10) returned to Lasutchik
Lasutchik collected $1.80 from pot
Lasutchik: doesn't show hand 
*** SUMMARY ***
Total pot $1.80 | Rake $0 
Seat 1: ygoegoe (button) folded before Flop (didn't bet)
Seat 2: Lasutchik (small blind) collected ($1.80)
Seat 3: wtu1986 (big blind) folded before Flop
Seat 4: Vahe50 folded before Flop (didn't bet)
Seat 5: BlOnDhOlIc folded before Flop (didn't bet)
Seat 6: chiyuki folded before Flop (didn't bet)
Seat 7: cr0lox folded before Flop (didn't bet)
Seat 8: giorgos_k folded before Flop (didn't bet)
Seat 9: Suhoff76 folded before Flop (didn't bet)



PokerStars Zoom Hand #84299356036:  Hold'em No Limit ($0.10/$0.25) - 2012/08/05 14:13:49 JST [2012/08/05 1:13:49 ET]
Table 'Whirlpool' 9-max Seat #1 is the button
Seat 1: ygoegoe ($28.21 in chips) 
Seat 2: Tom1999 ($23.22 in chips) 
Seat 3: Paranoix1990 ($19.66 in chips) 
Seat 4: acamrash ($13.65 in chips) 
Seat 5: fezman ($17.58 in chips) 
Seat 6: craden500 ($22.87 in chips) 
Seat 7: chiyuki ($20.53 in chips) 
Seat 8: kamikkaze ($30.44 in chips) 
Seat 9: Vahe50 ($7.70 in chips) 
Tom1999: posts small blind $0.10
Paranoix1990: posts big blind $0.25
*** HOLE CARDS ***
Dealt to chiyuki [9d 6c]
acamrash: folds 
fezman: raises $0.50 to $0.75
craden500: calls $0.75
chiyuki: folds 
kamikkaze: folds 
Vahe50: folds 
ygoegoe: folds 
Tom1999: folds 
Paranoix1990: calls $0.50
*** FLOP *** [Tc Jd 5s]
Paranoix1990: checks 
fezman: checks 
craden500: bets $1
Paranoix1990: folds 
fezman: folds 
Uncalled bet ($1) returned to craden500
craden500 collected $2.24 from pot
craden500: doesn't show hand 
*** SUMMARY ***
Total pot $2.35 | Rake $0.11 
Board [Tc Jd 5s]
Seat 1: ygoegoe (button) folded before Flop (didn't bet)
Seat 2: Tom1999 (small blind) folded before Flop
Seat 3: Paranoix1990 (big blind) folded on the Flop
Seat 4: acamrash folded before Flop (didn't bet)
Seat 5: fezman folded on the Flop
Seat 6: craden500 collected ($2.24)
Seat 7: chiyuki folded before Flop (didn't bet)
Seat 8: kamikkaze folded before Flop (didn't bet)
Seat 9: Vahe50 folded before Flop (didn't bet)



PokerStars Zoom Hand #84299367129:  Hold'em No Limit ($0.10/$0.25) - 2012/08/05 14:14:33 JST [2012/08/05 1:14:33 ET]
Table 'Whirlpool' 9-max Seat #1 is the button
Seat 1: kamikkaze ($30.34 in chips) 
Seat 2: 4thepeople ($21.13 in chips) 
Seat 3: Perstenev ($20.17 in chips) 
Seat 4: eyesJeJa ($26.82 in chips) 
Seat 5: chiyuki ($20.18 in chips) 
Seat 6: Scruf13 ($11.94 in chips) 
Seat 7: deadmoneykid ($23.40 in chips) 
Seat 8: BlOnDhOlIc ($60.21 in chips) 
Seat 9: ChrisCDee ($26.13 in chips) 
4thepeople: posts small blind $0.10
Perstenev: posts big blind $0.25
*** HOLE CARDS ***
Dealt to chiyuki [3c 5h]
eyesJeJa: folds 
chiyuki: folds 
Scruf13: folds 
deadmoneykid: folds 
BlOnDhOlIc: folds 
ChrisCDee: folds 
kamikkaze: folds 
4thepeople: calls $0.15
Perstenev: checks 
*** FLOP *** [Th Ks 8s]
4thepeople: checks 
Perstenev: checks 
*** TURN *** [Th Ks 8s] [2d]
4thepeople: bets $0.25
Perstenev: calls $0.25
*** RIVER *** [Th Ks 8s 2d] [7s]
4thepeople: bets $0.25
Perstenev: folds 
Uncalled bet ($0.25) returned to 4thepeople
4thepeople collected $0.96 from pot
4thepeople: doesn't show hand 
*** SUMMARY ***
Total pot $1 | Rake $0.04 
Board [Th Ks 8s 2d 7s]
Seat 1: kamikkaze (button) folded before Flop (didn't bet)
Seat 2: 4thepeople (small blind) collected ($0.96)
Seat 3: Perstenev (big blind) folded on the River
Seat 4: eyesJeJa folded before Flop (didn't bet)
Seat 5: chiyuki folded before Flop (didn't bet)
Seat 6: Scruf13 folded before Flop (didn't bet)
Seat 7: deadmoneykid folded before Flop (didn't bet)
Seat 8: BlOnDhOlIc folded before Flop (didn't bet)
Seat 9: ChrisCDee folded before Flop (didn't bet)



PokerStars Zoom Hand #84299370375:  Hold'em No Limit ($0.10/$0.25) - 2012/08/05 14:14:47 JST [2012/08/05 1:14:47 ET]
Table 'Whirlpool' 9-max Seat #1 is the button
Seat 1: phate-1up ($25 in chips) 
Seat 2: BlOnDhOlIc ($52.31 in chips) 
Seat 3: WARIBANA7777 ($13.45 in chips) 
Seat 4: Csabee21 ($24.54 in chips) 
Seat 5: el pore 5 ($15.84 in chips) 
Seat 6: eyesJeJa ($29.09 in chips) 
Seat 7: chiyuki ($20.18 in chips) 
Seat 8: hirozo ($33.65 in chips) 
Seat 9: PetitAlejo ($34.71 in chips) 
BlOnDhOlIc: posts small blind $0.10
WARIBANA7777: posts big blind $0.25
*** HOLE CARDS ***
Dealt to chiyuki [Js 5d]
Csabee21: folds 
el pore 5: calls $0.25
eyesJeJa: folds 
chiyuki: folds 
hirozo: folds 
PetitAlejo: folds 
phate-1up: folds 
BlOnDhOlIc: folds 
WARIBANA7777: checks 
*** FLOP *** [8s Ks 2c]
WARIBANA7777: checks 
el pore 5: bets $0.50
WARIBANA7777: folds 
Uncalled bet ($0.50) returned to el pore 5
el pore 5 collected $0.57 from pot
el pore 5: doesn't show hand 
*** SUMMARY ***
Total pot $0.60 | Rake $0.03 
Board [8s Ks 2c]
Seat 1: phate-1up (button) folded before Flop (didn't bet)
Seat 2: BlOnDhOlIc (small blind) folded before Flop
Seat 3: WARIBANA7777 (big blind) folded on the Flop
Seat 4: Csabee21 folded before Flop (didn't bet)
Seat 5: el pore 5 collected ($0.57)
Seat 6: eyesJeJa folded before Flop (didn't bet)
Seat 7: chiyuki folded before Flop (didn't bet)
Seat 8: hirozo folded before Flop (didn't bet)
Seat 9: PetitAlejo folded before Flop (didn't bet)



PokerStars Zoom Hand #84299369114:  Hold'em No Limit ($0.10/$0.25) - 2012/08/05 14:14:42 JST [2012/08/05 1:14:42 ET]
Table 'Whirlpool' 9-max Seat #1 is the button
Seat 1: Paranoix1990 ($18.91 in chips) 
Seat 2: 2997qwer ($11.20 in chips) 
Seat 3: kamikkaze ($30.34 in chips) 
Seat 4: BlOnDhOlIc ($52.31 in chips) 
Seat 5: phate-1up ($25 in chips) 
Seat 6: Csabee21 ($24.54 in chips) 
Seat 7: acamrash ($14.64 in chips) 
Seat 8: chiyuki ($20.18 in chips) 
Seat 9: Suhoff76 ($25 in chips) 
2997qwer: posts small blind $0.10
kamikkaze: posts big blind $0.25
*** HOLE CARDS ***
Dealt to chiyuki [6s Ad]
BlOnDhOlIc: folds 
phate-1up: folds 
Csabee21: folds 
acamrash: raises $0.36 to $0.61
chiyuki: folds 
Suhoff76: folds 
Paranoix1990: folds 
2997qwer: raises $1.14 to $1.75
kamikkaze: folds 
acamrash: raises $1.50 to $3.25
2997qwer: folds 
Uncalled bet ($1.50) returned to acamrash
acamrash collected $3.75 from pot
acamrash: doesn't show hand 
*** SUMMARY ***
Total pot $3.75 | Rake $0 
Seat 1: Paranoix1990 (button) folded before Flop (didn't bet)
Seat 2: 2997qwer (small blind) folded before Flop
Seat 3: kamikkaze (big blind) folded before Flop
Seat 4: BlOnDhOlIc folded before Flop (didn't bet)
Seat 5: phate-1up folded before Flop (didn't bet)
Seat 6: Csabee21 folded before Flop (didn't bet)
Seat 7: acamrash collected ($3.75)
Seat 8: chiyuki folded before Flop (didn't bet)
Seat 9: Suhoff76 folded before Flop (didn't bet)



PokerStars Zoom Hand #84299371376:  Hold'em No Limit ($0.10/$0.25) - 2012/08/05 14:14:51 JST [2012/08/05 1:14:51 ET]
Table 'Whirlpool' 9-max Seat #1 is the button
Seat 1: chiyuki ($20.18 in chips) 
Seat 2: KeLevro0 ($16.82 in chips) 
Seat 3: eyesJeJa ($29.09 in chips) 
Seat 4: craden500 ($24.36 in chips) 
Seat 5: Csabee21 ($24.54 in chips) 
Seat 6: RomarioJa ($11.53 in chips) 
Seat 7: Suhoff76 ($25 in chips) 
Seat 8: Dejacob ($29.61 in chips) 
Seat 9: wtu1986 ($32.32 in chips) 
KeLevro0: posts small blind $0.10
eyesJeJa: posts big blind $0.25
*** HOLE CARDS ***
Dealt to chiyuki [7s Jd]
craden500: folds 
Csabee21: folds 
RomarioJa: folds 
Suhoff76: folds 
Dejacob: folds 
wtu1986: raises $0.50 to $0.75
chiyuki: folds 
KeLevro0: folds 
eyesJeJa: folds 
Uncalled bet ($0.50) returned to wtu1986
wtu1986 collected $0.60 from pot
wtu1986: doesn't show hand 
*** SUMMARY ***
Total pot $0.60 | Rake $0 
Seat 1: chiyuki (button) folded before Flop (didn't bet)
Seat 2: KeLevro0 (small blind) folded before Flop
Seat 3: eyesJeJa (big blind) folded before Flop
Seat 4: craden500 folded before Flop (didn't bet)
Seat 5: Csabee21 folded before Flop (didn't bet)
Seat 6: RomarioJa folded before Flop (didn't bet)
Seat 7: Suhoff76 folded before Flop (didn't bet)
Seat 8: Dejacob folded before Flop (didn't bet)
Seat 9: wtu1986 collected ($0.60)



PokerStars Zoom Hand #84299365905:  Hold'em No Limit ($0.10/$0.25) - 2012/08/05 14:14:28 JST [2012/08/05 1:14:28 ET]
Table 'Whirlpool' 9-max Seat #1 is the button
Seat 1: RomarioJa ($11.53 in chips) 
Seat 2: chiyuki ($20.28 in chips) 
Seat 3: mariuka1 ($13.47 in chips) 
Seat 4: Dafleche ($16.66 in chips) 
Seat 5: Suhoff76 ($25.35 in chips) 
Seat 6: troms20 ($26.05 in chips) 
Seat 7: kamikkaze ($30.34 in chips) 
Seat 8: Rudolf ($41.87 in chips) 
Seat 9: dushvan ($30.57 in chips) 
chiyuki: posts small blind $0.10
mariuka1: posts big blind $0.25
*** HOLE CARDS ***
Dealt to chiyuki [9d 5d]
Dafleche: calls $0.25
Suhoff76: folds 
troms20: folds 
kamikkaze: folds 
Rudolf: calls $0.25
dushvan: folds 
RomarioJa: folds 
chiyuki: folds 
mariuka1: checks 
*** FLOP *** [5s 4h 8c]
mariuka1: bets $0.50
Dafleche: raises $0.50 to $1
Rudolf: folds 
mariuka1: calls $0.50
*** TURN *** [5s 4h 8c] [9c]
mariuka1: checks 
Dafleche: bets $1
mariuka1: calls $1
*** RIVER *** [5s 4h 8c 9c] [2h]
mariuka1: checks 
Dafleche: checks 
*** SHOW DOWN ***
mariuka1: shows [Td 8d] (a pair of Eights)
Dafleche: mucks hand 
mariuka1 collected $4.63 from pot
*** SUMMARY ***
Total pot $4.85 | Rake $0.22 
Board [5s 4h 8c 9c 2h]
Seat 1: RomarioJa (button) folded before Flop (didn't bet)
Seat 2: chiyuki (small blind) folded before Flop
Seat 3: mariuka1 (big blind) showed [Td 8d] and won ($4.63) with a pair of Eights
Seat 4: Dafleche mucked [6s 8s]
Seat 5: Suhoff76 folded before Flop (didn't bet)
Seat 6: troms20 folded before Flop (didn't bet)
Seat 7: kamikkaze folded before Flop (didn't bet)
Seat 8: Rudolf folded on the Flop
Seat 9: dushvan folded before Flop (didn't bet)



PokerStars Zoom Hand #84299374910:  Hold'em No Limit ($0.10/$0.25) - 2012/08/05 14:15:05 JST [2012/08/05 1:15:05 ET]
Table 'Whirlpool' 9-max Seat #1 is the button
Seat 1: Jene4kaBest ($12.15 in chips) 
Seat 2: goddaz116 ($17.25 in chips) 
Seat 3: kkbruins0408 ($12.52 in chips) 
Seat 4: chiyuki ($20.18 in chips) 
Seat 5: RikkStroken ($11.08 in chips) 
Seat 6: Nerkit ($11.10 in chips) 
Seat 7: KAKamiro ($65.54 in chips) 
Seat 8: JLajoie ($24.40 in chips) 
Seat 9: Perstenev ($13 in chips) 
goddaz116: posts small blind $0.10
kkbruins0408: posts big blind $0.25
*** HOLE CARDS ***
Dealt to chiyuki [9d Kc]
chiyuki: folds 
RikkStroken: raises $0.50 to $0.75
Nerkit: folds 
KAKamiro: folds 
JLajoie: calls $0.75
Perstenev: folds 
Jene4kaBest: folds 
goddaz116: folds 
kkbruins0408: folds 
*** FLOP *** [7h 3d Th]
RikkStroken: bets $1.25
JLajoie: folds 
Uncalled bet ($1.25) returned to RikkStroken
RikkStroken collected $1.77 from pot
RikkStroken: doesn't show hand 
*** SUMMARY ***
Total pot $1.85 | Rake $0.08 
Board [7h 3d Th]
Seat 1: Jene4kaBest (button) folded before Flop (didn't bet)
Seat 2: goddaz116 (small blind) folded before Flop
Seat 3: kkbruins0408 (big blind) folded before Flop
Seat 4: chiyuki folded before Flop (didn't bet)
Seat 5: RikkStroken collected ($1.77)
Seat 6: Nerkit folded before Flop (didn't bet)
Seat 7: KAKamiro folded before Flop (didn't bet)
Seat 8: JLajoie folded on the Flop
Seat 9: Perstenev folded before Flop (didn't bet)



PokerStars Zoom Hand #84299376153:  Hold'em No Limit ($0.10/$0.25) - 2012/08/05 14:15:10 JST [2012/08/05 1:15:10 ET]
Table 'Whirlpool' 9-max Seat #1 is the button
Seat 1: simonzez ($49.36 in chips) 
Seat 2: leo2095 ($12.12 in chips) 
Seat 3: chiyuki ($20.18 in chips) 
Seat 4: 4thepeople ($21.59 in chips) 
Seat 5: JLajoie ($24.65 in chips) 
Seat 6: Loholov ($20.67 in chips) 
Seat 7: Suhoff76 ($25 in chips) 
Seat 8: RomarioJa ($11.53 in chips) 
Seat 9: Perstenev ($12.92 in chips) 
leo2095: posts small blind $0.10
chiyuki: posts big blind $0.25
*** HOLE CARDS ***
Dealt to chiyuki [4d 8h]
4thepeople: folds 
JLajoie: folds 
Loholov: folds 
Suhoff76: folds 
RomarioJa: folds 
Perstenev: folds 
simonzez: calls $0.25
leo2095: folds 
chiyuki: checks 
*** FLOP *** [6d 9h Th]
chiyuki: checks 
simonzez: bets $0.25
chiyuki: calls $0.25
*** TURN *** [6d 9h Th] [8c]
chiyuki: checks 
simonzez: bets $0.25
chiyuki: calls $0.25
*** RIVER *** [6d 9h Th 8c] [Td]
chiyuki: checks 
simonzez: bets $0.25
chiyuki: calls $0.25
*** SHOW DOWN ***
simonzez: shows [Ad Ac] (two pair, Aces and Tens)
chiyuki: mucks hand 
simonzez collected $2.01 from pot
*** SUMMARY ***
Total pot $2.10 | Rake $0.09 
Board [6d 9h Th 8c Td]
Seat 1: simonzez (button) showed [Ad Ac] and won ($2.01) with two pair, Aces and Tens
Seat 2: leo2095 (small blind) folded before Flop
Seat 3: chiyuki (big blind) mucked [4d 8h]
Seat 4: 4thepeople folded before Flop (didn't bet)
Seat 5: JLajoie folded before Flop (didn't bet)
Seat 6: Loholov folded before Flop (didn't bet)
Seat 7: Suhoff76 folded before Flop (didn't bet)
Seat 8: RomarioJa folded before Flop (didn't bet)
Seat 9: Perstenev folded before Flop (didn't bet)



PokerStars Zoom Hand #84299389364:  Hold'em No Limit ($0.10/$0.25) - 2012/08/05 14:16:04 JST [2012/08/05 1:16:04 ET]
Table 'Whirlpool' 9-max Seat #1 is the button
Seat 1: silvno31 ($39.90 in chips) 
Seat 2: BlOnDhOlIc ($25.10 in chips) 
Seat 3: jeff0923 ($24.79 in chips) 
Seat 4: kamikkaze ($15.97 in chips) 
Seat 5: giorgos_k ($13.73 in chips) 
Seat 6: chiyuki ($25 in chips) 
Seat 7: Anafim ($12.59 in chips) 
Seat 8: Suhoff76 ($25 in chips) 
Seat 9: Dejacob ($25.79 in chips) 
BlOnDhOlIc: posts small blind $0.10
jeff0923: posts big blind $0.25
*** HOLE CARDS ***
Dealt to chiyuki [Jd 4c]
kamikkaze: folds 
giorgos_k: folds 
chiyuki: folds 
Anafim: folds 
Suhoff76: folds 
Dejacob: folds 
silvno31: folds 
BlOnDhOlIc: folds 
Uncalled bet ($0.15) returned to jeff0923
jeff0923 collected $0.20 from pot
jeff0923: doesn't show hand 
*** SUMMARY ***
Total pot $0.20 | Rake $0 
Seat 1: silvno31 (button) folded before Flop (didn't bet)
Seat 2: BlOnDhOlIc (small blind) folded before Flop
Seat 3: jeff0923 (big blind) collected ($0.20)
Seat 4: kamikkaze folded before Flop (didn't bet)
Seat 5: giorgos_k folded before Flop (didn't bet)
Seat 6: chiyuki folded before Flop (didn't bet)
Seat 7: Anafim folded before Flop (didn't bet)
Seat 8: Suhoff76 folded before Flop (didn't bet)
Seat 9: Dejacob folded before Flop (didn't bet)



PokerStars Zoom Hand #84299374133:  Hold'em No Limit ($0.10/$0.25) - 2012/08/05 14:15:02 JST [2012/08/05 1:15:02 ET]
Table 'Whirlpool' 9-max Seat #1 is the button
Seat 1: deadmoneykid ($26.35 in chips) 
Seat 2: Vahe50 ($32.65 in chips) 
Seat 3: BlOnDhOlIc ($52.21 in chips) 
Seat 4: Suhoff76 ($25 in chips) 
Seat 5: acamrash ($13.30 in chips) 
Seat 6: agurio ($29.37 in chips) 
Seat 7: dushvan ($30.57 in chips) 
Seat 8: giorgos_k ($8.35 in chips) 
Seat 9: chiyuki ($20.18 in chips) 
Vahe50: posts small blind $0.10
BlOnDhOlIc: posts big blind $0.25
*** HOLE CARDS ***
Dealt to chiyuki [3d Ks]
Suhoff76: folds 
acamrash: folds 
agurio: folds 
dushvan: folds 
giorgos_k: folds 
chiyuki: folds 
deadmoneykid: raises $0.25 to $0.50
Vahe50: folds 
BlOnDhOlIc: raises $1.50 to $2
deadmoneykid: calls $1.50
*** FLOP *** [5d 5s 9h]
BlOnDhOlIc: bets $2.75
deadmoneykid: raises $4 to $6.75
BlOnDhOlIc: folds 
Uncalled bet ($4) returned to deadmoneykid
deadmoneykid collected $9.17 from pot
deadmoneykid: doesn't show hand 
*** SUMMARY ***
Total pot $9.60 | Rake $0.43 
Board [5d 5s 9h]
Seat 1: deadmoneykid (button) collected ($9.17)
Seat 2: Vahe50 (small blind) folded before Flop
Seat 3: BlOnDhOlIc (big blind) folded on the Flop
Seat 4: Suhoff76 folded before Flop (didn't bet)
Seat 5: acamrash folded before Flop (didn't bet)
Seat 6: agurio folded before Flop (didn't bet)
Seat 7: dushvan folded before Flop (didn't bet)
Seat 8: giorgos_k folded before Flop (didn't bet)
Seat 9: chiyuki folded before Flop (didn't bet)



PokerStars Zoom Hand #84299391654:  Hold'em No Limit ($0.10/$0.25) - 2012/08/05 14:16:13 JST [2012/08/05 1:16:13 ET]
Table 'Whirlpool' 9-max Seat #1 is the button
Seat 1: Suhoff76 ($31.19 in chips) 
Seat 2: chiyuki ($25 in chips) 
Seat 3: Th3Fog ($47.11 in chips) 
Seat 4: wtu1986 ($24.90 in chips) 
Seat 5: Anafim ($12.59 in chips) 
Seat 6: BlOnDhOlIc ($25 in chips) 
Seat 7: goddaz116 ($17.25 in chips) 
Seat 8: troms20 ($21.49 in chips) 
Seat 9: eyesJeJa ($25 in chips) 
chiyuki: posts small blind $0.10
Th3Fog: posts big blind $0.25
*** HOLE CARDS ***
Dealt to chiyuki [7d 9s]
wtu1986: raises $0.50 to $0.75
Anafim: folds 
BlOnDhOlIc: folds 
goddaz116: folds 
troms20: folds 
eyesJeJa: folds 
Suhoff76: folds 
chiyuki: folds 
Th3Fog: folds 
Uncalled bet ($0.50) returned to wtu1986
wtu1986 collected $0.60 from pot
wtu1986: doesn't show hand 
*** SUMMARY ***
Total pot $0.60 | Rake $0 
Seat 1: Suhoff76 (button) folded before Flop (didn't bet)
Seat 2: chiyuki (small blind) folded before Flop
Seat 3: Th3Fog (big blind) folded before Flop
Seat 4: wtu1986 collected ($0.60)
Seat 5: Anafim folded before Flop (didn't bet)
Seat 6: BlOnDhOlIc folded before Flop (didn't bet)
Seat 7: goddaz116 folded before Flop (didn't bet)
Seat 8: troms20 folded before Flop (didn't bet)
Seat 9: eyesJeJa folded before Flop (didn't bet)



PokerStars Zoom Hand #84299394132:  Hold'em No Limit ($0.10/$0.25) - 2012/08/05 14:16:23 JST [2012/08/05 1:16:23 ET]
Table 'Whirlpool' 9-max Seat #1 is the button
Seat 1: acamrash ($12.25 in chips) 
Seat 2: eyesJeJa ($25 in chips) 
Seat 3: Dafleche ($15.56 in chips) 
Seat 4: RikkStroken ($21.66 in chips) 
Seat 5: chiyuki ($24.90 in chips) 
Seat 6: Déculotter69 ($20.48 in chips) 
Seat 7: Nerkit ($12.52 in chips) 
Seat 8: hirozo ($25.25 in chips) 
Seat 9: Ellen1947 ($28.40 in chips) 
eyesJeJa: posts small blind $0.10
Dafleche: posts big blind $0.25
*** HOLE CARDS ***
Dealt to chiyuki [Kh Ah]
RikkStroken: folds 
chiyuki: raises $0.50 to $0.75
Déculotter69: folds 
Nerkit: folds 
hirozo: folds 
Ellen1947: folds 
acamrash: folds 
eyesJeJa: folds 
Dafleche: folds 
Uncalled bet ($0.50) returned to chiyuki
chiyuki collected $0.60 from pot
chiyuki: doesn't show hand 
*** SUMMARY ***
Total pot $0.60 | Rake $0 
Seat 1: acamrash (button) folded before Flop (didn't bet)
Seat 2: eyesJeJa (small blind) folded before Flop
Seat 3: Dafleche (big blind) folded before Flop
Seat 4: RikkStroken folded before Flop (didn't bet)
Seat 5: chiyuki collected ($0.60)
Seat 6: Déculotter69 folded before Flop (didn't bet)
Seat 7: Nerkit folded before Flop (didn't bet)
Seat 8: hirozo folded before Flop (didn't bet)
Seat 9: Ellen1947 folded before Flop (didn't bet)



PokerStars Zoom Hand #84299390380:  Hold'em No Limit ($0.10/$0.25) - 2012/08/05 14:16:08 JST [2012/08/05 1:16:08 ET]
Table 'Whirlpool' 9-max Seat #1 is the button
Seat 1: PetitAlejo ($33.95 in chips) 
Seat 2: Dejacob ($25.79 in chips) 
Seat 3: slapshot2011 ($33.94 in chips) 
Seat 4: Suhoff76 ($31.19 in chips) 
Seat 5: wtu1986 ($24.90 in chips) 
Seat 6: Paranoix1990 ($19.38 in chips) 
Seat 7: chiyuki ($25 in chips) 
Seat 8: BlOnDhOlIc ($25 in chips) 
Seat 9: Vahe50 ($33.22 in chips) 
Dejacob: posts small blind $0.10
slapshot2011: posts big blind $0.25
*** HOLE CARDS ***
Dealt to chiyuki [9h 2d]
Suhoff76: folds 
wtu1986: folds 
Paranoix1990 has timed out
Paranoix1990: folds 
chiyuki: folds 
BlOnDhOlIc: folds 
Vahe50: folds 
PetitAlejo: raises $0.50 to $0.75
Dejacob: calls $0.65
slapshot2011: folds 
*** FLOP *** [8h 8s Tc]
Dejacob: checks 
PetitAlejo: bets $1.25
Dejacob: folds 
Uncalled bet ($1.25) returned to PetitAlejo
PetitAlejo collected $1.67 from pot
PetitAlejo: doesn't show hand 
*** SUMMARY ***
Total pot $1.75 | Rake $0.08 
Board [8h 8s Tc]
Seat 1: PetitAlejo (button) collected ($1.67)
Seat 2: Dejacob (small blind) folded on the Flop
Seat 3: slapshot2011 (big blind) folded before Flop
Seat 4: Suhoff76 folded before Flop (didn't bet)
Seat 5: wtu1986 folded before Flop (didn't bet)
Seat 6: Paranoix1990 folded before Flop (didn't bet)
Seat 7: chiyuki folded before Flop (didn't bet)
Seat 8: BlOnDhOlIc folded before Flop (didn't bet)
Seat 9: Vahe50 folded before Flop (didn't bet)



PokerStars Zoom Hand #84299397303:  Hold'em No Limit ($0.10/$0.25) - 2012/08/05 14:16:36 JST [2012/08/05 1:16:36 ET]
Table 'Whirlpool' 9-max Seat #1 is the button
Seat 1: leo2095 ($11.27 in chips) 
Seat 2: Dejacob ($29.71 in chips) 
Seat 3: Dan Royal ($43.31 in chips) 
Seat 4: hirozo ($25.25 in chips) 
Seat 5: troms20 ($28.40 in chips) 
Seat 6: Th3Fog ($74.93 in chips) 
Seat 7: ygoegoe ($27.96 in chips) 
Seat 8: chiyuki ($25.25 in chips) 
Seat 9: dushvan ($30.92 in chips) 
Dejacob: posts small blind $0.10
Dan Royal: posts big blind $0.25
*** HOLE CARDS ***
Dealt to chiyuki [Ac Th]
hirozo: raises $0.50 to $0.75
troms20: folds 
Th3Fog: folds 
ygoegoe: folds 
chiyuki: folds 
dushvan: folds 
leo2095: folds 
Dejacob: folds 
Dan Royal: folds 
Uncalled bet ($0.50) returned to hirozo
hirozo collected $0.60 from pot
hirozo: doesn't show hand 
*** SUMMARY ***
Total pot $0.60 | Rake $0 
Seat 1: leo2095 (button) folded before Flop (didn't bet)
Seat 2: Dejacob (small blind) folded before Flop
Seat 3: Dan Royal (big blind) folded before Flop
Seat 4: hirozo collected ($0.60)
Seat 5: troms20 folded before Flop (didn't bet)
Seat 6: Th3Fog folded before Flop (didn't bet)
Seat 7: ygoegoe folded before Flop (didn't bet)
Seat 8: chiyuki folded before Flop (didn't bet)
Seat 9: dushvan folded before Flop (didn't bet)



PokerStars Zoom Hand #84299401155:  Hold'em No Limit ($0.10/$0.25) - 2012/08/05 14:16:51 JST [2012/08/05 1:16:51 ET]
Table 'Whirlpool' 9-max Seat #1 is the button
Seat 1: hirozo ($25.60 in chips) 
Seat 2: agurio ($28.12 in chips) 
Seat 3: BlOnDhOlIc ($60.21 in chips) 
Seat 4: Paranoix1990 ($19.38 in chips) 
Seat 5: troms20 ($26.51 in chips) 
Seat 6: chiyuki ($25.25 in chips) 
Seat 7: RomarioJa ($13.43 in chips) 
Seat 8: Lasutchik ($8.68 in chips) 
Seat 9: eyesJeJa ($25 in chips) 
agurio: posts small blind $0.10
BlOnDhOlIc: posts big blind $0.25
*** HOLE CARDS ***
Dealt to chiyuki [4h Ac]
Paranoix1990: folds 
troms20: folds 
chiyuki: folds 
RomarioJa: folds 
Lasutchik: folds 
eyesJeJa: folds 
hirozo: raises $0.25 to $0.50
agurio: folds 
BlOnDhOlIc: folds 
Uncalled bet ($0.25) returned to hirozo
hirozo collected $0.60 from pot
hirozo: doesn't show hand 
*** SUMMARY ***
Total pot $0.60 | Rake $0 
Seat 1: hirozo (button) collected ($0.60)
Seat 2: agurio (small blind) folded before Flop
Seat 3: BlOnDhOlIc (big blind) folded before Flop
Seat 4: Paranoix1990 folded before Flop (didn't bet)
Seat 5: troms20 folded before Flop (didn't bet)
Seat 6: chiyuki folded before Flop (didn't bet)
Seat 7: RomarioJa folded before Flop (didn't bet)
Seat 8: Lasutchik folded before Flop (didn't bet)
Seat 9: eyesJeJa folded before Flop (didn't bet)



PokerStars Zoom Hand #84299404335:  Hold'em No Limit ($0.10/$0.25) - 2012/08/05 14:17:04 JST [2012/08/05 1:17:04 ET]
Table 'Whirlpool' 9-max Seat #1 is the button
Seat 1: Ellen1947 ($41.42 in chips) 
Seat 2: PetitAlejo ($29.49 in chips) 
Seat 3: Vahe50 ($20.16 in chips) 
Seat 4: chiyuki ($25.25 in chips) 
Seat 5: seula i ($25.60 in chips) 
Seat 6: eyesJeJa ($28.92 in chips) 
Seat 7: Lasutchik ($8.68 in chips) 
Seat 8: RikkStroken ($11.10 in chips) 
Seat 9: Perstenev ($12.92 in chips) 
PetitAlejo: posts small blind $0.10
Vahe50: posts big blind $0.25
*** HOLE CARDS ***
Dealt to chiyuki [Kh Ah]
chiyuki: raises $0.50 to $0.75
seula i: folds 
eyesJeJa: folds 
Lasutchik: folds 
RikkStroken: folds 
Perstenev: folds 
Ellen1947: folds 
PetitAlejo: folds 
Vahe50: folds 
Uncalled bet ($0.50) returned to chiyuki
chiyuki collected $0.60 from pot
chiyuki: doesn't show hand 
*** SUMMARY ***
Total pot $0.60 | Rake $0 
Seat 1: Ellen1947 (button) folded before Flop (didn't bet)
Seat 2: PetitAlejo (small blind) folded before Flop
Seat 3: Vahe50 (big blind) folded before Flop
Seat 4: chiyuki collected ($0.60)
Seat 5: seula i folded before Flop (didn't bet)
Seat 6: eyesJeJa folded before Flop (didn't bet)
Seat 7: Lasutchik folded before Flop (didn't bet)
Seat 8: RikkStroken folded before Flop (didn't bet)
Seat 9: Perstenev folded before Flop (didn't bet)



PokerStars Zoom Hand #84299399121:  Hold'em No Limit ($0.10/$0.25) - 2012/08/05 14:16:43 JST [2012/08/05 1:16:43 ET]
Table 'Whirlpool' 9-max Seat #1 is the button
Seat 1: chiyuki ($25.25 in chips) 
Seat 2: jeff0923 ($24.64 in chips) 
Seat 3: deadmoneykid ($23.95 in chips) 
Seat 4: KeLevro0 ($10.78 in chips) 
Seat 5: Vahe50 ($33.22 in chips) 
Seat 6: BlOnDhOlIc ($60.21 in chips) 
Seat 7: D@vidMed ($70.54 in chips) 
Seat 8: Loholov ($17.90 in chips) 
Seat 9: acamrash ($12.15 in chips) 
jeff0923: posts small blind $0.10
deadmoneykid: posts big blind $0.25
*** HOLE CARDS ***
Dealt to chiyuki [2d Js]
KeLevro0: folds 
Vahe50: folds 
BlOnDhOlIc: folds 
D@vidMed: folds 
Loholov: folds 
acamrash: folds 
chiyuki: folds 
jeff0923: raises $0.25 to $0.50
deadmoneykid: calls $0.25
*** FLOP *** [8s 8d 6d]
jeff0923: checks 
deadmoneykid: checks 
*** TURN *** [8s 8d 6d] [6h]
jeff0923: bets $1
deadmoneykid: folds 
Uncalled bet ($1) returned to jeff0923
jeff0923 collected $0.96 from pot
jeff0923: doesn't show hand 
*** SUMMARY ***
Total pot $1 | Rake $0.04 
Board [8s 8d 6d 6h]
Seat 1: chiyuki (button) folded before Flop (didn't bet)
Seat 2: jeff0923 (small blind) collected ($0.96)
Seat 3: deadmoneykid (big blind) folded on the Turn
Seat 4: KeLevro0 folded before Flop (didn't bet)
Seat 5: Vahe50 folded before Flop (didn't bet)
Seat 6: BlOnDhOlIc folded before Flop (didn't bet)
Seat 7: D@vidMed folded before Flop (didn't bet)
Seat 8: Loholov folded before Flop (didn't bet)
Seat 9: acamrash folded before Flop (didn't bet)



PokerStars Zoom Hand #84299403620:  Hold'em No Limit ($0.10/$0.25) - 2012/08/05 14:17:01 JST [2012/08/05 1:17:01 ET]
Table 'Whirlpool' 9-max Seat #1 is the button
Seat 1: Perstenev ($12.92 in chips) 
Seat 2: ygoegoe ($31.41 in chips) 
Seat 3: Paranoix1990 ($19.38 in chips) 
Seat 4: Th3Fog ($17.36 in chips) 
Seat 5: chiyuki ($25.25 in chips) 
Seat 6: flyinprits ($35.21 in chips) 
Seat 7: gunbowler ($143.20 in chips) 
Seat 8: taksist889 ($42.65 in chips) 
Seat 9: acamrash ($8.53 in chips) 
ygoegoe: posts small blind $0.10
Paranoix1990: posts big blind $0.25
*** HOLE CARDS ***
Dealt to chiyuki [4c 3h]
Th3Fog: folds 
chiyuki: folds 
flyinprits: folds 
gunbowler: folds 
taksist889: raises $0.50 to $0.75
acamrash: folds 
Perstenev: folds 
ygoegoe: folds 
Paranoix1990: calls $0.50
*** FLOP *** [7d Ts 8h]
Paranoix1990: checks 
taksist889: bets $1.50
Paranoix1990: calls $1.50
*** TURN *** [7d Ts 8h] [3d]
Paranoix1990: checks 
taksist889: bets $3.25
Paranoix1990: calls $3.25
*** RIVER *** [7d Ts 8h 3d] [5c]
Paranoix1990: checks 
taksist889: bets $6.25
Paranoix1990: calls $6.25
*** SHOW DOWN ***
taksist889: shows [Ah Ac] (a pair of Aces)
Paranoix1990: mucks hand 
taksist889 collected $22.54 from pot
*** SUMMARY ***
Total pot $23.60 | Rake $1.06 
Board [7d Ts 8h 3d 5c]
Seat 1: Perstenev (button) folded before Flop (didn't bet)
Seat 2: ygoegoe (small blind) folded before Flop
Seat 3: Paranoix1990 (big blind) mucked [Th Jh]
Seat 4: Th3Fog folded before Flop (didn't bet)
Seat 5: chiyuki folded before Flop (didn't bet)
Seat 6: flyinprits folded before Flop (didn't bet)
Seat 7: gunbowler folded before Flop (didn't bet)
Seat 8: taksist889 showed [Ah Ac] and won ($22.54) with a pair of Aces
Seat 9: acamrash folded before Flop (didn't bet)



PokerStars Zoom Hand #84299409618:  Hold'em No Limit ($0.10/$0.25) - 2012/08/05 14:17:26 JST [2012/08/05 1:17:26 ET]
Table 'Whirlpool' 9-max Seat #1 is the button
Seat 1: mariuka1 ($19.03 in chips) 
Seat 2: acamrash ($13.73 in chips) 
Seat 3: wtu1986 ($26.03 in chips) 
Seat 4: Spartacus675 ($29.84 in chips) 
Seat 5: eyesJeJa ($25 in chips) 
Seat 6: Dejacob ($25.14 in chips) 
Seat 7: Perstenev ($10.95 in chips) 
Seat 8: ll_LaMeR_ll ($47.52 in chips) 
Seat 9: chiyuki ($25.60 in chips) 
acamrash: posts small blind $0.10
wtu1986: posts big blind $0.25
*** HOLE CARDS ***
Dealt to chiyuki [5s Js]
Spartacus675: folds 
eyesJeJa: folds 
Dejacob: folds 
Perstenev: raises $0.50 to $0.75
ll_LaMeR_ll: calls $0.75
chiyuki: folds 
mariuka1: folds 
acamrash: folds 
wtu1986: calls $0.50
*** FLOP *** [Jc 3s 3d]
wtu1986: checks 
Perstenev: bets $1.12
ll_LaMeR_ll: folds 
wtu1986: folds 
Uncalled bet ($1.12) returned to Perstenev
Perstenev collected $2.24 from pot
Perstenev: doesn't show hand 
*** SUMMARY ***
Total pot $2.35 | Rake $0.11 
Board [Jc 3s 3d]
Seat 1: mariuka1 (button) folded before Flop (didn't bet)
Seat 2: acamrash (small blind) folded before Flop
Seat 3: wtu1986 (big blind) folded on the Flop
Seat 4: Spartacus675 folded before Flop (didn't bet)
Seat 5: eyesJeJa folded before Flop (didn't bet)
Seat 6: Dejacob folded before Flop (didn't bet)
Seat 7: Perstenev collected ($2.24)
Seat 8: ll_LaMeR_ll folded on the Flop
Seat 9: chiyuki folded before Flop (didn't bet)



PokerStars Zoom Hand #84299410646:  Hold'em No Limit ($0.10/$0.25) - 2012/08/05 14:17:30 JST [2012/08/05 1:17:30 ET]
Table 'Whirlpool' 9-max Seat #1 is the button
Seat 1: flyinprits ($29.44 in chips) 
Seat 2: deadmoneykid ($21.75 in chips) 
Seat 3: chiyuki ($25.60 in chips) 
Seat 4: eyesJeJa ($25 in chips) 
Seat 5: Suhoff76 ($30.84 in chips) 
Seat 6: RikkStroken ($26.86 in chips) 
Seat 7: PetitAlejo ($35.73 in chips) 
Seat 8: softdesign ($71.77 in chips) 
Seat 9: Dan Royal ($41.49 in chips) 
deadmoneykid: posts small blind $0.10
chiyuki: posts big blind $0.25
*** HOLE CARDS ***
Dealt to chiyuki [8h 3h]
eyesJeJa: folds 
Suhoff76: raises $0.32 to $0.57
RikkStroken: folds 
PetitAlejo: folds 
softdesign: folds 
Dan Royal: folds 
flyinprits: folds 
deadmoneykid: folds 
chiyuki: calls $0.32
*** FLOP *** [9d Td Qh]
chiyuki: checks 
Suhoff76: checks 
*** TURN *** [9d Td Qh] [9h]
chiyuki: checks 
Suhoff76: checks 
*** RIVER *** [9d Td Qh 9h] [7s]
chiyuki: checks 
Suhoff76: checks 
*** SHOW DOWN ***
chiyuki: shows [8h 3h] (a pair of Nines)
Suhoff76: shows [5d 5s] (two pair, Nines and Fives)
Suhoff76 collected $1.18 from pot
*** SUMMARY ***
Total pot $1.24 | Rake $0.06 
Board [9d Td Qh 9h 7s]
Seat 1: flyinprits (button) folded before Flop (didn't bet)
Seat 2: deadmoneykid (small blind) folded before Flop
Seat 3: chiyuki (big blind) showed [8h 3h] and lost with a pair of Nines
Seat 4: eyesJeJa folded before Flop (didn't bet)
Seat 5: Suhoff76 showed [5d 5s] and won ($1.18) with two pair, Nines and Fives
Seat 6: RikkStroken folded before Flop (didn't bet)
Seat 7: PetitAlejo folded before Flop (didn't bet)
Seat 8: softdesign folded before Flop (didn't bet)
Seat 9: Dan Royal folded before Flop (didn't bet)



PokerStars Zoom Hand #84299432087:  Hold'em No Limit ($0.10/$0.25) - 2012/08/05 14:18:57 JST [2012/08/05 1:18:57 ET]
Table 'Whirlpool' 9-max Seat #1 is the button
Seat 1: Jene4kaBest ($12.66 in chips) 
Seat 2: Wilcox76607 ($22.20 in chips) 
Seat 3: Roglus ($59.44 in chips) 
Seat 4: BlOnDhOlIc ($88.41 in chips) 
Seat 5: seula i ($27.74 in chips) 
Seat 6: troms20 ($58.33 in chips) 
Seat 7: chiyuki ($24.93 in chips) 
Seat 8: Faraz ($21.47 in chips) 
Seat 9: Perstenev ($12.65 in chips) 
Wilcox76607: posts small blind $0.10
Roglus: posts big blind $0.25
*** HOLE CARDS ***
Dealt to chiyuki [Ah 6h]
BlOnDhOlIc: folds 
seula i: folds 
troms20: folds 
chiyuki: folds 
Faraz: folds 
Perstenev: folds 
Jene4kaBest: folds 
Wilcox76607: raises $0.25 to $0.50
Roglus: folds 
Uncalled bet ($0.25) returned to Wilcox76607
Wilcox76607 collected $0.50 from pot
Wilcox76607: doesn't show hand 
*** SUMMARY ***
Total pot $0.50 | Rake $0 
Seat 1: Jene4kaBest (button) folded before Flop (didn't bet)
Seat 2: Wilcox76607 (small blind) collected ($0.50)
Seat 3: Roglus (big blind) folded before Flop
Seat 4: BlOnDhOlIc folded before Flop (didn't bet)
Seat 5: seula i folded before Flop (didn't bet)
Seat 6: troms20 folded before Flop (didn't bet)
Seat 7: chiyuki folded before Flop (didn't bet)
Seat 8: Faraz folded before Flop (didn't bet)
Seat 9: Perstenev folded before Flop (didn't bet)



PokerStars Zoom Hand #84299427731:  Hold'em No Limit ($0.10/$0.25) - 2012/08/05 14:18:40 JST [2012/08/05 1:18:40 ET]
Table 'Whirlpool' 9-max Seat #1 is the button
Seat 1: simonzez ($47.91 in chips) 
Seat 2: chiyuki ($25.03 in chips) 
Seat 3: dushvan ($30.92 in chips) 
Seat 4: acamrash ($11.80 in chips) 
Seat 5: phate-1up ($25 in chips) 
Seat 6: Nerkit ($9.20 in chips) 
Seat 7: Dan Royal ($41.84 in chips) 
Seat 8: hirozo ($33.22 in chips) 
Seat 9: Th3Fog ($17.57 in chips) 
chiyuki: posts small blind $0.10
dushvan: posts big blind $0.25
*** HOLE CARDS ***
Dealt to chiyuki [Kd 2s]
acamrash: folds 
phate-1up: folds 
Nerkit: folds 
Dan Royal: folds 
hirozo: folds 
Th3Fog: folds 
simonzez: calls $0.25
chiyuki: folds 
dushvan: checks 
*** FLOP *** [As Ad 6d]
dushvan: checks 
simonzez: checks 
*** TURN *** [As Ad 6d] [Jc]
dushvan: checks 
simonzez: checks 
*** RIVER *** [As Ad 6d Jc] [Ah]
dushvan: bets $0.25
simonzez: raises $1.50 to $1.75
dushvan: folds 
Uncalled bet ($1.50) returned to simonzez
simonzez collected $1.05 from pot
simonzez: doesn't show hand 
*** SUMMARY ***
Total pot $1.10 | Rake $0.05 
Board [As Ad 6d Jc Ah]
Seat 1: simonzez (button) collected ($1.05)
Seat 2: chiyuki (small blind) folded before Flop
Seat 3: dushvan (big blind) folded on the River
Seat 4: acamrash folded before Flop (didn't bet)
Seat 5: phate-1up folded before Flop (didn't bet)
Seat 6: Nerkit folded before Flop (didn't bet)
Seat 7: Dan Royal folded before Flop (didn't bet)
Seat 8: hirozo folded before Flop (didn't bet)
Seat 9: Th3Fog folded before Flop (didn't bet)



PokerStars Zoom Hand #84299430824:  Hold'em No Limit ($0.10/$0.25) - 2012/08/05 14:18:52 JST [2012/08/05 1:18:52 ET]
Table 'Whirlpool' 9-max Seat #1 is the button
Seat 1: ygoegoe ($27.56 in chips) 
Seat 2: eyesJeJa ($25.04 in chips) 
Seat 3: Dejacob ($25 in chips) 
Seat 4: el pore 5 ($14.77 in chips) 
Seat 5: hirozo ($33.57 in chips) 
Seat 6: phate-1up ($34.59 in chips) 
Seat 7: ChrisCDee ($68.38 in chips) 
Seat 8: chiyuki ($24.93 in chips) 
Seat 9: Suhoff76 ($31.20 in chips) 
eyesJeJa: posts small blind $0.10
Dejacob: posts big blind $0.25
*** HOLE CARDS ***
Dealt to chiyuki [3d 7h]
el pore 5: folds 
hirozo: folds 
phate-1up: folds 
ChrisCDee: folds 
chiyuki: folds 
Suhoff76: raises $0.32 to $0.57
ygoegoe: folds 
eyesJeJa: folds 
Dejacob: folds 
Uncalled bet ($0.32) returned to Suhoff76
Suhoff76 collected $0.60 from pot
Suhoff76: doesn't show hand 
*** SUMMARY ***
Total pot $0.60 | Rake $0 
Seat 1: ygoegoe (button) folded before Flop (didn't bet)
Seat 2: eyesJeJa (small blind) folded before Flop
Seat 3: Dejacob (big blind) folded before Flop
Seat 4: el pore 5 folded before Flop (didn't bet)
Seat 5: hirozo folded before Flop (didn't bet)
Seat 6: phate-1up folded before Flop (didn't bet)
Seat 7: ChrisCDee folded before Flop (didn't bet)
Seat 8: chiyuki folded before Flop (didn't bet)
Seat 9: Suhoff76 collected ($0.60)



PokerStars Zoom Hand #84299435520:  Hold'em No Limit ($0.10/$0.25) - 2012/08/05 14:19:11 JST [2012/08/05 1:19:11 ET]
Table 'Whirlpool' 9-max Seat #1 is the button
Seat 1: Déculotter69 ($16.10 in chips) 
Seat 2: Lasutchik ($8.66 in chips) 
Seat 3: Suhoff76 ($25 in chips) 
Seat 4: chiyuki ($24.93 in chips) 
Seat 5: KeLevro0 ($12.50 in chips) 
Seat 6: deadmoneykid ($23.38 in chips) 
Seat 7: roksmokndonk ($33.56 in chips) 
Seat 8: PetitAlejo ($28.74 in chips) 
Seat 9: kkbruins0408 ($14.01 in chips) 
Lasutchik: posts small blind $0.10
Suhoff76: posts big blind $0.25
*** HOLE CARDS ***
Dealt to chiyuki [Ah 6c]
chiyuki: folds 
KeLevro0: folds 
deadmoneykid: folds 
roksmokndonk: folds 
PetitAlejo: raises $0.50 to $0.75
kkbruins0408: folds 
Déculotter69: folds 
Lasutchik: folds 
Suhoff76: calls $0.50
*** FLOP *** [Js 9c Ac]
Suhoff76: checks 
PetitAlejo: bets $1
Suhoff76: folds 
Uncalled bet ($1) returned to PetitAlejo
PetitAlejo collected $1.53 from pot
PetitAlejo: doesn't show hand 
*** SUMMARY ***
Total pot $1.60 | Rake $0.07 
Board [Js 9c Ac]
Seat 1: Déculotter69 (button) folded before Flop (didn't bet)
Seat 2: Lasutchik (small blind) folded before Flop
Seat 3: Suhoff76 (big blind) folded on the Flop
Seat 4: chiyuki folded before Flop (didn't bet)
Seat 5: KeLevro0 folded before Flop (didn't bet)
Seat 6: deadmoneykid folded before Flop (didn't bet)
Seat 7: roksmokndonk folded before Flop (didn't bet)
Seat 8: PetitAlejo collected ($1.53)
Seat 9: kkbruins0408 folded before Flop (didn't bet)



PokerStars Zoom Hand #84299437010:  Hold'em No Limit ($0.10/$0.25) - 2012/08/05 14:19:17 JST [2012/08/05 1:19:17 ET]
Table 'Whirlpool' 9-max Seat #1 is the button
Seat 1: hirozo ($33.32 in chips) 
Seat 2: Lasutchik ($58.53 in chips) 
Seat 3: Perstenev ($11.74 in chips) 
Seat 4: kamikkaze ($12.10 in chips) 
Seat 5: chiyuki ($24.93 in chips) 
Seat 6: JLajoie ($26.80 in chips) 
Seat 7: Wilcox76607 ($22.45 in chips) 
Seat 8: Loholov ($16.75 in chips) 
Seat 9: simonzez ($48.46 in chips) 
Lasutchik: posts small blind $0.10
Perstenev: posts big blind $0.25
*** HOLE CARDS ***
Dealt to chiyuki [5s Th]
kamikkaze: folds 
chiyuki: folds 
JLajoie: folds 
Wilcox76607: folds 
Loholov: folds 
simonzez: calls $0.25
hirozo: folds 
Lasutchik: calls $0.15
Perstenev: checks 
*** FLOP *** [Qd 6c 5c]
Lasutchik: checks 
Perstenev: checks 
simonzez: bets $0.50
Lasutchik: folds 
Perstenev: folds 
Uncalled bet ($0.50) returned to simonzez
simonzez collected $0.72 from pot
simonzez: doesn't show hand 
*** SUMMARY ***
Total pot $0.75 | Rake $0.03 
Board [Qd 6c 5c]
Seat 1: hirozo (button) folded before Flop (didn't bet)
Seat 2: Lasutchik (small blind) folded on the Flop
Seat 3: Perstenev (big blind) folded on the Flop
Seat 4: kamikkaze folded before Flop (didn't bet)
Seat 5: chiyuki folded before Flop (didn't bet)
Seat 6: JLajoie folded before Flop (didn't bet)
Seat 7: Wilcox76607 folded before Flop (didn't bet)
Seat 8: Loholov folded before Flop (didn't bet)
Seat 9: simonzez collected ($0.72)



PokerStars Zoom Hand #84299434537:  Hold'em No Limit ($0.10/$0.25) - 2012/08/05 14:19:07 JST [2012/08/05 1:19:07 ET]
Table 'Whirlpool' 9-max Seat #1 is the button
Seat 1: chiyuki ($24.93 in chips) 
Seat 2: Nerkit ($11.65 in chips) 
Seat 3: hirozo ($33.57 in chips) 
Seat 4: troms20 ($28.30 in chips) 
Seat 5: D@vidMed ($69.94 in chips) 
Seat 6: KAKamiro ($66.38 in chips) 
Seat 7: phate-1up ($25 in chips) 
Seat 8: BlOnDhOlIc ($59.46 in chips) 
Seat 9: sparky5224 ($35.41 in chips) 
Nerkit: posts small blind $0.10
hirozo: posts big blind $0.25
*** HOLE CARDS ***
Dealt to chiyuki [6s 9c]
troms20: raises $0.50 to $0.75
D@vidMed: folds 
KAKamiro: calls $0.75
phate-1up: raises $2.25 to $3
BlOnDhOlIc has timed out
BlOnDhOlIc: folds 
sparky5224: folds 
chiyuki: folds 
Nerkit: folds 
hirozo: folds 
troms20: folds 
KAKamiro: folds 
Uncalled bet ($2.25) returned to phate-1up
phate-1up collected $2.60 from pot
phate-1up: doesn't show hand 
*** SUMMARY ***
Total pot $2.60 | Rake $0 
Seat 1: chiyuki (button) folded before Flop (didn't bet)
Seat 2: Nerkit (small blind) folded before Flop
Seat 3: hirozo (big blind) folded before Flop
Seat 4: troms20 folded before Flop
Seat 5: D@vidMed folded before Flop (didn't bet)
Seat 6: KAKamiro folded before Flop
Seat 7: phate-1up collected ($2.60)
Seat 8: BlOnDhOlIc folded before Flop (didn't bet)
Seat 9: sparky5224 folded before Flop (didn't bet)



PokerStars Zoom Hand #84299449445:  Hold'em No Limit ($0.10/$0.25) - 2012/08/05 14:20:08 JST [2012/08/05 1:20:08 ET]
Table 'Whirlpool' 9-max Seat #1 is the button
Seat 1: ygoegoe ($31.01 in chips) 
Seat 2: chiyuki ($24.68 in chips) 
Seat 3: caro196661cv ($25 in chips) 
Seat 4: seula i ($28.05 in chips) 
Seat 5: Th3Fog ($17.22 in chips) 
Seat 6: agurio ($25 in chips) 
Seat 7: troms20 ($21.49 in chips) 
Seat 8: KeLevro0 ($11.12 in chips) 
Seat 9: RomarioJa ($13.06 in chips) 
chiyuki: posts small blind $0.10
caro196661cv: posts big blind $0.25
*** HOLE CARDS ***
Dealt to chiyuki [9s 7d]
seula i: folds 
Th3Fog: folds 
agurio: folds 
troms20: folds 
KeLevro0: folds 
RomarioJa: folds 
ygoegoe: folds 
chiyuki: folds 
Uncalled bet ($0.15) returned to caro196661cv
caro196661cv collected $0.20 from pot
caro196661cv: doesn't show hand 
*** SUMMARY ***
Total pot $0.20 | Rake $0 
Seat 1: ygoegoe (button) folded before Flop (didn't bet)
Seat 2: chiyuki (small blind) folded before Flop
Seat 3: caro196661cv (big blind) collected ($0.20)
Seat 4: seula i folded before Flop (didn't bet)
Seat 5: Th3Fog folded before Flop (didn't bet)
Seat 6: agurio folded before Flop (didn't bet)
Seat 7: troms20 folded before Flop (didn't bet)
Seat 8: KeLevro0 folded before Flop (didn't bet)
Seat 9: RomarioJa folded before Flop (didn't bet)



PokerStars Zoom Hand #84299447255:  Hold'em No Limit ($0.10/$0.25) - 2012/08/05 14:19:59 JST [2012/08/05 1:19:59 ET]
Table 'Whirlpool' 9-max Seat #1 is the button
Seat 1: Dejacob ($31.33 in chips) 
Seat 2: Ellen1947 ($27.80 in chips) 
Seat 3: Loholov ($21.94 in chips) 
Seat 4: craden500 ($18.95 in chips) 
Seat 5: troms20 ($21.49 in chips) 
Seat 6: KeLevro0 ($12.15 in chips) 
Seat 7: seula i ($28.05 in chips) 
Seat 8: DanielWhyte ($22.33 in chips) 
Seat 9: chiyuki ($24.68 in chips) 
Ellen1947: posts small blind $0.10
Loholov: posts big blind $0.25
*** HOLE CARDS ***
Dealt to chiyuki [5c 6s]
craden500: folds 
troms20: folds 
KeLevro0: folds 
seula i: folds 
DanielWhyte: folds 
chiyuki: folds 
Dejacob: raises $0.50 to $0.75
Ellen1947: folds 
Loholov: calls $0.50
*** FLOP *** [3d 6d 5s]
Loholov: checks 
Dejacob: bets $1
Loholov: folds 
Uncalled bet ($1) returned to Dejacob
Dejacob collected $1.53 from pot
Dejacob: doesn't show hand 
*** SUMMARY ***
Total pot $1.60 | Rake $0.07 
Board [3d 6d 5s]
Seat 1: Dejacob (button) collected ($1.53)
Seat 2: Ellen1947 (small blind) folded before Flop
Seat 3: Loholov (big blind) folded on the Flop
Seat 4: craden500 folded before Flop (didn't bet)
Seat 5: troms20 folded before Flop (didn't bet)
Seat 6: KeLevro0 folded before Flop (didn't bet)
Seat 7: seula i folded before Flop (didn't bet)
Seat 8: DanielWhyte folded before Flop (didn't bet)
Seat 9: chiyuki folded before Flop (didn't bet)



PokerStars Zoom Hand #84299450671:  Hold'em No Limit ($0.10/$0.25) - 2012/08/05 14:20:13 JST [2012/08/05 1:20:13 ET]
Table 'Whirlpool' 9-max Seat #1 is the button
Seat 1: deadmoneykid ($31.80 in chips) 
Seat 2: troms20 ($21.49 in chips) 
Seat 3: mariuka1 ($12.50 in chips) 
Seat 4: jeff0923 ($25.51 in chips) 
Seat 5: Perstenev ($13.56 in chips) 
Seat 6: acamrash ($12.41 in chips) 
Seat 7: AlfredE525 ($15 in chips) 
Seat 8: chiyuki ($24.58 in chips) 
Seat 9: PetitAlejo ($36.11 in chips) 
troms20: posts small blind $0.10
mariuka1: posts big blind $0.25
*** HOLE CARDS ***
Dealt to chiyuki [Ah Tc]
jeff0923: folds 
Perstenev: folds 
acamrash: folds 
AlfredE525: raises $0.37 to $0.62
chiyuki: folds 
PetitAlejo: folds 
deadmoneykid: folds 
troms20: folds 
mariuka1: folds 
Uncalled bet ($0.37) returned to AlfredE525
AlfredE525 collected $0.60 from pot
AlfredE525: doesn't show hand 
*** SUMMARY ***
Total pot $0.60 | Rake $0 
Seat 1: deadmoneykid (button) folded before Flop (didn't bet)
Seat 2: troms20 (small blind) folded before Flop
Seat 3: mariuka1 (big blind) folded before Flop
Seat 4: jeff0923 folded before Flop (didn't bet)
Seat 5: Perstenev folded before Flop (didn't bet)
Seat 6: acamrash folded before Flop (didn't bet)
Seat 7: AlfredE525 collected ($0.60)
Seat 8: chiyuki folded before Flop (didn't bet)
Seat 9: PetitAlejo folded before Flop (didn't bet)



PokerStars Zoom Hand #84299436266:  Hold'em No Limit ($0.10/$0.25) - 2012/08/05 14:19:14 JST [2012/08/05 1:19:14 ET]
Table 'Whirlpool' 9-max Seat #1 is the button
Seat 1: fezman ($13.88 in chips) 
Seat 2: RomarioJa ($12.60 in chips) 
Seat 3: Dafleche ($15.07 in chips) 
Seat 4: Perstenev ($11.74 in chips) 
Seat 5: deadmoneykid ($23.45 in chips) 
Seat 6: chiyuki ($24.93 in chips) 
Seat 7: wtu1986 ($32.17 in chips) 
Seat 8: Vahe50 ($33.57 in chips) 
Seat 9: 4thepeople ($23.48 in chips) 
RomarioJa: posts small blind $0.10
Dafleche: posts big blind $0.25
*** HOLE CARDS ***
Dealt to chiyuki [2c 4c]
Perstenev: folds 
deadmoneykid: folds 
chiyuki: folds 
wtu1986: folds 
Vahe50: raises $0.25 to $0.50
4thepeople: calls $0.50
fezman: folds 
RomarioJa: folds 
Dafleche: calls $0.25
*** FLOP *** [5d 6s 2d]
Dafleche: checks 
Vahe50: bets $0.75
4thepeople: folds 
Dafleche: calls $0.75
*** TURN *** [5d 6s 2d] [7s]
Dafleche: checks 
Vahe50: bets $2.50
Dafleche: calls $2.50
*** RIVER *** [5d 6s 2d 7s] [7h]
Dafleche: bets $7
Vahe50: calls $7
*** SHOW DOWN ***
Dafleche: shows [8c 9c] (a straight, Five to Nine)
Vahe50: mucks hand 
Dafleche collected $21.11 from pot
*** SUMMARY ***
Total pot $22.10 | Rake $0.99 
Board [5d 6s 2d 7s 7h]
Seat 1: fezman (button) folded before Flop (didn't bet)
Seat 2: RomarioJa (small blind) folded before Flop
Seat 3: Dafleche (big blind) showed [8c 9c] and won ($21.11) with a straight, Five to Nine
Seat 4: Perstenev folded before Flop (didn't bet)
Seat 5: deadmoneykid folded before Flop (didn't bet)
Seat 6: chiyuki folded before Flop (didn't bet)
Seat 7: wtu1986 folded before Flop (didn't bet)
Seat 8: Vahe50 mucked [9d 9s]
Seat 9: 4thepeople folded on the Flop



PokerStars Zoom Hand #84299438026:  Hold'em No Limit ($0.10/$0.25) - 2012/08/05 14:19:21 JST [2012/08/05 1:19:21 ET]
Table 'Whirlpool' 9-max Seat #1 is the button
Seat 1: Wilcox76607 ($22.45 in chips) 
Seat 2: ll_LaMeR_ll ($48.63 in chips) 
Seat 3: chiyuki ($24.93 in chips) 
Seat 4: wtu1986 ($32.17 in chips) 
Seat 5: ChrisCDee ($25 in chips) 
Seat 6: RomarioJa ($10.91 in chips) 
Seat 7: Suhoff76 ($25.10 in chips) 
Seat 8: JLajoie ($26.80 in chips) 
Seat 9: hirozo ($33.32 in chips) 
ll_LaMeR_ll: posts small blind $0.10
chiyuki: posts big blind $0.25
*** HOLE CARDS ***
Dealt to chiyuki [7c Ah]
wtu1986: folds 
ChrisCDee: raises $0.50 to $0.75
RomarioJa: folds 
Suhoff76: folds 
JLajoie: folds 
hirozo: folds 
Wilcox76607: calls $0.75
ll_LaMeR_ll: folds 
chiyuki: folds 
*** FLOP *** [5d 6d 7h]
ChrisCDee: bets $1.41
Wilcox76607: calls $1.41
*** TURN *** [5d 6d 7h] [Kc]
ChrisCDee: bets $3.56
Wilcox76607: calls $3.56
*** RIVER *** [5d 6d 7h Kc] [5h]
ChrisCDee: checks 
Wilcox76607: bets $6.25
ChrisCDee: calls $6.25
*** SHOW DOWN ***
Wilcox76607: shows [Ad 4d] (a pair of Fives)
ChrisCDee: shows [9d 8d] (a straight, Five to Nine)
ChrisCDee collected $23.20 from pot
*** SUMMARY ***
Total pot $24.29 | Rake $1.09 
Board [5d 6d 7h Kc 5h]
Seat 1: Wilcox76607 (button) showed [Ad 4d] and lost with a pair of Fives
Seat 2: ll_LaMeR_ll (small blind) folded before Flop
Seat 3: chiyuki (big blind) folded before Flop
Seat 4: wtu1986 folded before Flop (didn't bet)
Seat 5: ChrisCDee showed [9d 8d] and won ($23.20) with a straight, Five to Nine
Seat 6: RomarioJa folded before Flop (didn't bet)
Seat 7: Suhoff76 folded before Flop (didn't bet)
Seat 8: JLajoie folded before Flop (didn't bet)
Seat 9: hirozo folded before Flop (didn't bet)



PokerStars Zoom Hand #84299455715:  Hold'em No Limit ($0.10/$0.25) - 2012/08/05 14:20:33 JST [2012/08/05 1:20:33 ET]
Table 'Whirlpool' 9-max Seat #1 is the button
Seat 1: Dejacob ($25.57 in chips) 
Seat 2: caro196661cv ($25.10 in chips) 
Seat 3: el pore 5 ($15.84 in chips) 
Seat 4: chiyuki ($24.58 in chips) 
Seat 5: taksist889 ($27.43 in chips) 
Seat 6: JLajoie ($26.45 in chips) 
Seat 7: Lasutchik ($8.31 in chips) 
Seat 8: ChrisCDee ($68.03 in chips) 
Seat 9: mariuka1 ($12.15 in chips) 
caro196661cv: posts small blind $0.10
el pore 5: posts big blind $0.25
*** HOLE CARDS ***
Dealt to chiyuki [Jh 4h]
chiyuki: folds 
taksist889: folds 
JLajoie: folds 
Lasutchik: folds 
ChrisCDee: folds 
mariuka1: folds 
Dejacob: folds 
caro196661cv: folds 
Uncalled bet ($0.15) returned to el pore 5
el pore 5 collected $0.20 from pot
el pore 5: doesn't show hand 
*** SUMMARY ***
Total pot $0.20 | Rake $0 
Seat 1: Dejacob (button) folded before Flop (didn't bet)
Seat 2: caro196661cv (small blind) folded before Flop
Seat 3: el pore 5 (big blind) collected ($0.20)
Seat 4: chiyuki folded before Flop (didn't bet)
Seat 5: taksist889 folded before Flop (didn't bet)
Seat 6: JLajoie folded before Flop (didn't bet)
Seat 7: Lasutchik folded before Flop (didn't bet)
Seat 8: ChrisCDee folded before Flop (didn't bet)
Seat 9: mariuka1 folded before Flop (didn't bet)



PokerStars Zoom Hand #84299454672:  Hold'em No Limit ($0.10/$0.25) - 2012/08/05 14:20:29 JST [2012/08/05 1:20:29 ET]
Table 'Whirlpool' 9-max Seat #1 is the button
Seat 1: RomarioJa ($13.06 in chips) 
Seat 2: Vahe50 ($19.91 in chips) 
Seat 3: troms20 ($21.39 in chips) 
Seat 4: chiyuki ($24.58 in chips) 
Seat 5: seula i ($68.41 in chips) 
Seat 6: phate-1up ($25.35 in chips) 
Seat 7: KeLevro0 ($11.12 in chips) 
Seat 8: ladymadon107 ($3.53 in chips) 
Seat 9: deadmoneykid ($31.80 in chips) 
Vahe50: posts small blind $0.10
troms20: posts big blind $0.25
*** HOLE CARDS ***
Dealt to chiyuki [4s 9d]
chiyuki: folds 
seula i: folds 
phate-1up: folds 
KeLevro0: folds 
ladymadon107: folds 
deadmoneykid: folds 
RomarioJa: folds 
Vahe50: raises $0.50 to $0.75
troms20: folds 
Uncalled bet ($0.50) returned to Vahe50
Vahe50 collected $0.50 from pot
Vahe50: doesn't show hand 
*** SUMMARY ***
Total pot $0.50 | Rake $0 
Seat 1: RomarioJa (button) folded before Flop (didn't bet)
Seat 2: Vahe50 (small blind) collected ($0.50)
Seat 3: troms20 (big blind) folded before Flop
Seat 4: chiyuki folded before Flop (didn't bet)
Seat 5: seula i folded before Flop (didn't bet)
Seat 6: phate-1up folded before Flop (didn't bet)
Seat 7: KeLevro0 folded before Flop (didn't bet)
Seat 8: ladymadon107 folded before Flop (didn't bet)
Seat 9: deadmoneykid folded before Flop (didn't bet)



PokerStars Zoom Hand #84299460188:  Hold'em No Limit ($0.10/$0.25) - 2012/08/05 14:20:52 JST [2012/08/05 1:20:52 ET]
Table 'Whirlpool' 9-max Seat #1 is the button
Seat 1: RikkStroken ($5.70 in chips) 
Seat 2: KeLevro0 ($8.11 in chips) 
Seat 3: chiyuki ($24.58 in chips) 
Seat 4: dushvan ($29.57 in chips) 
Seat 5: kamikkaze ($20.75 in chips) 
Seat 6: deadmoneykid ($22.67 in chips) 
Seat 7: seula i ($27.39 in chips) 
Seat 8: Suhoff76 ($27.79 in chips) 
Seat 9: Dejacob ($32.11 in chips) 
KeLevro0: posts small blind $0.10
chiyuki: posts big blind $0.25
*** HOLE CARDS ***
Dealt to chiyuki [6s 3d]
dushvan: folds 
kamikkaze: folds 
deadmoneykid: folds 
seula i: folds 
Suhoff76: folds 
Dejacob: folds 
RikkStroken: raises $0.75 to $1
KeLevro0: folds 
chiyuki: folds 
Uncalled bet ($0.75) returned to RikkStroken
RikkStroken collected $0.60 from pot
RikkStroken: doesn't show hand 
*** SUMMARY ***
Total pot $0.60 | Rake $0 
Seat 1: RikkStroken (button) collected ($0.60)
Seat 2: KeLevro0 (small blind) folded before Flop
Seat 3: chiyuki (big blind) folded before Flop
Seat 4: dushvan folded before Flop (didn't bet)
Seat 5: kamikkaze folded before Flop (didn't bet)
Seat 6: deadmoneykid folded before Flop (didn't bet)
Seat 7: seula i folded before Flop (didn't bet)
Seat 8: Suhoff76 folded before Flop (didn't bet)
Seat 9: Dejacob folded before Flop (didn't bet)



PokerStars Zoom Hand #84299448229:  Hold'em No Limit ($0.10/$0.25) - 2012/08/05 14:20:03 JST [2012/08/05 1:20:03 ET]
Table 'Whirlpool' 9-max Seat #1 is the button
Seat 1: Th3Fog ($73.93 in chips) 
Seat 2: kamikkaze ($21.92 in chips) 
Seat 3: hirozo ($35.93 in chips) 
Seat 4: troms20 ($21.49 in chips) 
Seat 5: KeLevro0 ($12.15 in chips) 
Seat 6: DanielWhyte ($22.33 in chips) 
Seat 7: chiyuki ($24.68 in chips) 
Seat 8: deadmoneykid ($23.13 in chips) 
Seat 9: RikkStroken ($21.31 in chips) 
kamikkaze: posts small blind $0.10
hirozo: posts big blind $0.25
*** HOLE CARDS ***
Dealt to chiyuki [9c 4c]
troms20: folds 
KeLevro0: folds 
DanielWhyte: raises $0.50 to $0.75
chiyuki: folds 
deadmoneykid: calls $0.75
RikkStroken: folds 
Th3Fog: folds 
kamikkaze: calls $0.65
hirozo: folds 
*** FLOP *** [6d Jh Kd]
kamikkaze: checks 
DanielWhyte: bets $1
deadmoneykid: folds 
kamikkaze: calls $1
*** TURN *** [6d Jh Kd] [2c]
kamikkaze: checks 
DanielWhyte: bets $2
kamikkaze: calls $2
*** RIVER *** [6d Jh Kd 2c] [Kh]
kamikkaze: checks 
DanielWhyte: bets $8.12
kamikkaze: folds 
Uncalled bet ($8.12) returned to DanielWhyte
DanielWhyte collected $8.12 from pot
DanielWhyte: doesn't show hand 
*** SUMMARY ***
Total pot $8.50 | Rake $0.38 
Board [6d Jh Kd 2c Kh]
Seat 1: Th3Fog (button) folded before Flop (didn't bet)
Seat 2: kamikkaze (small blind) folded on the River
Seat 3: hirozo (big blind) folded before Flop
Seat 4: troms20 folded before Flop (didn't bet)
Seat 5: KeLevro0 folded before Flop (didn't bet)
Seat 6: DanielWhyte collected ($8.12)
Seat 7: chiyuki folded before Flop (didn't bet)
Seat 8: deadmoneykid folded on the Flop
Seat 9: RikkStroken folded before Flop (didn't bet)



PokerStars Zoom Hand #84299456425:  Hold'em No Limit ($0.10/$0.25) - 2012/08/05 14:20:36 JST [2012/08/05 1:20:36 ET]
Table 'Whirlpool' 9-max Seat #1 is the button
Seat 1: chiyuki ($24.58 in chips) 
Seat 2: sparky5224 ($39.84 in chips) 
Seat 3: hirozo ($33.12 in chips) 
Seat 4: Spartacus675 ($27.86 in chips) 
Seat 5: Loholov ($21.19 in chips) 
Seat 6: peng2astic ($19.21 in chips) 
Seat 7: Landybob ($43.40 in chips) 
Seat 8: Dejacob ($32.11 in chips) 
Seat 9: Lasutchik ($56.63 in chips) 
sparky5224: posts small blind $0.10
hirozo: posts big blind $0.25
*** HOLE CARDS ***
Dealt to chiyuki [Kd Qs]
Spartacus675: folds 
Loholov: raises $0.50 to $0.75
peng2astic: folds 
Landybob: folds 
Dejacob: folds 
Lasutchik: folds 
chiyuki: folds 
sparky5224: calls $0.65
hirozo: folds 
*** FLOP *** [4h 2c Jh]
sparky5224: bets $1
Loholov: raises $1.75 to $2.75
sparky5224: calls $1.75
*** TURN *** [4h 2c Jh] [8s]
sparky5224: checks 
Loholov said, "J 6 - fish???)"
Loholov: bets $0.75
sparky5224: calls $0.75
*** RIVER *** [4h 2c Jh 8s] [7s]
sparky5224: bets $1.50
Loholov: calls $1.50
*** SHOW DOWN ***
sparky5224: shows [9c 9d] (a pair of Nines)
Loholov: shows [Jd Qd] (a pair of Jacks)
Loholov collected $11.22 from pot
*** SUMMARY ***
Total pot $11.75 | Rake $0.53 
Board [4h 2c Jh 8s 7s]
Seat 1: chiyuki (button) folded before Flop (didn't bet)
Seat 2: sparky5224 (small blind) showed [9c 9d] and lost with a pair of Nines
Seat 3: hirozo (big blind) folded before Flop
Seat 4: Spartacus675 folded before Flop (didn't bet)
Seat 5: Loholov showed [Jd Qd] and won ($11.22) with a pair of Jacks
Seat 6: peng2astic folded before Flop (didn't bet)
Seat 7: Landybob folded before Flop (didn't bet)
Seat 8: Dejacob folded before Flop (didn't bet)
Seat 9: Lasutchik folded before Flop (didn't bet)



PokerStars Zoom Hand #84299467353:  Hold'em No Limit ($0.10/$0.25) - 2012/08/05 14:21:21 JST [2012/08/05 1:21:21 ET]
Table 'Whirlpool' 9-max Seat #1 is the button
Seat 1: KCDOGG10 ($11.65 in chips) 
Seat 2: KeLevro0 ($10.87 in chips) 
Seat 3: Dejacob ($32.11 in chips) 
Seat 4: RomarioJa ($14.36 in chips) 
Seat 5: troms20 ($26.48 in chips) 
Seat 6: Nerkit ($13.14 in chips) 
Seat 7: PetitAlejo ($29.52 in chips) 
Seat 8: Lasutchik ($56.38 in chips) 
Seat 9: chiyuki ($24.33 in chips) 
KeLevro0: posts small blind $0.10
Dejacob: posts big blind $0.25
*** HOLE CARDS ***
Dealt to chiyuki [4h Qc]
RomarioJa: folds 
troms20: folds 
Nerkit: raises $0.50 to $0.75
PetitAlejo: folds 
Lasutchik: folds 
chiyuki: folds 
KCDOGG10: folds 
KeLevro0: folds 
Dejacob: folds 
Uncalled bet ($0.50) returned to Nerkit
Nerkit collected $0.60 from pot
Nerkit: doesn't show hand 
*** SUMMARY ***
Total pot $0.60 | Rake $0 
Seat 1: KCDOGG10 (button) folded before Flop (didn't bet)
Seat 2: KeLevro0 (small blind) folded before Flop
Seat 3: Dejacob (big blind) folded before Flop
Seat 4: RomarioJa folded before Flop (didn't bet)
Seat 5: troms20 folded before Flop (didn't bet)
Seat 6: Nerkit collected ($0.60)
Seat 7: PetitAlejo folded before Flop (didn't bet)
Seat 8: Lasutchik folded before Flop (didn't bet)
Seat 9: chiyuki folded before Flop (didn't bet)



PokerStars Zoom Hand #84299469868:  Hold'em No Limit ($0.10/$0.25) - 2012/08/05 14:21:31 JST [2012/08/05 1:21:31 ET]
Table 'Whirlpool' 9-max Seat #1 is the button
Seat 1: KeLevro0 ($9.11 in chips) 
Seat 2: phate-1up ($26.72 in chips) 
Seat 3: dushvan ($29.47 in chips) 
Seat 4: PetitAlejo ($29.52 in chips) 
Seat 5: hirozo ($36.28 in chips) 
Seat 6: RomarioJa ($12.71 in chips) 
Seat 7: chiyuki ($24.33 in chips) 
Seat 8: deadmoneykid ($31.05 in chips) 
Seat 9: Suhoff76 ($25 in chips) 
phate-1up: posts small blind $0.10
dushvan: posts big blind $0.25
*** HOLE CARDS ***
Dealt to chiyuki [2s 4d]
PetitAlejo: folds 
hirozo: folds 
RomarioJa: folds 
chiyuki: folds 
deadmoneykid: folds 
Suhoff76: folds 
KeLevro0: folds 
phate-1up: folds 
Uncalled bet ($0.15) returned to dushvan
dushvan collected $0.20 from pot
dushvan: doesn't show hand 
*** SUMMARY ***
Total pot $0.20 | Rake $0 
Seat 1: KeLevro0 (button) folded before Flop (didn't bet)
Seat 2: phate-1up (small blind) folded before Flop
Seat 3: dushvan (big blind) collected ($0.20)
Seat 4: PetitAlejo folded before Flop (didn't bet)
Seat 5: hirozo folded before Flop (didn't bet)
Seat 6: RomarioJa folded before Flop (didn't bet)
Seat 7: chiyuki folded before Flop (didn't bet)
Seat 8: deadmoneykid folded before Flop (didn't bet)
Seat 9: Suhoff76 folded before Flop (didn't bet)



PokerStars Zoom Hand #84299463644:  Hold'em No Limit ($0.10/$0.25) - 2012/08/05 14:21:06 JST [2012/08/05 1:21:06 ET]
Table 'Whirlpool' 9-max Seat #1 is the button
Seat 1: Nerkit ($9.90 in chips) 
Seat 2: Perstenev ($12.72 in chips) 
Seat 3: Landybob ($43.75 in chips) 
Seat 4: Paranoix1990 ($7.57 in chips) 
Seat 5: chiyuki ($24.33 in chips) 
Seat 6: Lasutchik ($8.31 in chips) 
Seat 7: deadmoneykid ($22.67 in chips) 
Seat 8: seula i ($28.32 in chips) 
Seat 9: Loholov ($15 in chips) 
Perstenev: posts small blind $0.10
Landybob: posts big blind $0.25
*** HOLE CARDS ***
Dealt to chiyuki [6c Qh]
Paranoix1990: folds 
chiyuki: folds 
Lasutchik: folds 
deadmoneykid: folds 
seula i: raises $0.50 to $0.75
Loholov: folds 
Nerkit: folds 
Perstenev: calls $0.65
Landybob: folds 
*** FLOP *** [3c Ts Kc]
Perstenev: checks 
seula i: bets $1.25
Perstenev: folds 
Uncalled bet ($1.25) returned to seula i
seula i collected $1.67 from pot
seula i: doesn't show hand 
*** SUMMARY ***
Total pot $1.75 | Rake $0.08 
Board [3c Ts Kc]
Seat 1: Nerkit (button) folded before Flop (didn't bet)
Seat 2: Perstenev (small blind) folded on the Flop
Seat 3: Landybob (big blind) folded before Flop
Seat 4: Paranoix1990 folded before Flop (didn't bet)
Seat 5: chiyuki folded before Flop (didn't bet)
Seat 6: Lasutchik folded before Flop (didn't bet)
Seat 7: deadmoneykid folded before Flop (didn't bet)
Seat 8: seula i collected ($1.67)
Seat 9: Loholov folded before Flop (didn't bet)



PokerStars Zoom Hand #84299471616:  Hold'em No Limit ($0.10/$0.25) - 2012/08/05 14:21:38 JST [2012/08/05 1:21:38 ET]
Table 'Whirlpool' 9-max Seat #1 is the button
Seat 1: mariuka1 ($11.80 in chips) 
Seat 2: chiyuki ($24.33 in chips) 
Seat 3: Faraz ($21.80 in chips) 
Seat 4: acamrash ($11.75 in chips) 
Seat 5: PetitAlejo ($50.11 in chips) 
Seat 6: wtu1986 ($25.10 in chips) 
Seat 7: Loholov ($15 in chips) 
Seat 8: hirozo ($25.70 in chips) 
Seat 9: ygoegoe ($29.84 in chips) 
chiyuki: posts small blind $0.10
Faraz: posts big blind $0.25
*** HOLE CARDS ***
Dealt to chiyuki [5c Ah]
acamrash: folds 
PetitAlejo: folds 
wtu1986: raises $0.50 to $0.75
Loholov: folds 
hirozo: folds 
ygoegoe: raises $1.50 to $2.25
mariuka1: folds 
chiyuki: folds 
Faraz: folds 
wtu1986: folds 
Uncalled bet ($1.50) returned to ygoegoe
ygoegoe collected $1.85 from pot
ygoegoe: doesn't show hand 
*** SUMMARY ***
Total pot $1.85 | Rake $0 
Seat 1: mariuka1 (button) folded before Flop (didn't bet)
Seat 2: chiyuki (small blind) folded before Flop
Seat 3: Faraz (big blind) folded before Flop
Seat 4: acamrash folded before Flop (didn't bet)
Seat 5: PetitAlejo folded before Flop (didn't bet)
Seat 6: wtu1986 folded before Flop
Seat 7: Loholov folded before Flop (didn't bet)
Seat 8: hirozo folded before Flop (didn't bet)
Seat 9: ygoegoe collected ($1.85)



PokerStars Zoom Hand #84299476813:  Hold'em No Limit ($0.10/$0.25) - 2012/08/05 14:22:00 JST [2012/08/05 1:22:00 ET]
Table 'Whirlpool' 9-max Seat #1 is the button
Seat 1: bonethugs699 ($24.75 in chips) 
Seat 2: Th3Fog ($49.85 in chips) 
Seat 3: hirozo ($32.77 in chips) 
Seat 4: D@vidMed ($65.52 in chips) 
Seat 5: troms20 ($54.90 in chips) 
Seat 6: seula i ($28.99 in chips) 
Seat 7: Faraz ($21.55 in chips) 
Seat 8: chiyuki ($24.23 in chips) 
Seat 9: kamikkaze ($17.92 in chips) 
Th3Fog: posts small blind $0.10
hirozo: posts big blind $0.25
*** HOLE CARDS ***
Dealt to chiyuki [Qd 8d]
D@vidMed: folds 
troms20: folds 
seula i: folds 
Faraz: folds 
chiyuki: folds 
kamikkaze: raises $0.38 to $0.63
bonethugs699: folds 
Th3Fog: folds 
hirozo: folds 
Uncalled bet ($0.38) returned to kamikkaze
kamikkaze collected $0.60 from pot
kamikkaze: doesn't show hand 
*** SUMMARY ***
Total pot $0.60 | Rake $0 
Seat 1: bonethugs699 (button) folded before Flop (didn't bet)
Seat 2: Th3Fog (small blind) folded before Flop
Seat 3: hirozo (big blind) folded before Flop
Seat 4: D@vidMed folded before Flop (didn't bet)
Seat 5: troms20 folded before Flop (didn't bet)
Seat 6: seula i folded before Flop (didn't bet)
Seat 7: Faraz folded before Flop (didn't bet)
Seat 8: chiyuki folded before Flop (didn't bet)
Seat 9: kamikkaze collected ($0.60)



PokerStars Zoom Hand #84299480610:  Hold'em No Limit ($0.10/$0.25) - 2012/08/05 14:22:14 JST [2012/08/05 1:22:14 ET]
Table 'Whirlpool' 9-max Seat #1 is the button
Seat 1: Nerkit ($13.39 in chips) 
Seat 2: WARIBANA7777 ($13.39 in chips) 
Seat 3: troms20 ($54.90 in chips) 
Seat 4: KeLevro0 ($10.02 in chips) 
Seat 5: chiyuki ($24.23 in chips) 
Seat 6: RomarioJa ($13.06 in chips) 
Seat 7: RikkStroken ($14.51 in chips) 
Seat 8: Suhoff76 ($25 in chips) 
Seat 9: Wilcox76607 ($21.02 in chips) 
WARIBANA7777: posts small blind $0.10
troms20: posts big blind $0.25
*** HOLE CARDS ***
Dealt to chiyuki [Kc Ad]
KeLevro0: folds 
chiyuki: raises $0.50 to $0.75
RomarioJa: folds 
RikkStroken: folds 
Suhoff76: folds 
Wilcox76607: folds 
Nerkit: folds 
WARIBANA7777: folds 
troms20: folds 
Uncalled bet ($0.50) returned to chiyuki
chiyuki collected $0.60 from pot
chiyuki: doesn't show hand 
*** SUMMARY ***
Total pot $0.60 | Rake $0 
Seat 1: Nerkit (button) folded before Flop (didn't bet)
Seat 2: WARIBANA7777 (small blind) folded before Flop
Seat 3: troms20 (big blind) folded before Flop
Seat 4: KeLevro0 folded before Flop (didn't bet)
Seat 5: chiyuki collected ($0.60)
Seat 6: RomarioJa folded before Flop (didn't bet)
Seat 7: RikkStroken folded before Flop (didn't bet)
Seat 8: Suhoff76 folded before Flop (didn't bet)
Seat 9: Wilcox76607 folded before Flop (didn't bet)



PokerStars Zoom Hand #84299479326:  Hold'em No Limit ($0.10/$0.25) - 2012/08/05 14:22:09 JST [2012/08/05 1:22:09 ET]
Table 'Whirlpool' 9-max Seat #1 is the button
Seat 1: phate-1up ($25 in chips) 
Seat 2: Loholov ($17.89 in chips) 
Seat 3: Yogi707 ($15 in chips) 
Seat 4: RomarioJa ($13.06 in chips) 
Seat 5: slapshot2011 ($31.48 in chips) 
Seat 6: chiyuki ($24.23 in chips) 
Seat 7: KeLevro0 ($10.03 in chips) 
Seat 8: seula i ($25 in chips) 
Seat 9: 4thepeople ($24.08 in chips) 
Loholov: posts small blind $0.10
Yogi707: posts big blind $0.25
*** HOLE CARDS ***
Dealt to chiyuki [3s 7d]
RomarioJa: folds 
slapshot2011: calls $0.25
chiyuki: folds 
KeLevro0: folds 
seula i: folds 
4thepeople: folds 
phate-1up: folds 
Loholov: folds 
Yogi707: checks 
*** FLOP *** [6s 9c 9d]
Yogi707: checks 
slapshot2011: checks 
*** TURN *** [6s 9c 9d] [5d]
Yogi707: checks 
slapshot2011: bets $0.50
Yogi707: calls $0.50
*** RIVER *** [6s 9c 9d 5d] [Tc]
Yogi707: checks 
slapshot2011: bets $0.75
Yogi707: folds 
Uncalled bet ($0.75) returned to slapshot2011
slapshot2011 collected $1.53 from pot
slapshot2011: doesn't show hand 
*** SUMMARY ***
Total pot $1.60 | Rake $0.07 
Board [6s 9c 9d 5d Tc]
Seat 1: phate-1up (button) folded before Flop (didn't bet)
Seat 2: Loholov (small blind) folded before Flop
Seat 3: Yogi707 (big blind) folded on the River
Seat 4: RomarioJa folded before Flop (didn't bet)
Seat 5: slapshot2011 collected ($1.53)
Seat 6: chiyuki folded before Flop (didn't bet)
Seat 7: KeLevro0 folded before Flop (didn't bet)
Seat 8: seula i folded before Flop (didn't bet)
Seat 9: 4thepeople folded before Flop (didn't bet)



PokerStars Zoom Hand #84299488959:  Hold'em No Limit ($0.10/$0.25) - 2012/08/05 14:22:48 JST [2012/08/05 1:22:48 ET]
Table 'Whirlpool' 9-max Seat #1 is the button
Seat 1: deadmoneykid ($21.28 in chips) 
Seat 2: DanielWhyte ($21.13 in chips) 
Seat 3: seula i ($27.04 in chips) 
Seat 4: chiyuki ($24.58 in chips) 
Seat 5: kamikkaze ($19.83 in chips) 
Seat 6: RikkStroken ($28.41 in chips) 
Seat 7: leo2095 ($13.29 in chips) 
Seat 8: PetitAlejo ($36.51 in chips) 
Seat 9: Roglus ($60.93 in chips) 
DanielWhyte: posts small blind $0.10
seula i: posts big blind $0.25
*** HOLE CARDS ***
Dealt to chiyuki [Ac 9c]
chiyuki: folds 
kamikkaze: folds 
RikkStroken: folds 
leo2095: raises $0.25 to $0.50
PetitAlejo: folds 
Roglus: folds 
deadmoneykid: folds 
DanielWhyte: folds 
seula i: folds 
Uncalled bet ($0.25) returned to leo2095
leo2095 collected $0.60 from pot
leo2095: doesn't show hand 
*** SUMMARY ***
Total pot $0.60 | Rake $0 
Seat 1: deadmoneykid (button) folded before Flop (didn't bet)
Seat 2: DanielWhyte (small blind) folded before Flop
Seat 3: seula i (big blind) folded before Flop
Seat 4: chiyuki folded before Flop (didn't bet)
Seat 5: kamikkaze folded before Flop (didn't bet)
Seat 6: RikkStroken folded before Flop (didn't bet)
Seat 7: leo2095 collected ($0.60)
Seat 8: PetitAlejo folded before Flop (didn't bet)
Seat 9: Roglus folded before Flop (didn't bet)



PokerStars Zoom Hand #84299494203:  Hold'em No Limit ($0.10/$0.25) - 2012/08/05 14:23:10 JST [2012/08/05 1:23:10 ET]
Table 'Whirlpool' 9-max Seat #1 is the button
Seat 1: Dejacob ($46.26 in chips) 
Seat 2: Loholov ($15 in chips) 
Seat 3: chiyuki ($24.58 in chips) 
Seat 4: Vahe50 ($23.25 in chips) 
Seat 5: Perstenev ($13.53 in chips) 
Seat 6: Th3Fog ($49.75 in chips) 
Seat 7: troms20 ($29.75 in chips) 
Seat 8: Lasutchik ($68.70 in chips) 
Seat 9: Nerkit ($11.73 in chips) 
Loholov: posts small blind $0.10
chiyuki: posts big blind $0.25
*** HOLE CARDS ***
Dealt to chiyuki [3c 7d]
Vahe50: folds 
Perstenev: folds 
Th3Fog: folds 
troms20: folds 
Lasutchik: folds 
Nerkit: folds 
Dejacob: raises $0.50 to $0.75
Loholov: calls $0.65
chiyuki: folds 
*** FLOP *** [4s Ac 3d]
Loholov: checks 
Dejacob: bets $1.25
Loholov: folds 
Uncalled bet ($1.25) returned to Dejacob
Dejacob collected $1.67 from pot
Dejacob: doesn't show hand 
*** SUMMARY ***
Total pot $1.75 | Rake $0.08 
Board [4s Ac 3d]
Seat 1: Dejacob (button) collected ($1.67)
Seat 2: Loholov (small blind) folded on the Flop
Seat 3: chiyuki (big blind) folded before Flop
Seat 4: Vahe50 folded before Flop (didn't bet)
Seat 5: Perstenev folded before Flop (didn't bet)
Seat 6: Th3Fog folded before Flop (didn't bet)
Seat 7: troms20 folded before Flop (didn't bet)
Seat 8: Lasutchik folded before Flop (didn't bet)
Seat 9: Nerkit folded before Flop (didn't bet)



PokerStars Zoom Hand #84299501191:  Hold'em No Limit ($0.10/$0.25) - 2012/08/05 14:23:38 JST [2012/08/05 1:23:38 ET]
Table 'Whirlpool' 9-max Seat #1 is the button
Seat 1: Suhoff76 ($26.82 in chips) 
Seat 2: RomarioJa ($30.39 in chips) 
Seat 3: Loholov ($17.04 in chips) 
Seat 4: phate-1up ($37.41 in chips) 
Seat 5: KCDOGG10 ($6.30 in chips) 
Seat 6: chiyuki ($24.33 in chips) 
Seat 7: troms20 ($54.90 in chips) 
Seat 8: AlfredE525 ($14.45 in chips) 
Seat 9: WARIBANA7777 ($12.94 in chips) 
RomarioJa: posts small blind $0.10
Loholov: posts big blind $0.25
*** HOLE CARDS ***
Dealt to chiyuki [Ad Qh]
phate-1up: folds 
KCDOGG10: folds 
chiyuki: raises $0.50 to $0.75
troms20: folds 
AlfredE525: folds 
WARIBANA7777: folds 
Suhoff76: folds 
RomarioJa: folds 
Loholov: folds 
Uncalled bet ($0.50) returned to chiyuki
chiyuki collected $0.60 from pot
chiyuki: doesn't show hand 
*** SUMMARY ***
Total pot $0.60 | Rake $0 
Seat 1: Suhoff76 (button) folded before Flop (didn't bet)
Seat 2: RomarioJa (small blind) folded before Flop
Seat 3: Loholov (big blind) folded before Flop
Seat 4: phate-1up folded before Flop (didn't bet)
Seat 5: KCDOGG10 folded before Flop (didn't bet)
Seat 6: chiyuki collected ($0.60)
Seat 7: troms20 folded before Flop (didn't bet)
Seat 8: AlfredE525 folded before Flop (didn't bet)
Seat 9: WARIBANA7777 folded before Flop (didn't bet)



PokerStars Zoom Hand #84299497431:  Hold'em No Limit ($0.10/$0.25) - 2012/08/05 14:23:23 JST [2012/08/05 1:23:23 ET]
Table 'Whirlpool' 9-max Seat #1 is the button
Seat 1: chiyuki ($24.33 in chips) 
Seat 2: 1Karina1 ($25 in chips) 
Seat 3: PetitAlejo ($33.41 in chips) 
Seat 4: KAKamiro ($40.94 in chips) 
Seat 5: phate-1up ($25 in chips) 
Seat 6: Spartacus675 ($29.76 in chips) 
Seat 7: hirozo ($27.37 in chips) 
Seat 8: roksmokndonk ($29.04 in chips) 
Seat 9: RikkStroken ($27.21 in chips) 
1Karina1: posts small blind $0.10
PetitAlejo: posts big blind $0.25
*** HOLE CARDS ***
Dealt to chiyuki [7d 9h]
KAKamiro: calls $0.25
phate-1up: folds 
Spartacus675: folds 
hirozo: folds 
roksmokndonk: folds 
RikkStroken: calls $0.25
chiyuki: folds 
1Karina1: calls $0.15
PetitAlejo: checks 
*** FLOP *** [4s 4h 6d]
1Karina1: checks 
PetitAlejo: checks 
KAKamiro: bets $1.25
RikkStroken: folds 
1Karina1: folds 
PetitAlejo: folds 
Uncalled bet ($1.25) returned to KAKamiro
KAKamiro collected $0.96 from pot
KAKamiro: doesn't show hand 
*** SUMMARY ***
Total pot $1 | Rake $0.04 
Board [4s 4h 6d]
Seat 1: chiyuki (button) folded before Flop (didn't bet)
Seat 2: 1Karina1 (small blind) folded on the Flop
Seat 3: PetitAlejo (big blind) folded on the Flop
Seat 4: KAKamiro collected ($0.96)
Seat 5: phate-1up folded before Flop (didn't bet)
Seat 6: Spartacus675 folded before Flop (didn't bet)
Seat 7: hirozo folded before Flop (didn't bet)
Seat 8: roksmokndonk folded before Flop (didn't bet)
Seat 9: RikkStroken folded on the Flop



PokerStars Zoom Hand #84299508873:  Hold'em No Limit ($0.10/$0.25) - 2012/08/05 14:24:09 JST [2012/08/05 1:24:09 ET]
Table 'Whirlpool' 9-max Seat #1 is the button
Seat 1: carlosrbr ($65.55 in chips) 
Seat 2: phate-1up ($25 in chips) 
Seat 3: Yogi707 ($14.15 in chips) 
Seat 4: chiyuki ($24.68 in chips) 
Seat 5: silvno31 ($35.28 in chips) 
Seat 6: Jene4kaBest ($11.16 in chips) 
Seat 7: PetitAlejo ($27.51 in chips) 
Seat 8: hl77777 ($13.46 in chips) 
Seat 9: KeLevro0 ($11.49 in chips) 
phate-1up: posts small blind $0.10
Yogi707: posts big blind $0.25
*** HOLE CARDS ***
Dealt to chiyuki [5d Ac]
chiyuki: folds 
silvno31: raises $0.50 to $0.75
Jene4kaBest: folds 
PetitAlejo: folds 
hl77777: folds 
KeLevro0: folds 
carlosrbr: folds 
phate-1up: folds 
Yogi707: folds 
Uncalled bet ($0.50) returned to silvno31
silvno31 collected $0.60 from pot
silvno31: doesn't show hand 
*** SUMMARY ***
Total pot $0.60 | Rake $0 
Seat 1: carlosrbr (button) folded before Flop (didn't bet)
Seat 2: phate-1up (small blind) folded before Flop
Seat 3: Yogi707 (big blind) folded before Flop
Seat 4: chiyuki folded before Flop (didn't bet)
Seat 5: silvno31 collected ($0.60)
Seat 6: Jene4kaBest folded before Flop (didn't bet)
Seat 7: PetitAlejo folded before Flop (didn't bet)
Seat 8: hl77777 folded before Flop (didn't bet)
Seat 9: KeLevro0 folded before Flop (didn't bet)



PokerStars Zoom Hand #84299509638:  Hold'em No Limit ($0.10/$0.25) - 2012/08/05 14:24:12 JST [2012/08/05 1:24:12 ET]
Table 'Whirlpool' 9-max Seat #1 is the button
Seat 1: Perstenev ($9.67 in chips) 
Seat 2: chiyuki ($24.68 in chips) 
Seat 3: Spartacus675 ($29.01 in chips) 
Seat 4: seula i ($25 in chips) 
Seat 5: Loholov ($15 in chips) 
Seat 6: KeLevro0 ($11.67 in chips) 
Seat 7: ygoegoe ($25.31 in chips) 
Seat 8: caro196661cv ($30.91 in chips) 
Seat 9: Dan Royal ($41.43 in chips) 
chiyuki: posts small blind $0.10
Spartacus675: posts big blind $0.25
*** HOLE CARDS ***
Dealt to chiyuki [Jh 6d]
seula i: folds 
Loholov: folds 
KeLevro0: folds 
ygoegoe: folds 
caro196661cv: raises $0.37 to $0.62
Dan Royal: folds 
Perstenev: folds 
chiyuki: folds 
Spartacus675: folds 
Uncalled bet ($0.37) returned to caro196661cv
caro196661cv collected $0.60 from pot
caro196661cv: doesn't show hand 
*** SUMMARY ***
Total pot $0.60 | Rake $0 
Seat 1: Perstenev (button) folded before Flop (didn't bet)
Seat 2: chiyuki (small blind) folded before Flop
Seat 3: Spartacus675 (big blind) folded before Flop
Seat 4: seula i folded before Flop (didn't bet)
Seat 5: Loholov folded before Flop (didn't bet)
Seat 6: KeLevro0 folded before Flop (didn't bet)
Seat 7: ygoegoe folded before Flop (didn't bet)
Seat 8: caro196661cv collected ($0.60)
Seat 9: Dan Royal folded before Flop (didn't bet)



PokerStars Zoom Hand #84299500172:  Hold'em No Limit ($0.10/$0.25) - 2012/08/05 14:23:34 JST [2012/08/05 1:23:34 ET]
Table 'Whirlpool' 9-max Seat #1 is the button
Seat 1: dushvan ($28.07 in chips) 
Seat 2: JLajoie ($27.59 in chips) 
Seat 3: hirozo ($32.87 in chips) 
Seat 4: Perstenev ($13.38 in chips) 
Seat 5: 4thepeople ($22.24 in chips) 
Seat 6: Th3Fog ($16.12 in chips) 
Seat 7: RomarioJa ($30.39 in chips) 
Seat 8: phate-1up ($37.41 in chips) 
Seat 9: chiyuki ($24.33 in chips) 
JLajoie: posts small blind $0.10
hirozo: posts big blind $0.25
*** HOLE CARDS ***
Dealt to chiyuki [8c 5d]
Perstenev: folds 
4thepeople: calls $0.25
Th3Fog: folds 
RomarioJa: folds 
phate-1up: folds 
chiyuki: folds 
dushvan: folds 
JLajoie: calls $0.15
hirozo: checks 
*** FLOP *** [2s 8d 3c]
JLajoie: checks 
hirozo: bets $0.36
4thepeople: folds 
JLajoie: calls $0.36
*** TURN *** [2s 8d 3c] [6c]
JLajoie: checks 
hirozo: checks 
*** RIVER *** [2s 8d 3c 6c] [Kc]
JLajoie: checks 
hirozo: checks 
*** SHOW DOWN ***
JLajoie: shows [9c Jh] (high card King)
hirozo: mucks hand 
JLajoie collected $1.40 from pot
*** SUMMARY ***
Total pot $1.47 | Rake $0.07 
Board [2s 8d 3c 6c Kc]
Seat 1: dushvan (button) folded before Flop (didn't bet)
Seat 2: JLajoie (small blind) showed [9c Jh] and won ($1.40) with high card King
Seat 3: hirozo (big blind) mucked [9h Ts]
Seat 4: Perstenev folded before Flop (didn't bet)
Seat 5: 4thepeople folded on the Flop
Seat 6: Th3Fog folded before Flop (didn't bet)
Seat 7: RomarioJa folded before Flop (didn't bet)
Seat 8: phate-1up folded before Flop (didn't bet)
Seat 9: chiyuki folded before Flop (didn't bet)



PokerStars Zoom Hand #84299512134:  Hold'em No Limit ($0.10/$0.25) - 2012/08/05 14:24:23 JST [2012/08/05 1:24:23 ET]
Table 'Whirlpool' 9-max Seat #1 is the button
Seat 1: chiyuki ($24.58 in chips) 
Seat 2: RomarioJa ($13.45 in chips) 
Seat 3: Th3Fog ($16.02 in chips) 
Seat 4: seula i ($25.01 in chips) 
Seat 5: wtu1986 ($31.49 in chips) 
Seat 6: Nerkit ($13.61 in chips) 
Seat 7: phate-1up ($25 in chips) 
Seat 8: KeLevro0 ($10.12 in chips) 
Seat 9: acamrash ($12.40 in chips) 
RomarioJa: posts small blind $0.10
Th3Fog: posts big blind $0.25
*** HOLE CARDS ***
Dealt to chiyuki [Qd 2c]
seula i: folds 
wtu1986: folds 
Nerkit: folds 
phate-1up: folds 
KeLevro0: folds 
acamrash: folds 
chiyuki: folds 
RomarioJa: folds 
Uncalled bet ($0.15) returned to Th3Fog
Th3Fog collected $0.20 from pot
Th3Fog: doesn't show hand 
*** SUMMARY ***
Total pot $0.20 | Rake $0 
Seat 1: chiyuki (button) folded before Flop (didn't bet)
Seat 2: RomarioJa (small blind) folded before Flop
Seat 3: Th3Fog (big blind) collected ($0.20)
Seat 4: seula i folded before Flop (didn't bet)
Seat 5: wtu1986 folded before Flop (didn't bet)
Seat 6: Nerkit folded before Flop (didn't bet)
Seat 7: phate-1up folded before Flop (didn't bet)
Seat 8: KeLevro0 folded before Flop (didn't bet)
Seat 9: acamrash folded before Flop (didn't bet)



PokerStars Zoom Hand #84299515925:  Hold'em No Limit ($0.10/$0.25) - 2012/08/05 14:24:38 JST [2012/08/05 1:24:38 ET]
Table 'Whirlpool' 9-max Seat #1 is the button
Seat 1: Yogi707 ($13.80 in chips) 
Seat 2: hirozo ($32.26 in chips) 
Seat 3: dushvan ($27.97 in chips) 
Seat 4: phate-1up ($29.10 in chips) 
Seat 5: Ellen1947 ($27.81 in chips) 
Seat 6: Suhoff76 ($26.47 in chips) 
Seat 7: wtu1986 ($31.49 in chips) 
Seat 8: chiyuki ($24.58 in chips) 
Seat 9: Perstenev ($13.03 in chips) 
hirozo: posts small blind $0.10
dushvan: posts big blind $0.25
*** HOLE CARDS ***
Dealt to chiyuki [7d Qc]
phate-1up: folds 
Ellen1947: folds 
Suhoff76: raises $0.32 to $0.57
wtu1986: folds 
chiyuki: folds 
Perstenev: folds 
Yogi707: folds 
hirozo: folds 
dushvan: folds 
Uncalled bet ($0.32) returned to Suhoff76
Suhoff76 collected $0.60 from pot
Suhoff76: doesn't show hand 
*** SUMMARY ***
Total pot $0.60 | Rake $0 
Seat 1: Yogi707 (button) folded before Flop (didn't bet)
Seat 2: hirozo (small blind) folded before Flop
Seat 3: dushvan (big blind) folded before Flop
Seat 4: phate-1up folded before Flop (didn't bet)
Seat 5: Ellen1947 folded before Flop (didn't bet)
Seat 6: Suhoff76 collected ($0.60)
Seat 7: wtu1986 folded before Flop (didn't bet)
Seat 8: chiyuki folded before Flop (didn't bet)
Seat 9: Perstenev folded before Flop (didn't bet)



PokerStars Zoom Hand #84299518605:  Hold'em No Limit ($0.10/$0.25) - 2012/08/05 14:24:49 JST [2012/08/05 1:24:49 ET]
Table 'Whirlpool' 9-max Seat #1 is the button
Seat 1: 4ydo yogurt ($20.03 in chips) 
Seat 2: 1Karina1 ($25.35 in chips) 
Seat 3: wtu1986 ($25.47 in chips) 
Seat 4: caro196661cv ($31.26 in chips) 
Seat 5: Roglus ($13.64 in chips) 
Seat 6: chiyuki ($24.58 in chips) 
Seat 7: Déculotter69 ($21.20 in chips) 
Seat 8: taksist889 ($26.78 in chips) 
Seat 9: kamikkaze ($15.84 in chips) 
1Karina1: posts small blind $0.10
wtu1986: posts big blind $0.25
*** HOLE CARDS ***
Dealt to chiyuki [Qd 4d]
caro196661cv: folds 
Roglus: folds 
chiyuki: folds 
Déculotter69: raises $0.50 to $0.75
taksist889: folds 
kamikkaze: folds 
4ydo yogurt: folds 
1Karina1: folds 
wtu1986: folds 
Uncalled bet ($0.50) returned to Déculotter69
Déculotter69 collected $0.60 from pot
Déculotter69: doesn't show hand 
*** SUMMARY ***
Total pot $0.60 | Rake $0 
Seat 1: 4ydo yogurt (button) folded before Flop (didn't bet)
Seat 2: 1Karina1 (small blind) folded before Flop
Seat 3: wtu1986 (big blind) folded before Flop
Seat 4: caro196661cv folded before Flop (didn't bet)
Seat 5: Roglus folded before Flop (didn't bet)
Seat 6: chiyuki folded before Flop (didn't bet)
Seat 7: Déculotter69 collected ($0.60)
Seat 8: taksist889 folded before Flop (didn't bet)
Seat 9: kamikkaze folded before Flop (didn't bet)



PokerStars Zoom Hand #84299519809:  Hold'em No Limit ($0.10/$0.25) - 2012/08/05 14:24:54 JST [2012/08/05 1:24:54 ET]
Table 'Whirlpool' 9-max Seat #1 is the button
Seat 1: 1Karina1 ($25 in chips) 
Seat 2: Perstenev ($9.42 in chips) 
Seat 3: Dan Royal ($41.33 in chips) 
Seat 4: chiyuki ($24.58 in chips) 
Seat 5: Suhoff76 ($26.82 in chips) 
Seat 6: Jene4kaBest ($11.16 in chips) 
Seat 7: kamikkaze ($15.84 in chips) 
Seat 8: hirozo ($35.53 in chips) 
Seat 9: PetitAlejo ($50.46 in chips) 
Perstenev: posts small blind $0.10
Dan Royal: posts big blind $0.25
*** HOLE CARDS ***
Dealt to chiyuki [Tc 4s]
chiyuki: folds 
Suhoff76: folds 
Jene4kaBest: folds 
kamikkaze: folds 
hirozo: folds 
PetitAlejo: folds 
1Karina1: folds 
Perstenev: folds 
Uncalled bet ($0.15) returned to Dan Royal
Dan Royal collected $0.20 from pot
Dan Royal: doesn't show hand 
*** SUMMARY ***
Total pot $0.20 | Rake $0 
Seat 1: 1Karina1 (button) folded before Flop (didn't bet)
Seat 2: Perstenev (small blind) folded before Flop
Seat 3: Dan Royal (big blind) collected ($0.20)
Seat 4: chiyuki folded before Flop (didn't bet)
Seat 5: Suhoff76 folded before Flop (didn't bet)
Seat 6: Jene4kaBest folded before Flop (didn't bet)
Seat 7: kamikkaze folded before Flop (didn't bet)
Seat 8: hirozo folded before Flop (didn't bet)
Seat 9: PetitAlejo folded before Flop (didn't bet)



PokerStars Zoom Hand #84299521832:  Hold'em No Limit ($0.10/$0.25) - 2012/08/05 14:25:02 JST [2012/08/05 1:25:02 ET]
Table 'Whirlpool' 9-max Seat #1 is the button
Seat 1: deadmoneykid ($21.18 in chips) 
Seat 2: Loholov ($15 in chips) 
Seat 3: chiyuki ($24.58 in chips) 
Seat 4: cr0lox ($17.88 in chips) 
Seat 5: taksist889 ($26.78 in chips) 
Seat 6: Suhoff76 ($25 in chips) 
Seat 7: WARIBANA7777 ($12.59 in chips) 
Seat 8: Perstenev ($13.03 in chips) 
Seat 9: ygoegoe ($27.34 in chips) 
Loholov: posts small blind $0.10
chiyuki: posts big blind $0.25
*** HOLE CARDS ***
Dealt to chiyuki [Jd 2s]
cr0lox: folds 
taksist889: folds 
Suhoff76: folds 
WARIBANA7777: folds 
Perstenev: folds 
ygoegoe: folds 
deadmoneykid: folds 
Loholov: folds 
Uncalled bet ($0.15) returned to chiyuki
chiyuki collected $0.20 from pot
chiyuki: doesn't show hand 
*** SUMMARY ***
Total pot $0.20 | Rake $0 
Seat 1: deadmoneykid (button) folded before Flop (didn't bet)
Seat 2: Loholov (small blind) folded before Flop
Seat 3: chiyuki (big blind) collected ($0.20)
Seat 4: cr0lox folded before Flop (didn't bet)
Seat 5: taksist889 folded before Flop (didn't bet)
Seat 6: Suhoff76 folded before Flop (didn't bet)
Seat 7: WARIBANA7777 folded before Flop (didn't bet)
Seat 8: Perstenev folded before Flop (didn't bet)
Seat 9: ygoegoe folded before Flop (didn't bet)



PokerStars Zoom Hand #84299526541:  Hold'em No Limit ($0.10/$0.25) - 2012/08/05 14:25:21 JST [2012/08/05 1:25:21 ET]
Table 'Whirlpool' 9-max Seat #1 is the button
Seat 1: acamrash ($12.96 in chips) 
Seat 2: wtu1986 ($25 in chips) 
Seat 3: ZhukOFFskI ($25 in chips) 
Seat 4: PetitAlejo ($50.46 in chips) 
Seat 5: 1Karina1 ($25 in chips) 
Seat 6: Perstenev ($12.78 in chips) 
Seat 7: KeLevro0 ($11.14 in chips) 
Seat 8: carlosrbr ($64.55 in chips) 
Seat 9: chiyuki ($24.68 in chips) 
wtu1986: posts small blind $0.10
ZhukOFFskI: posts big blind $0.25
*** HOLE CARDS ***
Dealt to chiyuki [6d 4d]
PetitAlejo: folds 
1Karina1: folds 
Perstenev: raises $0.50 to $0.75
KeLevro0: folds 
carlosrbr: folds 
chiyuki: folds 
acamrash: folds 
wtu1986: folds 
ZhukOFFskI: folds 
Uncalled bet ($0.50) returned to Perstenev
Perstenev collected $0.60 from pot
Perstenev: doesn't show hand 
*** SUMMARY ***
Total pot $0.60 | Rake $0 
Seat 1: acamrash (button) folded before Flop (didn't bet)
Seat 2: wtu1986 (small blind) folded before Flop
Seat 3: ZhukOFFskI (big blind) folded before Flop
Seat 4: PetitAlejo folded before Flop (didn't bet)
Seat 5: 1Karina1 folded before Flop (didn't bet)
Seat 6: Perstenev collected ($0.60)
Seat 7: KeLevro0 folded before Flop (didn't bet)
Seat 8: carlosrbr folded before Flop (didn't bet)
Seat 9: chiyuki folded before Flop (didn't bet)



PokerStars Zoom Hand #84299528545:  Hold'em No Limit ($0.10/$0.25) - 2012/08/05 14:25:30 JST [2012/08/05 1:25:30 ET]
Table 'Whirlpool' 9-max Seat #1 is the button
Seat 1: wtu1986 ($31.74 in chips) 
Seat 2: chiyuki ($24.68 in chips) 
Seat 3: kamikkaze ($31.30 in chips) 
Seat 4: RomarioJa ($11.71 in chips) 
Seat 5: Nerkit ($11.87 in chips) 
Seat 6: hirozo ($31.53 in chips) 
Seat 7: Paranoix1990 ($9.48 in chips) 
Seat 8: RikkStroken ($24.36 in chips) 
Seat 9: acamrash ($12.96 in chips) 
chiyuki: posts small blind $0.10
kamikkaze: posts big blind $0.25
*** HOLE CARDS ***
Dealt to chiyuki [7d Qd]
RomarioJa: folds 
Nerkit: folds 
hirozo: folds 
Paranoix1990: raises $0.25 to $0.50
RikkStroken: folds 
acamrash: folds 
wtu1986: folds 
chiyuki: folds 
kamikkaze: folds 
Uncalled bet ($0.25) returned to Paranoix1990
Paranoix1990 collected $0.60 from pot
Paranoix1990: doesn't show hand 
*** SUMMARY ***
Total pot $0.60 | Rake $0 
Seat 1: wtu1986 (button) folded before Flop (didn't bet)
Seat 2: chiyuki (small blind) folded before Flop
Seat 3: kamikkaze (big blind) folded before Flop
Seat 4: RomarioJa folded before Flop (didn't bet)
Seat 5: Nerkit folded before Flop (didn't bet)
Seat 6: hirozo folded before Flop (didn't bet)
Seat 7: Paranoix1990 collected ($0.60)
Seat 8: RikkStroken folded before Flop (didn't bet)
Seat 9: acamrash folded before Flop (didn't bet)



PokerStars Zoom Hand #84299517893:  Hold'em No Limit ($0.10/$0.25) - 2012/08/05 14:24:46 JST [2012/08/05 1:24:46 ET]
Table 'Whirlpool' 9-max Seat #1 is the button
Seat 1: deadmoneykid ($29.05 in chips) 
Seat 2: RikkStroken ($27.31 in chips) 
Seat 3: Perstenev ($9.67 in chips) 
Seat 4: KeLevro0 ($8.85 in chips) 
Seat 5: Dan Royal ($41.33 in chips) 
Seat 6: Dejacob ($47.88 in chips) 
Seat 7: chiyuki ($24.58 in chips) 
Seat 8: Jene4kaBest ($11.16 in chips) 
Seat 9: johnbaco1209 ($36.89 in chips) 
RikkStroken: posts small blind $0.10
Perstenev: posts big blind $0.25
*** HOLE CARDS ***
Dealt to chiyuki [3h 2s]
KeLevro0: raises $0.42 to $0.67
Dan Royal: folds 
Dejacob: folds 
chiyuki: folds 
Jene4kaBest: folds 
johnbaco1209: calls $0.67
deadmoneykid: folds 
RikkStroken: folds 
Perstenev: folds 
*** FLOP *** [Td Qs Ks]
KeLevro0: bets $0.90
johnbaco1209: calls $0.90
*** TURN *** [Td Qs Ks] [4h]
KeLevro0: bets $2.56
johnbaco1209: calls $2.56
*** RIVER *** [Td Qs Ks 4h] [3s]
KeLevro0: bets $4.72 and is all-in
johnbaco1209: folds 
Uncalled bet ($4.72) returned to KeLevro0
KeLevro0 collected $8.22 from pot
KeLevro0: doesn't show hand 
*** SUMMARY ***
Total pot $8.61 | Rake $0.39 
Board [Td Qs Ks 4h 3s]
Seat 1: deadmoneykid (button) folded before Flop (didn't bet)
Seat 2: RikkStroken (small blind) folded before Flop
Seat 3: Perstenev (big blind) folded before Flop
Seat 4: KeLevro0 collected ($8.22)
Seat 5: Dan Royal folded before Flop (didn't bet)
Seat 6: Dejacob folded before Flop (didn't bet)
Seat 7: chiyuki folded before Flop (didn't bet)
Seat 8: Jene4kaBest folded before Flop (didn't bet)
Seat 9: johnbaco1209 folded on the River



PokerStars Zoom Hand #84299527546:  Hold'em No Limit ($0.10/$0.25) - 2012/08/05 14:25:25 JST [2012/08/05 1:25:25 ET]
Table 'Whirlpool' 9-max Seat #1 is the button
Seat 1: Dejacob ($27.88 in chips) 
Seat 2: 1Karina1 ($25 in chips) 
Seat 3: ladymadon107 ($4.50 in chips) 
Seat 4: flyinprits ($25.44 in chips) 
Seat 5: chiyuki ($24.68 in chips) 
Seat 6: acamrash ($12.96 in chips) 
Seat 7: carlosrbr ($64.55 in chips) 
Seat 8: seula i ($25 in chips) 
Seat 9: deadmoneykid ($28.20 in chips) 
1Karina1: posts small blind $0.10
ladymadon107: posts big blind $0.25
*** HOLE CARDS ***
Dealt to chiyuki [Qh 2c]
flyinprits: folds 
chiyuki: folds 
acamrash: folds 
carlosrbr: raises $0.50 to $0.75
seula i: folds 
deadmoneykid: folds 
Dejacob: calls $0.75
1Karina1: folds 
ladymadon107: calls $0.50
*** FLOP *** [Ks 3c Ts]
ladymadon107: bets $1
carlosrbr: folds 
Dejacob: folds 
Uncalled bet ($1) returned to ladymadon107
ladymadon107 collected $2.24 from pot
ladymadon107: doesn't show hand 
*** SUMMARY ***
Total pot $2.35 | Rake $0.11 
Board [Ks 3c Ts]
Seat 1: Dejacob (button) folded on the Flop
Seat 2: 1Karina1 (small blind) folded before Flop
Seat 3: ladymadon107 (big blind) collected ($2.24)
Seat 4: flyinprits folded before Flop (didn't bet)
Seat 5: chiyuki folded before Flop (didn't bet)
Seat 6: acamrash folded before Flop (didn't bet)
Seat 7: carlosrbr folded on the Flop
Seat 8: seula i folded before Flop (didn't bet)
Seat 9: deadmoneykid folded before Flop (didn't bet)



PokerStars Zoom Hand #84299531530:  Hold'em No Limit ($0.10/$0.25) - 2012/08/05 14:25:42 JST [2012/08/05 1:25:42 ET]
Table 'Whirlpool' 9-max Seat #1 is the button
Seat 1: kamikkaze ($31.05 in chips) 
Seat 2: WARIBANA7777 ($12.34 in chips) 
Seat 3: ygoegoe ($27.24 in chips) 
Seat 4: Loholov ($17.04 in chips) 
Seat 5: RikkStroken ($24.36 in chips) 
Seat 6: silvno31 ($35.44 in chips) 
Seat 7: chiyuki ($24.58 in chips) 
Seat 8: Perstenev ($9.07 in chips) 
Seat 9: KeLevro0 ($12.30 in chips) 
WARIBANA7777: posts small blind $0.10
ygoegoe: posts big blind $0.25
*** HOLE CARDS ***
Dealt to chiyuki [8d 5c]
Loholov: raises $0.75 to $1
RikkStroken: raises $2.25 to $3.25
silvno31: folds 
chiyuki: folds 
Perstenev: folds 
KeLevro0: folds 
kamikkaze: folds 
WARIBANA7777: folds 
ygoegoe: folds 
Loholov: calls $2.25
*** FLOP *** [Js 9h Td]
Loholov: checks 
RikkStroken: bets $4
Loholov: calls $4
*** TURN *** [Js 9h Td] [6s]
Loholov: checks 
RikkStroken: bets $11
Loholov: folds 
Uncalled bet ($11) returned to RikkStroken
RikkStroken collected $14.18 from pot
RikkStroken: doesn't show hand 
*** SUMMARY ***
Total pot $14.85 | Rake $0.67 
Board [Js 9h Td 6s]
Seat 1: kamikkaze (button) folded before Flop (didn't bet)
Seat 2: WARIBANA7777 (small blind) folded before Flop
Seat 3: ygoegoe (big blind) folded before Flop
Seat 4: Loholov folded on the Turn
Seat 5: RikkStroken collected ($14.18)
Seat 6: silvno31 folded before Flop (didn't bet)
Seat 7: chiyuki folded before Flop (didn't bet)
Seat 8: Perstenev folded before Flop (didn't bet)
Seat 9: KeLevro0 folded before Flop (didn't bet)



PokerStars Zoom Hand #84299536988:  Hold'em No Limit ($0.10/$0.25) - 2012/08/05 14:26:04 JST [2012/08/05 1:26:04 ET]
Table 'Whirlpool' 9-max Seat #1 is the button
Seat 1: Perstenev ($11.81 in chips) 
Seat 2: flyinprits ($25.44 in chips) 
Seat 3: Dan Royal ($41.33 in chips) 
Seat 4: Ellen1947 ($13.76 in chips) 
Seat 5: dushvan ($28.32 in chips) 
Seat 6: troms20 ($29.40 in chips) 
Seat 7: Lasutchik ($6.86 in chips) 
Seat 8: chiyuki ($24.58 in chips) 
Seat 9: Dejacob ($29.45 in chips) 
flyinprits: posts small blind $0.10
Dan Royal: posts big blind $0.25
*** HOLE CARDS ***
Dealt to chiyuki [9h 2s]
Ellen1947: folds 
dushvan: folds 
troms20: folds 
Lasutchik: folds 
chiyuki: folds 
Dejacob: raises $0.50 to $0.75
Perstenev: folds 
flyinprits: folds 
Dan Royal: folds 
Uncalled bet ($0.50) returned to Dejacob
Dejacob collected $0.60 from pot
Dejacob: doesn't show hand 
*** SUMMARY ***
Total pot $0.60 | Rake $0 
Seat 1: Perstenev (button) folded before Flop (didn't bet)
Seat 2: flyinprits (small blind) folded before Flop
Seat 3: Dan Royal (big blind) folded before Flop
Seat 4: Ellen1947 folded before Flop (didn't bet)
Seat 5: dushvan folded before Flop (didn't bet)
Seat 6: troms20 folded before Flop (didn't bet)
Seat 7: Lasutchik folded before Flop (didn't bet)
Seat 8: chiyuki folded before Flop (didn't bet)
Seat 9: Dejacob collected ($0.60)



PokerStars Zoom Hand #84299535550:  Hold'em No Limit ($0.10/$0.25) - 2012/08/05 14:25:58 JST [2012/08/05 1:25:58 ET]
Table 'Whirlpool' 9-max Seat #1 is the button
Seat 1: chiyuki ($24.58 in chips) 
Seat 2: Spartacus675 ($28.66 in chips) 
Seat 3: wtu1986 ($31.74 in chips) 
Seat 4: carlosrbr ($63.80 in chips) 
Seat 5: phate-1up ($33.69 in chips) 
Seat 6: 1Karina1 ($25 in chips) 
Seat 7: seula i ($38.56 in chips) 
Seat 8: Alvinpe85 ($37.48 in chips) 
Seat 9: RomarioJa ($11.71 in chips) 
Spartacus675: posts small blind $0.10
wtu1986: posts big blind $0.25
*** HOLE CARDS ***
Dealt to chiyuki [3d Jh]
carlosrbr: folds 
phate-1up: folds 
1Karina1: folds 
seula i: raises $0.50 to $0.75
Alvinpe85: raises $1.50 to $2.25
RomarioJa: folds 
chiyuki: folds 
Spartacus675: folds 
wtu1986: folds 
seula i: calls $1.50
*** FLOP *** [6h Jd 6d]
seula i: checks 
Alvinpe85: checks 
*** TURN *** [6h Jd 6d] [7h]
seula i: checks 
Alvinpe85: bets $2.75
seula i: folds 
Uncalled bet ($2.75) returned to Alvinpe85
Alvinpe85 collected $4.63 from pot
Alvinpe85: doesn't show hand 
*** SUMMARY ***
Total pot $4.85 | Rake $0.22 
Board [6h Jd 6d 7h]
Seat 1: chiyuki (button) folded before Flop (didn't bet)
Seat 2: Spartacus675 (small blind) folded before Flop
Seat 3: wtu1986 (big blind) folded before Flop
Seat 4: carlosrbr folded before Flop (didn't bet)
Seat 5: phate-1up folded before Flop (didn't bet)
Seat 6: 1Karina1 folded before Flop (didn't bet)
Seat 7: seula i folded on the Turn
Seat 8: Alvinpe85 collected ($4.63)
Seat 9: RomarioJa folded before Flop (didn't bet)



PokerStars Zoom Hand #84299540317:  Hold'em No Limit ($0.10/$0.25) - 2012/08/05 14:26:18 JST [2012/08/05 1:26:18 ET]
Table 'Whirlpool' 9-max Seat #1 is the button
Seat 1: Loholov ($15.35 in chips) 
Seat 2: 1Karina1 ($25 in chips) 
Seat 3: PetitAlejo ($31.86 in chips) 
Seat 4: Th3Fog ($15.84 in chips) 
Seat 5: Lasutchik ($6.86 in chips) 
Seat 6: chiyuki ($24.58 in chips) 
Seat 7: wtu1986 ($31.49 in chips) 
Seat 8: deadmoneykid ($28.20 in chips) 
Seat 9: bonethugs699 ($14.25 in chips) 
1Karina1: posts small blind $0.10
PetitAlejo: posts big blind $0.25
*** HOLE CARDS ***
Dealt to chiyuki [Tc 5h]
Th3Fog: folds 
Lasutchik: folds 
chiyuki: folds 
wtu1986: folds 
deadmoneykid: folds 
bonethugs699: folds 
Loholov: raises $0.50 to $0.75
1Karina1: folds 
PetitAlejo: folds 
Uncalled bet ($0.50) returned to Loholov
Loholov collected $0.60 from pot
Loholov: doesn't show hand 
*** SUMMARY ***
Total pot $0.60 | Rake $0 
Seat 1: Loholov (button) collected ($0.60)
Seat 2: 1Karina1 (small blind) folded before Flop
Seat 3: PetitAlejo (big blind) folded before Flop
Seat 4: Th3Fog folded before Flop (didn't bet)
Seat 5: Lasutchik folded before Flop (didn't bet)
Seat 6: chiyuki folded before Flop (didn't bet)
Seat 7: wtu1986 folded before Flop (didn't bet)
Seat 8: deadmoneykid folded before Flop (didn't bet)
Seat 9: bonethugs699 folded before Flop (didn't bet)



PokerStars Zoom Hand #84299541566:  Hold'em No Limit ($0.10/$0.25) - 2012/08/05 14:26:23 JST [2012/08/05 1:26:23 ET]
Table 'Whirlpool' 9-max Seat #1 is the button
Seat 1: ZhukOFFskI ($23.28 in chips) 
Seat 2: 4ydo yogurt ($16.48 in chips) 
Seat 3: phate-1up ($30.15 in chips) 
Seat 4: troms20 ($29.40 in chips) 
Seat 5: Spartacus675 ($28.56 in chips) 
Seat 6: wtu1986 ($31.49 in chips) 
Seat 7: kamikkaze ($19.03 in chips) 
Seat 8: bonethugs699 ($14.25 in chips) 
Seat 9: chiyuki ($24.58 in chips) 
4ydo yogurt: posts small blind $0.10
phate-1up: posts big blind $0.25
*** HOLE CARDS ***
Dealt to chiyuki [2h Ad]
troms20: folds 
Spartacus675: folds 
wtu1986: folds 
kamikkaze: raises $0.50 to $0.75
bonethugs699: raises $0.55 to $1.30
chiyuki: folds 
ZhukOFFskI: folds 
4ydo yogurt: folds 
phate-1up: folds 
kamikkaze: calls $0.55
*** FLOP *** [8c 3d 4s]
kamikkaze: checks 
bonethugs699: checks 
*** TURN *** [8c 3d 4s] [Th]
kamikkaze: checks 
bonethugs699: checks 
*** RIVER *** [8c 3d 4s Th] [3h]
kamikkaze: checks 
bonethugs699: bets $2.62
kamikkaze: folds 
Uncalled bet ($2.62) returned to bonethugs699
bonethugs699 collected $2.82 from pot
bonethugs699: doesn't show hand 
*** SUMMARY ***
Total pot $2.95 | Rake $0.13 
Board [8c 3d 4s Th 3h]
Seat 1: ZhukOFFskI (button) folded before Flop (didn't bet)
Seat 2: 4ydo yogurt (small blind) folded before Flop
Seat 3: phate-1up (big blind) folded before Flop
Seat 4: troms20 folded before Flop (didn't bet)
Seat 5: Spartacus675 folded before Flop (didn't bet)
Seat 6: wtu1986 folded before Flop (didn't bet)
Seat 7: kamikkaze folded on the River
Seat 8: bonethugs699 collected ($2.82)
Seat 9: chiyuki folded before Flop (didn't bet)



PokerStars Zoom Hand #84299545022:  Hold'em No Limit ($0.10/$0.25) - 2012/08/05 14:26:37 JST [2012/08/05 1:26:37 ET]
Table 'Whirlpool' 9-max Seat #1 is the button
Seat 1: Roglus ($9.65 in chips) 
Seat 2: Suhoff76 ($32.76 in chips) 
Seat 3: chiyuki ($24.58 in chips) 
Seat 4: Dejacob ($27.03 in chips) 
Seat 5: ChrisCDee ($66.11 in chips) 
Seat 6: ygoegoe ($25.25 in chips) 
Seat 7: 1Karina1 ($25 in chips) 
Seat 8: Loholov ($15 in chips) 
Seat 9: wildy29 ($9.33 in chips) 
Suhoff76: posts small blind $0.10
chiyuki: posts big blind $0.25
*** HOLE CARDS ***
Dealt to chiyuki [Qh 3c]
Dejacob: folds 
ChrisCDee: folds 
ygoegoe: folds 
1Karina1: folds 
Loholov: folds 
wildy29: calls $0.25
Roglus: folds 
Suhoff76: folds 
chiyuki: checks 
*** FLOP *** [Qc Ac Jc]
chiyuki: checks 
wildy29: checks 
*** TURN *** [Qc Ac Jc] [7c]
chiyuki: bets $0.50
wildy29: calls $0.50
*** RIVER *** [Qc Ac Jc 7c] [Js]
chiyuki: checks 
wildy29: bets $1
chiyuki: folds 
Uncalled bet ($1) returned to wildy29
wildy29 collected $1.53 from pot
wildy29: doesn't show hand 
*** SUMMARY ***
Total pot $1.60 | Rake $0.07 
Board [Qc Ac Jc 7c Js]
Seat 1: Roglus (button) folded before Flop (didn't bet)
Seat 2: Suhoff76 (small blind) folded before Flop
Seat 3: chiyuki (big blind) folded on the River
Seat 4: Dejacob folded before Flop (didn't bet)
Seat 5: ChrisCDee folded before Flop (didn't bet)
Seat 6: ygoegoe folded before Flop (didn't bet)
Seat 7: 1Karina1 folded before Flop (didn't bet)
Seat 8: Loholov folded before Flop (didn't bet)
Seat 9: wildy29 collected ($1.53)



PokerStars Zoom Hand #84299558875:  Hold'em No Limit ($0.10/$0.25) - 2012/08/05 14:27:34 JST [2012/08/05 1:27:34 ET]
Table 'Whirlpool' 9-max Seat #1 is the button
Seat 1: KeLevro0 ($11.85 in chips) 
Seat 2: 4plankton ($17.38 in chips) 
Seat 3: Nerkit ($9.60 in chips) 
Seat 4: roksmokndonk ($27.67 in chips) 
Seat 5: chiyuki ($23.83 in chips) 
Seat 6: flyinprits ($27.17 in chips) 
Seat 7: mariuka1 ($12.15 in chips) 
Seat 8: Lasutchik ($6.51 in chips) 
Seat 9: Suhoff76 ($32.41 in chips) 
4plankton: posts small blind $0.10
Nerkit: posts big blind $0.25
*** HOLE CARDS ***
Dealt to chiyuki [7h 4d]
roksmokndonk: folds 
chiyuki: folds 
flyinprits: raises $0.50 to $0.75
mariuka1: folds 
Lasutchik: folds 
Suhoff76: folds 
KeLevro0: folds 
4plankton: folds 
Nerkit: folds 
Uncalled bet ($0.50) returned to flyinprits
flyinprits collected $0.60 from pot
flyinprits: doesn't show hand 
*** SUMMARY ***
Total pot $0.60 | Rake $0 
Seat 1: KeLevro0 (button) folded before Flop (didn't bet)
Seat 2: 4plankton (small blind) folded before Flop
Seat 3: Nerkit (big blind) folded before Flop
Seat 4: roksmokndonk folded before Flop (didn't bet)
Seat 5: chiyuki folded before Flop (didn't bet)
Seat 6: flyinprits collected ($0.60)
Seat 7: mariuka1 folded before Flop (didn't bet)
Seat 8: Lasutchik folded before Flop (didn't bet)
Seat 9: Suhoff76 folded before Flop (didn't bet)



PokerStars Zoom Hand #84299561269:  Hold'em No Limit ($0.10/$0.25) - 2012/08/05 14:27:44 JST [2012/08/05 1:27:44 ET]
Table 'Whirlpool' 9-max Seat #1 is the button
Seat 1: Th3Fog ($52.38 in chips) 
Seat 2: BlOnDhOlIc ($88.41 in chips) 
Seat 3: wtu1986 ($24.77 in chips) 
Seat 4: hirozo ($28.43 in chips) 
Seat 5: Dafleche ($18.25 in chips) 
Seat 6: chiyuki ($23.73 in chips) 
Seat 7: Suhoff76 ($25 in chips) 
Seat 8: kamikkaze ($18.73 in chips) 
Seat 9: Noviekid ($86.56 in chips) 
BlOnDhOlIc: posts small blind $0.10
wtu1986: posts big blind $0.25
*** HOLE CARDS ***
Dealt to chiyuki [9h 5d]
hirozo: raises $0.50 to $0.75
Dafleche: folds 
chiyuki: folds 
Suhoff76: folds 
kamikkaze: folds 
Noviekid: folds 
Th3Fog: folds 
BlOnDhOlIc: folds 
wtu1986: folds 
Uncalled bet ($0.50) returned to hirozo
hirozo collected $0.60 from pot
hirozo: doesn't show hand 
*** SUMMARY ***
Total pot $0.60 | Rake $0 
Seat 1: Th3Fog (button) folded before Flop (didn't bet)
Seat 2: BlOnDhOlIc (small blind) folded before Flop
Seat 3: wtu1986 (big blind) folded before Flop
Seat 4: hirozo collected ($0.60)
Seat 5: Dafleche folded before Flop (didn't bet)
Seat 6: chiyuki folded before Flop (didn't bet)
Seat 7: Suhoff76 folded before Flop (didn't bet)
Seat 8: kamikkaze folded before Flop (didn't bet)
Seat 9: Noviekid folded before Flop (didn't bet)



PokerStars Zoom Hand #84299564239:  Hold'em No Limit ($0.10/$0.25) - 2012/08/05 14:27:56 JST [2012/08/05 1:27:56 ET]
Table 'Whirlpool' 9-max Seat #1 is the button
Seat 1: chiyuki ($23.73 in chips) 
Seat 2: Dafleche ($18 in chips) 
Seat 3: kamikkaze ($32.32 in chips) 
Seat 4: hirozo ($37.82 in chips) 
Seat 5: Roglus ($10.42 in chips) 
Seat 6: Th3Fog ($52.38 in chips) 
Seat 7: loca-loca888 ($43.68 in chips) 
Seat 8: Suhoff76 ($28.05 in chips) 
Seat 9: hl77777 ($13.83 in chips) 
Dafleche: posts small blind $0.10
kamikkaze: posts big blind $0.25
*** HOLE CARDS ***
Dealt to chiyuki [7s 4s]
hirozo: folds 
Roglus: folds 
Th3Fog: folds 
loca-loca888: folds 
Suhoff76: folds 
hl77777: folds 
chiyuki: folds 
Dafleche: folds 
Uncalled bet ($0.15) returned to kamikkaze
kamikkaze collected $0.20 from pot
kamikkaze: doesn't show hand 
*** SUMMARY ***
Total pot $0.20 | Rake $0 
Seat 1: chiyuki (button) folded before Flop (didn't bet)
Seat 2: Dafleche (small blind) folded before Flop
Seat 3: kamikkaze (big blind) collected ($0.20)
Seat 4: hirozo folded before Flop (didn't bet)
Seat 5: Roglus folded before Flop (didn't bet)
Seat 6: Th3Fog folded before Flop (didn't bet)
Seat 7: loca-loca888 folded before Flop (didn't bet)
Seat 8: Suhoff76 folded before Flop (didn't bet)
Seat 9: hl77777 folded before Flop (didn't bet)



PokerStars Zoom Hand #84299563243:  Hold'em No Limit ($0.10/$0.25) - 2012/08/05 14:27:53 JST [2012/08/05 1:27:53 ET]
Table 'Whirlpool' 9-max Seat #1 is the button
Seat 1: troms20 ($32.39 in chips) 
Seat 2: softdesign ($68.51 in chips) 
Seat 3: Perstenev ($11.70 in chips) 
Seat 4: Ellen1947 ($26.71 in chips) 
Seat 5: KeLevro0 ($11.85 in chips) 
Seat 6: WARIBANA7777 ($9.79 in chips) 
Seat 7: Spartacus675 ($29.16 in chips) 
Seat 8: chiyuki ($23.73 in chips) 
Seat 9: yane73 ($13.77 in chips) 
softdesign: posts small blind $0.10
Perstenev: posts big blind $0.25
*** HOLE CARDS ***
Dealt to chiyuki [Ac 7s]
Ellen1947: folds 
KeLevro0: folds 
WARIBANA7777: folds 
Spartacus675: folds 
chiyuki: folds 
yane73: folds 
troms20: raises $0.50 to $0.75
softdesign: folds 
Perstenev: folds 
Uncalled bet ($0.50) returned to troms20
troms20 collected $0.60 from pot
troms20: doesn't show hand 
*** SUMMARY ***
Total pot $0.60 | Rake $0 
Seat 1: troms20 (button) collected ($0.60)
Seat 2: softdesign (small blind) folded before Flop
Seat 3: Perstenev (big blind) folded before Flop
Seat 4: Ellen1947 folded before Flop (didn't bet)
Seat 5: KeLevro0 folded before Flop (didn't bet)
Seat 6: WARIBANA7777 folded before Flop (didn't bet)
Seat 7: Spartacus675 folded before Flop (didn't bet)
Seat 8: chiyuki folded before Flop (didn't bet)
Seat 9: yane73 folded before Flop (didn't bet)



PokerStars Zoom Hand #84299559569:  Hold'em No Limit ($0.10/$0.25) - 2012/08/05 14:27:37 JST [2012/08/05 1:27:37 ET]
Table 'Whirlpool' 9-max Seat #1 is the button
Seat 1: eskeyp ($14.09 in chips) 
Seat 2: chiyuki ($23.83 in chips) 
Seat 3: Loholov ($15 in chips) 
Seat 4: DanielWhyte ($39.56 in chips) 
Seat 5: hirozo ($28.43 in chips) 
Seat 6: RikkStroken ($12.01 in chips) 
Seat 7: ygoegoe ($25.25 in chips) 
Seat 8: wildy29 ($10.11 in chips) 
Seat 9: Roglus ($74.36 in chips) 
chiyuki: posts small blind $0.10
Loholov: posts big blind $0.25
*** HOLE CARDS ***
Dealt to chiyuki [7c 4h]
DanielWhyte: folds 
hirozo: folds 
RikkStroken has timed out
RikkStroken: folds 
ygoegoe: folds 
wildy29: raises $0.25 to $0.50
Roglus: folds 
eskeyp: folds 
chiyuki: folds 
Loholov: folds 
Uncalled bet ($0.25) returned to wildy29
wildy29 collected $0.60 from pot
wildy29: doesn't show hand 
*** SUMMARY ***
Total pot $0.60 | Rake $0 
Seat 1: eskeyp (button) folded before Flop (didn't bet)
Seat 2: chiyuki (small blind) folded before Flop
Seat 3: Loholov (big blind) folded before Flop
Seat 4: DanielWhyte folded before Flop (didn't bet)
Seat 5: hirozo folded before Flop (didn't bet)
Seat 6: RikkStroken folded before Flop (didn't bet)
Seat 7: ygoegoe folded before Flop (didn't bet)
Seat 8: wildy29 collected ($0.60)
Seat 9: Roglus folded before Flop (didn't bet)



PokerStars Zoom Hand #84299568845:  Hold'em No Limit ($0.10/$0.25) - 2012/08/05 14:28:16 JST [2012/08/05 1:28:16 ET]
Table 'Whirlpool' 9-max Seat #1 is the button
Seat 1: RikkStroken ($12.01 in chips) 
Seat 2: ChrisCDee ($38.38 in chips) 
Seat 3: phate-1up ($25 in chips) 
Seat 4: wildy29 ($10.46 in chips) 
Seat 5: chiyuki ($23.73 in chips) 
Seat 6: ZhukOFFskI ($24.15 in chips) 
Seat 7: ygoegoe ($28.01 in chips) 
Seat 8: Nerkit ($14.48 in chips) 
Seat 9: Dan Royal ($40.98 in chips) 
ChrisCDee: posts small blind $0.10
phate-1up: posts big blind $0.25
*** HOLE CARDS ***
Dealt to chiyuki [Kh 5h]
wildy29: folds 
chiyuki: folds 
ZhukOFFskI: folds 
ygoegoe: folds 
Nerkit: folds 
Dan Royal: raises $0.50 to $0.75
RikkStroken: folds 
ChrisCDee: folds 
phate-1up: folds 
Uncalled bet ($0.50) returned to Dan Royal
Dan Royal collected $0.60 from pot
Dan Royal: doesn't show hand 
*** SUMMARY ***
Total pot $0.60 | Rake $0 
Seat 1: RikkStroken (button) folded before Flop (didn't bet)
Seat 2: ChrisCDee (small blind) folded before Flop
Seat 3: phate-1up (big blind) folded before Flop
Seat 4: wildy29 folded before Flop (didn't bet)
Seat 5: chiyuki folded before Flop (didn't bet)
Seat 6: ZhukOFFskI folded before Flop (didn't bet)
Seat 7: ygoegoe folded before Flop (didn't bet)
Seat 8: Nerkit folded before Flop (didn't bet)
Seat 9: Dan Royal collected ($0.60)



PokerStars Zoom Hand #84299567102:  Hold'em No Limit ($0.10/$0.25) - 2012/08/05 14:28:09 JST [2012/08/05 1:28:09 ET]
Table 'Whirlpool' 9-max Seat #1 is the button
Seat 1: deadmoneykid ($26.42 in chips) 
Seat 2: ZhukOFFskI ($24.25 in chips) 
Seat 3: pef1331 ($29.64 in chips) 
Seat 4: chiyuki ($23.73 in chips) 
Seat 5: softdesign ($68.41 in chips) 
Seat 6: acamrash ($10.39 in chips) 
Seat 7: KCDOGG10 ($20.25 in chips) 
Seat 8: Jene4kaBest ($12.40 in chips) 
Seat 9: znake77 ($16.36 in chips) 
ZhukOFFskI: posts small blind $0.10
pef1331: posts big blind $0.25
*** HOLE CARDS ***
Dealt to chiyuki [6h Kd]
chiyuki: folds 
softdesign: folds 
acamrash: folds 
KCDOGG10: folds 
Jene4kaBest: folds 
znake77: folds 
deadmoneykid: folds 
ZhukOFFskI: folds 
Uncalled bet ($0.15) returned to pef1331
pef1331 collected $0.20 from pot
pef1331: doesn't show hand 
*** SUMMARY ***
Total pot $0.20 | Rake $0 
Seat 1: deadmoneykid (button) folded before Flop (didn't bet)
Seat 2: ZhukOFFskI (small blind) folded before Flop
Seat 3: pef1331 (big blind) collected ($0.20)
Seat 4: chiyuki folded before Flop (didn't bet)
Seat 5: softdesign folded before Flop (didn't bet)
Seat 6: acamrash folded before Flop (didn't bet)
Seat 7: KCDOGG10 folded before Flop (didn't bet)
Seat 8: Jene4kaBest folded before Flop (didn't bet)
Seat 9: znake77 folded before Flop (didn't bet)



PokerStars Zoom Hand #84299570309:  Hold'em No Limit ($0.10/$0.25) - 2012/08/05 14:28:22 JST [2012/08/05 1:28:22 ET]
Table 'Whirlpool' 9-max Seat #1 is the button
Seat 1: RikkStroken ($31.29 in chips) 
Seat 2: wildy29 ($10.46 in chips) 
Seat 3: chiyuki ($23.73 in chips) 
Seat 4: slapshot2011 ($35.66 in chips) 
Seat 5: Perstenev ($22.77 in chips) 
Seat 6: Alvinpe85 ($39.91 in chips) 
Seat 7: ZhukOFFskI ($25 in chips) 
Seat 8: JLajoie ($25.94 in chips) 
Seat 9: Suhoff76 ($26 in chips) 
wildy29: posts small blind $0.10
chiyuki: posts big blind $0.25
*** HOLE CARDS ***
Dealt to chiyuki [3d 5s]
slapshot2011: folds 
Perstenev: folds 
Alvinpe85: folds 
ZhukOFFskI: folds 
JLajoie: raises $0.75 to $1
Suhoff76: folds 
RikkStroken: folds 
wildy29: folds 
chiyuki: folds 
Uncalled bet ($0.75) returned to JLajoie
JLajoie collected $0.60 from pot
JLajoie: doesn't show hand 
*** SUMMARY ***
Total pot $0.60 | Rake $0 
Seat 1: RikkStroken (button) folded before Flop (didn't bet)
Seat 2: wildy29 (small blind) folded before Flop
Seat 3: chiyuki (big blind) folded before Flop
Seat 4: slapshot2011 folded before Flop (didn't bet)
Seat 5: Perstenev folded before Flop (didn't bet)
Seat 6: Alvinpe85 folded before Flop (didn't bet)
Seat 7: ZhukOFFskI folded before Flop (didn't bet)
Seat 8: JLajoie collected ($0.60)
Seat 9: Suhoff76 folded before Flop (didn't bet)



PokerStars Zoom Hand #84299565421:  Hold'em No Limit ($0.10/$0.25) - 2012/08/05 14:28:02 JST [2012/08/05 1:28:02 ET]
Table 'Whirlpool' 9-max Seat #1 is the button
Seat 1: RomarioJa ($11.01 in chips) 
Seat 2: Yogi707 ($14.15 in chips) 
Seat 3: ChrisCDee ($38.63 in chips) 
Seat 4: Roglus ($74.36 in chips) 
Seat 5: hirozo ($25.57 in chips) 
Seat 6: loca-loca888 ($43.68 in chips) 
Seat 7: chiyuki ($23.73 in chips) 
Seat 8: Perstenev ($11.93 in chips) 
Seat 9: Dafleche ($17.90 in chips) 
Yogi707: posts small blind $0.10
ChrisCDee: posts big blind $0.25
*** HOLE CARDS ***
Dealt to chiyuki [3c 4s]
Roglus: folds 
hirozo: folds 
loca-loca888: raises $0.35 to $0.60
chiyuki: folds 
Perstenev: folds 
Dafleche: calls $0.60
RomarioJa: folds 
Yogi707: folds 
ChrisCDee: folds 
*** FLOP *** [Td Ah 8h]
loca-loca888: bets $0.90
Dafleche: calls $0.90
*** TURN *** [Td Ah 8h] [Jd]
loca-loca888: checks 
Dafleche: bets $2
loca-loca888: folds 
Uncalled bet ($2) returned to Dafleche
Dafleche collected $3.20 from pot
Dafleche: doesn't show hand 
*** SUMMARY ***
Total pot $3.35 | Rake $0.15 
Board [Td Ah 8h Jd]
Seat 1: RomarioJa (button) folded before Flop (didn't bet)
Seat 2: Yogi707 (small blind) folded before Flop
Seat 3: ChrisCDee (big blind) folded before Flop
Seat 4: Roglus folded before Flop (didn't bet)
Seat 5: hirozo folded before Flop (didn't bet)
Seat 6: loca-loca888 folded on the Turn
Seat 7: chiyuki folded before Flop (didn't bet)
Seat 8: Perstenev folded before Flop (didn't bet)
Seat 9: Dafleche collected ($3.20)



PokerStars Zoom Hand #84299575464:  Hold'em No Limit ($0.10/$0.25) - 2012/08/05 14:28:43 JST [2012/08/05 1:28:43 ET]
Table 'Whirlpool' 9-max Seat #1 is the button
Seat 1: pef1331 ($29.64 in chips) 
Seat 2: 1Karina1 ($25 in chips) 
Seat 3: Roglus ($10.32 in chips) 
Seat 4: ZhukOFFskI ($25 in chips) 
Seat 5: Nerkit ($14.48 in chips) 
Seat 6: wildy29 ($10.36 in chips) 
Seat 7: chiyuki ($23.48 in chips) 
Seat 8: phate-1up ($25 in chips) 
Seat 9: RikkStroken ($31.29 in chips) 
1Karina1: posts small blind $0.10
Roglus: posts big blind $0.25
*** HOLE CARDS ***
Dealt to chiyuki [9c 8s]
ZhukOFFskI: folds 
Nerkit: folds 
wildy29: folds 
chiyuki: folds 
phate-1up: folds 
RikkStroken: folds 
pef1331: folds 
1Karina1: raises $0.50 to $0.75
Roglus: folds 
Uncalled bet ($0.50) returned to 1Karina1
1Karina1 collected $0.50 from pot
1Karina1: doesn't show hand 
*** SUMMARY ***
Total pot $0.50 | Rake $0 
Seat 1: pef1331 (button) folded before Flop (didn't bet)
Seat 2: 1Karina1 (small blind) collected ($0.50)
Seat 3: Roglus (big blind) folded before Flop
Seat 4: ZhukOFFskI folded before Flop (didn't bet)
Seat 5: Nerkit folded before Flop (didn't bet)
Seat 6: wildy29 folded before Flop (didn't bet)
Seat 7: chiyuki folded before Flop (didn't bet)
Seat 8: phate-1up folded before Flop (didn't bet)
Seat 9: RikkStroken folded before Flop (didn't bet)



PokerStars Zoom Hand #84299576704:  Hold'em No Limit ($0.10/$0.25) - 2012/08/05 14:28:48 JST [2012/08/05 1:28:48 ET]
Table 'Whirlpool' 9-max Seat #1 is the button
Seat 1: KrystalAA ($12.15 in chips) 
Seat 2: chiyuki ($23.48 in chips) 
Seat 3: Perstenev ($22.77 in chips) 
Seat 4: KeLevro0 ($9.53 in chips) 
Seat 5: Dejacob ($49.22 in chips) 
Seat 6: ll_LaMeR_ll ($55.98 in chips) 
Seat 7: hirozo ($36.56 in chips) 
Seat 8: wildy29 ($10.36 in chips) 
Seat 9: timbof7 ($20.23 in chips) 
chiyuki: posts small blind $0.10
Perstenev: posts big blind $0.25
*** HOLE CARDS ***
Dealt to chiyuki [4s 3d]
KeLevro0: folds 
Dejacob: folds 
ll_LaMeR_ll: folds 
hirozo: folds 
wildy29: folds 
timbof7: folds 
KrystalAA: raises $0.46 to $0.71
chiyuki: folds 
Perstenev: folds 
Uncalled bet ($0.46) returned to KrystalAA
KrystalAA collected $0.60 from pot
KrystalAA: doesn't show hand 
*** SUMMARY ***
Total pot $0.60 | Rake $0 
Seat 1: KrystalAA (button) collected ($0.60)
Seat 2: chiyuki (small blind) folded before Flop
Seat 3: Perstenev (big blind) folded before Flop
Seat 4: KeLevro0 folded before Flop (didn't bet)
Seat 5: Dejacob folded before Flop (didn't bet)
Seat 6: ll_LaMeR_ll folded before Flop (didn't bet)
Seat 7: hirozo folded before Flop (didn't bet)
Seat 8: wildy29 folded before Flop (didn't bet)
Seat 9: timbof7 folded before Flop (didn't bet)



PokerStars Zoom Hand #84299567826:  Hold'em No Limit ($0.10/$0.25) - 2012/08/05 14:28:12 JST [2012/08/05 1:28:12 ET]
Table 'Whirlpool' 9-max Seat #1 is the button
Seat 1: deadmoneykid ($22.39 in chips) 
Seat 2: kamikkaze ($16.97 in chips) 
Seat 3: ChrisCDee ($66.46 in chips) 
Seat 4: chiyuki ($23.73 in chips) 
Seat 5: Faraz ($19.39 in chips) 
Seat 6: Perstenev ($11.45 in chips) 
Seat 7: Lasutchik ($70.61 in chips) 
Seat 8: Dejacob ($28.81 in chips) 
Seat 9: RomarioJa ($12.15 in chips) 
kamikkaze: posts small blind $0.10
ChrisCDee: posts big blind $0.25
*** HOLE CARDS ***
Dealt to chiyuki [5c Ts]
chiyuki: folds 
Faraz: folds 
Perstenev: calls $0.25
Lasutchik: folds 
Dejacob: folds 
RomarioJa: raises $0.75 to $1
deadmoneykid: folds 
kamikkaze: folds 
ChrisCDee: folds 
Perstenev: calls $0.75
*** FLOP *** [6c 7h Tc]
Perstenev: checks 
RomarioJa: bets $1.68
Perstenev: calls $1.68
*** TURN *** [6c 7h Tc] [2h]
Perstenev: checks 
RomarioJa: bets $3.59
Perstenev: folds 
Uncalled bet ($3.59) returned to RomarioJa
RomarioJa collected $5.45 from pot
RomarioJa: doesn't show hand 
*** SUMMARY ***
Total pot $5.71 | Rake $0.26 
Board [6c 7h Tc 2h]
Seat 1: deadmoneykid (button) folded before Flop (didn't bet)
Seat 2: kamikkaze (small blind) folded before Flop
Seat 3: ChrisCDee (big blind) folded before Flop
Seat 4: chiyuki folded before Flop (didn't bet)
Seat 5: Faraz folded before Flop (didn't bet)
Seat 6: Perstenev folded on the Turn
Seat 7: Lasutchik folded before Flop (didn't bet)
Seat 8: Dejacob folded before Flop (didn't bet)
Seat 9: RomarioJa collected ($5.45)



PokerStars Zoom Hand #84299579623:  Hold'em No Limit ($0.10/$0.25) - 2012/08/05 14:29:00 JST [2012/08/05 1:29:00 ET]
Table 'Whirlpool' 9-max Seat #1 is the button
Seat 1: kamikkaze ($15.80 in chips) 
Seat 2: ygoegoe ($27.26 in chips) 
Seat 3: RikkStroken ($12.95 in chips) 
Seat 4: Wilcox76607 ($16.21 in chips) 
Seat 5: phate-1up ($41.09 in chips) 
Seat 6: 4ydo yogurt ($12.80 in chips) 
Seat 7: Perstenev ($10.71 in chips) 
Seat 8: chiyuki ($23.38 in chips) 
Seat 9: hirozo ($28.78 in chips) 
ygoegoe: posts small blind $0.10
RikkStroken: posts big blind $0.25
*** HOLE CARDS ***
Dealt to chiyuki [6s Qc]
Wilcox76607: raises $0.50 to $0.75
phate-1up: folds 
4ydo yogurt: folds 
Perstenev: folds 
chiyuki: folds 
hirozo: folds 
kamikkaze: folds 
ygoegoe: folds 
RikkStroken: folds 
Uncalled bet ($0.50) returned to Wilcox76607
Wilcox76607 collected $0.60 from pot
Wilcox76607: doesn't show hand 
*** SUMMARY ***
Total pot $0.60 | Rake $0 
Seat 1: kamikkaze (button) folded before Flop (didn't bet)
Seat 2: ygoegoe (small blind) folded before Flop
Seat 3: RikkStroken (big blind) folded before Flop
Seat 4: Wilcox76607 collected ($0.60)
Seat 5: phate-1up folded before Flop (didn't bet)
Seat 6: 4ydo yogurt folded before Flop (didn't bet)
Seat 7: Perstenev folded before Flop (didn't bet)
Seat 8: chiyuki folded before Flop (didn't bet)
Seat 9: hirozo folded before Flop (didn't bet)



PokerStars Zoom Hand #84299577911:  Hold'em No Limit ($0.10/$0.25) - 2012/08/05 14:28:53 JST [2012/08/05 1:28:53 ET]
Table 'Whirlpool' 9-max Seat #1 is the button
Seat 1: softdesign ($68.41 in chips) 
Seat 2: seula i ($33.74 in chips) 
Seat 3: phate-1up ($26.32 in chips) 
Seat 4: Suhoff76 ($28.40 in chips) 
Seat 5: RikkStroken ($33.66 in chips) 
Seat 6: kamikkaze ($15.80 in chips) 
Seat 7: BlOnDhOlIc ($35.71 in chips) 
Seat 8: Th3Fog ($53.06 in chips) 
Seat 9: chiyuki ($23.38 in chips) 
seula i: posts small blind $0.10
phate-1up: posts big blind $0.25
*** HOLE CARDS ***
Dealt to chiyuki [Tc Qd]
Suhoff76: folds 
RikkStroken: folds 
kamikkaze: folds 
BlOnDhOlIc: folds 
Th3Fog: folds 
chiyuki: folds 
softdesign: folds 
seula i: folds 
Uncalled bet ($0.15) returned to phate-1up
phate-1up collected $0.20 from pot
phate-1up: doesn't show hand 
*** SUMMARY ***
Total pot $0.20 | Rake $0 
Seat 1: softdesign (button) folded before Flop (didn't bet)
Seat 2: seula i (small blind) folded before Flop
Seat 3: phate-1up (big blind) collected ($0.20)
Seat 4: Suhoff76 folded before Flop (didn't bet)
Seat 5: RikkStroken folded before Flop (didn't bet)
Seat 6: kamikkaze folded before Flop (didn't bet)
Seat 7: BlOnDhOlIc folded before Flop (didn't bet)
Seat 8: Th3Fog folded before Flop (didn't bet)
Seat 9: chiyuki folded before Flop (didn't bet)



PokerStars Zoom Hand #84299580869:  Hold'em No Limit ($0.10/$0.25) - 2012/08/05 14:29:05 JST [2012/08/05 1:29:05 ET]
Table 'Whirlpool' 9-max Seat #1 is the button
Seat 1: chiyuki ($23.38 in chips) 
Seat 2: seula i ($25.10 in chips) 
Seat 3: kamikkaze ($15.80 in chips) 
Seat 4: Noviekid ($86.56 in chips) 
Seat 5: 4ydo yogurt ($12.80 in chips) 
Seat 6: wtu1986 ($31.04 in chips) 
Seat 7: KeLevro0 ($9.53 in chips) 
Seat 8: Roglus ($74.93 in chips) 
Seat 9: Dejacob ($35.76 in chips) 
seula i: posts small blind $0.10
kamikkaze: posts big blind $0.25
*** HOLE CARDS ***
Dealt to chiyuki [6h Ac]
Noviekid: raises $0.50 to $0.75
4ydo yogurt: folds 
wtu1986: folds 
KeLevro0: folds 
Roglus: folds 
Dejacob: folds 
chiyuki: folds 
seula i: folds 
kamikkaze: folds 
Uncalled bet ($0.50) returned to Noviekid
Noviekid collected $0.60 from pot
Noviekid: doesn't show hand 
*** SUMMARY ***
Total pot $0.60 | Rake $0 
Seat 1: chiyuki (button) folded before Flop (didn't bet)
Seat 2: seula i (small blind) folded before Flop
Seat 3: kamikkaze (big blind) folded before Flop
Seat 4: Noviekid collected ($0.60)
Seat 5: 4ydo yogurt folded before Flop (didn't bet)
Seat 6: wtu1986 folded before Flop (didn't bet)
Seat 7: KeLevro0 folded before Flop (didn't bet)
Seat 8: Roglus folded before Flop (didn't bet)
Seat 9: Dejacob folded before Flop (didn't bet)



PokerStars Zoom Hand #84299578626:  Hold'em No Limit ($0.10/$0.25) - 2012/08/05 14:28:56 JST [2012/08/05 1:28:56 ET]
Table 'Whirlpool' 9-max Seat #1 is the button
Seat 1: acamrash ($10.14 in chips) 
Seat 2: wtu1986 ($31.72 in chips) 
Seat 3: DanielWhyte ($39.21 in chips) 
Seat 4: Nerkit ($10.57 in chips) 
Seat 5: chiyuki ($23.38 in chips) 
Seat 6: pef1331 ($29.64 in chips) 
Seat 7: PetitAlejo ($31.61 in chips) 
Seat 8: Loholov ($15 in chips) 
Seat 9: ZhukOFFskI ($24.90 in chips) 
wtu1986: posts small blind $0.10
DanielWhyte: posts big blind $0.25
*** HOLE CARDS ***
Dealt to chiyuki [Td 6d]
Nerkit: folds 
chiyuki: folds 
pef1331: folds 
PetitAlejo: folds 
Loholov: raises $0.50 to $0.75
ZhukOFFskI: folds 
acamrash: raises $1.85 to $2.60
wtu1986: folds 
DanielWhyte: folds 
Loholov: calls $1.85
*** FLOP *** [7s 7h 2c]
Loholov: checks 
acamrash: bets $3.75
Loholov: folds 
Uncalled bet ($3.75) returned to acamrash
acamrash collected $5.30 from pot
acamrash: doesn't show hand 
*** SUMMARY ***
Total pot $5.55 | Rake $0.25 
Board [7s 7h 2c]
Seat 1: acamrash (button) collected ($5.30)
Seat 2: wtu1986 (small blind) folded before Flop
Seat 3: DanielWhyte (big blind) folded before Flop
Seat 4: Nerkit folded before Flop (didn't bet)
Seat 5: chiyuki folded before Flop (didn't bet)
Seat 6: pef1331 folded before Flop (didn't bet)
Seat 7: PetitAlejo folded before Flop (didn't bet)
Seat 8: Loholov folded on the Flop
Seat 9: ZhukOFFskI folded before Flop (didn't bet)



PokerStars Zoom Hand #84299583008:  Hold'em No Limit ($0.10/$0.25) - 2012/08/05 14:29:15 JST [2012/08/05 1:29:15 ET]
Table 'Whirlpool' 9-max Seat #1 is the button
Seat 1: JLajoie ($36.99 in chips) 
Seat 2: cr0lox ($26.15 in chips) 
Seat 3: Perstenev ($10.71 in chips) 
Seat 4: ladymadon107 ($7.63 in chips) 
Seat 5: Feros 99 ($24.15 in chips) 
Seat 6: chiyuki ($23.38 in chips) 
Seat 7: slapshot2011 ($34.91 in chips) 
Seat 8: ZhukOFFskI ($24.90 in chips) 
Seat 9: ygoegoe ($27.16 in chips) 
cr0lox: posts small blind $0.10
Perstenev: posts big blind $0.25
*** HOLE CARDS ***
Dealt to chiyuki [2s As]
ladymadon107: raises $0.25 to $0.50
Feros 99: folds 
chiyuki: folds 
slapshot2011: folds 
ZhukOFFskI: folds 
ygoegoe: folds 
JLajoie: folds 
cr0lox: folds 
Perstenev: folds 
Uncalled bet ($0.25) returned to ladymadon107
ladymadon107 collected $0.60 from pot
ladymadon107: doesn't show hand 
*** SUMMARY ***
Total pot $0.60 | Rake $0 
Seat 1: JLajoie (button) folded before Flop (didn't bet)
Seat 2: cr0lox (small blind) folded before Flop
Seat 3: Perstenev (big blind) folded before Flop
Seat 4: ladymadon107 collected ($0.60)
Seat 5: Feros 99 folded before Flop (didn't bet)
Seat 6: chiyuki folded before Flop (didn't bet)
Seat 7: slapshot2011 folded before Flop (didn't bet)
Seat 8: ZhukOFFskI folded before Flop (didn't bet)
Seat 9: ygoegoe folded before Flop (didn't bet)



PokerStars Zoom Hand #84299584030:  Hold'em No Limit ($0.10/$0.25) - 2012/08/05 14:29:19 JST [2012/08/05 1:29:19 ET]
Table 'Whirlpool' 9-max Seat #1 is the button
Seat 1: cr0lox ($26.05 in chips) 
Seat 2: JLajoie ($36.99 in chips) 
Seat 3: chiyuki ($23.38 in chips) 
Seat 4: deadmoneykid ($22.14 in chips) 
Seat 5: Yogi707 ($13.80 in chips) 
Seat 6: slapshot2011 ($34.91 in chips) 
Seat 7: phate-1up ($26.42 in chips) 
Seat 8: KeLevro0 ($13.27 in chips) 
Seat 9: seula i ($25 in chips) 
JLajoie: posts small blind $0.10
chiyuki: posts big blind $0.25
*** HOLE CARDS ***
Dealt to chiyuki [Tc 8h]
deadmoneykid: folds 
Yogi707: folds 
slapshot2011: folds 
phate-1up: folds 
KeLevro0: folds 
seula i: folds 
cr0lox: folds 
JLajoie: folds 
Uncalled bet ($0.15) returned to chiyuki
chiyuki collected $0.20 from pot
chiyuki: doesn't show hand 
*** SUMMARY ***
Total pot $0.20 | Rake $0 
Seat 1: cr0lox (button) folded before Flop (didn't bet)
Seat 2: JLajoie (small blind) folded before Flop
Seat 3: chiyuki (big blind) collected ($0.20)
Seat 4: deadmoneykid folded before Flop (didn't bet)
Seat 5: Yogi707 folded before Flop (didn't bet)
Seat 6: slapshot2011 folded before Flop (didn't bet)
Seat 7: phate-1up folded before Flop (didn't bet)
Seat 8: KeLevro0 folded before Flop (didn't bet)
Seat 9: seula i folded before Flop (didn't bet)



PokerStars Zoom Hand #84299588966:  Hold'em No Limit ($0.10/$0.25) - 2012/08/05 14:29:39 JST [2012/08/05 1:29:39 ET]
Table 'Whirlpool' 9-max Seat #1 is the button
Seat 1: DanielWhyte ($38.86 in chips) 
Seat 2: Perstenev ($7.77 in chips) 
Seat 3: Spartacus675 ($30.30 in chips) 
Seat 4: PetitAlejo ($52.86 in chips) 
Seat 5: KrystalAA ($12.50 in chips) 
Seat 6: chiyuki ($23.48 in chips) 
Seat 7: Lasutchik ($70.26 in chips) 
Seat 8: Nerkit ($11.84 in chips) 
Seat 9: KeLevro0 ($9.74 in chips) 
Perstenev: posts small blind $0.10
Spartacus675: posts big blind $0.25
*** HOLE CARDS ***
Dealt to chiyuki [2d Jd]
PetitAlejo: folds 
KrystalAA: folds 
chiyuki: folds 
Lasutchik: folds 
Nerkit: folds 
KeLevro0: folds 
DanielWhyte: folds 
Perstenev: folds 
Uncalled bet ($0.15) returned to Spartacus675
Spartacus675 collected $0.20 from pot
Spartacus675: doesn't show hand 
*** SUMMARY ***
Total pot $0.20 | Rake $0 
Seat 1: DanielWhyte (button) folded before Flop (didn't bet)
Seat 2: Perstenev (small blind) folded before Flop
Seat 3: Spartacus675 (big blind) collected ($0.20)
Seat 4: PetitAlejo folded before Flop (didn't bet)
Seat 5: KrystalAA folded before Flop (didn't bet)
Seat 6: chiyuki folded before Flop (didn't bet)
Seat 7: Lasutchik folded before Flop (didn't bet)
Seat 8: Nerkit folded before Flop (didn't bet)
Seat 9: KeLevro0 folded before Flop (didn't bet)



PokerStars Zoom Hand #84299589728:  Hold'em No Limit ($0.10/$0.25) - 2012/08/05 14:29:42 JST [2012/08/05 1:29:42 ET]
Table 'Whirlpool' 9-max Seat #1 is the button
Seat 1: Perstenev ($7.67 in chips) 
Seat 2: Nerkit ($11.84 in chips) 
Seat 3: PetitAlejo ($52.86 in chips) 
Seat 4: yane73 ($14.37 in chips) 
Seat 5: kamikkaze ($15.55 in chips) 
Seat 6: Th3Fog ($67.24 in chips) 
Seat 7: silvno31 ($34.94 in chips) 
Seat 8: deadmoneykid ($26.42 in chips) 
Seat 9: chiyuki ($23.48 in chips) 
Nerkit: posts small blind $0.10
PetitAlejo: posts big blind $0.25
*** HOLE CARDS ***
Dealt to chiyuki [Jh Qs]
yane73: raises $0.50 to $0.75
kamikkaze: folds 
Th3Fog: folds 
silvno31: folds 
deadmoneykid: folds 
chiyuki: folds 
Perstenev: raises $6.92 to $7.67 and is all-in
Nerkit: folds 
PetitAlejo: folds 
yane73: calls $6.92
*** FLOP *** [9h 9c 5d]
*** TURN *** [9h 9c 5d] [6h]
*** RIVER *** [9h 9c 5d 6h] [Ah]
*** SHOW DOWN ***
yane73: shows [Kc Ks] (two pair, Kings and Nines)
Perstenev: shows [Ts Td] (two pair, Tens and Nines)
yane73 collected $14.98 from pot
*** SUMMARY ***
Total pot $15.69 | Rake $0.71 
Board [9h 9c 5d 6h Ah]
Seat 1: Perstenev (button) showed [Ts Td] and lost with two pair, Tens and Nines
Seat 2: Nerkit (small blind) folded before Flop
Seat 3: PetitAlejo (big blind) folded before Flop
Seat 4: yane73 showed [Kc Ks] and won ($14.98) with two pair, Kings and Nines
Seat 5: kamikkaze folded before Flop (didn't bet)
Seat 6: Th3Fog folded before Flop (didn't bet)
Seat 7: silvno31 folded before Flop (didn't bet)
Seat 8: deadmoneykid folded before Flop (didn't bet)
Seat 9: chiyuki folded before Flop (didn't bet)



PokerStars Zoom Hand #84299595229:  Hold'em No Limit ($0.10/$0.25) - 2012/08/05 14:30:04 JST [2012/08/05 1:30:04 ET]
Table 'Whirlpool' 9-max Seat #1 is the button
Seat 1: chiyuki ($23.38 in chips) 
Seat 2: XeriaX ($23.50 in chips) 
Seat 3: KeLevro0 ($13.17 in chips) 
Seat 4: Loholov ($31.43 in chips) 
Seat 5: ZhukOFFskI ($24.65 in chips) 
Seat 6: seula i ($35.61 in chips) 
Seat 7: Ladyteazer ($25.54 in chips) 
Seat 8: 1Karina1 ($26.43 in chips) 
Seat 9: phate-1up ($40.74 in chips) 
XeriaX: posts small blind $0.10
KeLevro0: posts big blind $0.25
*** HOLE CARDS ***
Dealt to chiyuki [2d 8c]
Loholov: folds 
ZhukOFFskI: folds 
seula i: folds 
Ladyteazer: folds 
1Karina1: raises $0.50 to $0.75
phate-1up: folds 
chiyuki: folds 
XeriaX: folds 
KeLevro0: folds 
Uncalled bet ($0.50) returned to 1Karina1
1Karina1 collected $0.60 from pot
1Karina1: doesn't show hand 
*** SUMMARY ***
Total pot $0.60 | Rake $0 
Seat 1: chiyuki (button) folded before Flop (didn't bet)
Seat 2: XeriaX (small blind) folded before Flop
Seat 3: KeLevro0 (big blind) folded before Flop
Seat 4: Loholov folded before Flop (didn't bet)
Seat 5: ZhukOFFskI folded before Flop (didn't bet)
Seat 6: seula i folded before Flop (didn't bet)
Seat 7: Ladyteazer folded before Flop (didn't bet)
Seat 8: 1Karina1 collected ($0.60)
Seat 9: phate-1up folded before Flop (didn't bet)



PokerStars Zoom Hand #84299594219:  Hold'em No Limit ($0.10/$0.25) - 2012/08/05 14:30:00 JST [2012/08/05 1:30:00 ET]
Table 'Whirlpool' 9-max Seat #1 is the button
Seat 1: Dejacob ($48.87 in chips) 
Seat 2: chiyuki ($23.48 in chips) 
Seat 3: softdesign ($68.73 in chips) 
Seat 4: wtu1986 ($30.42 in chips) 
Seat 5: KeLevro0 ($13.17 in chips) 
Seat 6: kamikkaze ($30.10 in chips) 
Seat 7: Alvinpe85 ($50.26 in chips) 
Seat 8: caro196661cv ($28.63 in chips) 
Seat 9: taksist889 ($21.21 in chips) 
chiyuki: posts small blind $0.10
softdesign: posts big blind $0.25
*** HOLE CARDS ***
Dealt to chiyuki [4h 3c]
wtu1986: folds 
KeLevro0: folds 
kamikkaze: folds 
Alvinpe85: folds 
caro196661cv: folds 
taksist889: raises $0.50 to $0.75
Dejacob: folds 
chiyuki: folds 
softdesign: folds 
Uncalled bet ($0.50) returned to taksist889
taksist889 collected $0.60 from pot
taksist889: doesn't show hand 
*** SUMMARY ***
Total pot $0.60 | Rake $0 
Seat 1: Dejacob (button) folded before Flop (didn't bet)
Seat 2: chiyuki (small blind) folded before Flop
Seat 3: softdesign (big blind) folded before Flop
Seat 4: wtu1986 folded before Flop (didn't bet)
Seat 5: KeLevro0 folded before Flop (didn't bet)
Seat 6: kamikkaze folded before Flop (didn't bet)
Seat 7: Alvinpe85 folded before Flop (didn't bet)
Seat 8: caro196661cv folded before Flop (didn't bet)
Seat 9: taksist889 collected ($0.60)



PokerStars Zoom Hand #84299599168:  Hold'em No Limit ($0.10/$0.25) - 2012/08/05 14:30:21 JST [2012/08/05 1:30:21 ET]
Table 'Whirlpool' 9-max Seat #1 is the button
Seat 1: Nerkit ($12.88 in chips) 
Seat 2: yane73 ($21.68 in chips) 
Seat 3: Alvinpe85 ($50.26 in chips) 
Seat 4: ZhukOFFskI ($21.31 in chips) 
Seat 5: seula i ($61.39 in chips) 
Seat 6: johnbaco1209 ($29.21 in chips) 
Seat 7: chiyuki ($23.38 in chips) 
Seat 8: eskeyp ($8.10 in chips) 
Seat 9: KeLevro0 ($9.08 in chips) 
yane73: posts small blind $0.10
Alvinpe85: posts big blind $0.25
*** HOLE CARDS ***
Dealt to chiyuki [4h 9c]
ZhukOFFskI: folds 
seula i: folds 
johnbaco1209: folds 
chiyuki: folds 
eskeyp: folds 
KeLevro0: folds 
Nerkit: folds 
yane73: folds 
Uncalled bet ($0.15) returned to Alvinpe85
Alvinpe85 collected $0.20 from pot
Alvinpe85: doesn't show hand 
*** SUMMARY ***
Total pot $0.20 | Rake $0 
Seat 1: Nerkit (button) folded before Flop (didn't bet)
Seat 2: yane73 (small blind) folded before Flop
Seat 3: Alvinpe85 (big blind) collected ($0.20)
Seat 4: ZhukOFFskI folded before Flop (didn't bet)
Seat 5: seula i folded before Flop (didn't bet)
Seat 6: johnbaco1209 folded before Flop (didn't bet)
Seat 7: chiyuki folded before Flop (didn't bet)
Seat 8: eskeyp folded before Flop (didn't bet)
Seat 9: KeLevro0 folded before Flop (didn't bet)



PokerStars Zoom Hand #84299599936:  Hold'em No Limit ($0.10/$0.25) - 2012/08/05 14:30:24 JST [2012/08/05 1:30:24 ET]
Table 'Whirlpool' 9-max Seat #1 is the button
Seat 1: KrystalAA ($11.65 in chips) 
Seat 2: slapshot2011 ($33.41 in chips) 
Seat 3: Th3Fog ($18.13 in chips) 
Seat 4: chiyuki ($23.38 in chips) 
Seat 5: PetitAlejo ($41.34 in chips) 
Seat 6: Suhoff76 ($25 in chips) 
Seat 7: ygoegoe ($25 in chips) 
Seat 8: bonethugs699 ($31.24 in chips) 
Seat 9: Yogi707 ($12.34 in chips) 
slapshot2011: posts small blind $0.10
Th3Fog: posts big blind $0.25
*** HOLE CARDS ***
Dealt to chiyuki [Qc 8d]
chiyuki: folds 
PetitAlejo: folds 
Suhoff76: folds 
ygoegoe: folds 
bonethugs699: folds 
Yogi707: folds 
KrystalAA: raises $0.46 to $0.71
slapshot2011: folds 
Th3Fog: folds 
Uncalled bet ($0.46) returned to KrystalAA
KrystalAA collected $0.60 from pot
KrystalAA: doesn't show hand 
*** SUMMARY ***
Total pot $0.60 | Rake $0 
Seat 1: KrystalAA (button) collected ($0.60)
Seat 2: slapshot2011 (small blind) folded before Flop
Seat 3: Th3Fog (big blind) folded before Flop
Seat 4: chiyuki folded before Flop (didn't bet)
Seat 5: PetitAlejo folded before Flop (didn't bet)
Seat 6: Suhoff76 folded before Flop (didn't bet)
Seat 7: ygoegoe folded before Flop (didn't bet)
Seat 8: bonethugs699 folded before Flop (didn't bet)
Seat 9: Yogi707 folded before Flop (didn't bet)



PokerStars Zoom Hand #84299596481:  Hold'em No Limit ($0.10/$0.25) - 2012/08/05 14:30:09 JST [2012/08/05 1:30:09 ET]
Table 'Whirlpool' 9-max Seat #1 is the button
Seat 1: PetitAlejo ($41.34 in chips) 
Seat 2: Perstenev ($11.68 in chips) 
Seat 3: Ladyteazer ($25.54 in chips) 
Seat 4: hirozo ($30.42 in chips) 
Seat 5: peng2astic ($21.36 in chips) 
Seat 6: Dan Royal ($29.68 in chips) 
Seat 7: RikkStroken ($12.36 in chips) 
Seat 8: chiyuki ($23.38 in chips) 
Seat 9: Loholov ($15.81 in chips) 
Perstenev: posts small blind $0.10
Ladyteazer: posts big blind $0.25
*** HOLE CARDS ***
Dealt to chiyuki [9c 2h]
hirozo: folds 
peng2astic: calls $0.25
Dan Royal: folds 
RikkStroken: folds 
chiyuki: folds 
Loholov: calls $0.25
PetitAlejo: folds 
Perstenev: folds 
Ladyteazer: checks 
*** FLOP *** [5s 7h 9h]
Ladyteazer: checks 
peng2astic: bets $0.75
Loholov: calls $0.75
Ladyteazer: folds 
*** TURN *** [5s 7h 9h] [Qs]
peng2astic: bets $0.75
Loholov: calls $0.75
*** RIVER *** [5s 7h 9h Qs] [7d]
peng2astic: bets $6.75
Loholov: folds 
Uncalled bet ($6.75) returned to peng2astic
peng2astic collected $3.68 from pot
peng2astic: doesn't show hand 
*** SUMMARY ***
Total pot $3.85 | Rake $0.17 
Board [5s 7h 9h Qs 7d]
Seat 1: PetitAlejo (button) folded before Flop (didn't bet)
Seat 2: Perstenev (small blind) folded before Flop
Seat 3: Ladyteazer (big blind) folded on the Flop
Seat 4: hirozo folded before Flop (didn't bet)
Seat 5: peng2astic collected ($3.68)
Seat 6: Dan Royal folded before Flop (didn't bet)
Seat 7: RikkStroken folded before Flop (didn't bet)
Seat 8: chiyuki folded before Flop (didn't bet)
Seat 9: Loholov folded on the River



PokerStars Zoom Hand #84299603604:  Hold'em No Limit ($0.10/$0.25) - 2012/08/05 14:30:39 JST [2012/08/05 1:30:39 ET]
Table 'Whirlpool' 9-max Seat #1 is the button
Seat 1: KrystalAA ($11.80 in chips) 
Seat 2: Alvinpe85 ($63.48 in chips) 
Seat 3: chiyuki ($23.38 in chips) 
Seat 4: Vahe50 ($20.04 in chips) 
Seat 5: JLajoie ($34.99 in chips) 
Seat 6: seula i ($61.39 in chips) 
Seat 7: Jene4kaBest ($12.27 in chips) 
Seat 8: Th3Fog ($66.89 in chips) 
Seat 9: ygoegoe ($26.91 in chips) 
Alvinpe85: posts small blind $0.10
chiyuki: posts big blind $0.25
*** HOLE CARDS ***
Dealt to chiyuki [4h 3d]
Vahe50: folds 
JLajoie: raises $0.75 to $1
seula i: folds 
Jene4kaBest: folds 
Th3Fog: folds 
ygoegoe: folds 
KrystalAA: folds 
Alvinpe85: folds 
chiyuki: folds 
Uncalled bet ($0.75) returned to JLajoie
JLajoie collected $0.60 from pot
JLajoie: doesn't show hand 
*** SUMMARY ***
Total pot $0.60 | Rake $0 
Seat 1: KrystalAA (button) folded before Flop (didn't bet)
Seat 2: Alvinpe85 (small blind) folded before Flop
Seat 3: chiyuki (big blind) folded before Flop
Seat 4: Vahe50 folded before Flop (didn't bet)
Seat 5: JLajoie collected ($0.60)
Seat 6: seula i folded before Flop (didn't bet)
Seat 7: Jene4kaBest folded before Flop (didn't bet)
Seat 8: Th3Fog folded before Flop (didn't bet)
Seat 9: ygoegoe folded before Flop (didn't bet)



PokerStars Zoom Hand #84299601166:  Hold'em No Limit ($0.10/$0.25) - 2012/08/05 14:30:29 JST [2012/08/05 1:30:29 ET]
Table 'Whirlpool' 9-max Seat #1 is the button
Seat 1: slapshot2011 ($33.31 in chips) 
Seat 2: BlOnDhOlIc ($86.78 in chips) 
Seat 3: ZhukOFFskI ($24.55 in chips) 
Seat 4: bonethugs699 ($31.24 in chips) 
Seat 5: chiyuki ($23.38 in chips) 
Seat 6: eskeyp ($8.10 in chips) 
Seat 7: pef1331 ($28.54 in chips) 
Seat 8: Dejacob ($30.73 in chips) 
Seat 9: PetitAlejo ($31.41 in chips) 
BlOnDhOlIc: posts small blind $0.10
ZhukOFFskI: posts big blind $0.25
*** HOLE CARDS ***
Dealt to chiyuki [7h Qh]
bonethugs699: folds 
chiyuki: folds 
eskeyp: folds 
pef1331: folds 
Dejacob: folds 
PetitAlejo: folds 
slapshot2011: calls $0.25
BlOnDhOlIc: folds 
ZhukOFFskI: checks 
*** FLOP *** [4d 2h 9h]
ZhukOFFskI: checks 
slapshot2011: bets $0.75
ZhukOFFskI: folds 
Uncalled bet ($0.75) returned to slapshot2011
slapshot2011 collected $0.57 from pot
slapshot2011: doesn't show hand 
*** SUMMARY ***
Total pot $0.60 | Rake $0.03 
Board [4d 2h 9h]
Seat 1: slapshot2011 (button) collected ($0.57)
Seat 2: BlOnDhOlIc (small blind) folded before Flop
Seat 3: ZhukOFFskI (big blind) folded on the Flop
Seat 4: bonethugs699 folded before Flop (didn't bet)
Seat 5: chiyuki folded before Flop (didn't bet)
Seat 6: eskeyp folded before Flop (didn't bet)
Seat 7: pef1331 folded before Flop (didn't bet)
Seat 8: Dejacob folded before Flop (didn't bet)
Seat 9: PetitAlejo folded before Flop (didn't bet)



PokerStars Zoom Hand #84299610564:  Hold'em No Limit ($0.10/$0.25) - 2012/08/05 14:31:07 JST [2012/08/05 1:31:07 ET]
Table 'Whirlpool' 9-max Seat #1 is the button
Seat 1: Perstenev ($12.65 in chips) 
Seat 2: chiyuki ($23.13 in chips) 
Seat 3: cofla tito ($12.65 in chips) 
Seat 4: Roglus ($1.30 in chips) 
Seat 5: kamikkaze ($17.38 in chips) 
Seat 6: Dejacob ($48.52 in chips) 
Seat 7: Vahe50 ($26.61 in chips) 
Seat 8: slapshot2011 ($33.63 in chips) 
Seat 9: softdesign ($73.35 in chips) 
chiyuki: posts small blind $0.10
cofla tito: posts big blind $0.25
*** HOLE CARDS ***
Dealt to chiyuki [Qs 7h]
Roglus: raises $1.05 to $1.30 and is all-in
kamikkaze: folds 
Dejacob: folds 
Vahe50: folds 
slapshot2011: folds 
softdesign: folds 
Perstenev: folds 
chiyuki: folds 
cofla tito: folds 
Uncalled bet ($1.05) returned to Roglus
Roglus collected $0.60 from pot
Roglus: doesn't show hand 
*** SUMMARY ***
Total pot $0.60 | Rake $0 
Seat 1: Perstenev (button) folded before Flop (didn't bet)
Seat 2: chiyuki (small blind) folded before Flop
Seat 3: cofla tito (big blind) folded before Flop
Seat 4: Roglus collected ($0.60)
Seat 5: kamikkaze folded before Flop (didn't bet)
Seat 6: Dejacob folded before Flop (didn't bet)
Seat 7: Vahe50 folded before Flop (didn't bet)
Seat 8: slapshot2011 folded before Flop (didn't bet)
Seat 9: softdesign folded before Flop (didn't bet)



PokerStars Zoom Hand #84299602378:  Hold'em No Limit ($0.10/$0.25) - 2012/08/05 14:30:34 JST [2012/08/05 1:30:34 ET]
Table 'Whirlpool' 9-max Seat #1 is the button
Seat 1: troms20 ($31.14 in chips) 
Seat 2: Dejacob ($48.87 in chips) 
Seat 3: fuguangps ($25 in chips) 
Seat 4: chiyuki ($23.38 in chips) 
Seat 5: phate-1up ($40.74 in chips) 
Seat 6: Perstenev ($8.46 in chips) 
Seat 7: johnbaco1209 ($29.21 in chips) 
Seat 8: seula i ($34.79 in chips) 
Seat 9: Nerkit ($12.88 in chips) 
Dejacob: posts small blind $0.10
fuguangps: posts big blind $0.25
*** HOLE CARDS ***
Dealt to chiyuki [3s 7h]
chiyuki: folds 
phate-1up: folds 
Perstenev: folds 
johnbaco1209: raises $0.50 to $0.75
seula i: raises $1.75 to $2.50
Nerkit: calls $2.50
troms20: raises $5 to $7.50
Dejacob: folds 
fuguangps: folds 
johnbaco1209: folds 
seula i: folds 
Nerkit: raises $5.38 to $12.88 and is all-in
troms20: calls $5.38
*** FLOP *** [9s 4h Js]
*** TURN *** [9s 4h Js] [8c]
*** RIVER *** [9s 4h Js 8c] [5c]
*** SHOW DOWN ***
Nerkit: shows [Ad Ah] (a pair of Aces)
troms20: shows [Kd Ks] (a pair of Kings)
Nerkit collected $28.04 from pot
*** SUMMARY ***
Total pot $29.36 | Rake $1.32 
Board [9s 4h Js 8c 5c]
Seat 1: troms20 (button) showed [Kd Ks] and lost with a pair of Kings
Seat 2: Dejacob (small blind) folded before Flop
Seat 3: fuguangps (big blind) folded before Flop
Seat 4: chiyuki folded before Flop (didn't bet)
Seat 5: phate-1up folded before Flop (didn't bet)
Seat 6: Perstenev folded before Flop (didn't bet)
Seat 7: johnbaco1209 folded before Flop
Seat 8: seula i folded before Flop
Seat 9: Nerkit showed [Ad Ah] and won ($28.04) with a pair of Aces



PokerStars Zoom Hand #84299608267:  Hold'em No Limit ($0.10/$0.25) - 2012/08/05 14:30:58 JST [2012/08/05 1:30:58 ET]
Table 'Whirlpool' 9-max Seat #1 is the button
Seat 1: Loholov ($15 in chips) 
Seat 2: caro196661cv ($28.38 in chips) 
Seat 3: BlOnDhOlIc ($25 in chips) 
Seat 4: simonzez ($52.19 in chips) 
Seat 5: fuguangps ($25 in chips) 
Seat 6: puffy5533 ($25.29 in chips) 
Seat 7: chiyuki ($23.13 in chips) 
Seat 8: 4ydo yogurt ($11.66 in chips) 
Seat 9: PetitAlejo ($52.16 in chips) 
caro196661cv: posts small blind $0.10
BlOnDhOlIc: posts big blind $0.25
*** HOLE CARDS ***
Dealt to chiyuki [8d Ac]
simonzez: calls $0.25
fuguangps: folds 
puffy5533: folds 
chiyuki: folds 
4ydo yogurt: raises $0.25 to $0.50
PetitAlejo: folds 
Loholov: calls $0.50
caro196661cv: folds 
BlOnDhOlIc: folds 
simonzez: calls $0.25
*** FLOP *** [Qh Qc 3c]
simonzez: checks 
4ydo yogurt: checks 
Loholov: checks 
*** TURN *** [Qh Qc 3c] [5c]
simonzez: checks 
4ydo yogurt: bets $0.80
Loholov: folds 
simonzez: calls $0.80
*** RIVER *** [Qh Qc 3c 5c] [8h]
simonzez: bets $2.50
4ydo yogurt: folds 
Uncalled bet ($2.50) returned to simonzez
simonzez collected $3.29 from pot
simonzez: doesn't show hand 
*** SUMMARY ***
Total pot $3.45 | Rake $0.16 
Board [Qh Qc 3c 5c 8h]
Seat 1: Loholov (button) folded on the Turn
Seat 2: caro196661cv (small blind) folded before Flop
Seat 3: BlOnDhOlIc (big blind) folded before Flop
Seat 4: simonzez collected ($3.29)
Seat 5: fuguangps folded before Flop (didn't bet)
Seat 6: puffy5533 folded before Flop (didn't bet)
Seat 7: chiyuki folded before Flop (didn't bet)
Seat 8: 4ydo yogurt folded on the River
Seat 9: PetitAlejo folded before Flop (didn't bet)



PokerStars Zoom Hand #84299615179:  Hold'em No Limit ($0.10/$0.25) - 2012/08/05 14:31:26 JST [2012/08/05 1:31:26 ET]
Table 'Whirlpool' 9-max Seat #1 is the button
Seat 1: chiyuki ($23.03 in chips) 
Seat 2: deadmoneykid ($25.53 in chips) 
Seat 3: Lasutchik ($11.65 in chips) 
Seat 4: Vahe50 ($26.61 in chips) 
Seat 5: BlOnDhOlIc ($25 in chips) 
Seat 6: phate-1up ($34.07 in chips) 
Seat 7: znake77 ($3.11 in chips) 
Seat 8: KeLevro0 ($10.49 in chips) 
Seat 9: KrystalAA ($12.50 in chips) 
deadmoneykid: posts small blind $0.10
Lasutchik: posts big blind $0.25
*** HOLE CARDS ***
Dealt to chiyuki [Ks 6h]
Vahe50: folds 
BlOnDhOlIc: folds 
phate-1up: folds 
znake77: folds 
KeLevro0: folds 
KrystalAA: folds 
chiyuki: folds 
deadmoneykid: folds 
Uncalled bet ($0.15) returned to Lasutchik
Lasutchik collected $0.20 from pot
Lasutchik: doesn't show hand 
*** SUMMARY ***
Total pot $0.20 | Rake $0 
Seat 1: chiyuki (button) folded before Flop (didn't bet)
Seat 2: deadmoneykid (small blind) folded before Flop
Seat 3: Lasutchik (big blind) collected ($0.20)
Seat 4: Vahe50 folded before Flop (didn't bet)
Seat 5: BlOnDhOlIc folded before Flop (didn't bet)
Seat 6: phate-1up folded before Flop (didn't bet)
Seat 7: znake77 folded before Flop (didn't bet)
Seat 8: KeLevro0 folded before Flop (didn't bet)
Seat 9: KrystalAA folded before Flop (didn't bet)



PokerStars Zoom Hand #84299616465:  Hold'em No Limit ($0.10/$0.25) - 2012/08/05 14:31:31 JST [2012/08/05 1:31:31 ET]
Table 'Whirlpool' 9-max Seat #1 is the button
Seat 1: znake77 ($3.11 in chips) 
Seat 2: stalkerec ($12 in chips) 
Seat 3: wtu1986 ($25.70 in chips) 
Seat 4: troms20 ($18.26 in chips) 
Seat 5: johnbaco1209 ($28.46 in chips) 
Seat 6: Nerkit ($28.04 in chips) 
Seat 7: phate-1up ($27.47 in chips) 
Seat 8: chiyuki ($23.03 in chips) 
Seat 9: el pore 5 ($17.91 in chips) 
stalkerec: posts small blind $0.10
wtu1986: posts big blind $0.25
*** HOLE CARDS ***
Dealt to chiyuki [Ac Tc]
troms20: folds 
johnbaco1209: folds 
Nerkit: folds 
phate-1up: raises $0.50 to $0.75
chiyuki: folds 
el pore 5: folds 
znake77: folds 
stalkerec: folds 
wtu1986: folds 
Uncalled bet ($0.50) returned to phate-1up
phate-1up collected $0.60 from pot
phate-1up: doesn't show hand 
*** SUMMARY ***
Total pot $0.60 | Rake $0 
Seat 1: znake77 (button) folded before Flop (didn't bet)
Seat 2: stalkerec (small blind) folded before Flop
Seat 3: wtu1986 (big blind) folded before Flop
Seat 4: troms20 folded before Flop (didn't bet)
Seat 5: johnbaco1209 folded before Flop (didn't bet)
Seat 6: Nerkit folded before Flop (didn't bet)
Seat 7: phate-1up collected ($0.60)
Seat 8: chiyuki folded before Flop (didn't bet)
Seat 9: el pore 5 folded before Flop (didn't bet)



PokerStars Zoom Hand #84299609571:  Hold'em No Limit ($0.10/$0.25) - 2012/08/05 14:31:03 JST [2012/08/05 1:31:03 ET]
Table 'Whirlpool' 9-max Seat #1 is the button
Seat 1: ZhukOFFskI ($22.16 in chips) 
Seat 2: fuguangps ($25 in chips) 
Seat 3: DanielWhyte ($38.51 in chips) 
Seat 4: wtu1986 ($25.25 in chips) 
Seat 5: Perstenev ($11.23 in chips) 
Seat 6: pef1331 ($28.19 in chips) 
Seat 7: kamikkaze ($17.38 in chips) 
Seat 8: Th3Fog ($49.98 in chips) 
Seat 9: chiyuki ($23.13 in chips) 
fuguangps: posts small blind $0.10
DanielWhyte: posts big blind $0.25
*** HOLE CARDS ***
Dealt to chiyuki [7c 3s]
wtu1986: folds 
Perstenev: folds 
pef1331: folds 
kamikkaze: folds 
Th3Fog: folds 
chiyuki: folds 
ZhukOFFskI: raises $0.50 to $0.75
fuguangps: raises $1.50 to $2.25
DanielWhyte: folds 
ZhukOFFskI: calls $1.50
*** FLOP *** [7d 9s 8c]
fuguangps: bets $3
ZhukOFFskI: calls $3
*** TURN *** [7d 9s 8c] [4c]
fuguangps: bets $4.75
ZhukOFFskI: folds 
Uncalled bet ($4.75) returned to fuguangps
fuguangps collected $10.27 from pot
fuguangps: doesn't show hand 
*** SUMMARY ***
Total pot $10.75 | Rake $0.48 
Board [7d 9s 8c 4c]
Seat 1: ZhukOFFskI (button) folded on the Turn
Seat 2: fuguangps (small blind) collected ($10.27)
Seat 3: DanielWhyte (big blind) folded before Flop
Seat 4: wtu1986 folded before Flop (didn't bet)
Seat 5: Perstenev folded before Flop (didn't bet)
Seat 6: pef1331 folded before Flop (didn't bet)
Seat 7: kamikkaze folded before Flop (didn't bet)
Seat 8: Th3Fog folded before Flop (didn't bet)
Seat 9: chiyuki folded before Flop (didn't bet)



PokerStars Zoom Hand #84299621348:  Hold'em No Limit ($0.10/$0.25) - 2012/08/05 14:31:52 JST [2012/08/05 1:31:52 ET]
Table 'Whirlpool' 9-max Seat #1 is the button
Seat 1: wtu1986 ($25.45 in chips) 
Seat 2: Vahe50 ($26.71 in chips) 
Seat 3: hl77777 ($12.50 in chips) 
Seat 4: Loholov ($15 in chips) 
Seat 5: chiyuki ($23.03 in chips) 
Seat 6: ChrisCDee ($23.96 in chips) 
Seat 7: yane73 ($21.88 in chips) 
Seat 8: phate-1up ($33.97 in chips) 
Seat 9: kamikkaze ($15 in chips) 
Vahe50: posts small blind $0.10
hl77777: posts big blind $0.25
*** HOLE CARDS ***
Dealt to chiyuki [3h Qd]
Loholov: folds 
chiyuki: folds 
ChrisCDee: folds 
yane73: raises $0.25 to $0.50
phate-1up: folds 
kamikkaze: folds 
wtu1986: folds 
Vahe50: folds 
hl77777: folds 
Uncalled bet ($0.25) returned to yane73
yane73 collected $0.60 from pot
yane73: doesn't show hand 
*** SUMMARY ***
Total pot $0.60 | Rake $0 
Seat 1: wtu1986 (button) folded before Flop (didn't bet)
Seat 2: Vahe50 (small blind) folded before Flop
Seat 3: hl77777 (big blind) folded before Flop
Seat 4: Loholov folded before Flop (didn't bet)
Seat 5: chiyuki folded before Flop (didn't bet)
Seat 6: ChrisCDee folded before Flop (didn't bet)
Seat 7: yane73 collected ($0.60)
Seat 8: phate-1up folded before Flop (didn't bet)
Seat 9: kamikkaze folded before Flop (didn't bet)



PokerStars Zoom Hand #84299620603:  Hold'em No Limit ($0.10/$0.25) - 2012/08/05 14:31:49 JST [2012/08/05 1:31:49 ET]
Table 'Whirlpool' 9-max Seat #1 is the button
Seat 1: Spartacus675 ($34.51 in chips) 
Seat 2: BlOnDhOlIc ($86.43 in chips) 
Seat 3: KrystalAA ($12.50 in chips) 
Seat 4: seula i ($32.29 in chips) 
Seat 5: RikkStroken ($81.04 in chips) 
Seat 6: chiyuki ($23.03 in chips) 
Seat 7: ZhukOFFskI ($24.30 in chips) 
Seat 8: Dan Royal ($31.61 in chips) 
Seat 9: Alvinpe85 ($64.04 in chips) 
BlOnDhOlIc: posts small blind $0.10
KrystalAA: posts big blind $0.25
*** HOLE CARDS ***
Dealt to chiyuki [Qc 8d]
seula i: folds 
RikkStroken: folds 
chiyuki: folds 
ZhukOFFskI: folds 
Dan Royal: folds 
Alvinpe85: folds 
Spartacus675: folds 
BlOnDhOlIc: raises $0.25 to $0.50
KrystalAA: calls $0.25
*** FLOP *** [Ts Kc 9h]
BlOnDhOlIc: bets $0.48
KrystalAA: calls $0.48
*** TURN *** [Ts Kc 9h] [2s]
BlOnDhOlIc: checks 
KrystalAA: checks 
*** RIVER *** [Ts Kc 9h 2s] [Ks]
BlOnDhOlIc: checks 
KrystalAA: checks 
*** SHOW DOWN ***
BlOnDhOlIc: shows [3d 2d] (two pair, Kings and Deuces)
KrystalAA: shows [8h Th] (two pair, Kings and Tens)
KrystalAA collected $1.87 from pot
*** SUMMARY ***
Total pot $1.96 | Rake $0.09 
Board [Ts Kc 9h 2s Ks]
Seat 1: Spartacus675 (button) folded before Flop (didn't bet)
Seat 2: BlOnDhOlIc (small blind) showed [3d 2d] and lost with two pair, Kings and Deuces
Seat 3: KrystalAA (big blind) showed [8h Th] and won ($1.87) with two pair, Kings and Tens
Seat 4: seula i folded before Flop (didn't bet)
Seat 5: RikkStroken folded before Flop (didn't bet)
Seat 6: chiyuki folded before Flop (didn't bet)
Seat 7: ZhukOFFskI folded before Flop (didn't bet)
Seat 8: Dan Royal folded before Flop (didn't bet)
Seat 9: Alvinpe85 folded before Flop (didn't bet)



PokerStars Zoom Hand #84299623516:  Hold'em No Limit ($0.10/$0.25) - 2012/08/05 14:32:01 JST [2012/08/05 1:32:01 ET]
Table 'Whirlpool' 9-max Seat #1 is the button
Seat 1: Dejacob ($36.16 in chips) 
Seat 2: Suhoff76 ($31.91 in chips) 
Seat 3: chiyuki ($23.03 in chips) 
Seat 4: pef1331 ($25 in chips) 
Seat 5: JLajoie ($24.55 in chips) 
Seat 6: 4plankton ($19.77 in chips) 
Seat 7: Nerkit ($11.24 in chips) 
Seat 8: troms20 ($20.33 in chips) 
Seat 9: phate-1up ($26.71 in chips) 
Suhoff76: posts small blind $0.10
chiyuki: posts big blind $0.25
*** HOLE CARDS ***
Dealt to chiyuki [3c 4d]
pef1331: raises $0.75 to $1
JLajoie: folds 
4plankton: folds 
Nerkit: folds 
troms20: calls $1
phate-1up: folds 
Dejacob: folds 
Suhoff76: folds 
chiyuki: folds 
*** FLOP *** [9h 8h Jh]
pef1331: checks 
troms20: checks 
*** TURN *** [9h 8h Jh] [8c]
pef1331: checks 
troms20: checks 
*** RIVER *** [9h 8h Jh 8c] [Ah]
pef1331: checks 
troms20: checks 
*** SHOW DOWN ***
pef1331: shows [6c 6d] (two pair, Eights and Sixes)
troms20: shows [7d 7s] (two pair, Eights and Sevens)
troms20 collected $2.24 from pot
*** SUMMARY ***
Total pot $2.35 | Rake $0.11 
Board [9h 8h Jh 8c Ah]
Seat 1: Dejacob (button) folded before Flop (didn't bet)
Seat 2: Suhoff76 (small blind) folded before Flop
Seat 3: chiyuki (big blind) folded before Flop
Seat 4: pef1331 showed [6c 6d] and lost with two pair, Eights and Sixes
Seat 5: JLajoie folded before Flop (didn't bet)
Seat 6: 4plankton folded before Flop (didn't bet)
Seat 7: Nerkit folded before Flop (didn't bet)
Seat 8: troms20 showed [7d 7s] and won ($2.24) with two pair, Eights and Sevens
Seat 9: phate-1up folded before Flop (didn't bet)



PokerStars Zoom Hand #84299626315:  Hold'em No Limit ($0.10/$0.25) - 2012/08/05 14:32:12 JST [2012/08/05 1:32:12 ET]
Table 'Whirlpool' 9-max Seat #1 is the button
Seat 1: cofla tito ($11.65 in chips) 
Seat 2: hl77777 ($12.25 in chips) 
Seat 3: RikkStroken ($80.94 in chips) 
Seat 4: Suhoff76 ($26.95 in chips) 
Seat 5: chiyuki ($22.78 in chips) 
Seat 6: fuguangps ($25 in chips) 
Seat 7: KeLevro0 ($9.74 in chips) 
Seat 8: KrystalAA ($12.70 in chips) 
Seat 9: WARIBANA7777 ($17.23 in chips) 
hl77777: posts small blind $0.10
RikkStroken: posts big blind $0.25
*** HOLE CARDS ***
Dealt to chiyuki [Ah 2s]
Suhoff76: folds 
chiyuki: folds 
fuguangps: folds 
KeLevro0: raises $0.42 to $0.67
KrystalAA: folds 
WARIBANA7777: folds 
cofla tito: folds 
hl77777: folds 
RikkStroken: calls $0.42
*** FLOP *** [4d 9s 3d]
RikkStroken: checks 
KeLevro0: bets $0.77
RikkStroken: folds 
Uncalled bet ($0.77) returned to KeLevro0
KeLevro0 collected $1.38 from pot
KeLevro0: doesn't show hand 
*** SUMMARY ***
Total pot $1.44 | Rake $0.06 
Board [4d 9s 3d]
Seat 1: cofla tito (button) folded before Flop (didn't bet)
Seat 2: hl77777 (small blind) folded before Flop
Seat 3: RikkStroken (big blind) folded on the Flop
Seat 4: Suhoff76 folded before Flop (didn't bet)
Seat 5: chiyuki folded before Flop (didn't bet)
Seat 6: fuguangps folded before Flop (didn't bet)
Seat 7: KeLevro0 collected ($1.38)
Seat 8: KrystalAA folded before Flop (didn't bet)
Seat 9: WARIBANA7777 folded before Flop (didn't bet)



PokerStars Zoom Hand #84299629282:  Hold'em No Limit ($0.10/$0.25) - 2012/08/05 14:32:24 JST [2012/08/05 1:32:24 ET]
Table 'Whirlpool' 9-max Seat #1 is the button
Seat 1: Jene4kaBest ($13.02 in chips) 
Seat 2: Th3Fog ($50.33 in chips) 
Seat 3: Alvinpe85 ($64.04 in chips) 
Seat 4: BlOnDhOlIc ($84.48 in chips) 
Seat 5: phate-1up ($27.72 in chips) 
Seat 6: KeLevro0 ($10.10 in chips) 
Seat 7: Suhoff76 ($25 in chips) 
Seat 8: wtu1986 ($30.07 in chips) 
Seat 9: chiyuki ($22.68 in chips) 
Th3Fog: posts small blind $0.10
Alvinpe85: posts big blind $0.25
*** HOLE CARDS ***
Dealt to chiyuki [6s 3d]
BlOnDhOlIc: folds 
phate-1up: folds 
KeLevro0: folds 
Suhoff76: folds 
wtu1986: folds 
chiyuki: folds 
Jene4kaBest: folds 
Th3Fog: raises $0.25 to $0.50
Alvinpe85: calls $0.25
*** FLOP *** [9c 5d 4d]
Th3Fog: bets $0.42
Alvinpe85: calls $0.42
*** TURN *** [9c 5d 4d] [Qh]
Th3Fog: checks 
Alvinpe85: bets $1
Th3Fog: folds 
Uncalled bet ($1) returned to Alvinpe85
Alvinpe85 collected $1.76 from pot
Alvinpe85: doesn't show hand 
*** SUMMARY ***
Total pot $1.84 | Rake $0.08 
Board [9c 5d 4d Qh]
Seat 1: Jene4kaBest (button) folded before Flop (didn't bet)
Seat 2: Th3Fog (small blind) folded on the Turn
Seat 3: Alvinpe85 (big blind) collected ($1.76)
Seat 4: BlOnDhOlIc folded before Flop (didn't bet)
Seat 5: phate-1up folded before Flop (didn't bet)
Seat 6: KeLevro0 folded before Flop (didn't bet)
Seat 7: Suhoff76 folded before Flop (didn't bet)
Seat 8: wtu1986 folded before Flop (didn't bet)
Seat 9: chiyuki folded before Flop (didn't bet)



PokerStars Zoom Hand #84299637190:  Hold'em No Limit ($0.10/$0.25) - 2012/08/05 14:32:57 JST [2012/08/05 1:32:57 ET]
Table 'Whirlpool' 9-max Seat #1 is the button
Seat 1: laurentzu84 ($25 in chips) 
Seat 2: WARIBANA7777 ($16.98 in chips) 
Seat 3: cr0lox ($26.02 in chips) 
Seat 4: troms20 ($49.15 in chips) 
Seat 5: loca-loca888 ($47.58 in chips) 
Seat 6: chiyuki ($22.68 in chips) 
Seat 7: Dejacob ($35.66 in chips) 
Seat 8: seula i ($28.88 in chips) 
Seat 9: JLajoie ($36.48 in chips) 
WARIBANA7777: posts small blind $0.10
cr0lox: posts big blind $0.25
*** HOLE CARDS ***
Dealt to chiyuki [Jd 8c]
troms20: folds 
loca-loca888: raises $0.35 to $0.60
chiyuki: folds 
Dejacob: folds 
seula i: folds 
JLajoie: folds 
laurentzu84: folds 
WARIBANA7777: folds 
cr0lox: folds 
Uncalled bet ($0.35) returned to loca-loca888
loca-loca888 collected $0.60 from pot
loca-loca888: doesn't show hand 
*** SUMMARY ***
Total pot $0.60 | Rake $0 
Seat 1: laurentzu84 (button) folded before Flop (didn't bet)
Seat 2: WARIBANA7777 (small blind) folded before Flop
Seat 3: cr0lox (big blind) folded before Flop
Seat 4: troms20 folded before Flop (didn't bet)
Seat 5: loca-loca888 collected ($0.60)
Seat 6: chiyuki folded before Flop (didn't bet)
Seat 7: Dejacob folded before Flop (didn't bet)
Seat 8: seula i folded before Flop (didn't bet)
Seat 9: JLajoie folded before Flop (didn't bet)



PokerStars Zoom Hand #84299625281:  Hold'em No Limit ($0.10/$0.25) - 2012/08/05 14:32:08 JST [2012/08/05 1:32:08 ET]
Table 'Whirlpool' 9-max Seat #1 is the button
Seat 1: stalkerec ($11.25 in chips) 
Seat 2: Lasutchik ($11.75 in chips) 
Seat 3: Feros 99 ($22.70 in chips) 
Seat 4: chiyuki ($22.78 in chips) 
Seat 5: Perstenev ($7.11 in chips) 
Seat 6: hl77777 ($12.25 in chips) 
Seat 7: Suhoff76 ($26.37 in chips) 
Seat 8: Dejacob ($28.54 in chips) 
Seat 9: AlfredE525 ($13.68 in chips) 
Lasutchik: posts small blind $0.10
Feros 99: posts big blind $0.25
*** HOLE CARDS ***
Dealt to chiyuki [5s Th]
chiyuki: folds 
Perstenev: folds 
hl77777: folds 
Suhoff76: folds 
Dejacob: folds 
AlfredE525: folds 
stalkerec: folds 
Lasutchik: calls $0.15
Feros 99: raises $0.50 to $0.75
Lasutchik: raises $11 to $11.75 and is all-in
Feros 99: calls $11
*** FLOP *** [6c Ts 2c]
*** TURN *** [6c Ts 2c] [Qs]
*** RIVER *** [6c Ts 2c Qs] [Jd]
*** SHOW DOWN ***
Lasutchik: shows [9d 9s] (a pair of Nines)
Feros 99: shows [Kc As] (a straight, Ten to Ace)
Feros 99 collected $22.44 from pot
*** SUMMARY ***
Total pot $23.50 | Rake $1.06 
Board [6c Ts 2c Qs Jd]
Seat 1: stalkerec (button) folded before Flop (didn't bet)
Seat 2: Lasutchik (small blind) showed [9d 9s] and lost with a pair of Nines
Seat 3: Feros 99 (big blind) showed [Kc As] and won ($22.44) with a straight, Ten to Ace
Seat 4: chiyuki folded before Flop (didn't bet)
Seat 5: Perstenev folded before Flop (didn't bet)
Seat 6: hl77777 folded before Flop (didn't bet)
Seat 7: Suhoff76 folded before Flop (didn't bet)
Seat 8: Dejacob folded before Flop (didn't bet)
Seat 9: AlfredE525 folded before Flop (didn't bet)



PokerStars Zoom Hand #84299628320:  Hold'em No Limit ($0.10/$0.25) - 2012/08/05 14:32:20 JST [2012/08/05 1:32:20 ET]
Table 'Whirlpool' 9-max Seat #1 is the button
Seat 1: Noviekid ($87.75 in chips) 
Seat 2: taksist889 ($20.81 in chips) 
Seat 3: fuguangps ($25 in chips) 
Seat 4: 1Karina1 ($25.35 in chips) 
Seat 5: cr0lox ($26.02 in chips) 
Seat 6: cofla tito ($11.65 in chips) 
Seat 7: chiyuki ($22.68 in chips) 
Seat 8: ZhukOFFskI ($16.81 in chips) 
Seat 9: bonethugs699 ($32.46 in chips) 
taksist889: posts small blind $0.10
fuguangps: posts big blind $0.25
*** HOLE CARDS ***
Dealt to chiyuki [3d Jh]
1Karina1: folds 
cr0lox: folds 
cofla tito: raises $0.25 to $0.50
chiyuki: folds 
ZhukOFFskI: folds 
bonethugs699: calls $0.50
Noviekid: folds 
taksist889: calls $0.40
fuguangps: folds 
*** FLOP *** [3s 8h Qc]
taksist889: checks 
cofla tito: checks 
bonethugs699: bets $1.55
taksist889: folds 
cofla tito: folds 
Uncalled bet ($1.55) returned to bonethugs699
bonethugs699 collected $1.67 from pot
bonethugs699: doesn't show hand 
*** SUMMARY ***
Total pot $1.75 | Rake $0.08 
Board [3s 8h Qc]
Seat 1: Noviekid (button) folded before Flop (didn't bet)
Seat 2: taksist889 (small blind) folded on the Flop
Seat 3: fuguangps (big blind) folded before Flop
Seat 4: 1Karina1 folded before Flop (didn't bet)
Seat 5: cr0lox folded before Flop (didn't bet)
Seat 6: cofla tito folded on the Flop
Seat 7: chiyuki folded before Flop (didn't bet)
Seat 8: ZhukOFFskI folded before Flop (didn't bet)
Seat 9: bonethugs699 collected ($1.67)



PokerStars Zoom Hand #84299634039:  Hold'em No Limit ($0.10/$0.25) - 2012/08/05 14:32:43 JST [2012/08/05 1:32:43 ET]
Table 'Whirlpool' 9-max Seat #1 is the button
Seat 1: RikkStroken ($14.86 in chips) 
Seat 2: Ellen1947 ($33.07 in chips) 
Seat 3: znake77 ($2.39 in chips) 
Seat 4: fuguangps ($25 in chips) 
Seat 5: PillZ86 ($4.92 in chips) 
Seat 6: WARIBANA7777 ($16.98 in chips) 
Seat 7: seula i ($28.88 in chips) 
Seat 8: chiyuki ($22.68 in chips) 
Seat 9: XeriaX ($27.26 in chips) 
Ellen1947: posts small blind $0.10
znake77: posts big blind $0.25
*** HOLE CARDS ***
Dealt to chiyuki [Ah 9c]
fuguangps: folds 
PillZ86: raises $0.25 to $0.50
WARIBANA7777: folds 
seula i: folds 
chiyuki: folds 
XeriaX: folds 
RikkStroken: raises $1.50 to $2
Ellen1947: folds 
znake77: folds 
PillZ86: folds 
Uncalled bet ($1.50) returned to RikkStroken
RikkStroken collected $1.35 from pot
RikkStroken: doesn't show hand 
*** SUMMARY ***
Total pot $1.35 | Rake $0 
Seat 1: RikkStroken (button) collected ($1.35)
Seat 2: Ellen1947 (small blind) folded before Flop
Seat 3: znake77 (big blind) folded before Flop
Seat 4: fuguangps folded before Flop (didn't bet)
Seat 5: PillZ86 folded before Flop
Seat 6: WARIBANA7777 folded before Flop (didn't bet)
Seat 7: seula i folded before Flop (didn't bet)
Seat 8: chiyuki folded before Flop (didn't bet)
Seat 9: XeriaX folded before Flop (didn't bet)



PokerStars Zoom Hand #84299632049:  Hold'em No Limit ($0.10/$0.25) - 2012/08/05 14:32:35 JST [2012/08/05 1:32:35 ET]
Table 'Whirlpool' 9-max Seat #1 is the button
Seat 1: chiyuki ($22.68 in chips) 
Seat 2: AlfredE525 ($15.03 in chips) 
Seat 3: BlOnDhOlIc ($84.48 in chips) 
Seat 4: ZhukOFFskI ($24.05 in chips) 
Seat 5: Perstenev ($11.65 in chips) 
Seat 6: loca-loca888 ($47.83 in chips) 
Seat 7: znake77 ($2.39 in chips) 
Seat 8: Loholov ($15.10 in chips) 
Seat 9: ChrisCDee ($64.51 in chips) 
AlfredE525: posts small blind $0.10
BlOnDhOlIc: posts big blind $0.25
*** HOLE CARDS ***
Dealt to chiyuki [9d 3s]
ZhukOFFskI: folds 
Perstenev: calls $0.25
loca-loca888: calls $0.25
znake77: folds 
Loholov: folds 
ChrisCDee: raises $1.25 to $1.50
chiyuki: folds 
AlfredE525: calls $1.40
BlOnDhOlIc: folds 
Perstenev: calls $1.25
loca-loca888: folds 
*** FLOP *** [Kd 5d 7d]
AlfredE525: checks 
Perstenev: checks 
ChrisCDee: bets $2.25
AlfredE525: folds 
Perstenev: folds 
Uncalled bet ($2.25) returned to ChrisCDee
ChrisCDee collected $4.78 from pot
ChrisCDee: doesn't show hand 
*** SUMMARY ***
Total pot $5 | Rake $0.22 
Board [Kd 5d 7d]
Seat 1: chiyuki (button) folded before Flop (didn't bet)
Seat 2: AlfredE525 (small blind) folded on the Flop
Seat 3: BlOnDhOlIc (big blind) folded before Flop
Seat 4: ZhukOFFskI folded before Flop (didn't bet)
Seat 5: Perstenev folded on the Flop
Seat 6: loca-loca888 folded before Flop
Seat 7: znake77 folded before Flop (didn't bet)
Seat 8: Loholov folded before Flop (didn't bet)
Seat 9: ChrisCDee collected ($4.78)



PokerStars Zoom Hand #84299627315:  Hold'em No Limit ($0.10/$0.25) - 2012/08/05 14:32:16 JST [2012/08/05 1:32:16 ET]
Table 'Whirlpool' 9-max Seat #1 is the button
Seat 1: bonethugs699 ($32.46 in chips) 
Seat 2: chiyuki ($22.78 in chips) 
Seat 3: WARIBANA7777 ($17.23 in chips) 
Seat 4: Perstenev ($20.70 in chips) 
Seat 5: Dafleche ($20.06 in chips) 
Seat 6: Jene4kaBest ($13.02 in chips) 
Seat 7: troms20 ($49.15 in chips) 
Seat 8: yane73 ($22.23 in chips) 
Seat 9: Nerkit ($16.22 in chips) 
chiyuki: posts small blind $0.10
WARIBANA7777: posts big blind $0.25
*** HOLE CARDS ***
Dealt to chiyuki [Ks 7c]
Perstenev has timed out
Perstenev: folds 
Dafleche: calls $0.25
Jene4kaBest: folds 
troms20: folds 
yane73: raises $0.25 to $0.50
Nerkit: calls $0.50
bonethugs699: folds 
chiyuki: folds 
WARIBANA7777: folds 
Dafleche: calls $0.25
*** FLOP *** [Th 3h 3c]
Dafleche: bets $0.25
yane73: folds 
Nerkit: raises $0.75 to $1
Dafleche: folds 
Uncalled bet ($0.75) returned to Nerkit
Nerkit collected $2.24 from pot
Nerkit: doesn't show hand 
*** SUMMARY ***
Total pot $2.35 | Rake $0.11 
Board [Th 3h 3c]
Seat 1: bonethugs699 (button) folded before Flop (didn't bet)
Seat 2: chiyuki (small blind) folded before Flop
Seat 3: WARIBANA7777 (big blind) folded before Flop
Seat 4: Perstenev folded before Flop (didn't bet)
Seat 5: Dafleche folded on the Flop
Seat 6: Jene4kaBest folded before Flop (didn't bet)
Seat 7: troms20 folded before Flop (didn't bet)
Seat 8: yane73 folded on the Flop
Seat 9: Nerkit collected ($2.24)



PokerStars Zoom Hand #84299638438:  Hold'em No Limit ($0.10/$0.25) - 2012/08/05 14:33:02 JST [2012/08/05 1:33:02 ET]
Table 'Whirlpool' 9-max Seat #1 is the button
Seat 1: fuguangps ($29.77 in chips) 
Seat 2: johnbaco1209 ($31.06 in chips) 
Seat 3: Suhoff76 ($31.81 in chips) 
Seat 4: 1Karina1 ($25.85 in chips) 
Seat 5: Dejacob ($35.66 in chips) 
Seat 6: Vahe50 ($21.40 in chips) 
Seat 7: chiyuki ($22.68 in chips) 
Seat 8: KeLevro0 ($11.72 in chips) 
Seat 9: BlOnDhOlIc ($31.84 in chips) 
johnbaco1209: posts small blind $0.10
Suhoff76: posts big blind $0.25
*** HOLE CARDS ***
Dealt to chiyuki [Kc 3c]
1Karina1: folds 
Dejacob: folds 
Vahe50: raises $0.25 to $0.50
chiyuki: folds 
KeLevro0: folds 
BlOnDhOlIc: folds 
fuguangps: raises $1.50 to $2
johnbaco1209: folds 
Suhoff76: folds 
Vahe50: folds 
Uncalled bet ($1.50) returned to fuguangps
fuguangps collected $1.35 from pot
fuguangps: doesn't show hand 
*** SUMMARY ***
Total pot $1.35 | Rake $0 
Seat 1: fuguangps (button) collected ($1.35)
Seat 2: johnbaco1209 (small blind) folded before Flop
Seat 3: Suhoff76 (big blind) folded before Flop
Seat 4: 1Karina1 folded before Flop (didn't bet)
Seat 5: Dejacob folded before Flop (didn't bet)
Seat 6: Vahe50 folded before Flop
Seat 7: chiyuki folded before Flop (didn't bet)
Seat 8: KeLevro0 folded before Flop (didn't bet)
Seat 9: BlOnDhOlIc folded before Flop (didn't bet)



PokerStars Zoom Hand #84299639716:  Hold'em No Limit ($0.10/$0.25) - 2012/08/05 14:33:07 JST [2012/08/05 1:33:07 ET]
Table 'Whirlpool' 9-max Seat #1 is the button
Seat 1: el pore 5 ($15.79 in chips) 
Seat 2: KCDOGG10 ($26.45 in chips) 
Seat 3: chiyuki ($22.68 in chips) 
Seat 4: KAKamiro ($20.69 in chips) 
Seat 5: stalkerec ($11.25 in chips) 
Seat 6: BlOnDhOlIc ($31.84 in chips) 
Seat 7: hl77777 ($9.40 in chips) 
Seat 8: phate-1up ($37.57 in chips) 
Seat 9: laurentzu84 ($25 in chips) 
KCDOGG10: posts small blind $0.10
chiyuki: posts big blind $0.25
*** HOLE CARDS ***
Dealt to chiyuki [8h Ac]
KAKamiro: folds 
stalkerec: folds 
BlOnDhOlIc: raises $0.25 to $0.50
hl77777: folds 
phate-1up: folds 
laurentzu84: folds 
el pore 5: folds 
KCDOGG10: folds 
chiyuki: calls $0.25
*** FLOP *** [9c As Kh]
chiyuki: checks 
BlOnDhOlIc: bets $0.52
chiyuki: calls $0.52
*** TURN *** [9c As Kh] [4s]
chiyuki: checks 
BlOnDhOlIc: bets $1.50
chiyuki: folds 
Uncalled bet ($1.50) returned to BlOnDhOlIc
BlOnDhOlIc collected $2.04 from pot
BlOnDhOlIc: doesn't show hand 
*** SUMMARY ***
Total pot $2.14 | Rake $0.10 
Board [9c As Kh 4s]
Seat 1: el pore 5 (button) folded before Flop (didn't bet)
Seat 2: KCDOGG10 (small blind) folded before Flop
Seat 3: chiyuki (big blind) folded on the Turn
Seat 4: KAKamiro folded before Flop (didn't bet)
Seat 5: stalkerec folded before Flop (didn't bet)
Seat 6: BlOnDhOlIc collected ($2.04)
Seat 7: hl77777 folded before Flop (didn't bet)
Seat 8: phate-1up folded before Flop (didn't bet)
Seat 9: laurentzu84 folded before Flop (didn't bet)



PokerStars Zoom Hand #84299647357:  Hold'em No Limit ($0.10/$0.25) - 2012/08/05 14:33:38 JST [2012/08/05 1:33:38 ET]
Table 'Whirlpool' 9-max Seat #1 is the button
Seat 1: stalkerec ($11 in chips) 
Seat 2: fuguangps ($30.62 in chips) 
Seat 3: Yogi707 ($14.93 in chips) 
Seat 4: Loholov ($19.98 in chips) 
Seat 5: craden500 ($11.75 in chips) 
Seat 6: chiyuki ($21.66 in chips) 
Seat 7: troms20 ($24.65 in chips) 
Seat 8: Walturrr ($24.65 in chips) 
Seat 9: dushvan ($47.99 in chips) 
fuguangps: posts small blind $0.10
Yogi707: posts big blind $0.25
*** HOLE CARDS ***
Dealt to chiyuki [8h 8c]
Loholov: folds 
craden500: folds 
chiyuki: raises $0.50 to $0.75
troms20: folds 
Walturrr: folds 
dushvan: folds 
stalkerec: folds 
fuguangps: folds 
Yogi707: folds 
Uncalled bet ($0.50) returned to chiyuki
chiyuki collected $0.60 from pot
chiyuki: doesn't show hand 
*** SUMMARY ***
Total pot $0.60 | Rake $0 
Seat 1: stalkerec (button) folded before Flop (didn't bet)
Seat 2: fuguangps (small blind) folded before Flop
Seat 3: Yogi707 (big blind) folded before Flop
Seat 4: Loholov folded before Flop (didn't bet)
Seat 5: craden500 folded before Flop (didn't bet)
Seat 6: chiyuki collected ($0.60)
Seat 7: troms20 folded before Flop (didn't bet)
Seat 8: Walturrr folded before Flop (didn't bet)
Seat 9: dushvan folded before Flop (didn't bet)



PokerStars Zoom Hand #84299653324:  Hold'em No Limit ($0.10/$0.25) - 2012/08/05 14:34:03 JST [2012/08/05 1:34:03 ET]
Table 'Whirlpool' 9-max Seat #1 is the button
Seat 1: seula i ($28.53 in chips) 
Seat 2: pikhtovnikov ($22.50 in chips) 
Seat 3: 1Karina1 ($25.35 in chips) 
Seat 4: 4plankton ($22.97 in chips) 
Seat 5: chiyuki ($22.01 in chips) 
Seat 6: BlOnDhOlIc ($81.99 in chips) 
Seat 7: GovGus ($25 in chips) 
Seat 8: PillZ86 ($5.46 in chips) 
Seat 9: Suhoff76 ($28.62 in chips) 
pikhtovnikov: posts small blind $0.10
1Karina1: posts big blind $0.25
*** HOLE CARDS ***
Dealt to chiyuki [2d Ad]
4plankton: folds 
chiyuki: folds 
BlOnDhOlIc: raises $0.25 to $0.50
GovGus: folds 
PillZ86: raises $4.96 to $5.46 and is all-in
Suhoff76: folds 
seula i: folds 
pikhtovnikov: calls $5.36
1Karina1: folds 
BlOnDhOlIc: folds 
*** FLOP *** [Ks Qd 5h]
*** TURN *** [Ks Qd 5h] [Js]
*** RIVER *** [Ks Qd 5h Js] [Tc]
*** SHOW DOWN ***
pikhtovnikov: shows [Qc 3c] (a pair of Queens)
PillZ86: shows [9c 9d] (a straight, Nine to King)
PillZ86 collected $11.14 from pot
*** SUMMARY ***
Total pot $11.67 | Rake $0.53 
Board [Ks Qd 5h Js Tc]
Seat 1: seula i (button) folded before Flop (didn't bet)
Seat 2: pikhtovnikov (small blind) showed [Qc 3c] and lost with a pair of Queens
Seat 3: 1Karina1 (big blind) folded before Flop
Seat 4: 4plankton folded before Flop (didn't bet)
Seat 5: chiyuki folded before Flop (didn't bet)
Seat 6: BlOnDhOlIc folded before Flop
Seat 7: GovGus folded before Flop (didn't bet)
Seat 8: PillZ86 showed [9c 9d] and won ($11.14) with a straight, Nine to King
Seat 9: Suhoff76 folded before Flop (didn't bet)



PokerStars Zoom Hand #84299656744:  Hold'em No Limit ($0.10/$0.25) - 2012/08/05 14:34:17 JST [2012/08/05 1:34:17 ET]
Table 'Whirlpool' 9-max Seat #1 is the button
Seat 1: loca-loca888 ($47.08 in chips) 
Seat 2: mariuka1 ($7.38 in chips) 
Seat 3: taksist889 ($17.89 in chips) 
Seat 4: Dejacob ($35.66 in chips) 
Seat 5: stalkerec ($10.90 in chips) 
Seat 6: JLajoie ($46.55 in chips) 
Seat 7: fuguangps ($26.42 in chips) 
Seat 8: Perstenev ($8.76 in chips) 
Seat 9: chiyuki ($21.91 in chips) 
mariuka1: posts small blind $0.10
taksist889: posts big blind $0.25
*** HOLE CARDS ***
Dealt to chiyuki [Ks Ad]
Dejacob: folds 
stalkerec: folds 
JLajoie: raises $0.75 to $1
fuguangps: folds 
Perstenev: folds 
chiyuki: raises $2 to $3
loca-loca888: folds 
mariuka1: folds 
taksist889: folds 
JLajoie: folds 
Uncalled bet ($2) returned to chiyuki
chiyuki collected $2.35 from pot
chiyuki: doesn't show hand 
*** SUMMARY ***
Total pot $2.35 | Rake $0 
Seat 1: loca-loca888 (button) folded before Flop (didn't bet)
Seat 2: mariuka1 (small blind) folded before Flop
Seat 3: taksist889 (big blind) folded before Flop
Seat 4: Dejacob folded before Flop (didn't bet)
Seat 5: stalkerec folded before Flop (didn't bet)
Seat 6: JLajoie folded before Flop
Seat 7: fuguangps folded before Flop (didn't bet)
Seat 8: Perstenev folded before Flop (didn't bet)
Seat 9: chiyuki collected ($2.35)



PokerStars Zoom Hand #84299654296:  Hold'em No Limit ($0.10/$0.25) - 2012/08/05 14:34:07 JST [2012/08/05 1:34:07 ET]
Table 'Whirlpool' 9-max Seat #1 is the button
Seat 1: KrystalAA ($10.15 in chips) 
Seat 2: chiyuki ($22.01 in chips) 
Seat 3: Nerkit ($11.59 in chips) 
Seat 4: 4plankton ($22.97 in chips) 
Seat 5: phate-1up ($26.71 in chips) 
Seat 6: Walturrr ($24.15 in chips) 
Seat 7: BlOnDhOlIc ($32.61 in chips) 
Seat 8: Ellen1947 ($32.22 in chips) 
Seat 9: Suhoff76 ($25.35 in chips) 
chiyuki: posts small blind $0.10
Nerkit: posts big blind $0.25
*** HOLE CARDS ***
Dealt to chiyuki [3c Td]
4plankton: raises $0.25 to $0.50
phate-1up: folds 
Walturrr: folds 
BlOnDhOlIc: calls $0.50
Ellen1947: folds 
Suhoff76: folds 
KrystalAA: calls $0.50
chiyuki: folds 
Nerkit: calls $0.25
*** FLOP *** [3s Ts Ac]
Nerkit: checks 
4plankton: bets $1.25
BlOnDhOlIc: folds 
KrystalAA: folds 
Nerkit: calls $1.25
*** TURN *** [3s Ts Ac] [6h]
Nerkit: checks 
4plankton: bets $1.25
Nerkit: raises $1.75 to $3
4plankton: calls $1.75
*** RIVER *** [3s Ts Ac 6h] [5c]
Nerkit: checks 
4plankton: checks 
*** SHOW DOWN ***
Nerkit: shows [Qd As] (a pair of Aces)
4plankton: shows [Ah Kd] (a pair of Aces - King kicker)
4plankton collected $10.12 from pot
*** SUMMARY ***
Total pot $10.60 | Rake $0.48 
Board [3s Ts Ac 6h 5c]
Seat 1: KrystalAA (button) folded on the Flop
Seat 2: chiyuki (small blind) folded before Flop
Seat 3: Nerkit (big blind) showed [Qd As] and lost with a pair of Aces
Seat 4: 4plankton showed [Ah Kd] and won ($10.12) with a pair of Aces
Seat 5: phate-1up folded before Flop (didn't bet)
Seat 6: Walturrr folded before Flop (didn't bet)
Seat 7: BlOnDhOlIc folded on the Flop
Seat 8: Ellen1947 folded before Flop (didn't bet)
Seat 9: Suhoff76 folded before Flop (didn't bet)



PokerStars Zoom Hand #84299663714:  Hold'em No Limit ($0.10/$0.25) - 2012/08/05 14:34:45 JST [2012/08/05 1:34:45 ET]
Table 'Whirlpool' 9-max Seat #1 is the button
Seat 1: chiyuki ($23.26 in chips) 
Seat 2: Yogi707 ($13.93 in chips) 
Seat 3: ChrisCDee ($40.16 in chips) 
Seat 4: seula i ($28.53 in chips) 
Seat 5: 4ydo yogurt ($11.06 in chips) 
Seat 6: wtu1986 ($25 in chips) 
Seat 7: cr0lox ($23.79 in chips) 
Seat 8: laurentzu84 ($26.10 in chips) 
Seat 9: GovGus ($25 in chips) 
Yogi707: posts small blind $0.10
ChrisCDee: posts big blind $0.25
*** HOLE CARDS ***
Dealt to chiyuki [5d 4h]
seula i: folds 
4ydo yogurt: raises $0.50 to $0.75
wtu1986: folds 
cr0lox: folds 
laurentzu84: folds 
GovGus: folds 
chiyuki: folds 
Yogi707: folds 
ChrisCDee: folds 
Uncalled bet ($0.50) returned to 4ydo yogurt
4ydo yogurt collected $0.60 from pot
4ydo yogurt: doesn't show hand 
*** SUMMARY ***
Total pot $0.60 | Rake $0 
Seat 1: chiyuki (button) folded before Flop (didn't bet)
Seat 2: Yogi707 (small blind) folded before Flop
Seat 3: ChrisCDee (big blind) folded before Flop
Seat 4: seula i folded before Flop (didn't bet)
Seat 5: 4ydo yogurt collected ($0.60)
Seat 6: wtu1986 folded before Flop (didn't bet)
Seat 7: cr0lox folded before Flop (didn't bet)
Seat 8: laurentzu84 folded before Flop (didn't bet)
Seat 9: GovGus folded before Flop (didn't bet)



PokerStars Zoom Hand #84299667688:  Hold'em No Limit ($0.10/$0.25) - 2012/08/05 14:35:01 JST [2012/08/05 1:35:01 ET]
Table 'Whirlpool' 9-max Seat #1 is the button
Seat 1: slapshot2011 ($32.75 in chips) 
Seat 2: Walturrr ($23.68 in chips) 
Seat 3: KrystalAA ($26.62 in chips) 
Seat 4: wtu1986 ($24.75 in chips) 
Seat 5: ygoegoe ($27.66 in chips) 
Seat 6: chiyuki ($23.26 in chips) 
Seat 7: 1Karina1 ($25 in chips) 
Seat 8: Landybob ($40.56 in chips) 
Seat 9: Suhoff76 ($25.45 in chips) 
Walturrr: posts small blind $0.10
KrystalAA: posts big blind $0.25
*** HOLE CARDS ***
Dealt to chiyuki [6d 7s]
wtu1986: folds 
ygoegoe: folds 
chiyuki: folds 
1Karina1: folds 
Landybob: folds 
Suhoff76: folds 
slapshot2011: folds 
Walturrr: folds 
Uncalled bet ($0.15) returned to KrystalAA
KrystalAA collected $0.20 from pot
KrystalAA: doesn't show hand 
*** SUMMARY ***
Total pot $0.20 | Rake $0 
Seat 1: slapshot2011 (button) folded before Flop (didn't bet)
Seat 2: Walturrr (small blind) folded before Flop
Seat 3: KrystalAA (big blind) collected ($0.20)
Seat 4: wtu1986 folded before Flop (didn't bet)
Seat 5: ygoegoe folded before Flop (didn't bet)
Seat 6: chiyuki folded before Flop (didn't bet)
Seat 7: 1Karina1 folded before Flop (didn't bet)
Seat 8: Landybob folded before Flop (didn't bet)
Seat 9: Suhoff76 folded before Flop (didn't bet)



PokerStars Zoom Hand #84299669391:  Hold'em No Limit ($0.10/$0.25) - 2012/08/05 14:35:08 JST [2012/08/05 1:35:08 ET]
Table 'Whirlpool' 9-max Seat #1 is the button
Seat 1: wtu1986 ($24.75 in chips) 
Seat 2: craden500 ($10.75 in chips) 
Seat 3: chiyuki ($23.26 in chips) 
Seat 4: BlOnDhOlIc ($37.87 in chips) 
Seat 5: phate-1up ($38.25 in chips) 
Seat 6: KrystalAA ($15.26 in chips) 
Seat 7: GovGus ($25 in chips) 
Seat 8: fuguangps ($26.17 in chips) 
Seat 9: Suhoff76 ($28.72 in chips) 
craden500: posts small blind $0.10
chiyuki: posts big blind $0.25
*** HOLE CARDS ***
Dealt to chiyuki [6d 2d]
BlOnDhOlIc: folds 
phate-1up: folds 
KrystalAA: folds 
GovGus: folds 
fuguangps: folds 
Suhoff76: folds 
wtu1986: folds 
craden500: raises $0.50 to $0.75
chiyuki: folds 
Uncalled bet ($0.50) returned to craden500
craden500 collected $0.50 from pot
craden500: doesn't show hand 
*** SUMMARY ***
Total pot $0.50 | Rake $0 
Seat 1: wtu1986 (button) folded before Flop (didn't bet)
Seat 2: craden500 (small blind) collected ($0.50)
Seat 3: chiyuki (big blind) folded before Flop
Seat 4: BlOnDhOlIc folded before Flop (didn't bet)
Seat 5: phate-1up folded before Flop (didn't bet)
Seat 6: KrystalAA folded before Flop (didn't bet)
Seat 7: GovGus folded before Flop (didn't bet)
Seat 8: fuguangps folded before Flop (didn't bet)
Seat 9: Suhoff76 folded before Flop (didn't bet)



PokerStars Zoom Hand #84299666423:  Hold'em No Limit ($0.10/$0.25) - 2012/08/05 14:34:56 JST [2012/08/05 1:34:56 ET]
Table 'Whirlpool' 9-max Seat #1 is the button
Seat 1: 4plankton ($28.34 in chips) 
Seat 2: Nerkit ($12.50 in chips) 
Seat 3: softdesign ($76.33 in chips) 
Seat 4: phate-1up ($38.25 in chips) 
Seat 5: slapshot2011 ($32.75 in chips) 
Seat 6: dushvan ($47.24 in chips) 
Seat 7: Dejacob ($35.41 in chips) 
Seat 8: chiyuki ($23.26 in chips) 
Seat 9: ygoegoe ($27.66 in chips) 
Nerkit: posts small blind $0.10
softdesign: posts big blind $0.25
*** HOLE CARDS ***
Dealt to chiyuki [Js 7h]
phate-1up: folds 
slapshot2011: folds 
dushvan: folds 
Dejacob: folds 
chiyuki: folds 
ygoegoe: folds 
4plankton: folds 
Nerkit: raises $0.50 to $0.75
softdesign: calls $0.50
*** FLOP *** [8h As 9c]
Nerkit: checks 
softdesign: bets $1.25
Nerkit: calls $1.25
*** TURN *** [8h As 9c] [3d]
Nerkit: checks 
softdesign: bets $1.50
Nerkit: raises $2 to $3.50
softdesign: calls $2
*** RIVER *** [8h As 9c 3d] [2h]
Nerkit: checks 
softdesign: checks 
*** SHOW DOWN ***
Nerkit: shows [Kh Ah] (a pair of Aces)
softdesign: mucks hand 
Nerkit collected $10.50 from pot
*** SUMMARY ***
Total pot $11 | Rake $0.50 
Board [8h As 9c 3d 2h]
Seat 1: 4plankton (button) folded before Flop (didn't bet)
Seat 2: Nerkit (small blind) showed [Kh Ah] and won ($10.50) with a pair of Aces
Seat 3: softdesign (big blind) mucked [9s 6d]
Seat 4: phate-1up folded before Flop (didn't bet)
Seat 5: slapshot2011 folded before Flop (didn't bet)
Seat 6: dushvan folded before Flop (didn't bet)
Seat 7: Dejacob folded before Flop (didn't bet)
Seat 8: chiyuki folded before Flop (didn't bet)
Seat 9: ygoegoe folded before Flop (didn't bet)



PokerStars Zoom Hand #84299674047:  Hold'em No Limit ($0.10/$0.25) - 2012/08/05 14:35:28 JST [2012/08/05 1:35:28 ET]
Table 'Whirlpool' 9-max Seat #1 is the button
Seat 1: mariuka1 ($7.38 in chips) 
Seat 2: phate-1up ($38 in chips) 
Seat 3: BlOnDhOlIc ($84.95 in chips) 
Seat 4: taksist889 ($18.74 in chips) 
Seat 5: Suhoff76 ($26.26 in chips) 
Seat 6: AlfredE525 ($9.40 in chips) 
Seat 7: chiyuki ($23.01 in chips) 
Seat 8: Perstenev ($10.62 in chips) 
Seat 9: Yogi707 ($13.58 in chips) 
phate-1up: posts small blind $0.10
BlOnDhOlIc: posts big blind $0.25
*** HOLE CARDS ***
Dealt to chiyuki [Kh 3s]
taksist889: folds 
Suhoff76: folds 
AlfredE525: folds 
chiyuki: folds 
Perstenev: folds 
Yogi707: folds 
mariuka1: folds 
phate-1up: raises $0.50 to $0.75
BlOnDhOlIc: folds 
Uncalled bet ($0.50) returned to phate-1up
phate-1up collected $0.50 from pot
phate-1up: doesn't show hand 
*** SUMMARY ***
Total pot $0.50 | Rake $0 
Seat 1: mariuka1 (button) folded before Flop (didn't bet)
Seat 2: phate-1up (small blind) collected ($0.50)
Seat 3: BlOnDhOlIc (big blind) folded before Flop
Seat 4: taksist889 folded before Flop (didn't bet)
Seat 5: Suhoff76 folded before Flop (didn't bet)
Seat 6: AlfredE525 folded before Flop (didn't bet)
Seat 7: chiyuki folded before Flop (didn't bet)
Seat 8: Perstenev folded before Flop (didn't bet)
Seat 9: Yogi707 folded before Flop (didn't bet)



PokerStars Zoom Hand #84299664489:  Hold'em No Limit ($0.10/$0.25) - 2012/08/05 14:34:48 JST [2012/08/05 1:34:48 ET]
Table 'Whirlpool' 9-max Seat #1 is the button
Seat 1: ZhukOFFskI ($28.88 in chips) 
Seat 2: KeLevro0 ($10.10 in chips) 
Seat 3: Perstenev ($12.80 in chips) 
Seat 4: chiyuki ($23.26 in chips) 
Seat 5: wildy29 ($12.31 in chips) 
Seat 6: Ellen1947 ($24.92 in chips) 
Seat 7: WARIBANA7777 ($15.88 in chips) 
Seat 8: deadmoneykid ($24.65 in chips) 
Seat 9: bonethugs699 ($17.03 in chips) 
KeLevro0: posts small blind $0.10
Perstenev: posts big blind $0.25
*** HOLE CARDS ***
Dealt to chiyuki [5d Td]
chiyuki: folds 
wildy29: calls $0.25
Ellen1947: raises $0.75 to $1
WARIBANA7777: folds 
deadmoneykid: folds 
bonethugs699: folds 
ZhukOFFskI: folds 
KeLevro0: folds 
Perstenev: folds 
wildy29: calls $0.75
*** FLOP *** [Kc Qh 6h]
wildy29: checks 
Ellen1947: checks 
*** TURN *** [Kc Qh 6h] [Ts]
wildy29: checks 
Ellen1947: bets $0.80
wildy29: folds 
Uncalled bet ($0.80) returned to Ellen1947
Ellen1947 collected $2.24 from pot
Ellen1947: doesn't show hand 
*** SUMMARY ***
Total pot $2.35 | Rake $0.11 
Board [Kc Qh 6h Ts]
Seat 1: ZhukOFFskI (button) folded before Flop (didn't bet)
Seat 2: KeLevro0 (small blind) folded before Flop
Seat 3: Perstenev (big blind) folded before Flop
Seat 4: chiyuki folded before Flop (didn't bet)
Seat 5: wildy29 folded on the Turn
Seat 6: Ellen1947 collected ($2.24)
Seat 7: WARIBANA7777 folded before Flop (didn't bet)
Seat 8: deadmoneykid folded before Flop (didn't bet)
Seat 9: bonethugs699 folded before Flop (didn't bet)



PokerStars Zoom Hand #84299676303:  Hold'em No Limit ($0.10/$0.25) - 2012/08/05 14:35:37 JST [2012/08/05 1:35:37 ET]
Table 'Whirlpool' 9-max Seat #1 is the button
Seat 1: ChrisCDee ($68.36 in chips) 
Seat 2: KeLevro0 ($8.35 in chips) 
Seat 3: BlOnDhOlIc ($32.01 in chips) 
Seat 4: Suhoff76 ($28.62 in chips) 
Seat 5: chiyuki ($23.01 in chips) 
Seat 6: Perstenev ($9.78 in chips) 
Seat 7: seula i ($34.06 in chips) 
Seat 8: GovGus ($25 in chips) 
Seat 9: fuguangps ($30.27 in chips) 
KeLevro0: posts small blind $0.10
BlOnDhOlIc: posts big blind $0.25
*** HOLE CARDS ***
Dealt to chiyuki [2h Kd]
Suhoff76: folds 
chiyuki: folds 
Perstenev: calls $0.25
seula i: folds 
GovGus: folds 
fuguangps: folds 
ChrisCDee: raises $1 to $1.25
KeLevro0: folds 
BlOnDhOlIc: folds 
Perstenev: calls $1
*** FLOP *** [Jc 4h 3d]
Perstenev: checks 
ChrisCDee: bets $1.63
Perstenev: folds 
Uncalled bet ($1.63) returned to ChrisCDee
ChrisCDee collected $2.72 from pot
ChrisCDee: doesn't show hand 
*** SUMMARY ***
Total pot $2.85 | Rake $0.13 
Board [Jc 4h 3d]
Seat 1: ChrisCDee (button) collected ($2.72)
Seat 2: KeLevro0 (small blind) folded before Flop
Seat 3: BlOnDhOlIc (big blind) folded before Flop
Seat 4: Suhoff76 folded before Flop (didn't bet)
Seat 5: chiyuki folded before Flop (didn't bet)
Seat 6: Perstenev folded on the Flop
Seat 7: seula i folded before Flop (didn't bet)
Seat 8: GovGus folded before Flop (didn't bet)
Seat 9: fuguangps folded before Flop (didn't bet)



PokerStars Zoom Hand #84299679826:  Hold'em No Limit ($0.10/$0.25) - 2012/08/05 14:35:51 JST [2012/08/05 1:35:51 ET]
Table 'Whirlpool' 9-max Seat #1 is the button
Seat 1: Nerkit ($11.40 in chips) 
Seat 2: troms20 ($24.40 in chips) 
Seat 3: Vahe50 ($39.97 in chips) 
Seat 4: seula i ($31.19 in chips) 
Seat 5: Loholov ($37.69 in chips) 
Seat 6: GovGus ($26.23 in chips) 
Seat 7: fuguangps ($26.19 in chips) 
Seat 8: Dan Royal ($42.73 in chips) 
Seat 9: chiyuki ($23.01 in chips) 
troms20: posts small blind $0.10
Vahe50: posts big blind $0.25
*** HOLE CARDS ***
Dealt to chiyuki [8s Td]
seula i: raises $0.75 to $1
Loholov: folds 
GovGus: folds 
fuguangps: folds 
Dan Royal: folds 
chiyuki: folds 
Nerkit: folds 
troms20: folds 
Vahe50: folds 
Uncalled bet ($0.75) returned to seula i
seula i collected $0.60 from pot
seula i: doesn't show hand 
*** SUMMARY ***
Total pot $0.60 | Rake $0 
Seat 1: Nerkit (button) folded before Flop (didn't bet)
Seat 2: troms20 (small blind) folded before Flop
Seat 3: Vahe50 (big blind) folded before Flop
Seat 4: seula i collected ($0.60)
Seat 5: Loholov folded before Flop (didn't bet)
Seat 6: GovGus folded before Flop (didn't bet)
Seat 7: fuguangps folded before Flop (didn't bet)
Seat 8: Dan Royal folded before Flop (didn't bet)
Seat 9: chiyuki folded before Flop (didn't bet)



PokerStars Zoom Hand #84299680776:  Hold'em No Limit ($0.10/$0.25) - 2012/08/05 14:35:55 JST [2012/08/05 1:35:55 ET]
Table 'Whirlpool' 9-max Seat #1 is the button
Seat 1: Dan Royal ($42.73 in chips) 
Seat 2: chiyuki ($23.01 in chips) 
Seat 3: phate-1up ($36.76 in chips) 
Seat 4: RikkStroken ($82.20 in chips) 
Seat 5: stalkerec ($7.75 in chips) 
Seat 6: loca-loca888 ($47.31 in chips) 
Seat 7: ChrisCDee ($39.81 in chips) 
Seat 8: KeLevro0 ($8.25 in chips) 
Seat 9: ZhukOFFskI ($21.35 in chips) 
chiyuki: posts small blind $0.10
phate-1up: posts big blind $0.25
*** HOLE CARDS ***
Dealt to chiyuki [Js Kc]
RikkStroken: folds 
stalkerec: folds 
loca-loca888: folds 
ChrisCDee: folds 
KeLevro0: folds 
ZhukOFFskI: folds 
Dan Royal: raises $0.50 to $0.75
chiyuki: folds 
phate-1up: folds 
Uncalled bet ($0.50) returned to Dan Royal
Dan Royal collected $0.60 from pot
Dan Royal: doesn't show hand 
*** SUMMARY ***
Total pot $0.60 | Rake $0 
Seat 1: Dan Royal (button) collected ($0.60)
Seat 2: chiyuki (small blind) folded before Flop
Seat 3: phate-1up (big blind) folded before Flop
Seat 4: RikkStroken folded before Flop (didn't bet)
Seat 5: stalkerec folded before Flop (didn't bet)
Seat 6: loca-loca888 folded before Flop (didn't bet)
Seat 7: ChrisCDee folded before Flop (didn't bet)
Seat 8: KeLevro0 folded before Flop (didn't bet)
Seat 9: ZhukOFFskI folded before Flop (didn't bet)



PokerStars Zoom Hand #84299678564:  Hold'em No Limit ($0.10/$0.25) - 2012/08/05 14:35:46 JST [2012/08/05 1:35:46 ET]
Table 'Whirlpool' 9-max Seat #1 is the button
Seat 1: troms20 ($24.40 in chips) 
Seat 2: wtu1986 ($24.75 in chips) 
Seat 3: KeLevro0 ($9.33 in chips) 
Seat 4: chiyuki ($23.01 in chips) 
Seat 5: DanielWhyte ($49.39 in chips) 
Seat 6: peng2astic ($13.20 in chips) 
Seat 7: phate-1up ($41.16 in chips) 
Seat 8: mariuka1 ($7.38 in chips) 
Seat 9: KrystalAA ($26.72 in chips) 
wtu1986: posts small blind $0.10
KeLevro0: posts big blind $0.25
*** HOLE CARDS ***
Dealt to chiyuki [Ts 2c]
chiyuki: folds 
DanielWhyte: calls $0.25
peng2astic: calls $0.25
phate-1up: folds 
mariuka1: folds 
KrystalAA: calls $0.25
troms20: folds 
wtu1986: folds 
KeLevro0: checks 
*** FLOP *** [9d 3c Qd]
KeLevro0: checks 
DanielWhyte: checks 
peng2astic: checks 
KrystalAA: checks 
*** TURN *** [9d 3c Qd] [6d]
KeLevro0: checks 
DanielWhyte: checks 
peng2astic: bets $1
KrystalAA: folds 
KeLevro0: folds 
DanielWhyte: folds 
Uncalled bet ($1) returned to peng2astic
peng2astic collected $1.05 from pot
peng2astic: doesn't show hand 
*** SUMMARY ***
Total pot $1.10 | Rake $0.05 
Board [9d 3c Qd 6d]
Seat 1: troms20 (button) folded before Flop (didn't bet)
Seat 2: wtu1986 (small blind) folded before Flop
Seat 3: KeLevro0 (big blind) folded on the Turn
Seat 4: chiyuki folded before Flop (didn't bet)
Seat 5: DanielWhyte folded on the Turn
Seat 6: peng2astic collected ($1.05)
Seat 7: phate-1up folded before Flop (didn't bet)
Seat 8: mariuka1 folded before Flop (didn't bet)
Seat 9: KrystalAA folded on the Turn



PokerStars Zoom Hand #84299686182:  Hold'em No Limit ($0.10/$0.25) - 2012/08/05 14:36:18 JST [2012/08/05 1:36:18 ET]
Table 'Whirlpool' 9-max Seat #1 is the button
Seat 1: chiyuki ($22.91 in chips) 
Seat 2: troms20 ($26.65 in chips) 
Seat 3: Loholov ($15.75 in chips) 
Seat 4: stalkerec ($7.84 in chips) 
Seat 5: slapshot2011 ($31.75 in chips) 
Seat 6: seula i ($31.54 in chips) 
Seat 7: ZhukOFFskI ($32.36 in chips) 
Seat 8: Suhoff76 ($25.20 in chips) 
Seat 9: GovGus ($26.23 in chips) 
troms20: posts small blind $0.10
Loholov: posts big blind $0.25
*** HOLE CARDS ***
Dealt to chiyuki [As Kd]
stalkerec: folds 
slapshot2011: folds 
seula i: folds 
ZhukOFFskI: folds 
Suhoff76: folds 
GovGus: folds 
chiyuki: raises $0.50 to $0.75
troms20: folds 
Loholov: calls $0.50
*** FLOP *** [4h Ah Ks]
Loholov: checks 
chiyuki: bets $1.25
Loholov: calls $1.25
*** TURN *** [4h Ah Ks] [Ad]
Loholov: checks 
chiyuki: checks 
*** RIVER *** [4h Ah Ks Ad] [8c]
Loholov: checks 
chiyuki: bets $2.75
Loholov: calls $2.75
*** SHOW DOWN ***
chiyuki: shows [As Kd] (a full house, Aces full of Kings)
Loholov: mucks hand 
chiyuki collected $9.17 from pot
*** SUMMARY ***
Total pot $9.60 | Rake $0.43 
Board [4h Ah Ks Ad 8c]
Seat 1: chiyuki (button) showed [As Kd] and won ($9.17) with a full house, Aces full of Kings
Seat 2: troms20 (small blind) folded before Flop
Seat 3: Loholov (big blind) mucked [9c Kc]
Seat 4: stalkerec folded before Flop (didn't bet)
Seat 5: slapshot2011 folded before Flop (didn't bet)
Seat 6: seula i folded before Flop (didn't bet)
Seat 7: ZhukOFFskI folded before Flop (didn't bet)
Seat 8: Suhoff76 folded before Flop (didn't bet)
Seat 9: GovGus folded before Flop (didn't bet)



PokerStars Zoom Hand #84299697510:  Hold'em No Limit ($0.10/$0.25) - 2012/08/05 14:37:04 JST [2012/08/05 1:37:04 ET]
Table 'Whirlpool' 9-max Seat #1 is the button
Seat 1: ChrisCDee ($39.46 in chips) 
Seat 2: phate-1up ($26.59 in chips) 
Seat 3: Landybob ($40.56 in chips) 
Seat 4: KAKamiro ($24.44 in chips) 
Seat 5: WARIBANA7777 ($15.71 in chips) 
Seat 6: wtu1986 ($24.90 in chips) 
Seat 7: Yogi707 ($16.37 in chips) 
Seat 8: chiyuki ($27.33 in chips) 
Seat 9: Loholov ($15 in chips) 
phate-1up: posts small blind $0.10
Landybob: posts big blind $0.25
*** HOLE CARDS ***
Dealt to chiyuki [Qh 9c]
KAKamiro: folds 
WARIBANA7777: folds 
wtu1986: folds 
Yogi707: raises $0.37 to $0.62
chiyuki: folds 
Loholov: folds 
ChrisCDee: folds 
phate-1up: folds 
Landybob: folds 
Uncalled bet ($0.37) returned to Yogi707
Yogi707 collected $0.60 from pot
Yogi707: doesn't show hand 
*** SUMMARY ***
Total pot $0.60 | Rake $0 
Seat 1: ChrisCDee (button) folded before Flop (didn't bet)
Seat 2: phate-1up (small blind) folded before Flop
Seat 3: Landybob (big blind) folded before Flop
Seat 4: KAKamiro folded before Flop (didn't bet)
Seat 5: WARIBANA7777 folded before Flop (didn't bet)
Seat 6: wtu1986 folded before Flop (didn't bet)
Seat 7: Yogi707 collected ($0.60)
Seat 8: chiyuki folded before Flop (didn't bet)
Seat 9: Loholov folded before Flop (didn't bet)



PokerStars Zoom Hand #84299700010:  Hold'em No Limit ($0.10/$0.25) - 2012/08/05 14:37:14 JST [2012/08/05 1:37:14 ET]
Table 'Whirlpool' 9-max Seat #1 is the button
Seat 1: Loholov ($15 in chips) 
Seat 2: Suhoff76 ($28.15 in chips) 
Seat 3: a_tasmanian ($25 in chips) 
Seat 4: chiyuki ($27.33 in chips) 
Seat 5: cofla tito ($9.72 in chips) 
Seat 6: ChrisCDee ($39.46 in chips) 
Seat 7: puffy5533 ($24.49 in chips) 
Seat 8: KrystalAA ($15.26 in chips) 
Seat 9: Cyanidoff ($25 in chips) 
Suhoff76: posts small blind $0.10
a_tasmanian: posts big blind $0.25
*** HOLE CARDS ***
Dealt to chiyuki [Kc 4c]
chiyuki: folds 
cofla tito: folds 
ChrisCDee: raises $0.50 to $0.75
puffy5533: folds 
KrystalAA: folds 
Cyanidoff: folds 
Loholov: folds 
Suhoff76: folds 
a_tasmanian: calls $0.50
*** FLOP *** [Jc As 5h]
a_tasmanian: checks 
ChrisCDee: bets $0.91
a_tasmanian: folds 
Uncalled bet ($0.91) returned to ChrisCDee
ChrisCDee collected $1.53 from pot
ChrisCDee: doesn't show hand 
*** SUMMARY ***
Total pot $1.60 | Rake $0.07 
Board [Jc As 5h]
Seat 1: Loholov (button) folded before Flop (didn't bet)
Seat 2: Suhoff76 (small blind) folded before Flop
Seat 3: a_tasmanian (big blind) folded on the Flop
Seat 4: chiyuki folded before Flop (didn't bet)
Seat 5: cofla tito folded before Flop (didn't bet)
Seat 6: ChrisCDee collected ($1.53)
Seat 7: puffy5533 folded before Flop (didn't bet)
Seat 8: KrystalAA folded before Flop (didn't bet)
Seat 9: Cyanidoff folded before Flop (didn't bet)



PokerStars Zoom Hand #84299700998:  Hold'em No Limit ($0.10/$0.25) - 2012/08/05 14:37:18 JST [2012/08/05 1:37:18 ET]
Table 'Whirlpool' 9-max Seat #1 is the button
Seat 1: Suhoff76 ($28.90 in chips) 
Seat 2: silvno31 ($28.44 in chips) 
Seat 3: chiyuki ($27.33 in chips) 
Seat 4: GovGus ($25 in chips) 
Seat 5: Dejacob ($33.53 in chips) 
Seat 6: DanielWhyte ($49.82 in chips) 
Seat 7: ChrisCDee ($71.32 in chips) 
Seat 8: phate-1up ($26.49 in chips) 
Seat 9: Nerkit ($11.42 in chips) 
silvno31: posts small blind $0.10
chiyuki: posts big blind $0.25
*** HOLE CARDS ***
Dealt to chiyuki [Kd 5d]
GovGus: folds 
Dejacob: folds 
DanielWhyte: folds 
ChrisCDee: folds 
phate-1up: raises $0.50 to $0.75
Nerkit: folds 
Suhoff76: folds 
silvno31: folds 
chiyuki: folds 
Uncalled bet ($0.50) returned to phate-1up
phate-1up collected $0.60 from pot
phate-1up: doesn't show hand 
*** SUMMARY ***
Total pot $0.60 | Rake $0 
Seat 1: Suhoff76 (button) folded before Flop (didn't bet)
Seat 2: silvno31 (small blind) folded before Flop
Seat 3: chiyuki (big blind) folded before Flop
Seat 4: GovGus folded before Flop (didn't bet)
Seat 5: Dejacob folded before Flop (didn't bet)
Seat 6: DanielWhyte folded before Flop (didn't bet)
Seat 7: ChrisCDee folded before Flop (didn't bet)
Seat 8: phate-1up collected ($0.60)
Seat 9: Nerkit folded before Flop (didn't bet)



PokerStars Zoom Hand #84299699007:  Hold'em No Limit ($0.10/$0.25) - 2012/08/05 14:37:10 JST [2012/08/05 1:37:10 ET]
Table 'Whirlpool' 9-max Seat #1 is the button
Seat 1: Cyanidoff ($25 in chips) 
Seat 2: led52 ($12.25 in chips) 
Seat 3: 1Karina1 ($25 in chips) 
Seat 4: Paranoix1990 ($12.49 in chips) 
Seat 5: troms20 ($63.81 in chips) 
Seat 6: deadmoneykid ($24.30 in chips) 
Seat 7: chiyuki ($27.33 in chips) 
Seat 8: seula i ($31.89 in chips) 
Seat 9: hl77777 ($16.95 in chips) 
led52: posts small blind $0.10
1Karina1: posts big blind $0.25
*** HOLE CARDS ***
Dealt to chiyuki [8c Qh]
Paranoix1990: calls $0.25
troms20: folds 
deadmoneykid: folds 
chiyuki: folds 
seula i: folds 
hl77777: folds 
Cyanidoff: folds 
led52: calls $0.15
1Karina1: checks 
*** FLOP *** [8h 6h 5c]
led52: checks 
1Karina1: checks 
Paranoix1990: checks 
*** TURN *** [8h 6h 5c] [2d]
led52: checks 
1Karina1: checks 
Paranoix1990: bets $0.50
led52: folds 
1Karina1: folds 
Uncalled bet ($0.50) returned to Paranoix1990
Paranoix1990 collected $0.72 from pot
Paranoix1990: doesn't show hand 
*** SUMMARY ***
Total pot $0.75 | Rake $0.03 
Board [8h 6h 5c 2d]
Seat 1: Cyanidoff (button) folded before Flop (didn't bet)
Seat 2: led52 (small blind) folded on the Turn
Seat 3: 1Karina1 (big blind) folded on the Turn
Seat 4: Paranoix1990 collected ($0.72)
Seat 5: troms20 folded before Flop (didn't bet)
Seat 6: deadmoneykid folded before Flop (didn't bet)
Seat 7: chiyuki folded before Flop (didn't bet)
Seat 8: seula i folded before Flop (didn't bet)
Seat 9: hl77777 folded before Flop (didn't bet)



PokerStars Zoom Hand #84299708396:  Hold'em No Limit ($0.10/$0.25) - 2012/08/05 14:37:49 JST [2012/08/05 1:37:49 ET]
Table 'Whirlpool' 9-max Seat #1 is the button
Seat 1: fuguangps ($31.90 in chips) 
Seat 2: Lasutchik ($75.93 in chips) 
Seat 3: snejokCoxx ($12.50 in chips) 
Seat 4: BlOnDhOlIc ($83.93 in chips) 
Seat 5: Suhoff76 ($28.80 in chips) 
Seat 6: chiyuki ($27.08 in chips) 
Seat 7: Wilcox76607 ($15.88 in chips) 
Seat 8: troms20 ($47.35 in chips) 
Seat 9: 4ydo yogurt ($10.97 in chips) 
Lasutchik: posts small blind $0.10
snejokCoxx: posts big blind $0.25
*** HOLE CARDS ***
Dealt to chiyuki [3h Ad]
BlOnDhOlIc: folds 
Suhoff76: folds 
chiyuki: folds 
Wilcox76607: folds 
troms20: folds 
4ydo yogurt: folds 
fuguangps: raises $0.50 to $0.75
Lasutchik: folds 
snejokCoxx: folds 
Uncalled bet ($0.50) returned to fuguangps
fuguangps collected $0.60 from pot
fuguangps: doesn't show hand 
*** SUMMARY ***
Total pot $0.60 | Rake $0 
Seat 1: fuguangps (button) collected ($0.60)
Seat 2: Lasutchik (small blind) folded before Flop
Seat 3: snejokCoxx (big blind) folded before Flop
Seat 4: BlOnDhOlIc folded before Flop (didn't bet)
Seat 5: Suhoff76 folded before Flop (didn't bet)
Seat 6: chiyuki folded before Flop (didn't bet)
Seat 7: Wilcox76607 folded before Flop (didn't bet)
Seat 8: troms20 folded before Flop (didn't bet)
Seat 9: 4ydo yogurt folded before Flop (didn't bet)



PokerStars Zoom Hand #84299711156:  Hold'em No Limit ($0.10/$0.25) - 2012/08/05 14:38:00 JST [2012/08/05 1:38:00 ET]
Table 'Whirlpool' 9-max Seat #1 is the button
Seat 1: BlOnDhOlIc ($79.16 in chips) 
Seat 2: chiyuki ($27.08 in chips) 
Seat 3: peng2astic ($11.15 in chips) 
Seat 4: Suhoff76 ($26.76 in chips) 
Seat 5: Dejacob ($36.97 in chips) 
Seat 6: deadmoneykid ($28.29 in chips) 
Seat 7: simonzez ($56.68 in chips) 
Seat 8: Nerkit ($11.42 in chips) 
Seat 9: Perstenev ($17.21 in chips) 
chiyuki: posts small blind $0.10
peng2astic: posts big blind $0.25
*** HOLE CARDS ***
Dealt to chiyuki [Js Ts]
Suhoff76: folds 
Dejacob: folds 
deadmoneykid: raises $0.35 to $0.60
simonzez: folds 
Nerkit: folds 
Perstenev: folds 
BlOnDhOlIc: folds 
chiyuki: folds 
peng2astic: calls $0.35
*** FLOP *** [Jd 4s 3s]
peng2astic: checks 
deadmoneykid: bets $0.75
peng2astic: folds 
Uncalled bet ($0.75) returned to deadmoneykid
deadmoneykid collected $1.24 from pot
deadmoneykid: doesn't show hand 
*** SUMMARY ***
Total pot $1.30 | Rake $0.06 
Board [Jd 4s 3s]
Seat 1: BlOnDhOlIc (button) folded before Flop (didn't bet)
Seat 2: chiyuki (small blind) folded before Flop
Seat 3: peng2astic (big blind) folded on the Flop
Seat 4: Suhoff76 folded before Flop (didn't bet)
Seat 5: Dejacob folded before Flop (didn't bet)
Seat 6: deadmoneykid collected ($1.24)
Seat 7: simonzez folded before Flop (didn't bet)
Seat 8: Nerkit folded before Flop (didn't bet)
Seat 9: Perstenev folded before Flop (didn't bet)



PokerStars Zoom Hand #84299716334:  Hold'em No Limit ($0.10/$0.25) - 2012/08/05 14:38:21 JST [2012/08/05 1:38:21 ET]
Table 'Whirlpool' 9-max Seat #1 is the button
Seat 1: chiyuki ($26.98 in chips) 
Seat 2: ZhukOFFskI ($28.88 in chips) 
Seat 3: phate-1up ($40.71 in chips) 
Seat 4: cr0lox ($24.30 in chips) 
Seat 5: KeLevro0 ($14 in chips) 
Seat 6: Perstenev ($17.21 in chips) 
Seat 7: troms20 ($63.46 in chips) 
Seat 8: led52 ($12 in chips) 
Seat 9: Suhoff76 ($25 in chips) 
ZhukOFFskI: posts small blind $0.10
phate-1up: posts big blind $0.25
*** HOLE CARDS ***
Dealt to chiyuki [Ad 4c]
cr0lox: folds 
KeLevro0: raises $0.42 to $0.67
Perstenev: folds 
troms20: folds 
led52: folds 
Suhoff76: folds 
chiyuki: folds 
ZhukOFFskI: folds 
phate-1up: folds 
Uncalled bet ($0.42) returned to KeLevro0
KeLevro0 collected $0.60 from pot
KeLevro0: doesn't show hand 
*** SUMMARY ***
Total pot $0.60 | Rake $0 
Seat 1: chiyuki (button) folded before Flop (didn't bet)
Seat 2: ZhukOFFskI (small blind) folded before Flop
Seat 3: phate-1up (big blind) folded before Flop
Seat 4: cr0lox folded before Flop (didn't bet)
Seat 5: KeLevro0 collected ($0.60)
Seat 6: Perstenev folded before Flop (didn't bet)
Seat 7: troms20 folded before Flop (didn't bet)
Seat 8: led52 folded before Flop (didn't bet)
Seat 9: Suhoff76 folded before Flop (didn't bet)



PokerStars Zoom Hand #84299720456:  Hold'em No Limit ($0.10/$0.25) - 2012/08/05 14:38:38 JST [2012/08/05 1:38:38 ET]
Table 'Whirlpool' 9-max Seat #1 is the button
Seat 1: 4plankton ($27.38 in chips) 
Seat 2: silvno31 ($29.36 in chips) 
Seat 3: KeLevro0 ($7.55 in chips) 
Seat 4: led52 ($12 in chips) 
Seat 5: chiyuki ($26.98 in chips) 
Seat 6: GovGus ($25 in chips) 
Seat 7: stalkerec ($4.95 in chips) 
Seat 8: Suhoff76 ($25.50 in chips) 
Seat 9: Lasutchik ($76.49 in chips) 
silvno31: posts small blind $0.10
KeLevro0: posts big blind $0.25
*** HOLE CARDS ***
Dealt to chiyuki [7c Js]
led52: folds 
chiyuki: folds 
GovGus: folds 
stalkerec: folds 
Suhoff76: folds 
Lasutchik: folds 
4plankton: folds 
silvno31: raises $0.25 to $0.50
KeLevro0: folds 
Uncalled bet ($0.25) returned to silvno31
silvno31 collected $0.50 from pot
silvno31: doesn't show hand 
*** SUMMARY ***
Total pot $0.50 | Rake $0 
Seat 1: 4plankton (button) folded before Flop (didn't bet)
Seat 2: silvno31 (small blind) collected ($0.50)
Seat 3: KeLevro0 (big blind) folded before Flop
Seat 4: led52 folded before Flop (didn't bet)
Seat 5: chiyuki folded before Flop (didn't bet)
Seat 6: GovGus folded before Flop (didn't bet)
Seat 7: stalkerec folded before Flop (didn't bet)
Seat 8: Suhoff76 folded before Flop (didn't bet)
Seat 9: Lasutchik folded before Flop (didn't bet)



PokerStars Zoom Hand #84299719460:  Hold'em No Limit ($0.10/$0.25) - 2012/08/05 14:38:34 JST [2012/08/05 1:38:34 ET]
Table 'Whirlpool' 9-max Seat #1 is the button
Seat 1: Nerkit ($15.69 in chips) 
Seat 2: cofla tito ($10.47 in chips) 
Seat 3: Dejacob ($37.80 in chips) 
Seat 4: deadmoneykid ($24.30 in chips) 
Seat 5: phate-1up ($35.61 in chips) 
Seat 6: Alvinpe85 ($64.24 in chips) 
Seat 7: led52 ($12 in chips) 
Seat 8: chiyuki ($26.98 in chips) 
Seat 9: 1Karina1 ($25 in chips) 
cofla tito: posts small blind $0.10
Dejacob: posts big blind $0.25
*** HOLE CARDS ***
Dealt to chiyuki [4h 3h]
deadmoneykid: folds 
phate-1up: folds 
Alvinpe85: folds 
led52: folds 
chiyuki: folds 
1Karina1: folds 
Nerkit: raises $0.50 to $0.75
cofla tito: folds 
Dejacob: folds 
Uncalled bet ($0.50) returned to Nerkit
Nerkit collected $0.60 from pot
Nerkit: doesn't show hand 
*** SUMMARY ***
Total pot $0.60 | Rake $0 
Seat 1: Nerkit (button) collected ($0.60)
Seat 2: cofla tito (small blind) folded before Flop
Seat 3: Dejacob (big blind) folded before Flop
Seat 4: deadmoneykid folded before Flop (didn't bet)
Seat 5: phate-1up folded before Flop (didn't bet)
Seat 6: Alvinpe85 folded before Flop (didn't bet)
Seat 7: led52 folded before Flop (didn't bet)
Seat 8: chiyuki folded before Flop (didn't bet)
Seat 9: 1Karina1 folded before Flop (didn't bet)



PokerStars Zoom Hand #84299721707:  Hold'em No Limit ($0.10/$0.25) - 2012/08/05 14:38:43 JST [2012/08/05 1:38:43 ET]
Table 'Whirlpool' 9-max Seat #1 is the button
Seat 1: snejokCoxx ($18.10 in chips) 
Seat 2: peng2astic ($10.55 in chips) 
Seat 3: troms20 ($63.46 in chips) 
Seat 4: stalkerec ($4.95 in chips) 
Seat 5: ChrisCDee ($37.69 in chips) 
Seat 6: simonzez ($55.96 in chips) 
Seat 7: chiyuki ($26.98 in chips) 
Seat 8: 4plankton ($27.38 in chips) 
Seat 9: BlOnDhOlIc ($87.39 in chips) 
peng2astic: posts small blind $0.10
troms20: posts big blind $0.25
*** HOLE CARDS ***
Dealt to chiyuki [Jc 8c]
stalkerec: folds 
ChrisCDee: folds 
simonzez: folds 
chiyuki: folds 
4plankton: folds 
BlOnDhOlIc: folds 
snejokCoxx: raises $0.45 to $0.70
peng2astic: folds 
troms20: folds 
Uncalled bet ($0.45) returned to snejokCoxx
snejokCoxx collected $0.60 from pot
snejokCoxx: doesn't show hand 
*** SUMMARY ***
Total pot $0.60 | Rake $0 
Seat 1: snejokCoxx (button) collected ($0.60)
Seat 2: peng2astic (small blind) folded before Flop
Seat 3: troms20 (big blind) folded before Flop
Seat 4: stalkerec folded before Flop (didn't bet)
Seat 5: ChrisCDee folded before Flop (didn't bet)
Seat 6: simonzez folded before Flop (didn't bet)
Seat 7: chiyuki folded before Flop (didn't bet)
Seat 8: 4plankton folded before Flop (didn't bet)
Seat 9: BlOnDhOlIc folded before Flop (didn't bet)



PokerStars Zoom Hand #84299722728:  Hold'em No Limit ($0.10/$0.25) - 2012/08/05 14:38:47 JST [2012/08/05 1:38:47 ET]
Table 'Whirlpool' 9-max Seat #1 is the button
Seat 1: Gichboy ($13.27 in chips) 
Seat 2: Suhoff76 ($28.55 in chips) 
Seat 3: chiyuki ($26.98 in chips) 
Seat 4: Perstenev ($10.79 in chips) 
Seat 5: peng2astic ($10.45 in chips) 
Seat 6: Lasutchik ($76.49 in chips) 
Seat 7: KeLevro0 ($9.16 in chips) 
Seat 8: led52 ($21.37 in chips) 
Seat 9: Loholov ($16.38 in chips) 
Suhoff76: posts small blind $0.10
chiyuki: posts big blind $0.25
*** HOLE CARDS ***
Dealt to chiyuki [Ks 6c]
Perstenev: folds 
peng2astic: raises $0.50 to $0.75
Lasutchik: folds 
KeLevro0: folds 
led52: folds 
Loholov: folds 
Gichboy: raises $0.50 to $1.25
Suhoff76: folds 
chiyuki: folds 
peng2astic: calls $0.50
*** FLOP *** [8d Ac 4s]
peng2astic: checks 
Gichboy: bets $1.50
peng2astic: folds 
Uncalled bet ($1.50) returned to Gichboy
Gichboy collected $2.72 from pot
Gichboy: doesn't show hand 
*** SUMMARY ***
Total pot $2.85 | Rake $0.13 
Board [8d Ac 4s]
Seat 1: Gichboy (button) collected ($2.72)
Seat 2: Suhoff76 (small blind) folded before Flop
Seat 3: chiyuki (big blind) folded before Flop
Seat 4: Perstenev folded before Flop (didn't bet)
Seat 5: peng2astic folded on the Flop
Seat 6: Lasutchik folded before Flop (didn't bet)
Seat 7: KeLevro0 folded before Flop (didn't bet)
Seat 8: led52 folded before Flop (didn't bet)
Seat 9: Loholov folded before Flop (didn't bet)



PokerStars Zoom Hand #84299715331:  Hold'em No Limit ($0.10/$0.25) - 2012/08/05 14:38:17 JST [2012/08/05 1:38:17 ET]
Table 'Whirlpool' 9-max Seat #1 is the button
Seat 1: Perstenev ($17.21 in chips) 
Seat 2: Ladyteazer ($23.57 in chips) 
Seat 3: Ellen1947 ($24.66 in chips) 
Seat 4: KeLevro0 ($14 in chips) 
Seat 5: Dejacob ($26.93 in chips) 
Seat 6: Nerkit ($16.48 in chips) 
Seat 7: deadmoneykid ($24.30 in chips) 
Seat 8: fuguangps ($25 in chips) 
Seat 9: chiyuki ($26.98 in chips) 
Ladyteazer: posts small blind $0.10
Ellen1947: posts big blind $0.25
*** HOLE CARDS ***
Dealt to chiyuki [7d Kc]
KeLevro0: folds 
Dejacob: folds 
Nerkit: folds 
deadmoneykid: folds 
fuguangps: folds 
chiyuki: folds 
Perstenev: folds 
Ladyteazer: raises $0.25 to $0.50
Ellen1947: calls $0.25
*** FLOP *** [4h 2h 8c]
Ladyteazer: bets $0.50
Ellen1947: calls $0.50
*** TURN *** [4h 2h 8c] [8s]
Ladyteazer: checks 
Ellen1947: bets $0.60
Ladyteazer: calls $0.60
*** RIVER *** [4h 2h 8c 8s] [Kh]
Ladyteazer: checks 
Ellen1947: checks 
*** SHOW DOWN ***
Ladyteazer: shows [Ac Kd] (two pair, Kings and Eights)
Ellen1947: mucks hand 
Ladyteazer collected $3.06 from pot
*** SUMMARY ***
Total pot $3.20 | Rake $0.14 
Board [4h 2h 8c 8s Kh]
Seat 1: Perstenev (button) folded before Flop (didn't bet)
Seat 2: Ladyteazer (small blind) showed [Ac Kd] and won ($3.06) with two pair, Kings and Eights
Seat 3: Ellen1947 (big blind) mucked [6c Ah]
Seat 4: KeLevro0 folded before Flop (didn't bet)
Seat 5: Dejacob folded before Flop (didn't bet)
Seat 6: Nerkit folded before Flop (didn't bet)
Seat 7: deadmoneykid folded before Flop (didn't bet)
Seat 8: fuguangps folded before Flop (didn't bet)
Seat 9: chiyuki folded before Flop (didn't bet)



PokerStars Zoom Hand #84299726446:  Hold'em No Limit ($0.10/$0.25) - 2012/08/05 14:39:03 JST [2012/08/05 1:39:03 ET]
Table 'Whirlpool' 9-max Seat #1 is the button
Seat 1: hirozo ($25 in chips) 
Seat 2: igor*gemert ($25.57 in chips) 
Seat 3: roksmokndonk ($23.79 in chips) 
Seat 4: chiyuki ($26.73 in chips) 
Seat 5: Suhoff76 ($25 in chips) 
Seat 6: KeLevro0 ($7.30 in chips) 
Seat 7: BlOnDhOlIc ($79.26 in chips) 
Seat 8: troms20 ($31.04 in chips) 
Seat 9: Perstenev ($16.96 in chips) 
igor*gemert: posts small blind $0.10
roksmokndonk: posts big blind $0.25
*** HOLE CARDS ***
Dealt to chiyuki [Ac Qh]
chiyuki: raises $0.50 to $0.75
Suhoff76: calls $0.75
KeLevro0: folds 
BlOnDhOlIc: folds 
troms20: folds 
Perstenev: calls $0.75
hirozo: calls $0.75
igor*gemert: folds 
roksmokndonk: calls $0.50
*** FLOP *** [3s Tc 6c]
roksmokndonk: checks 
chiyuki: checks 
Suhoff76: checks 
Perstenev: bets $0.75
hirozo: folds 
roksmokndonk: calls $0.75
chiyuki: calls $0.75
Suhoff76: folds 
*** TURN *** [3s Tc 6c] [Jc]
roksmokndonk: checks 
chiyuki: checks 
Perstenev: bets $4.37
roksmokndonk: calls $4.37
chiyuki: calls $4.37
*** RIVER *** [3s Tc 6c Jc] [Kh]
roksmokndonk: checks 
chiyuki: bets $7
Perstenev: raises $4.09 to $11.09 and is all-in
roksmokndonk: raises $6.83 to $17.92 and is all-in
chiyuki: calls $10.92
*** SHOW DOWN ***
roksmokndonk: shows [3c 2c] (a flush, Jack high)
chiyuki: mucks hand 
roksmokndonk collected $13.66 from side pot
Perstenev: mucks hand 
roksmokndonk collected $50.48 from main pot
*** SUMMARY ***
Total pot $66.14 Main pot $50.48. Side pot $13.66. | Rake $2 
Board [3s Tc 6c Jc Kh]
Seat 1: hirozo (button) folded on the Flop
Seat 2: igor*gemert (small blind) folded before Flop
Seat 3: roksmokndonk (big blind) showed [3c 2c] and won ($64.14) with a flush, Jack high
Seat 4: chiyuki mucked [Ac Qh]
Seat 5: Suhoff76 folded on the Flop
Seat 6: KeLevro0 folded before Flop (didn't bet)
Seat 7: BlOnDhOlIc folded before Flop (didn't bet)
Seat 8: troms20 folded before Flop (didn't bet)
Seat 9: Perstenev mucked [6s 6h]



PokerStars Zoom Hand #84299752983:  Hold'em No Limit ($0.10/$0.25) - 2012/08/05 14:40:52 JST [2012/08/05 1:40:52 ET]
Table 'Whirlpool' 9-max Seat #1 is the button
Seat 1: Perstenev ($13 in chips) 
Seat 2: yane73 ($26.27 in chips) 
Seat 3: led52 ($11.05 in chips) 
Seat 4: Cyanidoff ($25.35 in chips) 
Seat 5: chiyuki ($25 in chips) 
Seat 6: BlOnDhOlIc ($78.81 in chips) 
Seat 7: debstar27 ($27.56 in chips) 
Seat 8: stalkerec ($2.84 in chips) 
Seat 9: deadmoneykid ($22.82 in chips) 
yane73: posts small blind $0.10
led52: posts big blind $0.25
*** HOLE CARDS ***
Dealt to chiyuki [Kd 8h]
Cyanidoff: folds 
chiyuki: folds 
BlOnDhOlIc: folds 
debstar27: folds 
stalkerec: folds 
deadmoneykid: folds 
Perstenev: folds 
yane73: folds 
Uncalled bet ($0.15) returned to led52
led52 collected $0.20 from pot
led52: doesn't show hand 
*** SUMMARY ***
Total pot $0.20 | Rake $0 
Seat 1: Perstenev (button) folded before Flop (didn't bet)
Seat 2: yane73 (small blind) folded before Flop
Seat 3: led52 (big blind) collected ($0.20)
Seat 4: Cyanidoff folded before Flop (didn't bet)
Seat 5: chiyuki folded before Flop (didn't bet)
Seat 6: BlOnDhOlIc folded before Flop (didn't bet)
Seat 7: debstar27 folded before Flop (didn't bet)
Seat 8: stalkerec folded before Flop (didn't bet)
Seat 9: deadmoneykid folded before Flop (didn't bet)



PokerStars Zoom Hand #84299754712:  Hold'em No Limit ($0.10/$0.25) - 2012/08/05 14:40:59 JST [2012/08/05 1:40:59 ET]
Table 'Whirlpool' 9-max Seat #1 is the button
Seat 1: dushvan ($42.29 in chips) 
Seat 2: BlOnDhOlIc ($40.31 in chips) 
Seat 3: Cyanidoff ($25.35 in chips) 
Seat 4: Gichboy ($11.24 in chips) 
Seat 5: KrystalAA ($2.89 in chips) 
Seat 6: Perstenev ($7.71 in chips) 
Seat 7: JokerJudge ($26.22 in chips) 
Seat 8: chiyuki ($25 in chips) 
Seat 9: ZhukOFFskI ($33.84 in chips) 
BlOnDhOlIc: posts small blind $0.10
Cyanidoff: posts big blind $0.25
*** HOLE CARDS ***
Dealt to chiyuki [Kc Ks]
Gichboy: folds 
KrystalAA: folds 
Perstenev: folds 
JokerJudge: calls $0.25
chiyuki: raises $0.75 to $1
ZhukOFFskI: folds 
dushvan: folds 
BlOnDhOlIc: folds 
Cyanidoff: folds 
JokerJudge: calls $0.75
*** FLOP *** [Tc Ts 9c]
JokerJudge: checks 
chiyuki: bets $1.50
JokerJudge: calls $1.50
*** TURN *** [Tc Ts 9c] [4c]
JokerJudge: checks 
chiyuki: checks 
*** RIVER *** [Tc Ts 9c 4c] [3h]
JokerJudge: checks 
chiyuki: bets $2.75
JokerJudge: calls $2.75
*** SHOW DOWN ***
chiyuki: shows [Kc Ks] (two pair, Kings and Tens)
JokerJudge: mucks hand 
chiyuki collected $10.36 from pot
*** SUMMARY ***
Total pot $10.85 | Rake $0.49 
Board [Tc Ts 9c 4c 3h]
Seat 1: dushvan (button) folded before Flop (didn't bet)
Seat 2: BlOnDhOlIc (small blind) folded before Flop
Seat 3: Cyanidoff (big blind) folded before Flop
Seat 4: Gichboy folded before Flop (didn't bet)
Seat 5: KrystalAA folded before Flop (didn't bet)
Seat 6: Perstenev folded before Flop (didn't bet)
Seat 7: JokerJudge mucked [2c 2h]
Seat 8: chiyuki showed [Kc Ks] and won ($10.36) with two pair, Kings and Tens
Seat 9: ZhukOFFskI folded before Flop (didn't bet)



PokerStars Zoom Hand #84299752202:  Hold'em No Limit ($0.10/$0.25) - 2012/08/05 14:40:49 JST [2012/08/05 1:40:49 ET]
Table 'Whirlpool' 9-max Seat #1 is the button
Seat 1: JokerJudge ($26.22 in chips) 
Seat 2: roksmokndonk ($64.14 in chips) 
Seat 3: hirozo ($33.40 in chips) 
Seat 4: Dan Royal ($48.65 in chips) 
Seat 5: bigred1102 ($21.54 in chips) 
Seat 6: chiyuki ($25 in chips) 
Seat 7: el pore 5 ($31.59 in chips) 
Seat 8: Vahe50 ($15.25 in chips) 
Seat 9: 1Karina1 ($25 in chips) 
roksmokndonk: posts small blind $0.10
hirozo: posts big blind $0.25
*** HOLE CARDS ***
Dealt to chiyuki [7c 5s]
Dan Royal: folds 
bigred1102: raises $0.25 to $0.50
chiyuki: folds 
el pore 5: calls $0.50
Vahe50: folds 
1Karina1: folds 
JokerJudge: folds 
roksmokndonk is disconnected 
roksmokndonk has timed out while disconnected
roksmokndonk: folds 
hirozo: calls $0.25
*** FLOP *** [Js 8c 7s]
hirozo: bets $1.50
bigred1102: folds 
el pore 5: folds 
Uncalled bet ($1.50) returned to hirozo
hirozo collected $1.53 from pot
hirozo: doesn't show hand 
*** SUMMARY ***
Total pot $1.60 | Rake $0.07 
Board [Js 8c 7s]
Seat 1: JokerJudge (button) folded before Flop (didn't bet)
Seat 2: roksmokndonk (small blind) folded before Flop
Seat 3: hirozo (big blind) collected ($1.53)
Seat 4: Dan Royal folded before Flop (didn't bet)
Seat 5: bigred1102 folded on the Flop
Seat 6: chiyuki folded before Flop (didn't bet)
Seat 7: el pore 5 folded on the Flop
Seat 8: Vahe50 folded before Flop (didn't bet)
Seat 9: 1Karina1 folded before Flop (didn't bet)



PokerStars Zoom Hand #84299775275:  Hold'em No Limit ($0.10/$0.25) - 2012/08/05 14:42:25 JST [2012/08/05 1:42:25 ET]
Table 'Whirlpool' 9-max Seat #1 is the button
Seat 1: hirozo ($34.43 in chips) 
Seat 2: chiyuki ($30.11 in chips) 
Seat 3: Jene4kaBest ($10.80 in chips) 
Seat 4: Perstenev ($8.68 in chips) 
Seat 5: laurentzu84 ($32.04 in chips) 
Seat 6: WARIBANA7777 ($23.02 in chips) 
Seat 7: Paranoix1990 ($10.49 in chips) 
Seat 8: slapshot2011 ($33.73 in chips) 
Seat 9: ZhukOFFskI ($34.76 in chips) 
chiyuki: posts small blind $0.10
Jene4kaBest: posts big blind $0.25
*** HOLE CARDS ***
Dealt to chiyuki [Jc Qh]
Perstenev: folds 
laurentzu84: raises $0.50 to $0.75
WARIBANA7777: folds 
Paranoix1990: folds 
slapshot2011: folds 
ZhukOFFskI: folds 
hirozo: folds 
chiyuki: folds 
Jene4kaBest: folds 
Uncalled bet ($0.50) returned to laurentzu84
laurentzu84 collected $0.60 from pot
laurentzu84: doesn't show hand 
*** SUMMARY ***
Total pot $0.60 | Rake $0 
Seat 1: hirozo (button) folded before Flop (didn't bet)
Seat 2: chiyuki (small blind) folded before Flop
Seat 3: Jene4kaBest (big blind) folded before Flop
Seat 4: Perstenev folded before Flop (didn't bet)
Seat 5: laurentzu84 collected ($0.60)
Seat 6: WARIBANA7777 folded before Flop (didn't bet)
Seat 7: Paranoix1990 folded before Flop (didn't bet)
Seat 8: slapshot2011 folded before Flop (didn't bet)
Seat 9: ZhukOFFskI folded before Flop (didn't bet)



PokerStars Zoom Hand #84299778266:  Hold'em No Limit ($0.10/$0.25) - 2012/08/05 14:42:37 JST [2012/08/05 1:42:37 ET]
Table 'Whirlpool' 9-max Seat #1 is the button
Seat 1: led52 ($13.17 in chips) 
Seat 2: el pore 5 ($30.84 in chips) 
Seat 3: gunbowler ($145.75 in chips) 
Seat 4: laurentzu84 ($32.39 in chips) 
Seat 5: snejokCoxx ($11.45 in chips) 
Seat 6: cofla tito ($15.12 in chips) 
Seat 7: Loholov ($15.99 in chips) 
Seat 8: Cyanidoff ($25.35 in chips) 
Seat 9: chiyuki ($30.01 in chips) 
el pore 5: posts small blind $0.10
gunbowler: posts big blind $0.25
*** HOLE CARDS ***
Dealt to chiyuki [9s 3d]
laurentzu84: folds 
snejokCoxx: folds 
cofla tito: folds 
Loholov: folds 
Cyanidoff: folds 
chiyuki: folds 
led52: raises $0.50 to $0.75
el pore 5: folds 
gunbowler: raises $1.15 to $1.90
led52: folds 
Uncalled bet ($1.15) returned to gunbowler
gunbowler collected $1.60 from pot
gunbowler: doesn't show hand 
*** SUMMARY ***
Total pot $1.60 | Rake $0 
Seat 1: led52 (button) folded before Flop
Seat 2: el pore 5 (small blind) folded before Flop
Seat 3: gunbowler (big blind) collected ($1.60)
Seat 4: laurentzu84 folded before Flop (didn't bet)
Seat 5: snejokCoxx folded before Flop (didn't bet)
Seat 6: cofla tito folded before Flop (didn't bet)
Seat 7: Loholov folded before Flop (didn't bet)
Seat 8: Cyanidoff folded before Flop (didn't bet)
Seat 9: chiyuki folded before Flop (didn't bet)



PokerStars Zoom Hand #84299780198:  Hold'em No Limit ($0.10/$0.25) - 2012/08/05 14:42:45 JST [2012/08/05 1:42:45 ET]
Table 'Whirlpool' 9-max Seat #1 is the button
Seat 1: 4thepeople ($15.56 in chips) 
Seat 2: led52 ($12.41 in chips) 
Seat 3: cofla tito ($6.77 in chips) 
Seat 4: Nagus3x ($21.80 in chips) 
Seat 5: KeLevro0 ($11.87 in chips) 
Seat 6: chiyuki ($30.01 in chips) 
Seat 7: Tom1999 ($12 in chips) 
Seat 8: Loholov ($15.99 in chips) 
Seat 9: 4plankton ($29.76 in chips) 
led52: posts small blind $0.10
cofla tito: posts big blind $0.25
*** HOLE CARDS ***
Dealt to chiyuki [Qh Qs]
Nagus3x: raises $0.55 to $0.80
KeLevro0: folds 
chiyuki: raises $1.55 to $2.35
Tom1999: folds 
Loholov: folds 
4plankton: folds 
4thepeople: calls $2.35
led52: folds 
cofla tito: folds 
Nagus3x: calls $1.55
*** FLOP *** [Kd 3c 2d]
Nagus3x: checks 
chiyuki: checks 
4thepeople: bets $1.75
Nagus3x: folds 
chiyuki: calls $1.75
*** TURN *** [Kd 3c 2d] [8h]
chiyuki: checks 
4thepeople: bets $5
chiyuki: folds 
Uncalled bet ($5) returned to 4thepeople
4thepeople collected $10.41 from pot
4thepeople: doesn't show hand 
*** SUMMARY ***
Total pot $10.90 | Rake $0.49 
Board [Kd 3c 2d 8h]
Seat 1: 4thepeople (button) collected ($10.41)
Seat 2: led52 (small blind) folded before Flop
Seat 3: cofla tito (big blind) folded before Flop
Seat 4: Nagus3x folded on the Flop
Seat 5: KeLevro0 folded before Flop (didn't bet)
Seat 6: chiyuki folded on the Turn
Seat 7: Tom1999 folded before Flop (didn't bet)
Seat 8: Loholov folded before Flop (didn't bet)
Seat 9: 4plankton folded before Flop (didn't bet)



PokerStars Zoom Hand #84299779239:  Hold'em No Limit ($0.10/$0.25) - 2012/08/05 14:42:41 JST [2012/08/05 1:42:41 ET]
Table 'Whirlpool' 9-max Seat #1 is the button
Seat 1: chiyuki ($30.01 in chips) 
Seat 2: Landybob ($38.01 in chips) 
Seat 3: KrystalAA ($23.99 in chips) 
Seat 4: Jene4kaBest ($10.45 in chips) 
Seat 5: Walturrr ($24.72 in chips) 
Seat 6: ChrisCDee ($72.22 in chips) 
Seat 7: stalkerec ($7.26 in chips) 
Seat 8: loca-loca888 ($50.50 in chips) 
Seat 9: snejokCoxx ($11.45 in chips) 
Landybob: posts small blind $0.10
KrystalAA: posts big blind $0.25
*** HOLE CARDS ***
Dealt to chiyuki [3c Qh]
Jene4kaBest: folds 
Walturrr: folds 
ChrisCDee: folds 
stalkerec: calls $0.25
loca-loca888: calls $0.25
snejokCoxx: folds 
chiyuki: folds 
Landybob: calls $0.15
KrystalAA: checks 
*** FLOP *** [4d Kh 9d]
Landybob: checks 
KrystalAA: checks 
stalkerec: checks 
loca-loca888: checks 
*** TURN *** [4d Kh 9d] [Ad]
Landybob: checks 
KrystalAA: checks 
stalkerec: checks 
loca-loca888: checks 
*** RIVER *** [4d Kh 9d Ad] [Kc]
Landybob: checks 
KrystalAA: checks 
stalkerec: checks 
loca-loca888: checks 
*** SHOW DOWN ***
Landybob: shows [Tc Jc] (a pair of Kings)
KrystalAA: mucks hand 
stalkerec: shows [8d 8s] (two pair, Kings and Eights)
loca-loca888: shows [Ah 3h] (two pair, Aces and Kings)
loca-loca888 collected $0.96 from pot
*** SUMMARY ***
Total pot $1 | Rake $0.04 
Board [4d Kh 9d Ad Kc]
Seat 1: chiyuki (button) folded before Flop (didn't bet)
Seat 2: Landybob (small blind) showed [Tc Jc] and lost with a pair of Kings
Seat 3: KrystalAA (big blind) mucked [6s 3s]
Seat 4: Jene4kaBest folded before Flop (didn't bet)
Seat 5: Walturrr folded before Flop (didn't bet)
Seat 6: ChrisCDee folded before Flop (didn't bet)
Seat 7: stalkerec showed [8d 8s] and lost with two pair, Kings and Eights
Seat 8: loca-loca888 showed [Ah 3h] and won ($0.96) with two pair, Aces and Kings
Seat 9: snejokCoxx folded before Flop (didn't bet)



PokerStars Zoom Hand #84299790649:  Hold'em No Limit ($0.10/$0.25) - 2012/08/05 14:43:27 JST [2012/08/05 1:43:27 ET]
Table 'Whirlpool' 9-max Seat #1 is the button
Seat 1: Dejacob ($25 in chips) 
Seat 2: KAKamiro ($28.35 in chips) 
Seat 3: chiyuki ($25.91 in chips) 
Seat 4: jacquelinewu ($27.32 in chips) 
Seat 5: Cyanidoff ($25.75 in chips) 
Seat 6: BlOnDhOlIc ($36.70 in chips) 
Seat 7: 4plankton ($30.01 in chips) 
Seat 8: deepakmbh ($37.87 in chips) 
Seat 9: hl77777 ($14.10 in chips) 
KAKamiro: posts small blind $0.10
chiyuki: posts big blind $0.25
*** HOLE CARDS ***
Dealt to chiyuki [6s 7h]
jacquelinewu has timed out
jacquelinewu: folds 
Cyanidoff: folds 
BlOnDhOlIc: folds 
4plankton: folds 
deepakmbh: raises $0.50 to $0.75
hl77777: folds 
Dejacob: folds 
KAKamiro: folds 
chiyuki: folds 
Uncalled bet ($0.50) returned to deepakmbh
deepakmbh collected $0.60 from pot
deepakmbh: doesn't show hand 
*** SUMMARY ***
Total pot $0.60 | Rake $0 
Seat 1: Dejacob (button) folded before Flop (didn't bet)
Seat 2: KAKamiro (small blind) folded before Flop
Seat 3: chiyuki (big blind) folded before Flop
Seat 4: jacquelinewu folded before Flop (didn't bet)
Seat 5: Cyanidoff folded before Flop (didn't bet)
Seat 6: BlOnDhOlIc folded before Flop (didn't bet)
Seat 7: 4plankton folded before Flop (didn't bet)
Seat 8: deepakmbh collected ($0.60)
Seat 9: hl77777 folded before Flop (didn't bet)



PokerStars Zoom Hand #84299798141:  Hold'em No Limit ($0.10/$0.25) - 2012/08/05 14:43:59 JST [2012/08/05 1:43:59 ET]
Table 'Whirlpool' 9-max Seat #1 is the button
Seat 1: led52 ($10.75 in chips) 
Seat 2: chiyuki ($25.66 in chips) 
Seat 3: snejokCoxx ($11.45 in chips) 
Seat 4: phate-1up ($57.04 in chips) 
Seat 5: Dejacob ($25 in chips) 
Seat 6: seula i ($30.61 in chips) 
Seat 7: Phaedrus...3 ($26.64 in chips) 
Seat 8: DanielWhyte ($49.54 in chips) 
Seat 9: fuguangps ($25.70 in chips) 
chiyuki: posts small blind $0.10
snejokCoxx: posts big blind $0.25
*** HOLE CARDS ***
Dealt to chiyuki [Th 4c]
phate-1up: raises $0.50 to $0.75
Dejacob: folds 
seula i: calls $0.75
Phaedrus...3: folds 
DanielWhyte: folds 
fuguangps: folds 
led52: folds 
chiyuki: folds 
snejokCoxx: folds 
*** FLOP *** [Kc Td 7d]
phate-1up: bets $1.25
seula i: folds 
Uncalled bet ($1.25) returned to phate-1up
phate-1up collected $1.77 from pot
phate-1up: doesn't show hand 
*** SUMMARY ***
Total pot $1.85 | Rake $0.08 
Board [Kc Td 7d]
Seat 1: led52 (button) folded before Flop (didn't bet)
Seat 2: chiyuki (small blind) folded before Flop
Seat 3: snejokCoxx (big blind) folded before Flop
Seat 4: phate-1up collected ($1.77)
Seat 5: Dejacob folded before Flop (didn't bet)
Seat 6: seula i folded on the Flop
Seat 7: Phaedrus...3 folded before Flop (didn't bet)
Seat 8: DanielWhyte folded before Flop (didn't bet)
Seat 9: fuguangps folded before Flop (didn't bet)



PokerStars Zoom Hand #84299804003:  Hold'em No Limit ($0.10/$0.25) - 2012/08/05 14:44:23 JST [2012/08/05 1:44:23 ET]
Table 'Whirlpool' 9-max Seat #1 is the button
Seat 1: cofla tito ($6.52 in chips) 
Seat 2: deadmoneykid ($24.75 in chips) 
Seat 3: Sal y Limon1 ($25.36 in chips) 
Seat 4: seula i ($29.86 in chips) 
Seat 5: chiyuki ($25.56 in chips) 
Seat 6: deepakmbh ($29.76 in chips) 
Seat 7: jacquelinewu ($25 in chips) 
Seat 8: Nerkit ($12.50 in chips) 
Seat 9: 1Karina1 ($45.07 in chips) 
deadmoneykid: posts small blind $0.10
Sal y Limon1: posts big blind $0.25
*** HOLE CARDS ***
Dealt to chiyuki [2h 7c]
seula i: folds 
chiyuki: folds 
deepakmbh: folds 
jacquelinewu: raises $0.50 to $0.75
Nerkit: folds 
1Karina1: folds 
cofla tito: folds 
deadmoneykid: folds 
Sal y Limon1: folds 
Uncalled bet ($0.50) returned to jacquelinewu
jacquelinewu collected $0.60 from pot
jacquelinewu: doesn't show hand 
*** SUMMARY ***
Total pot $0.60 | Rake $0 
Seat 1: cofla tito (button) folded before Flop (didn't bet)
Seat 2: deadmoneykid (small blind) folded before Flop
Seat 3: Sal y Limon1 (big blind) folded before Flop
Seat 4: seula i folded before Flop (didn't bet)
Seat 5: chiyuki folded before Flop (didn't bet)
Seat 6: deepakmbh folded before Flop (didn't bet)
Seat 7: jacquelinewu collected ($0.60)
Seat 8: Nerkit folded before Flop (didn't bet)
Seat 9: 1Karina1 folded before Flop (didn't bet)



PokerStars Zoom Hand #84299799143:  Hold'em No Limit ($0.10/$0.25) - 2012/08/05 14:44:03 JST [2012/08/05 1:44:03 ET]
Table 'Whirlpool' 9-max Seat #1 is the button
Seat 1: Nerkit ($12.60 in chips) 
Seat 2: troublesomm ($25 in chips) 
Seat 3: Jene4kaBest ($7.65 in chips) 
Seat 4: peng2astic ($14.25 in chips) 
Seat 5: a_tasmanian ($23.38 in chips) 
Seat 6: KeLevro0 ($10.87 in chips) 
Seat 7: chiyuki ($25.56 in chips) 
Seat 8: deepakmbh ($29.76 in chips) 
Seat 9: ChrisCDee ($30.99 in chips) 
troublesomm: posts small blind $0.10
Jene4kaBest: posts big blind $0.25
*** HOLE CARDS ***
Dealt to chiyuki [As 4h]
peng2astic: calls $0.25
a_tasmanian: calls $0.25
KeLevro0: folds 
chiyuki: folds 
deepakmbh: folds 
ChrisCDee: folds 
Nerkit: folds 
troublesomm: calls $0.15
Jene4kaBest: checks 
*** FLOP *** [8h 9s 4s]
troublesomm: checks 
Jene4kaBest: bets $0.50
peng2astic: calls $0.50
a_tasmanian: calls $0.50
troublesomm: folds 
*** TURN *** [8h 9s 4s] [6d]
Jene4kaBest: checks 
peng2astic: checks 
a_tasmanian: checks 
*** RIVER *** [8h 9s 4s 6d] [7s]
Jene4kaBest: checks 
peng2astic: checks 
a_tasmanian: checks 
*** SHOW DOWN ***
Jene4kaBest: shows [8s 3d] (a pair of Eights)
peng2astic: mucks hand 
a_tasmanian: shows [Ac 8c] (a pair of Eights - Ace kicker)
a_tasmanian collected $2.39 from pot
*** SUMMARY ***
Total pot $2.50 | Rake $0.11 
Board [8h 9s 4s 6d 7s]
Seat 1: Nerkit (button) folded before Flop (didn't bet)
Seat 2: troublesomm (small blind) folded on the Flop
Seat 3: Jene4kaBest (big blind) showed [8s 3d] and lost with a pair of Eights
Seat 4: peng2astic mucked [Ah 4d]
Seat 5: a_tasmanian showed [Ac 8c] and won ($2.39) with a pair of Eights
Seat 6: KeLevro0 folded before Flop (didn't bet)
Seat 7: chiyuki folded before Flop (didn't bet)
Seat 8: deepakmbh folded before Flop (didn't bet)
Seat 9: ChrisCDee folded before Flop (didn't bet)



PokerStars Zoom Hand #84299801057:  Hold'em No Limit ($0.10/$0.25) - 2012/08/05 14:44:11 JST [2012/08/05 1:44:11 ET]
Table 'Whirlpool' 9-max Seat #1 is the button
Seat 1: ChrisCDee ($37.43 in chips) 
Seat 2: phate-1up ($40.34 in chips) 
Seat 3: BlOnDhOlIc ($39.31 in chips) 
Seat 4: Walturrr ($35.65 in chips) 
Seat 5: KeLevro0 ($12.60 in chips) 
Seat 6: Sal y Limon1 ($25.36 in chips) 
Seat 7: Alvinpe85 ($63.49 in chips) 
Seat 8: chiyuki ($25.56 in chips) 
Seat 9: slapshot2011 ($33.38 in chips) 
phate-1up: posts small blind $0.10
BlOnDhOlIc: posts big blind $0.25
*** HOLE CARDS ***
Dealt to chiyuki [Jd 5s]
Walturrr: folds 
KeLevro0: folds 
Sal y Limon1: folds 
Alvinpe85: folds 
chiyuki: folds 
slapshot2011: folds 
ChrisCDee: raises $0.50 to $0.75
phate-1up: raises $1.50 to $2.25
BlOnDhOlIc: folds 
ChrisCDee: folds 
Uncalled bet ($1.50) returned to phate-1up
phate-1up collected $1.75 from pot
phate-1up: doesn't show hand 
*** SUMMARY ***
Total pot $1.75 | Rake $0 
Seat 1: ChrisCDee (button) folded before Flop
Seat 2: phate-1up (small blind) collected ($1.75)
Seat 3: BlOnDhOlIc (big blind) folded before Flop
Seat 4: Walturrr folded before Flop (didn't bet)
Seat 5: KeLevro0 folded before Flop (didn't bet)
Seat 6: Sal y Limon1 folded before Flop (didn't bet)
Seat 7: Alvinpe85 folded before Flop (didn't bet)
Seat 8: chiyuki folded before Flop (didn't bet)
Seat 9: slapshot2011 folded before Flop (didn't bet)



PokerStars Zoom Hand #84299805676:  Hold'em No Limit ($0.10/$0.25) - 2012/08/05 14:44:30 JST [2012/08/05 1:44:30 ET]
Table 'Whirlpool' 9-max Seat #1 is the button
Seat 1: canammark ($27.44 in chips) 
Seat 2: hl77777 ($13.85 in chips) 
Seat 3: cr0lox ($20.16 in chips) 
Seat 4: Sal y Limon1 ($25.50 in chips) 
Seat 5: 1Karina1 ($32.12 in chips) 
Seat 6: Vahe50 ($6 in chips) 
Seat 7: chiyuki ($25.56 in chips) 
Seat 8: Cyanidoff ($27.33 in chips) 
Seat 9: jacquelinewu ($25 in chips) 
hl77777: posts small blind $0.10
cr0lox: posts big blind $0.25
*** HOLE CARDS ***
Dealt to chiyuki [8s 7d]
Sal y Limon1: folds 
1Karina1: folds 
Vahe50: folds 
chiyuki: folds 
Cyanidoff: folds 
jacquelinewu: raises $0.50 to $0.75
canammark: folds 
hl77777: folds 
cr0lox: folds 
Uncalled bet ($0.50) returned to jacquelinewu
jacquelinewu collected $0.60 from pot
jacquelinewu: doesn't show hand 
*** SUMMARY ***
Total pot $0.60 | Rake $0 
Seat 1: canammark (button) folded before Flop (didn't bet)
Seat 2: hl77777 (small blind) folded before Flop
Seat 3: cr0lox (big blind) folded before Flop
Seat 4: Sal y Limon1 folded before Flop (didn't bet)
Seat 5: 1Karina1 folded before Flop (didn't bet)
Seat 6: Vahe50 folded before Flop (didn't bet)
Seat 7: chiyuki folded before Flop (didn't bet)
Seat 8: Cyanidoff folded before Flop (didn't bet)
Seat 9: jacquelinewu collected ($0.60)



PokerStars Zoom Hand #84299800039:  Hold'em No Limit ($0.10/$0.25) - 2012/08/05 14:44:07 JST [2012/08/05 1:44:07 ET]
Table 'Whirlpool' 9-max Seat #1 is the button
Seat 1: GovGus ($40.31 in chips) 
Seat 2: Perstenev ($13.51 in chips) 
Seat 3: igor*gemert ($23.22 in chips) 
Seat 4: Lars111 ($13.97 in chips) 
Seat 5: BlOnDhOlIc ($39.31 in chips) 
Seat 6: tribunpdm ($28.65 in chips) 
Seat 7: KeLevro0 ($12.60 in chips) 
Seat 8: slapshot2011 ($33.38 in chips) 
Seat 9: chiyuki ($25.56 in chips) 
Perstenev: posts small blind $0.10
igor*gemert: posts big blind $0.25
*** HOLE CARDS ***
Dealt to chiyuki [3s As]
Lars111: calls $0.25
BlOnDhOlIc: folds 
tribunpdm: folds 
KeLevro0: folds 
slapshot2011: folds 
chiyuki: folds 
GovGus: calls $0.25
Perstenev: folds 
igor*gemert: checks 
*** FLOP *** [Th Ad 6d]
igor*gemert: checks 
Lars111: bets $0.25
GovGus: calls $0.25
igor*gemert: folds 
*** TURN *** [Th Ad 6d] [7d]
Lars111: checks 
GovGus: checks 
*** RIVER *** [Th Ad 6d 7d] [4d]
Lars111: bets $0.25
GovGus: folds 
Uncalled bet ($0.25) returned to Lars111
Lars111 collected $1.29 from pot
Lars111: doesn't show hand 
*** SUMMARY ***
Total pot $1.35 | Rake $0.06 
Board [Th Ad 6d 7d 4d]
Seat 1: GovGus (button) folded on the River
Seat 2: Perstenev (small blind) folded before Flop
Seat 3: igor*gemert (big blind) folded on the Flop
Seat 4: Lars111 collected ($1.29)
Seat 5: BlOnDhOlIc folded before Flop (didn't bet)
Seat 6: tribunpdm folded before Flop (didn't bet)
Seat 7: KeLevro0 folded before Flop (didn't bet)
Seat 8: slapshot2011 folded before Flop (didn't bet)
Seat 9: chiyuki folded before Flop (didn't bet)



PokerStars Zoom Hand #84299806656:  Hold'em No Limit ($0.10/$0.25) - 2012/08/05 14:44:34 JST [2012/08/05 1:44:34 ET]
Table 'Whirlpool' 9-max Seat #1 is the button
Seat 1: chiyuki ($25.56 in chips) 
Seat 2: DanielWhyte ($49.54 in chips) 
Seat 3: hirozo ($26.33 in chips) 
Seat 4: deadmoneykid ($24.65 in chips) 
Seat 5: stalkerec ($8.45 in chips) 
Seat 6: 1Karina1 ($25.35 in chips) 
Seat 7: Walturrr ($35.55 in chips) 
Seat 8: ll_LaMeR_ll ($71.60 in chips) 
Seat 9: softdesign ($62.19 in chips) 
DanielWhyte: posts small blind $0.10
hirozo: posts big blind $0.25
*** HOLE CARDS ***
Dealt to chiyuki [2c 2h]
deadmoneykid: folds 
stalkerec: raises $0.50 to $0.75
1Karina1: folds 
Walturrr: folds 
ll_LaMeR_ll: raises $1.25 to $2
softdesign: folds 
chiyuki: folds 
DanielWhyte: folds 
hirozo: folds 
stalkerec: calls $1.25
*** FLOP *** [2s 3d Kh]
stalkerec: checks 
ll_LaMeR_ll: bets $2.50
stalkerec: folds 
Uncalled bet ($2.50) returned to ll_LaMeR_ll
ll_LaMeR_ll collected $4.15 from pot
ll_LaMeR_ll: doesn't show hand 
*** SUMMARY ***
Total pot $4.35 | Rake $0.20 
Board [2s 3d Kh]
Seat 1: chiyuki (button) folded before Flop (didn't bet)
Seat 2: DanielWhyte (small blind) folded before Flop
Seat 3: hirozo (big blind) folded before Flop
Seat 4: deadmoneykid folded before Flop (didn't bet)
Seat 5: stalkerec folded on the Flop
Seat 6: 1Karina1 folded before Flop (didn't bet)
Seat 7: Walturrr folded before Flop (didn't bet)
Seat 8: ll_LaMeR_ll collected ($4.15)
Seat 9: softdesign folded before Flop (didn't bet)



PokerStars Zoom Hand #84299797166:  Hold'em No Limit ($0.10/$0.25) - 2012/08/05 14:43:55 JST [2012/08/05 1:43:55 ET]
Table 'Whirlpool' 9-max Seat #1 is the button
Seat 1: deepakmbh ($29.76 in chips) 
Seat 2: KrystalAA ($23.74 in chips) 
Seat 3: igor*gemert ($25.95 in chips) 
Seat 4: chiyuki ($25.66 in chips) 
Seat 5: jacquelinewu ($25 in chips) 
Seat 6: Dejacob ($32.57 in chips) 
Seat 7: Tom1999 ($15 in chips) 
Seat 8: stalkerec ($8.32 in chips) 
Seat 9: BlOnDhOlIc ($86.69 in chips) 
KrystalAA: posts small blind $0.10
igor*gemert: posts big blind $0.25
*** HOLE CARDS ***
Dealt to chiyuki [8c Ad]
chiyuki: folds 
jacquelinewu: folds 
Dejacob: raises $0.50 to $0.75
Tom1999: calls $0.75
stalkerec: folds 
BlOnDhOlIc: folds 
deepakmbh: folds 
KrystalAA: calls $0.65
igor*gemert: folds 
*** FLOP *** [Qh 7c 5h]
KrystalAA: checks 
Dejacob: bets $2
Tom1999: calls $2
KrystalAA: calls $2
*** TURN *** [Qh 7c 5h] [3s]
KrystalAA: checks 
Dejacob: checks 
Tom1999: checks 
*** RIVER *** [Qh 7c 5h 3s] [Kc]
KrystalAA: checks 
Dejacob: checks 
Tom1999: checks 
*** SHOW DOWN ***
KrystalAA: shows [7s 8s] (a pair of Sevens)
Dejacob: shows [Tc Td] (a pair of Tens)
Tom1999: shows [9c Qc] (a pair of Queens)
Tom1999 collected $8.12 from pot
*** SUMMARY ***
Total pot $8.50 | Rake $0.38 
Board [Qh 7c 5h 3s Kc]
Seat 1: deepakmbh (button) folded before Flop (didn't bet)
Seat 2: KrystalAA (small blind) showed [7s 8s] and lost with a pair of Sevens
Seat 3: igor*gemert (big blind) folded before Flop
Seat 4: chiyuki folded before Flop (didn't bet)
Seat 5: jacquelinewu folded before Flop (didn't bet)
Seat 6: Dejacob showed [Tc Td] and lost with a pair of Tens
Seat 7: Tom1999 showed [9c Qc] and won ($8.12) with a pair of Queens
Seat 8: stalkerec folded before Flop (didn't bet)
Seat 9: BlOnDhOlIc folded before Flop (didn't bet)



PokerStars Zoom Hand #84299814287:  Hold'em No Limit ($0.10/$0.25) - 2012/08/05 14:45:06 JST [2012/08/05 1:45:06 ET]
Table 'Whirlpool' 9-max Seat #1 is the button
Seat 1: mjmichi ($25 in chips) 
Seat 2: hirozo ($32.68 in chips) 
Seat 3: chiyuki ($25.56 in chips) 
Seat 4: a_tasmanian ($25.02 in chips) 
Seat 5: Landybob ($37.01 in chips) 
Seat 6: Tom1999 ($20.37 in chips) 
Seat 7: GovGus ($39.81 in chips) 
Seat 8: deadmoneykid ($24.65 in chips) 
Seat 9: Walturrr ($35.55 in chips) 
hirozo: posts small blind $0.10
chiyuki: posts big blind $0.25
*** HOLE CARDS ***
Dealt to chiyuki [6d 9s]
a_tasmanian: folds 
Landybob: folds 
Tom1999: folds 
GovGus: folds 
deadmoneykid: raises $0.35 to $0.60
Walturrr: folds 
mjmichi: folds 
hirozo: folds 
chiyuki: folds 
Uncalled bet ($0.35) returned to deadmoneykid
deadmoneykid collected $0.60 from pot
deadmoneykid: doesn't show hand 
*** SUMMARY ***
Total pot $0.60 | Rake $0 
Seat 1: mjmichi (button) folded before Flop (didn't bet)
Seat 2: hirozo (small blind) folded before Flop
Seat 3: chiyuki (big blind) folded before Flop
Seat 4: a_tasmanian folded before Flop (didn't bet)
Seat 5: Landybob folded before Flop (didn't bet)
Seat 6: Tom1999 folded before Flop (didn't bet)
Seat 7: GovGus folded before Flop (didn't bet)
Seat 8: deadmoneykid collected ($0.60)
Seat 9: Walturrr folded before Flop (didn't bet)



PokerStars Zoom Hand #84299811649:  Hold'em No Limit ($0.10/$0.25) - 2012/08/05 14:44:55 JST [2012/08/05 1:44:55 ET]
Table 'Whirlpool' 9-max Seat #1 is the button
Seat 1: KimPa39 ($26.10 in chips) 
Seat 2: mjmichi ($25.10 in chips) 
Seat 3: tkd_joker ($24.65 in chips) 
Seat 4: dushvan ($41.94 in chips) 
Seat 5: Alvinpe85 ($63.59 in chips) 
Seat 6: chiyuki ($25.56 in chips) 
Seat 7: igor*gemert ($25.95 in chips) 
Seat 8: WARIBANA7777 ($17.76 in chips) 
Seat 9: 4plankton ($29.66 in chips) 
mjmichi: posts small blind $0.10
tkd_joker: posts big blind $0.25
*** HOLE CARDS ***
Dealt to chiyuki [2s Ah]
dushvan: folds 
Alvinpe85: folds 
chiyuki: folds 
igor*gemert: folds 
WARIBANA7777: folds 
4plankton: calls $0.25
KimPa39: folds 
mjmichi: raises $0.75 to $1
tkd_joker: folds 
4plankton: calls $0.75
*** FLOP *** [2h 5d 9s]
mjmichi: bets $1.50
4plankton: folds 
Uncalled bet ($1.50) returned to mjmichi
mjmichi collected $2.15 from pot
mjmichi: doesn't show hand 
*** SUMMARY ***
Total pot $2.25 | Rake $0.10 
Board [2h 5d 9s]
Seat 1: KimPa39 (button) folded before Flop (didn't bet)
Seat 2: mjmichi (small blind) collected ($2.15)
Seat 3: tkd_joker (big blind) folded before Flop
Seat 4: dushvan folded before Flop (didn't bet)
Seat 5: Alvinpe85 folded before Flop (didn't bet)
Seat 6: chiyuki folded before Flop (didn't bet)
Seat 7: igor*gemert folded before Flop (didn't bet)
Seat 8: WARIBANA7777 folded before Flop (didn't bet)
Seat 9: 4plankton folded on the Flop



PokerStars Zoom Hand #84299813080:  Hold'em No Limit ($0.10/$0.25) - 2012/08/05 14:45:01 JST [2012/08/05 1:45:01 ET]
Table 'Whirlpool' 9-max Seat #1 is the button
Seat 1: hl77777 ($8.92 in chips) 
Seat 2: seula i ($29.61 in chips) 
Seat 3: KimPa39 ($26.10 in chips) 
Seat 4: igor*gemert ($25.95 in chips) 
Seat 5: Perstenev ($14.22 in chips) 
Seat 6: Alvinpe85 ($63.59 in chips) 
Seat 7: WARIBANA7777 ($17.76 in chips) 
Seat 8: fuguangps ($25.60 in chips) 
Seat 9: chiyuki ($25.56 in chips) 
seula i: posts small blind $0.10
KimPa39: posts big blind $0.25
*** HOLE CARDS ***
Dealt to chiyuki [Kh 9h]
igor*gemert: folds 
Perstenev: folds 
Alvinpe85: folds 
WARIBANA7777: folds 
fuguangps: folds 
chiyuki: folds 
hl77777: raises $0.50 to $0.75
seula i: folds 
KimPa39: calls $0.50
*** FLOP *** [Jc 9s 7c]
KimPa39: checks 
hl77777: bets $1
KimPa39: folds 
Uncalled bet ($1) returned to hl77777
hl77777 collected $1.53 from pot
hl77777: doesn't show hand 
*** SUMMARY ***
Total pot $1.60 | Rake $0.07 
Board [Jc 9s 7c]
Seat 1: hl77777 (button) collected ($1.53)
Seat 2: seula i (small blind) folded before Flop
Seat 3: KimPa39 (big blind) folded on the Flop
Seat 4: igor*gemert folded before Flop (didn't bet)
Seat 5: Perstenev folded before Flop (didn't bet)
Seat 6: Alvinpe85 folded before Flop (didn't bet)
Seat 7: WARIBANA7777 folded before Flop (didn't bet)
Seat 8: fuguangps folded before Flop (didn't bet)
Seat 9: chiyuki folded before Flop (didn't bet)



PokerStars Zoom Hand #84299810642:  Hold'em No Limit ($0.10/$0.25) - 2012/08/05 14:44:51 JST [2012/08/05 1:44:51 ET]
Table 'Whirlpool' 9-max Seat #1 is the button
Seat 1: tkd_joker ($24.65 in chips) 
Seat 2: jacquelinewu ($25.35 in chips) 
Seat 3: Nerkit ($12.30 in chips) 
Seat 4: 1Karina1 ($32.12 in chips) 
Seat 5: chiyuki ($25.56 in chips) 
Seat 6: troublesomm ($25 in chips) 
Seat 7: phate-1up ($33.81 in chips) 
Seat 8: bigred1102 ($22.11 in chips) 
Seat 9: WARIBANA7777 ($17.76 in chips) 
jacquelinewu: posts small blind $0.10
Nerkit: posts big blind $0.25
*** HOLE CARDS ***
Dealt to chiyuki [Ts 9s]
1Karina1: folds 
chiyuki: folds 
troublesomm: folds 
phate-1up: raises $0.50 to $0.75
bigred1102: calls $0.75
WARIBANA7777: folds 
tkd_joker: folds 
jacquelinewu: calls $0.65
Nerkit: folds 
*** FLOP *** [6d Kh 3d]
jacquelinewu: checks 
phate-1up: bets $1.50
bigred1102: folds 
jacquelinewu: folds 
Uncalled bet ($1.50) returned to phate-1up
phate-1up collected $2.39 from pot
phate-1up: doesn't show hand 
*** SUMMARY ***
Total pot $2.50 | Rake $0.11 
Board [6d Kh 3d]
Seat 1: tkd_joker (button) folded before Flop (didn't bet)
Seat 2: jacquelinewu (small blind) folded on the Flop
Seat 3: Nerkit (big blind) folded before Flop
Seat 4: 1Karina1 folded before Flop (didn't bet)
Seat 5: chiyuki folded before Flop (didn't bet)
Seat 6: troublesomm folded before Flop (didn't bet)
Seat 7: phate-1up collected ($2.39)
Seat 8: bigred1102 folded on the Flop
Seat 9: WARIBANA7777 folded before Flop (didn't bet)



PokerStars Zoom Hand #84299816910:  Hold'em No Limit ($0.10/$0.25) - 2012/08/05 14:45:17 JST [2012/08/05 1:45:17 ET]
Table 'Whirlpool' 9-max Seat #1 is the button
Seat 1: fuguangps ($30.70 in chips) 
Seat 2: chiyuki ($25.31 in chips) 
Seat 3: Yogi707 ($17.24 in chips) 
Seat 4: mjmichi ($25 in chips) 
Seat 5: Jene4kaBest ($6.80 in chips) 
Seat 6: caro196661cv ($23.01 in chips) 
Seat 7: Nagus3x ($21.83 in chips) 
Seat 8: Sal y Limon1 ($25.40 in chips) 
Seat 9: phate-1up ($57.81 in chips) 
chiyuki: posts small blind $0.10
Yogi707: posts big blind $0.25
*** HOLE CARDS ***
Dealt to chiyuki [9s Ts]
mjmichi: folds 
Jene4kaBest: folds 
caro196661cv: folds 
Nagus3x: folds 
Sal y Limon1: folds 
phate-1up: folds 
fuguangps: folds 
chiyuki: raises $0.50 to $0.75
Yogi707: calls $0.50
*** FLOP *** [6c 2c 8s]
chiyuki: bets $0.71
Yogi707: calls $0.71
*** TURN *** [6c 2c 8s] [5c]
chiyuki: checks 
Yogi707: bets $1.39
chiyuki: folds 
Uncalled bet ($1.39) returned to Yogi707
Yogi707 collected $2.79 from pot
Yogi707: doesn't show hand 
*** SUMMARY ***
Total pot $2.92 | Rake $0.13 
Board [6c 2c 8s 5c]
Seat 1: fuguangps (button) folded before Flop (didn't bet)
Seat 2: chiyuki (small blind) folded on the Turn
Seat 3: Yogi707 (big blind) collected ($2.79)
Seat 4: mjmichi folded before Flop (didn't bet)
Seat 5: Jene4kaBest folded before Flop (didn't bet)
Seat 6: caro196661cv folded before Flop (didn't bet)
Seat 7: Nagus3x folded before Flop (didn't bet)
Seat 8: Sal y Limon1 folded before Flop (didn't bet)
Seat 9: phate-1up folded before Flop (didn't bet)



PokerStars Zoom Hand #84299823377:  Hold'em No Limit ($0.10/$0.25) - 2012/08/05 14:45:43 JST [2012/08/05 1:45:43 ET]
Table 'Whirlpool' 9-max Seat #1 is the button
Seat 1: chiyuki ($23.85 in chips) 
Seat 2: mjmichi ($25 in chips) 
Seat 3: snejokCoxx ($11.40 in chips) 
Seat 4: 1Karina1 ($25 in chips) 
Seat 5: KAKamiro ($25.58 in chips) 
Seat 6: laurentzu84 ($30.53 in chips) 
Seat 7: Cyanidoff ($25 in chips) 
Seat 8: rorfo23 ($26.59 in chips) 
Seat 9: tkd_joker ($24.30 in chips) 
mjmichi: posts small blind $0.10
snejokCoxx: posts big blind $0.25
*** HOLE CARDS ***
Dealt to chiyuki [Ts Qc]
1Karina1: folds 
KAKamiro: folds 
laurentzu84: folds 
Cyanidoff: folds 
rorfo23: folds 
tkd_joker: folds 
chiyuki: raises $0.50 to $0.75
mjmichi: folds 
snejokCoxx: folds 
Uncalled bet ($0.50) returned to chiyuki
chiyuki collected $0.60 from pot
chiyuki: doesn't show hand 
*** SUMMARY ***
Total pot $0.60 | Rake $0 
Seat 1: chiyuki (button) collected ($0.60)
Seat 2: mjmichi (small blind) folded before Flop
Seat 3: snejokCoxx (big blind) folded before Flop
Seat 4: 1Karina1 folded before Flop (didn't bet)
Seat 5: KAKamiro folded before Flop (didn't bet)
Seat 6: laurentzu84 folded before Flop (didn't bet)
Seat 7: Cyanidoff folded before Flop (didn't bet)
Seat 8: rorfo23 folded before Flop (didn't bet)
Seat 9: tkd_joker folded before Flop (didn't bet)



PokerStars Zoom Hand #84299830185:  Hold'em No Limit ($0.10/$0.25) - 2012/08/05 14:46:12 JST [2012/08/05 1:46:12 ET]
Table 'Whirlpool' 9-max Seat #1 is the button
Seat 1: slapshot2011 ($34.37 in chips) 
Seat 2: igor*gemert ($19.37 in chips) 
Seat 3: laurentzu84 ($30.53 in chips) 
Seat 4: KimPa39 ($25.25 in chips) 
Seat 5: cr0lox ($19.91 in chips) 
Seat 6: chiyuki ($24.20 in chips) 
Seat 7: softdesign ($61.69 in chips) 
Seat 8: snejokCoxx ($12.86 in chips) 
Seat 9: hirozo ($39.55 in chips) 
igor*gemert: posts small blind $0.10
laurentzu84: posts big blind $0.25
*** HOLE CARDS ***
Dealt to chiyuki [Js As]
KimPa39: folds 
cr0lox: folds 
chiyuki: raises $0.50 to $0.75
softdesign: folds 
snejokCoxx: folds 
hirozo: folds 
slapshot2011: folds 
igor*gemert: folds 
laurentzu84: folds 
Uncalled bet ($0.50) returned to chiyuki
chiyuki collected $0.60 from pot
chiyuki: doesn't show hand 
*** SUMMARY ***
Total pot $0.60 | Rake $0 
Seat 1: slapshot2011 (button) folded before Flop (didn't bet)
Seat 2: igor*gemert (small blind) folded before Flop
Seat 3: laurentzu84 (big blind) folded before Flop
Seat 4: KimPa39 folded before Flop (didn't bet)
Seat 5: cr0lox folded before Flop (didn't bet)
Seat 6: chiyuki collected ($0.60)
Seat 7: softdesign folded before Flop (didn't bet)
Seat 8: snejokCoxx folded before Flop (didn't bet)
Seat 9: hirozo folded before Flop (didn't bet)



PokerStars Zoom Hand #84299828534:  Hold'em No Limit ($0.10/$0.25) - 2012/08/05 14:46:05 JST [2012/08/05 1:46:05 ET]
Table 'Whirlpool' 9-max Seat #1 is the button
Seat 1: Perstenev ($19.32 in chips) 
Seat 2: igor*gemert ($25.70 in chips) 
Seat 3: ll_LaMeR_ll ($77.82 in chips) 
Seat 4: Jene4kaBest ($6.55 in chips) 
Seat 5: wildy29 ($11.94 in chips) 
Seat 6: seula i ($116.96 in chips) 
Seat 7: tkd_joker ($24.30 in chips) 
Seat 8: chiyuki ($24.20 in chips) 
Seat 9: KeLevro0 ($11.80 in chips) 
igor*gemert: posts small blind $0.10
ll_LaMeR_ll: posts big blind $0.25
*** HOLE CARDS ***
Dealt to chiyuki [9s Qh]
Jene4kaBest: folds 
wildy29: folds 
seula i: folds 
tkd_joker: folds 
chiyuki: folds 
KeLevro0: folds 
Perstenev: calls $0.25
igor*gemert: folds 
ll_LaMeR_ll: raises $0.75 to $1
Perstenev: calls $0.75
*** FLOP *** [9h 5c 7s]
ll_LaMeR_ll: bets $1.25
Perstenev: calls $1.25
*** TURN *** [9h 5c 7s] [Qd]
ll_LaMeR_ll: bets $2.50
Perstenev: folds 
Uncalled bet ($2.50) returned to ll_LaMeR_ll
ll_LaMeR_ll collected $4.39 from pot
ll_LaMeR_ll: doesn't show hand 
*** SUMMARY ***
Total pot $4.60 | Rake $0.21 
Board [9h 5c 7s Qd]
Seat 1: Perstenev (button) folded on the Turn
Seat 2: igor*gemert (small blind) folded before Flop
Seat 3: ll_LaMeR_ll (big blind) collected ($4.39)
Seat 4: Jene4kaBest folded before Flop (didn't bet)
Seat 5: wildy29 folded before Flop (didn't bet)
Seat 6: seula i folded before Flop (didn't bet)
Seat 7: tkd_joker folded before Flop (didn't bet)
Seat 8: chiyuki folded before Flop (didn't bet)
Seat 9: KeLevro0 folded before Flop (didn't bet)



PokerStars Zoom Hand #84299833949:  Hold'em No Limit ($0.10/$0.25) - 2012/08/05 14:46:27 JST [2012/08/05 1:46:27 ET]
Table 'Whirlpool' 9-max Seat #1 is the button
Seat 1: Landybob ($37.01 in chips) 
Seat 2: deadmoneykid ($25.10 in chips) 
Seat 3: phate-1up ($25 in chips) 
Seat 4: chiyuki ($24.55 in chips) 
Seat 5: Walturrr ($35.20 in chips) 
Seat 6: 1Karina1 ($25 in chips) 
Seat 7: canammark ($26.09 in chips) 
Seat 8: hirozo ($27.27 in chips) 
Seat 9: Nagus3x ($22.76 in chips) 
deadmoneykid: posts small blind $0.10
phate-1up: posts big blind $0.25
*** HOLE CARDS ***
Dealt to chiyuki [Qc Qd]
chiyuki: raises $0.50 to $0.75
Walturrr: folds 
1Karina1: folds 
canammark: folds 
hirozo: calls $0.75
Nagus3x: folds 
Landybob: calls $0.75
deadmoneykid: folds 
phate-1up: folds 
*** FLOP *** [As 7c Qs]
chiyuki: bets $1.50
hirozo: folds 
Landybob: calls $1.50
*** TURN *** [As 7c Qs] [9d]
chiyuki: bets $4
Landybob: folds 
Uncalled bet ($4) returned to chiyuki
chiyuki collected $5.35 from pot
chiyuki: doesn't show hand 
*** SUMMARY ***
Total pot $5.60 | Rake $0.25 
Board [As 7c Qs 9d]
Seat 1: Landybob (button) folded on the Turn
Seat 2: deadmoneykid (small blind) folded before Flop
Seat 3: phate-1up (big blind) folded before Flop
Seat 4: chiyuki collected ($5.35)
Seat 5: Walturrr folded before Flop (didn't bet)
Seat 6: 1Karina1 folded before Flop (didn't bet)
Seat 7: canammark folded before Flop (didn't bet)
Seat 8: hirozo folded on the Flop
Seat 9: Nagus3x folded before Flop (didn't bet)



PokerStars Zoom Hand #84299846965:  Hold'em No Limit ($0.10/$0.25) - 2012/08/05 14:47:21 JST [2012/08/05 1:47:21 ET]
Table 'Whirlpool' 9-max Seat #1 is the button
Seat 1: snejokCoxx ($13.21 in chips) 
Seat 2: jacquelinewu ($36.91 in chips) 
Seat 3: phate-1up ($56.96 in chips) 
Seat 4: Alvinpe85 ($61.94 in chips) 
Seat 5: pativyko ($18.59 in chips) 
Seat 6: led52 ($10.22 in chips) 
Seat 7: chiyuki ($27.65 in chips) 
Seat 8: hl77777 ($13.75 in chips) 
Seat 9: mjmichi ($40.02 in chips) 
jacquelinewu: posts small blind $0.10
phate-1up: posts big blind $0.25
*** HOLE CARDS ***
Dealt to chiyuki [Kd Qs]
Alvinpe85: folds 
pativyko: folds 
led52: folds 
chiyuki: raises $0.50 to $0.75
hl77777: folds 
mjmichi: calls $0.75
snejokCoxx: folds 
jacquelinewu: folds 
phate-1up: folds 
*** FLOP *** [6d 3d Tc]
chiyuki: bets $1
mjmichi: raises $1 to $2
chiyuki: folds 
Uncalled bet ($1) returned to mjmichi
mjmichi collected $3.68 from pot
mjmichi: doesn't show hand 
*** SUMMARY ***
Total pot $3.85 | Rake $0.17 
Board [6d 3d Tc]
Seat 1: snejokCoxx (button) folded before Flop (didn't bet)
Seat 2: jacquelinewu (small blind) folded before Flop
Seat 3: phate-1up (big blind) folded before Flop
Seat 4: Alvinpe85 folded before Flop (didn't bet)
Seat 5: pativyko folded before Flop (didn't bet)
Seat 6: led52 folded before Flop (didn't bet)
Seat 7: chiyuki folded on the Flop
Seat 8: hl77777 folded before Flop (didn't bet)
Seat 9: mjmichi collected ($3.68)



PokerStars Zoom Hand #84299863319:  Hold'em No Limit ($0.10/$0.25) - 2012/08/05 14:48:29 JST [2012/08/05 1:48:29 ET]
Table 'Whirlpool' 9-max Seat #1 is the button
Seat 1: troublesomm ($25 in chips) 
Seat 2: Ladyteazer ($29.84 in chips) 
Seat 3: led52 ($14.50 in chips) 
Seat 4: Dafleche ($14.30 in chips) 
Seat 5: 1Karina1 ($25 in chips) 
Seat 6: BlOnDhOlIc ($75.89 in chips) 
Seat 7: Dejacob ($26.47 in chips) 
Seat 8: snejokCoxx ($13.21 in chips) 
Seat 9: chiyuki ($25.90 in chips) 
Ladyteazer: posts small blind $0.10
led52: posts big blind $0.25
*** HOLE CARDS ***
Dealt to chiyuki [Kh 5s]
Dafleche: folds 
1Karina1: folds 
BlOnDhOlIc: raises $0.37 to $0.62
Dejacob: folds 
snejokCoxx: folds 
chiyuki: folds 
troublesomm: folds 
Ladyteazer: folds 
led52: folds 
Uncalled bet ($0.37) returned to BlOnDhOlIc
BlOnDhOlIc collected $0.60 from pot
BlOnDhOlIc: doesn't show hand 
*** SUMMARY ***
Total pot $0.60 | Rake $0 
Seat 1: troublesomm (button) folded before Flop (didn't bet)
Seat 2: Ladyteazer (small blind) folded before Flop
Seat 3: led52 (big blind) folded before Flop
Seat 4: Dafleche folded before Flop (didn't bet)
Seat 5: 1Karina1 folded before Flop (didn't bet)
Seat 6: BlOnDhOlIc collected ($0.60)
Seat 7: Dejacob folded before Flop (didn't bet)
Seat 8: snejokCoxx folded before Flop (didn't bet)
Seat 9: chiyuki folded before Flop (didn't bet)



PokerStars Zoom Hand #84299864516:  Hold'em No Limit ($0.10/$0.25) - 2012/08/05 14:48:34 JST [2012/08/05 1:48:34 ET]
Table 'Whirlpool' 9-max Seat #1 is the button
Seat 1: Perstenev ($16.37 in chips) 
Seat 2: Ellen1947 ($29.06 in chips) 
Seat 3: chiyuki ($25.90 in chips) 
Seat 4: phate-1up ($46.44 in chips) 
Seat 5: KrystalAA ($29.14 in chips) 
Seat 6: 4ydo yogurt ($12.20 in chips) 
Seat 7: mid22 ($8.47 in chips) 
Seat 8: seula i ($29.11 in chips) 
Seat 9: Ladyteazer ($29.74 in chips) 
Ellen1947: posts small blind $0.10
chiyuki: posts big blind $0.25
*** HOLE CARDS ***
Dealt to chiyuki [3d 7h]
phate-1up: folds 
KrystalAA: folds 
4ydo yogurt: raises $0.50 to $0.75
mid22: folds 
seula i: folds 
Ladyteazer: folds 
Perstenev: folds 
Ellen1947: folds 
chiyuki: folds 
Uncalled bet ($0.50) returned to 4ydo yogurt
4ydo yogurt collected $0.60 from pot
4ydo yogurt: doesn't show hand 
*** SUMMARY ***
Total pot $0.60 | Rake $0 
Seat 1: Perstenev (button) folded before Flop (didn't bet)
Seat 2: Ellen1947 (small blind) folded before Flop
Seat 3: chiyuki (big blind) folded before Flop
Seat 4: phate-1up folded before Flop (didn't bet)
Seat 5: KrystalAA folded before Flop (didn't bet)
Seat 6: 4ydo yogurt collected ($0.60)
Seat 7: mid22 folded before Flop (didn't bet)
Seat 8: seula i folded before Flop (didn't bet)
Seat 9: Ladyteazer folded before Flop (didn't bet)



PokerStars Zoom Hand #84299861857:  Hold'em No Limit ($0.10/$0.25) - 2012/08/05 14:48:22 JST [2012/08/05 1:48:22 ET]
Table 'Whirlpool' 9-max Seat #1 is the button
Seat 1: ZhukOFFskI ($35.90 in chips) 
Seat 2: pativyko ($18.69 in chips) 
Seat 3: Alvinpe85 ($44.82 in chips) 
Seat 4: jacquelinewu ($36.56 in chips) 
Seat 5: chiyuki ($25.90 in chips) 
Seat 6: led52 ($12.15 in chips) 
Seat 7: Ellen1947 ($29.06 in chips) 
Seat 8: 1Karina1 ($25 in chips) 
Seat 9: cofla tito ($12.02 in chips) 
pativyko: posts small blind $0.10
Alvinpe85: posts big blind $0.25
*** HOLE CARDS ***
Dealt to chiyuki [Qh 5s]
jacquelinewu: folds 
chiyuki: folds 
led52: folds 
Ellen1947: folds 
1Karina1: folds 
cofla tito: folds 
ZhukOFFskI: folds 
pativyko: calls $0.15
Alvinpe85: raises $0.75 to $1
pativyko: raises $0.75 to $1.75
Alvinpe85: calls $0.75
*** FLOP *** [Js 6h 5d]
pativyko: checks 
Alvinpe85: checks 
*** TURN *** [Js 6h 5d] [Tc]
pativyko: bets $2.25
Alvinpe85: calls $2.25
*** RIVER *** [Js 6h 5d Tc] [5c]
pativyko: checks 
Alvinpe85: checks 
*** SHOW DOWN ***
pativyko: shows [Ac Qd] (a pair of Fives)
Alvinpe85: shows [8s 8c] (two pair, Eights and Fives)
Alvinpe85 collected $7.64 from pot
*** SUMMARY ***
Total pot $8 | Rake $0.36 
Board [Js 6h 5d Tc 5c]
Seat 1: ZhukOFFskI (button) folded before Flop (didn't bet)
Seat 2: pativyko (small blind) showed [Ac Qd] and lost with a pair of Fives
Seat 3: Alvinpe85 (big blind) showed [8s 8c] and won ($7.64) with two pair, Eights and Fives
Seat 4: jacquelinewu folded before Flop (didn't bet)
Seat 5: chiyuki folded before Flop (didn't bet)
Seat 6: led52 folded before Flop (didn't bet)
Seat 7: Ellen1947 folded before Flop (didn't bet)
Seat 8: 1Karina1 folded before Flop (didn't bet)
Seat 9: cofla tito folded before Flop (didn't bet)



PokerStars Zoom Hand #84299875048:  Hold'em No Limit ($0.10/$0.25) - 2012/08/05 14:49:17 JST [2012/08/05 1:49:17 ET]
Table 'Whirlpool' 9-max Seat #1 is the button
Seat 1: cofla tito ($9.49 in chips) 
Seat 2: hl77777 ($14.50 in chips) 
Seat 3: rorfo23 ($22.74 in chips) 
Seat 4: troublesomm ($25 in chips) 
Seat 5: fuguangps ($25.25 in chips) 
Seat 6: chiyuki ($25.55 in chips) 
Seat 7: canammark ($24.90 in chips) 
Seat 8: led52 ($15.85 in chips) 
Seat 9: tkd_joker ($23.42 in chips) 
hl77777: posts small blind $0.10
rorfo23: posts big blind $0.25
*** HOLE CARDS ***
Dealt to chiyuki [3s 7s]
troublesomm: folds 
fuguangps: folds 
chiyuki: folds 
canammark: folds 
led52: folds 
tkd_joker: folds 
cofla tito: folds 
hl77777: folds 
Uncalled bet ($0.15) returned to rorfo23
rorfo23 collected $0.20 from pot
rorfo23: doesn't show hand 
*** SUMMARY ***
Total pot $0.20 | Rake $0 
Seat 1: cofla tito (button) folded before Flop (didn't bet)
Seat 2: hl77777 (small blind) folded before Flop
Seat 3: rorfo23 (big blind) collected ($0.20)
Seat 4: troublesomm folded before Flop (didn't bet)
Seat 5: fuguangps folded before Flop (didn't bet)
Seat 6: chiyuki folded before Flop (didn't bet)
Seat 7: canammark folded before Flop (didn't bet)
Seat 8: led52 folded before Flop (didn't bet)
Seat 9: tkd_joker folded before Flop (didn't bet)



PokerStars Zoom Hand #84299874308:  Hold'em No Limit ($0.10/$0.25) - 2012/08/05 14:49:14 JST [2012/08/05 1:49:14 ET]
Table 'Whirlpool' 9-max Seat #1 is the button
Seat 1: Wilcox76607 ($31.96 in chips) 
Seat 2: chiyuki ($25.65 in chips) 
Seat 3: GovGus ($28.18 in chips) 
Seat 4: mjmichi ($41.70 in chips) 
Seat 5: Phaedrus...3 ($25 in chips) 
Seat 6: KeLevro0 ($17.37 in chips) 
Seat 7: deadmoneykid ($22.05 in chips) 
Seat 8: KrystalAA ($17.41 in chips) 
Seat 9: 4plankton ($26.83 in chips) 
chiyuki: posts small blind $0.10
GovGus: posts big blind $0.25
*** HOLE CARDS ***
Dealt to chiyuki [8h 9c]
mjmichi: raises $0.50 to $0.75
Phaedrus...3: folds 
KeLevro0: folds 
deadmoneykid: folds 
KrystalAA: folds 
4plankton: folds 
Wilcox76607: folds 
chiyuki: folds 
GovGus: folds 
Uncalled bet ($0.50) returned to mjmichi
mjmichi collected $0.60 from pot
mjmichi: doesn't show hand 
*** SUMMARY ***
Total pot $0.60 | Rake $0 
Seat 1: Wilcox76607 (button) folded before Flop (didn't bet)
Seat 2: chiyuki (small blind) folded before Flop
Seat 3: GovGus (big blind) folded before Flop
Seat 4: mjmichi collected ($0.60)
Seat 5: Phaedrus...3 folded before Flop (didn't bet)
Seat 6: KeLevro0 folded before Flop (didn't bet)
Seat 7: deadmoneykid folded before Flop (didn't bet)
Seat 8: KrystalAA folded before Flop (didn't bet)
Seat 9: 4plankton folded before Flop (didn't bet)



PokerStars Zoom Hand #84299873020:  Hold'em No Limit ($0.10/$0.25) - 2012/08/05 14:49:09 JST [2012/08/05 1:49:09 ET]
Table 'Whirlpool' 9-max Seat #1 is the button
Seat 1: phate-1up ($72.41 in chips) 
Seat 2: seula i ($28.86 in chips) 
Seat 3: snejokCoxx ($13.21 in chips) 
Seat 4: mjmichi ($25 in chips) 
Seat 5: Walturrr ($26.16 in chips) 
Seat 6: troublesomm ($30.92 in chips) 
Seat 7: ZhukOFFskI ($28.03 in chips) 
Seat 8: chiyuki ($25.65 in chips) 
Seat 9: fuguangps ($32.09 in chips) 
seula i: posts small blind $0.10
snejokCoxx: posts big blind $0.25
*** HOLE CARDS ***
Dealt to chiyuki [2d 3s]
mjmichi: folds 
Walturrr: folds 
troublesomm: folds 
ZhukOFFskI: folds 
chiyuki: folds 
fuguangps: folds 
phate-1up: raises $0.50 to $0.75
seula i: calls $0.65
snejokCoxx: folds 
*** FLOP *** [Kh Td 6c]
seula i: checks 
phate-1up: checks 
*** TURN *** [Kh Td 6c] [Ah]
seula i: bets $1.50
phate-1up: folds 
Uncalled bet ($1.50) returned to seula i
seula i collected $1.67 from pot
seula i: doesn't show hand 
*** SUMMARY ***
Total pot $1.75 | Rake $0.08 
Board [Kh Td 6c Ah]
Seat 1: phate-1up (button) folded on the Turn
Seat 2: seula i (small blind) collected ($1.67)
Seat 3: snejokCoxx (big blind) folded before Flop
Seat 4: mjmichi folded before Flop (didn't bet)
Seat 5: Walturrr folded before Flop (didn't bet)
Seat 6: troublesomm folded before Flop (didn't bet)
Seat 7: ZhukOFFskI folded before Flop (didn't bet)
Seat 8: chiyuki folded before Flop (didn't bet)
Seat 9: fuguangps folded before Flop (didn't bet)



PokerStars Zoom Hand #84299877236:  Hold'em No Limit ($0.10/$0.25) - 2012/08/05 14:49:26 JST [2012/08/05 1:49:26 ET]
Table 'Whirlpool' 9-max Seat #1 is the button
Seat 1: chiyuki ($25.55 in chips) 
Seat 2: 1Karina1 ($25 in chips) 
Seat 3: troublesomm ($30.82 in chips) 
Seat 4: DanielWhyte ($47.07 in chips) 
Seat 5: KeLevro0 ($17.37 in chips) 
Seat 6: mrvalet841 ($25.42 in chips) 
Seat 7: Tom1999 ($25.29 in chips) 
Seat 8: KimPa39 ($24.50 in chips) 
Seat 9: Dan Royal ($45.29 in chips) 
1Karina1: posts small blind $0.10
troublesomm: posts big blind $0.25
*** HOLE CARDS ***
Dealt to chiyuki [Jh 8h]
DanielWhyte: folds 
KeLevro0: folds 
mrvalet841: folds 
Tom1999: folds 
KimPa39: raises $0.50 to $0.75
Dan Royal: folds 
chiyuki: folds 
1Karina1: folds 
troublesomm: folds 
Uncalled bet ($0.50) returned to KimPa39
KimPa39 collected $0.60 from pot
KimPa39: doesn't show hand 
*** SUMMARY ***
Total pot $0.60 | Rake $0 
Seat 1: chiyuki (button) folded before Flop (didn't bet)
Seat 2: 1Karina1 (small blind) folded before Flop
Seat 3: troublesomm (big blind) folded before Flop
Seat 4: DanielWhyte folded before Flop (didn't bet)
Seat 5: KeLevro0 folded before Flop (didn't bet)
Seat 6: mrvalet841 folded before Flop (didn't bet)
Seat 7: Tom1999 folded before Flop (didn't bet)
Seat 8: KimPa39 collected ($0.60)
Seat 9: Dan Royal folded before Flop (didn't bet)



PokerStars Zoom Hand #84299876274:  Hold'em No Limit ($0.10/$0.25) - 2012/08/05 14:49:22 JST [2012/08/05 1:49:22 ET]
Table 'Whirlpool' 9-max Seat #1 is the button
Seat 1: Tom1999 ($25.29 in chips) 
Seat 2: Nerkit ($11.83 in chips) 
Seat 3: hl77777 ($14.40 in chips) 
Seat 4: chiyuki ($25.55 in chips) 
Seat 5: ChrisCDee ($30.88 in chips) 
Seat 6: seula i ($29.86 in chips) 
Seat 7: colorado2108 ($15 in chips) 
Seat 8: mrvalet841 ($25.42 in chips) 
Seat 9: canammark ($24.90 in chips) 
Nerkit: posts small blind $0.10
hl77777: posts big blind $0.25
*** HOLE CARDS ***
Dealt to chiyuki [3d Kc]
chiyuki: folds 
ChrisCDee: folds 
seula i: folds 
colorado2108: calls $0.25
mrvalet841: folds 
canammark: folds 
Tom1999: folds 
Nerkit: folds 
hl77777: checks 
*** FLOP *** [9s Th 9d]
hl77777: checks 
colorado2108: checks 
*** TURN *** [9s Th 9d] [3c]
hl77777: bets $0.50
colorado2108: folds 
Uncalled bet ($0.50) returned to hl77777
hl77777 collected $0.57 from pot
hl77777: doesn't show hand 
*** SUMMARY ***
Total pot $0.60 | Rake $0.03 
Board [9s Th 9d 3c]
Seat 1: Tom1999 (button) folded before Flop (didn't bet)
Seat 2: Nerkit (small blind) folded before Flop
Seat 3: hl77777 (big blind) collected ($0.57)
Seat 4: chiyuki folded before Flop (didn't bet)
Seat 5: ChrisCDee folded before Flop (didn't bet)
Seat 6: seula i folded before Flop (didn't bet)
Seat 7: colorado2108 folded on the Turn
Seat 8: mrvalet841 folded before Flop (didn't bet)
Seat 9: canammark folded before Flop (didn't bet)



PokerStars Zoom Hand #84299880848:  Hold'em No Limit ($0.10/$0.25) - 2012/08/05 14:49:42 JST [2012/08/05 1:49:42 ET]
Table 'Whirlpool' 9-max Seat #1 is the button
Seat 1: Dan Royal ($45.29 in chips) 
Seat 2: 1Karina1 ($25 in chips) 
Seat 3: seula i ($29.86 in chips) 
Seat 4: 4plankton ($26.73 in chips) 
Seat 5: Dejacob ($32.23 in chips) 
Seat 6: BlOnDhOlIc ($34.35 in chips) 
Seat 7: oktan60 ($10.87 in chips) 
Seat 8: chiyuki ($25.55 in chips) 
Seat 9: pativyko ($15.04 in chips) 
1Karina1: posts small blind $0.10
seula i: posts big blind $0.25
*** HOLE CARDS ***
Dealt to chiyuki [4d 2c]
4plankton: folds 
Dejacob: folds 
BlOnDhOlIc: folds 
oktan60: calls $0.25
chiyuki: folds 
pativyko: folds 
Dan Royal: folds 
1Karina1: folds 
seula i: raises $1 to $1.25
oktan60: calls $1
*** FLOP *** [Jh 7h Ac]
seula i: bets $1.50
oktan60: calls $1.50
*** TURN *** [Jh 7h Ac] [3d]
seula i: checks 
oktan60: bets $1.75
seula i: folds 
Uncalled bet ($1.75) returned to oktan60
oktan60 collected $5.35 from pot
oktan60: doesn't show hand 
*** SUMMARY ***
Total pot $5.60 | Rake $0.25 
Board [Jh 7h Ac 3d]
Seat 1: Dan Royal (button) folded before Flop (didn't bet)
Seat 2: 1Karina1 (small blind) folded before Flop
Seat 3: seula i (big blind) folded on the Turn
Seat 4: 4plankton folded before Flop (didn't bet)
Seat 5: Dejacob folded before Flop (didn't bet)
Seat 6: BlOnDhOlIc folded before Flop (didn't bet)
Seat 7: oktan60 collected ($5.35)
Seat 8: chiyuki folded before Flop (didn't bet)
Seat 9: pativyko folded before Flop (didn't bet)



PokerStars Zoom Hand #84299881803:  Hold'em No Limit ($0.10/$0.25) - 2012/08/05 14:49:46 JST [2012/08/05 1:49:46 ET]
Table 'Whirlpool' 9-max Seat #1 is the button
Seat 1: hirozo ($51.25 in chips) 
Seat 2: BlOnDhOlIc ($34.35 in chips) 
Seat 3: Jene4kaBest ($14.23 in chips) 
Seat 4: Cyanidoff ($25 in chips) 
Seat 5: troublesomm ($30.57 in chips) 
Seat 6: snejokCoxx ($12.50 in chips) 
Seat 7: chiyuki ($25.55 in chips) 
Seat 8: deadmoneykid ($24.50 in chips) 
Seat 9: Nerkit ($17.48 in chips) 
BlOnDhOlIc: posts small blind $0.10
Jene4kaBest: posts big blind $0.25
*** HOLE CARDS ***
Dealt to chiyuki [3h 6c]
Cyanidoff: folds 
troublesomm: raises $0.50 to $0.75
snejokCoxx: folds 
chiyuki: folds 
deadmoneykid: folds 
Nerkit: folds 
hirozo: folds 
BlOnDhOlIc: folds 
Jene4kaBest: calls $0.50
*** FLOP *** [6d 7s Th]
Jene4kaBest: checks 
troublesomm: bets $1.13
Jene4kaBest: folds 
Uncalled bet ($1.13) returned to troublesomm
troublesomm collected $1.53 from pot
troublesomm: doesn't show hand 
*** SUMMARY ***
Total pot $1.60 | Rake $0.07 
Board [6d 7s Th]
Seat 1: hirozo (button) folded before Flop (didn't bet)
Seat 2: BlOnDhOlIc (small blind) folded before Flop
Seat 3: Jene4kaBest (big blind) folded on the Flop
Seat 4: Cyanidoff folded before Flop (didn't bet)
Seat 5: troublesomm collected ($1.53)
Seat 6: snejokCoxx folded before Flop (didn't bet)
Seat 7: chiyuki folded before Flop (didn't bet)
Seat 8: deadmoneykid folded before Flop (didn't bet)
Seat 9: Nerkit folded before Flop (didn't bet)



PokerStars Zoom Hand #84299882765:  Hold'em No Limit ($0.10/$0.25) - 2012/08/05 14:49:50 JST [2012/08/05 1:49:50 ET]
Table 'Whirlpool' 9-max Seat #1 is the button
Seat 1: Cyanidoff ($25 in chips) 
Seat 2: Perstenev ($12.37 in chips) 
Seat 3: chiyuki ($25.55 in chips) 
Seat 4: jacquelinewu ($25 in chips) 
Seat 5: yane73 ($39.16 in chips) 
Seat 6: seula i ($116.71 in chips) 
Seat 7: KrystalAA ($14.86 in chips) 
Seat 8: KeLevro0 ($14.73 in chips) 
Seat 9: Ladyteazer ($29.74 in chips) 
Perstenev: posts small blind $0.10
chiyuki: posts big blind $0.25
*** HOLE CARDS ***
Dealt to chiyuki [5s Qs]
jacquelinewu: folds 
yane73: folds 
seula i: folds 
KrystalAA: folds 
KeLevro0: folds 
Ladyteazer: raises $0.75 to $1
Cyanidoff: folds 
Perstenev: folds 
chiyuki: folds 
Uncalled bet ($0.75) returned to Ladyteazer
Ladyteazer collected $0.60 from pot
Ladyteazer: doesn't show hand 
*** SUMMARY ***
Total pot $0.60 | Rake $0 
Seat 1: Cyanidoff (button) folded before Flop (didn't bet)
Seat 2: Perstenev (small blind) folded before Flop
Seat 3: chiyuki (big blind) folded before Flop
Seat 4: jacquelinewu folded before Flop (didn't bet)
Seat 5: yane73 folded before Flop (didn't bet)
Seat 6: seula i folded before Flop (didn't bet)
Seat 7: KrystalAA folded before Flop (didn't bet)
Seat 8: KeLevro0 folded before Flop (didn't bet)
Seat 9: Ladyteazer collected ($0.60)



PokerStars Zoom Hand #84299891349:  Hold'em No Limit ($0.10/$0.25) - 2012/08/05 14:50:24 JST [2012/08/05 1:50:24 ET]
Table 'Whirlpool' 9-max Seat #1 is the button
Seat 1: Ladyteazer ($30.09 in chips) 
Seat 2: tribunpdm ($31.87 in chips) 
Seat 3: Wilcox76607 ($38.66 in chips) 
Seat 4: Nerkit ($10.73 in chips) 
Seat 5: ZhukOFFskI ($35.90 in chips) 
Seat 6: Dafleche ($18.52 in chips) 
Seat 7: BlOnDhOlIc ($34 in chips) 
Seat 8: snejokCoxx ($10.80 in chips) 
Seat 9: chiyuki ($25.20 in chips) 
tribunpdm: posts small blind $0.10
Wilcox76607: posts big blind $0.25
*** HOLE CARDS ***
Dealt to chiyuki [Kd 4c]
Nerkit: folds 
ZhukOFFskI: folds 
Dafleche: raises $0.25 to $0.50
BlOnDhOlIc: folds 
snejokCoxx: folds 
chiyuki: folds 
Ladyteazer: folds 
tribunpdm: folds 
Wilcox76607: folds 
Uncalled bet ($0.25) returned to Dafleche
Dafleche collected $0.60 from pot
Dafleche: doesn't show hand 
*** SUMMARY ***
Total pot $0.60 | Rake $0 
Seat 1: Ladyteazer (button) folded before Flop (didn't bet)
Seat 2: tribunpdm (small blind) folded before Flop
Seat 3: Wilcox76607 (big blind) folded before Flop
Seat 4: Nerkit folded before Flop (didn't bet)
Seat 5: ZhukOFFskI folded before Flop (didn't bet)
Seat 6: Dafleche collected ($0.60)
Seat 7: BlOnDhOlIc folded before Flop (didn't bet)
Seat 8: snejokCoxx folded before Flop (didn't bet)
Seat 9: chiyuki folded before Flop (didn't bet)



PokerStars Zoom Hand #84299895345:  Hold'em No Limit ($0.10/$0.25) - 2012/08/05 14:50:40 JST [2012/08/05 1:50:40 ET]
Table 'Whirlpool' 9-max Seat #1 is the button
Seat 1: 4ydo yogurt ($11.55 in chips) 
Seat 2: ChrisCDee ($35.14 in chips) 
Seat 3: Sal y Limon1 ($25.08 in chips) 
Seat 4: hl77777 ($15.07 in chips) 
Seat 5: chiyuki ($25.20 in chips) 
Seat 6: Dafleche ($18.87 in chips) 
Seat 7: Perstenev ($12.27 in chips) 
Seat 8: led52 ($11.15 in chips) 
Seat 9: phate-1up ($46.09 in chips) 
ChrisCDee: posts small blind $0.10
Sal y Limon1: posts big blind $0.25
*** HOLE CARDS ***
Dealt to chiyuki [Ts Kc]
hl77777: folds 
chiyuki: folds 
Dafleche: folds 
Perstenev: folds 
led52: folds 
phate-1up: folds 
4ydo yogurt: folds 
ChrisCDee: folds 
Uncalled bet ($0.15) returned to Sal y Limon1
Sal y Limon1 collected $0.20 from pot
Sal y Limon1: doesn't show hand 
*** SUMMARY ***
Total pot $0.20 | Rake $0 
Seat 1: 4ydo yogurt (button) folded before Flop (didn't bet)
Seat 2: ChrisCDee (small blind) folded before Flop
Seat 3: Sal y Limon1 (big blind) collected ($0.20)
Seat 4: hl77777 folded before Flop (didn't bet)
Seat 5: chiyuki folded before Flop (didn't bet)
Seat 6: Dafleche folded before Flop (didn't bet)
Seat 7: Perstenev folded before Flop (didn't bet)
Seat 8: led52 folded before Flop (didn't bet)
Seat 9: phate-1up folded before Flop (didn't bet)



PokerStars Zoom Hand #84299892376:  Hold'em No Limit ($0.10/$0.25) - 2012/08/05 14:50:28 JST [2012/08/05 1:50:28 ET]
Table 'Whirlpool' 9-max Seat #1 is the button
Seat 1: Perstenev ($11.67 in chips) 
Seat 2: KeLevro0 ($11.90 in chips) 
Seat 3: HighDuka ($27.74 in chips) 
Seat 4: led52 ($12.15 in chips) 
Seat 5: seula i ($116.61 in chips) 
Seat 6: chiyuki ($25.20 in chips) 
Seat 7: ChrisCDee ($33.16 in chips) 
Seat 8: yane73 ($39.06 in chips) 
Seat 9: Nerkit ($10.24 in chips) 
KeLevro0: posts small blind $0.10
HighDuka: posts big blind $0.25
*** HOLE CARDS ***
Dealt to chiyuki [2h Ks]
led52: folds 
seula i: folds 
chiyuki: folds 
ChrisCDee: folds 
yane73: raises $0.50 to $0.75
Nerkit: folds 
Perstenev: folds 
KeLevro0: folds 
HighDuka: calls $0.50
*** FLOP *** [9c Kd Qs]
HighDuka: checks 
yane73: bets $1.25
HighDuka: folds 
Uncalled bet ($1.25) returned to yane73
yane73 collected $1.53 from pot
yane73: doesn't show hand 
*** SUMMARY ***
Total pot $1.60 | Rake $0.07 
Board [9c Kd Qs]
Seat 1: Perstenev (button) folded before Flop (didn't bet)
Seat 2: KeLevro0 (small blind) folded before Flop
Seat 3: HighDuka (big blind) folded on the Flop
Seat 4: led52 folded before Flop (didn't bet)
Seat 5: seula i folded before Flop (didn't bet)
Seat 6: chiyuki folded before Flop (didn't bet)
Seat 7: ChrisCDee folded before Flop (didn't bet)
Seat 8: yane73 collected ($1.53)
Seat 9: Nerkit folded before Flop (didn't bet)



PokerStars Zoom Hand #84299890088:  Hold'em No Limit ($0.10/$0.25) - 2012/08/05 14:50:19 JST [2012/08/05 1:50:19 ET]
Table 'Whirlpool' 9-max Seat #1 is the button
Seat 1: jacquelinewu ($46.58 in chips) 
Seat 2: chiyuki ($25.30 in chips) 
Seat 3: Dejacob ($26.47 in chips) 
Seat 4: phate-1up ($29.48 in chips) 
Seat 5: led52 ($12.15 in chips) 
Seat 6: Ladyteazer ($30.09 in chips) 
Seat 7: BlOnDhOlIc ($34.49 in chips) 
Seat 8: deadmoneykid ($27.92 in chips) 
Seat 9: cofla tito ($9.52 in chips) 
chiyuki: posts small blind $0.10
Dejacob: posts big blind $0.25
*** HOLE CARDS ***
Dealt to chiyuki [4d Qc]
phate-1up: raises $0.50 to $0.75
led52: folds 
Ladyteazer: folds 
BlOnDhOlIc: folds 
deadmoneykid: folds 
cofla tito: calls $0.75
jacquelinewu: folds 
chiyuki: folds 
Dejacob: folds 
*** FLOP *** [4h 3h 3c]
phate-1up: checks 
cofla tito: checks 
*** TURN *** [4h 3h 3c] [Jh]
phate-1up: checks 
cofla tito: bets $0.50
phate-1up: calls $0.50
*** RIVER *** [4h 3h 3c Jh] [5s]
phate-1up: checks 
cofla tito: checks 
*** SHOW DOWN ***
phate-1up: shows [Ad Qd] (a pair of Threes)
cofla tito: shows [Qs Ah] (a pair of Threes)
phate-1up collected $1.36 from pot
cofla tito collected $1.36 from pot
*** SUMMARY ***
Total pot $2.85 | Rake $0.13 
Board [4h 3h 3c Jh 5s]
Seat 1: jacquelinewu (button) folded before Flop (didn't bet)
Seat 2: chiyuki (small blind) folded before Flop
Seat 3: Dejacob (big blind) folded before Flop
Seat 4: phate-1up showed [Ad Qd] and won ($1.36) with a pair of Threes
Seat 5: led52 folded before Flop (didn't bet)
Seat 6: Ladyteazer folded before Flop (didn't bet)
Seat 7: BlOnDhOlIc folded before Flop (didn't bet)
Seat 8: deadmoneykid folded before Flop (didn't bet)
Seat 9: cofla tito showed [Qs Ah] and won ($1.36) with a pair of Threes



PokerStars Zoom Hand #84299898563:  Hold'em No Limit ($0.10/$0.25) - 2012/08/05 14:50:54 JST [2012/08/05 1:50:54 ET]
Table 'Whirlpool' 9-max Seat #1 is the button
Seat 1: deadmoneykid ($27.92 in chips) 
Seat 2: jacquelinewu ($46.58 in chips) 
Seat 3: ZhukOFFskI ($28.81 in chips) 
Seat 4: Perstenev ($12.27 in chips) 
Seat 5: PillZ86 ($16.15 in chips) 
Seat 6: DanielWhyte ($46.72 in chips) 
Seat 7: chiyuki ($25.20 in chips) 
Seat 8: cofla tito ($9.24 in chips) 
Seat 9: 4ydo yogurt ($11.55 in chips) 
jacquelinewu: posts small blind $0.10
ZhukOFFskI: posts big blind $0.25
*** HOLE CARDS ***
Dealt to chiyuki [7h 6s]
Perstenev: folds 
PillZ86: folds 
DanielWhyte: folds 
chiyuki: folds 
cofla tito: folds 
4ydo yogurt: folds 
deadmoneykid: folds 
jacquelinewu: raises $0.50 to $0.75
ZhukOFFskI: folds 
Uncalled bet ($0.50) returned to jacquelinewu
jacquelinewu collected $0.50 from pot
jacquelinewu: doesn't show hand 
*** SUMMARY ***
Total pot $0.50 | Rake $0 
Seat 1: deadmoneykid (button) folded before Flop (didn't bet)
Seat 2: jacquelinewu (small blind) collected ($0.50)
Seat 3: ZhukOFFskI (big blind) folded before Flop
Seat 4: Perstenev folded before Flop (didn't bet)
Seat 5: PillZ86 folded before Flop (didn't bet)
Seat 6: DanielWhyte folded before Flop (didn't bet)
Seat 7: chiyuki folded before Flop (didn't bet)
Seat 8: cofla tito folded before Flop (didn't bet)
Seat 9: 4ydo yogurt folded before Flop (didn't bet)



PokerStars Zoom Hand #84299894559:  Hold'em No Limit ($0.10/$0.25) - 2012/08/05 14:50:37 JST [2012/08/05 1:50:37 ET]
Table 'Whirlpool' 9-max Seat #1 is the button
Seat 1: mjmichi ($25 in chips) 
Seat 2: deepakmbh ($23.27 in chips) 
Seat 3: troublesomm ($25.70 in chips) 
Seat 4: Perstenev ($13.81 in chips) 
Seat 5: chiyuki ($25.20 in chips) 
Seat 6: ZhukOFFskI ($28.81 in chips) 
Seat 7: Dejacob ($26.22 in chips) 
Seat 8: Tom1999 ($18.13 in chips) 
Seat 9: silvno31 ($24.80 in chips) 
deepakmbh: posts small blind $0.10
troublesomm: posts big blind $0.25
*** HOLE CARDS ***
Dealt to chiyuki [8s 3c]
Perstenev: folds 
chiyuki: folds 
ZhukOFFskI: folds 
Dejacob: folds 
Tom1999: folds 
silvno31: folds 
mjmichi: raises $0.50 to $0.75
deepakmbh: calls $0.65
troublesomm: folds 
*** FLOP *** [Ts 2s 9c]
deepakmbh: checks 
mjmichi: bets $1.25
deepakmbh: raises $2.50 to $3.75
mjmichi: folds 
Uncalled bet ($2.50) returned to deepakmbh
deepakmbh collected $4.06 from pot
deepakmbh: doesn't show hand 
*** SUMMARY ***
Total pot $4.25 | Rake $0.19 
Board [Ts 2s 9c]
Seat 1: mjmichi (button) folded on the Flop
Seat 2: deepakmbh (small blind) collected ($4.06)
Seat 3: troublesomm (big blind) folded before Flop
Seat 4: Perstenev folded before Flop (didn't bet)
Seat 5: chiyuki folded before Flop (didn't bet)
Seat 6: ZhukOFFskI folded before Flop (didn't bet)
Seat 7: Dejacob folded before Flop (didn't bet)
Seat 8: Tom1999 folded before Flop (didn't bet)
Seat 9: silvno31 folded before Flop (didn't bet)



PokerStars Zoom Hand #84299900529:  Hold'em No Limit ($0.10/$0.25) - 2012/08/05 14:51:02 JST [2012/08/05 1:51:02 ET]
Table 'Whirlpool' 9-max Seat #1 is the button
Seat 1: kamikkaze ($16.83 in chips) 
Seat 2: phate-1up ($45.84 in chips) 
Seat 3: deadmoneykid ($27.92 in chips) 
Seat 4: chiyuki ($25.20 in chips) 
Seat 5: el pore 5 ($26.18 in chips) 
Seat 6: yane73 ($39.84 in chips) 
Seat 7: KrystalAA ($14.86 in chips) 
Seat 8: Paranoix1990 ($23.17 in chips) 
Seat 9: pativyko ($14.79 in chips) 
phate-1up: posts small blind $0.10
deadmoneykid: posts big blind $0.25
*** HOLE CARDS ***
Dealt to chiyuki [Ks 6h]
chiyuki: folds 
el pore 5: folds 
yane73: folds 
KrystalAA: folds 
Paranoix1990: folds 
pativyko: folds 
kamikkaze: folds 
phate-1up: folds 
Uncalled bet ($0.15) returned to deadmoneykid
deadmoneykid collected $0.20 from pot
deadmoneykid: doesn't show hand 
*** SUMMARY ***
Total pot $0.20 | Rake $0 
Seat 1: kamikkaze (button) folded before Flop (didn't bet)
Seat 2: phate-1up (small blind) folded before Flop
Seat 3: deadmoneykid (big blind) collected ($0.20)
Seat 4: chiyuki folded before Flop (didn't bet)
Seat 5: el pore 5 folded before Flop (didn't bet)
Seat 6: yane73 folded before Flop (didn't bet)
Seat 7: KrystalAA folded before Flop (didn't bet)
Seat 8: Paranoix1990 folded before Flop (didn't bet)
Seat 9: pativyko folded before Flop (didn't bet)



PokerStars Zoom Hand #84299901784:  Hold'em No Limit ($0.10/$0.25) - 2012/08/05 14:51:07 JST [2012/08/05 1:51:07 ET]
Table 'Whirlpool' 9-max Seat #1 is the button
Seat 1: Perstenev ($13.56 in chips) 
Seat 2: HighDuka ($26.99 in chips) 
Seat 3: Jene4kaBest ($13.73 in chips) 
Seat 4: chiyuki ($25.20 in chips) 
Seat 5: GovGus ($35.50 in chips) 
Seat 6: slapshot2011 ($58.05 in chips) 
Seat 7: deadmoneykid ($29.50 in chips) 
Seat 8: edilson_ita ($30.45 in chips) 
Seat 9: jacquelinewu ($42.46 in chips) 
HighDuka: posts small blind $0.10
Jene4kaBest: posts big blind $0.25
*** HOLE CARDS ***
Dealt to chiyuki [7d 4c]
chiyuki: folds 
GovGus: folds 
slapshot2011: folds 
deadmoneykid: folds 
edilson_ita: folds 
jacquelinewu: folds 
Perstenev: folds 
HighDuka: raises $0.50 to $0.75
Jene4kaBest: folds 
Uncalled bet ($0.50) returned to HighDuka
HighDuka collected $0.50 from pot
HighDuka: doesn't show hand 
*** SUMMARY ***
Total pot $0.50 | Rake $0 
Seat 1: Perstenev (button) folded before Flop (didn't bet)
Seat 2: HighDuka (small blind) collected ($0.50)
Seat 3: Jene4kaBest (big blind) folded before Flop
Seat 4: chiyuki folded before Flop (didn't bet)
Seat 5: GovGus folded before Flop (didn't bet)
Seat 6: slapshot2011 folded before Flop (didn't bet)
Seat 7: deadmoneykid folded before Flop (didn't bet)
Seat 8: edilson_ita folded before Flop (didn't bet)
Seat 9: jacquelinewu folded before Flop (didn't bet)



PokerStars Zoom Hand #84299896638:  Hold'em No Limit ($0.10/$0.25) - 2012/08/05 14:50:46 JST [2012/08/05 1:50:46 ET]
Table 'Whirlpool' 9-max Seat #1 is the button
Seat 1: chiyuki ($25.20 in chips) 
Seat 2: phate-1up ($25.10 in chips) 
Seat 3: Nerkit ($10.24 in chips) 
Seat 4: troublesomm ($31.25 in chips) 
Seat 5: sparky5224 ($34.13 in chips) 
Seat 6: Cyanidoff ($25.78 in chips) 
Seat 7: hl77777 ($15.07 in chips) 
Seat 8: Perstenev ($11.67 in chips) 
Seat 9: colorado2108 ($15.10 in chips) 
phate-1up: posts small blind $0.10
Nerkit: posts big blind $0.25
*** HOLE CARDS ***
Dealt to chiyuki [2d Js]
troublesomm: folds 
sparky5224: calls $0.25
Cyanidoff: folds 
hl77777: folds 
Perstenev: folds 
colorado2108: calls $0.25
chiyuki: folds 
phate-1up: folds 
Nerkit: checks 
*** FLOP *** [7h 2c 8c]
Nerkit: checks 
sparky5224: checks 
colorado2108: bets $1
Nerkit: folds 
sparky5224: calls $1
*** TURN *** [7h 2c 8c] [5d]
sparky5224: bets $0.25
colorado2108: calls $0.25
*** RIVER *** [7h 2c 8c 5d] [4d]
sparky5224: bets $0.50
colorado2108: raises $2.25 to $2.75
sparky5224: calls $2.25
*** SHOW DOWN ***
colorado2108: shows [9d Th] (high card Ten)
sparky5224: shows [Kh 5s] (a pair of Fives)
sparky5224 collected $8.45 from pot
*** SUMMARY ***
Total pot $8.85 | Rake $0.40 
Board [7h 2c 8c 5d 4d]
Seat 1: chiyuki (button) folded before Flop (didn't bet)
Seat 2: phate-1up (small blind) folded before Flop
Seat 3: Nerkit (big blind) folded on the Flop
Seat 4: troublesomm folded before Flop (didn't bet)
Seat 5: sparky5224 showed [Kh 5s] and won ($8.45) with a pair of Fives
Seat 6: Cyanidoff folded before Flop (didn't bet)
Seat 7: hl77777 folded before Flop (didn't bet)
Seat 8: Perstenev folded before Flop (didn't bet)
Seat 9: colorado2108 showed [9d Th] and lost with high card Ten



PokerStars Zoom Hand #84299902742:  Hold'em No Limit ($0.10/$0.25) - 2012/08/05 14:51:11 JST [2012/08/05 1:51:11 ET]
Table 'Whirlpool' 9-max Seat #1 is the button
Seat 1: jacquelinewu ($25 in chips) 
Seat 2: wildy29 ($26.40 in chips) 
Seat 3: chiyuki ($25.20 in chips) 
Seat 4: seula i ($29.88 in chips) 
Seat 5: deadmoneykid ($24.82 in chips) 
Seat 6: hirozo ($40.15 in chips) 
Seat 7: GovGus ($29.49 in chips) 
Seat 8: phate-1up ($29.59 in chips) 
Seat 9: Ladyteazer ($29.74 in chips) 
wildy29: posts small blind $0.10
chiyuki: posts big blind $0.25
*** HOLE CARDS ***
Dealt to chiyuki [6c 2s]
seula i: raises $0.75 to $1
deadmoneykid: folds 
hirozo: folds 
GovGus: calls $1
phate-1up: raises $3.25 to $4.25
Ladyteazer: folds 
jacquelinewu: folds 
wildy29: folds 
chiyuki: folds 
seula i: folds 
GovGus: folds 
Uncalled bet ($3.25) returned to phate-1up
phate-1up collected $3.35 from pot
phate-1up: doesn't show hand 
*** SUMMARY ***
Total pot $3.35 | Rake $0 
Seat 1: jacquelinewu (button) folded before Flop (didn't bet)
Seat 2: wildy29 (small blind) folded before Flop
Seat 3: chiyuki (big blind) folded before Flop
Seat 4: seula i folded before Flop
Seat 5: deadmoneykid folded before Flop (didn't bet)
Seat 6: hirozo folded before Flop (didn't bet)
Seat 7: GovGus folded before Flop
Seat 8: phate-1up collected ($3.35)
Seat 9: Ladyteazer folded before Flop (didn't bet)



PokerStars Zoom Hand #84299913771:  Hold'em No Limit ($0.10/$0.25) - 2012/08/05 14:51:55 JST [2012/08/05 1:51:55 ET]
Table 'Whirlpool' 9-max Seat #1 is the button
Seat 1: cofla tito ($8.24 in chips) 
Seat 2: BlOnDhOlIc ($85.96 in chips) 
Seat 3: KeLevro0 ($11.93 in chips) 
Seat 4: Perstenev ($13.52 in chips) 
Seat 5: Dejacob ($32.33 in chips) 
Seat 6: phate-1up ($25.35 in chips) 
Seat 7: mjmichi ($25 in chips) 
Seat 8: led52 ($11.40 in chips) 
Seat 9: chiyuki ($24.85 in chips) 
BlOnDhOlIc: posts small blind $0.10
KeLevro0: posts big blind $0.25
*** HOLE CARDS ***
Dealt to chiyuki [4h 2s]
Perstenev: folds 
Dejacob: folds 
phate-1up: folds 
mjmichi: folds 
led52: folds 
chiyuki: folds 
cofla tito: folds 
BlOnDhOlIc: raises $0.25 to $0.50
KeLevro0: folds 
Uncalled bet ($0.25) returned to BlOnDhOlIc
BlOnDhOlIc collected $0.50 from pot
BlOnDhOlIc: doesn't show hand 
*** SUMMARY ***
Total pot $0.50 | Rake $0 
Seat 1: cofla tito (button) folded before Flop (didn't bet)
Seat 2: BlOnDhOlIc (small blind) collected ($0.50)
Seat 3: KeLevro0 (big blind) folded before Flop
Seat 4: Perstenev folded before Flop (didn't bet)
Seat 5: Dejacob folded before Flop (didn't bet)
Seat 6: phate-1up folded before Flop (didn't bet)
Seat 7: mjmichi folded before Flop (didn't bet)
Seat 8: led52 folded before Flop (didn't bet)
Seat 9: chiyuki folded before Flop (didn't bet)



PokerStars Zoom Hand #84299910584:  Hold'em No Limit ($0.10/$0.25) - 2012/08/05 14:51:42 JST [2012/08/05 1:51:42 ET]
Table 'Whirlpool' 9-max Seat #1 is the button
Seat 1: mid22 ($9.59 in chips) 
Seat 2: chiyuki ($24.95 in chips) 
Seat 3: rorfo23 ($21.24 in chips) 
Seat 4: Walturrr ($28.63 in chips) 
Seat 5: Tom1999 ($21.54 in chips) 
Seat 6: Dan Royal ($43.12 in chips) 
Seat 7: hirozo ($50.90 in chips) 
Seat 8: KeLevro0 ($12.15 in chips) 
Seat 9: Vahe50 ($11.93 in chips) 
chiyuki: posts small blind $0.10
rorfo23: posts big blind $0.25
*** HOLE CARDS ***
Dealt to chiyuki [6h Qs]
Walturrr: raises $0.47 to $0.72
Tom1999: folds 
Dan Royal: folds 
hirozo: folds 
KeLevro0: folds 
Vahe50: folds 
mid22: folds 
chiyuki: folds 
rorfo23: calls $0.47
*** FLOP *** [Jh 7s 2d]
rorfo23: checks 
Walturrr: bets $0.85
rorfo23: raises $1.40 to $2.25
Walturrr: folds 
Uncalled bet ($1.40) returned to rorfo23
rorfo23 collected $3.09 from pot
rorfo23: doesn't show hand 
*** SUMMARY ***
Total pot $3.24 | Rake $0.15 
Board [Jh 7s 2d]
Seat 1: mid22 (button) folded before Flop (didn't bet)
Seat 2: chiyuki (small blind) folded before Flop
Seat 3: rorfo23 (big blind) collected ($3.09)
Seat 4: Walturrr folded on the Flop
Seat 5: Tom1999 folded before Flop (didn't bet)
Seat 6: Dan Royal folded before Flop (didn't bet)
Seat 7: hirozo folded before Flop (didn't bet)
Seat 8: KeLevro0 folded before Flop (didn't bet)
Seat 9: Vahe50 folded before Flop (didn't bet)



PokerStars Zoom Hand #84299915529:  Hold'em No Limit ($0.10/$0.25) - 2012/08/05 14:52:02 JST [2012/08/05 1:52:02 ET]
Table 'Whirlpool' 9-max Seat #1 is the button
Seat 1: chiyuki ($24.85 in chips) 
Seat 2: 1Karina1 ($29.19 in chips) 
Seat 3: hirozo ($73.44 in chips) 
Seat 4: mjmichi ($41.95 in chips) 
Seat 5: ZhukOFFskI ($49.35 in chips) 
Seat 6: kamikkaze ($15 in chips) 
Seat 7: cofla tito ($8.24 in chips) 
Seat 8: DanielWhyte ($46.37 in chips) 
Seat 9: KrystalAA ($17.41 in chips) 
1Karina1: posts small blind $0.10
hirozo: posts big blind $0.25
*** HOLE CARDS ***
Dealt to chiyuki [Qc As]
mjmichi: folds 
ZhukOFFskI: folds 
kamikkaze: folds 
cofla tito: folds 
DanielWhyte: folds 
KrystalAA: raises $0.46 to $0.71
chiyuki: raises $1.46 to $2.17
1Karina1: folds 
hirozo: folds 
KrystalAA: calls $1.46
*** FLOP *** [4d Td 6s]
KrystalAA: checks 
chiyuki: bets $3.25
KrystalAA: calls $3.25
*** TURN *** [4d Td 6s] [Th]
KrystalAA: checks 
chiyuki: bets $15.50
KrystalAA: calls $11.99 and is all-in
Uncalled bet ($3.51) returned to chiyuki
*** RIVER *** [4d Td 6s Th] [9d]
*** SHOW DOWN ***
KrystalAA: shows [Qs Ts] (three of a kind, Tens)
chiyuki: mucks hand 
KrystalAA collected $33.59 from pot
*** SUMMARY ***
Total pot $35.17 | Rake $1.58 
Board [4d Td 6s Th 9d]
Seat 1: chiyuki (button) mucked [Qc As]
Seat 2: 1Karina1 (small blind) folded before Flop
Seat 3: hirozo (big blind) folded before Flop
Seat 4: mjmichi folded before Flop (didn't bet)
Seat 5: ZhukOFFskI folded before Flop (didn't bet)
Seat 6: kamikkaze folded before Flop (didn't bet)
Seat 7: cofla tito folded before Flop (didn't bet)
Seat 8: DanielWhyte folded before Flop (didn't bet)
Seat 9: KrystalAA showed [Qs Ts] and won ($33.59) with three of a kind, Tens



PokerStars Zoom Hand #84299932057:  Hold'em No Limit ($0.10/$0.25) - 2012/08/05 14:53:09 JST [2012/08/05 1:53:09 ET]
Table 'Whirlpool' 9-max Seat #1 is the button
Seat 1: DonSimonUsa ($20.67 in chips) 
Seat 2: jacquelinewu ($44.45 in chips) 
Seat 3: Cyanidoff ($28.15 in chips) 
Seat 4: ZhukOFFskI ($28.56 in chips) 
Seat 5: Jene4kaBest ($17.79 in chips) 
Seat 6: phate-1up ($31.94 in chips) 
Seat 7: led52 ($10.70 in chips) 
Seat 8: chiyuki ($25 in chips) 
Seat 9: dushvan ($37.72 in chips) 
jacquelinewu: posts small blind $0.10
Cyanidoff: posts big blind $0.25
*** HOLE CARDS ***
Dealt to chiyuki [9s 4s]
ZhukOFFskI: calls $0.25
Jene4kaBest: folds 
phate-1up: folds 
led52: folds 
chiyuki: folds 
dushvan: folds 
DonSimonUsa: folds 
jacquelinewu: folds 
Cyanidoff: checks 
*** FLOP *** [2c 3d Qd]
Cyanidoff: folds 
ZhukOFFskI collected $0.57 from pot
ZhukOFFskI: doesn't show hand 
*** SUMMARY ***
Total pot $0.60 | Rake $0.03 
Board [2c 3d Qd]
Seat 1: DonSimonUsa (button) folded before Flop (didn't bet)
Seat 2: jacquelinewu (small blind) folded before Flop
Seat 3: Cyanidoff (big blind) folded on the Flop
Seat 4: ZhukOFFskI collected ($0.57)
Seat 5: Jene4kaBest folded before Flop (didn't bet)
Seat 6: phate-1up folded before Flop (didn't bet)
Seat 7: led52 folded before Flop (didn't bet)
Seat 8: chiyuki folded before Flop (didn't bet)
Seat 9: dushvan folded before Flop (didn't bet)



PokerStars Zoom Hand #84299934541:  Hold'em No Limit ($0.10/$0.25) - 2012/08/05 14:53:20 JST [2012/08/05 1:53:20 ET]
Table 'Whirlpool' 9-max Seat #1 is the button
Seat 1: deadmoneykid ($28.27 in chips) 
Seat 2: dushvan ($37.72 in chips) 
Seat 3: hirozo ($53.76 in chips) 
Seat 4: KrystalAA ($28.13 in chips) 
Seat 5: Tom1999 ($28.33 in chips) 
Seat 6: Dejacob ($25 in chips) 
Seat 7: GovGus ($27.24 in chips) 
Seat 8: chiyuki ($25 in chips) 
Seat 9: Nerkit ($9.75 in chips) 
dushvan: posts small blind $0.10
hirozo: posts big blind $0.25
*** HOLE CARDS ***
Dealt to chiyuki [7h 8h]
KrystalAA: folds 
Tom1999: folds 
Dejacob: folds 
GovGus: folds 
chiyuki: folds 
Nerkit: folds 
deadmoneykid: folds 
dushvan: raises $0.50 to $0.75
hirozo: folds 
Uncalled bet ($0.50) returned to dushvan
dushvan collected $0.50 from pot
dushvan: doesn't show hand 
*** SUMMARY ***
Total pot $0.50 | Rake $0 
Seat 1: deadmoneykid (button) folded before Flop (didn't bet)
Seat 2: dushvan (small blind) collected ($0.50)
Seat 3: hirozo (big blind) folded before Flop
Seat 4: KrystalAA folded before Flop (didn't bet)
Seat 5: Tom1999 folded before Flop (didn't bet)
Seat 6: Dejacob folded before Flop (didn't bet)
Seat 7: GovGus folded before Flop (didn't bet)
Seat 8: chiyuki folded before Flop (didn't bet)
Seat 9: Nerkit folded before Flop (didn't bet)



PokerStars Zoom Hand #84299935816:  Hold'em No Limit ($0.10/$0.25) - 2012/08/05 14:53:25 JST [2012/08/05 1:53:25 ET]
Table 'Whirlpool' 9-max Seat #1 is the button
Seat 1: Nerkit ($9.75 in chips) 
Seat 2: Walturrr ($26.95 in chips) 
Seat 3: chiyuki ($25 in chips) 
Seat 4: troublesomm ($25 in chips) 
Seat 5: snejokCoxx ($12.25 in chips) 
Seat 6: HighDuka ($41.82 in chips) 
Seat 7: kamikkaze ($15.35 in chips) 
Seat 8: Tom1999 ($28.33 in chips) 
Seat 9: el pore 5 ($27.60 in chips) 
Walturrr: posts small blind $0.10
chiyuki: posts big blind $0.25
*** HOLE CARDS ***
Dealt to chiyuki [Jh 3h]
troublesomm: folds 
snejokCoxx: folds 
HighDuka: raises $0.50 to $0.75
kamikkaze: folds 
Tom1999: folds 
el pore 5: folds 
Nerkit: folds 
Walturrr: folds 
chiyuki: folds 
Uncalled bet ($0.50) returned to HighDuka
HighDuka collected $0.60 from pot
HighDuka: doesn't show hand 
*** SUMMARY ***
Total pot $0.60 | Rake $0 
Seat 1: Nerkit (button) folded before Flop (didn't bet)
Seat 2: Walturrr (small blind) folded before Flop
Seat 3: chiyuki (big blind) folded before Flop
Seat 4: troublesomm folded before Flop (didn't bet)
Seat 5: snejokCoxx folded before Flop (didn't bet)
Seat 6: HighDuka collected ($0.60)
Seat 7: kamikkaze folded before Flop (didn't bet)
Seat 8: Tom1999 folded before Flop (didn't bet)
Seat 9: el pore 5 folded before Flop (didn't bet)



PokerStars Zoom Hand #84299933063:  Hold'em No Limit ($0.10/$0.25) - 2012/08/05 14:53:13 JST [2012/08/05 1:53:13 ET]
Table 'Whirlpool' 9-max Seat #1 is the button
Seat 1: edilson_ita ($31.47 in chips) 
Seat 2: DonSimonUsa ($20.67 in chips) 
Seat 3: Tom1999 ($28.58 in chips) 
Seat 4: Walturrr ($33.49 in chips) 
Seat 5: KeLevro0 ($11.80 in chips) 
Seat 6: troublesomm ($25 in chips) 
Seat 7: chiyuki ($25 in chips) 
Seat 8: laurentzu84 ($37.20 in chips) 
Seat 9: BlOnDhOlIc ($83.06 in chips) 
DonSimonUsa: posts small blind $0.10
Tom1999: posts big blind $0.25
*** HOLE CARDS ***
Dealt to chiyuki [4h Kh]
Walturrr: folds 
KeLevro0: folds 
troublesomm: folds 
chiyuki: folds 
laurentzu84: folds 
BlOnDhOlIc: raises $0.37 to $0.62
edilson_ita: calls $0.62
DonSimonUsa: folds 
Tom1999: folds 
*** FLOP *** [8c 3d 6d]
BlOnDhOlIc: checks 
edilson_ita: bets $1
BlOnDhOlIc: folds 
Uncalled bet ($1) returned to edilson_ita
edilson_ita collected $1.52 from pot
edilson_ita: doesn't show hand 
*** SUMMARY ***
Total pot $1.59 | Rake $0.07 
Board [8c 3d 6d]
Seat 1: edilson_ita (button) collected ($1.52)
Seat 2: DonSimonUsa (small blind) folded before Flop
Seat 3: Tom1999 (big blind) folded before Flop
Seat 4: Walturrr folded before Flop (didn't bet)
Seat 5: KeLevro0 folded before Flop (didn't bet)
Seat 6: troublesomm folded before Flop (didn't bet)
Seat 7: chiyuki folded before Flop (didn't bet)
Seat 8: laurentzu84 folded before Flop (didn't bet)
Seat 9: BlOnDhOlIc folded on the Flop



PokerStars Zoom Hand #84299939927:  Hold'em No Limit ($0.10/$0.25) - 2012/08/05 14:53:42 JST [2012/08/05 1:53:42 ET]
Table 'Whirlpool' 9-max Seat #1 is the button
Seat 1: Sal y Limon1 ($24.75 in chips) 
Seat 2: chiyuki ($24.75 in chips) 
Seat 3: GovGus ($27.43 in chips) 
Seat 4: mjmichi ($25 in chips) 
Seat 5: Dejacob ($25 in chips) 
Seat 6: pativyko ($15.44 in chips) 
Seat 7: cofla tito ($8.24 in chips) 
Seat 8: ChrisCDee ($31.16 in chips) 
Seat 9: KrystalAA ($14.86 in chips) 
chiyuki: posts small blind $0.10
GovGus: posts big blind $0.25
*** HOLE CARDS ***
Dealt to chiyuki [8s 9d]
mjmichi: folds 
Dejacob: folds 
pativyko: raises $0.50 to $0.75
cofla tito: folds 
ChrisCDee: folds 
KrystalAA: folds 
Sal y Limon1: folds 
chiyuki: folds 
GovGus: folds 
Uncalled bet ($0.50) returned to pativyko
pativyko collected $0.60 from pot
pativyko: doesn't show hand 
*** SUMMARY ***
Total pot $0.60 | Rake $0 
Seat 1: Sal y Limon1 (button) folded before Flop (didn't bet)
Seat 2: chiyuki (small blind) folded before Flop
Seat 3: GovGus (big blind) folded before Flop
Seat 4: mjmichi folded before Flop (didn't bet)
Seat 5: Dejacob folded before Flop (didn't bet)
Seat 6: pativyko collected ($0.60)
Seat 7: cofla tito folded before Flop (didn't bet)
Seat 8: ChrisCDee folded before Flop (didn't bet)
Seat 9: KrystalAA folded before Flop (didn't bet)



PokerStars Zoom Hand #84299933769:  Hold'em No Limit ($0.10/$0.25) - 2012/08/05 14:53:17 JST [2012/08/05 1:53:17 ET]
Table 'Whirlpool' 9-max Seat #1 is the button
Seat 1: 1Karina1 ($25 in chips) 
Seat 2: mjmichi ($25.54 in chips) 
Seat 3: kesstukas25 ($15 in chips) 
Seat 4: HighDuka ($41.82 in chips) 
Seat 5: Ladyteazer ($28.66 in chips) 
Seat 6: chiyuki ($25 in chips) 
Seat 7: canammark ($23.90 in chips) 
Seat 8: seula i ($114.11 in chips) 
Seat 9: Phaedrus...3 ($25 in chips) 
mjmichi: posts small blind $0.10
kesstukas25: posts big blind $0.25
*** HOLE CARDS ***
Dealt to chiyuki [5h 6h]
HighDuka: folds 
Ladyteazer: raises $0.75 to $1
chiyuki: folds 
canammark: calls $1
seula i: folds 
Phaedrus...3: folds 
1Karina1: folds 
mjmichi: folds 
kesstukas25: folds 
*** FLOP *** [8c Jc 2h]
Ladyteazer: bets $1
canammark: raises $2.25 to $3.25
Ladyteazer: calls $2.25
*** TURN *** [8c Jc 2h] [7h]
Ladyteazer: checks 
canammark: bets $5
Ladyteazer: calls $5
*** RIVER *** [8c Jc 2h 7h] [5s]
Ladyteazer: checks 
canammark: bets $8.50
Ladyteazer: calls $8.50
*** SHOW DOWN ***
canammark: shows [Jd 8d] (two pair, Jacks and Eights)
Ladyteazer: mucks hand 
canammark collected $34.24 from pot
*** SUMMARY ***
Total pot $35.85 | Rake $1.61 
Board [8c Jc 2h 7h 5s]
Seat 1: 1Karina1 (button) folded before Flop (didn't bet)
Seat 2: mjmichi (small blind) folded before Flop
Seat 3: kesstukas25 (big blind) folded before Flop
Seat 4: HighDuka folded before Flop (didn't bet)
Seat 5: Ladyteazer mucked [Td Ts]
Seat 6: chiyuki folded before Flop (didn't bet)
Seat 7: canammark showed [Jd 8d] and won ($34.24) with two pair, Jacks and Eights
Seat 8: seula i folded before Flop (didn't bet)
Seat 9: Phaedrus...3 folded before Flop (didn't bet)



PokerStars Zoom Hand #84299942397:  Hold'em No Limit ($0.10/$0.25) - 2012/08/05 14:53:52 JST [2012/08/05 1:53:52 ET]
Table 'Whirlpool' 9-max Seat #1 is the button
Seat 1: Cyanidoff ($27.80 in chips) 
Seat 2: Perstenev ($16.08 in chips) 
Seat 3: softdesign ($66.09 in chips) 
Seat 4: BlOnDhOlIc ($88.77 in chips) 
Seat 5: chiyuki ($24.65 in chips) 
Seat 6: deepakmbh ($47.70 in chips) 
Seat 7: GovGus ($27.18 in chips) 
Seat 8: kesstukas25 ($14.65 in chips) 
Seat 9: ChrisCDee ($31.16 in chips) 
Perstenev: posts small blind $0.10
softdesign: posts big blind $0.25
*** HOLE CARDS ***
Dealt to chiyuki [Jd Kd]
BlOnDhOlIc: folds 
chiyuki: raises $0.50 to $0.75
deepakmbh: calls $0.75
GovGus: calls $0.75
kesstukas25: folds 
ChrisCDee: calls $0.75
Cyanidoff: calls $0.75
Perstenev: calls $0.65
softdesign: folds 
*** FLOP *** [2c Ah 8h]
Perstenev: checks 
chiyuki: checks 
deepakmbh: checks 
GovGus: checks 
ChrisCDee: checks 
Cyanidoff: checks 
*** TURN *** [2c Ah 8h] [8c]
Perstenev: checks 
chiyuki: checks 
deepakmbh: bets $3
GovGus: folds 
ChrisCDee: folds 
Cyanidoff: folds 
Perstenev: folds 
chiyuki: folds 
Uncalled bet ($3) returned to deepakmbh
deepakmbh collected $4.54 from pot
deepakmbh: doesn't show hand 
*** SUMMARY ***
Total pot $4.75 | Rake $0.21 
Board [2c Ah 8h 8c]
Seat 1: Cyanidoff (button) folded on the Turn
Seat 2: Perstenev (small blind) folded on the Turn
Seat 3: softdesign (big blind) folded before Flop
Seat 4: BlOnDhOlIc folded before Flop (didn't bet)
Seat 5: chiyuki folded on the Turn
Seat 6: deepakmbh collected ($4.54)
Seat 7: GovGus folded on the Turn
Seat 8: kesstukas25 folded before Flop (didn't bet)
Seat 9: ChrisCDee folded on the Turn



PokerStars Zoom Hand #84299959661:  Hold'em No Limit ($0.10/$0.25) - 2012/08/05 14:55:03 JST [2012/08/05 1:55:03 ET]
Table 'Whirlpool' 9-max Seat #1 is the button
Seat 1: deepakmbh ($11.86 in chips) 
Seat 2: Dejacob ($25 in chips) 
Seat 3: tribunpdm ($26.02 in chips) 
Seat 4: colorado2108 ($12.60 in chips) 
Seat 5: Cyanidoff ($25 in chips) 
Seat 6: chiyuki ($23.90 in chips) 
Seat 7: simonzez ($20.62 in chips) 
Seat 8: DonSimonUsa ($18.22 in chips) 
Seat 9: PAMBOS.L ($16.47 in chips) 
Dejacob: posts small blind $0.10
tribunpdm: posts big blind $0.25
*** HOLE CARDS ***
Dealt to chiyuki [As 8c]
colorado2108: folds 
Cyanidoff: folds 
chiyuki: folds 
simonzez: folds 
DonSimonUsa: folds 
PAMBOS.L: raises $0.25 to $0.50
deepakmbh: folds 
Dejacob: folds 
tribunpdm: folds 
Uncalled bet ($0.25) returned to PAMBOS.L
PAMBOS.L collected $0.60 from pot
PAMBOS.L: doesn't show hand 
*** SUMMARY ***
Total pot $0.60 | Rake $0 
Seat 1: deepakmbh (button) folded before Flop (didn't bet)
Seat 2: Dejacob (small blind) folded before Flop
Seat 3: tribunpdm (big blind) folded before Flop
Seat 4: colorado2108 folded before Flop (didn't bet)
Seat 5: Cyanidoff folded before Flop (didn't bet)
Seat 6: chiyuki folded before Flop (didn't bet)
Seat 7: simonzez folded before Flop (didn't bet)
Seat 8: DonSimonUsa folded before Flop (didn't bet)
Seat 9: PAMBOS.L collected ($0.60)



PokerStars Zoom Hand #84299962621:  Hold'em No Limit ($0.10/$0.25) - 2012/08/05 14:55:15 JST [2012/08/05 1:55:15 ET]
Table 'Whirlpool' 9-max Seat #1 is the button
Seat 1: chiyuki ($23.90 in chips) 
Seat 2: phate-1up ($30.72 in chips) 
Seat 3: turbotom122 ($12.50 in chips) 
Seat 4: troublesomm ($25.25 in chips) 
Seat 5: cofla tito ($7.99 in chips) 
Seat 6: Landybob ($41.17 in chips) 
Seat 7: 1Karina1 ($28.84 in chips) 
Seat 8: hl77777 ($11.80 in chips) 
Seat 9: Perstenev ($12.47 in chips) 
phate-1up: posts small blind $0.10
turbotom122: posts big blind $0.25
*** HOLE CARDS ***
Dealt to chiyuki [Ac 3h]
troublesomm: folds 
cofla tito: folds 
Landybob: folds 
1Karina1: folds 
hl77777: raises $0.50 to $0.75
Perstenev: folds 
chiyuki: folds 
phate-1up: folds 
turbotom122: folds 
Uncalled bet ($0.50) returned to hl77777
hl77777 collected $0.60 from pot
hl77777: doesn't show hand 
*** SUMMARY ***
Total pot $0.60 | Rake $0 
Seat 1: chiyuki (button) folded before Flop (didn't bet)
Seat 2: phate-1up (small blind) folded before Flop
Seat 3: turbotom122 (big blind) folded before Flop
Seat 4: troublesomm folded before Flop (didn't bet)
Seat 5: cofla tito folded before Flop (didn't bet)
Seat 6: Landybob folded before Flop (didn't bet)
Seat 7: 1Karina1 folded before Flop (didn't bet)
Seat 8: hl77777 collected ($0.60)
Seat 9: Perstenev folded before Flop (didn't bet)



PokerStars Zoom Hand #84299960672:  Hold'em No Limit ($0.10/$0.25) - 2012/08/05 14:55:07 JST [2012/08/05 1:55:07 ET]
Table 'Whirlpool' 9-max Seat #1 is the button
Seat 1: seula i ($25.89 in chips) 
Seat 2: GovGus ($26.99 in chips) 
Seat 3: Cyanidoff ($25 in chips) 
Seat 4: mid22 ($8.74 in chips) 
Seat 5: Nerkit ($9.15 in chips) 
Seat 6: Jene4kaBest ($16.92 in chips) 
Seat 7: chiyuki ($23.90 in chips) 
Seat 8: snejokCoxx ($22.72 in chips) 
Seat 9: deepakmbh ($11.86 in chips) 
GovGus: posts small blind $0.10
Cyanidoff: posts big blind $0.25
*** HOLE CARDS ***
Dealt to chiyuki [3c 5s]
mid22: calls $0.25
Nerkit: folds 
Jene4kaBest: folds 
chiyuki: folds 
snejokCoxx: folds 
deepakmbh: raises $0.50 to $0.75
seula i: folds 
GovGus: folds 
Cyanidoff: folds 
mid22: calls $0.50
*** FLOP *** [2c 7d 7h]
mid22: bets $0.50
deepakmbh: folds 
Uncalled bet ($0.50) returned to mid22
mid22 collected $1.77 from pot
mid22: doesn't show hand 
*** SUMMARY ***
Total pot $1.85 | Rake $0.08 
Board [2c 7d 7h]
Seat 1: seula i (button) folded before Flop (didn't bet)
Seat 2: GovGus (small blind) folded before Flop
Seat 3: Cyanidoff (big blind) folded before Flop
Seat 4: mid22 collected ($1.77)
Seat 5: Nerkit folded before Flop (didn't bet)
Seat 6: Jene4kaBest folded before Flop (didn't bet)
Seat 7: chiyuki folded before Flop (didn't bet)
Seat 8: snejokCoxx folded before Flop (didn't bet)
Seat 9: deepakmbh folded on the Flop



PokerStars Zoom Hand #84299958425:  Hold'em No Limit ($0.10/$0.25) - 2012/08/05 14:54:58 JST [2012/08/05 1:54:58 ET]
Table 'Whirlpool' 9-max Seat #1 is the button
Seat 1: DonSimonUsa ($18.22 in chips) 
Seat 2: troublesomm ($25 in chips) 
Seat 3: DutchShultzs ($25.75 in chips) 
Seat 4: Nerkit ($15.23 in chips) 
Seat 5: tribunpdm ($26.02 in chips) 
Seat 6: 4ydo yogurt ($24.94 in chips) 
Seat 7: BlOnDhOlIc ($84.05 in chips) 
Seat 8: cofla tito ($9.30 in chips) 
Seat 9: chiyuki ($23.90 in chips) 
troublesomm: posts small blind $0.10
DutchShultzs: posts big blind $0.25
*** HOLE CARDS ***
Dealt to chiyuki [7h Jh]
Nerkit: folds 
tribunpdm: folds 
4ydo yogurt: folds 
BlOnDhOlIc: raises $0.25 to $0.50
cofla tito: folds 
chiyuki: folds 
DonSimonUsa: folds 
troublesomm: calls $0.40
DutchShultzs: folds 
*** FLOP *** [3h Ac 6h]
troublesomm: checks 
BlOnDhOlIc: bets $0.59
troublesomm: raises $0.66 to $1.25
BlOnDhOlIc: calls $0.66
*** TURN *** [3h Ac 6h] [Jd]
troublesomm: bets $2
BlOnDhOlIc: calls $2
*** RIVER *** [3h Ac 6h Jd] [9c]
troublesomm: checks 
BlOnDhOlIc: bets $4.25
troublesomm: calls $4.25
*** SHOW DOWN ***
BlOnDhOlIc: shows [6s As] (two pair, Aces and Sixes)
troublesomm: mucks hand 
BlOnDhOlIc collected $15.52 from pot
*** SUMMARY ***
Total pot $16.25 | Rake $0.73 
Board [3h Ac 6h Jd 9c]
Seat 1: DonSimonUsa (button) folded before Flop (didn't bet)
Seat 2: troublesomm (small blind) mucked [Qc Ad]
Seat 3: DutchShultzs (big blind) folded before Flop
Seat 4: Nerkit folded before Flop (didn't bet)
Seat 5: tribunpdm folded before Flop (didn't bet)
Seat 6: 4ydo yogurt folded before Flop (didn't bet)
Seat 7: BlOnDhOlIc showed [6s As] and won ($15.52) with two pair, Aces and Sixes
Seat 8: cofla tito folded before Flop (didn't bet)
Seat 9: chiyuki folded before Flop (didn't bet)



PokerStars Zoom Hand #84299963730:  Hold'em No Limit ($0.10/$0.25) - 2012/08/05 14:55:20 JST [2012/08/05 1:55:20 ET]
Table 'Whirlpool' 9-max Seat #1 is the button
Seat 1: 1Karina1 ($25 in chips) 
Seat 2: edilson_ita ($25.37 in chips) 
Seat 3: Dafleche ($20.96 in chips) 
Seat 4: chiyuki ($23.90 in chips) 
Seat 5: DanielWhyte ($51.35 in chips) 
Seat 6: troublesomm ($25.25 in chips) 
Seat 7: GovGus ($44.51 in chips) 
Seat 8: slapshot2011 ($50.48 in chips) 
Seat 9: seula i ($25.89 in chips) 
edilson_ita: posts small blind $0.10
Dafleche: posts big blind $0.25
*** HOLE CARDS ***
Dealt to chiyuki [3c 2s]
chiyuki: folds 
DanielWhyte: folds 
troublesomm: folds 
GovGus: folds 
slapshot2011: calls $0.25
seula i: folds 
1Karina1: folds 
edilson_ita: calls $0.15
Dafleche: checks 
*** FLOP *** [8h Tc 8d]
edilson_ita: checks 
Dafleche: bets $0.25
slapshot2011: calls $0.25
edilson_ita: raises $1 to $1.25
Dafleche: folds 
slapshot2011: folds 
Uncalled bet ($1) returned to edilson_ita
edilson_ita collected $1.43 from pot
edilson_ita: doesn't show hand 
*** SUMMARY ***
Total pot $1.50 | Rake $0.07 
Board [8h Tc 8d]
Seat 1: 1Karina1 (button) folded before Flop (didn't bet)
Seat 2: edilson_ita (small blind) collected ($1.43)
Seat 3: Dafleche (big blind) folded on the Flop
Seat 4: chiyuki folded before Flop (didn't bet)
Seat 5: DanielWhyte folded before Flop (didn't bet)
Seat 6: troublesomm folded before Flop (didn't bet)
Seat 7: GovGus folded before Flop (didn't bet)
Seat 8: slapshot2011 folded on the Flop
Seat 9: seula i folded before Flop (didn't bet)



PokerStars Zoom Hand #84299964553:  Hold'em No Limit ($0.10/$0.25) - 2012/08/05 14:55:24 JST [2012/08/05 1:55:24 ET]
Table 'Whirlpool' 9-max Seat #1 is the button
Seat 1: troublesomm ($25.25 in chips) 
Seat 2: Dejacob ($25 in chips) 
Seat 3: Phaedrus...3 ($26.13 in chips) 
Seat 4: Jene4kaBest ($16.92 in chips) 
Seat 5: chiyuki ($23.90 in chips) 
Seat 6: sparky5224 ($36.01 in chips) 
Seat 7: Alvinpe85 ($58.77 in chips) 
Seat 8: 4plankton ($28.68 in chips) 
Seat 9: 1Karina1 ($25 in chips) 
Dejacob: posts small blind $0.10
Phaedrus...3: posts big blind $0.25
*** HOLE CARDS ***
Dealt to chiyuki [8c Kd]
Jene4kaBest: folds 
chiyuki: folds 
sparky5224: calls $0.25
Alvinpe85: folds 
4plankton: folds 
1Karina1: folds 
troublesomm: folds 
Dejacob: folds 
Phaedrus...3: checks 
*** FLOP *** [9c 8s 6h]
Phaedrus...3: checks 
sparky5224: bets $0.25
Phaedrus...3: folds 
Uncalled bet ($0.25) returned to sparky5224
sparky5224 collected $0.57 from pot
sparky5224: doesn't show hand 
*** SUMMARY ***
Total pot $0.60 | Rake $0.03 
Board [9c 8s 6h]
Seat 1: troublesomm (button) folded before Flop (didn't bet)
Seat 2: Dejacob (small blind) folded before Flop
Seat 3: Phaedrus...3 (big blind) folded on the Flop
Seat 4: Jene4kaBest folded before Flop (didn't bet)
Seat 5: chiyuki folded before Flop (didn't bet)
Seat 6: sparky5224 collected ($0.57)
Seat 7: Alvinpe85 folded before Flop (didn't bet)
Seat 8: 4plankton folded before Flop (didn't bet)
Seat 9: 1Karina1 folded before Flop (didn't bet)



PokerStars Zoom Hand #84299969759:  Hold'em No Limit ($0.10/$0.25) - 2012/08/05 14:55:51 JST [2012/08/05 1:55:51 ET]
Table 'Whirlpool' 9-max Seat #1 is the button
Seat 1: Dafleche ($20.46 in chips) 
Seat 2: jacquelinewu ($46.25 in chips) 
Seat 3: ZhukOFFskI ($48.75 in chips) 
Seat 4: chiyuki ($23.65 in chips) 
Seat 5: laurentzu84 ($34.85 in chips) 
Seat 6: GovGus ($26.68 in chips) 
Seat 7: hirozo ($75.21 in chips) 
Seat 8: snejokCoxx ($10.70 in chips) 
Seat 9: Dejacob ($35.96 in chips) 
jacquelinewu: posts small blind $0.10
ZhukOFFskI: posts big blind $0.25
*** HOLE CARDS ***
Dealt to chiyuki [Js 2c]
chiyuki: folds 
laurentzu84: folds 
GovGus: folds 
hirozo: folds 
snejokCoxx: folds 
Dejacob: folds 
Dafleche: folds 
jacquelinewu: raises $0.50 to $0.75
ZhukOFFskI: folds 
Uncalled bet ($0.50) returned to jacquelinewu
jacquelinewu collected $0.50 from pot
jacquelinewu: doesn't show hand 
*** SUMMARY ***
Total pot $0.50 | Rake $0 
Seat 1: Dafleche (button) folded before Flop (didn't bet)
Seat 2: jacquelinewu (small blind) collected ($0.50)
Seat 3: ZhukOFFskI (big blind) folded before Flop
Seat 4: chiyuki folded before Flop (didn't bet)
Seat 5: laurentzu84 folded before Flop (didn't bet)
Seat 6: GovGus folded before Flop (didn't bet)
Seat 7: hirozo folded before Flop (didn't bet)
Seat 8: snejokCoxx folded before Flop (didn't bet)
Seat 9: Dejacob folded before Flop (didn't bet)



PokerStars Zoom Hand #84299965955:  Hold'em No Limit ($0.10/$0.25) - 2012/08/05 14:55:31 JST [2012/08/05 1:55:31 ET]
Table 'Whirlpool' 9-max Seat #1 is the button
Seat 1: Dejacob ($25 in chips) 
Seat 2: turbotom122 ($12.25 in chips) 
Seat 3: chiyuki ($23.90 in chips) 
Seat 4: Perstenev ($15.08 in chips) 
Seat 5: ChrisCDee ($30.76 in chips) 
Seat 6: led52 ($13.42 in chips) 
Seat 7: GovGus ($25 in chips) 
Seat 8: deepakmbh ($11.11 in chips) 
Seat 9: jacquelinewu ($47 in chips) 
turbotom122: posts small blind $0.10
chiyuki: posts big blind $0.25
*** HOLE CARDS ***
Dealt to chiyuki [Js 5d]
Perstenev: folds 
ChrisCDee: folds 
led52: folds 
GovGus: raises $0.75 to $1
deepakmbh: folds 
jacquelinewu: folds 
Dejacob: folds 
turbotom122: raises $0.75 to $1.75
chiyuki: folds 
GovGus: calls $0.75
*** FLOP *** [Qc 8s Kc]
turbotom122: bets $10.50 and is all-in
GovGus: calls $10.50
*** TURN *** [Qc 8s Kc] [Jc]
*** RIVER *** [Qc 8s Kc Jc] [6s]
*** SHOW DOWN ***
turbotom122: shows [4d Ad] (high card Ace)
GovGus: shows [Qd Ks] (two pair, Kings and Queens)
GovGus collected $23.64 from pot
*** SUMMARY ***
Total pot $24.75 | Rake $1.11 
Board [Qc 8s Kc Jc 6s]
Seat 1: Dejacob (button) folded before Flop (didn't bet)
Seat 2: turbotom122 (small blind) showed [4d Ad] and lost with high card Ace
Seat 3: chiyuki (big blind) folded before Flop
Seat 4: Perstenev folded before Flop (didn't bet)
Seat 5: ChrisCDee folded before Flop (didn't bet)
Seat 6: led52 folded before Flop (didn't bet)
Seat 7: GovGus showed [Qd Ks] and won ($23.64) with two pair, Kings and Queens
Seat 8: deepakmbh folded before Flop (didn't bet)
Seat 9: jacquelinewu folded before Flop (didn't bet)



PokerStars Zoom Hand #84299970746:  Hold'em No Limit ($0.10/$0.25) - 2012/08/05 14:55:56 JST [2012/08/05 1:55:56 ET]
Table 'Whirlpool' 9-max Seat #1 is the button
Seat 1: deadmoneykid ($28.27 in chips) 
Seat 2: chiyuki ($23.65 in chips) 
Seat 3: snejokCoxx ($12.50 in chips) 
Seat 4: Perstenev ($13.95 in chips) 
Seat 5: Nerkit ($12.50 in chips) 
Seat 6: mid22 ($9.66 in chips) 
Seat 7: ll_LaMeR_ll ($78.41 in chips) 
Seat 8: troublesomm ($25 in chips) 
Seat 9: ZhukOFFskI ($27.66 in chips) 
chiyuki: posts small blind $0.10
snejokCoxx: posts big blind $0.25
*** HOLE CARDS ***
Dealt to chiyuki [8h 5c]
Perstenev: folds 
Nerkit: folds 
mid22: folds 
ll_LaMeR_ll: folds 
troublesomm: folds 
ZhukOFFskI: folds 
deadmoneykid: folds 
chiyuki: folds 
Uncalled bet ($0.15) returned to snejokCoxx
snejokCoxx collected $0.20 from pot
snejokCoxx: doesn't show hand 
*** SUMMARY ***
Total pot $0.20 | Rake $0 
Seat 1: deadmoneykid (button) folded before Flop (didn't bet)
Seat 2: chiyuki (small blind) folded before Flop
Seat 3: snejokCoxx (big blind) collected ($0.20)
Seat 4: Perstenev folded before Flop (didn't bet)
Seat 5: Nerkit folded before Flop (didn't bet)
Seat 6: mid22 folded before Flop (didn't bet)
Seat 7: ll_LaMeR_ll folded before Flop (didn't bet)
Seat 8: troublesomm folded before Flop (didn't bet)
Seat 9: ZhukOFFskI folded before Flop (didn't bet)



PokerStars Zoom Hand #84299975824:  Hold'em No Limit ($0.10/$0.25) - 2012/08/05 14:56:22 JST [2012/08/05 1:56:22 ET]
Table 'Whirlpool' 9-max Seat #1 is the button
Seat 1: tribunpdm ($24.52 in chips) 
Seat 2: Phaedrus...3 ($25.13 in chips) 
Seat 3: KeLevro0 ($11.33 in chips) 
Seat 4: Landybob ($40.82 in chips) 
Seat 5: seula i ($25.64 in chips) 
Seat 6: DanielWhyte ($51.35 in chips) 
Seat 7: 1Karina1 ($25 in chips) 
Seat 8: chiyuki ($23.55 in chips) 
Seat 9: KAKamiro ($29.31 in chips) 
Phaedrus...3: posts small blind $0.10
KeLevro0: posts big blind $0.25
*** HOLE CARDS ***
Dealt to chiyuki [Qh 6c]
Landybob: folds 
seula i: folds 
DanielWhyte: raises $0.50 to $0.75
1Karina1: folds 
chiyuki: folds 
KAKamiro: folds 
tribunpdm: folds 
Phaedrus...3: folds 
KeLevro0: folds 
Uncalled bet ($0.50) returned to DanielWhyte
DanielWhyte collected $0.60 from pot
DanielWhyte: doesn't show hand 
*** SUMMARY ***
Total pot $0.60 | Rake $0 
Seat 1: tribunpdm (button) folded before Flop (didn't bet)
Seat 2: Phaedrus...3 (small blind) folded before Flop
Seat 3: KeLevro0 (big blind) folded before Flop
Seat 4: Landybob folded before Flop (didn't bet)
Seat 5: seula i folded before Flop (didn't bet)
Seat 6: DanielWhyte collected ($0.60)
Seat 7: 1Karina1 folded before Flop (didn't bet)
Seat 8: chiyuki folded before Flop (didn't bet)
Seat 9: KAKamiro folded before Flop (didn't bet)



PokerStars Zoom Hand #84299977015:  Hold'em No Limit ($0.10/$0.25) - 2012/08/05 14:56:28 JST [2012/08/05 1:56:28 ET]
Table 'Whirlpool' 9-max Seat #1 is the button
Seat 1: phate-1up ($69.68 in chips) 
Seat 2: snejokCoxx ($12.60 in chips) 
Seat 3: 1Karina1 ($25 in chips) 
Seat 4: deadmoneykid ($20.35 in chips) 
Seat 5: ZhukOFFskI ($27.66 in chips) 
Seat 6: chiyuki ($23.55 in chips) 
Seat 7: Littlea029 ($25 in chips) 
Seat 8: DutchShultzs ($25 in chips) 
Seat 9: Perstenev ($13.60 in chips) 
snejokCoxx: posts small blind $0.10
1Karina1: posts big blind $0.25
*** HOLE CARDS ***
Dealt to chiyuki [8d 7d]
deadmoneykid: folds 
ZhukOFFskI: folds 
chiyuki: folds 
Littlea029: folds 
DutchShultzs: folds 
Perstenev: folds 
phate-1up: folds 
snejokCoxx: folds 
Uncalled bet ($0.15) returned to 1Karina1
1Karina1 collected $0.20 from pot
1Karina1: doesn't show hand 
*** SUMMARY ***
Total pot $0.20 | Rake $0 
Seat 1: phate-1up (button) folded before Flop (didn't bet)
Seat 2: snejokCoxx (small blind) folded before Flop
Seat 3: 1Karina1 (big blind) collected ($0.20)
Seat 4: deadmoneykid folded before Flop (didn't bet)
Seat 5: ZhukOFFskI folded before Flop (didn't bet)
Seat 6: chiyuki folded before Flop (didn't bet)
Seat 7: Littlea029 folded before Flop (didn't bet)
Seat 8: DutchShultzs folded before Flop (didn't bet)
Seat 9: Perstenev folded before Flop (didn't bet)



PokerStars Zoom Hand #84299974389:  Hold'em No Limit ($0.10/$0.25) - 2012/08/05 14:56:15 JST [2012/08/05 1:56:15 ET]
Table 'Whirlpool' 9-max Seat #1 is the button
Seat 1: chiyuki ($23.55 in chips) 
Seat 2: Dan Royal ($32.91 in chips) 
Seat 3: jacquelinewu ($29.34 in chips) 
Seat 4: hl77777 ($11.90 in chips) 
Seat 5: led52 ($10.05 in chips) 
Seat 6: 1Karina1 ($25 in chips) 
Seat 7: Alvinpe85 ($58.42 in chips) 
Seat 8: miramax89 ($20.97 in chips) 
Seat 9: ZhukOFFskI ($28.78 in chips) 
Dan Royal: posts small blind $0.10
jacquelinewu: posts big blind $0.25
*** HOLE CARDS ***
Dealt to chiyuki [5h 3d]
hl77777: folds 
led52: folds 
1Karina1: folds 
Alvinpe85: folds 
miramax89: folds 
ZhukOFFskI: raises $0.50 to $0.75
chiyuki: folds 
Dan Royal: folds 
jacquelinewu: raises $1.25 to $2
ZhukOFFskI: folds 
Uncalled bet ($1.25) returned to jacquelinewu
jacquelinewu collected $1.60 from pot
jacquelinewu: doesn't show hand 
*** SUMMARY ***
Total pot $1.60 | Rake $0 
Seat 1: chiyuki (button) folded before Flop (didn't bet)
Seat 2: Dan Royal (small blind) folded before Flop
Seat 3: jacquelinewu (big blind) collected ($1.60)
Seat 4: hl77777 folded before Flop (didn't bet)
Seat 5: led52 folded before Flop (didn't bet)
Seat 6: 1Karina1 folded before Flop (didn't bet)
Seat 7: Alvinpe85 folded before Flop (didn't bet)
Seat 8: miramax89 folded before Flop (didn't bet)
Seat 9: ZhukOFFskI folded before Flop



PokerStars Zoom Hand #84299976421:  Hold'em No Limit ($0.10/$0.25) - 2012/08/05 14:56:25 JST [2012/08/05 1:56:25 ET]
Table 'Whirlpool' 9-max Seat #1 is the button
Seat 1: cofla tito ($8.74 in chips) 
Seat 2: Gichboy ($10.94 in chips) 
Seat 3: pativyko ($7.54 in chips) 
Seat 4: colorado2108 ($27.74 in chips) 
Seat 5: jacquelinewu ($47.25 in chips) 
Seat 6: rorfo23 ($24.25 in chips) 
Seat 7: chiyuki ($23.55 in chips) 
Seat 8: hirozo ($25.65 in chips) 
Seat 9: Dan Royal ($32.81 in chips) 
Gichboy: posts small blind $0.10
pativyko: posts big blind $0.25
*** HOLE CARDS ***
Dealt to chiyuki [9d Kd]
colorado2108: folds 
jacquelinewu: raises $0.50 to $0.75
rorfo23: folds 
chiyuki: folds 
hirozo: folds 
Dan Royal: raises $1.50 to $2.25
cofla tito: folds 
Gichboy: folds 
pativyko: folds 
jacquelinewu: folds 
Uncalled bet ($1.50) returned to Dan Royal
Dan Royal collected $1.85 from pot
Dan Royal: doesn't show hand 
*** SUMMARY ***
Total pot $1.85 | Rake $0 
Seat 1: cofla tito (button) folded before Flop (didn't bet)
Seat 2: Gichboy (small blind) folded before Flop
Seat 3: pativyko (big blind) folded before Flop
Seat 4: colorado2108 folded before Flop (didn't bet)
Seat 5: jacquelinewu folded before Flop
Seat 6: rorfo23 folded before Flop (didn't bet)
Seat 7: chiyuki folded before Flop (didn't bet)
Seat 8: hirozo folded before Flop (didn't bet)
Seat 9: Dan Royal collected ($1.85)



PokerStars Zoom Hand #84299978195:  Hold'em No Limit ($0.10/$0.25) - 2012/08/05 14:56:34 JST [2012/08/05 1:56:34 ET]
Table 'Whirlpool' 9-max Seat #1 is the button
Seat 1: Littlea029 ($25 in chips) 
Seat 2: tribunpdm ($24.52 in chips) 
Seat 3: kaplya2010 ($15.52 in chips) 
Seat 4: deadmoneykid ($20.35 in chips) 
Seat 5: chiyuki ($23.55 in chips) 
Seat 6: colorado2108 ($27.74 in chips) 
Seat 7: Cyanidoff ($27.16 in chips) 
Seat 8: GovGus ($29.31 in chips) 
Seat 9: Dejacob ($25.78 in chips) 
tribunpdm: posts small blind $0.10
kaplya2010: posts big blind $0.25
*** HOLE CARDS ***
Dealt to chiyuki [Ts 5c]
deadmoneykid: folds 
chiyuki: folds 
colorado2108: folds 
Cyanidoff: folds 
GovGus: folds 
Dejacob: raises $0.50 to $0.75
Littlea029: folds 
tribunpdm: folds 
kaplya2010: calls $0.50
*** FLOP *** [2h 2c Ac]
kaplya2010: checks 
Dejacob: bets $1
kaplya2010: folds 
Uncalled bet ($1) returned to Dejacob
Dejacob collected $1.53 from pot
Dejacob: doesn't show hand 
*** SUMMARY ***
Total pot $1.60 | Rake $0.07 
Board [2h 2c Ac]
Seat 1: Littlea029 (button) folded before Flop (didn't bet)
Seat 2: tribunpdm (small blind) folded before Flop
Seat 3: kaplya2010 (big blind) folded on the Flop
Seat 4: deadmoneykid folded before Flop (didn't bet)
Seat 5: chiyuki folded before Flop (didn't bet)
Seat 6: colorado2108 folded before Flop (didn't bet)
Seat 7: Cyanidoff folded before Flop (didn't bet)
Seat 8: GovGus folded before Flop (didn't bet)
Seat 9: Dejacob collected ($1.53)



PokerStars Zoom Hand #84299983164:  Hold'em No Limit ($0.10/$0.25) - 2012/08/05 14:57:00 JST [2012/08/05 1:57:00 ET]
Table 'Whirlpool' 9-max Seat #1 is the button
Seat 1: seula i ($42.29 in chips) 
Seat 2: Tom1999 ($26.07 in chips) 
Seat 3: kamikkaze ($15 in chips) 
Seat 4: peng2astic ($2.31 in chips) 
Seat 5: dushvan ($40.76 in chips) 
Seat 6: KrystalAA ($33.94 in chips) 
Seat 7: ZhukOFFskI ($28.03 in chips) 
Seat 8: 1Karina1 ($25 in chips) 
Seat 9: chiyuki ($23.30 in chips) 
Tom1999: posts small blind $0.10
kamikkaze: posts big blind $0.25
*** HOLE CARDS ***
Dealt to chiyuki [Jc 6d]
peng2astic: folds 
dushvan: folds 
KrystalAA: folds 
ZhukOFFskI: folds 
1Karina1: folds 
chiyuki: folds 
seula i: raises $0.25 to $0.50
Tom1999: folds 
kamikkaze: folds 
Uncalled bet ($0.25) returned to seula i
seula i collected $0.60 from pot
seula i: doesn't show hand 
*** SUMMARY ***
Total pot $0.60 | Rake $0 
Seat 1: seula i (button) collected ($0.60)
Seat 2: Tom1999 (small blind) folded before Flop
Seat 3: kamikkaze (big blind) folded before Flop
Seat 4: peng2astic folded before Flop (didn't bet)
Seat 5: dushvan folded before Flop (didn't bet)
Seat 6: KrystalAA folded before Flop (didn't bet)
Seat 7: ZhukOFFskI folded before Flop (didn't bet)
Seat 8: 1Karina1 folded before Flop (didn't bet)
Seat 9: chiyuki folded before Flop (didn't bet)



PokerStars Zoom Hand #84299972618:  Hold'em No Limit ($0.10/$0.25) - 2012/08/05 14:56:06 JST [2012/08/05 1:56:06 ET]
Table 'Whirlpool' 9-max Seat #1 is the button
Seat 1: 1Karina1 ($27.09 in chips) 
Seat 2: DutchShultzs ($25 in chips) 
Seat 3: laurentzu84 ($34.85 in chips) 
Seat 4: hirozo ($44.05 in chips) 
Seat 5: KrystalAA ($33.69 in chips) 
Seat 6: deadmoneykid ($28.27 in chips) 
Seat 7: Nerkit ($12.50 in chips) 
Seat 8: ChrisCDee ($69.04 in chips) 
Seat 9: chiyuki ($23.55 in chips) 
DutchShultzs: posts small blind $0.10
laurentzu84: posts big blind $0.25
*** HOLE CARDS ***
Dealt to chiyuki [4h 8d]
hirozo: folds 
KrystalAA: folds 
deadmoneykid: raises $0.35 to $0.60
Nerkit: calls $0.60
ChrisCDee: folds 
chiyuki: folds 
1Karina1: folds 
DutchShultzs: folds 
laurentzu84: raises $0.40 to $1
deadmoneykid: calls $0.40
Nerkit: calls $0.40
*** FLOP *** [7h 6c 3d]
laurentzu84: bets $2
deadmoneykid: folds 
Nerkit: folds 
Uncalled bet ($2) returned to laurentzu84
laurentzu84 collected $2.96 from pot
laurentzu84: doesn't show hand 
*** SUMMARY ***
Total pot $3.10 | Rake $0.14 
Board [7h 6c 3d]
Seat 1: 1Karina1 (button) folded before Flop (didn't bet)
Seat 2: DutchShultzs (small blind) folded before Flop
Seat 3: laurentzu84 (big blind) collected ($2.96)
Seat 4: hirozo folded before Flop (didn't bet)
Seat 5: KrystalAA folded before Flop (didn't bet)
Seat 6: deadmoneykid folded on the Flop
Seat 7: Nerkit folded on the Flop
Seat 8: ChrisCDee folded before Flop (didn't bet)
Seat 9: chiyuki folded before Flop (didn't bet)



PokerStars Zoom Hand #84299978987:  Hold'em No Limit ($0.10/$0.25) - 2012/08/05 14:56:38 JST [2012/08/05 1:56:38 ET]
Table 'Whirlpool' 9-max Seat #1 is the button
Seat 1: kesstukas25 ($17.67 in chips) 
Seat 2: snejokCoxx ($10.45 in chips) 
Seat 3: chiyuki ($23.55 in chips) 
Seat 4: Ellen1947 ($33.24 in chips) 
Seat 5: turbotom122 ($12.50 in chips) 
Seat 6: Gichboy ($14 in chips) 
Seat 7: Perstenev ($13.60 in chips) 
Seat 8: silvno31 ($14.17 in chips) 
Seat 9: Nagibator441 ($10.29 in chips) 
snejokCoxx: posts small blind $0.10
chiyuki: posts big blind $0.25
*** HOLE CARDS ***
Dealt to chiyuki [Jh 6d]
Ellen1947: folds 
turbotom122: calls $0.25
Gichboy: folds 
Perstenev: folds 
silvno31: folds 
Nagibator441: folds 
kesstukas25: raises $0.75 to $1
snejokCoxx: folds 
chiyuki: folds 
turbotom122: raises $11.50 to $12.50 and is all-in
kesstukas25: folds 
Uncalled bet ($11.50) returned to turbotom122
turbotom122 collected $2.35 from pot
turbotom122: doesn't show hand 
*** SUMMARY ***
Total pot $2.35 | Rake $0 
Seat 1: kesstukas25 (button) folded before Flop
Seat 2: snejokCoxx (small blind) folded before Flop
Seat 3: chiyuki (big blind) folded before Flop
Seat 4: Ellen1947 folded before Flop (didn't bet)
Seat 5: turbotom122 collected ($2.35)
Seat 6: Gichboy folded before Flop (didn't bet)
Seat 7: Perstenev folded before Flop (didn't bet)
Seat 8: silvno31 folded before Flop (didn't bet)
Seat 9: Nagibator441 folded before Flop (didn't bet)



PokerStars Zoom Hand #84299986171:  Hold'em No Limit ($0.10/$0.25) - 2012/08/05 14:57:15 JST [2012/08/05 1:57:15 ET]
Table 'Whirlpool' 9-max Seat #1 is the button
Seat 1: KeLevro0 ($10.98 in chips) 
Seat 2: chiyuki ($23.30 in chips) 
Seat 3: kamikkaze ($15 in chips) 
Seat 4: phate-1up ($34.81 in chips) 
Seat 5: DutchShultzs ($25 in chips) 
Seat 6: Dejacob ($26.56 in chips) 
Seat 7: Sal y Limon1 ($24.75 in chips) 
Seat 8: deadmoneykid ($20.35 in chips) 
Seat 9: DanielWhyte ($50.95 in chips) 
chiyuki: posts small blind $0.10
kamikkaze: posts big blind $0.25
*** HOLE CARDS ***
Dealt to chiyuki [Qc 2h]
phate-1up: folds 
DutchShultzs: folds 
Dejacob: folds 
Sal y Limon1: folds 
deadmoneykid: folds 
DanielWhyte: folds 
KeLevro0: folds 
chiyuki: folds 
Uncalled bet ($0.15) returned to kamikkaze
kamikkaze collected $0.20 from pot
kamikkaze: doesn't show hand 
*** SUMMARY ***
Total pot $0.20 | Rake $0 
Seat 1: KeLevro0 (button) folded before Flop (didn't bet)
Seat 2: chiyuki (small blind) folded before Flop
Seat 3: kamikkaze (big blind) collected ($0.20)
Seat 4: phate-1up folded before Flop (didn't bet)
Seat 5: DutchShultzs folded before Flop (didn't bet)
Seat 6: Dejacob folded before Flop (didn't bet)
Seat 7: Sal y Limon1 folded before Flop (didn't bet)
Seat 8: deadmoneykid folded before Flop (didn't bet)
Seat 9: DanielWhyte folded before Flop (didn't bet)



PokerStars Zoom Hand #84299986995:  Hold'em No Limit ($0.10/$0.25) - 2012/08/05 14:57:19 JST [2012/08/05 1:57:19 ET]
Table 'Whirlpool' 9-max Seat #1 is the button
Seat 1: DanielWhyte ($50.95 in chips) 
Seat 2: seula i ($42.64 in chips) 
Seat 3: phate-1up ($34.81 in chips) 
Seat 4: ChrisCDee ($68.94 in chips) 
Seat 5: 1Karina1 ($25.25 in chips) 
Seat 6: Tom1999 ($25.97 in chips) 
Seat 7: 4plankton ($27.33 in chips) 
Seat 8: chiyuki ($23.20 in chips) 
Seat 9: DutchShultzs ($25 in chips) 
seula i: posts small blind $0.10
phate-1up: posts big blind $0.25
*** HOLE CARDS ***
Dealt to chiyuki [As Ac]
ChrisCDee: folds 
1Karina1: folds 
Tom1999: folds 
4plankton: folds 
chiyuki: raises $0.50 to $0.75
DutchShultzs: folds 
DanielWhyte: folds 
seula i: folds 
phate-1up: calls $0.50
*** FLOP *** [3c 2c Kc]
phate-1up: checks 
chiyuki: bets $1.50
phate-1up: folds 
Uncalled bet ($1.50) returned to chiyuki
chiyuki collected $1.53 from pot
chiyuki: doesn't show hand 
*** SUMMARY ***
Total pot $1.60 | Rake $0.07 
Board [3c 2c Kc]
Seat 1: DanielWhyte (button) folded before Flop (didn't bet)
Seat 2: seula i (small blind) folded before Flop
Seat 3: phate-1up (big blind) folded on the Flop
Seat 4: ChrisCDee folded before Flop (didn't bet)
Seat 5: 1Karina1 folded before Flop (didn't bet)
Seat 6: Tom1999 folded before Flop (didn't bet)
Seat 7: 4plankton folded before Flop (didn't bet)
Seat 8: chiyuki collected ($1.53)
Seat 9: DutchShultzs folded before Flop (didn't bet)



PokerStars Zoom Hand #84299996836:  Hold'em No Limit ($0.10/$0.25) - 2012/08/05 14:58:09 JST [2012/08/05 1:58:09 ET]
Table 'Whirlpool' 9-max Seat #1 is the button
Seat 1: chiyuki ($23.98 in chips) 
Seat 2: deadmoneykid ($27.37 in chips) 
Seat 3: KeLevro0 ($11.41 in chips) 
Seat 4: kesstukas25 ($16.67 in chips) 
Seat 5: phate-1up ($25 in chips) 
Seat 6: ChrisCDee ($69.29 in chips) 
Seat 7: tribunpdm ($28.85 in chips) 
Seat 8: 1Karina1 ($25 in chips) 
Seat 9: Cyanidoff ($31.58 in chips) 
deadmoneykid: posts small blind $0.10
KeLevro0: posts big blind $0.25
*** HOLE CARDS ***
Dealt to chiyuki [Ks Jd]
kesstukas25: raises $0.50 to $0.75
phate-1up: folds 
ChrisCDee: folds 
tribunpdm: folds 
1Karina1: folds 
Cyanidoff: folds 
chiyuki: folds 
deadmoneykid: folds 
KeLevro0: folds 
Uncalled bet ($0.50) returned to kesstukas25
kesstukas25 collected $0.60 from pot
kesstukas25: doesn't show hand 
*** SUMMARY ***
Total pot $0.60 | Rake $0 
Seat 1: chiyuki (button) folded before Flop (didn't bet)
Seat 2: deadmoneykid (small blind) folded before Flop
Seat 3: KeLevro0 (big blind) folded before Flop
Seat 4: kesstukas25 collected ($0.60)
Seat 5: phate-1up folded before Flop (didn't bet)
Seat 6: ChrisCDee folded before Flop (didn't bet)
Seat 7: tribunpdm folded before Flop (didn't bet)
Seat 8: 1Karina1 folded before Flop (didn't bet)
Seat 9: Cyanidoff folded before Flop (didn't bet)



PokerStars Zoom Hand #84300003065:  Hold'em No Limit ($0.10/$0.25) - 2012/08/05 14:58:40 JST [2012/08/05 1:58:40 ET]
Table 'Whirlpool' 9-max Seat #1 is the button
Seat 1: DutchShultzs ($28.86 in chips) 
Seat 2: cofla tito ($11.55 in chips) 
Seat 3: phate-1up ($25 in chips) 
Seat 4: jacquelinewu ($31.73 in chips) 
Seat 5: chiyuki ($23.98 in chips) 
Seat 6: Dejacob ($47.26 in chips) 
Seat 7: kaplya2010 ($15.14 in chips) 
Seat 8: 1Karina1 ($25 in chips) 
Seat 9: Tom1999 ($23.10 in chips) 
cofla tito: posts small blind $0.10
phate-1up: posts big blind $0.25
*** HOLE CARDS ***
Dealt to chiyuki [3s 2c]
jacquelinewu: folds 
chiyuki: folds 
Dejacob: folds 
kaplya2010: folds 
1Karina1: folds 
Tom1999: folds 
DutchShultzs: raises $0.35 to $0.60
cofla tito: folds 
phate-1up: folds 
Uncalled bet ($0.35) returned to DutchShultzs
DutchShultzs collected $0.60 from pot
DutchShultzs: doesn't show hand 
*** SUMMARY ***
Total pot $0.60 | Rake $0 
Seat 1: DutchShultzs (button) collected ($0.60)
Seat 2: cofla tito (small blind) folded before Flop
Seat 3: phate-1up (big blind) folded before Flop
Seat 4: jacquelinewu folded before Flop (didn't bet)
Seat 5: chiyuki folded before Flop (didn't bet)
Seat 6: Dejacob folded before Flop (didn't bet)
Seat 7: kaplya2010 folded before Flop (didn't bet)
Seat 8: 1Karina1 folded before Flop (didn't bet)
Seat 9: Tom1999 folded before Flop (didn't bet)



PokerStars Zoom Hand #84300000874:  Hold'em No Limit ($0.10/$0.25) - 2012/08/05 14:58:29 JST [2012/08/05 1:58:29 ET]
Table 'Whirlpool' 9-max Seat #1 is the button
Seat 1: deepakmbh ($25 in chips) 
Seat 2: Phaedrus...3 ($23.18 in chips) 
Seat 3: KAKamiro ($29.28 in chips) 
Seat 4: deadmoneykid ($27.27 in chips) 
Seat 5: troublesomm ($26.54 in chips) 
Seat 6: DutchShultzs ($34.20 in chips) 
Seat 7: chiyuki ($23.98 in chips) 
Seat 8: snejokCoxx ($12.15 in chips) 
Seat 9: Alvinpe85 ($48.92 in chips) 
Phaedrus...3: posts small blind $0.10
KAKamiro: posts big blind $0.25
*** HOLE CARDS ***
Dealt to chiyuki [6d 2s]
deadmoneykid: folds 
troublesomm: folds 
DutchShultzs: folds 
chiyuki: folds 
snejokCoxx: folds 
Alvinpe85: raises $0.37 to $0.62
deepakmbh: folds 
Phaedrus...3: folds 
KAKamiro: calls $0.37
*** FLOP *** [Qc 9d 8c]
KAKamiro: checks 
Alvinpe85: bets $0.89
KAKamiro: folds 
Uncalled bet ($0.89) returned to Alvinpe85
Alvinpe85 collected $1.28 from pot
Alvinpe85: doesn't show hand 
*** SUMMARY ***
Total pot $1.34 | Rake $0.06 
Board [Qc 9d 8c]
Seat 1: deepakmbh (button) folded before Flop (didn't bet)
Seat 2: Phaedrus...3 (small blind) folded before Flop
Seat 3: KAKamiro (big blind) folded on the Flop
Seat 4: deadmoneykid folded before Flop (didn't bet)
Seat 5: troublesomm folded before Flop (didn't bet)
Seat 6: DutchShultzs folded before Flop (didn't bet)
Seat 7: chiyuki folded before Flop (didn't bet)
Seat 8: snejokCoxx folded before Flop (didn't bet)
Seat 9: Alvinpe85 collected ($1.28)



PokerStars Zoom Hand #84300004468:  Hold'em No Limit ($0.10/$0.25) - 2012/08/05 14:58:47 JST [2012/08/05 1:58:47 ET]
Table 'Whirlpool' 9-max Seat #1 is the button
Seat 1: deadmoneykid ($27.27 in chips) 
Seat 2: ChrisCDee ($46.69 in chips) 
Seat 3: chiyuki ($23.98 in chips) 
Seat 4: 1Karina1 ($26.29 in chips) 
Seat 5: ZhukOFFskI ($41.88 in chips) 
Seat 6: hirozo ($74.36 in chips) 
Seat 7: Phaedrus...3 ($23.08 in chips) 
Seat 8: KimPa39 ($34.12 in chips) 
Seat 9: Tom1999 ($22.22 in chips) 
ChrisCDee: posts small blind $0.10
chiyuki: posts big blind $0.25
*** HOLE CARDS ***
Dealt to chiyuki [Jd Qd]
1Karina1: folds 
ZhukOFFskI: folds 
hirozo: folds 
Phaedrus...3: folds 
KimPa39: folds 
Tom1999: folds 
deadmoneykid: folds 
ChrisCDee: raises $0.75 to $1
chiyuki: folds 
Uncalled bet ($0.75) returned to ChrisCDee
ChrisCDee collected $0.50 from pot
ChrisCDee: doesn't show hand 
*** SUMMARY ***
Total pot $0.50 | Rake $0 
Seat 1: deadmoneykid (button) folded before Flop (didn't bet)
Seat 2: ChrisCDee (small blind) collected ($0.50)
Seat 3: chiyuki (big blind) folded before Flop
Seat 4: 1Karina1 folded before Flop (didn't bet)
Seat 5: ZhukOFFskI folded before Flop (didn't bet)
Seat 6: hirozo folded before Flop (didn't bet)
Seat 7: Phaedrus...3 folded before Flop (didn't bet)
Seat 8: KimPa39 folded before Flop (didn't bet)
Seat 9: Tom1999 folded before Flop (didn't bet)



PokerStars Zoom Hand #84300002031:  Hold'em No Limit ($0.10/$0.25) - 2012/08/05 14:58:35 JST [2012/08/05 1:58:35 ET]
Table 'Whirlpool' 9-max Seat #1 is the button
Seat 1: Perstenev ($13.45 in chips) 
Seat 2: KeLevro0 ($11.08 in chips) 
Seat 3: Faantomace ($25.85 in chips) 
Seat 4: troublesomm ($26.54 in chips) 
Seat 5: DanielWhyte ($50.60 in chips) 
Seat 6: chiyuki ($23.98 in chips) 
Seat 7: Vahe50 ($16.25 in chips) 
Seat 8: Cyanidoff ($31.58 in chips) 
Seat 9: Lars111 ($35.98 in chips) 
KeLevro0: posts small blind $0.10
Faantomace: posts big blind $0.25
*** HOLE CARDS ***
Dealt to chiyuki [6h Js]
troublesomm: folds 
DanielWhyte: calls $0.25
chiyuki: folds 
Vahe50: folds 
Cyanidoff: raises $0.75 to $1
Lars111: calls $1
Perstenev: folds 
KeLevro0: calls $0.90
Faantomace: folds 
DanielWhyte: calls $0.75
*** FLOP *** [7d Ad Tc]
KeLevro0: checks 
DanielWhyte: checks 
Cyanidoff: bets $2.67
Lars111: folds 
KeLevro0: folds 
DanielWhyte: calls $2.67
*** TURN *** [7d Ad Tc] [Kd]
DanielWhyte: checks 
Cyanidoff: bets $5
DanielWhyte: folds 
Uncalled bet ($5) returned to Cyanidoff
Cyanidoff collected $9.16 from pot
Cyanidoff: doesn't show hand 
*** SUMMARY ***
Total pot $9.59 | Rake $0.43 
Board [7d Ad Tc Kd]
Seat 1: Perstenev (button) folded before Flop (didn't bet)
Seat 2: KeLevro0 (small blind) folded on the Flop
Seat 3: Faantomace (big blind) folded before Flop
Seat 4: troublesomm folded before Flop (didn't bet)
Seat 5: DanielWhyte folded on the Turn
Seat 6: chiyuki folded before Flop (didn't bet)
Seat 7: Vahe50 folded before Flop (didn't bet)
Seat 8: Cyanidoff collected ($9.16)
Seat 9: Lars111 folded on the Flop



PokerStars Zoom Hand #84300003657:  Hold'em No Limit ($0.10/$0.25) - 2012/08/05 14:58:43 JST [2012/08/05 1:58:43 ET]
Table 'Whirlpool' 9-max Seat #1 is the button
Seat 1: kesstukas25 ($16.77 in chips) 
Seat 2: 1Karina1 ($26.39 in chips) 
Seat 3: troublesomm ($25.67 in chips) 
Seat 4: chiyuki ($23.98 in chips) 
Seat 5: Perstenev ($9.29 in chips) 
Seat 6: silvno31 ($17 in chips) 
Seat 7: KeLevro0 ($12.15 in chips) 
Seat 8: colorado2108 ($28.85 in chips) 
Seat 9: Jene4kaBest ($15.67 in chips) 
1Karina1: posts small blind $0.10
troublesomm: posts big blind $0.25
*** HOLE CARDS ***
Dealt to chiyuki [2h 7s]
chiyuki: folds 
Perstenev: folds 
silvno31: raises $0.75 to $1
KeLevro0: folds 
colorado2108: folds 
Jene4kaBest: folds 
kesstukas25: folds 
1Karina1: folds 
troublesomm: calls $0.75
*** FLOP *** [As 8s Ad]
troublesomm: checks 
silvno31: bets $2
troublesomm: calls $2
*** TURN *** [As 8s Ad] [6s]
troublesomm: checks 
silvno31: checks 
*** RIVER *** [As 8s Ad 6s] [8d]
troublesomm: checks 
silvno31: checks 
*** SHOW DOWN ***
troublesomm: shows [Ah Qc] (a full house, Aces full of Eights)
silvno31: mucks hand 
troublesomm collected $5.83 from pot
*** SUMMARY ***
Total pot $6.10 | Rake $0.27 
Board [As 8s Ad 6s 8d]
Seat 1: kesstukas25 (button) folded before Flop (didn't bet)
Seat 2: 1Karina1 (small blind) folded before Flop
Seat 3: troublesomm (big blind) showed [Ah Qc] and won ($5.83) with a full house, Aces full of Eights
Seat 4: chiyuki folded before Flop (didn't bet)
Seat 5: Perstenev folded before Flop (didn't bet)
Seat 6: silvno31 mucked [9h Th]
Seat 7: KeLevro0 folded before Flop (didn't bet)
Seat 8: colorado2108 folded before Flop (didn't bet)
Seat 9: Jene4kaBest folded before Flop (didn't bet)



PokerStars Zoom Hand #84300009799:  Hold'em No Limit ($0.10/$0.25) - 2012/08/05 14:59:14 JST [2012/08/05 1:59:14 ET]
Table 'Whirlpool' 9-max Seat #1 is the button
Seat 1: jacquelinewu ($48.09 in chips) 
Seat 2: GovGus ($26.45 in chips) 
Seat 3: mjmichi ($25 in chips) 
Seat 4: Phaedrus...3 ($23.08 in chips) 
Seat 5: Dafleche ($46.83 in chips) 
Seat 6: Dan Royal ($32.16 in chips) 
Seat 7: Tom1999 ($23 in chips) 
Seat 8: snejokCoxx ($12.15 in chips) 
Seat 9: chiyuki ($23.73 in chips) 
GovGus: posts small blind $0.10
mjmichi: posts big blind $0.25
*** HOLE CARDS ***
Dealt to chiyuki [Ac 2c]
Phaedrus...3: folds 
Dafleche: folds 
Dan Royal: folds 
Tom1999: folds 
snejokCoxx: folds 
chiyuki: folds 
jacquelinewu: raises $0.50 to $0.75
GovGus: folds 
mjmichi: folds 
Uncalled bet ($0.50) returned to jacquelinewu
jacquelinewu collected $0.60 from pot
jacquelinewu: doesn't show hand 
*** SUMMARY ***
Total pot $0.60 | Rake $0 
Seat 1: jacquelinewu (button) collected ($0.60)
Seat 2: GovGus (small blind) folded before Flop
Seat 3: mjmichi (big blind) folded before Flop
Seat 4: Phaedrus...3 folded before Flop (didn't bet)
Seat 5: Dafleche folded before Flop (didn't bet)
Seat 6: Dan Royal folded before Flop (didn't bet)
Seat 7: Tom1999 folded before Flop (didn't bet)
Seat 8: snejokCoxx folded before Flop (didn't bet)
Seat 9: chiyuki folded before Flop (didn't bet)



PokerStars Zoom Hand #84300012808:  Hold'em No Limit ($0.10/$0.25) - 2012/08/05 14:59:30 JST [2012/08/05 1:59:30 ET]
Table 'Whirlpool' 9-max Seat #1 is the button
Seat 1: snejokCoxx ($10.88 in chips) 
Seat 2: Landybob ($41.59 in chips) 
Seat 3: phate-1up ($69.68 in chips) 
Seat 4: canammark ($36.94 in chips) 
Seat 5: troublesomm ($37.48 in chips) 
Seat 6: chiyuki ($23.73 in chips) 
Seat 7: tribunpdm ($27.60 in chips) 
Seat 8: deadmoneykid ($26.23 in chips) 
Seat 9: River_GmbH ($14.40 in chips) 
Landybob: posts small blind $0.10
phate-1up: posts big blind $0.25
*** HOLE CARDS ***
Dealt to chiyuki [8h 7c]
canammark: folds 
troublesomm: folds 
chiyuki: folds 
tribunpdm: folds 
deadmoneykid: folds 
River_GmbH: folds 
snejokCoxx: folds 
Landybob: folds 
Uncalled bet ($0.15) returned to phate-1up
phate-1up collected $0.20 from pot
phate-1up: doesn't show hand 
*** SUMMARY ***
Total pot $0.20 | Rake $0 
Seat 1: snejokCoxx (button) folded before Flop (didn't bet)
Seat 2: Landybob (small blind) folded before Flop
Seat 3: phate-1up (big blind) collected ($0.20)
Seat 4: canammark folded before Flop (didn't bet)
Seat 5: troublesomm folded before Flop (didn't bet)
Seat 6: chiyuki folded before Flop (didn't bet)
Seat 7: tribunpdm folded before Flop (didn't bet)
Seat 8: deadmoneykid folded before Flop (didn't bet)
Seat 9: River_GmbH folded before Flop (didn't bet)



PokerStars Zoom Hand #84300014171:  Hold'em No Limit ($0.10/$0.25) - 2012/08/05 14:59:37 JST [2012/08/05 1:59:37 ET]
Table 'Whirlpool' 9-max Seat #1 is the button
Seat 1: Alvinpe85 ($58.37 in chips) 
Seat 2: chiyuki ($23.73 in chips) 
Seat 3: cofla tito ($10.85 in chips) 
Seat 4: KeLevro0 ($11.06 in chips) 
Seat 5: Dejacob ($26.06 in chips) 
Seat 6: deadmoneykid ($26.23 in chips) 
Seat 7: Dan Royal ($32.06 in chips) 
Seat 8: el pore 5 ($17.82 in chips) 
Seat 9: 1Karina1 ($25 in chips) 
chiyuki: posts small blind $0.10
cofla tito: posts big blind $0.25
*** HOLE CARDS ***
Dealt to chiyuki [2s Ac]
KeLevro0: folds 
Dejacob: folds 
deadmoneykid: folds 
Dan Royal: folds 
el pore 5: folds 
1Karina1: folds 
Alvinpe85: raises $0.37 to $0.62
chiyuki: folds 
cofla tito: folds 
Uncalled bet ($0.37) returned to Alvinpe85
Alvinpe85 collected $0.60 from pot
Alvinpe85: doesn't show hand 
*** SUMMARY ***
Total pot $0.60 | Rake $0 
Seat 1: Alvinpe85 (button) collected ($0.60)
Seat 2: chiyuki (small blind) folded before Flop
Seat 3: cofla tito (big blind) folded before Flop
Seat 4: KeLevro0 folded before Flop (didn't bet)
Seat 5: Dejacob folded before Flop (didn't bet)
Seat 6: deadmoneykid folded before Flop (didn't bet)
Seat 7: Dan Royal folded before Flop (didn't bet)
Seat 8: el pore 5 folded before Flop (didn't bet)
Seat 9: 1Karina1 folded before Flop (didn't bet)



PokerStars Zoom Hand #84300018420:  Hold'em No Limit ($0.10/$0.25) - 2012/08/05 14:59:58 JST [2012/08/05 1:59:58 ET]
Table 'Whirlpool' 9-max Seat #1 is the button
Seat 1: chiyuki ($23.63 in chips) 
Seat 2: 4plankton ($16.83 in chips) 
Seat 3: Alvinpe85 ($50.43 in chips) 
Seat 4: deepakmbh ($25.70 in chips) 
Seat 5: deadmoneykid ($26.23 in chips) 
Seat 6: jacquelinewu ($26.94 in chips) 
Seat 7: GovGus ($36.74 in chips) 
Seat 8: troublesomm ($28.40 in chips) 
Seat 9: cofla tito ($10.60 in chips) 
4plankton: posts small blind $0.10
Alvinpe85: posts big blind $0.25
*** HOLE CARDS ***
Dealt to chiyuki [Jd Qs]
deepakmbh: folds 
deadmoneykid: folds 
jacquelinewu: folds 
GovGus: folds 
troublesomm: folds 
cofla tito: folds 
chiyuki: folds 
4plankton: folds 
Uncalled bet ($0.15) returned to Alvinpe85
Alvinpe85 collected $0.20 from pot
Alvinpe85: doesn't show hand 
*** SUMMARY ***
Total pot $0.20 | Rake $0 
Seat 1: chiyuki (button) folded before Flop (didn't bet)
Seat 2: 4plankton (small blind) folded before Flop
Seat 3: Alvinpe85 (big blind) collected ($0.20)
Seat 4: deepakmbh folded before Flop (didn't bet)
Seat 5: deadmoneykid folded before Flop (didn't bet)
Seat 6: jacquelinewu folded before Flop (didn't bet)
Seat 7: GovGus folded before Flop (didn't bet)
Seat 8: troublesomm folded before Flop (didn't bet)
Seat 9: cofla tito folded before Flop (didn't bet)



PokerStars Zoom Hand #84300021170:  Hold'em No Limit ($0.10/$0.25) - 2012/08/05 15:00:12 JST [2012/08/05 2:00:12 ET]
Table 'Whirlpool' 9-max Seat #1 is the button
Seat 1: phate-1up ($52.34 in chips) 
Seat 2: Dejacob ($31.44 in chips) 
Seat 3: ChrisCDee ($26.51 in chips) 
Seat 4: snejokCoxx ($12.15 in chips) 
Seat 5: chiyuki ($23.63 in chips) 
Seat 6: 1Karina1 ($25 in chips) 
Seat 7: DutchShultzs ($25 in chips) 
Seat 8: Faantomace ($21.53 in chips) 
Seat 9: Wilcox76607 ($35.77 in chips) 
Dejacob: posts small blind $0.10
ChrisCDee: posts big blind $0.25
*** HOLE CARDS ***
Dealt to chiyuki [Qc 5c]
snejokCoxx: raises $0.40 to $0.65
chiyuki: folds 
1Karina1: folds 
DutchShultzs: folds 
Faantomace: folds 
Wilcox76607: folds 
phate-1up: folds 
Dejacob: folds 
ChrisCDee: folds 
Uncalled bet ($0.40) returned to snejokCoxx
snejokCoxx collected $0.60 from pot
snejokCoxx: doesn't show hand 
*** SUMMARY ***
Total pot $0.60 | Rake $0 
Seat 1: phate-1up (button) folded before Flop (didn't bet)
Seat 2: Dejacob (small blind) folded before Flop
Seat 3: ChrisCDee (big blind) folded before Flop
Seat 4: snejokCoxx collected ($0.60)
Seat 5: chiyuki folded before Flop (didn't bet)
Seat 6: 1Karina1 folded before Flop (didn't bet)
Seat 7: DutchShultzs folded before Flop (didn't bet)
Seat 8: Faantomace folded before Flop (didn't bet)
Seat 9: Wilcox76607 folded before Flop (didn't bet)



PokerStars Zoom Hand #84300017041:  Hold'em No Limit ($0.10/$0.25) - 2012/08/05 14:59:51 JST [2012/08/05 1:59:51 ET]
Table 'Whirlpool' 9-max Seat #1 is the button
Seat 1: Phaedrus...3 ($22.83 in chips) 
Seat 2: canammark ($36.69 in chips) 
Seat 3: Silveystryk ($25 in chips) 
Seat 4: cofla tito ($10.70 in chips) 
Seat 5: Tom1999 ($23.75 in chips) 
Seat 6: Perstenev ($13.88 in chips) 
Seat 7: ChrisCDee ($68.94 in chips) 
Seat 8: chiyuki ($23.63 in chips) 
Seat 9: DutchShultzs ($26.78 in chips) 
canammark: posts small blind $0.10
Silveystryk: posts big blind $0.25
*** HOLE CARDS ***
Dealt to chiyuki [3h 4s]
cofla tito: folds 
Tom1999: folds 
Perstenev: folds 
ChrisCDee: raises $0.50 to $0.75
chiyuki: folds 
DutchShultzs: folds 
Phaedrus...3: folds 
canammark: folds 
Silveystryk: folds 
Uncalled bet ($0.50) returned to ChrisCDee
ChrisCDee collected $0.60 from pot
ChrisCDee: doesn't show hand 
*** SUMMARY ***
Total pot $0.60 | Rake $0 
Seat 1: Phaedrus...3 (button) folded before Flop (didn't bet)
Seat 2: canammark (small blind) folded before Flop
Seat 3: Silveystryk (big blind) folded before Flop
Seat 4: cofla tito folded before Flop (didn't bet)
Seat 5: Tom1999 folded before Flop (didn't bet)
Seat 6: Perstenev folded before Flop (didn't bet)
Seat 7: ChrisCDee collected ($0.60)
Seat 8: chiyuki folded before Flop (didn't bet)
Seat 9: DutchShultzs folded before Flop (didn't bet)



PokerStars Zoom Hand #84300019603:  Hold'em No Limit ($0.10/$0.25) - 2012/08/05 15:00:04 JST [2012/08/05 2:00:04 ET]
Table 'Whirlpool' 9-max Seat #1 is the button
Seat 1: ZhukOFFskI ($28.05 in chips) 
Seat 2: deadmoneykid ($26.23 in chips) 
Seat 3: Dejacob ($26.06 in chips) 
Seat 4: empfang ($21.74 in chips) 
Seat 5: deepakmbh ($25.70 in chips) 
Seat 6: 4plankton ($16.73 in chips) 
Seat 7: chiyuki ($23.63 in chips) 
Seat 8: cofla tito ($10.60 in chips) 
Seat 9: troublesomm ($28.40 in chips) 
deadmoneykid: posts small blind $0.10
Dejacob: posts big blind $0.25
*** HOLE CARDS ***
Dealt to chiyuki [8s Qs]
empfang: folds 
deepakmbh: calls $0.25
4plankton: folds 
chiyuki: folds 
cofla tito: folds 
troublesomm: folds 
ZhukOFFskI: folds 
deadmoneykid: folds 
Dejacob: checks 
*** FLOP *** [6s As 3s]
Dejacob: checks 
deepakmbh: bets $0.40
Dejacob: folds 
Uncalled bet ($0.40) returned to deepakmbh
deepakmbh collected $0.57 from pot
deepakmbh: doesn't show hand 
*** SUMMARY ***
Total pot $0.60 | Rake $0.03 
Board [6s As 3s]
Seat 1: ZhukOFFskI (button) folded before Flop (didn't bet)
Seat 2: deadmoneykid (small blind) folded before Flop
Seat 3: Dejacob (big blind) folded on the Flop
Seat 4: empfang folded before Flop (didn't bet)
Seat 5: deepakmbh collected ($0.57)
Seat 6: 4plankton folded before Flop (didn't bet)
Seat 7: chiyuki folded before Flop (didn't bet)
Seat 8: cofla tito folded before Flop (didn't bet)
Seat 9: troublesomm folded before Flop (didn't bet)



PokerStars Zoom Hand #84300022401:  Hold'em No Limit ($0.10/$0.25) - 2012/08/05 15:00:18 JST [2012/08/05 2:00:18 ET]
Table 'Whirlpool' 9-max Seat #1 is the button
Seat 1: KeLevro0 ($10.83 in chips) 
Seat 2: phate-1up ($52.34 in chips) 
Seat 3: DanielWhyte ($48.98 in chips) 
Seat 4: seula i ($106.96 in chips) 
Seat 5: Perstenev ($8.93 in chips) 
Seat 6: 1Karina1 ($25.94 in chips) 
Seat 7: Faantomace ($21.53 in chips) 
Seat 8: chiyuki ($23.63 in chips) 
Seat 9: colorado2108 ($27.85 in chips) 
phate-1up: posts small blind $0.10
DanielWhyte: posts big blind $0.25
*** HOLE CARDS ***
Dealt to chiyuki [9s 9h]
seula i: folds 
Perstenev: folds 
1Karina1: folds 
Faantomace: folds 
chiyuki: raises $0.50 to $0.75
colorado2108: folds 
KeLevro0: raises $1.75 to $2.50
phate-1up: folds 
DanielWhyte: folds 
chiyuki: folds 
Uncalled bet ($1.75) returned to KeLevro0
KeLevro0 collected $1.85 from pot
KeLevro0: doesn't show hand 
*** SUMMARY ***
Total pot $1.85 | Rake $0 
Seat 1: KeLevro0 (button) collected ($1.85)
Seat 2: phate-1up (small blind) folded before Flop
Seat 3: DanielWhyte (big blind) folded before Flop
Seat 4: seula i folded before Flop (didn't bet)
Seat 5: Perstenev folded before Flop (didn't bet)
Seat 6: 1Karina1 folded before Flop (didn't bet)
Seat 7: Faantomace folded before Flop (didn't bet)
Seat 8: chiyuki folded before Flop
Seat 9: colorado2108 folded before Flop (didn't bet)



PokerStars Zoom Hand #84300027498:  Hold'em No Limit ($0.10/$0.25) - 2012/08/05 15:00:44 JST [2012/08/05 2:00:44 ET]
Table 'Whirlpool' 9-max Seat #1 is the button
Seat 1: Dejacob ($25.71 in chips) 
Seat 2: dushvan ($43.53 in chips) 
Seat 3: chiyuki ($22.88 in chips) 
Seat 4: Alvinpe85 ($58.47 in chips) 
Seat 5: edilson_ita ($10.66 in chips) 
Seat 6: KeLevro0 ($11.93 in chips) 
Seat 7: ZhukOFFskI ($46.07 in chips) 
Seat 8: INSP!RON ($25.79 in chips) 
Seat 9: Silveystryk ($25 in chips) 
dushvan: posts small blind $0.10
chiyuki: posts big blind $0.25
*** HOLE CARDS ***
Dealt to chiyuki [8d 7h]
Alvinpe85: folds 
edilson_ita: folds 
KeLevro0: folds 
ZhukOFFskI: folds 
INSP!RON: folds 
Silveystryk: folds 
Dejacob: folds 
dushvan: raises $0.50 to $0.75
chiyuki: folds 
Uncalled bet ($0.50) returned to dushvan
dushvan collected $0.50 from pot
dushvan: doesn't show hand 
*** SUMMARY ***
Total pot $0.50 | Rake $0 
Seat 1: Dejacob (button) folded before Flop (didn't bet)
Seat 2: dushvan (small blind) collected ($0.50)
Seat 3: chiyuki (big blind) folded before Flop
Seat 4: Alvinpe85 folded before Flop (didn't bet)
Seat 5: edilson_ita folded before Flop (didn't bet)
Seat 6: KeLevro0 folded before Flop (didn't bet)
Seat 7: ZhukOFFskI folded before Flop (didn't bet)
Seat 8: INSP!RON folded before Flop (didn't bet)
Seat 9: Silveystryk folded before Flop (didn't bet)



PokerStars Zoom Hand #84300020370:  Hold'em No Limit ($0.10/$0.25) - 2012/08/05 15:00:08 JST [2012/08/05 2:00:08 ET]
Table 'Whirlpool' 9-max Seat #1 is the button
Seat 1: KrystalAA ($30.14 in chips) 
Seat 2: 1Karina1 ($25 in chips) 
Seat 3: Nerkit ($12.50 in chips) 
Seat 4: chiyuki ($23.63 in chips) 
Seat 5: jacquelinewu ($26.94 in chips) 
Seat 6: 111ii111 ($24.62 in chips) 
Seat 7: Wilcox76607 ($35.77 in chips) 
Seat 8: ChrisCDee ($26.51 in chips) 
Seat 9: softdesign ($63.04 in chips) 
1Karina1: posts small blind $0.10
Nerkit: posts big blind $0.25
*** HOLE CARDS ***
Dealt to chiyuki [8c As]
chiyuki: folds 
jacquelinewu: folds 
111ii111: raises $0.50 to $0.75
Wilcox76607: folds 
ChrisCDee: folds 
softdesign: folds 
KrystalAA: calls $0.75
1Karina1: folds 
Nerkit: folds 
*** FLOP *** [8s Jh Kd]
111ii111: checks 
KrystalAA: checks 
*** TURN *** [8s Jh Kd] [4h]
111ii111: checks 
KrystalAA: bets $0.93
111ii111: calls $0.93
*** RIVER *** [8s Jh Kd 4h] [Td]
111ii111: checks 
KrystalAA: checks 
*** SHOW DOWN ***
111ii111: shows [8d 7d] (a pair of Eights)
KrystalAA: shows [Jc Qs] (a pair of Jacks)
KrystalAA collected $3.54 from pot
*** SUMMARY ***
Total pot $3.71 | Rake $0.17 
Board [8s Jh Kd 4h Td]
Seat 1: KrystalAA (button) showed [Jc Qs] and won ($3.54) with a pair of Jacks
Seat 2: 1Karina1 (small blind) folded before Flop
Seat 3: Nerkit (big blind) folded before Flop
Seat 4: chiyuki folded before Flop (didn't bet)
Seat 5: jacquelinewu folded before Flop (didn't bet)
Seat 6: 111ii111 showed [8d 7d] and lost with a pair of Eights
Seat 7: Wilcox76607 folded before Flop (didn't bet)
Seat 8: ChrisCDee folded before Flop (didn't bet)
Seat 9: softdesign folded before Flop (didn't bet)



PokerStars Zoom Hand #84300030114:  Hold'em No Limit ($0.10/$0.25) - 2012/08/05 15:00:56 JST [2012/08/05 2:00:56 ET]
Table 'Whirlpool' 9-max Seat #1 is the button
Seat 1: KimPa39 ($34.22 in chips) 
Seat 2: chiyuki ($22.63 in chips) 
Seat 3: Silveystryk ($24.65 in chips) 
Seat 4: ZhukOFFskI ($46.07 in chips) 
Seat 5: gunbowler ($158.20 in chips) 
Seat 6: hirozo ($49.60 in chips) 
Seat 7: Alvinpe85 ($50.78 in chips) 
Seat 8: troublesomm ($28.40 in chips) 
Seat 9: 1Karina1 ($25.69 in chips) 
chiyuki: posts small blind $0.10
Silveystryk: posts big blind $0.25
*** HOLE CARDS ***
Dealt to chiyuki [5d 9h]
ZhukOFFskI: folds 
gunbowler: folds 
hirozo: folds 
Alvinpe85: folds 
troublesomm: folds 
1Karina1: folds 
KimPa39: folds 
chiyuki: folds 
Uncalled bet ($0.15) returned to Silveystryk
Silveystryk collected $0.20 from pot
Silveystryk: doesn't show hand 
*** SUMMARY ***
Total pot $0.20 | Rake $0 
Seat 1: KimPa39 (button) folded before Flop (didn't bet)
Seat 2: chiyuki (small blind) folded before Flop
Seat 3: Silveystryk (big blind) collected ($0.20)
Seat 4: ZhukOFFskI folded before Flop (didn't bet)
Seat 5: gunbowler folded before Flop (didn't bet)
Seat 6: hirozo folded before Flop (didn't bet)
Seat 7: Alvinpe85 folded before Flop (didn't bet)
Seat 8: troublesomm folded before Flop (didn't bet)
Seat 9: 1Karina1 folded before Flop (didn't bet)



PokerStars Zoom Hand #84300033410:  Hold'em No Limit ($0.10/$0.25) - 2012/08/05 15:01:11 JST [2012/08/05 2:01:11 ET]
Table 'Whirlpool' 9-max Seat #1 is the button
Seat 1: snejokCoxx ($12.40 in chips) 
Seat 2: kamikkaze ($14.75 in chips) 
Seat 3: kesstukas25 ($18.72 in chips) 
Seat 4: hirozo ($69.15 in chips) 
Seat 5: chiyuki ($22.53 in chips) 
Seat 6: Silveystryk ($25 in chips) 
Seat 7: kaplya2010 ($14.37 in chips) 
Seat 8: GovGus ($44.81 in chips) 
Seat 9: empfang ($21.14 in chips) 
kamikkaze: posts small blind $0.10
kesstukas25: posts big blind $0.25
*** HOLE CARDS ***
Dealt to chiyuki [7s 6d]
hirozo: folds 
chiyuki: folds 
Silveystryk: folds 
kaplya2010: raises $0.25 to $0.50
GovGus: folds 
empfang: folds 
snejokCoxx: folds 
kamikkaze: folds 
kesstukas25: folds 
Uncalled bet ($0.25) returned to kaplya2010
kaplya2010 collected $0.60 from pot
kaplya2010: doesn't show hand 
*** SUMMARY ***
Total pot $0.60 | Rake $0 
Seat 1: snejokCoxx (button) folded before Flop (didn't bet)
Seat 2: kamikkaze (small blind) folded before Flop
Seat 3: kesstukas25 (big blind) folded before Flop
Seat 4: hirozo folded before Flop (didn't bet)
Seat 5: chiyuki folded before Flop (didn't bet)
Seat 6: Silveystryk folded before Flop (didn't bet)
Seat 7: kaplya2010 collected ($0.60)
Seat 8: GovGus folded before Flop (didn't bet)
Seat 9: empfang folded before Flop (didn't bet)



PokerStars Zoom Hand #84300032299:  Hold'em No Limit ($0.10/$0.25) - 2012/08/05 15:01:06 JST [2012/08/05 2:01:06 ET]
Table 'Whirlpool' 9-max Seat #1 is the button
Seat 1: troublesomm ($37.13 in chips) 
Seat 2: metrio982 ($11 in chips) 
Seat 3: cofla tito ($10.35 in chips) 
Seat 4: KrystalAA ($29.41 in chips) 
Seat 5: Perstenev ($14.80 in chips) 
Seat 6: edilson_ita ($10.41 in chips) 
Seat 7: Dejacob ($31.09 in chips) 
Seat 8: KeLevro0 ($12.51 in chips) 
Seat 9: chiyuki ($22.53 in chips) 
metrio982: posts small blind $0.10
cofla tito: posts big blind $0.25
*** HOLE CARDS ***
Dealt to chiyuki [Jh 3c]
KrystalAA: folds 
Perstenev: folds 
edilson_ita: folds 
Dejacob: raises $0.50 to $0.75
KeLevro0: folds 
chiyuki: folds 
troublesomm: folds 
metrio982: folds 
cofla tito: folds 
Uncalled bet ($0.50) returned to Dejacob
Dejacob collected $0.60 from pot
Dejacob: doesn't show hand 
*** SUMMARY ***
Total pot $0.60 | Rake $0 
Seat 1: troublesomm (button) folded before Flop (didn't bet)
Seat 2: metrio982 (small blind) folded before Flop
Seat 3: cofla tito (big blind) folded before Flop
Seat 4: KrystalAA folded before Flop (didn't bet)
Seat 5: Perstenev folded before Flop (didn't bet)
Seat 6: edilson_ita folded before Flop (didn't bet)
Seat 7: Dejacob collected ($0.60)
Seat 8: KeLevro0 folded before Flop (didn't bet)
Seat 9: chiyuki folded before Flop (didn't bet)



PokerStars Zoom Hand #84300034320:  Hold'em No Limit ($0.10/$0.25) - 2012/08/05 15:01:15 JST [2012/08/05 2:01:15 ET]
Table 'Whirlpool' 9-max Seat #1 is the button
Seat 1: silvno31 ($16.84 in chips) 
Seat 2: deepakmbh ($23.60 in chips) 
Seat 3: KrystalAA ($34.61 in chips) 
Seat 4: DutchShultzs ($25 in chips) 
Seat 5: snejokCoxx ($10.53 in chips) 
Seat 6: 1Karina1 ($25 in chips) 
Seat 7: chiyuki ($22.53 in chips) 
Seat 8: Ellen1947 ($31.79 in chips) 
Seat 9: seula i ($41.44 in chips) 
deepakmbh: posts small blind $0.10
KrystalAA: posts big blind $0.25
*** HOLE CARDS ***
Dealt to chiyuki [Kc Ah]
DutchShultzs: folds 
snejokCoxx: folds 
1Karina1: folds 
chiyuki: raises $0.50 to $0.75
Ellen1947: folds 
seula i: folds 
silvno31: folds 
deepakmbh: calls $0.65
KrystalAA: folds 
*** FLOP *** [6h 2s Ad]
deepakmbh: checks 
chiyuki: bets $1.25
deepakmbh: calls $1.25
*** TURN *** [6h 2s Ad] [Kd]
deepakmbh: checks 
chiyuki: bets $3.25
deepakmbh: raises $5.25 to $8.50
chiyuki: calls $5.25
*** RIVER *** [6h 2s Ad Kd] [Qc]
deepakmbh: bets $13.10 and is all-in
chiyuki: folds 
Uncalled bet ($13.10) returned to deepakmbh
deepakmbh collected $20.29 from pot
deepakmbh: doesn't show hand 
*** SUMMARY ***
Total pot $21.25 | Rake $0.96 
Board [6h 2s Ad Kd Qc]
Seat 1: silvno31 (button) folded before Flop (didn't bet)
Seat 2: deepakmbh (small blind) collected ($20.29)
Seat 3: KrystalAA (big blind) folded before Flop
Seat 4: DutchShultzs folded before Flop (didn't bet)
Seat 5: snejokCoxx folded before Flop (didn't bet)
Seat 6: 1Karina1 folded before Flop (didn't bet)
Seat 7: chiyuki folded on the River
Seat 8: Ellen1947 folded before Flop (didn't bet)
Seat 9: seula i folded before Flop (didn't bet)



PokerStars Zoom Hand #84300066929:  Hold'em No Limit ($0.10/$0.25) - 2012/08/05 15:03:30 JST [2012/08/05 2:03:30 ET]
Table 'Whirlpool' 9-max Seat #1 is the button
Seat 1: Wilcox76607 ($33.68 in chips) 
Seat 2: DutchShultzs ($32.50 in chips) 
Seat 3: risekuku468 ($40.01 in chips) 
Seat 4: Streikel ($17.37 in chips) 
Seat 5: Dejacob ($26.38 in chips) 
Seat 6: phate-1up ($49.75 in chips) 
Seat 7: KeLevro0 ($11.52 in chips) 
Seat 8: hobby56 ($14.01 in chips) 
Seat 9: chiyuki ($25 in chips) 
DutchShultzs: posts small blind $0.10
risekuku468: posts big blind $0.25
*** HOLE CARDS ***
Dealt to chiyuki [Qd Js]
Streikel: folds 
Dejacob: folds 
phate-1up: folds 
KeLevro0: folds 
hobby56: folds 
chiyuki: folds 
Wilcox76607: folds 
DutchShultzs: folds 
Uncalled bet ($0.15) returned to risekuku468
risekuku468 collected $0.20 from pot
risekuku468: doesn't show hand 
*** SUMMARY ***
Total pot $0.20 | Rake $0 
Seat 1: Wilcox76607 (button) folded before Flop (didn't bet)
Seat 2: DutchShultzs (small blind) folded before Flop
Seat 3: risekuku468 (big blind) collected ($0.20)
Seat 4: Streikel folded before Flop (didn't bet)
Seat 5: Dejacob folded before Flop (didn't bet)
Seat 6: phate-1up folded before Flop (didn't bet)
Seat 7: KeLevro0 folded before Flop (didn't bet)
Seat 8: hobby56 folded before Flop (didn't bet)
Seat 9: chiyuki folded before Flop (didn't bet)



PokerStars Zoom Hand #84300068494:  Hold'em No Limit ($0.10/$0.25) - 2012/08/05 15:03:36 JST [2012/08/05 2:03:36 ET]
Table 'Whirlpool' 9-max Seat #1 is the button
Seat 1: ygoegoe ($25 in chips) 
Seat 2: 1Karina1 ($25 in chips) 
Seat 3: Perstenev ($16.30 in chips) 
Seat 4: INSP!RON ($25 in chips) 
Seat 5: Silveystryk ($23.65 in chips) 
Seat 6: chiyuki ($25 in chips) 
Seat 7: Dejacob ($26.38 in chips) 
Seat 8: hirozo ($73.26 in chips) 
Seat 9: Nerkit ($10.87 in chips) 
1Karina1: posts small blind $0.10
Perstenev: posts big blind $0.25
*** HOLE CARDS ***
Dealt to chiyuki [8c Jh]
INSP!RON: folds 
Silveystryk: folds 
chiyuki: folds 
Dejacob: folds 
hirozo: folds 
Nerkit: folds 
ygoegoe: raises $0.37 to $0.62
1Karina1: folds 
Perstenev: calls $0.37
*** FLOP *** [9h 5d Kd]
Perstenev: checks 
ygoegoe: bets $1.08
Perstenev: folds 
Uncalled bet ($1.08) returned to ygoegoe
ygoegoe collected $1.28 from pot
ygoegoe: doesn't show hand 
*** SUMMARY ***
Total pot $1.34 | Rake $0.06 
Board [9h 5d Kd]
Seat 1: ygoegoe (button) collected ($1.28)
Seat 2: 1Karina1 (small blind) folded before Flop
Seat 3: Perstenev (big blind) folded on the Flop
Seat 4: INSP!RON folded before Flop (didn't bet)
Seat 5: Silveystryk folded before Flop (didn't bet)
Seat 6: chiyuki folded before Flop (didn't bet)
Seat 7: Dejacob folded before Flop (didn't bet)
Seat 8: hirozo folded before Flop (didn't bet)
Seat 9: Nerkit folded before Flop (didn't bet)



PokerStars Zoom Hand #84300065179:  Hold'em No Limit ($0.10/$0.25) - 2012/08/05 15:03:23 JST [2012/08/05 2:03:23 ET]
Table 'Whirlpool' 9-max Seat #1 is the button
Seat 1: starreset ($25 in chips) 
Seat 2: gunbowler ($196.76 in chips) 
Seat 3: Lasutchik ($78.08 in chips) 
Seat 4: chiyuki ($25 in chips) 
Seat 5: 1Karina1 ($27.76 in chips) 
Seat 6: INSP!RON ($25 in chips) 
Seat 7: kamikkaze ($13.30 in chips) 
Seat 8: KeLevro0 ($12.50 in chips) 
Seat 9: el pore 5 ($14.88 in chips) 
gunbowler: posts small blind $0.10
Lasutchik: posts big blind $0.25
*** HOLE CARDS ***
Dealt to chiyuki [8c 2h]
chiyuki: folds 
1Karina1: folds 
INSP!RON: folds 
kamikkaze: folds 
KeLevro0: folds 
el pore 5: folds 
starreset: raises $0.50 to $0.75
gunbowler: calls $0.65
Lasutchik: calls $0.50
*** FLOP *** [4s 8s Jh]
gunbowler: checks 
Lasutchik: bets $1.09
starreset: raises $1.59 to $2.68
gunbowler: folds 
Lasutchik: raises $74.65 to $77.33 and is all-in
starreset: folds 
Uncalled bet ($74.65) returned to Lasutchik
Lasutchik collected $7.27 from pot
Lasutchik: doesn't show hand 
*** SUMMARY ***
Total pot $7.61 | Rake $0.34 
Board [4s 8s Jh]
Seat 1: starreset (button) folded on the Flop
Seat 2: gunbowler (small blind) folded on the Flop
Seat 3: Lasutchik (big blind) collected ($7.27)
Seat 4: chiyuki folded before Flop (didn't bet)
Seat 5: 1Karina1 folded before Flop (didn't bet)
Seat 6: INSP!RON folded before Flop (didn't bet)
Seat 7: kamikkaze folded before Flop (didn't bet)
Seat 8: KeLevro0 folded before Flop (didn't bet)
Seat 9: el pore 5 folded before Flop (didn't bet)



PokerStars Zoom Hand #84300070369:  Hold'em No Limit ($0.10/$0.25) - 2012/08/05 15:03:43 JST [2012/08/05 2:03:43 ET]
Table 'Whirlpool' 9-max Seat #1 is the button
Seat 1: Dejacob ($25 in chips) 
Seat 2: Nerkit ($10.87 in chips) 
Seat 3: chiyuki ($25 in chips) 
Seat 4: deepakmbh ($67.50 in chips) 
Seat 5: KeLevro0 ($11.52 in chips) 
Seat 6: INSP!RON ($25 in chips) 
Seat 7: troublesomm ($36.78 in chips) 
Seat 8: 111ii111 ($5.24 in chips) 
Seat 9: yane73 ($75.44 in chips) 
Nerkit: posts small blind $0.10
chiyuki: posts big blind $0.25
*** HOLE CARDS ***
Dealt to chiyuki [7d 2c]
deepakmbh: folds 
KeLevro0: folds 
INSP!RON: folds 
troublesomm: folds 
111ii111: folds 
yane73: folds 
Dejacob: raises $0.50 to $0.75
Nerkit: folds 
chiyuki: folds 
Uncalled bet ($0.50) returned to Dejacob
Dejacob collected $0.60 from pot
Dejacob: doesn't show hand 
*** SUMMARY ***
Total pot $0.60 | Rake $0 
Seat 1: Dejacob (button) collected ($0.60)
Seat 2: Nerkit (small blind) folded before Flop
Seat 3: chiyuki (big blind) folded before Flop
Seat 4: deepakmbh folded before Flop (didn't bet)
Seat 5: KeLevro0 folded before Flop (didn't bet)
Seat 6: INSP!RON folded before Flop (didn't bet)
Seat 7: troublesomm folded before Flop (didn't bet)
Seat 8: 111ii111 folded before Flop (didn't bet)
Seat 9: yane73 folded before Flop (didn't bet)



PokerStars Zoom Hand #84300062610:  Hold'em No Limit ($0.10/$0.25) - 2012/08/05 15:03:14 JST [2012/08/05 2:03:14 ET]
Table 'Whirlpool' 9-max Seat #1 is the button
Seat 1: chiyuki ($25 in chips) 
Seat 2: mid22 ($17.38 in chips) 
Seat 3: ZhukOFFskI ($29.83 in chips) 
Seat 4: KrystalAA ($33.24 in chips) 
Seat 5: el pore 5 ($14.88 in chips) 
Seat 6: snejokCoxx ($8.65 in chips) 
Seat 7: KimPa39 ($28.22 in chips) 
Seat 8: turbotom122 ($13.66 in chips) 
Seat 9: kamikkaze ($15.12 in chips) 
mid22: posts small blind $0.10
ZhukOFFskI: posts big blind $0.25
*** HOLE CARDS ***
Dealt to chiyuki [4s Td]
KrystalAA: folds 
el pore 5: folds 
snejokCoxx: raises $0.40 to $0.65
KimPa39: folds 
turbotom122: folds 
kamikkaze: folds 
chiyuki: folds 
mid22: calls $0.55
ZhukOFFskI: folds 
*** FLOP *** [8h Ts 7c]
mid22: checks 
snejokCoxx: checks 
*** TURN *** [8h Ts 7c] [8s]
mid22: bets $0.50
snejokCoxx: calls $0.50
*** RIVER *** [8h Ts 7c 8s] [2s]
mid22: checks 
snejokCoxx: checks 
*** SHOW DOWN ***
mid22: shows [7h 5h] (two pair, Eights and Sevens)
snejokCoxx: mucks hand 
mid22 collected $2.44 from pot
*** SUMMARY ***
Total pot $2.55 | Rake $0.11 
Board [8h Ts 7c 8s 2s]
Seat 1: chiyuki (button) folded before Flop (didn't bet)
Seat 2: mid22 (small blind) showed [7h 5h] and won ($2.44) with two pair, Eights and Sevens
Seat 3: ZhukOFFskI (big blind) folded before Flop
Seat 4: KrystalAA folded before Flop (didn't bet)
Seat 5: el pore 5 folded before Flop (didn't bet)
Seat 6: snejokCoxx mucked [6s 6c]
Seat 7: KimPa39 folded before Flop (didn't bet)
Seat 8: turbotom122 folded before Flop (didn't bet)
Seat 9: kamikkaze folded before Flop (didn't bet)



PokerStars Zoom Hand #84300075030:  Hold'em No Limit ($0.10/$0.25) - 2012/08/05 15:04:02 JST [2012/08/05 2:04:02 ET]
Table 'Whirlpool' 9-max Seat #1 is the button
Seat 1: Perstenev ($11.75 in chips) 
Seat 2: chiyuki ($24.75 in chips) 
Seat 3: metrio982 ($6.06 in chips) 
Seat 4: seula i ($25 in chips) 
Seat 5: jacquelinewu ($41.81 in chips) 
Seat 6: ygoegoe ($25 in chips) 
Seat 7: snejokCoxx ($12.33 in chips) 
Seat 8: GovGus ($34.74 in chips) 
Seat 9: Dejacob ($45.51 in chips) 
chiyuki: posts small blind $0.10
metrio982: posts big blind $0.25
*** HOLE CARDS ***
Dealt to chiyuki [Td 5h]
seula i: folds 
jacquelinewu: raises $0.50 to $0.75
ygoegoe: folds 
snejokCoxx: folds 
GovGus: folds 
Dejacob: folds 
Perstenev: folds 
chiyuki: folds 
metrio982: raises $0.50 to $1.25
jacquelinewu: raises $14.75 to $16
metrio982: calls $4.81 and is all-in
Uncalled bet ($9.94) returned to jacquelinewu
*** FLOP *** [4d 2c 2s]
*** TURN *** [4d 2c 2s] [Kh]
*** RIVER *** [4d 2c 2s Kh] [6c]
*** SHOW DOWN ***
metrio982: shows [Ks Ah] (two pair, Kings and Deuces)
jacquelinewu: shows [Kc Kd] (a full house, Kings full of Deuces)
jacquelinewu collected $11.67 from pot
*** SUMMARY ***
Total pot $12.22 | Rake $0.55 
Board [4d 2c 2s Kh 6c]
Seat 1: Perstenev (button) folded before Flop (didn't bet)
Seat 2: chiyuki (small blind) folded before Flop
Seat 3: metrio982 (big blind) showed [Ks Ah] and lost with two pair, Kings and Deuces
Seat 4: seula i folded before Flop (didn't bet)
Seat 5: jacquelinewu showed [Kc Kd] and won ($11.67) with a full house, Kings full of Deuces
Seat 6: ygoegoe folded before Flop (didn't bet)
Seat 7: snejokCoxx folded before Flop (didn't bet)
Seat 8: GovGus folded before Flop (didn't bet)
Seat 9: Dejacob folded before Flop (didn't bet)



PokerStars Zoom Hand #84300078691:  Hold'em No Limit ($0.10/$0.25) - 2012/08/05 15:04:18 JST [2012/08/05 2:04:18 ET]
Table 'Whirlpool' 9-max Seat #1 is the button
Seat 1: troublesomm ($36.78 in chips) 
Seat 2: deepakmbh ($68.05 in chips) 
Seat 3: 4ydo yogurt ($25.39 in chips) 
Seat 4: KrystalAA ($33.26 in chips) 
Seat 5: Dejacob ($26.23 in chips) 
Seat 6: KimPa39 ($27.62 in chips) 
Seat 7: simonzez ($24.66 in chips) 
Seat 8: chiyuki ($24.65 in chips) 
Seat 9: 1Karina1 ($28.31 in chips) 
deepakmbh: posts small blind $0.10
4ydo yogurt: posts big blind $0.25
*** HOLE CARDS ***
Dealt to chiyuki [2d 6s]
KrystalAA: folds 
Dejacob: folds 
KimPa39: raises $0.50 to $0.75
simonzez: calls $0.75
chiyuki: folds 
1Karina1: folds 
troublesomm: folds 
deepakmbh: folds 
4ydo yogurt: calls $0.50
*** FLOP *** [5s 4c 5h]
4ydo yogurt: checks 
KimPa39: bets $1.50
simonzez: folds 
4ydo yogurt: folds 
Uncalled bet ($1.50) returned to KimPa39
KimPa39 collected $2.24 from pot
KimPa39: doesn't show hand 
*** SUMMARY ***
Total pot $2.35 | Rake $0.11 
Board [5s 4c 5h]
Seat 1: troublesomm (button) folded before Flop (didn't bet)
Seat 2: deepakmbh (small blind) folded before Flop
Seat 3: 4ydo yogurt (big blind) folded on the Flop
Seat 4: KrystalAA folded before Flop (didn't bet)
Seat 5: Dejacob folded before Flop (didn't bet)
Seat 6: KimPa39 collected ($2.24)
Seat 7: simonzez folded on the Flop
Seat 8: chiyuki folded before Flop (didn't bet)
Seat 9: 1Karina1 folded before Flop (didn't bet)



PokerStars Zoom Hand #84300076760:  Hold'em No Limit ($0.10/$0.25) - 2012/08/05 15:04:10 JST [2012/08/05 2:04:10 ET]
Table 'Whirlpool' 9-max Seat #1 is the button
Seat 1: Dan Royal ($22 in chips) 
Seat 2: seula i ($34.41 in chips) 
Seat 3: snejokCoxx ($12.50 in chips) 
Seat 4: DutchShultzs ($30.16 in chips) 
Seat 5: DanielWhyte ($54.28 in chips) 
Seat 6: chiyuki ($24.65 in chips) 
Seat 7: Andrei 23rus ($24.15 in chips) 
Seat 8: cofla tito ($12.27 in chips) 
Seat 9: kamikkaze ($12.95 in chips) 
seula i: posts small blind $0.10
snejokCoxx: posts big blind $0.25
*** HOLE CARDS ***
Dealt to chiyuki [2d Ah]
DutchShultzs: folds 
DanielWhyte: folds 
chiyuki: folds 
Andrei 23rus: folds 
cofla tito: folds 
kamikkaze: folds 
Dan Royal: raises $0.50 to $0.75
seula i: folds 
snejokCoxx: calls $0.50
*** FLOP *** [8h 4c 4d]
snejokCoxx: checks 
Dan Royal: bets $0.75
snejokCoxx: folds 
Uncalled bet ($0.75) returned to Dan Royal
Dan Royal collected $1.53 from pot
Dan Royal: doesn't show hand 
*** SUMMARY ***
Total pot $1.60 | Rake $0.07 
Board [8h 4c 4d]
Seat 1: Dan Royal (button) collected ($1.53)
Seat 2: seula i (small blind) folded before Flop
Seat 3: snejokCoxx (big blind) folded on the Flop
Seat 4: DutchShultzs folded before Flop (didn't bet)
Seat 5: DanielWhyte folded before Flop (didn't bet)
Seat 6: chiyuki folded before Flop (didn't bet)
Seat 7: Andrei 23rus folded before Flop (didn't bet)
Seat 8: cofla tito folded before Flop (didn't bet)
Seat 9: kamikkaze folded before Flop (didn't bet)



PokerStars Zoom Hand #84300079740:  Hold'em No Limit ($0.10/$0.25) - 2012/08/05 15:04:22 JST [2012/08/05 2:04:22 ET]
Table 'Whirlpool' 9-max Seat #1 is the button
Seat 1: 1Karina1 ($28.31 in chips) 
Seat 2: KeLevro0 ($11.52 in chips) 
Seat 3: Silveystryk ($28.97 in chips) 
Seat 4: chiyuki ($24.65 in chips) 
Seat 5: Andrei 23rus ($24.15 in chips) 
Seat 6: hobby56 ($14.01 in chips) 
Seat 7: Ellen1947 ($31.14 in chips) 
Seat 8: deepakmbh ($67.95 in chips) 
Seat 9: ZhukOFFskI ($48.19 in chips) 
KeLevro0: posts small blind $0.10
Silveystryk: posts big blind $0.25
*** HOLE CARDS ***
Dealt to chiyuki [Qc 4c]
chiyuki: folds 
Andrei 23rus: raises $0.50 to $0.75
hobby56: folds 
Ellen1947: folds 
deepakmbh: calls $0.75
ZhukOFFskI: folds 
1Karina1: folds 
KeLevro0: folds 
Silveystryk: folds 
*** FLOP *** [5d 9c Jh]
Andrei 23rus: bets $0.75
deepakmbh: calls $0.75
*** TURN *** [5d 9c Jh] [7c]
Andrei 23rus: checks 
deepakmbh: bets $2.25
Andrei 23rus: calls $2.25
*** RIVER *** [5d 9c Jh 7c] [6s]
Andrei 23rus: checks 
deepakmbh: bets $6
Andrei 23rus: folds 
Uncalled bet ($6) returned to deepakmbh
deepakmbh collected $7.50 from pot
deepakmbh: doesn't show hand 
*** SUMMARY ***
Total pot $7.85 | Rake $0.35 
Board [5d 9c Jh 7c 6s]
Seat 1: 1Karina1 (button) folded before Flop (didn't bet)
Seat 2: KeLevro0 (small blind) folded before Flop
Seat 3: Silveystryk (big blind) folded before Flop
Seat 4: chiyuki folded before Flop (didn't bet)
Seat 5: Andrei 23rus folded on the River
Seat 6: hobby56 folded before Flop (didn't bet)
Seat 7: Ellen1947 folded before Flop (didn't bet)
Seat 8: deepakmbh collected ($7.50)
Seat 9: ZhukOFFskI folded before Flop (didn't bet)



PokerStars Zoom Hand #84300081787:  Hold'em No Limit ($0.10/$0.25) - 2012/08/05 15:04:30 JST [2012/08/05 2:04:30 ET]
Table 'Whirlpool' 9-max Seat #1 is the button
Seat 1: INSP!RON ($25 in chips) 
Seat 2: rorfo23 ($20.34 in chips) 
Seat 3: hobby56 ($14.01 in chips) 
Seat 4: DutchShultzs ($32.60 in chips) 
Seat 5: troublesomm ($36.68 in chips) 
Seat 6: kaplya2010 ($21.78 in chips) 
Seat 7: chiyuki ($24.65 in chips) 
Seat 8: River_GmbH ($13.15 in chips) 
Seat 9: kesstukas25 ($12.50 in chips) 
rorfo23: posts small blind $0.10
hobby56: posts big blind $0.25
*** HOLE CARDS ***
Dealt to chiyuki [Js Ad]
DutchShultzs: raises $0.50 to $0.75
troublesomm: folds 
kaplya2010: folds 
chiyuki: folds 
River_GmbH: folds 
kesstukas25: calls $0.75
INSP!RON: folds 
rorfo23: folds 
hobby56: folds 
*** FLOP *** [Kc 5c 4s]
DutchShultzs: bets $1.30
kesstukas25: folds 
Uncalled bet ($1.30) returned to DutchShultzs
DutchShultzs collected $1.77 from pot
DutchShultzs: doesn't show hand 
*** SUMMARY ***
Total pot $1.85 | Rake $0.08 
Board [Kc 5c 4s]
Seat 1: INSP!RON (button) folded before Flop (didn't bet)
Seat 2: rorfo23 (small blind) folded before Flop
Seat 3: hobby56 (big blind) folded before Flop
Seat 4: DutchShultzs collected ($1.77)
Seat 5: troublesomm folded before Flop (didn't bet)
Seat 6: kaplya2010 folded before Flop (didn't bet)
Seat 7: chiyuki folded before Flop (didn't bet)
Seat 8: River_GmbH folded before Flop (didn't bet)
Seat 9: kesstukas25 folded on the Flop



PokerStars Zoom Hand #84300084620:  Hold'em No Limit ($0.10/$0.25) - 2012/08/05 15:04:41 JST [2012/08/05 2:04:41 ET]
Table 'Whirlpool' 9-max Seat #1 is the button
Seat 1: deepakmbh ($33.15 in chips) 
Seat 2: hobby56 ($13.76 in chips) 
Seat 3: Ellen1947 ($31.14 in chips) 
Seat 4: starreset ($25.78 in chips) 
Seat 5: chiyuki ($24.65 in chips) 
Seat 6: mid22 ($18.17 in chips) 
Seat 7: 4ydo yogurt ($24.64 in chips) 
Seat 8: 1Karina1 ($25 in chips) 
Seat 9: Streikel ($16.52 in chips) 
hobby56: posts small blind $0.10
Ellen1947: posts big blind $0.25
*** HOLE CARDS ***
Dealt to chiyuki [3c Tc]
starreset: folds 
chiyuki: folds 
mid22: calls $0.25
4ydo yogurt: folds 
1Karina1: folds 
Streikel: folds 
deepakmbh: folds 
hobby56: folds 
Ellen1947: checks 
*** FLOP *** [Qd 7d 6h]
Ellen1947: checks 
mid22: checks 
*** TURN *** [Qd 7d 6h] [6c]
Ellen1947: checks 
mid22: checks 
*** RIVER *** [Qd 7d 6h 6c] [8d]
Ellen1947: bets $0.25
mid22: folds 
Uncalled bet ($0.25) returned to Ellen1947
Ellen1947 collected $0.57 from pot
Ellen1947: doesn't show hand 
*** SUMMARY ***
Total pot $0.60 | Rake $0.03 
Board [Qd 7d 6h 6c 8d]
Seat 1: deepakmbh (button) folded before Flop (didn't bet)
Seat 2: hobby56 (small blind) folded before Flop
Seat 3: Ellen1947 (big blind) collected ($0.57)
Seat 4: starreset folded before Flop (didn't bet)
Seat 5: chiyuki folded before Flop (didn't bet)
Seat 6: mid22 folded on the River
Seat 7: 4ydo yogurt folded before Flop (didn't bet)
Seat 8: 1Karina1 folded before Flop (didn't bet)
Seat 9: Streikel folded before Flop (didn't bet)



PokerStars Zoom Hand #84300080784:  Hold'em No Limit ($0.10/$0.25) - 2012/08/05 15:04:26 JST [2012/08/05 2:04:26 ET]
Table 'Whirlpool' 9-max Seat #1 is the button
Seat 1: chiyuki ($24.65 in chips) 
Seat 2: Dejacob ($45.51 in chips) 
Seat 3: ygoegoe ($25 in chips) 
Seat 4: ChrisCDee ($46.75 in chips) 
Seat 5: cofla tito ($12.27 in chips) 
Seat 6: KeLevro0 ($11.42 in chips) 
Seat 7: kesstukas25 ($12.50 in chips) 
Seat 8: ZhukOFFskI ($29.58 in chips) 
Seat 9: mjmichi ($25 in chips) 
Dejacob: posts small blind $0.10
ygoegoe: posts big blind $0.25
*** HOLE CARDS ***
Dealt to chiyuki [2c 7d]
ChrisCDee: folds 
cofla tito: raises $0.25 to $0.50
KeLevro0: folds 
kesstukas25: folds 
ZhukOFFskI: folds 
mjmichi: calls $0.50
chiyuki: folds 
Dejacob: folds 
ygoegoe: folds 
*** FLOP *** [5d Qd Kc]
cofla tito: bets $0.75
mjmichi: calls $0.75
*** TURN *** [5d Qd Kc] [Kh]
cofla tito: bets $1
mjmichi: calls $1
*** RIVER *** [5d Qd Kc Kh] [8h]
cofla tito: checks 
mjmichi: bets $5
cofla tito: folds 
Uncalled bet ($5) returned to mjmichi
mjmichi collected $4.63 from pot
mjmichi: doesn't show hand 
*** SUMMARY ***
Total pot $4.85 | Rake $0.22 
Board [5d Qd Kc Kh 8h]
Seat 1: chiyuki (button) folded before Flop (didn't bet)
Seat 2: Dejacob (small blind) folded before Flop
Seat 3: ygoegoe (big blind) folded before Flop
Seat 4: ChrisCDee folded before Flop (didn't bet)
Seat 5: cofla tito folded on the River
Seat 6: KeLevro0 folded before Flop (didn't bet)
Seat 7: kesstukas25 folded before Flop (didn't bet)
Seat 8: ZhukOFFskI folded before Flop (didn't bet)
Seat 9: mjmichi collected ($4.63)



PokerStars Zoom Hand #84300086177:  Hold'em No Limit ($0.10/$0.25) - 2012/08/05 15:04:47 JST [2012/08/05 2:04:47 ET]
Table 'Whirlpool' 9-max Seat #1 is the button
Seat 1: Nerkit ($11.50 in chips) 
Seat 2: KimPa39 ($29.11 in chips) 
Seat 3: starreset ($25.78 in chips) 
Seat 4: Perstenev ($11.75 in chips) 
Seat 5: Ellen1947 ($31.39 in chips) 
Seat 6: DutchShultzs ($31.80 in chips) 
Seat 7: phate-1up ($25.43 in chips) 
Seat 8: chiyuki ($24.65 in chips) 
Seat 9: Lasutchik ($81.82 in chips) 
KimPa39: posts small blind $0.10
starreset: posts big blind $0.25
*** HOLE CARDS ***
Dealt to chiyuki [4c Kd]
Perstenev: folds 
Ellen1947: raises $0.25 to $0.50
DutchShultzs: calls $0.50
phate-1up: folds 
chiyuki: folds 
Lasutchik: calls $0.50
Nerkit: calls $0.50
KimPa39: folds 
starreset: folds 
*** FLOP *** [5s 5h 2s]
Ellen1947: checks 
DutchShultzs: checks 
Lasutchik: checks 
Nerkit: checks 
*** TURN *** [5s 5h 2s] [8s]
Ellen1947: checks 
DutchShultzs: bets $0.90
Lasutchik: folds 
Nerkit: folds 
Ellen1947: folds 
Uncalled bet ($0.90) returned to DutchShultzs
DutchShultzs collected $2.24 from pot
DutchShultzs: doesn't show hand 
*** SUMMARY ***
Total pot $2.35 | Rake $0.11 
Board [5s 5h 2s 8s]
Seat 1: Nerkit (button) folded on the Turn
Seat 2: KimPa39 (small blind) folded before Flop
Seat 3: starreset (big blind) folded before Flop
Seat 4: Perstenev folded before Flop (didn't bet)
Seat 5: Ellen1947 folded on the Turn
Seat 6: DutchShultzs collected ($2.24)
Seat 7: phate-1up folded before Flop (didn't bet)
Seat 8: chiyuki folded before Flop (didn't bet)
Seat 9: Lasutchik folded on the Turn



PokerStars Zoom Hand #84300087503:  Hold'em No Limit ($0.10/$0.25) - 2012/08/05 15:04:52 JST [2012/08/05 2:04:52 ET]
Table 'Whirlpool' 9-max Seat #1 is the button
Seat 1: KimPa39 ($29.01 in chips) 
Seat 2: hirozo ($80.40 in chips) 
Seat 3: chiyuki ($24.65 in chips) 
Seat 4: seula i ($37.44 in chips) 
Seat 5: 4ydo yogurt ($24.64 in chips) 
Seat 6: Streikel ($16.52 in chips) 
Seat 7: rorfo23 ($20.24 in chips) 
Seat 8: bigred1102 ($30.51 in chips) 
Seat 9: phate-1up ($69.33 in chips) 
hirozo: posts small blind $0.10
chiyuki: posts big blind $0.25
*** HOLE CARDS ***
Dealt to chiyuki [Qc Kh]
seula i: folds 
4ydo yogurt: folds 
Streikel: folds 
rorfo23: folds 
bigred1102: folds 
phate-1up: raises $0.50 to $0.75
KimPa39: folds 
hirozo: folds 
chiyuki: calls $0.50
*** FLOP *** [3c 7s 8h]
chiyuki: checks 
phate-1up: bets $1.25
chiyuki: calls $1.25
*** TURN *** [3c 7s 8h] [6d]
chiyuki: checks 
phate-1up: checks 
*** RIVER *** [3c 7s 8h 6d] [8d]
chiyuki: bets $2
phate-1up: folds 
Uncalled bet ($2) returned to chiyuki
chiyuki collected $3.92 from pot
chiyuki: doesn't show hand 
*** SUMMARY ***
Total pot $4.10 | Rake $0.18 
Board [3c 7s 8h 6d 8d]
Seat 1: KimPa39 (button) folded before Flop (didn't bet)
Seat 2: hirozo (small blind) folded before Flop
Seat 3: chiyuki (big blind) collected ($3.92)
Seat 4: seula i folded before Flop (didn't bet)
Seat 5: 4ydo yogurt folded before Flop (didn't bet)
Seat 6: Streikel folded before Flop (didn't bet)
Seat 7: rorfo23 folded before Flop (didn't bet)
Seat 8: bigred1102 folded before Flop (didn't bet)
Seat 9: phate-1up folded on the River



PokerStars Zoom Hand #84300109985:  Hold'em No Limit ($0.10/$0.25) - 2012/08/05 15:06:21 JST [2012/08/05 2:06:21 ET]
Table 'Whirlpool' 9-max Seat #1 is the button
Seat 1: hirozo ($50.62 in chips) 
Seat 2: chiyuki ($26.57 in chips) 
Seat 3: Silveystryk ($22.55 in chips) 
Seat 4: Jene4kaBest ($10.07 in chips) 
Seat 5: snejokCoxx ($13.82 in chips) 
Seat 6: jacquelinewu ($25 in chips) 
Seat 7: Rilko1975 ($25.79 in chips) 
Seat 8: puffy5533 ($26.34 in chips) 
Seat 9: KrystalAA ($33.14 in chips) 
chiyuki: posts small blind $0.10
Silveystryk: posts big blind $0.25
*** HOLE CARDS ***
Dealt to chiyuki [4d Tc]
Jene4kaBest: folds 
snejokCoxx: folds 
jacquelinewu: folds 
Rilko1975: folds 
puffy5533: folds 
KrystalAA: folds 
hirozo: raises $0.25 to $0.50
chiyuki: folds 
Silveystryk: folds 
Uncalled bet ($0.25) returned to hirozo
hirozo collected $0.60 from pot
hirozo: doesn't show hand 
*** SUMMARY ***
Total pot $0.60 | Rake $0 
Seat 1: hirozo (button) collected ($0.60)
Seat 2: chiyuki (small blind) folded before Flop
Seat 3: Silveystryk (big blind) folded before Flop
Seat 4: Jene4kaBest folded before Flop (didn't bet)
Seat 5: snejokCoxx folded before Flop (didn't bet)
Seat 6: jacquelinewu folded before Flop (didn't bet)
Seat 7: Rilko1975 folded before Flop (didn't bet)
Seat 8: puffy5533 folded before Flop (didn't bet)
Seat 9: KrystalAA folded before Flop (didn't bet)



PokerStars Zoom Hand #84300111044:  Hold'em No Limit ($0.10/$0.25) - 2012/08/05 15:06:25 JST [2012/08/05 2:06:25 ET]
Table 'Whirlpool' 9-max Seat #1 is the button
Seat 1: Ellen1947 ($30.54 in chips) 
Seat 2: colorado2108 ($53.60 in chips) 
Seat 3: troublesomm ($40.86 in chips) 
Seat 4: Jene4kaBest ($10.07 in chips) 
Seat 5: deepakmbh ($62.01 in chips) 
Seat 6: seula i ($106.54 in chips) 
Seat 7: ChrisCDee ($45.40 in chips) 
Seat 8: Rilko1975 ($25.79 in chips) 
Seat 9: chiyuki ($26.47 in chips) 
colorado2108: posts small blind $0.10
troublesomm: posts big blind $0.25
*** HOLE CARDS ***
Dealt to chiyuki [Jc 9c]
Jene4kaBest: folds 
deepakmbh: raises $0.50 to $0.75
seula i: folds 
ChrisCDee: folds 
Rilko1975: folds 
chiyuki: folds 
Ellen1947: folds 
colorado2108: folds 
troublesomm: folds 
Uncalled bet ($0.50) returned to deepakmbh
deepakmbh collected $0.60 from pot
deepakmbh: doesn't show hand 
*** SUMMARY ***
Total pot $0.60 | Rake $0 
Seat 1: Ellen1947 (button) folded before Flop (didn't bet)
Seat 2: colorado2108 (small blind) folded before Flop
Seat 3: troublesomm (big blind) folded before Flop
Seat 4: Jene4kaBest folded before Flop (didn't bet)
Seat 5: deepakmbh collected ($0.60)
Seat 6: seula i folded before Flop (didn't bet)
Seat 7: ChrisCDee folded before Flop (didn't bet)
Seat 8: Rilko1975 folded before Flop (didn't bet)
Seat 9: chiyuki folded before Flop (didn't bet)



PokerStars Zoom Hand #84300108486:  Hold'em No Limit ($0.10/$0.25) - 2012/08/05 15:06:15 JST [2012/08/05 2:06:15 ET]
Table 'Whirlpool' 9-max Seat #1 is the button
Seat 1: jacquelinewu ($25 in chips) 
Seat 2: Dejacob ($27.56 in chips) 
Seat 3: kamikkaze ($12.60 in chips) 
Seat 4: chiyuki ($26.57 in chips) 
Seat 5: 4ydo yogurt ($25.24 in chips) 
Seat 6: kesstukas25 ($12.50 in chips) 
Seat 7: WARIBANA7777 ($15.88 in chips) 
Seat 8: 1Karina1 ($27.96 in chips) 
Seat 9: Perstenev ($14.66 in chips) 
Dejacob: posts small blind $0.10
kamikkaze: posts big blind $0.25
*** HOLE CARDS ***
Dealt to chiyuki [5d 2h]
chiyuki: folds 
4ydo yogurt: folds 
kesstukas25: folds 
WARIBANA7777: folds 
1Karina1: raises $0.50 to $0.75
Perstenev: calls $0.75
jacquelinewu: folds 
Dejacob: folds 
kamikkaze: folds 
*** FLOP *** [Js Ac Tc]
1Karina1: bets $1.25
Perstenev: calls $1.25
*** TURN *** [Js Ac Tc] [9s]
1Karina1: checks 
Perstenev: checks 
*** RIVER *** [Js Ac Tc 9s] [6s]
1Karina1: checks 
Perstenev: bets $2.07
1Karina1: calls $2.07
*** SHOW DOWN ***
Perstenev: shows [Ah Qd] (a pair of Aces)
1Karina1: shows [Qc As] (a pair of Aces)
1Karina1 collected $4.06 from pot
Perstenev collected $4.05 from pot
*** SUMMARY ***
Total pot $8.49 | Rake $0.38 
Board [Js Ac Tc 9s 6s]
Seat 1: jacquelinewu (button) folded before Flop (didn't bet)
Seat 2: Dejacob (small blind) folded before Flop
Seat 3: kamikkaze (big blind) folded before Flop
Seat 4: chiyuki folded before Flop (didn't bet)
Seat 5: 4ydo yogurt folded before Flop (didn't bet)
Seat 6: kesstukas25 folded before Flop (didn't bet)
Seat 7: WARIBANA7777 folded before Flop (didn't bet)
Seat 8: 1Karina1 showed [Qc As] and won ($4.06) with a pair of Aces
Seat 9: Perstenev showed [Ah Qd] and won ($4.05) with a pair of Aces



PokerStars Zoom Hand #84300109256:  Hold'em No Limit ($0.10/$0.25) - 2012/08/05 15:06:18 JST [2012/08/05 2:06:18 ET]
Table 'Whirlpool' 9-max Seat #1 is the button
Seat 1: ZhukOFFskI ($29.23 in chips) 
Seat 2: jeades ($13.25 in chips) 
Seat 3: kamikkaze ($15.62 in chips) 
Seat 4: Ellen1947 ($30.54 in chips) 
Seat 5: svg51 ($14.40 in chips) 
Seat 6: phate-1up ($48.96 in chips) 
Seat 7: chiyuki ($26.57 in chips) 
Seat 8: el pore 5 ($18.67 in chips) 
Seat 9: Alvinpe85 ($47.38 in chips) 
jeades: posts small blind $0.10
kamikkaze: posts big blind $0.25
*** HOLE CARDS ***
Dealt to chiyuki [5d 6h]
Ellen1947: folds 
svg51: calls $0.25
phate-1up: folds 
chiyuki: folds 
el pore 5: folds 
Alvinpe85: raises $0.62 to $0.87
ZhukOFFskI: folds 
jeades: folds 
kamikkaze: folds 
svg51: calls $0.62
*** FLOP *** [Ks Kc 4h]
svg51: checks 
Alvinpe85: bets $1.20
svg51: calls $1.20
*** TURN *** [Ks Kc 4h] [Js]
svg51: checks 
Alvinpe85: checks 
*** RIVER *** [Ks Kc 4h Js] [5h]
svg51: bets $1.25
Alvinpe85: folds 
Uncalled bet ($1.25) returned to svg51
svg51 collected $4.29 from pot
svg51: doesn't show hand 
*** SUMMARY ***
Total pot $4.49 | Rake $0.20 
Board [Ks Kc 4h Js 5h]
Seat 1: ZhukOFFskI (button) folded before Flop (didn't bet)
Seat 2: jeades (small blind) folded before Flop
Seat 3: kamikkaze (big blind) folded before Flop
Seat 4: Ellen1947 folded before Flop (didn't bet)
Seat 5: svg51 collected ($4.29)
Seat 6: phate-1up folded before Flop (didn't bet)
Seat 7: chiyuki folded before Flop (didn't bet)
Seat 8: el pore 5 folded before Flop (didn't bet)
Seat 9: Alvinpe85 folded on the River



PokerStars Zoom Hand #84300114761:  Hold'em No Limit ($0.10/$0.25) - 2012/08/05 15:06:40 JST [2012/08/05 2:06:40 ET]
Table 'Whirlpool' 9-max Seat #1 is the button
Seat 1: chiyuki ($26.47 in chips) 
Seat 2: 1Karina1 ($25.10 in chips) 
Seat 3: PillZ86 ($23.39 in chips) 
Seat 4: moku36 ($17.18 in chips) 
Seat 5: Paranoix1990 ($14.56 in chips) 
Seat 6: cofla tito ($10.19 in chips) 
Seat 7: snejokCoxx ($13.82 in chips) 
Seat 8: kesstukas25 ($12.52 in chips) 
Seat 9: Jene4kaBest ($9.97 in chips) 
1Karina1: posts small blind $0.10
PillZ86: posts big blind $0.25
*** HOLE CARDS ***
Dealt to chiyuki [9d 9s]
moku36: folds 
Paranoix1990: folds 
cofla tito: folds 
snejokCoxx: folds 
kesstukas25: folds 
Jene4kaBest: raises $0.50 to $0.75
chiyuki: calls $0.75
1Karina1: folds 
PillZ86: folds 
*** FLOP *** [Qd 2c 6s]
Jene4kaBest: bets $0.75
chiyuki: calls $0.75
*** TURN *** [Qd 2c 6s] [Qh]
Jene4kaBest: bets $1.28
chiyuki: calls $1.28
*** RIVER *** [Qd 2c 6s Qh] [Jd]
Jene4kaBest: checks 
chiyuki: checks 
*** SHOW DOWN ***
Jene4kaBest: shows [6d 7d] (two pair, Queens and Sixes)
chiyuki: shows [9d 9s] (two pair, Queens and Nines)
chiyuki collected $5.64 from pot
*** SUMMARY ***
Total pot $5.91 | Rake $0.27 
Board [Qd 2c 6s Qh Jd]
Seat 1: chiyuki (button) showed [9d 9s] and won ($5.64) with two pair, Queens and Nines
Seat 2: 1Karina1 (small blind) folded before Flop
Seat 3: PillZ86 (big blind) folded before Flop
Seat 4: moku36 folded before Flop (didn't bet)
Seat 5: Paranoix1990 folded before Flop (didn't bet)
Seat 6: cofla tito folded before Flop (didn't bet)
Seat 7: snejokCoxx folded before Flop (didn't bet)
Seat 8: kesstukas25 folded before Flop (didn't bet)
Seat 9: Jene4kaBest showed [6d 7d] and lost with two pair, Queens and Sixes



PokerStars Zoom Hand #84300133473:  Hold'em No Limit ($0.10/$0.25) - 2012/08/05 15:07:54 JST [2012/08/05 2:07:54 ET]
Table 'Whirlpool' 9-max Seat #1 is the button
Seat 1: Yoshimac ($13.43 in chips) 
Seat 2: Saruotiss ($22.53 in chips) 
Seat 3: Vahe50 ($13.94 in chips) 
Seat 4: chiyuki ($29.33 in chips) 
Seat 5: PAMBOS.L ($24.54 in chips) 
Seat 6: phate-1up ($25 in chips) 
Seat 7: Gichboy ($6.56 in chips) 
Seat 8: Jene4kaBest ($7.19 in chips) 
Seat 9: masterkoolb ($12.50 in chips) 
Saruotiss: posts small blind $0.10
Vahe50: posts big blind $0.25
*** HOLE CARDS ***
Dealt to chiyuki [Tc Qs]
chiyuki: folds 
PAMBOS.L: folds 
phate-1up: folds 
Gichboy: folds 
Jene4kaBest: folds 
masterkoolb: folds 
Yoshimac: calls $0.25
Saruotiss: folds 
Vahe50: checks 
*** FLOP *** [2s Ac Js]
Vahe50: bets $0.50
Yoshimac: folds 
Uncalled bet ($0.50) returned to Vahe50
Vahe50 collected $0.57 from pot
Vahe50: doesn't show hand 
*** SUMMARY ***
Total pot $0.60 | Rake $0.03 
Board [2s Ac Js]
Seat 1: Yoshimac (button) folded on the Flop
Seat 2: Saruotiss (small blind) folded before Flop
Seat 3: Vahe50 (big blind) collected ($0.57)
Seat 4: chiyuki folded before Flop (didn't bet)
Seat 5: PAMBOS.L folded before Flop (didn't bet)
Seat 6: phate-1up folded before Flop (didn't bet)
Seat 7: Gichboy folded before Flop (didn't bet)
Seat 8: Jene4kaBest folded before Flop (didn't bet)
Seat 9: masterkoolb folded before Flop (didn't bet)



PokerStars Zoom Hand #84300137458:  Hold'em No Limit ($0.10/$0.25) - 2012/08/05 15:08:10 JST [2012/08/05 2:08:10 ET]
Table 'Whirlpool' 9-max Seat #1 is the button
Seat 1: Lasutchik ($75.93 in chips) 
Seat 2: Perstenev ($12.75 in chips) 
Seat 3: chiyuki ($29.23 in chips) 
Seat 4: pandaaaaaa ($12.15 in chips) 
Seat 5: kamikkaze ($15.02 in chips) 
Seat 6: DutchShultzs ($26.79 in chips) 
Seat 7: Paranoix1990 ($14.06 in chips) 
Seat 8: phate-1up ($25 in chips) 
Seat 9: snejokCoxx ($13.55 in chips) 
Perstenev: posts small blind $0.10
chiyuki: posts big blind $0.25
*** HOLE CARDS ***
Dealt to chiyuki [3c Ts]
pandaaaaaa: folds 
kamikkaze: folds 
DutchShultzs: folds 
Paranoix1990: folds 
phate-1up: folds 
snejokCoxx: folds 
Lasutchik: folds 
Perstenev: raises $0.50 to $0.75
chiyuki: folds 
Uncalled bet ($0.50) returned to Perstenev
Perstenev collected $0.50 from pot
Perstenev: doesn't show hand 
*** SUMMARY ***
Total pot $0.50 | Rake $0 
Seat 1: Lasutchik (button) folded before Flop (didn't bet)
Seat 2: Perstenev (small blind) collected ($0.50)
Seat 3: chiyuki (big blind) folded before Flop
Seat 4: pandaaaaaa folded before Flop (didn't bet)
Seat 5: kamikkaze folded before Flop (didn't bet)
Seat 6: DutchShultzs folded before Flop (didn't bet)
Seat 7: Paranoix1990 folded before Flop (didn't bet)
Seat 8: phate-1up folded before Flop (didn't bet)
Seat 9: snejokCoxx folded before Flop (didn't bet)



PokerStars Zoom Hand #84300142573:  Hold'em No Limit ($0.10/$0.25) - 2012/08/05 15:08:30 JST [2012/08/05 2:08:30 ET]
Table 'Whirlpool' 9-max Seat #1 is the button
Seat 1: seula i ($30.81 in chips) 
Seat 2: Vahe50 ($14.26 in chips) 
Seat 3: Dejacob ($27.31 in chips) 
Seat 4: deadmoneykid ($30.32 in chips) 
Seat 5: KeLevro0 ($9.17 in chips) 
Seat 6: DutchShultzs ($27.66 in chips) 
Seat 7: edilson_ita ($39.71 in chips) 
Seat 8: kamikkaze ($14.92 in chips) 
Seat 9: chiyuki ($28.98 in chips) 
Vahe50: posts small blind $0.10
Dejacob: posts big blind $0.25
*** HOLE CARDS ***
Dealt to chiyuki [3c 2s]
deadmoneykid: folds 
KeLevro0: folds 
DutchShultzs: folds 
edilson_ita: folds 
kamikkaze: folds 
chiyuki: folds 
seula i: folds 
Vahe50: raises $0.25 to $0.50
Dejacob: folds 
Uncalled bet ($0.25) returned to Vahe50
Vahe50 collected $0.50 from pot
Vahe50: doesn't show hand 
*** SUMMARY ***
Total pot $0.50 | Rake $0 
Seat 1: seula i (button) folded before Flop (didn't bet)
Seat 2: Vahe50 (small blind) collected ($0.50)
Seat 3: Dejacob (big blind) folded before Flop
Seat 4: deadmoneykid folded before Flop (didn't bet)
Seat 5: KeLevro0 folded before Flop (didn't bet)
Seat 6: DutchShultzs folded before Flop (didn't bet)
Seat 7: edilson_ita folded before Flop (didn't bet)
Seat 8: kamikkaze folded before Flop (didn't bet)
Seat 9: chiyuki folded before Flop (didn't bet)



PokerStars Zoom Hand #84300136478:  Hold'em No Limit ($0.10/$0.25) - 2012/08/05 15:08:06 JST [2012/08/05 2:08:06 ET]
Table 'Whirlpool' 9-max Seat #1 is the button
Seat 1: PillZ86 ($22.89 in chips) 
Seat 2: chiyuki ($29.33 in chips) 
Seat 3: PAMBOS.L ($24.54 in chips) 
Seat 4: DutchShultzs ($32.84 in chips) 
Seat 5: Silveystryk ($23.93 in chips) 
Seat 6: Dejacob ($39.66 in chips) 
Seat 7: masterkoolb ($12.50 in chips) 
Seat 8: deadmoneykid ($24.88 in chips) 
Seat 9: pandaaaaaa ($12.15 in chips) 
chiyuki: posts small blind $0.10
PAMBOS.L: posts big blind $0.25
*** HOLE CARDS ***
Dealt to chiyuki [3h 9h]
DutchShultzs: folds 
Silveystryk: calls $0.25
Dejacob: folds 
masterkoolb: raises $1 to $1.25
deadmoneykid: folds 
pandaaaaaa: folds 
PillZ86: folds 
chiyuki: folds 
PAMBOS.L: calls $1
Silveystryk: folds 
*** FLOP *** [7d Jc 2c]
PAMBOS.L: checks 
masterkoolb: bets $2.04
PAMBOS.L: folds 
Uncalled bet ($2.04) returned to masterkoolb
masterkoolb collected $2.72 from pot
masterkoolb: doesn't show hand 
*** SUMMARY ***
Total pot $2.85 | Rake $0.13 
Board [7d Jc 2c]
Seat 1: PillZ86 (button) folded before Flop (didn't bet)
Seat 2: chiyuki (small blind) folded before Flop
Seat 3: PAMBOS.L (big blind) folded on the Flop
Seat 4: DutchShultzs folded before Flop (didn't bet)
Seat 5: Silveystryk folded before Flop
Seat 6: Dejacob folded before Flop (didn't bet)
Seat 7: masterkoolb collected ($2.72)
Seat 8: deadmoneykid folded before Flop (didn't bet)
Seat 9: pandaaaaaa folded before Flop (didn't bet)



PokerStars Zoom Hand #84300132411:  Hold'em No Limit ($0.10/$0.25) - 2012/08/05 15:07:50 JST [2012/08/05 2:07:50 ET]
Table 'Whirlpool' 9-max Seat #1 is the button
Seat 1: ZhukOFFskI ($49.53 in chips) 
Seat 2: hirozo ($50.97 in chips) 
Seat 3: NuMetal88 ($34.12 in chips) 
Seat 4: Yoshimac ($13.43 in chips) 
Seat 5: deadmoneykid ($24.88 in chips) 
Seat 6: chiyuki ($29.33 in chips) 
Seat 7: phate-1up ($53.56 in chips) 
Seat 8: KAKamiro ($21.14 in chips) 
Seat 9: PAMBOS.L ($24.54 in chips) 
hirozo: posts small blind $0.10
NuMetal88: posts big blind $0.25
*** HOLE CARDS ***
Dealt to chiyuki [8c Jh]
Yoshimac: folds 
deadmoneykid: folds 
chiyuki: folds 
phate-1up: folds 
KAKamiro: raises $1 to $1.25
PAMBOS.L: folds 
ZhukOFFskI: folds 
hirozo: calls $1.15
NuMetal88: folds 
*** FLOP *** [2h 9d Tc]
hirozo: bets $1.75
KAKamiro: raises $1.75 to $3.50
hirozo: folds 
Uncalled bet ($1.75) returned to KAKamiro
KAKamiro collected $5.97 from pot
KAKamiro: doesn't show hand 
*** SUMMARY ***
Total pot $6.25 | Rake $0.28 
Board [2h 9d Tc]
Seat 1: ZhukOFFskI (button) folded before Flop (didn't bet)
Seat 2: hirozo (small blind) folded on the Flop
Seat 3: NuMetal88 (big blind) folded before Flop
Seat 4: Yoshimac folded before Flop (didn't bet)
Seat 5: deadmoneykid folded before Flop (didn't bet)
Seat 6: chiyuki folded before Flop (didn't bet)
Seat 7: phate-1up folded before Flop (didn't bet)
Seat 8: KAKamiro collected ($5.97)
Seat 9: PAMBOS.L folded before Flop (didn't bet)



PokerStars Zoom Hand #84300144644:  Hold'em No Limit ($0.10/$0.25) - 2012/08/05 15:08:38 JST [2012/08/05 2:08:38 ET]
Table 'Whirlpool' 9-max Seat #1 is the button
Seat 1: deepakmbh ($40.10 in chips) 
Seat 2: deadmoneykid ($28.85 in chips) 
Seat 3: phate-1up ($25 in chips) 
Seat 4: INSP!RON ($25 in chips) 
Seat 5: Lasutchik ($75.83 in chips) 
Seat 6: Alvinpe85 ($46.70 in chips) 
Seat 7: chiyuki ($28.98 in chips) 
Seat 8: JhonnyP1979 ($3.44 in chips) 
Seat 9: DutchShultzs ($26.54 in chips) 
deadmoneykid: posts small blind $0.10
phate-1up: posts big blind $0.25
*** HOLE CARDS ***
Dealt to chiyuki [8h 5h]
INSP!RON: folds 
Lasutchik: folds 
Alvinpe85: folds 
chiyuki: folds 
JhonnyP1979: folds 
DutchShultzs: folds 
deepakmbh: folds 
deadmoneykid: folds 
Uncalled bet ($0.15) returned to phate-1up
phate-1up collected $0.20 from pot
phate-1up: doesn't show hand 
*** SUMMARY ***
Total pot $0.20 | Rake $0 
Seat 1: deepakmbh (button) folded before Flop (didn't bet)
Seat 2: deadmoneykid (small blind) folded before Flop
Seat 3: phate-1up (big blind) collected ($0.20)
Seat 4: INSP!RON folded before Flop (didn't bet)
Seat 5: Lasutchik folded before Flop (didn't bet)
Seat 6: Alvinpe85 folded before Flop (didn't bet)
Seat 7: chiyuki folded before Flop (didn't bet)
Seat 8: JhonnyP1979 folded before Flop (didn't bet)
Seat 9: DutchShultzs folded before Flop (didn't bet)



PokerStars Zoom Hand #84300143593:  Hold'em No Limit ($0.10/$0.25) - 2012/08/05 15:08:34 JST [2012/08/05 2:08:34 ET]
Table 'Whirlpool' 9-max Seat #1 is the button
Seat 1: Perstenev ($13 in chips) 
Seat 2: seula i ($42.17 in chips) 
Seat 3: snejokCoxx ($10.11 in chips) 
Seat 4: GovGus ($29.45 in chips) 
Seat 5: Nerkit ($12.50 in chips) 
Seat 6: jacquelinewu ($38.56 in chips) 
Seat 7: Silveystryk ($27.59 in chips) 
Seat 8: chiyuki ($28.98 in chips) 
Seat 9: 1Karina1 ($30.04 in chips) 
seula i: posts small blind $0.10
snejokCoxx: posts big blind $0.25
*** HOLE CARDS ***
Dealt to chiyuki [5c 9d]
GovGus: folds 
Nerkit: folds 
jacquelinewu: folds 
Silveystryk: folds 
chiyuki: folds 
1Karina1: folds 
Perstenev: folds 
seula i: folds 
Uncalled bet ($0.15) returned to snejokCoxx
snejokCoxx collected $0.20 from pot
snejokCoxx: doesn't show hand 
*** SUMMARY ***
Total pot $0.20 | Rake $0 
Seat 1: Perstenev (button) folded before Flop (didn't bet)
Seat 2: seula i (small blind) folded before Flop
Seat 3: snejokCoxx (big blind) collected ($0.20)
Seat 4: GovGus folded before Flop (didn't bet)
Seat 5: Nerkit folded before Flop (didn't bet)
Seat 6: jacquelinewu folded before Flop (didn't bet)
Seat 7: Silveystryk folded before Flop (didn't bet)
Seat 8: chiyuki folded before Flop (didn't bet)
Seat 9: 1Karina1 folded before Flop (didn't bet)



PokerStars Zoom Hand #84300148036:  Hold'em No Limit ($0.10/$0.25) - 2012/08/05 15:08:51 JST [2012/08/05 2:08:51 ET]
Table 'Whirlpool' 9-max Seat #1 is the button
Seat 1: DutchShultzs ($26.54 in chips) 
Seat 2: tribunpdm ($31.10 in chips) 
Seat 3: Paranoix1990 ($13.31 in chips) 
Seat 4: laurentzu84 ($33.01 in chips) 
Seat 5: MOReilly000 ($33.70 in chips) 
Seat 6: KAKamiro ($24.11 in chips) 
Seat 7: jacquelinewu ($38.56 in chips) 
Seat 8: Nerkit ($12.85 in chips) 
Seat 9: chiyuki ($28.98 in chips) 
tribunpdm: posts small blind $0.10
Paranoix1990: posts big blind $0.25
*** HOLE CARDS ***
Dealt to chiyuki [Qh 3c]
laurentzu84: folds 
MOReilly000: folds 
KAKamiro: folds 
jacquelinewu: folds 
Nerkit: folds 
chiyuki: folds 
DutchShultzs: folds 
tribunpdm: folds 
Uncalled bet ($0.15) returned to Paranoix1990
Paranoix1990 collected $0.20 from pot
Paranoix1990: doesn't show hand 
*** SUMMARY ***
Total pot $0.20 | Rake $0 
Seat 1: DutchShultzs (button) folded before Flop (didn't bet)
Seat 2: tribunpdm (small blind) folded before Flop
Seat 3: Paranoix1990 (big blind) collected ($0.20)
Seat 4: laurentzu84 folded before Flop (didn't bet)
Seat 5: MOReilly000 folded before Flop (didn't bet)
Seat 6: KAKamiro folded before Flop (didn't bet)
Seat 7: jacquelinewu folded before Flop (didn't bet)
Seat 8: Nerkit folded before Flop (didn't bet)
Seat 9: chiyuki folded before Flop (didn't bet)



PokerStars Zoom Hand #84300149043:  Hold'em No Limit ($0.10/$0.25) - 2012/08/05 15:08:56 JST [2012/08/05 2:08:56 ET]
Table 'Whirlpool' 9-max Seat #1 is the button
Seat 1: 4plankton ($21.55 in chips) 
Seat 2: troublesomm ($26.07 in chips) 
Seat 3: Rafioso ($12.50 in chips) 
Seat 4: kamikkaze ($14.92 in chips) 
Seat 5: KAKamiro ($24.11 in chips) 
Seat 6: chiyuki ($28.98 in chips) 
Seat 7: 1Karina1 ($29.65 in chips) 
Seat 8: Perstenev ($13 in chips) 
Seat 9: tribunpdm ($31 in chips) 
troublesomm: posts small blind $0.10
Rafioso: posts big blind $0.25
*** HOLE CARDS ***
Dealt to chiyuki [Th Kd]
kamikkaze: folds 
KAKamiro: folds 
chiyuki: folds 
1Karina1: folds 
Perstenev: folds 
tribunpdm: folds 
4plankton: folds 
troublesomm: folds 
Uncalled bet ($0.15) returned to Rafioso
Rafioso collected $0.20 from pot
Rafioso: doesn't show hand 
*** SUMMARY ***
Total pot $0.20 | Rake $0 
Seat 1: 4plankton (button) folded before Flop (didn't bet)
Seat 2: troublesomm (small blind) folded before Flop
Seat 3: Rafioso (big blind) collected ($0.20)
Seat 4: kamikkaze folded before Flop (didn't bet)
Seat 5: KAKamiro folded before Flop (didn't bet)
Seat 6: chiyuki folded before Flop (didn't bet)
Seat 7: 1Karina1 folded before Flop (didn't bet)
Seat 8: Perstenev folded before Flop (didn't bet)
Seat 9: tribunpdm folded before Flop (didn't bet)



PokerStars Zoom Hand #84300147267:  Hold'em No Limit ($0.10/$0.25) - 2012/08/05 15:08:48 JST [2012/08/05 2:08:48 ET]
Table 'Whirlpool' 9-max Seat #1 is the button
Seat 1: chiyuki ($28.98 in chips) 
Seat 2: 1Karina1 ($29.75 in chips) 
Seat 3: Roglus ($8.83 in chips) 
Seat 4: hirozo ($47.97 in chips) 
Seat 5: hobby56 ($2.83 in chips) 
Seat 6: kamikkaze ($14.92 in chips) 
Seat 7: rorfo23 ($13.66 in chips) 
Seat 8: DanielWhyte ($56.84 in chips) 
Seat 9: Perstenev ($13 in chips) 
1Karina1: posts small blind $0.10
Roglus: posts big blind $0.25
*** HOLE CARDS ***
Dealt to chiyuki [4h 6s]
hirozo: folds 
hobby56: folds 
kamikkaze: folds 
rorfo23: raises $0.50 to $0.75
DanielWhyte: folds 
Perstenev: folds 
chiyuki: folds 
1Karina1: folds 
Roglus: folds 
Uncalled bet ($0.50) returned to rorfo23
rorfo23 collected $0.60 from pot
rorfo23: doesn't show hand 
*** SUMMARY ***
Total pot $0.60 | Rake $0 
Seat 1: chiyuki (button) folded before Flop (didn't bet)
Seat 2: 1Karina1 (small blind) folded before Flop
Seat 3: Roglus (big blind) folded before Flop
Seat 4: hirozo folded before Flop (didn't bet)
Seat 5: hobby56 folded before Flop (didn't bet)
Seat 6: kamikkaze folded before Flop (didn't bet)
Seat 7: rorfo23 collected ($0.60)
Seat 8: DanielWhyte folded before Flop (didn't bet)
Seat 9: Perstenev folded before Flop (didn't bet)



PokerStars Zoom Hand #84300135187:  Hold'em No Limit ($0.10/$0.25) - 2012/08/05 15:08:01 JST [2012/08/05 2:08:01 ET]
Table 'Whirlpool' 9-max Seat #1 is the button
Seat 1: ygoegoe ($27.40 in chips) 
Seat 2: GovGus ($31.21 in chips) 
Seat 3: simonzez ($25.10 in chips) 
Seat 4: chiyuki ($29.33 in chips) 
Seat 5: phate-1up ($48.61 in chips) 
Seat 6: Nerkit ($9.05 in chips) 
Seat 7: DanielWhyte ($56.84 in chips) 
Seat 8: kesstukas25 ($12.50 in chips) 
Seat 9: Perstenev ($14.29 in chips) 
GovGus: posts small blind $0.10
simonzez: posts big blind $0.25
*** HOLE CARDS ***
Dealt to chiyuki [Qh 7c]
chiyuki: folds 
phate-1up: folds 
Nerkit: folds 
DanielWhyte: folds 
kesstukas25: folds 
Perstenev: folds 
ygoegoe: folds 
GovGus: raises $0.50 to $0.75
simonzez: calls $0.50
*** FLOP *** [6c 9h 8d]
GovGus: bets $1
simonzez: raises $1 to $2
GovGus: calls $1
*** TURN *** [6c 9h 8d] [2c]
GovGus: checks 
simonzez: bets $1.50
GovGus: calls $1.50
*** RIVER *** [6c 9h 8d 2c] [7s]
GovGus: checks 
simonzez: checks 
*** SHOW DOWN ***
GovGus: shows [7h Jd] (a pair of Sevens)
simonzez: shows [7d Qs] (a pair of Sevens - Queen kicker)
simonzez collected $8.12 from pot
*** SUMMARY ***
Total pot $8.50 | Rake $0.38 
Board [6c 9h 8d 2c 7s]
Seat 1: ygoegoe (button) folded before Flop (didn't bet)
Seat 2: GovGus (small blind) showed [7h Jd] and lost with a pair of Sevens
Seat 3: simonzez (big blind) showed [7d Qs] and won ($8.12) with a pair of Sevens
Seat 4: chiyuki folded before Flop (didn't bet)
Seat 5: phate-1up folded before Flop (didn't bet)
Seat 6: Nerkit folded before Flop (didn't bet)
Seat 7: DanielWhyte folded before Flop (didn't bet)
Seat 8: kesstukas25 folded before Flop (didn't bet)
Seat 9: Perstenev folded before Flop (didn't bet)



PokerStars Zoom Hand #84300152104:  Hold'em No Limit ($0.10/$0.25) - 2012/08/05 15:09:08 JST [2012/08/05 2:09:08 ET]
Table 'Whirlpool' 9-max Seat #1 is the button
Seat 1: pandaaaaaa ($11.80 in chips) 
Seat 2: deadmoneykid ($24.98 in chips) 
Seat 3: chiyuki ($28.98 in chips) 
Seat 4: Saruotiss ($21.68 in chips) 
Seat 5: ZhukOFFskI ($37.73 in chips) 
Seat 6: 1Karina1 ($29.65 in chips) 
Seat 7: Ellen1947 ($28.70 in chips) 
Seat 8: Lasutchik ($75.58 in chips) 
Seat 9: INSP!RON ($25 in chips) 
deadmoneykid: posts small blind $0.10
chiyuki: posts big blind $0.25
*** HOLE CARDS ***
Dealt to chiyuki [Qd Ks]
Saruotiss: folds 
ZhukOFFskI: folds 
1Karina1: folds 
Ellen1947: folds 
Lasutchik: folds 
INSP!RON: folds 
pandaaaaaa: folds 
deadmoneykid: folds 
Uncalled bet ($0.15) returned to chiyuki
chiyuki collected $0.20 from pot
chiyuki: doesn't show hand 
*** SUMMARY ***
Total pot $0.20 | Rake $0 
Seat 1: pandaaaaaa (button) folded before Flop (didn't bet)
Seat 2: deadmoneykid (small blind) folded before Flop
Seat 3: chiyuki (big blind) collected ($0.20)
Seat 4: Saruotiss folded before Flop (didn't bet)
Seat 5: ZhukOFFskI folded before Flop (didn't bet)
Seat 6: 1Karina1 folded before Flop (didn't bet)
Seat 7: Ellen1947 folded before Flop (didn't bet)
Seat 8: Lasutchik folded before Flop (didn't bet)
Seat 9: INSP!RON folded before Flop (didn't bet)



PokerStars Zoom Hand #84300157527:  Hold'em No Limit ($0.10/$0.25) - 2012/08/05 15:09:29 JST [2012/08/05 2:09:29 ET]
Table 'Whirlpool' 9-max Seat #1 is the button
Seat 1: moku36 ($20.47 in chips) 
Seat 2: chiyuki ($29.08 in chips) 
Seat 3: phate-1up ($47.86 in chips) 
Seat 4: mid22 ($12.83 in chips) 
Seat 5: Littlea029 ($31.30 in chips) 
Seat 6: seula i ($41.07 in chips) 
Seat 7: pandaaaaaa ($11.55 in chips) 
Seat 8: Perstenev ($10.05 in chips) 
Seat 9: Dejacob ($27.06 in chips) 
chiyuki: posts small blind $0.10
phate-1up: posts big blind $0.25
*** HOLE CARDS ***
Dealt to chiyuki [Qc 6h]
mid22: folds 
Littlea029: folds 
seula i: folds 
pandaaaaaa: folds 
Perstenev: folds 
Dejacob: raises $0.50 to $0.75
moku36: folds 
chiyuki: folds 
phate-1up: folds 
Uncalled bet ($0.50) returned to Dejacob
Dejacob collected $0.60 from pot
Dejacob: doesn't show hand 
*** SUMMARY ***
Total pot $0.60 | Rake $0 
Seat 1: moku36 (button) folded before Flop (didn't bet)
Seat 2: chiyuki (small blind) folded before Flop
Seat 3: phate-1up (big blind) folded before Flop
Seat 4: mid22 folded before Flop (didn't bet)
Seat 5: Littlea029 folded before Flop (didn't bet)
Seat 6: seula i folded before Flop (didn't bet)
Seat 7: pandaaaaaa folded before Flop (didn't bet)
Seat 8: Perstenev folded before Flop (didn't bet)
Seat 9: Dejacob collected ($0.60)



PokerStars Zoom Hand #84300150563:  Hold'em No Limit ($0.10/$0.25) - 2012/08/05 15:09:02 JST [2012/08/05 2:09:02 ET]
Table 'Whirlpool' 9-max Seat #1 is the button
Seat 1: troublesomm ($40.51 in chips) 
Seat 2: 4plankton ($21.55 in chips) 
Seat 3: kamikkaze ($14.92 in chips) 
Seat 4: Dejacob ($25 in chips) 
Seat 5: chiyuki ($28.98 in chips) 
Seat 6: phate-1up ($25.10 in chips) 
Seat 7: 4ydo yogurt ($32.73 in chips) 
Seat 8: DutchShultzs ($35.78 in chips) 
Seat 9: pandaaaaaa ($11.55 in chips) 
4plankton: posts small blind $0.10
kamikkaze: posts big blind $0.25
*** HOLE CARDS ***
Dealt to chiyuki [Js 6h]
Dejacob: folds 
chiyuki: folds 
phate-1up: folds 
4ydo yogurt: folds 
DutchShultzs: folds 
pandaaaaaa: folds 
troublesomm: folds 
4plankton: calls $0.15
kamikkaze: checks 
*** FLOP *** [2s Kd 9d]
4plankton: checks 
kamikkaze: bets $0.31
4plankton: calls $0.31
*** TURN *** [2s Kd 9d] [9s]
4plankton: checks 
kamikkaze: checks 
*** RIVER *** [2s Kd 9d 9s] [8d]
4plankton: checks 
kamikkaze: bets $1.01
4plankton: folds 
Uncalled bet ($1.01) returned to kamikkaze
kamikkaze collected $1.07 from pot
kamikkaze: doesn't show hand 
*** SUMMARY ***
Total pot $1.12 | Rake $0.05 
Board [2s Kd 9d 9s 8d]
Seat 1: troublesomm (button) folded before Flop (didn't bet)
Seat 2: 4plankton (small blind) folded on the River
Seat 3: kamikkaze (big blind) collected ($1.07)
Seat 4: Dejacob folded before Flop (didn't bet)
Seat 5: chiyuki folded before Flop (didn't bet)
Seat 6: phate-1up folded before Flop (didn't bet)
Seat 7: 4ydo yogurt folded before Flop (didn't bet)
Seat 8: DutchShultzs folded before Flop (didn't bet)
Seat 9: pandaaaaaa folded before Flop (didn't bet)



PokerStars Zoom Hand #84300158602:  Hold'em No Limit ($0.10/$0.25) - 2012/08/05 15:09:33 JST [2012/08/05 2:09:33 ET]
Table 'Whirlpool' 9-max Seat #1 is the button
Seat 1: Alvinpe85 ($46.35 in chips) 
Seat 2: Nerkit ($9.05 in chips) 
Seat 3: deadmoneykid ($30.07 in chips) 
Seat 4: mid22 ($12.83 in chips) 
Seat 5: moku36 ($20.47 in chips) 
Seat 6: kesstukas25 ($14.43 in chips) 
Seat 7: 1Karina1 ($25 in chips) 
Seat 8: chiyuki ($28.98 in chips) 
Seat 9: snejokCoxx ($13.20 in chips) 
Nerkit: posts small blind $0.10
deadmoneykid: posts big blind $0.25
*** HOLE CARDS ***
Dealt to chiyuki [Qh 4h]
mid22: folds 
moku36: folds 
kesstukas25: folds 
1Karina1: folds 
chiyuki: folds 
snejokCoxx: folds 
Alvinpe85: folds 
Nerkit: raises $0.50 to $0.75
deadmoneykid: folds 
Uncalled bet ($0.50) returned to Nerkit
Nerkit collected $0.50 from pot
Nerkit: doesn't show hand 
*** SUMMARY ***
Total pot $0.50 | Rake $0 
Seat 1: Alvinpe85 (button) folded before Flop (didn't bet)
Seat 2: Nerkit (small blind) collected ($0.50)
Seat 3: deadmoneykid (big blind) folded before Flop
Seat 4: mid22 folded before Flop (didn't bet)
Seat 5: moku36 folded before Flop (didn't bet)
Seat 6: kesstukas25 folded before Flop (didn't bet)
Seat 7: 1Karina1 folded before Flop (didn't bet)
Seat 8: chiyuki folded before Flop (didn't bet)
Seat 9: snejokCoxx folded before Flop (didn't bet)



PokerStars Zoom Hand #84300159884:  Hold'em No Limit ($0.10/$0.25) - 2012/08/05 15:09:38 JST [2012/08/05 2:09:38 ET]
Table 'Whirlpool' 9-max Seat #1 is the button
Seat 1: hirozo ($71.68 in chips) 
Seat 2: el pore 5 ($11.32 in chips) 
Seat 3: Perstenev ($10.05 in chips) 
Seat 4: Ellen1947 ($28.45 in chips) 
Seat 5: chiyuki ($28.98 in chips) 
Seat 6: moku36 ($20.47 in chips) 
Seat 7: KrystalAA ($25.48 in chips) 
Seat 8: 1Karina1 ($25 in chips) 
Seat 9: Alvinpe85 ($46.35 in chips) 
el pore 5: posts small blind $0.10
Perstenev: posts big blind $0.25
*** HOLE CARDS ***
Dealt to chiyuki [Ks 8h]
Ellen1947: folds 
chiyuki: folds 
moku36: folds 
KrystalAA: raises $0.46 to $0.71
1Karina1: folds 
Alvinpe85: folds 
hirozo: folds 
el pore 5: folds 
Perstenev: folds 
Uncalled bet ($0.46) returned to KrystalAA
KrystalAA collected $0.60 from pot
KrystalAA: doesn't show hand 
*** SUMMARY ***
Total pot $0.60 | Rake $0 
Seat 1: hirozo (button) folded before Flop (didn't bet)
Seat 2: el pore 5 (small blind) folded before Flop
Seat 3: Perstenev (big blind) folded before Flop
Seat 4: Ellen1947 folded before Flop (didn't bet)
Seat 5: chiyuki folded before Flop (didn't bet)
Seat 6: moku36 folded before Flop (didn't bet)
Seat 7: KrystalAA collected ($0.60)
Seat 8: 1Karina1 folded before Flop (didn't bet)
Seat 9: Alvinpe85 folded before Flop (didn't bet)



PokerStars Zoom Hand #84300155775:  Hold'em No Limit ($0.10/$0.25) - 2012/08/05 15:09:22 JST [2012/08/05 2:09:22 ET]
Table 'Whirlpool' 9-max Seat #1 is the button
Seat 1: Nerkit ($12.60 in chips) 
Seat 2: Roglus ($11.48 in chips) 
Seat 3: Jeshka69 ($23.16 in chips) 
Seat 4: laurentzu84 ($33.01 in chips) 
Seat 5: 1Karina1 ($25 in chips) 
Seat 6: Tom1999 ($19.34 in chips) 
Seat 7: chiyuki ($29.08 in chips) 
Seat 8: Wilcox76607 ($33.74 in chips) 
Seat 9: deadmoneykid ($30.07 in chips) 
Roglus: posts small blind $0.10
Jeshka69: posts big blind $0.25
*** HOLE CARDS ***
Dealt to chiyuki [9d 4s]
laurentzu84: raises $0.50 to $0.75
1Karina1: folds 
Tom1999: folds 
chiyuki: folds 
Wilcox76607: folds 
deadmoneykid: folds 
Nerkit: folds 
Roglus: folds 
Jeshka69: folds 
Uncalled bet ($0.50) returned to laurentzu84
laurentzu84 collected $0.60 from pot
laurentzu84: doesn't show hand 
*** SUMMARY ***
Total pot $0.60 | Rake $0 
Seat 1: Nerkit (button) folded before Flop (didn't bet)
Seat 2: Roglus (small blind) folded before Flop
Seat 3: Jeshka69 (big blind) folded before Flop
Seat 4: laurentzu84 collected ($0.60)
Seat 5: 1Karina1 folded before Flop (didn't bet)
Seat 6: Tom1999 folded before Flop (didn't bet)
Seat 7: chiyuki folded before Flop (didn't bet)
Seat 8: Wilcox76607 folded before Flop (didn't bet)
Seat 9: deadmoneykid folded before Flop (didn't bet)



PokerStars Zoom Hand #84300165314:  Hold'em No Limit ($0.10/$0.25) - 2012/08/05 15:09:59 JST [2012/08/05 2:09:59 ET]
Table 'Whirlpool' 9-max Seat #1 is the button
Seat 1: Rilko1975 ($25.07 in chips) 
Seat 2: seula i ($30.06 in chips) 
Seat 3: 1Karina1 ($29.69 in chips) 
Seat 4: Nerkit ($12.50 in chips) 
Seat 5: mjmichi ($28.36 in chips) 
Seat 6: INSP!RON ($32.20 in chips) 
Seat 7: Lasutchik ($75.81 in chips) 
Seat 8: Dejacob ($25.35 in chips) 
Seat 9: chiyuki ($28.98 in chips) 
seula i: posts small blind $0.10
1Karina1: posts big blind $0.25
*** HOLE CARDS ***
Dealt to chiyuki [Kh 5d]
Nerkit: folds 
mjmichi: folds 
INSP!RON: folds 
Lasutchik: folds 
Dejacob: folds 
chiyuki: folds 
Rilko1975: folds 
seula i: folds 
Uncalled bet ($0.15) returned to 1Karina1
1Karina1 collected $0.20 from pot
1Karina1: doesn't show hand 
*** SUMMARY ***
Total pot $0.20 | Rake $0 
Seat 1: Rilko1975 (button) folded before Flop (didn't bet)
Seat 2: seula i (small blind) folded before Flop
Seat 3: 1Karina1 (big blind) collected ($0.20)
Seat 4: Nerkit folded before Flop (didn't bet)
Seat 5: mjmichi folded before Flop (didn't bet)
Seat 6: INSP!RON folded before Flop (didn't bet)
Seat 7: Lasutchik folded before Flop (didn't bet)
Seat 8: Dejacob folded before Flop (didn't bet)
Seat 9: chiyuki folded before Flop (didn't bet)



PokerStars Zoom Hand #84300161687:  Hold'em No Limit ($0.10/$0.25) - 2012/08/05 15:09:45 JST [2012/08/05 2:09:45 ET]
Table 'Whirlpool' 9-max Seat #1 is the button
Seat 1: chiyuki ($28.98 in chips) 
Seat 2: troublesomm ($27.67 in chips) 
Seat 3: Vahe50 ($14.86 in chips) 
Seat 4: hirozo ($71.68 in chips) 
Seat 5: Nerkit ($9.57 in chips) 
Seat 6: 4plankton ($20.99 in chips) 
Seat 7: Alvinpe85 ($46.35 in chips) 
Seat 8: 1Karina1 ($25 in chips) 
Seat 9: moku36 ($20.47 in chips) 
troublesomm: posts small blind $0.10
Vahe50: posts big blind $0.25
*** HOLE CARDS ***
Dealt to chiyuki [9c 5c]
hirozo: folds 
Nerkit: folds 
4plankton: folds 
Alvinpe85: folds 
1Karina1: folds 
moku36: folds 
chiyuki: folds 
troublesomm: raises $0.50 to $0.75
Vahe50: calls $0.50
*** FLOP *** [4c 9d 7d]
troublesomm: bets $1.05
Vahe50: folds 
Uncalled bet ($1.05) returned to troublesomm
troublesomm collected $1.43 from pot
troublesomm: doesn't show hand 
*** SUMMARY ***
Total pot $1.50 | Rake $0.07 
Board [4c 9d 7d]
Seat 1: chiyuki (button) folded before Flop (didn't bet)
Seat 2: troublesomm (small blind) collected ($1.43)
Seat 3: Vahe50 (big blind) folded on the Flop
Seat 4: hirozo folded before Flop (didn't bet)
Seat 5: Nerkit folded before Flop (didn't bet)
Seat 6: 4plankton folded before Flop (didn't bet)
Seat 7: Alvinpe85 folded before Flop (didn't bet)
Seat 8: 1Karina1 folded before Flop (didn't bet)
Seat 9: moku36 folded before Flop (didn't bet)



PokerStars Zoom Hand #84300168100:  Hold'em No Limit ($0.10/$0.25) - 2012/08/05 15:10:11 JST [2012/08/05 2:10:11 ET]
Table 'Whirlpool' 9-max Seat #1 is the button
Seat 1: Nerkit ($11.85 in chips) 
Seat 2: deadmoneykid ($25.41 in chips) 
Seat 3: phate-1up ($25 in chips) 
Seat 4: 1Karina1 ($29.75 in chips) 
Seat 5: troublesomm ($40.26 in chips) 
Seat 6: chiyuki ($28.98 in chips) 
Seat 7: Perstenev ($9.70 in chips) 
Seat 8: ygoegoe ($25.25 in chips) 
Seat 9: turbotom122 ($27.84 in chips) 
deadmoneykid: posts small blind $0.10
phate-1up: posts big blind $0.25
*** HOLE CARDS ***
Dealt to chiyuki [Ah 7c]
1Karina1: folds 
troublesomm: folds 
chiyuki: folds 
Perstenev: raises $0.50 to $0.75
ygoegoe: folds 
turbotom122: folds 
Nerkit: folds 
deadmoneykid: folds 
phate-1up: folds 
Uncalled bet ($0.50) returned to Perstenev
Perstenev collected $0.60 from pot
Perstenev: doesn't show hand 
*** SUMMARY ***
Total pot $0.60 | Rake $0 
Seat 1: Nerkit (button) folded before Flop (didn't bet)
Seat 2: deadmoneykid (small blind) folded before Flop
Seat 3: phate-1up (big blind) folded before Flop
Seat 4: 1Karina1 folded before Flop (didn't bet)
Seat 5: troublesomm folded before Flop (didn't bet)
Seat 6: chiyuki folded before Flop (didn't bet)
Seat 7: Perstenev collected ($0.60)
Seat 8: ygoegoe folded before Flop (didn't bet)
Seat 9: turbotom122 folded before Flop (didn't bet)



PokerStars Zoom Hand #84300169104:  Hold'em No Limit ($0.10/$0.25) - 2012/08/05 15:10:15 JST [2012/08/05 2:10:15 ET]
Table 'Whirlpool' 9-max Seat #1 is the button
Seat 1: Silveystryk ($23.08 in chips) 
Seat 2: 1Karina1 ($29.75 in chips) 
Seat 3: NuMetal88 ($25 in chips) 
Seat 4: chiyuki ($28.98 in chips) 
Seat 5: KrystalAA ($32.17 in chips) 
Seat 6: el pore 5 ($10.97 in chips) 
Seat 7: PAMBOS.L ($22.59 in chips) 
Seat 8: risekuku468 ($36.87 in chips) 
Seat 9: Wilcox76607 ($33.64 in chips) 
1Karina1: posts small blind $0.10
NuMetal88: posts big blind $0.25
*** HOLE CARDS ***
Dealt to chiyuki [4s 9s]
chiyuki: folds 
KrystalAA: folds 
el pore 5: raises $1.25 to $1.50
PAMBOS.L: folds 
risekuku468: folds 
Wilcox76607: folds 
Silveystryk: folds 
1Karina1: folds 
NuMetal88: folds 
Uncalled bet ($1.25) returned to el pore 5
el pore 5 collected $0.60 from pot
el pore 5: doesn't show hand 
*** SUMMARY ***
Total pot $0.60 | Rake $0 
Seat 1: Silveystryk (button) folded before Flop (didn't bet)
Seat 2: 1Karina1 (small blind) folded before Flop
Seat 3: NuMetal88 (big blind) folded before Flop
Seat 4: chiyuki folded before Flop (didn't bet)
Seat 5: KrystalAA folded before Flop (didn't bet)
Seat 6: el pore 5 collected ($0.60)
Seat 7: PAMBOS.L folded before Flop (didn't bet)
Seat 8: risekuku468 folded before Flop (didn't bet)
Seat 9: Wilcox76607 folded before Flop (didn't bet)



PokerStars Zoom Hand #84300166816:  Hold'em No Limit ($0.10/$0.25) - 2012/08/05 15:10:05 JST [2012/08/05 2:10:05 ET]
Table 'Whirlpool' 9-max Seat #1 is the button
Seat 1: el pore 5 ($10.97 in chips) 
Seat 2: jacquelinewu ($36.49 in chips) 
Seat 3: kwkim73 ($25 in chips) 
Seat 4: seula i ($41.07 in chips) 
Seat 5: hirozo ($28.20 in chips) 
Seat 6: Nerkit ($9.57 in chips) 
Seat 7: yane73 ($64.08 in chips) 
Seat 8: chiyuki ($28.98 in chips) 
Seat 9: DutchShultzs ($26.19 in chips) 
jacquelinewu: posts small blind $0.10
kwkim73: posts big blind $0.25
*** HOLE CARDS ***
Dealt to chiyuki [Ah 7h]
seula i: folds 
hirozo: folds 
Nerkit: folds 
yane73: raises $0.50 to $0.75
chiyuki: folds 
DutchShultzs: folds 
el pore 5: folds 
jacquelinewu: folds 
kwkim73: folds 
Uncalled bet ($0.50) returned to yane73
yane73 collected $0.60 from pot
yane73: doesn't show hand 
*** SUMMARY ***
Total pot $0.60 | Rake $0 
Seat 1: el pore 5 (button) folded before Flop (didn't bet)
Seat 2: jacquelinewu (small blind) folded before Flop
Seat 3: kwkim73 (big blind) folded before Flop
Seat 4: seula i folded before Flop (didn't bet)
Seat 5: hirozo folded before Flop (didn't bet)
Seat 6: Nerkit folded before Flop (didn't bet)
Seat 7: yane73 collected ($0.60)
Seat 8: chiyuki folded before Flop (didn't bet)
Seat 9: DutchShultzs folded before Flop (didn't bet)



PokerStars Zoom Hand #84300164503:  Hold'em No Limit ($0.10/$0.25) - 2012/08/05 15:09:56 JST [2012/08/05 2:09:56 ET]
Table 'Whirlpool' 9-max Seat #1 is the button
Seat 1: Rilko1975 ($29.63 in chips) 
Seat 2: laurentzu84 ($33.36 in chips) 
Seat 3: 1Karina1 ($25 in chips) 
Seat 4: chiyuki ($28.98 in chips) 
Seat 5: Perstenev ($9.70 in chips) 
Seat 6: 4ydo yogurt ($33.18 in chips) 
Seat 7: troublesomm ($26.07 in chips) 
Seat 8: deadmoneykid ($29.82 in chips) 
Seat 9: mid22 ($12.48 in chips) 
laurentzu84: posts small blind $0.10
1Karina1: posts big blind $0.25
*** HOLE CARDS ***
Dealt to chiyuki [3h 6c]
chiyuki: folds 
Perstenev: folds 
4ydo yogurt: folds 
troublesomm: folds 
deadmoneykid: folds 
mid22: calls $0.25
Rilko1975: folds 
laurentzu84: folds 
1Karina1: checks 
*** FLOP *** [Kc 8h 6s]
1Karina1: checks 
mid22: checks 
*** TURN *** [Kc 8h 6s] [Ts]
1Karina1: bets $0.50
mid22: calls $0.50
*** RIVER *** [Kc 8h 6s Ts] [7s]
1Karina1: checks 
mid22: checks 
*** SHOW DOWN ***
1Karina1: shows [2h Td] (a pair of Tens)
mid22: mucks hand 
1Karina1 collected $1.53 from pot
*** SUMMARY ***
Total pot $1.60 | Rake $0.07 
Board [Kc 8h 6s Ts 7s]
Seat 1: Rilko1975 (button) folded before Flop (didn't bet)
Seat 2: laurentzu84 (small blind) folded before Flop
Seat 3: 1Karina1 (big blind) showed [2h Td] and won ($1.53) with a pair of Tens
Seat 4: chiyuki folded before Flop (didn't bet)
Seat 5: Perstenev folded before Flop (didn't bet)
Seat 6: 4ydo yogurt folded before Flop (didn't bet)
Seat 7: troublesomm folded before Flop (didn't bet)
Seat 8: deadmoneykid folded before Flop (didn't bet)
Seat 9: mid22 mucked [Ah Qc]



PokerStars Zoom Hand #84300170168:  Hold'em No Limit ($0.10/$0.25) - 2012/08/05 15:10:19 JST [2012/08/05 2:10:19 ET]
Table 'Whirlpool' 9-max Seat #1 is the button
Seat 1: Dejacob ($25 in chips) 
Seat 2: phate-1up ($66.18 in chips) 
Seat 3: chiyuki ($28.98 in chips) 
Seat 4: Dan Royal ($21.40 in chips) 
Seat 5: Silveystryk ($23.08 in chips) 
Seat 6: troublesomm ($25.77 in chips) 
Seat 7: rorfo23 ($15.40 in chips) 
Seat 8: DutchShultzs ($35.43 in chips) 
Seat 9: INSP!RON ($28.55 in chips) 
phate-1up: posts small blind $0.10
chiyuki: posts big blind $0.25
*** HOLE CARDS ***
Dealt to chiyuki [9d Ad]
Dan Royal: folds 
Silveystryk: folds 
troublesomm: folds 
rorfo23: folds 
DutchShultzs: folds 
INSP!RON: raises $0.50 to $0.75
Dejacob: folds 
phate-1up: raises $1.50 to $2.25
chiyuki: folds 
INSP!RON: calls $1.50
*** FLOP *** [7h 7d 6c]
phate-1up: bets $3.25
INSP!RON: folds 
Uncalled bet ($3.25) returned to phate-1up
phate-1up collected $4.54 from pot
phate-1up: doesn't show hand 
*** SUMMARY ***
Total pot $4.75 | Rake $0.21 
Board [7h 7d 6c]
Seat 1: Dejacob (button) folded before Flop (didn't bet)
Seat 2: phate-1up (small blind) collected ($4.54)
Seat 3: chiyuki (big blind) folded before Flop
Seat 4: Dan Royal folded before Flop (didn't bet)
Seat 5: Silveystryk folded before Flop (didn't bet)
Seat 6: troublesomm folded before Flop (didn't bet)
Seat 7: rorfo23 folded before Flop (didn't bet)
Seat 8: DutchShultzs folded before Flop (didn't bet)
Seat 9: INSP!RON folded on the Flop



PokerStars Zoom Hand #84300187878:  Hold'em No Limit ($0.10/$0.25) - 2012/08/05 15:11:29 JST [2012/08/05 2:11:29 ET]
Table 'Whirlpool' 9-max Seat #1 is the button
Seat 1: troublesomm ($39.01 in chips) 
Seat 2: 1Karina1 ($29.40 in chips) 
Seat 3: AAAKK777 ($32.99 in chips) 
Seat 4: ChrisCDee ($64.02 in chips) 
Seat 5: masterkoolb ($12.50 in chips) 
Seat 6: drunk_bender ($26.14 in chips) 
Seat 7: chiyuki ($28.63 in chips) 
Seat 8: Dejacob ($25 in chips) 
Seat 9: snejokCoxx ($10.38 in chips) 
1Karina1: posts small blind $0.10
AAAKK777: posts big blind $0.25
*** HOLE CARDS ***
Dealt to chiyuki [Tc 8c]
ChrisCDee: folds 
masterkoolb: folds 
drunk_bender: folds 
chiyuki: folds 
Dejacob: folds 
snejokCoxx: folds 
troublesomm: folds 
1Karina1: folds 
Uncalled bet ($0.15) returned to AAAKK777
AAAKK777 collected $0.20 from pot
AAAKK777: doesn't show hand 
*** SUMMARY ***
Total pot $0.20 | Rake $0 
Seat 1: troublesomm (button) folded before Flop (didn't bet)
Seat 2: 1Karina1 (small blind) folded before Flop
Seat 3: AAAKK777 (big blind) collected ($0.20)
Seat 4: ChrisCDee folded before Flop (didn't bet)
Seat 5: masterkoolb folded before Flop (didn't bet)
Seat 6: drunk_bender folded before Flop (didn't bet)
Seat 7: chiyuki folded before Flop (didn't bet)
Seat 8: Dejacob folded before Flop (didn't bet)
Seat 9: snejokCoxx folded before Flop (didn't bet)



PokerStars Zoom Hand #84300180182:  Hold'em No Limit ($0.10/$0.25) - 2012/08/05 15:10:58 JST [2012/08/05 2:10:58 ET]
Table 'Whirlpool' 9-max Seat #1 is the button
Seat 1: Rafioso ($11.30 in chips) 
Seat 2: chiyuki ($28.73 in chips) 
Seat 3: deadmoneykid ($24.63 in chips) 
Seat 4: Nerkit ($11.75 in chips) 
Seat 5: turbotom122 ($28.75 in chips) 
Seat 6: kesstukas25 ($14.08 in chips) 
Seat 7: hirozo ($80.91 in chips) 
Seat 8: Sal y Limon1 ($24.75 in chips) 
Seat 9: Gichboy ($4 in chips) 
chiyuki: posts small blind $0.10
deadmoneykid: posts big blind $0.25
*** HOLE CARDS ***
Dealt to chiyuki [8h Ac]
Nerkit: folds 
turbotom122: calls $0.25
kesstukas25: folds 
hirozo: folds 
Sal y Limon1: folds 
Gichboy: calls $0.25
Rafioso: folds 
chiyuki: folds 
deadmoneykid: checks 
*** FLOP *** [8s 2d 6h]
deadmoneykid: bets $0.40
turbotom122: calls $0.40
Gichboy: folds 
*** TURN *** [8s 2d 6h] [Jc]
deadmoneykid: checks 
turbotom122: checks 
*** RIVER *** [8s 2d 6h Jc] [Kc]
deadmoneykid: checks 
turbotom122: folds 
deadmoneykid collected $1.58 from pot
deadmoneykid: doesn't show hand 
*** SUMMARY ***
Total pot $1.65 | Rake $0.07 
Board [8s 2d 6h Jc Kc]
Seat 1: Rafioso (button) folded before Flop (didn't bet)
Seat 2: chiyuki (small blind) folded before Flop
Seat 3: deadmoneykid (big blind) collected ($1.58)
Seat 4: Nerkit folded before Flop (didn't bet)
Seat 5: turbotom122 folded on the River
Seat 6: kesstukas25 folded before Flop (didn't bet)
Seat 7: hirozo folded before Flop (didn't bet)
Seat 8: Sal y Limon1 folded before Flop (didn't bet)
Seat 9: Gichboy folded on the Flop



PokerStars Zoom Hand #84300191215:  Hold'em No Limit ($0.10/$0.25) - 2012/08/05 15:11:42 JST [2012/08/05 2:11:42 ET]
Table 'Whirlpool' 9-max Seat #1 is the button
Seat 1: pandaaaaaa ($12.32 in chips) 
Seat 2: seula i ($101.10 in chips) 
Seat 3: DanielWhyte ($59.62 in chips) 
Seat 4: 1Karina1 ($25 in chips) 
Seat 5: chiyuki ($28.63 in chips) 
Seat 6: KeLevro0 ($12.50 in chips) 
Seat 7: Dejacob ($25 in chips) 
Seat 8: Vahe50 ($14.56 in chips) 
Seat 9: Robchie ($13.43 in chips) 
seula i: posts small blind $0.10
DanielWhyte: posts big blind $0.25
*** HOLE CARDS ***
Dealt to chiyuki [7d 5c]
1Karina1: folds 
chiyuki: folds 
KeLevro0: folds 
Dejacob: folds 
Vahe50: folds 
Robchie: folds 
pandaaaaaa: folds 
seula i: folds 
Uncalled bet ($0.15) returned to DanielWhyte
DanielWhyte collected $0.20 from pot
DanielWhyte: doesn't show hand 
*** SUMMARY ***
Total pot $0.20 | Rake $0 
Seat 1: pandaaaaaa (button) folded before Flop (didn't bet)
Seat 2: seula i (small blind) folded before Flop
Seat 3: DanielWhyte (big blind) collected ($0.20)
Seat 4: 1Karina1 folded before Flop (didn't bet)
Seat 5: chiyuki folded before Flop (didn't bet)
Seat 6: KeLevro0 folded before Flop (didn't bet)
Seat 7: Dejacob folded before Flop (didn't bet)
Seat 8: Vahe50 folded before Flop (didn't bet)
Seat 9: Robchie folded before Flop (didn't bet)



PokerStars Zoom Hand #84300189967:  Hold'em No Limit ($0.10/$0.25) - 2012/08/05 15:11:37 JST [2012/08/05 2:11:37 ET]
Table 'Whirlpool' 9-max Seat #1 is the button
Seat 1: NuMetal88 ($25.15 in chips) 
Seat 2: kwkim73 ($25 in chips) 
Seat 3: Perstenev ($14.76 in chips) 
Seat 4: Nerkit ($12 in chips) 
Seat 5: hirozo ($71.33 in chips) 
Seat 6: chiyuki ($28.63 in chips) 
Seat 7: Robchie ($13.43 in chips) 
Seat 8: kamikkaze ($16.13 in chips) 
Seat 9: 1Karina1 ($29.44 in chips) 
kwkim73: posts small blind $0.10
Perstenev: posts big blind $0.25
*** HOLE CARDS ***
Dealt to chiyuki [4d Kh]
Nerkit: folds 
hirozo: folds 
chiyuki: folds 
Robchie: folds 
kamikkaze: folds 
1Karina1: folds 
NuMetal88: folds 
kwkim73: raises $0.50 to $0.75
Perstenev: folds 
Uncalled bet ($0.50) returned to kwkim73
kwkim73 collected $0.50 from pot
kwkim73: doesn't show hand 
*** SUMMARY ***
Total pot $0.50 | Rake $0 
Seat 1: NuMetal88 (button) folded before Flop (didn't bet)
Seat 2: kwkim73 (small blind) collected ($0.50)
Seat 3: Perstenev (big blind) folded before Flop
Seat 4: Nerkit folded before Flop (didn't bet)
Seat 5: hirozo folded before Flop (didn't bet)
Seat 6: chiyuki folded before Flop (didn't bet)
Seat 7: Robchie folded before Flop (didn't bet)
Seat 8: kamikkaze folded before Flop (didn't bet)
Seat 9: 1Karina1 folded before Flop (didn't bet)



PokerStars Zoom Hand #84300184035:  Hold'em No Limit ($0.10/$0.25) - 2012/08/05 15:11:13 JST [2012/08/05 2:11:13 ET]
Table 'Whirlpool' 9-max Seat #1 is the button
Seat 1: chiyuki ($28.63 in chips) 
Seat 2: Lasutchik ($75.56 in chips) 
Seat 3: troublesomm ($25.67 in chips) 
Seat 4: yane73 ($64.08 in chips) 
Seat 5: Saruotiss ($24.39 in chips) 
Seat 6: snejokCoxx ($12.15 in chips) 
Seat 7: Nerkit ($12 in chips) 
Seat 8: NuMetal88 ($25.25 in chips) 
Seat 9: risekuku468 ($36.42 in chips) 
Lasutchik: posts small blind $0.10
troublesomm: posts big blind $0.25
*** HOLE CARDS ***
Dealt to chiyuki [8h Jh]
yane73: calls $0.25
Saruotiss: folds 
snejokCoxx: folds 
Nerkit: folds 
NuMetal88: folds 
risekuku468: folds 
chiyuki: folds 
Lasutchik: folds 
troublesomm: checks 
*** FLOP *** [8d Jc 4h]
troublesomm: checks 
yane73: checks 
*** TURN *** [8d Jc 4h] [Tc]
troublesomm: checks 
yane73: checks 
*** RIVER *** [8d Jc 4h Tc] [Ks]
troublesomm: checks 
yane73: checks 
*** SHOW DOWN ***
troublesomm: shows [6d Ad] (high card Ace)
yane73: mucks hand 
troublesomm collected $0.57 from pot
*** SUMMARY ***
Total pot $0.60 | Rake $0.03 
Board [8d Jc 4h Tc Ks]
Seat 1: chiyuki (button) folded before Flop (didn't bet)
Seat 2: Lasutchik (small blind) folded before Flop
Seat 3: troublesomm (big blind) showed [6d Ad] and won ($0.57) with high card Ace
Seat 4: yane73 mucked [3s 5s]
Seat 5: Saruotiss folded before Flop (didn't bet)
Seat 6: snejokCoxx folded before Flop (didn't bet)
Seat 7: Nerkit folded before Flop (didn't bet)
Seat 8: NuMetal88 folded before Flop (didn't bet)
Seat 9: risekuku468 folded before Flop (didn't bet)



PokerStars Zoom Hand #84300193924:  Hold'em No Limit ($0.10/$0.25) - 2012/08/05 15:11:53 JST [2012/08/05 2:11:53 ET]
Table 'Whirlpool' 9-max Seat #1 is the button
Seat 1: DPsemplic ($7.71 in chips) 
Seat 2: Perstenev ($14.51 in chips) 
Seat 3: seula i ($101 in chips) 
Seat 4: chiyuki ($28.63 in chips) 
Seat 5: ChrisCDee ($26.07 in chips) 
Seat 6: NuMetal88 ($25 in chips) 
Seat 7: River_GmbH ($17.89 in chips) 
Seat 8: masterkoolb ($17.20 in chips) 
Seat 9: Nerkit ($20.05 in chips) 
Perstenev: posts small blind $0.10
seula i: posts big blind $0.25
*** HOLE CARDS ***
Dealt to chiyuki [3h 5c]
chiyuki: folds 
ChrisCDee: folds 
NuMetal88: folds 
River_GmbH: folds 
masterkoolb: raises $0.60 to $0.85
Nerkit: folds 
DPsemplic: folds 
Perstenev: folds 
seula i: folds 
Uncalled bet ($0.60) returned to masterkoolb
masterkoolb collected $0.60 from pot
masterkoolb: doesn't show hand 
*** SUMMARY ***
Total pot $0.60 | Rake $0 
Seat 1: DPsemplic (button) folded before Flop (didn't bet)
Seat 2: Perstenev (small blind) folded before Flop
Seat 3: seula i (big blind) folded before Flop
Seat 4: chiyuki folded before Flop (didn't bet)
Seat 5: ChrisCDee folded before Flop (didn't bet)
Seat 6: NuMetal88 folded before Flop (didn't bet)
Seat 7: River_GmbH folded before Flop (didn't bet)
Seat 8: masterkoolb collected ($0.60)
Seat 9: Nerkit folded before Flop (didn't bet)



PokerStars Zoom Hand #84300192945:  Hold'em No Limit ($0.10/$0.25) - 2012/08/05 15:11:49 JST [2012/08/05 2:11:49 ET]
Table 'Whirlpool' 9-max Seat #1 is the button
Seat 1: el pore 5 ($12.21 in chips) 
Seat 2: AAAKK777 ($33.09 in chips) 
Seat 3: Jene4kaBest ($3.09 in chips) 
Seat 4: chiyuki ($28.63 in chips) 
Seat 5: ZhukOFFskI ($50.55 in chips) 
Seat 6: DutchShultzs ($35.43 in chips) 
Seat 7: ChrisCDee ($47.21 in chips) 
Seat 8: risekuku468 ($36.77 in chips) 
Seat 9: troublesomm ($25.07 in chips) 
AAAKK777: posts small blind $0.10
Jene4kaBest: posts big blind $0.25
*** HOLE CARDS ***
Dealt to chiyuki [2c 6s]
chiyuki: folds 
ZhukOFFskI: folds 
DutchShultzs: folds 
ChrisCDee: folds 
risekuku468: folds 
troublesomm: folds 
el pore 5: raises $1 to $1.25
AAAKK777: folds 
Jene4kaBest: folds 
Uncalled bet ($1) returned to el pore 5
el pore 5 collected $0.60 from pot
el pore 5: doesn't show hand 
*** SUMMARY ***
Total pot $0.60 | Rake $0 
Seat 1: el pore 5 (button) collected ($0.60)
Seat 2: AAAKK777 (small blind) folded before Flop
Seat 3: Jene4kaBest (big blind) folded before Flop
Seat 4: chiyuki folded before Flop (didn't bet)
Seat 5: ZhukOFFskI folded before Flop (didn't bet)
Seat 6: DutchShultzs folded before Flop (didn't bet)
Seat 7: ChrisCDee folded before Flop (didn't bet)
Seat 8: risekuku468 folded before Flop (didn't bet)
Seat 9: troublesomm folded before Flop (didn't bet)



PokerStars Zoom Hand #84300195485:  Hold'em No Limit ($0.10/$0.25) - 2012/08/05 15:11:59 JST [2012/08/05 2:11:59 ET]
Table 'Whirlpool' 9-max Seat #1 is the button
Seat 1: 1Karina1 ($29.30 in chips) 
Seat 2: starreset ($32.73 in chips) 
Seat 3: chiyuki ($28.63 in chips) 
Seat 4: pandaaaaaa ($12.32 in chips) 
Seat 5: DPsemplic ($7.71 in chips) 
Seat 6: simonzez ($25.87 in chips) 
Seat 7: rey2040 ($14.02 in chips) 
Seat 8: DutchShultzs ($35.43 in chips) 
Seat 9: Tom1999 ($23.47 in chips) 
starreset: posts small blind $0.10
chiyuki: posts big blind $0.25
*** HOLE CARDS ***
Dealt to chiyuki [Qc Kh]
pandaaaaaa: folds 
DPsemplic: folds 
simonzez: folds 
rey2040: folds 
DutchShultzs: folds 
Tom1999: folds 
1Karina1: folds 
starreset: folds 
Uncalled bet ($0.15) returned to chiyuki
chiyuki collected $0.20 from pot
chiyuki: doesn't show hand 
*** SUMMARY ***
Total pot $0.20 | Rake $0 
Seat 1: 1Karina1 (button) folded before Flop (didn't bet)
Seat 2: starreset (small blind) folded before Flop
Seat 3: chiyuki (big blind) collected ($0.20)
Seat 4: pandaaaaaa folded before Flop (didn't bet)
Seat 5: DPsemplic folded before Flop (didn't bet)
Seat 6: simonzez folded before Flop (didn't bet)
Seat 7: rey2040 folded before Flop (didn't bet)
Seat 8: DutchShultzs folded before Flop (didn't bet)
Seat 9: Tom1999 folded before Flop (didn't bet)



PokerStars Zoom Hand #84300199869:  Hold'em No Limit ($0.10/$0.25) - 2012/08/05 15:12:16 JST [2012/08/05 2:12:16 ET]
Table 'Whirlpool' 9-max Seat #1 is the button
Seat 1: Jene4kaBest ($2.74 in chips) 
Seat 2: chiyuki ($28.73 in chips) 
Seat 3: jacquelinewu ($38.35 in chips) 
Seat 4: kamikkaze ($13.20 in chips) 
Seat 5: DutchShultzs ($33.74 in chips) 
Seat 6: Roglus ($7.90 in chips) 
Seat 7: jeades ($20.13 in chips) 
Seat 8: snejokCoxx ($10.38 in chips) 
Seat 9: hirozo ($33.20 in chips) 
chiyuki: posts small blind $0.10
jacquelinewu: posts big blind $0.25
*** HOLE CARDS ***
Dealt to chiyuki [7h 7s]
kamikkaze: folds 
DutchShultzs: folds 
Roglus: raises $0.50 to $0.75
jeades: folds 
snejokCoxx: folds 
hirozo: folds 
Jene4kaBest: folds 
chiyuki: folds 
jacquelinewu: folds 
Uncalled bet ($0.50) returned to Roglus
Roglus collected $0.60 from pot
Roglus: doesn't show hand 
*** SUMMARY ***
Total pot $0.60 | Rake $0 
Seat 1: Jene4kaBest (button) folded before Flop (didn't bet)
Seat 2: chiyuki (small blind) folded before Flop
Seat 3: jacquelinewu (big blind) folded before Flop
Seat 4: kamikkaze folded before Flop (didn't bet)
Seat 5: DutchShultzs folded before Flop (didn't bet)
Seat 6: Roglus collected ($0.60)
Seat 7: jeades folded before Flop (didn't bet)
Seat 8: snejokCoxx folded before Flop (didn't bet)
Seat 9: hirozo folded before Flop (didn't bet)



PokerStars Zoom Hand #84300204140:  Hold'em No Limit ($0.10/$0.25) - 2012/08/05 15:12:34 JST [2012/08/05 2:12:34 ET]
Table 'Whirlpool' 9-max Seat #1 is the button
Seat 1: laurentzu84 ($25 in chips) 
Seat 2: ChrisCDee ($73.97 in chips) 
Seat 3: Dejacob ($25 in chips) 
Seat 4: River_GmbH ($17.89 in chips) 
Seat 5: kwkim73 ($29.90 in chips) 
Seat 6: snejokCoxx ($11.80 in chips) 
Seat 7: jacquelinewu ($25.35 in chips) 
Seat 8: chiyuki ($28.63 in chips) 
Seat 9: WARIBANA7777 ($17.21 in chips) 
ChrisCDee: posts small blind $0.10
Dejacob: posts big blind $0.25
*** HOLE CARDS ***
Dealt to chiyuki [Ac Qh]
River_GmbH: folds 
kwkim73: folds 
snejokCoxx: folds 
jacquelinewu: folds 
chiyuki: raises $0.50 to $0.75
WARIBANA7777: folds 
laurentzu84: folds 
ChrisCDee: folds 
Dejacob: folds 
Uncalled bet ($0.50) returned to chiyuki
chiyuki collected $0.60 from pot
chiyuki: doesn't show hand 
*** SUMMARY ***
Total pot $0.60 | Rake $0 
Seat 1: laurentzu84 (button) folded before Flop (didn't bet)
Seat 2: ChrisCDee (small blind) folded before Flop
Seat 3: Dejacob (big blind) folded before Flop
Seat 4: River_GmbH folded before Flop (didn't bet)
Seat 5: kwkim73 folded before Flop (didn't bet)
Seat 6: snejokCoxx folded before Flop (didn't bet)
Seat 7: jacquelinewu folded before Flop (didn't bet)
Seat 8: chiyuki collected ($0.60)
Seat 9: WARIBANA7777 folded before Flop (didn't bet)



PokerStars Zoom Hand #84300198347:  Hold'em No Limit ($0.10/$0.25) - 2012/08/05 15:12:10 JST [2012/08/05 2:12:10 ET]
Table 'Whirlpool' 9-max Seat #1 is the button
Seat 1: INSP!RON ($25 in chips) 
Seat 2: kamikkaze ($13.30 in chips) 
Seat 3: Ellen1947 ($23.25 in chips) 
Seat 4: Paranoix1990 ($10.19 in chips) 
Seat 5: jacquelinewu ($38.35 in chips) 
Seat 6: DutchShultzs ($33.74 in chips) 
Seat 7: Perstenev ($10.40 in chips) 
Seat 8: Nerkit ($20.05 in chips) 
Seat 9: chiyuki ($28.73 in chips) 
kamikkaze: posts small blind $0.10
Ellen1947: posts big blind $0.25
*** HOLE CARDS ***
Dealt to chiyuki [6h 9c]
Paranoix1990: folds 
jacquelinewu: folds 
DutchShultzs: folds 
Perstenev: folds 
Nerkit: folds 
chiyuki: folds 
INSP!RON: raises $0.35 to $0.60
kamikkaze: folds 
Ellen1947: calls $0.35
*** FLOP *** [8s 4d Js]
Ellen1947: checks 
INSP!RON: checks 
*** TURN *** [8s 4d Js] [3c]
Ellen1947: bets $0.80
INSP!RON: raises $2.10 to $2.90
Ellen1947: folds 
Uncalled bet ($2.10) returned to INSP!RON
INSP!RON collected $2.77 from pot
INSP!RON: doesn't show hand 
*** SUMMARY ***
Total pot $2.90 | Rake $0.13 
Board [8s 4d Js 3c]
Seat 1: INSP!RON (button) collected ($2.77)
Seat 2: kamikkaze (small blind) folded before Flop
Seat 3: Ellen1947 (big blind) folded on the Turn
Seat 4: Paranoix1990 folded before Flop (didn't bet)
Seat 5: jacquelinewu folded before Flop (didn't bet)
Seat 6: DutchShultzs folded before Flop (didn't bet)
Seat 7: Perstenev folded before Flop (didn't bet)
Seat 8: Nerkit folded before Flop (didn't bet)
Seat 9: chiyuki folded before Flop (didn't bet)



PokerStars Zoom Hand #84300208501:  Hold'em No Limit ($0.10/$0.25) - 2012/08/05 15:12:51 JST [2012/08/05 2:12:51 ET]
Table 'Whirlpool' 9-max Seat #1 is the button
Seat 1: snejokCoxx ($10.03 in chips) 
Seat 2: Perstenev ($10.40 in chips) 
Seat 3: kwkim73 ($29.90 in chips) 
Seat 4: troublesomm ($39.79 in chips) 
Seat 5: jacquelinewu ($73.49 in chips) 
Seat 6: Saruotiss ($46.18 in chips) 
Seat 7: chiyuki ($28.98 in chips) 
Seat 8: silvno31 ($25.90 in chips) 
Seat 9: GovGus ($34.50 in chips) 
Perstenev: posts small blind $0.10
kwkim73: posts big blind $0.25
*** HOLE CARDS ***
Dealt to chiyuki [8s 4h]
troublesomm: folds 
jacquelinewu: folds 
Saruotiss: folds 
chiyuki: folds 
silvno31: folds 
GovGus: folds 
snejokCoxx: folds 
Perstenev: folds 
Uncalled bet ($0.15) returned to kwkim73
kwkim73 collected $0.20 from pot
kwkim73: doesn't show hand 
*** SUMMARY ***
Total pot $0.20 | Rake $0 
Seat 1: snejokCoxx (button) folded before Flop (didn't bet)
Seat 2: Perstenev (small blind) folded before Flop
Seat 3: kwkim73 (big blind) collected ($0.20)
Seat 4: troublesomm folded before Flop (didn't bet)
Seat 5: jacquelinewu folded before Flop (didn't bet)
Seat 6: Saruotiss folded before Flop (didn't bet)
Seat 7: chiyuki folded before Flop (didn't bet)
Seat 8: silvno31 folded before Flop (didn't bet)
Seat 9: GovGus folded before Flop (didn't bet)



PokerStars Zoom Hand #84300211991:  Hold'em No Limit ($0.10/$0.25) - 2012/08/05 15:13:05 JST [2012/08/05 2:13:05 ET]
Table 'Whirlpool' 9-max Seat #1 is the button
Seat 1: chiyuki ($28.98 in chips) 
Seat 2: hirozo ($46.72 in chips) 
Seat 3: DutchShultzs ($41.38 in chips) 
Seat 4: Gichboy ($10.35 in chips) 
Seat 5: snejokCoxx ($12.85 in chips) 
Seat 6: moku36 ($19.22 in chips) 
Seat 7: ZhukOFFskI ($30.73 in chips) 
Seat 8: 1Karina1 ($28.95 in chips) 
Seat 9: Vahe50 ($14.41 in chips) 
hirozo: posts small blind $0.10
DutchShultzs: posts big blind $0.25
*** HOLE CARDS ***
Dealt to chiyuki [Qd 2h]
Gichboy: folds 
snejokCoxx: folds 
moku36: raises $0.25 to $0.50
ZhukOFFskI: folds 
1Karina1: folds 
Vahe50: folds 
chiyuki: folds 
hirozo: folds 
DutchShultzs: folds 
Uncalled bet ($0.25) returned to moku36
moku36 collected $0.60 from pot
moku36: doesn't show hand 
*** SUMMARY ***
Total pot $0.60 | Rake $0 
Seat 1: chiyuki (button) folded before Flop (didn't bet)
Seat 2: hirozo (small blind) folded before Flop
Seat 3: DutchShultzs (big blind) folded before Flop
Seat 4: Gichboy folded before Flop (didn't bet)
Seat 5: snejokCoxx folded before Flop (didn't bet)
Seat 6: moku36 collected ($0.60)
Seat 7: ZhukOFFskI folded before Flop (didn't bet)
Seat 8: 1Karina1 folded before Flop (didn't bet)
Seat 9: Vahe50 folded before Flop (didn't bet)



PokerStars Zoom Hand #84300214717:  Hold'em No Limit ($0.10/$0.25) - 2012/08/05 15:13:16 JST [2012/08/05 2:13:16 ET]
Table 'Whirlpool' 9-max Seat #1 is the button
Seat 1: therati ($18.83 in chips) 
Seat 2: Perstenev ($13.02 in chips) 
Seat 3: Gichboy ($10.35 in chips) 
Seat 4: DanielWhyte ($61.32 in chips) 
Seat 5: kwkim73 ($25 in chips) 
Seat 6: chiyuki ($28.98 in chips) 
Seat 7: Silveystryk ($19.48 in chips) 
Seat 8: Tom1999 ($14.16 in chips) 
Seat 9: kamikkaze ($12.85 in chips) 
Perstenev: posts small blind $0.10
Gichboy: posts big blind $0.25
*** HOLE CARDS ***
Dealt to chiyuki [Ad 3h]
DanielWhyte: folds 
kwkim73: folds 
chiyuki: folds 
Silveystryk: folds 
Tom1999: raises $0.75 to $1
kamikkaze: folds 
therati: folds 
Perstenev: folds 
Gichboy: folds 
Uncalled bet ($0.75) returned to Tom1999
Tom1999 collected $0.60 from pot
Tom1999: doesn't show hand 
*** SUMMARY ***
Total pot $0.60 | Rake $0 
Seat 1: therati (button) folded before Flop (didn't bet)
Seat 2: Perstenev (small blind) folded before Flop
Seat 3: Gichboy (big blind) folded before Flop
Seat 4: DanielWhyte folded before Flop (didn't bet)
Seat 5: kwkim73 folded before Flop (didn't bet)
Seat 6: chiyuki folded before Flop (didn't bet)
Seat 7: Silveystryk folded before Flop (didn't bet)
Seat 8: Tom1999 collected ($0.60)
Seat 9: kamikkaze folded before Flop (didn't bet)



PokerStars Zoom Hand #84300213747:  Hold'em No Limit ($0.10/$0.25) - 2012/08/05 15:13:12 JST [2012/08/05 2:13:12 ET]
Table 'Whirlpool' 9-max Seat #1 is the button
Seat 1: WARIBANA7777 ($17.11 in chips) 
Seat 2: HighDuka ($40.32 in chips) 
Seat 3: Rilko1975 ($23.07 in chips) 
Seat 4: bigred1102 ($21.09 in chips) 
Seat 5: ZhukOFFskI ($37.83 in chips) 
Seat 6: kamikkaze ($12.85 in chips) 
Seat 7: chiyuki ($28.98 in chips) 
Seat 8: 1Karina1 ($25 in chips) 
Seat 9: Tom1999 ($14.16 in chips) 
HighDuka: posts small blind $0.10
Rilko1975: posts big blind $0.25
*** HOLE CARDS ***
Dealt to chiyuki [9s 5c]
bigred1102: folds 
ZhukOFFskI: folds 
kamikkaze: folds 
chiyuki: folds 
1Karina1: raises $0.50 to $0.75
Tom1999: folds 
WARIBANA7777: folds 
HighDuka: folds 
Rilko1975: folds 
Uncalled bet ($0.50) returned to 1Karina1
1Karina1 collected $0.60 from pot
1Karina1: doesn't show hand 
*** SUMMARY ***
Total pot $0.60 | Rake $0 
Seat 1: WARIBANA7777 (button) folded before Flop (didn't bet)
Seat 2: HighDuka (small blind) folded before Flop
Seat 3: Rilko1975 (big blind) folded before Flop
Seat 4: bigred1102 folded before Flop (didn't bet)
Seat 5: ZhukOFFskI folded before Flop (didn't bet)
Seat 6: kamikkaze folded before Flop (didn't bet)
Seat 7: chiyuki folded before Flop (didn't bet)
Seat 8: 1Karina1 collected ($0.60)
Seat 9: Tom1999 folded before Flop (didn't bet)



PokerStars Zoom Hand #84300209477:  Hold'em No Limit ($0.10/$0.25) - 2012/08/05 15:12:55 JST [2012/08/05 2:12:55 ET]
Table 'Whirlpool' 9-max Seat #1 is the button
Seat 1: KeLevro0 ($11.50 in chips) 
Seat 2: silvno31 ($25.90 in chips) 
Seat 3: Sal y Limon1 ($25 in chips) 
Seat 4: INSP!RON ($25 in chips) 
Seat 5: Tom1999 ($23.47 in chips) 
Seat 6: chiyuki ($28.98 in chips) 
Seat 7: Dejacob ($25 in chips) 
Seat 8: GovGus ($34.50 in chips) 
Seat 9: Perstenev ($10.30 in chips) 
silvno31: posts small blind $0.10
Sal y Limon1: posts big blind $0.25
*** HOLE CARDS ***
Dealt to chiyuki [5d 9s]
INSP!RON: folds 
Tom1999: raises $0.50 to $0.75
chiyuki: folds 
Dejacob: folds 
GovGus: folds 
Perstenev: folds 
KeLevro0: folds 
silvno31: calls $0.65
Sal y Limon1: calls $0.50
*** FLOP *** [As 2d 9c]
silvno31: checks 
Sal y Limon1: checks 
Tom1999: bets $0.75
silvno31: calls $0.75
Sal y Limon1: folds 
*** TURN *** [As 2d 9c] [8d]
silvno31: checks 
Tom1999: bets $1.25
silvno31: raises $1.25 to $2.50
Tom1999: folds 
Uncalled bet ($1.25) returned to silvno31
silvno31 collected $5.97 from pot
silvno31: doesn't show hand 
*** SUMMARY ***
Total pot $6.25 | Rake $0.28 
Board [As 2d 9c 8d]
Seat 1: KeLevro0 (button) folded before Flop (didn't bet)
Seat 2: silvno31 (small blind) collected ($5.97)
Seat 3: Sal y Limon1 (big blind) folded on the Flop
Seat 4: INSP!RON folded before Flop (didn't bet)
Seat 5: Tom1999 folded on the Turn
Seat 6: chiyuki folded before Flop (didn't bet)
Seat 7: Dejacob folded before Flop (didn't bet)
Seat 8: GovGus folded before Flop (didn't bet)
Seat 9: Perstenev folded before Flop (didn't bet)



PokerStars Zoom Hand #84300216682:  Hold'em No Limit ($0.10/$0.25) - 2012/08/05 15:13:24 JST [2012/08/05 2:13:24 ET]
Table 'Whirlpool' 9-max Seat #1 is the button
Seat 1: hirozo ($32.85 in chips) 
Seat 2: puffy5533 ($24.75 in chips) 
Seat 3: Nerkit ($15.15 in chips) 
Seat 4: el pore 5 ($8.56 in chips) 
Seat 5: jacquelinewu ($26.21 in chips) 
Seat 6: deadmoneykid ($24.66 in chips) 
Seat 7: snejokCoxx ($11.79 in chips) 
Seat 8: Roglus ($8.80 in chips) 
Seat 9: chiyuki ($28.98 in chips) 
puffy5533: posts small blind $0.10
Nerkit: posts big blind $0.25
*** HOLE CARDS ***
Dealt to chiyuki [2d 8c]
el pore 5: folds 
jacquelinewu: folds 
deadmoneykid: folds 
snejokCoxx: folds 
Roglus: folds 
chiyuki: folds 
hirozo: raises $0.25 to $0.50
puffy5533: folds 
Nerkit: folds 
Uncalled bet ($0.25) returned to hirozo
hirozo collected $0.60 from pot
hirozo: doesn't show hand 
*** SUMMARY ***
Total pot $0.60 | Rake $0 
Seat 1: hirozo (button) collected ($0.60)
Seat 2: puffy5533 (small blind) folded before Flop
Seat 3: Nerkit (big blind) folded before Flop
Seat 4: el pore 5 folded before Flop (didn't bet)
Seat 5: jacquelinewu folded before Flop (didn't bet)
Seat 6: deadmoneykid folded before Flop (didn't bet)
Seat 7: snejokCoxx folded before Flop (didn't bet)
Seat 8: Roglus folded before Flop (didn't bet)
Seat 9: chiyuki folded before Flop (didn't bet)



PokerStars Zoom Hand #84300224416:  Hold'em No Limit ($0.10/$0.25) - 2012/08/05 15:13:55 JST [2012/08/05 2:13:55 ET]
Table 'Whirlpool' 9-max Seat #1 is the button
Seat 1: grand maitre ($26.55 in chips) 
Seat 2: chiyuki ($28.73 in chips) 
Seat 3: puffy5533 ($24.65 in chips) 
Seat 4: ygoegoe ($30.77 in chips) 
Seat 5: phate-1up ($51.58 in chips) 
Seat 6: tribunpdm ($29.43 in chips) 
Seat 7: Littlea029 ($29.96 in chips) 
Seat 8: DutchShultzs ($25 in chips) 
Seat 9: kwkim73 ($29.15 in chips) 
chiyuki: posts small blind $0.10
puffy5533: posts big blind $0.25
*** HOLE CARDS ***
Dealt to chiyuki [8d 9h]
ygoegoe: folds 
phate-1up: folds 
tribunpdm: folds 
Littlea029: folds 
DutchShultzs: folds 
kwkim73: folds 
grand maitre: folds 
chiyuki: folds 
Uncalled bet ($0.15) returned to puffy5533
puffy5533 collected $0.20 from pot
puffy5533: doesn't show hand 
*** SUMMARY ***
Total pot $0.20 | Rake $0 
Seat 1: grand maitre (button) folded before Flop (didn't bet)
Seat 2: chiyuki (small blind) folded before Flop
Seat 3: puffy5533 (big blind) collected ($0.20)
Seat 4: ygoegoe folded before Flop (didn't bet)
Seat 5: phate-1up folded before Flop (didn't bet)
Seat 6: tribunpdm folded before Flop (didn't bet)
Seat 7: Littlea029 folded before Flop (didn't bet)
Seat 8: DutchShultzs folded before Flop (didn't bet)
Seat 9: kwkim73 folded before Flop (didn't bet)



PokerStars Zoom Hand #84300225985:  Hold'em No Limit ($0.10/$0.25) - 2012/08/05 15:14:01 JST [2012/08/05 2:14:01 ET]
Table 'Whirlpool' 9-max Seat #1 is the button
Seat 1: seula i ($40.72 in chips) 
Seat 2: jacquelinewu ($73.59 in chips) 
Seat 3: troublesomm ($39.69 in chips) 
Seat 4: deadmoneykid ($32.21 in chips) 
Seat 5: chiyuki ($28.63 in chips) 
Seat 6: womble32 ($26.21 in chips) 
Seat 7: NuMetal88 ($25.67 in chips) 
Seat 8: kwkim73 ($29.15 in chips) 
Seat 9: Ellen1947 ($25 in chips) 
jacquelinewu: posts small blind $0.10
troublesomm: posts big blind $0.25
*** HOLE CARDS ***
Dealt to chiyuki [Qs 9c]
deadmoneykid: folds 
chiyuki: folds 
womble32: folds 
NuMetal88: folds 
kwkim73: folds 
Ellen1947: folds 
seula i: folds 
jacquelinewu: raises $0.50 to $0.75
troublesomm: folds 
Uncalled bet ($0.50) returned to jacquelinewu
jacquelinewu collected $0.50 from pot
jacquelinewu: doesn't show hand 
*** SUMMARY ***
Total pot $0.50 | Rake $0 
Seat 1: seula i (button) folded before Flop (didn't bet)
Seat 2: jacquelinewu (small blind) collected ($0.50)
Seat 3: troublesomm (big blind) folded before Flop
Seat 4: deadmoneykid folded before Flop (didn't bet)
Seat 5: chiyuki folded before Flop (didn't bet)
Seat 6: womble32 folded before Flop (didn't bet)
Seat 7: NuMetal88 folded before Flop (didn't bet)
Seat 8: kwkim73 folded before Flop (didn't bet)
Seat 9: Ellen1947 folded before Flop (didn't bet)



PokerStars Zoom Hand #84300222909:  Hold'em No Limit ($0.10/$0.25) - 2012/08/05 15:13:49 JST [2012/08/05 2:13:49 ET]
Table 'Whirlpool' 9-max Seat #1 is the button
Seat 1: rey2040 ($12.30 in chips) 
Seat 2: Dan Royal ($41.29 in chips) 
Seat 3: 4plankton ($18.94 in chips) 
Seat 4: Perstenev ($14.06 in chips) 
Seat 5: moku36 ($19.57 in chips) 
Seat 6: Dejacob ($42.32 in chips) 
Seat 7: tribunpdm ($29.43 in chips) 
Seat 8: chiyuki ($28.73 in chips) 
Seat 9: svg51 ($13.82 in chips) 
Dan Royal: posts small blind $0.10
4plankton: posts big blind $0.25
*** HOLE CARDS ***
Dealt to chiyuki [Kd 2s]
Perstenev: folds 
moku36: calls $0.25
Dejacob: folds 
tribunpdm: folds 
chiyuki: folds 
svg51: folds 
rey2040: calls $0.25
Dan Royal: calls $0.15
4plankton: checks 
*** FLOP *** [9d Tc 8h]
Dan Royal: checks 
4plankton: checks 
moku36: checks 
rey2040: checks 
*** TURN *** [9d Tc 8h] [4h]
Dan Royal: checks 
4plankton: bets $0.25
moku36: folds 
rey2040: folds 
Dan Royal: folds 
Uncalled bet ($0.25) returned to 4plankton
4plankton collected $0.96 from pot
4plankton: doesn't show hand 
*** SUMMARY ***
Total pot $1 | Rake $0.04 
Board [9d Tc 8h 4h]
Seat 1: rey2040 (button) folded on the Turn
Seat 2: Dan Royal (small blind) folded on the Turn
Seat 3: 4plankton (big blind) collected ($0.96)
Seat 4: Perstenev folded before Flop (didn't bet)
Seat 5: moku36 folded on the Turn
Seat 6: Dejacob folded before Flop (didn't bet)
Seat 7: tribunpdm folded before Flop (didn't bet)
Seat 8: chiyuki folded before Flop (didn't bet)
Seat 9: svg51 folded before Flop (didn't bet)



PokerStars Zoom Hand #84300218288:  Hold'em No Limit ($0.10/$0.25) - 2012/08/05 15:13:30 JST [2012/08/05 2:13:30 ET]
Table 'Whirlpool' 9-max Seat #1 is the button
Seat 1: ChrisCDee ($25.72 in chips) 
Seat 2: Alvinpe85 ($42.07 in chips) 
Seat 3: chiyuki ($28.98 in chips) 
Seat 4: KeLevro0 ($11.85 in chips) 
Seat 5: GovGus ($34.50 in chips) 
Seat 6: 1Karina1 ($25.35 in chips) 
Seat 7: DutchShultzs ($41.13 in chips) 
Seat 8: mid22 ($16.71 in chips) 
Seat 9: Sal y Limon1 ($24.75 in chips) 
Alvinpe85: posts small blind $0.10
chiyuki: posts big blind $0.25
*** HOLE CARDS ***
Dealt to chiyuki [Th 8c]
KeLevro0: folds 
GovGus: folds 
1Karina1: raises $0.50 to $0.75
DutchShultzs: folds 
mid22: calls $0.75
Sal y Limon1: calls $0.75
ChrisCDee: folds 
Alvinpe85: folds 
chiyuki: folds 
*** FLOP *** [7c 7s Qc]
1Karina1: checks 
mid22: checks 
Sal y Limon1: checks 
*** TURN *** [7c 7s Qc] [8d]
1Karina1: checks 
mid22: checks 
Sal y Limon1: checks 
*** RIVER *** [7c 7s Qc 8d] [Jh]
1Karina1: checks 
mid22: checks 
Sal y Limon1: checks 
*** SHOW DOWN ***
1Karina1: shows [9h 9d] (two pair, Nines and Sevens)
mid22: mucks hand 
Sal y Limon1: mucks hand 
1Karina1 collected $2.48 from pot
*** SUMMARY ***
Total pot $2.60 | Rake $0.12 
Board [7c 7s Qc 8d Jh]
Seat 1: ChrisCDee (button) folded before Flop (didn't bet)
Seat 2: Alvinpe85 (small blind) folded before Flop
Seat 3: chiyuki (big blind) folded before Flop
Seat 4: KeLevro0 folded before Flop (didn't bet)
Seat 5: GovGus folded before Flop (didn't bet)
Seat 6: 1Karina1 showed [9h 9d] and won ($2.48) with two pair, Nines and Sevens
Seat 7: DutchShultzs folded before Flop (didn't bet)
Seat 8: mid22 mucked [9c As]
Seat 9: Sal y Limon1 mucked [Ah 5h]



PokerStars Zoom Hand #84300227002:  Hold'em No Limit ($0.10/$0.25) - 2012/08/05 15:14:05 JST [2012/08/05 2:14:05 ET]
Table 'Whirlpool' 9-max Seat #1 is the button
Seat 1: River_GmbH ($16.04 in chips) 
Seat 2: KrystalAA ($34.49 in chips) 
Seat 3: 4ydo yogurt ($38.63 in chips) 
Seat 4: snejokCoxx ($9.78 in chips) 
Seat 5: chiyuki ($28.63 in chips) 
Seat 6: kwkim73 ($26.44 in chips) 
Seat 7: kamikkaze ($16.23 in chips) 
Seat 8: DutchShultzs ($41.03 in chips) 
Seat 9: ChrisCDee ($72.31 in chips) 
KrystalAA: posts small blind $0.10
4ydo yogurt: posts big blind $0.25
*** HOLE CARDS ***
Dealt to chiyuki [6c 6h]
snejokCoxx: raises $0.40 to $0.65
chiyuki: folds 
kwkim73: folds 
kamikkaze: folds 
DutchShultzs: folds 
ChrisCDee: folds 
River_GmbH: folds 
KrystalAA: folds 
4ydo yogurt: calls $0.40
*** FLOP *** [6d Td Ah]
4ydo yogurt: bets $0.67
snejokCoxx: folds 
Uncalled bet ($0.67) returned to 4ydo yogurt
4ydo yogurt collected $1.34 from pot
4ydo yogurt: doesn't show hand 
*** SUMMARY ***
Total pot $1.40 | Rake $0.06 
Board [6d Td Ah]
Seat 1: River_GmbH (button) folded before Flop (didn't bet)
Seat 2: KrystalAA (small blind) folded before Flop
Seat 3: 4ydo yogurt (big blind) collected ($1.34)
Seat 4: snejokCoxx folded on the Flop
Seat 5: chiyuki folded before Flop (didn't bet)
Seat 6: kwkim73 folded before Flop (didn't bet)
Seat 7: kamikkaze folded before Flop (didn't bet)
Seat 8: DutchShultzs folded before Flop (didn't bet)
Seat 9: ChrisCDee folded before Flop (didn't bet)



PokerStars Zoom Hand #84300228496:  Hold'em No Limit ($0.10/$0.25) - 2012/08/05 15:14:11 JST [2012/08/05 2:14:11 ET]
Table 'Whirlpool' 9-max Seat #1 is the button
Seat 1: chiyuki ($28.63 in chips) 
Seat 2: snejokCoxx ($13.88 in chips) 
Seat 3: hirozo ($81.26 in chips) 
Seat 4: el pore 5 ($8.81 in chips) 
Seat 5: silvno31 ($28.37 in chips) 
Seat 6: kwkim73 ($29.15 in chips) 
Seat 7: Nerkit ($10.65 in chips) 
Seat 8: Perstenev ($29.03 in chips) 
Seat 9: phate-1up ($59.32 in chips) 
snejokCoxx: posts small blind $0.10
hirozo: posts big blind $0.25
*** HOLE CARDS ***
Dealt to chiyuki [As Ad]
el pore 5: folds 
silvno31: folds 
kwkim73: folds 
Nerkit: folds 
Perstenev: folds 
phate-1up: raises $0.50 to $0.75
chiyuki: raises $1.50 to $2.25
snejokCoxx: folds 
hirozo: folds 
phate-1up: raises $3.25 to $5.50
chiyuki: raises $23.13 to $28.63 and is all-in
phate-1up: folds 
Uncalled bet ($23.13) returned to chiyuki
chiyuki collected $11.35 from pot
chiyuki: doesn't show hand 
*** SUMMARY ***
Total pot $11.35 | Rake $0 
Seat 1: chiyuki (button) collected ($11.35)
Seat 2: snejokCoxx (small blind) folded before Flop
Seat 3: hirozo (big blind) folded before Flop
Seat 4: el pore 5 folded before Flop (didn't bet)
Seat 5: silvno31 folded before Flop (didn't bet)
Seat 6: kwkim73 folded before Flop (didn't bet)
Seat 7: Nerkit folded before Flop (didn't bet)
Seat 8: Perstenev folded before Flop (didn't bet)
Seat 9: phate-1up folded before Flop



PokerStars Zoom Hand #84300245817:  Hold'em No Limit ($0.10/$0.25) - 2012/08/05 15:15:20 JST [2012/08/05 2:15:20 ET]
Table 'Whirlpool' 9-max Seat #1 is the button
Seat 1: troublesomm ($35.25 in chips) 
Seat 2: Perstenev ($31.40 in chips) 
Seat 3: chiyuki ($34.48 in chips) 
Seat 4: dergeb ($16.78 in chips) 
Seat 5: INSP!RON ($25 in chips) 
Seat 6: karpexxx ($14.60 in chips) 
Seat 7: ygoegoe ($30.67 in chips) 
Seat 8: DutchShultzs ($25.50 in chips) 
Seat 9: Rilko1975 ($24.75 in chips) 
Perstenev: posts small blind $0.10
chiyuki: posts big blind $0.25
*** HOLE CARDS ***
Dealt to chiyuki [Kh As]
dergeb: folds 
INSP!RON: folds 
karpexxx: folds 
ygoegoe: folds 
DutchShultzs: folds 
Rilko1975: folds 
troublesomm: folds 
Perstenev: folds 
Uncalled bet ($0.15) returned to chiyuki
chiyuki collected $0.20 from pot
chiyuki: doesn't show hand 
*** SUMMARY ***
Total pot $0.20 | Rake $0 
Seat 1: troublesomm (button) folded before Flop (didn't bet)
Seat 2: Perstenev (small blind) folded before Flop
Seat 3: chiyuki (big blind) collected ($0.20)
Seat 4: dergeb folded before Flop (didn't bet)
Seat 5: INSP!RON folded before Flop (didn't bet)
Seat 6: karpexxx folded before Flop (didn't bet)
Seat 7: ygoegoe folded before Flop (didn't bet)
Seat 8: DutchShultzs folded before Flop (didn't bet)
Seat 9: Rilko1975 folded before Flop (didn't bet)



PokerStars Zoom Hand #84300245018:  Hold'em No Limit ($0.10/$0.25) - 2012/08/05 15:15:17 JST [2012/08/05 2:15:17 ET]
Table 'Whirlpool' 9-max Seat #1 is the button
Seat 1: Jene4kaBest ($11.90 in chips) 
Seat 2: seula i ($40.01 in chips) 
Seat 3: hirozo ($80.91 in chips) 
Seat 4: chiyuki ($34.48 in chips) 
Seat 5: silvno31 ($28.59 in chips) 
Seat 6: deadmoneykid ($27.22 in chips) 
Seat 7: INSP!RON ($30.30 in chips) 
Seat 8: yane73 ($22.01 in chips) 
Seat 9: slapshot2011 ($25 in chips) 
seula i: posts small blind $0.10
hirozo: posts big blind $0.25
*** HOLE CARDS ***
Dealt to chiyuki [Kd 4h]
chiyuki: folds 
silvno31: folds 
deadmoneykid: folds 
INSP!RON: folds 
yane73: folds 
slapshot2011: calls $0.25
Jene4kaBest: folds 
seula i: calls $0.15
hirozo: checks 
*** FLOP *** [Js 2s 9c]
seula i: checks 
hirozo: checks 
slapshot2011: bets $0.75
seula i: folds 
hirozo: folds 
Uncalled bet ($0.75) returned to slapshot2011
slapshot2011 collected $0.72 from pot
slapshot2011: doesn't show hand 
*** SUMMARY ***
Total pot $0.75 | Rake $0.03 
Board [Js 2s 9c]
Seat 1: Jene4kaBest (button) folded before Flop (didn't bet)
Seat 2: seula i (small blind) folded on the Flop
Seat 3: hirozo (big blind) folded on the Flop
Seat 4: chiyuki folded before Flop (didn't bet)
Seat 5: silvno31 folded before Flop (didn't bet)
Seat 6: deadmoneykid folded before Flop (didn't bet)
Seat 7: INSP!RON folded before Flop (didn't bet)
Seat 8: yane73 folded before Flop (didn't bet)
Seat 9: slapshot2011 collected ($0.72)



PokerStars Zoom Hand #84300248636:  Hold'em No Limit ($0.10/$0.25) - 2012/08/05 15:15:31 JST [2012/08/05 2:15:31 ET]
Table 'Whirlpool' 9-max Seat #1 is the button
Seat 1: kwkim73 ($27.83 in chips) 
Seat 2: 1Karina1 ($37.80 in chips) 
Seat 3: DutchShultzs ($33.42 in chips) 
Seat 4: chiyuki ($34.58 in chips) 
Seat 5: tribunpdm ($34.32 in chips) 
Seat 6: HighDuka ($26.40 in chips) 
Seat 7: ChrisCDee ($23.72 in chips) 
Seat 8: phate-1up ($54.07 in chips) 
Seat 9: kaplya2010 ($19.24 in chips) 
1Karina1: posts small blind $0.10
DutchShultzs: posts big blind $0.25
*** HOLE CARDS ***
Dealt to chiyuki [2h Ks]
chiyuki: folds 
tribunpdm: folds 
HighDuka: folds 
ChrisCDee: folds 
phate-1up: folds 
kaplya2010: raises $0.25 to $0.50
kwkim73: folds 
1Karina1: folds 
DutchShultzs: folds 
Uncalled bet ($0.25) returned to kaplya2010
kaplya2010 collected $0.60 from pot
kaplya2010: doesn't show hand 
*** SUMMARY ***
Total pot $0.60 | Rake $0 
Seat 1: kwkim73 (button) folded before Flop (didn't bet)
Seat 2: 1Karina1 (small blind) folded before Flop
Seat 3: DutchShultzs (big blind) folded before Flop
Seat 4: chiyuki folded before Flop (didn't bet)
Seat 5: tribunpdm folded before Flop (didn't bet)
Seat 6: HighDuka folded before Flop (didn't bet)
Seat 7: ChrisCDee folded before Flop (didn't bet)
Seat 8: phate-1up folded before Flop (didn't bet)
Seat 9: kaplya2010 collected ($0.60)



PokerStars Zoom Hand #84300241503:  Hold'em No Limit ($0.10/$0.25) - 2012/08/05 15:15:03 JST [2012/08/05 2:15:03 ET]
Table 'Whirlpool' 9-max Seat #1 is the button
Seat 1: kwkim73 ($26.35 in chips) 
Seat 2: troublesomm ($35.35 in chips) 
Seat 3: dergeb ($17.03 in chips) 
Seat 4: Dejacob ($26.12 in chips) 
Seat 5: deadmoneykid ($27.22 in chips) 
Seat 6: Tom1999 ($40.67 in chips) 
Seat 7: Wilcox76607 ($35.64 in chips) 
Seat 8: snejokCoxx ($11.44 in chips) 
Seat 9: chiyuki ($34.48 in chips) 
troublesomm: posts small blind $0.10
dergeb: posts big blind $0.25
*** HOLE CARDS ***
Dealt to chiyuki [7s As]
Dejacob: raises $0.50 to $0.75
deadmoneykid: folds 
Tom1999: calls $0.75
Wilcox76607: folds 
snejokCoxx: folds 
chiyuki: folds 
kwkim73: folds 
troublesomm: folds 
dergeb: folds 
*** FLOP *** [7h 5c 6c]
Dejacob: bets $1
Tom1999: calls $1
*** TURN *** [7h 5c 6c] [Th]
Dejacob: bets $2.50
Tom1999: calls $2.50
*** RIVER *** [7h 5c 6c Th] [3c]
Dejacob: checks 
Tom1999: bets $3.25
Dejacob: folds 
Uncalled bet ($3.25) returned to Tom1999
Tom1999 collected $8.45 from pot
Tom1999: doesn't show hand 
*** SUMMARY ***
Total pot $8.85 | Rake $0.40 
Board [7h 5c 6c Th 3c]
Seat 1: kwkim73 (button) folded before Flop (didn't bet)
Seat 2: troublesomm (small blind) folded before Flop
Seat 3: dergeb (big blind) folded before Flop
Seat 4: Dejacob folded on the River
Seat 5: deadmoneykid folded before Flop (didn't bet)
Seat 6: Tom1999 collected ($8.45)
Seat 7: Wilcox76607 folded before Flop (didn't bet)
Seat 8: snejokCoxx folded before Flop (didn't bet)
Seat 9: chiyuki folded before Flop (didn't bet)



PokerStars Zoom Hand #84300249907:  Hold'em No Limit ($0.10/$0.25) - 2012/08/05 15:15:36 JST [2012/08/05 2:15:36 ET]
Table 'Whirlpool' 9-max Seat #1 is the button
Seat 1: ZhukOFFskI ($29.39 in chips) 
Seat 2: chiyuki ($34.58 in chips) 
Seat 3: kwkim73 ($25 in chips) 
Seat 4: Silveystryk ($27.08 in chips) 
Seat 5: HighDuka ($26.40 in chips) 
Seat 6: WARIBANA7777 ($17.54 in chips) 
Seat 7: kamikkaze ($16.58 in chips) 
Seat 8: rey2040 ($11.95 in chips) 
Seat 9: INSP!RON ($25 in chips) 
chiyuki: posts small blind $0.10
kwkim73: posts big blind $0.25
*** HOLE CARDS ***
Dealt to chiyuki [2d Qd]
Silveystryk: folds 
HighDuka: folds 
WARIBANA7777: folds 
kamikkaze: folds 
rey2040: raises $0.50 to $0.75
INSP!RON: folds 
ZhukOFFskI: folds 
chiyuki: folds 
kwkim73: folds 
Uncalled bet ($0.50) returned to rey2040
rey2040 collected $0.60 from pot
rey2040: doesn't show hand 
*** SUMMARY ***
Total pot $0.60 | Rake $0 
Seat 1: ZhukOFFskI (button) folded before Flop (didn't bet)
Seat 2: chiyuki (small blind) folded before Flop
Seat 3: kwkim73 (big blind) folded before Flop
Seat 4: Silveystryk folded before Flop (didn't bet)
Seat 5: HighDuka folded before Flop (didn't bet)
Seat 6: WARIBANA7777 folded before Flop (didn't bet)
Seat 7: kamikkaze folded before Flop (didn't bet)
Seat 8: rey2040 collected ($0.60)
Seat 9: INSP!RON folded before Flop (didn't bet)



PokerStars Zoom Hand #84300251155:  Hold'em No Limit ($0.10/$0.25) - 2012/08/05 15:15:41 JST [2012/08/05 2:15:41 ET]
Table 'Whirlpool' 9-max Seat #1 is the button
Seat 1: ChrisCDee ($72.21 in chips) 
Seat 2: phate-1up ($29.07 in chips) 
Seat 3: Sal y Limon1 ($26.20 in chips) 
Seat 4: GovGus ($35.35 in chips) 
Seat 5: Silveystryk ($17.73 in chips) 
Seat 6: Dejacob ($42.49 in chips) 
Seat 7: hirozo ($32.85 in chips) 
Seat 8: chiyuki ($34.48 in chips) 
Seat 9: ygoegoe ($32.88 in chips) 
phate-1up: posts small blind $0.10
Sal y Limon1: posts big blind $0.25
*** HOLE CARDS ***
Dealt to chiyuki [Jh 4c]
GovGus: folds 
Silveystryk: calls $0.25
Dejacob: folds 
hirozo: folds 
chiyuki: folds 
ygoegoe: folds 
ChrisCDee: calls $0.25
phate-1up: folds 
Sal y Limon1: checks 
*** FLOP *** [7d Qh 2s]
Sal y Limon1: checks 
Silveystryk: checks 
ChrisCDee: bets $0.48
Sal y Limon1: folds 
Silveystryk: folds 
Uncalled bet ($0.48) returned to ChrisCDee
ChrisCDee collected $0.81 from pot
ChrisCDee: doesn't show hand 
*** SUMMARY ***
Total pot $0.85 | Rake $0.04 
Board [7d Qh 2s]
Seat 1: ChrisCDee (button) collected ($0.81)
Seat 2: phate-1up (small blind) folded before Flop
Seat 3: Sal y Limon1 (big blind) folded on the Flop
Seat 4: GovGus folded before Flop (didn't bet)
Seat 5: Silveystryk folded on the Flop
Seat 6: Dejacob folded before Flop (didn't bet)
Seat 7: hirozo folded before Flop (didn't bet)
Seat 8: chiyuki folded before Flop (didn't bet)
Seat 9: ygoegoe folded before Flop (didn't bet)



PokerStars Zoom Hand #84300252659:  Hold'em No Limit ($0.10/$0.25) - 2012/08/05 15:15:47 JST [2012/08/05 2:15:47 ET]
Table 'Whirlpool' 9-max Seat #1 is the button
Seat 1: seula i ($39.76 in chips) 
Seat 2: kamikkaze ($16.58 in chips) 
Seat 3: troublesomm ($25 in chips) 
Seat 4: svg51 ($11.22 in chips) 
Seat 5: chiyuki ($34.48 in chips) 
Seat 6: hirozo ($74.36 in chips) 
Seat 7: ZhukOFFskI ($29.39 in chips) 
Seat 8: dushvan ($32.84 in chips) 
Seat 9: nastya040 ($18.37 in chips) 
kamikkaze: posts small blind $0.10
troublesomm: posts big blind $0.25
*** HOLE CARDS ***
Dealt to chiyuki [Jc As]
svg51: folds 
chiyuki: folds 
hirozo: folds 
ZhukOFFskI: folds 
dushvan: folds 
nastya040: folds 
seula i: raises $0.50 to $0.75
kamikkaze: folds 
troublesomm: calls $0.50
*** FLOP *** [3c 7c Qs]
troublesomm: checks 
seula i: checks 
*** TURN *** [3c 7c Qs] [4d]
troublesomm: bets $0.84
seula i: calls $0.84
*** RIVER *** [3c 7c Qs 4d] [6s]
troublesomm: checks 
seula i: bets $3.75
troublesomm: calls $3.75
*** SHOW DOWN ***
seula i: shows [Ad 5d] (a straight, Three to Seven)
troublesomm: mucks hand 
seula i collected $10.29 from pot
*** SUMMARY ***
Total pot $10.78 | Rake $0.49 
Board [3c 7c Qs 4d 6s]
Seat 1: seula i (button) showed [Ad 5d] and won ($10.29) with a straight, Three to Seven
Seat 2: kamikkaze (small blind) folded before Flop
Seat 3: troublesomm (big blind) mucked [6d 6h]
Seat 4: svg51 folded before Flop (didn't bet)
Seat 5: chiyuki folded before Flop (didn't bet)
Seat 6: hirozo folded before Flop (didn't bet)
Seat 7: ZhukOFFskI folded before Flop (didn't bet)
Seat 8: dushvan folded before Flop (didn't bet)
Seat 9: nastya040 folded before Flop (didn't bet)



PokerStars Zoom Hand #84300255182:  Hold'em No Limit ($0.10/$0.25) - 2012/08/05 15:15:57 JST [2012/08/05 2:15:57 ET]
Table 'Whirlpool' 9-max Seat #1 is the button
Seat 1: Saruotiss ($47.26 in chips) 
Seat 2: Gichboy ($12.75 in chips) 
Seat 3: dergeb ($16.68 in chips) 
Seat 4: Wilcox76607 ($35.89 in chips) 
Seat 5: hirozo ($74.36 in chips) 
Seat 6: yane73 ($24.44 in chips) 
Seat 7: chiyuki ($34.48 in chips) 
Seat 8: 1Karina1 ($37.45 in chips) 
Seat 9: Tom1999 ($44.77 in chips) 
Gichboy: posts small blind $0.10
dergeb: posts big blind $0.25
*** HOLE CARDS ***
Dealt to chiyuki [8s 3h]
Wilcox76607: folds 
hirozo: folds 
yane73: folds 
chiyuki: folds 
1Karina1: folds 
Tom1999: folds 
Saruotiss: folds 
Gichboy: calls $0.15
dergeb: checks 
*** FLOP *** [7h 2c 6h]
Gichboy: checks 
dergeb: checks 
*** TURN *** [7h 2c 6h] [8c]
Gichboy: bets $0.25
dergeb: calls $0.25
*** RIVER *** [7h 2c 6h 8c] [Kh]
Gichboy: bets $0.25
dergeb: calls $0.25
*** SHOW DOWN ***
Gichboy: shows [Ad 8d] (a pair of Eights)
dergeb: shows [Ts Kc] (a pair of Kings)
dergeb collected $1.43 from pot
*** SUMMARY ***
Total pot $1.50 | Rake $0.07 
Board [7h 2c 6h 8c Kh]
Seat 1: Saruotiss (button) folded before Flop (didn't bet)
Seat 2: Gichboy (small blind) showed [Ad 8d] and lost with a pair of Eights
Seat 3: dergeb (big blind) showed [Ts Kc] and won ($1.43) with a pair of Kings
Seat 4: Wilcox76607 folded before Flop (didn't bet)
Seat 5: hirozo folded before Flop (didn't bet)
Seat 6: yane73 folded before Flop (didn't bet)
Seat 7: chiyuki folded before Flop (didn't bet)
Seat 8: 1Karina1 folded before Flop (didn't bet)
Seat 9: Tom1999 folded before Flop (didn't bet)



PokerStars Zoom Hand #84300259718:  Hold'em No Limit ($0.10/$0.25) - 2012/08/05 15:16:16 JST [2012/08/05 2:16:16 ET]
Table 'Whirlpool' 9-max Seat #1 is the button
Seat 1: kwkim73 ($25 in chips) 
Seat 2: Perstenev ($31.30 in chips) 
Seat 3: DutchShultzs ($25 in chips) 
Seat 4: ZhukOFFskI ($29.39 in chips) 
Seat 5: Roglus ($4.15 in chips) 
Seat 6: chiyuki ($34.48 in chips) 
Seat 7: 1Karina1 ($31.07 in chips) 
Seat 8: troublesomm ($35 in chips) 
Seat 9: el pore 5 ($9.69 in chips) 
Perstenev: posts small blind $0.10
DutchShultzs: posts big blind $0.25
*** HOLE CARDS ***
Dealt to chiyuki [Kh 3s]
ZhukOFFskI: folds 
Roglus: folds 
chiyuki: folds 
1Karina1: folds 
troublesomm: folds 
el pore 5: raises $9.44 to $9.69 and is all-in
kwkim73: folds 
Perstenev: folds 
DutchShultzs: folds 
Uncalled bet ($9.44) returned to el pore 5
el pore 5 collected $0.60 from pot
el pore 5: doesn't show hand 
*** SUMMARY ***
Total pot $0.60 | Rake $0 
Seat 1: kwkim73 (button) folded before Flop (didn't bet)
Seat 2: Perstenev (small blind) folded before Flop
Seat 3: DutchShultzs (big blind) folded before Flop
Seat 4: ZhukOFFskI folded before Flop (didn't bet)
Seat 5: Roglus folded before Flop (didn't bet)
Seat 6: chiyuki folded before Flop (didn't bet)
Seat 7: 1Karina1 folded before Flop (didn't bet)
Seat 8: troublesomm folded before Flop (didn't bet)
Seat 9: el pore 5 collected ($0.60)



PokerStars Zoom Hand #84300263587:  Hold'em No Limit ($0.10/$0.25) - 2012/08/05 15:16:31 JST [2012/08/05 2:16:31 ET]
Table 'Whirlpool' 9-max Seat #1 is the button
Seat 1: troublesomm ($25 in chips) 
Seat 2: tribunpdm ($34.07 in chips) 
Seat 3: simonzez ($29.89 in chips) 
Seat 4: phate-1up ($53.82 in chips) 
Seat 5: chiyuki ($34.48 in chips) 
Seat 6: Ellen1947 ($25.25 in chips) 
Seat 7: GravyWalrus ($9.11 in chips) 
Seat 8: seula i ($44.71 in chips) 
Seat 9: deadmoneykid ($31.59 in chips) 
tribunpdm: posts small blind $0.10
simonzez: posts big blind $0.25
*** HOLE CARDS ***
Dealt to chiyuki [3s Js]
phate-1up: raises $0.50 to $0.75
chiyuki: folds 
Ellen1947: folds 
GravyWalrus: folds 
seula i: folds 
deadmoneykid: folds 
troublesomm: folds 
tribunpdm: folds 
simonzez: folds 
Uncalled bet ($0.50) returned to phate-1up
phate-1up collected $0.60 from pot
phate-1up: doesn't show hand 
*** SUMMARY ***
Total pot $0.60 | Rake $0 
Seat 1: troublesomm (button) folded before Flop (didn't bet)
Seat 2: tribunpdm (small blind) folded before Flop
Seat 3: simonzez (big blind) folded before Flop
Seat 4: phate-1up collected ($0.60)
Seat 5: chiyuki folded before Flop (didn't bet)
Seat 6: Ellen1947 folded before Flop (didn't bet)
Seat 7: GravyWalrus folded before Flop (didn't bet)
Seat 8: seula i folded before Flop (didn't bet)
Seat 9: deadmoneykid folded before Flop (didn't bet)



PokerStars Zoom Hand #84300260751:  Hold'em No Limit ($0.10/$0.25) - 2012/08/05 15:16:20 JST [2012/08/05 2:16:20 ET]
Table 'Whirlpool' 9-max Seat #1 is the button
Seat 1: chiyuki ($34.48 in chips) 
Seat 2: Ellen1947 ($25 in chips) 
Seat 3: colorado2108 ($37.06 in chips) 
Seat 4: Roglus ($4.15 in chips) 
Seat 5: Perstenev ($31.20 in chips) 
Seat 6: 1Karina1 ($31.07 in chips) 
Seat 7: nastya040 ($18.37 in chips) 
Seat 8: snejokCoxx ($9.03 in chips) 
Seat 9: deadmoneykid ($34.11 in chips) 
Ellen1947: posts small blind $0.10
colorado2108: posts big blind $0.25
*** HOLE CARDS ***
Dealt to chiyuki [7h Qs]
Roglus: folds 
Perstenev: raises $0.50 to $0.75
1Karina1: folds 
nastya040: folds 
snejokCoxx: folds 
deadmoneykid: folds 
chiyuki: folds 
Ellen1947: folds 
colorado2108: folds 
Uncalled bet ($0.50) returned to Perstenev
Perstenev collected $0.60 from pot
Perstenev: doesn't show hand 
*** SUMMARY ***
Total pot $0.60 | Rake $0 
Seat 1: chiyuki (button) folded before Flop (didn't bet)
Seat 2: Ellen1947 (small blind) folded before Flop
Seat 3: colorado2108 (big blind) folded before Flop
Seat 4: Roglus folded before Flop (didn't bet)
Seat 5: Perstenev collected ($0.60)
Seat 6: 1Karina1 folded before Flop (didn't bet)
Seat 7: nastya040 folded before Flop (didn't bet)
Seat 8: snejokCoxx folded before Flop (didn't bet)
Seat 9: deadmoneykid folded before Flop (didn't bet)



PokerStars Zoom Hand #84300262068:  Hold'em No Limit ($0.10/$0.25) - 2012/08/05 15:16:25 JST [2012/08/05 2:16:25 ET]
Table 'Whirlpool' 9-max Seat #1 is the button
Seat 1: Dejacob ($32.87 in chips) 
Seat 2: svg51 ($11.32 in chips) 
Seat 3: nastya040 ($18.37 in chips) 
Seat 4: mid22 ($18.57 in chips) 
Seat 5: INSP!RON ($25 in chips) 
Seat 6: simonzez ($29.89 in chips) 
Seat 7: Robchie ($10.59 in chips) 
Seat 8: Paranoix1990 ($6.72 in chips) 
Seat 9: chiyuki ($34.48 in chips) 
svg51: posts small blind $0.10
nastya040: posts big blind $0.25
*** HOLE CARDS ***
Dealt to chiyuki [3h 2s]
mid22: calls $0.25
INSP!RON: folds 
simonzez: folds 
Robchie: folds 
Paranoix1990: folds 
chiyuki: folds 
Dejacob: folds 
svg51: folds 
nastya040: checks 
*** FLOP *** [Kc 7s Qd]
nastya040: checks 
mid22: checks 
*** TURN *** [Kc 7s Qd] [Tc]
nastya040: checks 
mid22: checks 
*** RIVER *** [Kc 7s Qd Tc] [8c]
nastya040: checks 
mid22: checks 
*** SHOW DOWN ***
nastya040: shows [4c 7c] (a flush, King high)
mid22: mucks hand 
nastya040 collected $0.57 from pot
*** SUMMARY ***
Total pot $0.60 | Rake $0.03 
Board [Kc 7s Qd Tc 8c]
Seat 1: Dejacob (button) folded before Flop (didn't bet)
Seat 2: svg51 (small blind) folded before Flop
Seat 3: nastya040 (big blind) showed [4c 7c] and won ($0.57) with a flush, King high
Seat 4: mid22 mucked [9c 7d]
Seat 5: INSP!RON folded before Flop (didn't bet)
Seat 6: simonzez folded before Flop (didn't bet)
Seat 7: Robchie folded before Flop (didn't bet)
Seat 8: Paranoix1990 folded before Flop (didn't bet)
Seat 9: chiyuki folded before Flop (didn't bet)



PokerStars Zoom Hand #84300269720:  Hold'em No Limit ($0.10/$0.25) - 2012/08/05 15:16:55 JST [2012/08/05 2:16:55 ET]
Table 'Whirlpool' 9-max Seat #1 is the button
Seat 1: nastya040 ($18.69 in chips) 
Seat 2: kamikkaze ($15 in chips) 
Seat 3: mid22 ($18.32 in chips) 
Seat 4: Rilko1975 ($34.37 in chips) 
Seat 5: KrystalAA ($26.60 in chips) 
Seat 6: snejokCoxx ($13.67 in chips) 
Seat 7: deadmoneykid ($26.87 in chips) 
Seat 8: chiyuki ($34.23 in chips) 
Seat 9: PAMBOS.L ($17.65 in chips) 
kamikkaze: posts small blind $0.10
mid22: posts big blind $0.25
*** HOLE CARDS ***
Dealt to chiyuki [3c 3s]
Rilko1975: folds 
KrystalAA: folds 
snejokCoxx: folds 
deadmoneykid: folds 
chiyuki: folds 
PAMBOS.L: folds 
nastya040: folds 
kamikkaze: folds 
Uncalled bet ($0.15) returned to mid22
mid22 collected $0.20 from pot
mid22: doesn't show hand 
*** SUMMARY ***
Total pot $0.20 | Rake $0 
Seat 1: nastya040 (button) folded before Flop (didn't bet)
Seat 2: kamikkaze (small blind) folded before Flop
Seat 3: mid22 (big blind) collected ($0.20)
Seat 4: Rilko1975 folded before Flop (didn't bet)
Seat 5: KrystalAA folded before Flop (didn't bet)
Seat 6: snejokCoxx folded before Flop (didn't bet)
Seat 7: deadmoneykid folded before Flop (didn't bet)
Seat 8: chiyuki folded before Flop (didn't bet)
Seat 9: PAMBOS.L folded before Flop (didn't bet)



PokerStars Zoom Hand #84300274072:  Hold'em No Limit ($0.10/$0.25) - 2012/08/05 15:17:12 JST [2012/08/05 2:17:12 ET]
Table 'Whirlpool' 9-max Seat #1 is the button
Seat 1: silvno31 ($24.74 in chips) 
Seat 2: chiyuki ($34.23 in chips) 
Seat 3: ygoegoe ($30.32 in chips) 
Seat 4: moku36 ($20.72 in chips) 
Seat 5: Wilcox76607 ($35.14 in chips) 
Seat 6: hirozo ($76.87 in chips) 
Seat 7: KrystalAA ($33.68 in chips) 
Seat 8: DutchShultzs ($25 in chips) 
Seat 9: snejokCoxx ($13.57 in chips) 
chiyuki: posts small blind $0.10
ygoegoe: posts big blind $0.25
*** HOLE CARDS ***
Dealt to chiyuki [6s 4h]
moku36: folds 
Wilcox76607: raises $0.50 to $0.75
hirozo: folds 
KrystalAA: folds 
DutchShultzs: folds 
snejokCoxx: folds 
silvno31: folds 
chiyuki: folds 
ygoegoe: folds 
Uncalled bet ($0.50) returned to Wilcox76607
Wilcox76607 collected $0.60 from pot
Wilcox76607: doesn't show hand 
*** SUMMARY ***
Total pot $0.60 | Rake $0 
Seat 1: silvno31 (button) folded before Flop (didn't bet)
Seat 2: chiyuki (small blind) folded before Flop
Seat 3: ygoegoe (big blind) folded before Flop
Seat 4: moku36 folded before Flop (didn't bet)
Seat 5: Wilcox76607 collected ($0.60)
Seat 6: hirozo folded before Flop (didn't bet)
Seat 7: KrystalAA folded before Flop (didn't bet)
Seat 8: DutchShultzs folded before Flop (didn't bet)
Seat 9: snejokCoxx folded before Flop (didn't bet)



PokerStars Zoom Hand #84300264874:  Hold'em No Limit ($0.10/$0.25) - 2012/08/05 15:16:36 JST [2012/08/05 2:16:36 ET]
Table 'Whirlpool' 9-max Seat #1 is the button
Seat 1: KrystalAA ($33.78 in chips) 
Seat 2: colorado2108 ($36.81 in chips) 
Seat 3: chiyuki ($34.48 in chips) 
Seat 4: WARIBANA7777 ($17.19 in chips) 
Seat 5: DutchShultzs ($33.07 in chips) 
Seat 6: phate-1up ($52.71 in chips) 
Seat 7: seula i ($27.76 in chips) 
Seat 8: hirozo ($80.41 in chips) 
Seat 9: Ellen1947 ($24.90 in chips) 
colorado2108: posts small blind $0.10
chiyuki: posts big blind $0.25
*** HOLE CARDS ***
Dealt to chiyuki [Qc 6h]
WARIBANA7777: folds 
DutchShultzs: folds 
phate-1up: raises $0.50 to $0.75
seula i: folds 
hirozo: calls $0.75
Ellen1947: folds 
KrystalAA: folds 
colorado2108: calls $0.65
chiyuki: folds 
*** FLOP *** [4d 3s 6d]
colorado2108: checks 
phate-1up: checks 
hirozo: bets $1.59
colorado2108: folds 
phate-1up: calls $1.59
*** TURN *** [4d 3s 6d] [Js]
phate-1up: checks 
hirozo: checks 
*** RIVER *** [4d 3s 6d Js] [8s]
phate-1up: checks 
hirozo: checks 
*** SHOW DOWN ***
phate-1up: shows [Ks Ad] (high card Ace)
hirozo: shows [7h 7c] (a pair of Sevens)
hirozo collected $5.42 from pot
*** SUMMARY ***
Total pot $5.68 | Rake $0.26 
Board [4d 3s 6d Js 8s]
Seat 1: KrystalAA (button) folded before Flop (didn't bet)
Seat 2: colorado2108 (small blind) folded on the Flop
Seat 3: chiyuki (big blind) folded before Flop
Seat 4: WARIBANA7777 folded before Flop (didn't bet)
Seat 5: DutchShultzs folded before Flop (didn't bet)
Seat 6: phate-1up showed [Ks Ad] and lost with high card Ace
Seat 7: seula i folded before Flop (didn't bet)
Seat 8: hirozo showed [7h 7c] and won ($5.42) with a pair of Sevens
Seat 9: Ellen1947 folded before Flop (didn't bet)



PokerStars Zoom Hand #84300277722:  Hold'em No Limit ($0.10/$0.25) - 2012/08/05 15:17:27 JST [2012/08/05 2:17:27 ET]
Table 'Whirlpool' 9-max Seat #1 is the button
Seat 1: GovGus ($37.39 in chips) 
Seat 2: Dejacob ($25.45 in chips) 
Seat 3: Perstenev ($13.35 in chips) 
Seat 4: snejokCoxx ($13.57 in chips) 
Seat 5: womble32 ($27.03 in chips) 
Seat 6: chiyuki ($34.13 in chips) 
Seat 7: DutchShultzs ($25 in chips) 
Seat 8: karpexxx ($15.70 in chips) 
Seat 9: yane73 ($35.34 in chips) 
Dejacob: posts small blind $0.10
Perstenev: posts big blind $0.25
*** HOLE CARDS ***
Dealt to chiyuki [6h Kc]
snejokCoxx: folds 
womble32: folds 
chiyuki: folds 
DutchShultzs: folds 
karpexxx: folds 
yane73: folds 
GovGus: folds 
Dejacob: folds 
Uncalled bet ($0.15) returned to Perstenev
Perstenev collected $0.20 from pot
Perstenev: doesn't show hand 
*** SUMMARY ***
Total pot $0.20 | Rake $0 
Seat 1: GovGus (button) folded before Flop (didn't bet)
Seat 2: Dejacob (small blind) folded before Flop
Seat 3: Perstenev (big blind) collected ($0.20)
Seat 4: snejokCoxx folded before Flop (didn't bet)
Seat 5: womble32 folded before Flop (didn't bet)
Seat 6: chiyuki folded before Flop (didn't bet)
Seat 7: DutchShultzs folded before Flop (didn't bet)
Seat 8: karpexxx folded before Flop (didn't bet)
Seat 9: yane73 folded before Flop (didn't bet)



PokerStars Zoom Hand #84300280182:  Hold'em No Limit ($0.10/$0.25) - 2012/08/05 15:17:37 JST [2012/08/05 2:17:37 ET]
Table 'Whirlpool' 9-max Seat #1 is the button
Seat 1: hirozo ($76.77 in chips) 
Seat 2: jacquelinewu ($73.89 in chips) 
Seat 3: Dan Royal ($39.34 in chips) 
Seat 4: laurentzu84 ($33 in chips) 
Seat 5: deadmoneykid ($33.86 in chips) 
Seat 6: ygoegoe ($30.07 in chips) 
Seat 7: Alvinpe85 ($49.85 in chips) 
Seat 8: GovGus ($33.66 in chips) 
Seat 9: chiyuki ($34.13 in chips) 
jacquelinewu: posts small blind $0.10
Dan Royal: posts big blind $0.25
*** HOLE CARDS ***
Dealt to chiyuki [7c 9d]
laurentzu84: folds 
deadmoneykid: raises $0.50 to $0.75
ygoegoe: folds 
Alvinpe85: folds 
GovGus: folds 
chiyuki: folds 
hirozo: folds 
jacquelinewu: folds 
Dan Royal: folds 
Uncalled bet ($0.50) returned to deadmoneykid
deadmoneykid collected $0.60 from pot
deadmoneykid: doesn't show hand 
*** SUMMARY ***
Total pot $0.60 | Rake $0 
Seat 1: hirozo (button) folded before Flop (didn't bet)
Seat 2: jacquelinewu (small blind) folded before Flop
Seat 3: Dan Royal (big blind) folded before Flop
Seat 4: laurentzu84 folded before Flop (didn't bet)
Seat 5: deadmoneykid collected ($0.60)
Seat 6: ygoegoe folded before Flop (didn't bet)
Seat 7: Alvinpe85 folded before Flop (didn't bet)
Seat 8: GovGus folded before Flop (didn't bet)
Seat 9: chiyuki folded before Flop (didn't bet)



PokerStars Zoom Hand #84300278463:  Hold'em No Limit ($0.10/$0.25) - 2012/08/05 15:17:30 JST [2012/08/05 2:17:30 ET]
Table 'Whirlpool' 9-max Seat #1 is the button
Seat 1: Sal y Limon1 ($24.75 in chips) 
Seat 2: Gichboy ($32.09 in chips) 
Seat 3: DutchShultzs ($25 in chips) 
Seat 4: chiyuki ($34.13 in chips) 
Seat 5: Nerkit ($10.65 in chips) 
Seat 6: KrystalAA ($33.68 in chips) 
Seat 7: Jene4kaBest ($11.90 in chips) 
Seat 8: silvno31 ($24.49 in chips) 
Seat 9: INSP!RON ($29.23 in chips) 
Gichboy: posts small blind $0.10
DutchShultzs: posts big blind $0.25
*** HOLE CARDS ***
Dealt to chiyuki [8c Tc]
chiyuki: folds 
Nerkit: folds 
KrystalAA: folds 
Jene4kaBest: folds 
silvno31: raises $0.50 to $0.75
INSP!RON: folds 
Sal y Limon1: folds 
Gichboy: calls $0.65
DutchShultzs: folds 
*** FLOP *** [Th 3s 7s]
Gichboy: checks 
silvno31: bets $1.25
Gichboy: folds 
Uncalled bet ($1.25) returned to silvno31
silvno31 collected $1.67 from pot
silvno31: doesn't show hand 
*** SUMMARY ***
Total pot $1.75 | Rake $0.08 
Board [Th 3s 7s]
Seat 1: Sal y Limon1 (button) folded before Flop (didn't bet)
Seat 2: Gichboy (small blind) folded on the Flop
Seat 3: DutchShultzs (big blind) folded before Flop
Seat 4: chiyuki folded before Flop (didn't bet)
Seat 5: Nerkit folded before Flop (didn't bet)
Seat 6: KrystalAA folded before Flop (didn't bet)
Seat 7: Jene4kaBest folded before Flop (didn't bet)
Seat 8: silvno31 collected ($1.67)
Seat 9: INSP!RON folded before Flop (didn't bet)



PokerStars Zoom Hand #84300276393:  Hold'em No Limit ($0.10/$0.25) - 2012/08/05 15:17:22 JST [2012/08/05 2:17:22 ET]
Table 'Whirlpool' 9-max Seat #1 is the button
Seat 1: Nerkit ($10.65 in chips) 
Seat 2: mjmichi ($34.42 in chips) 
Seat 3: silvno31 ($24.74 in chips) 
Seat 4: seula i ($44.81 in chips) 
Seat 5: Yoshimac ($30.55 in chips) 
Seat 6: kaplya2010 ($14.54 in chips) 
Seat 7: chiyuki ($34.13 in chips) 
Seat 8: deadmoneykid ($31.34 in chips) 
Seat 9: troublesomm ($38.86 in chips) 
mjmichi: posts small blind $0.10
silvno31: posts big blind $0.25
*** HOLE CARDS ***
Dealt to chiyuki [8h 2h]
seula i: raises $0.75 to $1
Yoshimac: folds 
kaplya2010: calls $1
chiyuki: folds 
deadmoneykid: folds 
troublesomm: folds 
Nerkit: folds 
mjmichi: calls $0.90
silvno31: folds 
*** FLOP *** [6c 4h Td]
mjmichi: checks 
seula i: checks 
kaplya2010: checks 
*** TURN *** [6c 4h Td] [5c]
mjmichi: bets $2
seula i: folds 
kaplya2010: folds 
Uncalled bet ($2) returned to mjmichi
mjmichi collected $3.10 from pot
mjmichi: doesn't show hand 
*** SUMMARY ***
Total pot $3.25 | Rake $0.15 
Board [6c 4h Td 5c]
Seat 1: Nerkit (button) folded before Flop (didn't bet)
Seat 2: mjmichi (small blind) collected ($3.10)
Seat 3: silvno31 (big blind) folded before Flop
Seat 4: seula i folded on the Turn
Seat 5: Yoshimac folded before Flop (didn't bet)
Seat 6: kaplya2010 folded on the Turn
Seat 7: chiyuki folded before Flop (didn't bet)
Seat 8: deadmoneykid folded before Flop (didn't bet)
Seat 9: troublesomm folded before Flop (didn't bet)



PokerStars Zoom Hand #84300288741:  Hold'em No Limit ($0.10/$0.25) - 2012/08/05 15:18:11 JST [2012/08/05 2:18:11 ET]
Table 'Whirlpool' 9-max Seat #1 is the button
Seat 1: PetitAlejo ($26.59 in chips) 
Seat 2: pandaaaaaa ($9.42 in chips) 
Seat 3: chiyuki ($34.13 in chips) 
Seat 4: INSP!RON ($26.49 in chips) 
Seat 5: kaplya2010 ($13.54 in chips) 
Seat 6: phate-1up ($28.57 in chips) 
Seat 7: silvno31 ($25.41 in chips) 
Seat 8: Silveystryk ($21.41 in chips) 
Seat 9: el pore 5 ($10.97 in chips) 
pandaaaaaa: posts small blind $0.10
chiyuki: posts big blind $0.25
*** HOLE CARDS ***
Dealt to chiyuki [3h 8s]
INSP!RON: folds 
kaplya2010: folds 
phate-1up: folds 
silvno31: folds 
Silveystryk: folds 
el pore 5: folds 
PetitAlejo: folds 
pandaaaaaa: calls $0.15
chiyuki: checks 
*** FLOP *** [5s Th Ah]
pandaaaaaa: checks 
chiyuki: checks 
*** TURN *** [5s Th Ah] [3c]
pandaaaaaa: checks 
chiyuki: checks 
*** RIVER *** [5s Th Ah 3c] [2d]
pandaaaaaa: checks 
chiyuki: checks 
*** SHOW DOWN ***
pandaaaaaa: shows [Jh Kd] (high card Ace)
chiyuki: shows [3h 8s] (a pair of Threes)
chiyuki collected $0.48 from pot
*** SUMMARY ***
Total pot $0.50 | Rake $0.02 
Board [5s Th Ah 3c 2d]
Seat 1: PetitAlejo (button) folded before Flop (didn't bet)
Seat 2: pandaaaaaa (small blind) showed [Jh Kd] and lost with high card Ace
Seat 3: chiyuki (big blind) showed [3h 8s] and won ($0.48) with a pair of Threes
Seat 4: INSP!RON folded before Flop (didn't bet)
Seat 5: kaplya2010 folded before Flop (didn't bet)
Seat 6: phate-1up folded before Flop (didn't bet)
Seat 7: silvno31 folded before Flop (didn't bet)
Seat 8: Silveystryk folded before Flop (didn't bet)
Seat 9: el pore 5 folded before Flop (didn't bet)



PokerStars Zoom Hand #84300296421:  Hold'em No Limit ($0.10/$0.25) - 2012/08/05 15:18:42 JST [2012/08/05 2:18:42 ET]
Table 'Whirlpool' 9-max Seat #1 is the button
Seat 1: Perstenev ($8.87 in chips) 
Seat 2: chiyuki ($34.36 in chips) 
Seat 3: DutchShultzs ($25 in chips) 
Seat 4: Ellen1947 ($23.80 in chips) 
Seat 5: phate-1up ($28.47 in chips) 
Seat 6: Dejacob ($27.96 in chips) 
Seat 7: PetitAlejo ($25 in chips) 
Seat 8: troublesomm ($35.35 in chips) 
Seat 9: dushvan ($54.93 in chips) 
chiyuki: posts small blind $0.10
DutchShultzs: posts big blind $0.25
*** HOLE CARDS ***
Dealt to chiyuki [3d 2c]
Ellen1947: folds 
phate-1up: folds 
Dejacob: folds 
PetitAlejo: folds 
troublesomm: folds 
dushvan: raises $0.50 to $0.75
Perstenev: folds 
chiyuki: folds 
DutchShultzs: folds 
Uncalled bet ($0.50) returned to dushvan
dushvan collected $0.60 from pot
dushvan: doesn't show hand 
*** SUMMARY ***
Total pot $0.60 | Rake $0 
Seat 1: Perstenev (button) folded before Flop (didn't bet)
Seat 2: chiyuki (small blind) folded before Flop
Seat 3: DutchShultzs (big blind) folded before Flop
Seat 4: Ellen1947 folded before Flop (didn't bet)
Seat 5: phate-1up folded before Flop (didn't bet)
Seat 6: Dejacob folded before Flop (didn't bet)
Seat 7: PetitAlejo folded before Flop (didn't bet)
Seat 8: troublesomm folded before Flop (didn't bet)
Seat 9: dushvan collected ($0.60)



PokerStars Zoom Hand #84300287270:  Hold'em No Limit ($0.10/$0.25) - 2012/08/05 15:18:05 JST [2012/08/05 2:18:05 ET]
Table 'Whirlpool' 9-max Seat #1 is the button
Seat 1: Perstenev ($13.45 in chips) 
Seat 2: Rici47 ($24.50 in chips) 
Seat 3: DutchShultzs ($32.72 in chips) 
Seat 4: chiyuki ($34.13 in chips) 
Seat 5: Dejacob ($31.77 in chips) 
Seat 6: WARIBANA7777 ($17.09 in chips) 
Seat 7: Tom1999 ($11.52 in chips) 
Seat 8: GovGus ($37.74 in chips) 
Seat 9: Saruotiss ($46.16 in chips) 
Rici47: posts small blind $0.10
DutchShultzs: posts big blind $0.25
*** HOLE CARDS ***
Dealt to chiyuki [6c 6s]
chiyuki: folds 
Dejacob: raises $0.50 to $0.75
WARIBANA7777: folds 
Tom1999: calls $0.75
GovGus: folds 
Saruotiss: folds 
Perstenev: folds 
Rici47: folds 
DutchShultzs: folds 
*** FLOP *** [7s 3s Js]
Dejacob: bets $1.25
Tom1999: calls $1.25
*** TURN *** [7s 3s Js] [Kh]
Dejacob: bets $3.25
Tom1999: calls $3.25
*** RIVER *** [7s 3s Js Kh] [Kd]
Dejacob: bets $9.75
Tom1999: folds 
Uncalled bet ($9.75) returned to Dejacob
Dejacob collected $10.36 from pot
Dejacob: doesn't show hand 
*** SUMMARY ***
Total pot $10.85 | Rake $0.49 
Board [7s 3s Js Kh Kd]
Seat 1: Perstenev (button) folded before Flop (didn't bet)
Seat 2: Rici47 (small blind) folded before Flop
Seat 3: DutchShultzs (big blind) folded before Flop
Seat 4: chiyuki folded before Flop (didn't bet)
Seat 5: Dejacob collected ($10.36)
Seat 6: WARIBANA7777 folded before Flop (didn't bet)
Seat 7: Tom1999 folded on the River
Seat 8: GovGus folded before Flop (didn't bet)
Seat 9: Saruotiss folded before Flop (didn't bet)



PokerStars Zoom Hand #84300279470:  Hold'em No Limit ($0.10/$0.25) - 2012/08/05 15:17:34 JST [2012/08/05 2:17:34 ET]
Table 'Whirlpool' 9-max Seat #1 is the button
Seat 1: chiyuki ($34.13 in chips) 
Seat 2: Saruotiss ($46.26 in chips) 
Seat 3: womble32 ($27.03 in chips) 
Seat 4: mjmichi ($47.37 in chips) 
Seat 5: snejokCoxx ($13.57 in chips) 
Seat 6: pandaaaaaa ($9.67 in chips) 
Seat 7: Silveystryk ($26.63 in chips) 
Seat 8: seula i ($27.41 in chips) 
Seat 9: turbotom122 ($26.87 in chips) 
Saruotiss: posts small blind $0.10
womble32: posts big blind $0.25
*** HOLE CARDS ***
Dealt to chiyuki [Kc 5c]
mjmichi: raises $0.50 to $0.75
snejokCoxx: folds 
pandaaaaaa: folds 
Silveystryk: folds 
seula i: folds 
turbotom122: folds 
chiyuki: folds 
Saruotiss: folds 
womble32: calls $0.50
*** FLOP *** [Ah Kd Js]
womble32: checks 
mjmichi: checks 
*** TURN *** [Ah Kd Js] [2c]
womble32: bets $1
mjmichi: calls $1
*** RIVER *** [Ah Kd Js 2c] [Jd]
womble32: bets $1.75
mjmichi: folds 
Uncalled bet ($1.75) returned to womble32
womble32 collected $3.44 from pot
womble32: doesn't show hand 
*** SUMMARY ***
Total pot $3.60 | Rake $0.16 
Board [Ah Kd Js 2c Jd]
Seat 1: chiyuki (button) folded before Flop (didn't bet)
Seat 2: Saruotiss (small blind) folded before Flop
Seat 3: womble32 (big blind) collected ($3.44)
Seat 4: mjmichi folded on the River
Seat 5: snejokCoxx folded before Flop (didn't bet)
Seat 6: pandaaaaaa folded before Flop (didn't bet)
Seat 7: Silveystryk folded before Flop (didn't bet)
Seat 8: seula i folded before Flop (didn't bet)
Seat 9: turbotom122 folded before Flop (didn't bet)



PokerStars Zoom Hand #84300281442:  Hold'em No Limit ($0.10/$0.25) - 2012/08/05 15:17:42 JST [2012/08/05 2:17:42 ET]
Table 'Whirlpool' 9-max Seat #1 is the button
Seat 1: el pore 5 ($11.07 in chips) 
Seat 2: KeLevro0 ($12.25 in chips) 
Seat 3: laurentzu84 ($33 in chips) 
Seat 4: Silveystryk ($26.63 in chips) 
Seat 5: seula i ($95.75 in chips) 
Seat 6: Sal y Limon1 ($26.95 in chips) 
Seat 7: moku36 ($20.72 in chips) 
Seat 8: chiyuki ($34.13 in chips) 
Seat 9: Dejacob ($42.09 in chips) 
KeLevro0: posts small blind $0.10
laurentzu84: posts big blind $0.25
*** HOLE CARDS ***
Dealt to chiyuki [Th Ah]
Silveystryk: folds 
seula i: folds 
Sal y Limon1: folds 
moku36: raises $0.50 to $0.75
chiyuki: folds 
Dejacob: folds 
el pore 5: folds 
KeLevro0: calls $0.65
laurentzu84: calls $0.50
*** FLOP *** [4d 6c 2s]
KeLevro0: checks 
laurentzu84: checks 
moku36: bets $1.25
KeLevro0: calls $1.25
laurentzu84: calls $1.25
*** TURN *** [4d 6c 2s] [2h]
KeLevro0: checks 
laurentzu84: checks 
moku36: checks 
*** RIVER *** [4d 6c 2s 2h] [Kc]
KeLevro0: bets $2.75
laurentzu84: folds 
moku36: folds 
Uncalled bet ($2.75) returned to KeLevro0
KeLevro0 collected $5.73 from pot
KeLevro0: doesn't show hand 
*** SUMMARY ***
Total pot $6 | Rake $0.27 
Board [4d 6c 2s 2h Kc]
Seat 1: el pore 5 (button) folded before Flop (didn't bet)
Seat 2: KeLevro0 (small blind) collected ($5.73)
Seat 3: laurentzu84 (big blind) folded on the River
Seat 4: Silveystryk folded before Flop (didn't bet)
Seat 5: seula i folded before Flop (didn't bet)
Seat 6: Sal y Limon1 folded before Flop (didn't bet)
Seat 7: moku36 folded on the River
Seat 8: chiyuki folded before Flop (didn't bet)
Seat 9: Dejacob folded before Flop (didn't bet)



PokerStars Zoom Hand #84300297886:  Hold'em No Limit ($0.10/$0.25) - 2012/08/05 15:18:48 JST [2012/08/05 2:18:48 ET]
Table 'Whirlpool' 9-max Seat #1 is the button
Seat 1: chiyuki ($34.26 in chips) 
Seat 2: troublesomm ($35.35 in chips) 
Seat 3: phate-1up ($28.47 in chips) 
Seat 4: Roglus ($2.85 in chips) 
Seat 5: PetitAlejo ($27 in chips) 
Seat 6: Perstenev ($8.87 in chips) 
Seat 7: deadmoneykid ($31.81 in chips) 
Seat 8: Lasutchik ($74.11 in chips) 
Seat 9: 1Karina1 ($38.59 in chips) 
troublesomm: posts small blind $0.10
phate-1up: posts big blind $0.25
*** HOLE CARDS ***
Dealt to chiyuki [Jh 5s]
Roglus: raises $0.37 to $0.62
PetitAlejo: folds 
Perstenev: folds 
deadmoneykid: folds 
Lasutchik: folds 
1Karina1: folds 
chiyuki: folds 
troublesomm: folds 
phate-1up: folds 
Uncalled bet ($0.37) returned to Roglus
Roglus collected $0.60 from pot
Roglus: doesn't show hand 
*** SUMMARY ***
Total pot $0.60 | Rake $0 
Seat 1: chiyuki (button) folded before Flop (didn't bet)
Seat 2: troublesomm (small blind) folded before Flop
Seat 3: phate-1up (big blind) folded before Flop
Seat 4: Roglus collected ($0.60)
Seat 5: PetitAlejo folded before Flop (didn't bet)
Seat 6: Perstenev folded before Flop (didn't bet)
Seat 7: deadmoneykid folded before Flop (didn't bet)
Seat 8: Lasutchik folded before Flop (didn't bet)
Seat 9: 1Karina1 folded before Flop (didn't bet)



PokerStars Zoom Hand #84300300883:  Hold'em No Limit ($0.10/$0.25) - 2012/08/05 15:19:00 JST [2012/08/05 2:19:00 ET]
Table 'Whirlpool' 9-max Seat #1 is the button
Seat 1: dergeb ($18.32 in chips) 
Seat 2: WARIBANA7777 ($16.84 in chips) 
Seat 3: masterkoolb ($12.50 in chips) 
Seat 4: pandaaaaaa ($9.17 in chips) 
Seat 5: Nerkit ($11.30 in chips) 
Seat 6: Rici47 ($22.90 in chips) 
Seat 7: chiyuki ($34.26 in chips) 
Seat 8: mjmichi ($45.62 in chips) 
Seat 9: DutchShultzs ($25 in chips) 
WARIBANA7777: posts small blind $0.10
masterkoolb: posts big blind $0.25
*** HOLE CARDS ***
Dealt to chiyuki [5c 6h]
pandaaaaaa: folds 
Nerkit: folds 
Rici47: folds 
chiyuki: folds 
mjmichi: folds 
DutchShultzs: folds 
dergeb: folds 
WARIBANA7777: folds 
Uncalled bet ($0.15) returned to masterkoolb
masterkoolb collected $0.20 from pot
masterkoolb: doesn't show hand 
*** SUMMARY ***
Total pot $0.20 | Rake $0 
Seat 1: dergeb (button) folded before Flop (didn't bet)
Seat 2: WARIBANA7777 (small blind) folded before Flop
Seat 3: masterkoolb (big blind) collected ($0.20)
Seat 4: pandaaaaaa folded before Flop (didn't bet)
Seat 5: Nerkit folded before Flop (didn't bet)
Seat 6: Rici47 folded before Flop (didn't bet)
Seat 7: chiyuki folded before Flop (didn't bet)
Seat 8: mjmichi folded before Flop (didn't bet)
Seat 9: DutchShultzs folded before Flop (didn't bet)



PokerStars Zoom Hand #84300303193:  Hold'em No Limit ($0.10/$0.25) - 2012/08/05 15:19:09 JST [2012/08/05 2:19:09 ET]
Table 'Whirlpool' 9-max Seat #1 is the button
Seat 1: ZhukOFFskI ($72.48 in chips) 
Seat 2: INSP!RON ($26.59 in chips) 
Seat 3: panaam ($22.70 in chips) 
Seat 4: WARIBANA7777 ($16.74 in chips) 
Seat 5: Sal y Limon1 ($25.85 in chips) 
Seat 6: chiyuki ($34.26 in chips) 
Seat 7: troublesomm ($35.25 in chips) 
Seat 8: Roglus ($3.20 in chips) 
Seat 9: DutchShultzs ($32.37 in chips) 
INSP!RON: posts small blind $0.10
panaam: posts big blind $0.25
*** HOLE CARDS ***
Dealt to chiyuki [4c 3c]
WARIBANA7777: folds 
Sal y Limon1: raises $0.50 to $0.75
chiyuki: folds 
troublesomm: folds 
Roglus: folds 
DutchShultzs: folds 
ZhukOFFskI: folds 
INSP!RON: folds 
panaam: calls $0.50
*** FLOP *** [6s 3s 2d]
panaam: checks 
Sal y Limon1: bets $1
panaam: folds 
Uncalled bet ($1) returned to Sal y Limon1
Sal y Limon1 collected $1.53 from pot
Sal y Limon1: doesn't show hand 
*** SUMMARY ***
Total pot $1.60 | Rake $0.07 
Board [6s 3s 2d]
Seat 1: ZhukOFFskI (button) folded before Flop (didn't bet)
Seat 2: INSP!RON (small blind) folded before Flop
Seat 3: panaam (big blind) folded on the Flop
Seat 4: WARIBANA7777 folded before Flop (didn't bet)
Seat 5: Sal y Limon1 collected ($1.53)
Seat 6: chiyuki folded before Flop (didn't bet)
Seat 7: troublesomm folded before Flop (didn't bet)
Seat 8: Roglus folded before Flop (didn't bet)
Seat 9: DutchShultzs folded before Flop (didn't bet)



PokerStars Zoom Hand #84300306844:  Hold'em No Limit ($0.10/$0.25) - 2012/08/05 15:19:23 JST [2012/08/05 2:19:23 ET]
Table 'Whirlpool' 9-max Seat #1 is the button
Seat 1: risekuku468 ($35.96 in chips) 
Seat 2: Silveystryk ($27.18 in chips) 
Seat 3: chiyuki ($34.26 in chips) 
Seat 4: GovGus ($35.43 in chips) 
Seat 5: Ellen1947 ($22.40 in chips) 
Seat 6: rey2040 ($8.65 in chips) 
Seat 7: deadmoneykid ($26.78 in chips) 
Seat 8: Roglus ($3.10 in chips) 
Seat 9: kwkim73 ($28.83 in chips) 
Silveystryk: posts small blind $0.10
chiyuki: posts big blind $0.25
*** HOLE CARDS ***
Dealt to chiyuki [Ks 3d]
GovGus: folds 
Ellen1947: folds 
rey2040: folds 
deadmoneykid: folds 
Roglus: folds 
kwkim73: folds 
risekuku468: raises $0.50 to $0.75
Silveystryk: folds 
chiyuki: folds 
Uncalled bet ($0.50) returned to risekuku468
risekuku468 collected $0.60 from pot
risekuku468: doesn't show hand 
*** SUMMARY ***
Total pot $0.60 | Rake $0 
Seat 1: risekuku468 (button) collected ($0.60)
Seat 2: Silveystryk (small blind) folded before Flop
Seat 3: chiyuki (big blind) folded before Flop
Seat 4: GovGus folded before Flop (didn't bet)
Seat 5: Ellen1947 folded before Flop (didn't bet)
Seat 6: rey2040 folded before Flop (didn't bet)
Seat 7: deadmoneykid folded before Flop (didn't bet)
Seat 8: Roglus folded before Flop (didn't bet)
Seat 9: kwkim73 folded before Flop (didn't bet)



PokerStars Zoom Hand #84300300148:  Hold'em No Limit ($0.10/$0.25) - 2012/08/05 15:18:57 JST [2012/08/05 2:18:57 ET]
Table 'Whirlpool' 9-max Seat #1 is the button
Seat 1: troublesomm ($35.25 in chips) 
Seat 2: Perstenev ($13.10 in chips) 
Seat 3: kaplya2010 ($13.44 in chips) 
Seat 4: ChrisCDee ($44.78 in chips) 
Seat 5: jacquelinewu ($36.45 in chips) 
Seat 6: panaam ($22.70 in chips) 
Seat 7: Alvinpe85 ($48.72 in chips) 
Seat 8: Dan Royal ($36.74 in chips) 
Seat 9: chiyuki ($34.26 in chips) 
Perstenev: posts small blind $0.10
kaplya2010: posts big blind $0.25
*** HOLE CARDS ***
Dealt to chiyuki [Qd 3s]
ChrisCDee: folds 
jacquelinewu: folds 
panaam: folds 
Alvinpe85: folds 
Dan Royal: raises $0.25 to $0.50
chiyuki: folds 
troublesomm: folds 
Perstenev: folds 
kaplya2010: raises $1 to $1.50
Dan Royal: raises $3.50 to $5
kaplya2010: calls $3.50
*** FLOP *** [2c 6s Ac]
kaplya2010: checks 
Dan Royal: checks 
*** TURN *** [2c 6s Ac] [7h]
kaplya2010: bets $7.23
Dan Royal: raises $7.23 to $14.46
kaplya2010: calls $1.21 and is all-in
Uncalled bet ($6.02) returned to Dan Royal
*** RIVER *** [2c 6s Ac 7h] [8d]
*** SHOW DOWN ***
kaplya2010: shows [Kh As] (a pair of Aces)
Dan Royal: shows [Ks Kc] (a pair of Kings)
kaplya2010 collected $25.77 from pot
*** SUMMARY ***
Total pot $26.98 | Rake $1.21 
Board [2c 6s Ac 7h 8d]
Seat 1: troublesomm (button) folded before Flop (didn't bet)
Seat 2: Perstenev (small blind) folded before Flop
Seat 3: kaplya2010 (big blind) showed [Kh As] and won ($25.77) with a pair of Aces
Seat 4: ChrisCDee folded before Flop (didn't bet)
Seat 5: jacquelinewu folded before Flop (didn't bet)
Seat 6: panaam folded before Flop (didn't bet)
Seat 7: Alvinpe85 folded before Flop (didn't bet)
Seat 8: Dan Royal showed [Ks Kc] and lost with a pair of Kings
Seat 9: chiyuki folded before Flop (didn't bet)



PokerStars Zoom Hand #84300304566:  Hold'em No Limit ($0.10/$0.25) - 2012/08/05 15:19:14 JST [2012/08/05 2:19:14 ET]
Table 'Whirlpool' 9-max Seat #1 is the button
Seat 1: dushvan ($55.18 in chips) 
Seat 2: KeLevro0 ($12.50 in chips) 
Seat 3: troublesomm ($37.01 in chips) 
Seat 4: Yoshimac ($29.70 in chips) 
Seat 5: chiyuki ($34.26 in chips) 
Seat 6: PetitAlejo ($26.75 in chips) 
Seat 7: 1Karina1 ($25 in chips) 
Seat 8: Rilko1975 ($34.95 in chips) 
Seat 9: ygoegoe ($44.20 in chips) 
KeLevro0: posts small blind $0.10
troublesomm: posts big blind $0.25
*** HOLE CARDS ***
Dealt to chiyuki [4h 2s]
Yoshimac: folds 
chiyuki: folds 
PetitAlejo: folds 
1Karina1: folds 
Rilko1975: folds 
ygoegoe: folds 
dushvan: raises $0.50 to $0.75
KeLevro0: folds 
troublesomm: folds 
Uncalled bet ($0.50) returned to dushvan
dushvan collected $0.60 from pot
dushvan: doesn't show hand 
*** SUMMARY ***
Total pot $0.60 | Rake $0 
Seat 1: dushvan (button) collected ($0.60)
Seat 2: KeLevro0 (small blind) folded before Flop
Seat 3: troublesomm (big blind) folded before Flop
Seat 4: Yoshimac folded before Flop (didn't bet)
Seat 5: chiyuki folded before Flop (didn't bet)
Seat 6: PetitAlejo folded before Flop (didn't bet)
Seat 7: 1Karina1 folded before Flop (didn't bet)
Seat 8: Rilko1975 folded before Flop (didn't bet)
Seat 9: ygoegoe folded before Flop (didn't bet)



PokerStars Zoom Hand #84300311237:  Hold'em No Limit ($0.10/$0.25) - 2012/08/05 15:19:40 JST [2012/08/05 2:19:40 ET]
Table 'Whirlpool' 9-max Seat #1 is the button
Seat 1: ZhukOFFskI ($30.17 in chips) 
Seat 2: Nerkit ($11.78 in chips) 
Seat 3: Silveystryk ($26.60 in chips) 
Seat 4: Ellen1947 ($22.40 in chips) 
Seat 5: chiyuki ($34.01 in chips) 
Seat 6: KrystalAA ($30.83 in chips) 
Seat 7: Rilko1975 ($34.95 in chips) 
Seat 8: risekuku468 ($36.31 in chips) 
Seat 9: masterkoolb ($12.50 in chips) 
Nerkit: posts small blind $0.10
Silveystryk: posts big blind $0.25
*** HOLE CARDS ***
Dealt to chiyuki [Jh 4s]
Ellen1947: folds 
chiyuki: folds 
KrystalAA: folds 
Rilko1975: raises $0.50 to $0.75
risekuku468: folds 
masterkoolb: folds 
ZhukOFFskI: folds 
Nerkit: folds 
Silveystryk: folds 
Uncalled bet ($0.50) returned to Rilko1975
Rilko1975 collected $0.60 from pot
Rilko1975: doesn't show hand 
*** SUMMARY ***
Total pot $0.60 | Rake $0 
Seat 1: ZhukOFFskI (button) folded before Flop (didn't bet)
Seat 2: Nerkit (small blind) folded before Flop
Seat 3: Silveystryk (big blind) folded before Flop
Seat 4: Ellen1947 folded before Flop (didn't bet)
Seat 5: chiyuki folded before Flop (didn't bet)
Seat 6: KrystalAA folded before Flop (didn't bet)
Seat 7: Rilko1975 collected ($0.60)
Seat 8: risekuku468 folded before Flop (didn't bet)
Seat 9: masterkoolb folded before Flop (didn't bet)



PokerStars Zoom Hand #84300313075:  Hold'em No Limit ($0.10/$0.25) - 2012/08/05 15:19:48 JST [2012/08/05 2:19:48 ET]
Table 'Whirlpool' 9-max Seat #1 is the button
Seat 1: 1Karina1 ($26.72 in chips) 
Seat 2: tribunpdm ($28.34 in chips) 
Seat 3: colorado2108 ($45.65 in chips) 
Seat 4: chiyuki ($34.01 in chips) 
Seat 5: Dan Royal ($23.30 in chips) 
Seat 6: hirozo ($44.87 in chips) 
Seat 7: KeLevro0 ($12.40 in chips) 
Seat 8: kwkim73 ($32.23 in chips) 
Seat 9: Alvinpe85 ($49.49 in chips) 
tribunpdm: posts small blind $0.10
colorado2108: posts big blind $0.25
*** HOLE CARDS ***
Dealt to chiyuki [6c 6h]
chiyuki: folds 
Dan Royal: folds 
hirozo: folds 
KeLevro0: folds 
kwkim73: raises $0.50 to $0.75
Alvinpe85: folds 
1Karina1: folds 
tribunpdm: calls $0.65
colorado2108: calls $0.50
*** FLOP *** [As 7s 3h]
tribunpdm: checks 
colorado2108: bets $0.75
kwkim73: folds 
tribunpdm: folds 
Uncalled bet ($0.75) returned to colorado2108
colorado2108 collected $2.15 from pot
colorado2108: doesn't show hand 
colorado2108 is disconnected 
*** SUMMARY ***
Total pot $2.25 | Rake $0.10 
Board [As 7s 3h]
Seat 1: 1Karina1 (button) folded before Flop (didn't bet)
Seat 2: tribunpdm (small blind) folded on the Flop
Seat 3: colorado2108 (big blind) collected ($2.15)
Seat 4: chiyuki folded before Flop (didn't bet)
Seat 5: Dan Royal folded before Flop (didn't bet)
Seat 6: hirozo folded before Flop (didn't bet)
Seat 7: KeLevro0 folded before Flop (didn't bet)
Seat 8: kwkim73 folded on the Flop
Seat 9: Alvinpe85 folded before Flop (didn't bet)



PokerStars Zoom Hand #84300314311:  Hold'em No Limit ($0.10/$0.25) - 2012/08/05 15:19:53 JST [2012/08/05 2:19:53 ET]
Table 'Whirlpool' 9-max Seat #1 is the button
Seat 1: 1Karina1 ($25 in chips) 
Seat 2: chiyuki ($34.01 in chips) 
Seat 3: KeLevro0 ($9.19 in chips) 
Seat 4: Silveystryk ($26.35 in chips) 
Seat 5: DutchShultzs ($25 in chips) 
Seat 6: Rici47 ($41.53 in chips) 
Seat 7: dushvan ($55.53 in chips) 
Seat 8: phate-1up ($54.46 in chips) 
Seat 9: mjmichi ($45.37 in chips) 
chiyuki: posts small blind $0.10
KeLevro0: posts big blind $0.25
*** HOLE CARDS ***
Dealt to chiyuki [Ks Qs]
Silveystryk: folds 
DutchShultzs: folds 
Rici47: folds 
dushvan: folds 
phate-1up: folds 
mjmichi: folds 
1Karina1: folds 
chiyuki: raises $0.50 to $0.75
KeLevro0: folds 
Uncalled bet ($0.50) returned to chiyuki
chiyuki collected $0.50 from pot
chiyuki: doesn't show hand 
*** SUMMARY ***
Total pot $0.50 | Rake $0 
Seat 1: 1Karina1 (button) folded before Flop (didn't bet)
Seat 2: chiyuki (small blind) collected ($0.50)
Seat 3: KeLevro0 (big blind) folded before Flop
Seat 4: Silveystryk folded before Flop (didn't bet)
Seat 5: DutchShultzs folded before Flop (didn't bet)
Seat 6: Rici47 folded before Flop (didn't bet)
Seat 7: dushvan folded before Flop (didn't bet)
Seat 8: phate-1up folded before Flop (didn't bet)
Seat 9: mjmichi folded before Flop (didn't bet)



PokerStars Zoom Hand #84300321339:  Hold'em No Limit ($0.10/$0.25) - 2012/08/05 15:20:21 JST [2012/08/05 2:20:21 ET]
Table 'Whirlpool' 9-max Seat #1 is the button
Seat 1: snejokCoxx ($14.51 in chips) 
Seat 2: hirozo ($83.14 in chips) 
Seat 3: xxx Spb xxx ($25.35 in chips) 
Seat 4: Silveystryk ($27.08 in chips) 
Seat 5: therati ($22.52 in chips) 
Seat 6: PetitAlejo ($25 in chips) 
Seat 7: GravyWalrus ($8.02 in chips) 
Seat 8: chiyuki ($34.26 in chips) 
Seat 9: troublesomm ($34.90 in chips) 
hirozo: posts small blind $0.10
xxx Spb xxx: posts big blind $0.25
*** HOLE CARDS ***
Dealt to chiyuki [Qd Jc]
Silveystryk: folds 
therati: folds 
PetitAlejo: folds 
GravyWalrus: folds 
chiyuki: raises $0.50 to $0.75
troublesomm: folds 
snejokCoxx: folds 
hirozo: folds 
xxx Spb xxx: folds 
Uncalled bet ($0.50) returned to chiyuki
chiyuki collected $0.60 from pot
chiyuki: doesn't show hand 
*** SUMMARY ***
Total pot $0.60 | Rake $0 
Seat 1: snejokCoxx (button) folded before Flop (didn't bet)
Seat 2: hirozo (small blind) folded before Flop
Seat 3: xxx Spb xxx (big blind) folded before Flop
Seat 4: Silveystryk folded before Flop (didn't bet)
Seat 5: therati folded before Flop (didn't bet)
Seat 6: PetitAlejo folded before Flop (didn't bet)
Seat 7: GravyWalrus folded before Flop (didn't bet)
Seat 8: chiyuki collected ($0.60)
Seat 9: troublesomm folded before Flop (didn't bet)



PokerStars Zoom Hand #84300333347:  Hold'em No Limit ($0.10/$0.25) - 2012/08/05 15:21:09 JST [2012/08/05 2:21:09 ET]
Table 'Whirlpool' 9-max Seat #1 is the button
Seat 1: chiyuki ($34.61 in chips) 
Seat 2: masterkoolb ($17.64 in chips) 
Seat 3: phate-1up ($54.46 in chips) 
Seat 4: DutchShultzs ($31.48 in chips) 
Seat 5: pandaaaaaa ($8.47 in chips) 
Seat 6: mjmichi ($42.37 in chips) 
Seat 7: tribunpdm ($23.84 in chips) 
Seat 8: silvno31 ($47.97 in chips) 
Seat 9: ChrisCDee ($25 in chips) 
masterkoolb: posts small blind $0.10
phate-1up: posts big blind $0.25
*** HOLE CARDS ***
Dealt to chiyuki [5h Jc]
DutchShultzs: folds 
pandaaaaaa: folds 
mjmichi: raises $0.50 to $0.75
tribunpdm: raises $1.25 to $2
silvno31: folds 
ChrisCDee: folds 
chiyuki: folds 
masterkoolb: folds 
phate-1up: folds 
mjmichi: folds 
Uncalled bet ($1.25) returned to tribunpdm
tribunpdm collected $1.85 from pot
tribunpdm: doesn't show hand 
*** SUMMARY ***
Total pot $1.85 | Rake $0 
Seat 1: chiyuki (button) folded before Flop (didn't bet)
Seat 2: masterkoolb (small blind) folded before Flop
Seat 3: phate-1up (big blind) folded before Flop
Seat 4: DutchShultzs folded before Flop (didn't bet)
Seat 5: pandaaaaaa folded before Flop (didn't bet)
Seat 6: mjmichi folded before Flop
Seat 7: tribunpdm collected ($1.85)
Seat 8: silvno31 folded before Flop (didn't bet)
Seat 9: ChrisCDee folded before Flop (didn't bet)



PokerStars Zoom Hand #84300335228:  Hold'em No Limit ($0.10/$0.25) - 2012/08/05 15:21:16 JST [2012/08/05 2:21:16 ET]
Table 'Whirlpool' 9-max Seat #1 is the button
Seat 1: Silveystryk ($27.08 in chips) 
Seat 2: Jene4kaBest ($21.33 in chips) 
Seat 3: Alvinpe85 ($49.74 in chips) 
Seat 4: Roglus ($8.34 in chips) 
Seat 5: 1Karina1 ($40.07 in chips) 
Seat 6: snejokCoxx ($11.80 in chips) 
Seat 7: slapshot2011 ($23.72 in chips) 
Seat 8: ygoegoe ($43.10 in chips) 
Seat 9: chiyuki ($34.61 in chips) 
Jene4kaBest: posts small blind $0.10
Alvinpe85: posts big blind $0.25
*** HOLE CARDS ***
Dealt to chiyuki [Jh 5c]
Roglus: folds 
1Karina1: raises $0.50 to $0.75
snejokCoxx: calls $0.75
slapshot2011: folds 
ygoegoe: folds 
chiyuki: folds 
Silveystryk: folds 
Jene4kaBest: folds 
Alvinpe85: folds 
*** FLOP *** [4s Tc 5s]
1Karina1: checks 
snejokCoxx: bets $1.11
1Karina1: folds 
Uncalled bet ($1.11) returned to snejokCoxx
snejokCoxx collected $1.77 from pot
snejokCoxx: doesn't show hand 
*** SUMMARY ***
Total pot $1.85 | Rake $0.08 
Board [4s Tc 5s]
Seat 1: Silveystryk (button) folded before Flop (didn't bet)
Seat 2: Jene4kaBest (small blind) folded before Flop
Seat 3: Alvinpe85 (big blind) folded before Flop
Seat 4: Roglus folded before Flop (didn't bet)
Seat 5: 1Karina1 folded on the Flop
Seat 6: snejokCoxx collected ($1.77)
Seat 7: slapshot2011 folded before Flop (didn't bet)
Seat 8: ygoegoe folded before Flop (didn't bet)
Seat 9: chiyuki folded before Flop (didn't bet)



PokerStars Zoom Hand #84300328764:  Hold'em No Limit ($0.10/$0.25) - 2012/08/05 15:20:50 JST [2012/08/05 2:20:50 ET]
Table 'Whirlpool' 9-max Seat #1 is the button
Seat 1: panaam ($21.85 in chips) 
Seat 2: KeLevro0 ($12.60 in chips) 
Seat 3: hirozo ($77.04 in chips) 
Seat 4: laurentzu84 ($27.85 in chips) 
Seat 5: INSP!RON ($31.59 in chips) 
Seat 6: chiyuki ($34.61 in chips) 
Seat 7: deepakmbh ($24.65 in chips) 
Seat 8: Robchie ($16.36 in chips) 
Seat 9: ChrisCDee ($68.87 in chips) 
KeLevro0: posts small blind $0.10
hirozo: posts big blind $0.25
*** HOLE CARDS ***
Dealt to chiyuki [6c 6d]
laurentzu84: folds 
INSP!RON: raises $0.50 to $0.75
chiyuki: folds 
deepakmbh: calls $0.75
Robchie: calls $0.75
ChrisCDee: folds 
panaam: folds 
KeLevro0: folds 
hirozo: calls $0.50
*** FLOP *** [9s 4h 2s]
hirozo: checks 
INSP!RON: checks 
deepakmbh: checks 
Robchie: bets $1
hirozo: folds 
INSP!RON: calls $1
deepakmbh: calls $1
*** TURN *** [9s 4h 2s] [3s]
INSP!RON: checks 
deepakmbh: checks 
Robchie: checks 
*** RIVER *** [9s 4h 2s 3s] [Qh]
INSP!RON: checks 
deepakmbh: bets $3.50
Robchie: folds 
INSP!RON: folds 
Uncalled bet ($3.50) returned to deepakmbh
deepakmbh collected $5.83 from pot
deepakmbh: doesn't show hand 
*** SUMMARY ***
Total pot $6.10 | Rake $0.27 
Board [9s 4h 2s 3s Qh]
Seat 1: panaam (button) folded before Flop (didn't bet)
Seat 2: KeLevro0 (small blind) folded before Flop
Seat 3: hirozo (big blind) folded on the Flop
Seat 4: laurentzu84 folded before Flop (didn't bet)
Seat 5: INSP!RON folded on the River
Seat 6: chiyuki folded before Flop (didn't bet)
Seat 7: deepakmbh collected ($5.83)
Seat 8: Robchie folded on the River
Seat 9: ChrisCDee folded before Flop (didn't bet)



PokerStars Zoom Hand #84300340096:  Hold'em No Limit ($0.10/$0.25) - 2012/08/05 15:21:35 JST [2012/08/05 2:21:35 ET]
Table 'Whirlpool' 9-max Seat #1 is the button
Seat 1: KrystalAA ($31.20 in chips) 
Seat 2: silvno31 ($47.72 in chips) 
Seat 3: chiyuki ($34.61 in chips) 
Seat 4: troublesomm ($29.06 in chips) 
Seat 5: macmauret ($18.71 in chips) 
Seat 6: Rici47 ($44.03 in chips) 
Seat 7: phate-1up ($29.69 in chips) 
Seat 8: GovGus ($31.35 in chips) 
Seat 9: Ellen1947 ($23.95 in chips) 
silvno31: posts small blind $0.10
chiyuki: posts big blind $0.25
*** HOLE CARDS ***
Dealt to chiyuki [7s 5c]
troublesomm: folds 
macmauret: folds 
Rici47: folds 
phate-1up: folds 
GovGus: folds 
Ellen1947: folds 
KrystalAA: raises $0.46 to $0.71
silvno31: folds 
chiyuki: folds 
Uncalled bet ($0.46) returned to KrystalAA
KrystalAA collected $0.60 from pot
KrystalAA: doesn't show hand 
*** SUMMARY ***
Total pot $0.60 | Rake $0 
Seat 1: KrystalAA (button) collected ($0.60)
Seat 2: silvno31 (small blind) folded before Flop
Seat 3: chiyuki (big blind) folded before Flop
Seat 4: troublesomm folded before Flop (didn't bet)
Seat 5: macmauret folded before Flop (didn't bet)
Seat 6: Rici47 folded before Flop (didn't bet)
Seat 7: phate-1up folded before Flop (didn't bet)
Seat 8: GovGus folded before Flop (didn't bet)
Seat 9: Ellen1947 folded before Flop (didn't bet)



PokerStars Zoom Hand #84300331570:  Hold'em No Limit ($0.10/$0.25) - 2012/08/05 15:21:02 JST [2012/08/05 2:21:02 ET]
Table 'Whirlpool' 9-max Seat #1 is the button
Seat 1: nice.franki ($14.61 in chips) 
Seat 2: GSDP ($24.65 in chips) 
Seat 3: PetitAlejo ($25.35 in chips) 
Seat 4: deadmoneykid ($32.08 in chips) 
Seat 5: DutchShultzs ($33.22 in chips) 
Seat 6: tribunpdm ($23.84 in chips) 
Seat 7: chiyuki ($34.61 in chips) 
Seat 8: mjmichi ($42.37 in chips) 
Seat 9: hirozo ($82.79 in chips) 
GSDP: posts small blind $0.10
PetitAlejo: posts big blind $0.25
*** HOLE CARDS ***
Dealt to chiyuki [6s 3c]
deadmoneykid: calls $0.25
DutchShultzs: folds 
tribunpdm: folds 
chiyuki: folds 
mjmichi: folds 
hirozo: calls $0.25
nice.franki: raises $1.25 to $1.50
GSDP: folds 
PetitAlejo: folds 
deadmoneykid: folds 
hirozo: calls $1.25
*** FLOP *** [5c Qd Kh]
hirozo: checks 
nice.franki: bets $1.72
hirozo: folds 
Uncalled bet ($1.72) returned to nice.franki
nice.franki collected $3.44 from pot
nice.franki: doesn't show hand 
*** SUMMARY ***
Total pot $3.60 | Rake $0.16 
Board [5c Qd Kh]
Seat 1: nice.franki (button) collected ($3.44)
Seat 2: GSDP (small blind) folded before Flop
Seat 3: PetitAlejo (big blind) folded before Flop
Seat 4: deadmoneykid folded before Flop
Seat 5: DutchShultzs folded before Flop (didn't bet)
Seat 6: tribunpdm folded before Flop (didn't bet)
Seat 7: chiyuki folded before Flop (didn't bet)
Seat 8: mjmichi folded before Flop (didn't bet)
Seat 9: hirozo folded on the Flop



PokerStars Zoom Hand #84300347013:  Hold'em No Limit ($0.10/$0.25) - 2012/08/05 15:22:02 JST [2012/08/05 2:22:02 ET]
Table 'Whirlpool' 9-max Seat #1 is the button
Seat 1: Jene4kaBest ($21.23 in chips) 
Seat 2: Perstenev ($13 in chips) 
Seat 3: seula i ($25 in chips) 
Seat 4: nice.franki ($12.15 in chips) 
Seat 5: chiyuki ($34.36 in chips) 
Seat 6: deepakmbh ($22.15 in chips) 
Seat 7: Dejacob ($25 in chips) 
Seat 8: 4ydo yogurt ($33.69 in chips) 
Seat 9: GovGus ($25 in chips) 
Perstenev: posts small blind $0.10
seula i: posts big blind $0.25
*** HOLE CARDS ***
Dealt to chiyuki [3d Ac]
nice.franki: folds 
chiyuki: folds 
deepakmbh: folds 
Dejacob: folds 
4ydo yogurt: folds 
GovGus: raises $0.75 to $1
Jene4kaBest: folds 
Perstenev: folds 
seula i: folds 
Uncalled bet ($0.75) returned to GovGus
GovGus collected $0.60 from pot
GovGus: doesn't show hand 
*** SUMMARY ***
Total pot $0.60 | Rake $0 
Seat 1: Jene4kaBest (button) folded before Flop (didn't bet)
Seat 2: Perstenev (small blind) folded before Flop
Seat 3: seula i (big blind) folded before Flop
Seat 4: nice.franki folded before Flop (didn't bet)
Seat 5: chiyuki folded before Flop (didn't bet)
Seat 6: deepakmbh folded before Flop (didn't bet)
Seat 7: Dejacob folded before Flop (didn't bet)
Seat 8: 4ydo yogurt folded before Flop (didn't bet)
Seat 9: GovGus collected ($0.60)



PokerStars Zoom Hand #84300347760:  Hold'em No Limit ($0.10/$0.25) - 2012/08/05 15:22:05 JST [2012/08/05 2:22:05 ET]
Table 'Whirlpool' 9-max Seat #1 is the button
Seat 1: ChrisCDee ($47.06 in chips) 
Seat 2: chiyuki ($34.36 in chips) 
Seat 3: troublesomm ($32.15 in chips) 
Seat 4: phate-1up ($52.04 in chips) 
Seat 5: deadmoneykid ($41.31 in chips) 
Seat 6: snejokCoxx ($14.21 in chips) 
Seat 7: KrystalAA ($17.65 in chips) 
Seat 8: dushvan ($55.43 in chips) 
Seat 9: jacquelinewu ($73.26 in chips) 
chiyuki: posts small blind $0.10
troublesomm: posts big blind $0.25
*** HOLE CARDS ***
Dealt to chiyuki [8d 2d]
phate-1up: folds 
deadmoneykid: folds 
snejokCoxx: folds 
KrystalAA: folds 
dushvan: folds 
jacquelinewu: raises $0.50 to $0.75
ChrisCDee: folds 
chiyuki: folds 
troublesomm: folds 
Uncalled bet ($0.50) returned to jacquelinewu
jacquelinewu collected $0.60 from pot
jacquelinewu: doesn't show hand 
*** SUMMARY ***
Total pot $0.60 | Rake $0 
Seat 1: ChrisCDee (button) folded before Flop (didn't bet)
Seat 2: chiyuki (small blind) folded before Flop
Seat 3: troublesomm (big blind) folded before Flop
Seat 4: phate-1up folded before Flop (didn't bet)
Seat 5: deadmoneykid folded before Flop (didn't bet)
Seat 6: snejokCoxx folded before Flop (didn't bet)
Seat 7: KrystalAA folded before Flop (didn't bet)
Seat 8: dushvan folded before Flop (didn't bet)
Seat 9: jacquelinewu collected ($0.60)



PokerStars Zoom Hand #84300348827:  Hold'em No Limit ($0.10/$0.25) - 2012/08/05 15:22:10 JST [2012/08/05 2:22:10 ET]
Table 'Whirlpool' 9-max Seat #1 is the button
Seat 1: INSP!RON ($38.67 in chips) 
Seat 2: deadmoneykid ($26.47 in chips) 
Seat 3: Jene4kaBest ($21.23 in chips) 
Seat 4: rey2040 ($9.47 in chips) 
Seat 5: WARIBANA7777 ($14.33 in chips) 
Seat 6: 1Karina1 ($27.76 in chips) 
Seat 7: ViTiV2010 ($12.85 in chips) 
Seat 8: chiyuki ($34.26 in chips) 
Seat 9: DutchShultzs ($32.87 in chips) 
deadmoneykid: posts small blind $0.10
Jene4kaBest: posts big blind $0.25
*** HOLE CARDS ***
Dealt to chiyuki [Qs Ac]
rey2040: folds 
WARIBANA7777: folds 
1Karina1: folds 
ViTiV2010: folds 
chiyuki: raises $0.50 to $0.75
DutchShultzs: folds 
INSP!RON: folds 
deadmoneykid: folds 
Jene4kaBest: calls $0.50
*** FLOP *** [Qd 2h 2d]
Jene4kaBest: checks 
chiyuki: bets $1
Jene4kaBest: folds 
Uncalled bet ($1) returned to chiyuki
chiyuki collected $1.53 from pot
chiyuki: doesn't show hand 
*** SUMMARY ***
Total pot $1.60 | Rake $0.07 
Board [Qd 2h 2d]
Seat 1: INSP!RON (button) folded before Flop (didn't bet)
Seat 2: deadmoneykid (small blind) folded before Flop
Seat 3: Jene4kaBest (big blind) folded on the Flop
Seat 4: rey2040 folded before Flop (didn't bet)
Seat 5: WARIBANA7777 folded before Flop (didn't bet)
Seat 6: 1Karina1 folded before Flop (didn't bet)
Seat 7: ViTiV2010 folded before Flop (didn't bet)
Seat 8: chiyuki collected ($1.53)
Seat 9: DutchShultzs folded before Flop (didn't bet)



PokerStars Zoom Hand #84300362611:  Hold'em No Limit ($0.10/$0.25) - 2012/08/05 15:23:04 JST [2012/08/05 2:23:04 ET]
Table 'Whirlpool' 9-max Seat #1 is the button
Seat 1: chiyuki ($35.04 in chips) 
Seat 2: Jene4kaBest ($20.48 in chips) 
Seat 3: pandaaaaaa ($7.72 in chips) 
Seat 4: Wilcox76607 ($19.31 in chips) 
Seat 5: WARIBANA7777 ($13.98 in chips) 
Seat 6: AntoineHunt ($35.60 in chips) 
Seat 7: Perstenev ($17.27 in chips) 
Seat 8: jacquelinewu ($34.80 in chips) 
Seat 9: ChrisCDee ($25 in chips) 
Jene4kaBest: posts small blind $0.10
pandaaaaaa: posts big blind $0.25
*** HOLE CARDS ***
Dealt to chiyuki [7s 6h]
Wilcox76607: raises $0.50 to $0.75
WARIBANA7777: folds 
AntoineHunt: folds 
Perstenev: folds 
jacquelinewu: folds 
ChrisCDee: folds 
chiyuki: folds 
Jene4kaBest: folds 
pandaaaaaa: folds 
Uncalled bet ($0.50) returned to Wilcox76607
Wilcox76607 collected $0.60 from pot
Wilcox76607: doesn't show hand 
*** SUMMARY ***
Total pot $0.60 | Rake $0 
Seat 1: chiyuki (button) folded before Flop (didn't bet)
Seat 2: Jene4kaBest (small blind) folded before Flop
Seat 3: pandaaaaaa (big blind) folded before Flop
Seat 4: Wilcox76607 collected ($0.60)
Seat 5: WARIBANA7777 folded before Flop (didn't bet)
Seat 6: AntoineHunt folded before Flop (didn't bet)
Seat 7: Perstenev folded before Flop (didn't bet)
Seat 8: jacquelinewu folded before Flop (didn't bet)
Seat 9: ChrisCDee folded before Flop (didn't bet)



PokerStars Zoom Hand #84300364711:  Hold'em No Limit ($0.10/$0.25) - 2012/08/05 15:23:12 JST [2012/08/05 2:23:12 ET]
Table 'Whirlpool' 9-max Seat #1 is the button
Seat 1: el pore 5 ($13.87 in chips) 
Seat 2: DutchShultzs ($26.73 in chips) 
Seat 3: ZhukOFFskI ($74.78 in chips) 
Seat 4: Dejacob ($39.60 in chips) 
Seat 5: phate-1up ($30.14 in chips) 
Seat 6: Saruotiss ($55.97 in chips) 
Seat 7: chiyuki ($35.04 in chips) 
Seat 8: GravyWalrus ($9.05 in chips) 
Seat 9: Nerkit ($11.33 in chips) 
DutchShultzs: posts small blind $0.10
ZhukOFFskI: posts big blind $0.25
*** HOLE CARDS ***
Dealt to chiyuki [7d Jc]
Dejacob: folds 
phate-1up: folds 
Saruotiss: folds 
chiyuki: folds 
GravyWalrus: folds 
Nerkit: folds 
el pore 5: folds 
DutchShultzs: folds 
Uncalled bet ($0.15) returned to ZhukOFFskI
ZhukOFFskI collected $0.20 from pot
ZhukOFFskI: doesn't show hand 
*** SUMMARY ***
Total pot $0.20 | Rake $0 
Seat 1: el pore 5 (button) folded before Flop (didn't bet)
Seat 2: DutchShultzs (small blind) folded before Flop
Seat 3: ZhukOFFskI (big blind) collected ($0.20)
Seat 4: Dejacob folded before Flop (didn't bet)
Seat 5: phate-1up folded before Flop (didn't bet)
Seat 6: Saruotiss folded before Flop (didn't bet)
Seat 7: chiyuki folded before Flop (didn't bet)
Seat 8: GravyWalrus folded before Flop (didn't bet)
Seat 9: Nerkit folded before Flop (didn't bet)



PokerStars Zoom Hand #84300363958:  Hold'em No Limit ($0.10/$0.25) - 2012/08/05 15:23:09 JST [2012/08/05 2:23:09 ET]
Table 'Whirlpool' 9-max Seat #1 is the button
Seat 1: ZhukOFFskI ($34.04 in chips) 
Seat 2: Perstenev ($11.80 in chips) 
Seat 3: AVerdonk ($23.88 in chips) 
Seat 4: chiyuki ($35.04 in chips) 
Seat 5: turbotom122 ($26.99 in chips) 
Seat 6: Tom1999 ($4.70 in chips) 
Seat 7: ygoegoe ($42.85 in chips) 
Seat 8: rey2040 ($9.47 in chips) 
Seat 9: GovGus ($25 in chips) 
Perstenev: posts small blind $0.10
AVerdonk: posts big blind $0.25
*** HOLE CARDS ***
Dealt to chiyuki [4d 9s]
chiyuki: folds 
turbotom122: folds 
Tom1999: folds 
ygoegoe: folds 
rey2040: folds 
GovGus: raises $0.50 to $0.75
ZhukOFFskI: folds 
Perstenev: folds 
AVerdonk: calls $0.50
*** FLOP *** [3d 9c 7h]
AVerdonk: bets $5
GovGus: folds 
Uncalled bet ($5) returned to AVerdonk
AVerdonk collected $1.53 from pot
AVerdonk: doesn't show hand 
*** SUMMARY ***
Total pot $1.60 | Rake $0.07 
Board [3d 9c 7h]
Seat 1: ZhukOFFskI (button) folded before Flop (didn't bet)
Seat 2: Perstenev (small blind) folded before Flop
Seat 3: AVerdonk (big blind) collected ($1.53)
Seat 4: chiyuki folded before Flop (didn't bet)
Seat 5: turbotom122 folded before Flop (didn't bet)
Seat 6: Tom1999 folded before Flop (didn't bet)
Seat 7: ygoegoe folded before Flop (didn't bet)
Seat 8: rey2040 folded before Flop (didn't bet)
Seat 9: GovGus folded on the Flop



PokerStars Zoom Hand #84300365430:  Hold'em No Limit ($0.10/$0.25) - 2012/08/05 15:23:15 JST [2012/08/05 2:23:15 ET]
Table 'Whirlpool' 9-max Seat #1 is the button
Seat 1: Grishukps ($12.50 in chips) 
Seat 2: silvno31 ($47.32 in chips) 
Seat 3: Perstenev ($10.34 in chips) 
Seat 4: ygoegoe ($25.68 in chips) 
Seat 5: jacquelinewu ($36.89 in chips) 
Seat 6: chiyuki ($35.04 in chips) 
Seat 7: ChrisCDee ($47.54 in chips) 
Seat 8: mjmichi ($49.23 in chips) 
Seat 9: nice.franki ($12.15 in chips) 
silvno31: posts small blind $0.10
Perstenev: posts big blind $0.25
*** HOLE CARDS ***
Dealt to chiyuki [9h Js]
ygoegoe: folds 
jacquelinewu: folds 
chiyuki: folds 
ChrisCDee: folds 
mjmichi: folds 
nice.franki: folds 
Grishukps: folds 
silvno31: raises $0.50 to $0.75
Perstenev: folds 
Uncalled bet ($0.50) returned to silvno31
silvno31 collected $0.50 from pot
silvno31: doesn't show hand 
*** SUMMARY ***
Total pot $0.50 | Rake $0 
Seat 1: Grishukps (button) folded before Flop (didn't bet)
Seat 2: silvno31 (small blind) collected ($0.50)
Seat 3: Perstenev (big blind) folded before Flop
Seat 4: ygoegoe folded before Flop (didn't bet)
Seat 5: jacquelinewu folded before Flop (didn't bet)
Seat 6: chiyuki folded before Flop (didn't bet)
Seat 7: ChrisCDee folded before Flop (didn't bet)
Seat 8: mjmichi folded before Flop (didn't bet)
Seat 9: nice.franki folded before Flop (didn't bet)



PokerStars Zoom Hand #84300367523:  Hold'em No Limit ($0.10/$0.25) - 2012/08/05 15:23:24 JST [2012/08/05 2:23:24 ET]
Table 'Whirlpool' 9-max Seat #1 is the button
Seat 1: laurentzu84 ($31.04 in chips) 
Seat 2: phate-1up ($30.14 in chips) 
Seat 3: jacquelinewu ($36.89 in chips) 
Seat 4: chiyuki ($35.04 in chips) 
Seat 5: KeLevro0 ($13.39 in chips) 
Seat 6: Rilko1975 ($37.36 in chips) 
Seat 7: mjmichi ($49.23 in chips) 
Seat 8: Grishukps ($12.50 in chips) 
Seat 9: DutchShultzs ($26.63 in chips) 
phate-1up: posts small blind $0.10
jacquelinewu: posts big blind $0.25
*** HOLE CARDS ***
Dealt to chiyuki [3c Qc]
chiyuki: folds 
KeLevro0: raises $0.42 to $0.67
Rilko1975: folds 
mjmichi: folds 
Grishukps: folds 
DutchShultzs: folds 
laurentzu84: folds 
phate-1up: folds 
jacquelinewu: folds 
Uncalled bet ($0.42) returned to KeLevro0
KeLevro0 collected $0.60 from pot
KeLevro0: doesn't show hand 
*** SUMMARY ***
Total pot $0.60 | Rake $0 
Seat 1: laurentzu84 (button) folded before Flop (didn't bet)
Seat 2: phate-1up (small blind) folded before Flop
Seat 3: jacquelinewu (big blind) folded before Flop
Seat 4: chiyuki folded before Flop (didn't bet)
Seat 5: KeLevro0 collected ($0.60)
Seat 6: Rilko1975 folded before Flop (didn't bet)
Seat 7: mjmichi folded before Flop (didn't bet)
Seat 8: Grishukps folded before Flop (didn't bet)
Seat 9: DutchShultzs folded before Flop (didn't bet)



PokerStars Zoom Hand #84300369084:  Hold'em No Limit ($0.10/$0.25) - 2012/08/05 15:23:30 JST [2012/08/05 2:23:30 ET]
Table 'Whirlpool' 9-max Seat #1 is the button
Seat 1: troublesomm ($28.71 in chips) 
Seat 2: Yoshimac ($21.73 in chips) 
Seat 3: seula i ($25.35 in chips) 
Seat 4: Dejacob ($53.92 in chips) 
Seat 5: chiyuki ($35.04 in chips) 
Seat 6: INSP!RON ($39.48 in chips) 
Seat 7: GovGus ($25 in chips) 
Seat 8: panaam ($20.98 in chips) 
Seat 9: Lasutchik ($72.20 in chips) 
Yoshimac: posts small blind $0.10
seula i: posts big blind $0.25
*** HOLE CARDS ***
Dealt to chiyuki [Js 6d]
Dejacob: folds 
chiyuki: folds 
INSP!RON: raises $0.50 to $0.75
GovGus: folds 
panaam: folds 
Lasutchik: folds 
troublesomm: folds 
Yoshimac: folds 
seula i: calls $0.50
*** FLOP *** [Ah 9s As]
seula i: checks 
INSP!RON: checks 
*** TURN *** [Ah 9s As] [8h]
seula i: bets $1.50
INSP!RON: folds 
Uncalled bet ($1.50) returned to seula i
seula i collected $1.53 from pot
seula i: doesn't show hand 
*** SUMMARY ***
Total pot $1.60 | Rake $0.07 
Board [Ah 9s As 8h]
Seat 1: troublesomm (button) folded before Flop (didn't bet)
Seat 2: Yoshimac (small blind) folded before Flop
Seat 3: seula i (big blind) collected ($1.53)
Seat 4: Dejacob folded before Flop (didn't bet)
Seat 5: chiyuki folded before Flop (didn't bet)
Seat 6: INSP!RON folded on the Turn
Seat 7: GovGus folded before Flop (didn't bet)
Seat 8: panaam folded before Flop (didn't bet)
Seat 9: Lasutchik folded before Flop (didn't bet)



PokerStars Zoom Hand #84300370110:  Hold'em No Limit ($0.10/$0.25) - 2012/08/05 15:23:34 JST [2012/08/05 2:23:34 ET]
Table 'Whirlpool' 9-max Seat #1 is the button
Seat 1: Saruotiss ($55.97 in chips) 
Seat 2: KrystalAA ($34.52 in chips) 
Seat 3: Tidder ($25 in chips) 
Seat 4: DutchShultzs ($26.63 in chips) 
Seat 5: mjmichi ($49.23 in chips) 
Seat 6: deadmoneykid ($40.96 in chips) 
Seat 7: Grishukps ($12.50 in chips) 
Seat 8: Perstenev ($12.55 in chips) 
Seat 9: chiyuki ($35.04 in chips) 
KrystalAA: posts small blind $0.10
Tidder: posts big blind $0.25
*** HOLE CARDS ***
Dealt to chiyuki [Ks Qc]
DutchShultzs: folds 
mjmichi: folds 
deadmoneykid: folds 
Grishukps: folds 
Perstenev: folds 
chiyuki: raises $0.50 to $0.75
Saruotiss: calls $0.75
KrystalAA: folds 
Tidder: folds 
*** FLOP *** [Qd 4h 3c]
chiyuki: bets $1
Saruotiss: calls $1
*** TURN *** [Qd 4h 3c] [7h]
chiyuki: bets $2
Saruotiss: calls $2
*** RIVER *** [Qd 4h 3c 7h] [Ac]
chiyuki: checks 
Saruotiss: bets $4.25
chiyuki: folds 
Uncalled bet ($4.25) returned to Saruotiss
Saruotiss collected $7.50 from pot
Saruotiss: doesn't show hand 
*** SUMMARY ***
Total pot $7.85 | Rake $0.35 
Board [Qd 4h 3c 7h Ac]
Seat 1: Saruotiss (button) collected ($7.50)
Seat 2: KrystalAA (small blind) folded before Flop
Seat 3: Tidder (big blind) folded before Flop
Seat 4: DutchShultzs folded before Flop (didn't bet)
Seat 5: mjmichi folded before Flop (didn't bet)
Seat 6: deadmoneykid folded before Flop (didn't bet)
Seat 7: Grishukps folded before Flop (didn't bet)
Seat 8: Perstenev folded before Flop (didn't bet)
Seat 9: chiyuki folded on the River



PokerStars Zoom Hand #84300395805:  Hold'em No Limit ($0.10/$0.25) - 2012/08/05 15:25:15 JST [2012/08/05 2:25:15 ET]
Table 'Whirlpool' 9-max Seat #1 is the button
Seat 1: Silveystryk ($25.30 in chips) 
Seat 2: masterkoolb ($16.15 in chips) 
Seat 3: chiyuki ($31.29 in chips) 
Seat 4: therati ($22.10 in chips) 
Seat 5: hirozo ($80.69 in chips) 
Seat 6: KeLevro0 ($12.50 in chips) 
Seat 7: INSP!RON ($40.95 in chips) 
Seat 8: phate-1up ($42.17 in chips) 
Seat 9: nice.franki ($12.15 in chips) 
masterkoolb: posts small blind $0.10
chiyuki: posts big blind $0.25
*** HOLE CARDS ***
Dealt to chiyuki [3c Kh]
therati: folds 
hirozo: folds 
KeLevro0: folds 
INSP!RON: raises $0.50 to $0.75
phate-1up: folds 
nice.franki: folds 
Silveystryk: folds 
masterkoolb: folds 
chiyuki: folds 
Uncalled bet ($0.50) returned to INSP!RON
INSP!RON collected $0.60 from pot
INSP!RON: doesn't show hand 
*** SUMMARY ***
Total pot $0.60 | Rake $0 
Seat 1: Silveystryk (button) folded before Flop (didn't bet)
Seat 2: masterkoolb (small blind) folded before Flop
Seat 3: chiyuki (big blind) folded before Flop
Seat 4: therati folded before Flop (didn't bet)
Seat 5: hirozo folded before Flop (didn't bet)
Seat 6: KeLevro0 folded before Flop (didn't bet)
Seat 7: INSP!RON collected ($0.60)
Seat 8: phate-1up folded before Flop (didn't bet)
Seat 9: nice.franki folded before Flop (didn't bet)



PokerStars Zoom Hand #84300404437:  Hold'em No Limit ($0.10/$0.25) - 2012/08/05 15:25:50 JST [2012/08/05 2:25:50 ET]
Table 'Whirlpool' 9-max Seat #1 is the button
Seat 1: ZhukOFFskI ($29.55 in chips) 
Seat 2: chiyuki ($31.04 in chips) 
Seat 3: seula i ($26.06 in chips) 
Seat 4: hirozo ($41.63 in chips) 
Seat 5: nice.franki ($11.80 in chips) 
Seat 6: Tidder ($23.75 in chips) 
Seat 7: troublesomm ($37.09 in chips) 
Seat 8: AAAKK777 ($32.36 in chips) 
Seat 9: 1Karina1 ($26.60 in chips) 
chiyuki: posts small blind $0.10
seula i: posts big blind $0.25
*** HOLE CARDS ***
Dealt to chiyuki [8c As]
hirozo: raises $0.50 to $0.75
nice.franki: folds 
Tidder: folds 
troublesomm: folds 
AAAKK777: folds 
1Karina1: folds 
ZhukOFFskI: folds 
chiyuki: folds 
seula i: folds 
Uncalled bet ($0.50) returned to hirozo
hirozo collected $0.60 from pot
hirozo: doesn't show hand 
*** SUMMARY ***
Total pot $0.60 | Rake $0 
Seat 1: ZhukOFFskI (button) folded before Flop (didn't bet)
Seat 2: chiyuki (small blind) folded before Flop
Seat 3: seula i (big blind) folded before Flop
Seat 4: hirozo collected ($0.60)
Seat 5: nice.franki folded before Flop (didn't bet)
Seat 6: Tidder folded before Flop (didn't bet)
Seat 7: troublesomm folded before Flop (didn't bet)
Seat 8: AAAKK777 folded before Flop (didn't bet)
Seat 9: 1Karina1 folded before Flop (didn't bet)



PokerStars Zoom Hand #84300407473:  Hold'em No Limit ($0.10/$0.25) - 2012/08/05 15:26:02 JST [2012/08/05 2:26:02 ET]
Table 'Whirlpool' 9-max Seat #1 is the button
Seat 1: NuMetal88 ($25.25 in chips) 
Seat 2: Tidder ($23.75 in chips) 
Seat 3: Dejacob ($25 in chips) 
Seat 4: hirozo ($35.58 in chips) 
Seat 5: jacquelinewu ($35.78 in chips) 
Seat 6: chiyuki ($30.94 in chips) 
Seat 7: ZhukOFFskI ($36.23 in chips) 
Seat 8: panaam ($19.56 in chips) 
Seat 9: 4plankton ($20.41 in chips) 
Tidder: posts small blind $0.10
Dejacob: posts big blind $0.25
*** HOLE CARDS ***
Dealt to chiyuki [2h 5d]
hirozo: folds 
jacquelinewu: folds 
chiyuki: folds 
ZhukOFFskI: folds 
panaam: folds 
4plankton: folds 
NuMetal88: folds 
Tidder: folds 
Uncalled bet ($0.15) returned to Dejacob
Dejacob collected $0.20 from pot
Dejacob: doesn't show hand 
*** SUMMARY ***
Total pot $0.20 | Rake $0 
Seat 1: NuMetal88 (button) folded before Flop (didn't bet)
Seat 2: Tidder (small blind) folded before Flop
Seat 3: Dejacob (big blind) collected ($0.20)
Seat 4: hirozo folded before Flop (didn't bet)
Seat 5: jacquelinewu folded before Flop (didn't bet)
Seat 6: chiyuki folded before Flop (didn't bet)
Seat 7: ZhukOFFskI folded before Flop (didn't bet)
Seat 8: panaam folded before Flop (didn't bet)
Seat 9: 4plankton folded before Flop (didn't bet)



PokerStars Zoom Hand #84300402653:  Hold'em No Limit ($0.10/$0.25) - 2012/08/05 15:25:42 JST [2012/08/05 2:25:42 ET]
Table 'Whirlpool' 9-max Seat #1 is the button
Seat 1: rey2040 ($8.92 in chips) 
Seat 2: River_GmbH ($16.20 in chips) 
Seat 3: Roglus ($6.76 in chips) 
Seat 4: KeLevro0 ($12.40 in chips) 
Seat 5: phate-1up ($80.09 in chips) 
Seat 6: KrystalAA ($18.58 in chips) 
Seat 7: Silveystryk ($29.21 in chips) 
Seat 8: chiyuki ($31.04 in chips) 
Seat 9: Gichboy ($26.18 in chips) 
River_GmbH: posts small blind $0.10
Roglus: posts big blind $0.25
*** HOLE CARDS ***
Dealt to chiyuki [4c 6h]
KeLevro0: folds 
phate-1up: folds 
KrystalAA: folds 
Silveystryk: raises $0.25 to $0.50
chiyuki: folds 
Gichboy: calls $0.50
rey2040: folds 
River_GmbH: folds 
Roglus: calls $0.25
*** FLOP *** [5h Jc 6c]
Roglus: checks 
Silveystryk: checks 
Gichboy: checks 
*** TURN *** [5h Jc 6c] [4h]
Roglus: checks 
Silveystryk: checks 
Gichboy: checks 
*** RIVER *** [5h Jc 6c 4h] [Kh]
Roglus: bets $0.53
Silveystryk: calls $0.53
Gichboy: calls $0.53
*** SHOW DOWN ***
Roglus: shows [3d Ah] (high card Ace)
Silveystryk: shows [Qc Ks] (a pair of Kings)
Gichboy: shows [Kc Qd] (a pair of Kings)
Silveystryk collected $1.53 from pot
Gichboy collected $1.52 from pot
*** SUMMARY ***
Total pot $3.19 | Rake $0.14 
Board [5h Jc 6c 4h Kh]
Seat 1: rey2040 (button) folded before Flop (didn't bet)
Seat 2: River_GmbH (small blind) folded before Flop
Seat 3: Roglus (big blind) showed [3d Ah] and lost with high card Ace
Seat 4: KeLevro0 folded before Flop (didn't bet)
Seat 5: phate-1up folded before Flop (didn't bet)
Seat 6: KrystalAA folded before Flop (didn't bet)
Seat 7: Silveystryk showed [Qc Ks] and won ($1.53) with a pair of Kings
Seat 8: chiyuki folded before Flop (didn't bet)
Seat 9: Gichboy showed [Kc Qd] and won ($1.52) with a pair of Kings



PokerStars Zoom Hand #84300412838:  Hold'em No Limit ($0.10/$0.25) - 2012/08/05 15:26:23 JST [2012/08/05 2:26:23 ET]
Table 'Whirlpool' 9-max Seat #1 is the button
Seat 1: Faraz ($14.75 in chips) 
Seat 2: Grishukps ($12.50 in chips) 
Seat 3: KrystalAA ($15.89 in chips) 
Seat 4: pandaaaaaa ($7.86 in chips) 
Seat 5: Rici47 ($30.26 in chips) 
Seat 6: Nerkit ($14.84 in chips) 
Seat 7: troublesomm ($25 in chips) 
Seat 8: AntoineHunt ($40.32 in chips) 
Seat 9: chiyuki ($30.94 in chips) 
Grishukps: posts small blind $0.10
KrystalAA: posts big blind $0.25
*** HOLE CARDS ***
Dealt to chiyuki [3h Ts]
pandaaaaaa: folds 
Rici47: folds 
Nerkit: folds 
troublesomm: folds 
AntoineHunt: folds 
chiyuki: folds 
Faraz: raises $0.25 to $0.50
Grishukps: folds 
KrystalAA: folds 
Uncalled bet ($0.25) returned to Faraz
Faraz collected $0.60 from pot
Faraz: doesn't show hand 
*** SUMMARY ***
Total pot $0.60 | Rake $0 
Seat 1: Faraz (button) collected ($0.60)
Seat 2: Grishukps (small blind) folded before Flop
Seat 3: KrystalAA (big blind) folded before Flop
Seat 4: pandaaaaaa folded before Flop (didn't bet)
Seat 5: Rici47 folded before Flop (didn't bet)
Seat 6: Nerkit folded before Flop (didn't bet)
Seat 7: troublesomm folded before Flop (didn't bet)
Seat 8: AntoineHunt folded before Flop (didn't bet)
Seat 9: chiyuki folded before Flop (didn't bet)



PokerStars Zoom Hand #84300409464:  Hold'em No Limit ($0.10/$0.25) - 2012/08/05 15:26:10 JST [2012/08/05 2:26:10 ET]
Table 'Whirlpool' 9-max Seat #1 is the button
Seat 1: Grishukps ($12.50 in chips) 
Seat 2: 4plankton ($20.41 in chips) 
Seat 3: God)Squall ($25 in chips) 
Seat 4: nice.franki ($11.55 in chips) 
Seat 5: INSP!RON ($41.10 in chips) 
Seat 6: troublesomm ($37.09 in chips) 
Seat 7: chiyuki ($30.94 in chips) 
Seat 8: DutchShultzs ($25 in chips) 
Seat 9: Perstenev ($15.90 in chips) 
4plankton: posts small blind $0.10
God)Squall: posts big blind $0.25
*** HOLE CARDS ***
Dealt to chiyuki [Tc 4s]
nice.franki: folds 
INSP!RON: folds 
troublesomm: folds 
chiyuki: folds 
DutchShultzs: folds 
Perstenev: folds 
Grishukps: folds 
4plankton: calls $0.15
God)Squall: checks 
*** FLOP *** [9h Jh Qc]
4plankton: checks 
God)Squall: checks 
*** TURN *** [9h Jh Qc] [6d]
4plankton: checks 
God)Squall: checks 
*** RIVER *** [9h Jh Qc 6d] [9s]
4plankton: checks 
God)Squall: bets $0.75
4plankton: folds 
Uncalled bet ($0.75) returned to God)Squall
God)Squall collected $0.48 from pot
God)Squall: doesn't show hand 
*** SUMMARY ***
Total pot $0.50 | Rake $0.02 
Board [9h Jh Qc 6d 9s]
Seat 1: Grishukps (button) folded before Flop (didn't bet)
Seat 2: 4plankton (small blind) folded on the River
Seat 3: God)Squall (big blind) collected ($0.48)
Seat 4: nice.franki folded before Flop (didn't bet)
Seat 5: INSP!RON folded before Flop (didn't bet)
Seat 6: troublesomm folded before Flop (didn't bet)
Seat 7: chiyuki folded before Flop (didn't bet)
Seat 8: DutchShultzs folded before Flop (didn't bet)
Seat 9: Perstenev folded before Flop (didn't bet)



PokerStars Zoom Hand #84300406675:  Hold'em No Limit ($0.10/$0.25) - 2012/08/05 15:25:59 JST [2012/08/05 2:25:59 ET]
Table 'Whirlpool' 9-max Seat #1 is the button
Seat 1: chiyuki ($30.94 in chips) 
Seat 2: KeLevro0 ($12.15 in chips) 
Seat 3: cofla tito ($11.80 in chips) 
Seat 4: rey2040 ($8.92 in chips) 
Seat 5: seula i ($25 in chips) 
Seat 6: deadmoneykid ($39.51 in chips) 
Seat 7: kamikkaze ($12.50 in chips) 
Seat 8: 1Karina1 ($26.60 in chips) 
Seat 9: troublesomm ($37.09 in chips) 
KeLevro0: posts small blind $0.10
cofla tito: posts big blind $0.25
*** HOLE CARDS ***
Dealt to chiyuki [Ah 5s]
rey2040: folds 
seula i: folds 
deadmoneykid: folds 
kamikkaze: raises $0.38 to $0.63
1Karina1: folds 
troublesomm: folds 
chiyuki: folds 
KeLevro0: folds 
cofla tito: calls $0.38
*** FLOP *** [Qs Kc 8d]
cofla tito: checks 
kamikkaze: bets $0.84
cofla tito: calls $0.84
*** TURN *** [Qs Kc 8d] [9d]
cofla tito: bets $0.50
kamikkaze: calls $0.50
*** RIVER *** [Qs Kc 8d 9d] [6d]
cofla tito: checks 
kamikkaze: checks 
*** SHOW DOWN ***
cofla tito: shows [4c Qc] (a pair of Queens)
kamikkaze: shows [Qd As] (a pair of Queens - Ace kicker)
kamikkaze collected $3.86 from pot
*** SUMMARY ***
Total pot $4.04 | Rake $0.18 
Board [Qs Kc 8d 9d 6d]
Seat 1: chiyuki (button) folded before Flop (didn't bet)
Seat 2: KeLevro0 (small blind) folded before Flop
Seat 3: cofla tito (big blind) showed [4c Qc] and lost with a pair of Queens
Seat 4: rey2040 folded before Flop (didn't bet)
Seat 5: seula i folded before Flop (didn't bet)
Seat 6: deadmoneykid folded before Flop (didn't bet)
Seat 7: kamikkaze showed [Qd As] and won ($3.86) with a pair of Queens
Seat 8: 1Karina1 folded before Flop (didn't bet)
Seat 9: troublesomm folded before Flop (didn't bet)



PokerStars Zoom Hand #84300418108:  Hold'em No Limit ($0.10/$0.25) - 2012/08/05 15:26:44 JST [2012/08/05 2:26:44 ET]
Table 'Whirlpool' 9-max Seat #1 is the button
Seat 1: masterkoolb ($15.70 in chips) 
Seat 2: chiyuki ($30.94 in chips) 
Seat 3: Rilko1975 ($34.61 in chips) 
Seat 4: GovGus ($42.55 in chips) 
Seat 5: DutchShultzs ($25.93 in chips) 
Seat 6: KrystalAA ($15.64 in chips) 
Seat 7: troublesomm ($36.74 in chips) 
Seat 8: Grishukps ($12.50 in chips) 
Seat 9: snejokCoxx ($11.92 in chips) 
chiyuki: posts small blind $0.10
Rilko1975: posts big blind $0.25
*** HOLE CARDS ***
Dealt to chiyuki [Ad 7h]
GovGus: folds 
DutchShultzs: folds 
KrystalAA: folds 
troublesomm: folds 
Grishukps: raises $0.50 to $0.75
snejokCoxx: folds 
masterkoolb: folds 
chiyuki: folds 
Rilko1975: folds 
Uncalled bet ($0.50) returned to Grishukps
Grishukps collected $0.60 from pot
Grishukps: doesn't show hand 
*** SUMMARY ***
Total pot $0.60 | Rake $0 
Seat 1: masterkoolb (button) folded before Flop (didn't bet)
Seat 2: chiyuki (small blind) folded before Flop
Seat 3: Rilko1975 (big blind) folded before Flop
Seat 4: GovGus folded before Flop (didn't bet)
Seat 5: DutchShultzs folded before Flop (didn't bet)
Seat 6: KrystalAA folded before Flop (didn't bet)
Seat 7: troublesomm folded before Flop (didn't bet)
Seat 8: Grishukps collected ($0.60)
Seat 9: snejokCoxx folded before Flop (didn't bet)



PokerStars Zoom Hand #84300411843:  Hold'em No Limit ($0.10/$0.25) - 2012/08/05 15:26:19 JST [2012/08/05 2:26:19 ET]
Table 'Whirlpool' 9-max Seat #1 is the button
Seat 1: ViTiV2010 ($12.35 in chips) 
Seat 2: Perstenev ($13 in chips) 
Seat 3: hirozo ($80.59 in chips) 
Seat 4: DutchShultzs ($37.51 in chips) 
Seat 5: chiyuki ($30.94 in chips) 
Seat 6: INSP!RON ($41.75 in chips) 
Seat 7: 1Karina1 ($26.35 in chips) 
Seat 8: Dejacob ($25 in chips) 
Seat 9: troublesomm ($25 in chips) 
Perstenev: posts small blind $0.10
hirozo: posts big blind $0.25
*** HOLE CARDS ***
Dealt to chiyuki [Kc Ts]
DutchShultzs: folds 
chiyuki: folds 
INSP!RON: folds 
1Karina1: raises $0.50 to $0.75
Dejacob: folds 
troublesomm: folds 
ViTiV2010: folds 
Perstenev: folds 
hirozo: raises $1.03 to $1.78
1Karina1: calls $1.03
*** FLOP *** [4h 3d 2h]
hirozo: bets $2.33
1Karina1: calls $2.33
*** TURN *** [4h 3d 2h] [5d]
hirozo: checks 
1Karina1: checks 
*** RIVER *** [4h 3d 2h 5d] [2c]
hirozo: checks 
1Karina1: checks 
*** SHOW DOWN ***
hirozo: shows [Jc Js] (two pair, Jacks and Deuces)
1Karina1: mucks hand 
hirozo collected $7.95 from pot
*** SUMMARY ***
Total pot $8.32 | Rake $0.37 
Board [4h 3d 2h 5d 2c]
Seat 1: ViTiV2010 (button) folded before Flop (didn't bet)
Seat 2: Perstenev (small blind) folded before Flop
Seat 3: hirozo (big blind) showed [Jc Js] and won ($7.95) with two pair, Jacks and Deuces
Seat 4: DutchShultzs folded before Flop (didn't bet)
Seat 5: chiyuki folded before Flop (didn't bet)
Seat 6: INSP!RON folded before Flop (didn't bet)
Seat 7: 1Karina1 mucked [8s 8d]
Seat 8: Dejacob folded before Flop (didn't bet)
Seat 9: troublesomm folded before Flop (didn't bet)



PokerStars Zoom Hand #84300416898:  Hold'em No Limit ($0.10/$0.25) - 2012/08/05 15:26:39 JST [2012/08/05 2:26:39 ET]
Table 'Whirlpool' 9-max Seat #1 is the button
Seat 1: troublesomm ($25 in chips) 
Seat 2: masterkoolb ($15.80 in chips) 
Seat 3: Vahe50 ($14.06 in chips) 
Seat 4: chiyuki ($30.94 in chips) 
Seat 5: jacquelinewu ($74.87 in chips) 
Seat 6: phate-1up ($79.99 in chips) 
Seat 7: DutchShultzs ($25.93 in chips) 
Seat 8: 1Karina1 ($39.55 in chips) 
Seat 9: kwkim73 ($25 in chips) 
masterkoolb: posts small blind $0.10
Vahe50: posts big blind $0.25
*** HOLE CARDS ***
Dealt to chiyuki [Tc 4s]
chiyuki: folds 
jacquelinewu: folds 
phate-1up: folds 
DutchShultzs: folds 
1Karina1: folds 
kwkim73: raises $0.50 to $0.75
troublesomm: folds 
masterkoolb: folds 
Vahe50: folds 
Uncalled bet ($0.50) returned to kwkim73
kwkim73 collected $0.60 from pot
kwkim73: doesn't show hand 
*** SUMMARY ***
Total pot $0.60 | Rake $0 
Seat 1: troublesomm (button) folded before Flop (didn't bet)
Seat 2: masterkoolb (small blind) folded before Flop
Seat 3: Vahe50 (big blind) folded before Flop
Seat 4: chiyuki folded before Flop (didn't bet)
Seat 5: jacquelinewu folded before Flop (didn't bet)
Seat 6: phate-1up folded before Flop (didn't bet)
Seat 7: DutchShultzs folded before Flop (didn't bet)
Seat 8: 1Karina1 folded before Flop (didn't bet)
Seat 9: kwkim73 collected ($0.60)



PokerStars Zoom Hand #84300422917:  Hold'em No Limit ($0.10/$0.25) - 2012/08/05 15:27:04 JST [2012/08/05 2:27:04 ET]
Table 'Whirlpool' 9-max Seat #1 is the button
Seat 1: Nerkit ($14.49 in chips) 
Seat 2: macmauret ($13.06 in chips) 
Seat 3: chiyuki ($30.84 in chips) 
Seat 4: 1Karina1 ($26.19 in chips) 
Seat 5: Grishukps ($12.85 in chips) 
Seat 6: Perstenev ($15.55 in chips) 
Seat 7: Saruotiss ($61.76 in chips) 
Seat 8: GSDP ($25.41 in chips) 
Seat 9: hirozo ($35.23 in chips) 
macmauret: posts small blind $0.10
chiyuki: posts big blind $0.25
*** HOLE CARDS ***
Dealt to chiyuki [Kh 4h]
1Karina1: folds 
Grishukps: folds 
Perstenev: folds 
Saruotiss: folds 
GSDP: folds 
hirozo: folds 
Nerkit: raises $0.37 to $0.62
macmauret: folds 
chiyuki: folds 
Uncalled bet ($0.37) returned to Nerkit
Nerkit collected $0.60 from pot
Nerkit: doesn't show hand 
*** SUMMARY ***
Total pot $0.60 | Rake $0 
Seat 1: Nerkit (button) collected ($0.60)
Seat 2: macmauret (small blind) folded before Flop
Seat 3: chiyuki (big blind) folded before Flop
Seat 4: 1Karina1 folded before Flop (didn't bet)
Seat 5: Grishukps folded before Flop (didn't bet)
Seat 6: Perstenev folded before Flop (didn't bet)
Seat 7: Saruotiss folded before Flop (didn't bet)
Seat 8: GSDP folded before Flop (didn't bet)
Seat 9: hirozo folded before Flop (didn't bet)



PokerStars Zoom Hand #84300426187:  Hold'em No Limit ($0.10/$0.25) - 2012/08/05 15:27:17 JST [2012/08/05 2:27:17 ET]
Table 'Whirlpool' 9-max Seat #1 is the button
Seat 1: Grishukps ($12.60 in chips) 
Seat 2: panaam ($21.38 in chips) 
Seat 3: svg51 ($9.33 in chips) 
Seat 4: kamikkaze ($14.04 in chips) 
Seat 5: Saruotiss ($61.76 in chips) 
Seat 6: nice.franki ($11.45 in chips) 
Seat 7: moku36 ($28.93 in chips) 
Seat 8: chiyuki ($30.59 in chips) 
Seat 9: kaplya2010 ($23.01 in chips) 
panaam: posts small blind $0.10
svg51: posts big blind $0.25
*** HOLE CARDS ***
Dealt to chiyuki [4h Ts]
kamikkaze: folds 
Saruotiss: folds 
nice.franki: folds 
moku36: folds 
chiyuki: folds 
kaplya2010: folds 
Grishukps: raises $0.37 to $0.62
panaam: folds 
svg51: raises $0.88 to $1.50
Grishukps: folds 
Uncalled bet ($0.88) returned to svg51
svg51 collected $1.34 from pot
svg51: doesn't show hand 
*** SUMMARY ***
Total pot $1.34 | Rake $0 
Seat 1: Grishukps (button) folded before Flop
Seat 2: panaam (small blind) folded before Flop
Seat 3: svg51 (big blind) collected ($1.34)
Seat 4: kamikkaze folded before Flop (didn't bet)
Seat 5: Saruotiss folded before Flop (didn't bet)
Seat 6: nice.franki folded before Flop (didn't bet)
Seat 7: moku36 folded before Flop (didn't bet)
Seat 8: chiyuki folded before Flop (didn't bet)
Seat 9: kaplya2010 folded before Flop (didn't bet)



PokerStars Zoom Hand #84300428456:  Hold'em No Limit ($0.10/$0.25) - 2012/08/05 15:27:26 JST [2012/08/05 2:27:26 ET]
Table 'Whirlpool' 9-max Seat #1 is the button
Seat 1: chiyuki ($30.59 in chips) 
Seat 2: jacquelinewu ($25 in chips) 
Seat 3: Jene4kaBest ($20.18 in chips) 
Seat 4: turbotom122 ($21.01 in chips) 
Seat 5: GSDP ($25.41 in chips) 
Seat 6: troublesomm ($28.01 in chips) 
Seat 7: WARIBANA7777 ($15.68 in chips) 
Seat 8: INSP!RON ($42.50 in chips) 
Seat 9: phate-1up ($52.41 in chips) 
jacquelinewu: posts small blind $0.10
Jene4kaBest: posts big blind $0.25
*** HOLE CARDS ***
Dealt to chiyuki [Qs Qd]
turbotom122: calls $0.25
GSDP: folds 
troublesomm: folds 
WARIBANA7777: folds 
INSP!RON: folds 
phate-1up: folds 
chiyuki: raises $0.75 to $1
jacquelinewu: folds 
Jene4kaBest: folds 
turbotom122: raises $20.01 to $21.01 and is all-in
chiyuki: calls $20.01
*** FLOP *** [Th 6d 6s]
*** TURN *** [Th 6d 6s] [Ts]
*** RIVER *** [Th 6d 6s Ts] [9s]
*** SHOW DOWN ***
turbotom122: shows [Ah Kh] (two pair, Tens and Sixes)
chiyuki: shows [Qs Qd] (two pair, Queens and Tens)
chiyuki collected $40.46 from pot
*** SUMMARY ***
Total pot $42.37 | Rake $1.91 
Board [Th 6d 6s Ts 9s]
Seat 1: chiyuki (button) showed [Qs Qd] and won ($40.46) with two pair, Queens and Tens
Seat 2: jacquelinewu (small blind) folded before Flop
Seat 3: Jene4kaBest (big blind) folded before Flop
Seat 4: turbotom122 showed [Ah Kh] and lost with two pair, Tens and Sixes
Seat 5: GSDP folded before Flop (didn't bet)
Seat 6: troublesomm folded before Flop (didn't bet)
Seat 7: WARIBANA7777 folded before Flop (didn't bet)
Seat 8: INSP!RON folded before Flop (didn't bet)
Seat 9: phate-1up folded before Flop (didn't bet)



PokerStars Zoom Hand #84300442438:  Hold'em No Limit ($0.10/$0.25) - 2012/08/05 15:28:22 JST [2012/08/05 2:28:22 ET]
Table 'Whirlpool' 9-max Seat #1 is the button
Seat 1: jacquelinewu ($25.35 in chips) 
Seat 2: turbotom122 ($12.50 in chips) 
Seat 3: Silveystryk ($37.87 in chips) 
Seat 4: Perstenev ($13.80 in chips) 
Seat 5: nice.franki ($11.46 in chips) 
Seat 6: Grishukps ($12.85 in chips) 
Seat 7: Dan Royal ($31.41 in chips) 
Seat 8: ChrisCDee ($33.94 in chips) 
Seat 9: chiyuki ($50.04 in chips) 
turbotom122: posts small blind $0.10
Silveystryk: posts big blind $0.25
*** HOLE CARDS ***
Dealt to chiyuki [Jh 5h]
Perstenev: folds 
nice.franki: folds 
Grishukps: folds 
Dan Royal: folds 
ChrisCDee: raises $0.50 to $0.75
chiyuki: folds 
jacquelinewu: folds 
turbotom122: folds 
Silveystryk: folds 
Uncalled bet ($0.50) returned to ChrisCDee
ChrisCDee collected $0.60 from pot
ChrisCDee: doesn't show hand 
*** SUMMARY ***
Total pot $0.60 | Rake $0 
Seat 1: jacquelinewu (button) folded before Flop (didn't bet)
Seat 2: turbotom122 (small blind) folded before Flop
Seat 3: Silveystryk (big blind) folded before Flop
Seat 4: Perstenev folded before Flop (didn't bet)
Seat 5: nice.franki folded before Flop (didn't bet)
Seat 6: Grishukps folded before Flop (didn't bet)
Seat 7: Dan Royal folded before Flop (didn't bet)
Seat 8: ChrisCDee collected ($0.60)
Seat 9: chiyuki folded before Flop (didn't bet)



PokerStars Zoom Hand #84300444645:  Hold'em No Limit ($0.10/$0.25) - 2012/08/05 15:28:31 JST [2012/08/05 2:28:31 ET]
Table 'Whirlpool' 9-max Seat #1 is the button
Seat 1: kamikkaze ($13.69 in chips) 
Seat 2: troublesomm ($27.90 in chips) 
Seat 3: macmauret ($22.25 in chips) 
Seat 4: mjmichi ($48.62 in chips) 
Seat 5: jacquelinewu ($37.47 in chips) 
Seat 6: Grishukps ($12.85 in chips) 
Seat 7: chiyuki ($50.04 in chips) 
Seat 8: kwkim73 ($26.55 in chips) 
Seat 9: silvno31 ($46.89 in chips) 
troublesomm: posts small blind $0.10
macmauret: posts big blind $0.25
*** HOLE CARDS ***
Dealt to chiyuki [Jc 7h]
mjmichi: folds 
jacquelinewu: folds 
Grishukps: folds 
chiyuki: folds 
kwkim73: folds 
silvno31: folds 
kamikkaze: raises $0.38 to $0.63
troublesomm: folds 
macmauret: folds 
Uncalled bet ($0.38) returned to kamikkaze
kamikkaze collected $0.60 from pot
kamikkaze: doesn't show hand 
*** SUMMARY ***
Total pot $0.60 | Rake $0 
Seat 1: kamikkaze (button) collected ($0.60)
Seat 2: troublesomm (small blind) folded before Flop
Seat 3: macmauret (big blind) folded before Flop
Seat 4: mjmichi folded before Flop (didn't bet)
Seat 5: jacquelinewu folded before Flop (didn't bet)
Seat 6: Grishukps folded before Flop (didn't bet)
Seat 7: chiyuki folded before Flop (didn't bet)
Seat 8: kwkim73 folded before Flop (didn't bet)
Seat 9: silvno31 folded before Flop (didn't bet)



PokerStars Zoom Hand #84300451492:  Hold'em No Limit ($0.10/$0.25) - 2012/08/05 15:28:58 JST [2012/08/05 2:28:58 ET]
Table 'Whirlpool' 9-max Seat #1 is the button
Seat 1: panaam ($20.28 in chips) 
Seat 2: phate-1up ($50.68 in chips) 
Seat 3: chiyuki ($50.04 in chips) 
Seat 4: 1Karina1 ($25.22 in chips) 
Seat 5: Nagus3x ($22.05 in chips) 
Seat 6: rey2040 ($9.96 in chips) 
Seat 7: jacquelinewu ($37.37 in chips) 
Seat 8: Alvinpe85 ($54.84 in chips) 
Seat 9: nice.franki ($11.80 in chips) 
phate-1up: posts small blind $0.10
chiyuki: posts big blind $0.25
*** HOLE CARDS ***
Dealt to chiyuki [6c 4h]
1Karina1: folds 
Nagus3x: raises $0.55 to $0.80
rey2040: folds 
jacquelinewu: folds 
Alvinpe85: folds 
nice.franki: folds 
panaam: folds 
phate-1up: folds 
chiyuki: folds 
Uncalled bet ($0.55) returned to Nagus3x
Nagus3x collected $0.60 from pot
Nagus3x: doesn't show hand 
*** SUMMARY ***
Total pot $0.60 | Rake $0 
Seat 1: panaam (button) folded before Flop (didn't bet)
Seat 2: phate-1up (small blind) folded before Flop
Seat 3: chiyuki (big blind) folded before Flop
Seat 4: 1Karina1 folded before Flop (didn't bet)
Seat 5: Nagus3x collected ($0.60)
Seat 6: rey2040 folded before Flop (didn't bet)
Seat 7: jacquelinewu folded before Flop (didn't bet)
Seat 8: Alvinpe85 folded before Flop (didn't bet)
Seat 9: nice.franki folded before Flop (didn't bet)



PokerStars Zoom Hand #84300440918:  Hold'em No Limit ($0.10/$0.25) - 2012/08/05 15:28:16 JST [2012/08/05 2:28:16 ET]
Table 'Whirlpool' 9-max Seat #1 is the button
Seat 1: Vahe50 ($14.06 in chips) 
Seat 2: INSP!RON ($41.75 in chips) 
Seat 3: kwkim73 ($25.60 in chips) 
Seat 4: Nerkit ($13.88 in chips) 
Seat 5: yane73 ($7.22 in chips) 
Seat 6: chiyuki ($50.04 in chips) 
Seat 7: silvno31 ($46.89 in chips) 
Seat 8: DutchShultzs ($43.93 in chips) 
Seat 9: hirozo ($43.43 in chips) 
INSP!RON: posts small blind $0.10
kwkim73: posts big blind $0.25
*** HOLE CARDS ***
Dealt to chiyuki [3c 7d]
Nerkit: raises $0.37 to $0.62
yane73: raises $0.38 to $1
chiyuki: folds 
silvno31: folds 
DutchShultzs: folds 
hirozo: folds 
Vahe50: folds 
INSP!RON: folds 
kwkim73: folds 
Nerkit: calls $0.38
*** FLOP *** [Jh Kh 9h]
Nerkit: checks 
yane73: checks 
*** TURN *** [Jh Kh 9h] [Ad]
Nerkit: checks 
yane73: bets $6.22 and is all-in
Nerkit: folds 
Uncalled bet ($6.22) returned to yane73
yane73 collected $2.24 from pot
yane73: doesn't show hand 
*** SUMMARY ***
Total pot $2.35 | Rake $0.11 
Board [Jh Kh 9h Ad]
Seat 1: Vahe50 (button) folded before Flop (didn't bet)
Seat 2: INSP!RON (small blind) folded before Flop
Seat 3: kwkim73 (big blind) folded before Flop
Seat 4: Nerkit folded on the Turn
Seat 5: yane73 collected ($2.24)
Seat 6: chiyuki folded before Flop (didn't bet)
Seat 7: silvno31 folded before Flop (didn't bet)
Seat 8: DutchShultzs folded before Flop (didn't bet)
Seat 9: hirozo folded before Flop (didn't bet)



PokerStars Zoom Hand #84300446422:  Hold'em No Limit ($0.10/$0.25) - 2012/08/05 15:28:38 JST [2012/08/05 2:28:38 ET]
Table 'Whirlpool' 9-max Seat #1 is the button
Seat 1: fil740 ($11.38 in chips) 
Seat 2: kwkim73 ($26.55 in chips) 
Seat 3: KimPa39 ($25 in chips) 
Seat 4: phate-1up ($46.55 in chips) 
Seat 5: chiyuki ($50.04 in chips) 
Seat 6: troublesomm ($36.39 in chips) 
Seat 7: hirozo ($43.43 in chips) 
Seat 8: nastya040 ($15.80 in chips) 
Seat 9: KeLevro0 ($13.25 in chips) 
kwkim73: posts small blind $0.10
KimPa39: posts big blind $0.25
*** HOLE CARDS ***
Dealt to chiyuki [Qd 5s]
phate-1up: folds 
chiyuki: folds 
troublesomm: folds 
hirozo: folds 
nastya040: calls $0.25
KeLevro0: folds 
fil740: raises $0.25 to $0.50
kwkim73: folds 
KimPa39: calls $0.25
nastya040: calls $0.25
*** FLOP *** [Tc 4c 9s]
KimPa39: checks 
nastya040: bets $0.50
fil740: calls $0.50
KimPa39: calls $0.50
*** TURN *** [Tc 4c 9s] [3c]
KimPa39: checks 
nastya040: bets $0.75
fil740: calls $0.75
KimPa39: calls $0.75
*** RIVER *** [Tc 4c 9s 3c] [2s]
KimPa39: checks 
nastya040: bets $0.50
fil740: folds 
KimPa39: calls $0.50
*** SHOW DOWN ***
nastya040: shows [4h 3h] (two pair, Fours and Threes)
KimPa39: mucks hand 
nastya040 collected $6.06 from pot
*** SUMMARY ***
Total pot $6.35 | Rake $0.29 
Board [Tc 4c 9s 3c 2s]
Seat 1: fil740 (button) folded on the River
Seat 2: kwkim73 (small blind) folded before Flop
Seat 3: KimPa39 (big blind) mucked [Qs 9c]
Seat 4: phate-1up folded before Flop (didn't bet)
Seat 5: chiyuki folded before Flop (didn't bet)
Seat 6: troublesomm folded before Flop (didn't bet)
Seat 7: hirozo folded before Flop (didn't bet)
Seat 8: nastya040 showed [4h 3h] and won ($6.06) with two pair, Fours and Threes
Seat 9: KeLevro0 folded before Flop (didn't bet)



PokerStars Zoom Hand #84300455066:  Hold'em No Limit ($0.10/$0.25) - 2012/08/05 15:29:12 JST [2012/08/05 2:29:12 ET]
Table 'Whirlpool' 9-max Seat #1 is the button
Seat 1: laurentzu84 ($27.89 in chips) 
Seat 2: chiyuki ($49.79 in chips) 
Seat 3: silvno31 ($46.14 in chips) 
Seat 4: phate-1up ($50.58 in chips) 
Seat 5: River_GmbH ($15.60 in chips) 
Seat 6: cofla tito ($12.06 in chips) 
Seat 7: DutchShultzs ($37.41 in chips) 
Seat 8: ZhukOFFskI ($35.63 in chips) 
Seat 9: Ellen1947 ($28.89 in chips) 
chiyuki: posts small blind $0.10
silvno31: posts big blind $0.25
*** HOLE CARDS ***
Dealt to chiyuki [9d 2c]
phate-1up: folds 
River_GmbH has timed out
River_GmbH: folds 
cofla tito: folds 
DutchShultzs: folds 
ZhukOFFskI: folds 
Ellen1947: folds 
laurentzu84: folds 
chiyuki: folds 
Uncalled bet ($0.15) returned to silvno31
silvno31 collected $0.20 from pot
silvno31: doesn't show hand 
*** SUMMARY ***
Total pot $0.20 | Rake $0 
Seat 1: laurentzu84 (button) folded before Flop (didn't bet)
Seat 2: chiyuki (small blind) folded before Flop
Seat 3: silvno31 (big blind) collected ($0.20)
Seat 4: phate-1up folded before Flop (didn't bet)
Seat 5: River_GmbH folded before Flop (didn't bet)
Seat 6: cofla tito folded before Flop (didn't bet)
Seat 7: DutchShultzs folded before Flop (didn't bet)
Seat 8: ZhukOFFskI folded before Flop (didn't bet)
Seat 9: Ellen1947 folded before Flop (didn't bet)



PokerStars Zoom Hand #84300447895:  Hold'em No Limit ($0.10/$0.25) - 2012/08/05 15:28:44 JST [2012/08/05 2:28:44 ET]
Table 'Whirlpool' 9-max Seat #1 is the button
Seat 1: hirozo ($43.43 in chips) 
Seat 2: jacquelinewu ($37.47 in chips) 
Seat 3: deadmoneykid ($26.37 in chips) 
Seat 4: Rici47 ($26.26 in chips) 
Seat 5: kwkim73 ($38.99 in chips) 
Seat 6: slapshot2011 ($18.53 in chips) 
Seat 7: ChrisCDee ($26.80 in chips) 
Seat 8: chiyuki ($50.04 in chips) 
Seat 9: Silveystryk ($37.62 in chips) 
jacquelinewu: posts small blind $0.10
deadmoneykid: posts big blind $0.25
*** HOLE CARDS ***
Dealt to chiyuki [2h Qs]
Rici47: calls $0.25
kwkim73: folds 
slapshot2011: calls $0.25
ChrisCDee: raises $1 to $1.25
chiyuki: folds 
Silveystryk: folds 
hirozo: folds 
jacquelinewu: folds 
deadmoneykid: folds 
Rici47: calls $1
slapshot2011: folds 
*** FLOP *** [4h 9s Kd]
Rici47: bets $0.75
ChrisCDee: calls $0.75
*** TURN *** [4h 9s Kd] [8c]
Rici47: bets $1.75
ChrisCDee: folds 
Uncalled bet ($1.75) returned to Rici47
Rici47 collected $4.39 from pot
Rici47: doesn't show hand 
*** SUMMARY ***
Total pot $4.60 | Rake $0.21 
Board [4h 9s Kd 8c]
Seat 1: hirozo (button) folded before Flop (didn't bet)
Seat 2: jacquelinewu (small blind) folded before Flop
Seat 3: deadmoneykid (big blind) folded before Flop
Seat 4: Rici47 collected ($4.39)
Seat 5: kwkim73 folded before Flop (didn't bet)
Seat 6: slapshot2011 folded before Flop
Seat 7: ChrisCDee folded on the Turn
Seat 8: chiyuki folded before Flop (didn't bet)
Seat 9: Silveystryk folded before Flop (didn't bet)



PokerStars Zoom Hand #84300457496:  Hold'em No Limit ($0.10/$0.25) - 2012/08/05 15:29:23 JST [2012/08/05 2:29:23 ET]
Table 'Whirlpool' 9-max Seat #1 is the button
Seat 1: AntoineHunt ($39.44 in chips) 
Seat 2: Silveystryk ($21.95 in chips) 
Seat 3: rey2040 ($10.31 in chips) 
Seat 4: chiyuki ($49.69 in chips) 
Seat 5: soul_5577 ($12.15 in chips) 
Seat 6: snejokCoxx ($12.35 in chips) 
Seat 7: Faraz ($20.88 in chips) 
Seat 8: Saruotiss ($61.26 in chips) 
Seat 9: WARIBANA7777 ($14.68 in chips) 
Silveystryk: posts small blind $0.10
rey2040: posts big blind $0.25
*** HOLE CARDS ***
Dealt to chiyuki [8c 8h]
chiyuki: folds 
soul_5577: folds 
snejokCoxx: folds 
Faraz: raises $0.25 to $0.50
Saruotiss: calls $0.50
WARIBANA7777: folds 
AntoineHunt: folds 
Silveystryk: folds 
rey2040: folds 
*** FLOP *** [Kc 4h 9d]
Faraz: bets $0.75
Saruotiss: folds 
Uncalled bet ($0.75) returned to Faraz
Faraz collected $1.29 from pot
Faraz: doesn't show hand 
*** SUMMARY ***
Total pot $1.35 | Rake $0.06 
Board [Kc 4h 9d]
Seat 1: AntoineHunt (button) folded before Flop (didn't bet)
Seat 2: Silveystryk (small blind) folded before Flop
Seat 3: rey2040 (big blind) folded before Flop
Seat 4: chiyuki folded before Flop (didn't bet)
Seat 5: soul_5577 folded before Flop (didn't bet)
Seat 6: snejokCoxx folded before Flop (didn't bet)
Seat 7: Faraz collected ($1.29)
Seat 8: Saruotiss folded on the Flop
Seat 9: WARIBANA7777 folded before Flop (didn't bet)



PokerStars Zoom Hand #84300463215:  Hold'em No Limit ($0.10/$0.25) - 2012/08/05 15:29:46 JST [2012/08/05 2:29:46 ET]
Table 'Whirlpool' 9-max Seat #1 is the button
Seat 1: Alvinpe85 ($55.29 in chips) 
Seat 2: Dan Royal ($31.51 in chips) 
Seat 3: Perstenev ($8.40 in chips) 
Seat 4: Gichboy ($28.33 in chips) 
Seat 5: chiyuki ($49.69 in chips) 
Seat 6: WARIBANA7777 ($14.68 in chips) 
Seat 7: Nerkit ($14.76 in chips) 
Seat 8: snejokCoxx ($12.15 in chips) 
Seat 9: cofla tito ($11.71 in chips) 
Dan Royal: posts small blind $0.10
Perstenev: posts big blind $0.25
*** HOLE CARDS ***
Dealt to chiyuki [8h 5d]
Gichboy: folds 
chiyuki: folds 
WARIBANA7777: folds 
Nerkit: folds 
snejokCoxx: folds 
cofla tito: folds 
Alvinpe85: folds 
Dan Royal: raises $0.50 to $0.75
Perstenev: folds 
Uncalled bet ($0.50) returned to Dan Royal
Dan Royal collected $0.50 from pot
Dan Royal: doesn't show hand 
*** SUMMARY ***
Total pot $0.50 | Rake $0 
Seat 1: Alvinpe85 (button) folded before Flop (didn't bet)
Seat 2: Dan Royal (small blind) collected ($0.50)
Seat 3: Perstenev (big blind) folded before Flop
Seat 4: Gichboy folded before Flop (didn't bet)
Seat 5: chiyuki folded before Flop (didn't bet)
Seat 6: WARIBANA7777 folded before Flop (didn't bet)
Seat 7: Nerkit folded before Flop (didn't bet)
Seat 8: snejokCoxx folded before Flop (didn't bet)
Seat 9: cofla tito folded before Flop (didn't bet)



PokerStars Zoom Hand #84300461707:  Hold'em No Limit ($0.10/$0.25) - 2012/08/05 15:29:40 JST [2012/08/05 2:29:40 ET]
Table 'Whirlpool' 9-max Seat #1 is the button
Seat 1: kamikkaze ($13.78 in chips) 
Seat 2: kwkim73 ($38.74 in chips) 
Seat 3: Ellen1947 ($28.89 in chips) 
Seat 4: Perstenev ($8.40 in chips) 
Seat 5: God)Squall ($32.70 in chips) 
Seat 6: chiyuki ($49.69 in chips) 
Seat 7: Silveystryk ($37.62 in chips) 
Seat 8: WARIBANA7777 ($14.68 in chips) 
Seat 9: Dan Royal ($31.51 in chips) 
kwkim73: posts small blind $0.10
Ellen1947: posts big blind $0.25
*** HOLE CARDS ***
Dealt to chiyuki [8c 2h]
Perstenev: folds 
God)Squall: raises $0.50 to $0.75
chiyuki: folds 
Silveystryk: folds 
WARIBANA7777: folds 
Dan Royal: folds 
kamikkaze: calls $0.75
kwkim73: folds 
Ellen1947: folds 
*** FLOP *** [5c 9d Ac]
God)Squall: checks 
kamikkaze: checks 
*** TURN *** [5c 9d Ac] [Ad]
God)Squall: checks 
kamikkaze: checks 
*** RIVER *** [5c 9d Ac Ad] [7d]
God)Squall: checks 
kamikkaze: checks 
*** SHOW DOWN ***
God)Squall: shows [Jh Qh] (a pair of Aces)
kamikkaze: shows [8s 8h] (two pair, Aces and Eights)
kamikkaze collected $1.77 from pot
*** SUMMARY ***
Total pot $1.85 | Rake $0.08 
Board [5c 9d Ac Ad 7d]
Seat 1: kamikkaze (button) showed [8s 8h] and won ($1.77) with two pair, Aces and Eights
Seat 2: kwkim73 (small blind) folded before Flop
Seat 3: Ellen1947 (big blind) folded before Flop
Seat 4: Perstenev folded before Flop (didn't bet)
Seat 5: God)Squall showed [Jh Qh] and lost with a pair of Aces
Seat 6: chiyuki folded before Flop (didn't bet)
Seat 7: Silveystryk folded before Flop (didn't bet)
Seat 8: WARIBANA7777 folded before Flop (didn't bet)
Seat 9: Dan Royal folded before Flop (didn't bet)



PokerStars Zoom Hand #84300465832:  Hold'em No Limit ($0.10/$0.25) - 2012/08/05 15:29:56 JST [2012/08/05 2:29:56 ET]
Table 'Whirlpool' 9-max Seat #1 is the button
Seat 1: jacquelinewu ($72.52 in chips) 
Seat 2: Rilko1975 ($24.92 in chips) 
Seat 3: hldtom ($25 in chips) 
Seat 4: chiyuki ($49.69 in chips) 
Seat 5: Perstenev ($13.45 in chips) 
Seat 6: KeLevro0 ($14.45 in chips) 
Seat 7: Lasutchik ($12.15 in chips) 
Seat 8: silvno31 ($46.59 in chips) 
Seat 9: mjmichi ($55.62 in chips) 
Rilko1975: posts small blind $0.10
hldtom: posts big blind $0.25
*** HOLE CARDS ***
Dealt to chiyuki [Th Qc]
chiyuki: folds 
Perstenev: folds 
KeLevro0: folds 
Lasutchik: folds 
silvno31: folds 
mjmichi: folds 
jacquelinewu: raises $0.50 to $0.75
Rilko1975: folds 
hldtom: folds 
Uncalled bet ($0.50) returned to jacquelinewu
jacquelinewu collected $0.60 from pot
jacquelinewu: doesn't show hand 
*** SUMMARY ***
Total pot $0.60 | Rake $0 
Seat 1: jacquelinewu (button) collected ($0.60)
Seat 2: Rilko1975 (small blind) folded before Flop
Seat 3: hldtom (big blind) folded before Flop
Seat 4: chiyuki folded before Flop (didn't bet)
Seat 5: Perstenev folded before Flop (didn't bet)
Seat 6: KeLevro0 folded before Flop (didn't bet)
Seat 7: Lasutchik folded before Flop (didn't bet)
Seat 8: silvno31 folded before Flop (didn't bet)
Seat 9: mjmichi folded before Flop (didn't bet)



PokerStars Zoom Hand #84300460482:  Hold'em No Limit ($0.10/$0.25) - 2012/08/05 15:29:35 JST [2012/08/05 2:29:35 ET]
Table 'Whirlpool' 9-max Seat #1 is the button
Seat 1: chiyuki ($49.69 in chips) 
Seat 2: KimPa39 ($22.75 in chips) 
Seat 3: troublesomm ($25 in chips) 
Seat 4: Ellen1947 ($28.89 in chips) 
Seat 5: Gichboy ($28.33 in chips) 
Seat 6: mjmichi ($47.19 in chips) 
Seat 7: Faraz ($15.13 in chips) 
Seat 8: kwkim73 ($38.74 in chips) 
Seat 9: NuMetal88 ($28.24 in chips) 
KimPa39: posts small blind $0.10
troublesomm: posts big blind $0.25
*** HOLE CARDS ***
Dealt to chiyuki [4s 5d]
Ellen1947: folds 
Gichboy: folds 
mjmichi: folds 
Faraz: folds 
kwkim73: folds 
NuMetal88: raises $0.50 to $0.75
chiyuki: folds 
KimPa39: calls $0.65
troublesomm: folds 
*** FLOP *** [3d 9h As]
KimPa39: checks 
NuMetal88: bets $1.25
KimPa39: raises $2.25 to $3.50
NuMetal88: folds 
Uncalled bet ($2.25) returned to KimPa39
KimPa39 collected $4.06 from pot
KimPa39: doesn't show hand 
*** SUMMARY ***
Total pot $4.25 | Rake $0.19 
Board [3d 9h As]
Seat 1: chiyuki (button) folded before Flop (didn't bet)
Seat 2: KimPa39 (small blind) collected ($4.06)
Seat 3: troublesomm (big blind) folded before Flop
Seat 4: Ellen1947 folded before Flop (didn't bet)
Seat 5: Gichboy folded before Flop (didn't bet)
Seat 6: mjmichi folded before Flop (didn't bet)
Seat 7: Faraz folded before Flop (didn't bet)
Seat 8: kwkim73 folded before Flop (didn't bet)
Seat 9: NuMetal88 folded on the Flop



PokerStars Zoom Hand #84300466865:  Hold'em No Limit ($0.10/$0.25) - 2012/08/05 15:30:00 JST [2012/08/05 2:30:00 ET]
Table 'Whirlpool' 9-max Seat #1 is the button
Seat 1: silvno31 ($46.59 in chips) 
Seat 2: GovGus ($25.77 in chips) 
Seat 3: chiyuki ($49.69 in chips) 
Seat 4: deadmoneykid ($25.38 in chips) 
Seat 5: herkko11 ($11.22 in chips) 
Seat 6: Robchie ($17.68 in chips) 
Seat 7: ziggzagg77 ($11.88 in chips) 
Seat 8: cofla tito ($8.69 in chips) 
Seat 9: aSasha280 ($16.18 in chips) 
GovGus: posts small blind $0.10
chiyuki: posts big blind $0.25
*** HOLE CARDS ***
Dealt to chiyuki [Kd 8c]
deadmoneykid: folds 
herkko11: folds 
Robchie: folds 
ziggzagg77: folds 
cofla tito: raises $0.50 to $0.75
aSasha280: folds 
silvno31: folds 
GovGus: folds 
chiyuki: folds 
Uncalled bet ($0.50) returned to cofla tito
cofla tito collected $0.60 from pot
cofla tito: doesn't show hand 
*** SUMMARY ***
Total pot $0.60 | Rake $0 
Seat 1: silvno31 (button) folded before Flop (didn't bet)
Seat 2: GovGus (small blind) folded before Flop
Seat 3: chiyuki (big blind) folded before Flop
Seat 4: deadmoneykid folded before Flop (didn't bet)
Seat 5: herkko11 folded before Flop (didn't bet)
Seat 6: Robchie folded before Flop (didn't bet)
Seat 7: ziggzagg77 folded before Flop (didn't bet)
Seat 8: cofla tito collected ($0.60)
Seat 9: aSasha280 folded before Flop (didn't bet)



PokerStars Zoom Hand #84300471572:  Hold'em No Limit ($0.10/$0.25) - 2012/08/05 15:30:18 JST [2012/08/05 2:30:18 ET]
Table 'Whirlpool' 9-max Seat #1 is the button
Seat 1: 1Karina1 ($25.12 in chips) 
Seat 2: chiyuki ($49.44 in chips) 
Seat 3: turbotom122 ($14.20 in chips) 
Seat 4: INSP!RON ($40.65 in chips) 
Seat 5: River_GmbH ($15.35 in chips) 
Seat 6: kwkim73 ($25.35 in chips) 
Seat 7: nice.franki ($11.45 in chips) 
Seat 8: KeLevro0 ($10.01 in chips) 
Seat 9: KimPa39 ($24.94 in chips) 
chiyuki: posts small blind $0.10
turbotom122: posts big blind $0.25
*** HOLE CARDS ***
Dealt to chiyuki [9h 6d]
INSP!RON: folds 
River_GmbH: folds 
kwkim73: folds 
nice.franki: folds 
KeLevro0: folds 
KimPa39: folds 
1Karina1: folds 
chiyuki: folds 
Uncalled bet ($0.15) returned to turbotom122
turbotom122 collected $0.20 from pot
turbotom122: doesn't show hand 
*** SUMMARY ***
Total pot $0.20 | Rake $0 
Seat 1: 1Karina1 (button) folded before Flop (didn't bet)
Seat 2: chiyuki (small blind) folded before Flop
Seat 3: turbotom122 (big blind) collected ($0.20)
Seat 4: INSP!RON folded before Flop (didn't bet)
Seat 5: River_GmbH folded before Flop (didn't bet)
Seat 6: kwkim73 folded before Flop (didn't bet)
Seat 7: nice.franki folded before Flop (didn't bet)
Seat 8: KeLevro0 folded before Flop (didn't bet)
Seat 9: KimPa39 folded before Flop (didn't bet)



PokerStars Zoom Hand #84300464264:  Hold'em No Limit ($0.10/$0.25) - 2012/08/05 15:29:50 JST [2012/08/05 2:29:50 ET]
Table 'Whirlpool' 9-max Seat #1 is the button
Seat 1: ChrisCDee ($24.82 in chips) 
Seat 2: nice.franki ($9.80 in chips) 
Seat 3: Dejacob ($27.37 in chips) 
Seat 4: Roglus ($11.04 in chips) 
Seat 5: xxx Spb xxx ($25 in chips) 
Seat 6: troublesomm ($29.50 in chips) 
Seat 7: 1Karina1 ($25.12 in chips) 
Seat 8: HighDuka ($36.03 in chips) 
Seat 9: chiyuki ($49.69 in chips) 
nice.franki: posts small blind $0.10
Dejacob: posts big blind $0.25
*** HOLE CARDS ***
Dealt to chiyuki [5c Kh]
Roglus: folds 
xxx Spb xxx: folds 
troublesomm: folds 
1Karina1: folds 
HighDuka: folds 
chiyuki: folds 
ChrisCDee: folds 
nice.franki: raises $0.50 to $0.75
Dejacob: raises $1.75 to $2.50
nice.franki: raises $7.30 to $9.80 and is all-in
Dejacob: calls $7.30
*** FLOP *** [Ad 4h Ks]
*** TURN *** [Ad 4h Ks] [3c]
*** RIVER *** [Ad 4h Ks 3c] [5h]
*** SHOW DOWN ***
nice.franki: shows [Qc Qd] (a pair of Queens)
Dejacob: shows [Ac Qs] (a pair of Aces)
Dejacob collected $18.72 from pot
*** SUMMARY ***
Total pot $19.60 | Rake $0.88 
Board [Ad 4h Ks 3c 5h]
Seat 1: ChrisCDee (button) folded before Flop (didn't bet)
Seat 2: nice.franki (small blind) showed [Qc Qd] and lost with a pair of Queens
Seat 3: Dejacob (big blind) showed [Ac Qs] and won ($18.72) with a pair of Aces
Seat 4: Roglus folded before Flop (didn't bet)
Seat 5: xxx Spb xxx folded before Flop (didn't bet)
Seat 6: troublesomm folded before Flop (didn't bet)
Seat 7: 1Karina1 folded before Flop (didn't bet)
Seat 8: HighDuka folded before Flop (didn't bet)
Seat 9: chiyuki folded before Flop (didn't bet)



PokerStars Zoom Hand #84300470833:  Hold'em No Limit ($0.10/$0.25) - 2012/08/05 15:30:15 JST [2012/08/05 2:30:15 ET]
Table 'Whirlpool' 9-max Seat #1 is the button
Seat 1: deadmoneykid ($30.47 in chips) 
Seat 2: hldtom ($25 in chips) 
Seat 3: laurentzu84 ($29.62 in chips) 
Seat 4: troublesomm ($29.25 in chips) 
Seat 5: Dejacob ($25 in chips) 
Seat 6: Perstenev ($8.15 in chips) 
Seat 7: phate-1up ($86.05 in chips) 
Seat 8: chiyuki ($49.44 in chips) 
Seat 9: WARIBANA7777 ($14.43 in chips) 
hldtom: posts small blind $0.10
laurentzu84: posts big blind $0.25
*** HOLE CARDS ***
Dealt to chiyuki [5d 6c]
troublesomm: folds 
Dejacob: folds 
Perstenev: folds 
phate-1up: folds 
chiyuki: folds 
WARIBANA7777: folds 
deadmoneykid: raises $0.25 to $0.50
hldtom: raises $1.25 to $1.75
laurentzu84: folds 
deadmoneykid: folds 
Uncalled bet ($1.25) returned to hldtom
hldtom collected $1.25 from pot
hldtom: doesn't show hand 
*** SUMMARY ***
Total pot $1.25 | Rake $0 
Seat 1: deadmoneykid (button) folded before Flop
Seat 2: hldtom (small blind) collected ($1.25)
Seat 3: laurentzu84 (big blind) folded before Flop
Seat 4: troublesomm folded before Flop (didn't bet)
Seat 5: Dejacob folded before Flop (didn't bet)
Seat 6: Perstenev folded before Flop (didn't bet)
Seat 7: phate-1up folded before Flop (didn't bet)
Seat 8: chiyuki folded before Flop (didn't bet)
Seat 9: WARIBANA7777 folded before Flop (didn't bet)



PokerStars Zoom Hand #84300474831:  Hold'em No Limit ($0.10/$0.25) - 2012/08/05 15:30:31 JST [2012/08/05 2:30:31 ET]
Table 'Whirlpool' 9-max Seat #1 is the button
Seat 1: Jene4kaBest ($15.84 in chips) 
Seat 2: Lasutchik ($12.15 in chips) 
Seat 3: Wilcox76607 ($12.92 in chips) 
Seat 4: KeLevro0 ($10.01 in chips) 
Seat 5: fil740 ($8.13 in chips) 
Seat 6: seula i ($25 in chips) 
Seat 7: chiyuki ($49.34 in chips) 
Seat 8: phate-1up ($50.23 in chips) 
Seat 9: nice.franki ($11.11 in chips) 
Lasutchik: posts small blind $0.10
Wilcox76607: posts big blind $0.25
*** HOLE CARDS ***
Dealt to chiyuki [Js 2h]
KeLevro0: raises $0.42 to $0.67
fil740: folds 
seula i: folds 
chiyuki: folds 
phate-1up: folds 
nice.franki: folds 
Jene4kaBest: folds 
Lasutchik: folds 
Wilcox76607: folds 
Uncalled bet ($0.42) returned to KeLevro0
KeLevro0 collected $0.60 from pot
KeLevro0: doesn't show hand 
*** SUMMARY ***
Total pot $0.60 | Rake $0 
Seat 1: Jene4kaBest (button) folded before Flop (didn't bet)
Seat 2: Lasutchik (small blind) folded before Flop
Seat 3: Wilcox76607 (big blind) folded before Flop
Seat 4: KeLevro0 collected ($0.60)
Seat 5: fil740 folded before Flop (didn't bet)
Seat 6: seula i folded before Flop (didn't bet)
Seat 7: chiyuki folded before Flop (didn't bet)
Seat 8: phate-1up folded before Flop (didn't bet)
Seat 9: nice.franki folded before Flop (didn't bet)



PokerStars Zoom Hand #84300477504:  Hold'em No Limit ($0.10/$0.25) - 2012/08/05 15:30:43 JST [2012/08/05 2:30:43 ET]
Table 'Whirlpool' 9-max Seat #1 is the button
Seat 1: DutchShultzs ($25.67 in chips) 
Seat 2: KeLevro0 ($10.24 in chips) 
Seat 3: Grishukps ($13.10 in chips) 
Seat 4: cofla tito ($9.04 in chips) 
Seat 5: laurentzu84 ($29.37 in chips) 
Seat 6: chiyuki ($49.34 in chips) 
Seat 7: svg51 ($6.62 in chips) 
Seat 8: seula i ($25.29 in chips) 
Seat 9: nice.franki ($11.45 in chips) 
KeLevro0: posts small blind $0.10
Grishukps: posts big blind $0.25
*** HOLE CARDS ***
Dealt to chiyuki [6s 9d]
cofla tito: folds 
laurentzu84: folds 
chiyuki: folds 
svg51: folds 
seula i: raises $0.50 to $0.75
nice.franki: folds 
DutchShultzs: folds 
KeLevro0: folds 
Grishukps: folds 
Uncalled bet ($0.50) returned to seula i
seula i collected $0.60 from pot
seula i: doesn't show hand 
*** SUMMARY ***
Total pot $0.60 | Rake $0 
Seat 1: DutchShultzs (button) folded before Flop (didn't bet)
Seat 2: KeLevro0 (small blind) folded before Flop
Seat 3: Grishukps (big blind) folded before Flop
Seat 4: cofla tito folded before Flop (didn't bet)
Seat 5: laurentzu84 folded before Flop (didn't bet)
Seat 6: chiyuki folded before Flop (didn't bet)
Seat 7: svg51 folded before Flop (didn't bet)
Seat 8: seula i collected ($0.60)
Seat 9: nice.franki folded before Flop (didn't bet)



PokerStars Zoom Hand #84300479278:  Hold'em No Limit ($0.10/$0.25) - 2012/08/05 15:30:50 JST [2012/08/05 2:30:50 ET]
Table 'Whirlpool' 9-max Seat #1 is the button
Seat 1: nice.franki ($23.40 in chips) 
Seat 2: snejokCoxx ($11.77 in chips) 
Seat 3: WARIBANA7777 ($14.33 in chips) 
Seat 4: cofla tito ($11.21 in chips) 
Seat 5: 1Karina1 ($25 in chips) 
Seat 6: Wilcox76607 ($12.57 in chips) 
Seat 7: wildy29 ($40.14 in chips) 
Seat 8: chiyuki ($49.34 in chips) 
Seat 9: kamikkaze ($15.15 in chips) 
snejokCoxx: posts small blind $0.10
WARIBANA7777: posts big blind $0.25
*** HOLE CARDS ***
Dealt to chiyuki [Kd 2c]
cofla tito: raises $0.25 to $0.50
1Karina1: folds 
Wilcox76607: folds 
wildy29: folds 
chiyuki: folds 
kamikkaze: folds 
nice.franki: folds 
snejokCoxx: folds 
WARIBANA7777: folds 
Uncalled bet ($0.25) returned to cofla tito
cofla tito collected $0.60 from pot
cofla tito: doesn't show hand 
*** SUMMARY ***
Total pot $0.60 | Rake $0 
Seat 1: nice.franki (button) folded before Flop (didn't bet)
Seat 2: snejokCoxx (small blind) folded before Flop
Seat 3: WARIBANA7777 (big blind) folded before Flop
Seat 4: cofla tito collected ($0.60)
Seat 5: 1Karina1 folded before Flop (didn't bet)
Seat 6: Wilcox76607 folded before Flop (didn't bet)
Seat 7: wildy29 folded before Flop (didn't bet)
Seat 8: chiyuki folded before Flop (didn't bet)
Seat 9: kamikkaze folded before Flop (didn't bet)



PokerStars Zoom Hand #84300459482:  Hold'em No Limit ($0.10/$0.25) - 2012/08/05 15:29:31 JST [2012/08/05 2:29:31 ET]
Table 'Whirlpool' 9-max Seat #1 is the button
Seat 1: WARIBANA7777 ($14.68 in chips) 
Seat 2: snejokCoxx ($12.25 in chips) 
Seat 3: opie62 ($25.35 in chips) 
Seat 4: Alvinpe85 ($52.41 in chips) 
Seat 5: Tom1999 ($20.92 in chips) 
Seat 6: fima00000007 ($10.15 in chips) 
Seat 7: chiyuki ($49.69 in chips) 
Seat 8: JhonnyP1979 ($3.99 in chips) 
Seat 9: Rici47 ($30.79 in chips) 
snejokCoxx: posts small blind $0.10
opie62: posts big blind $0.25
*** HOLE CARDS ***
Dealt to chiyuki [Kd Jc]
Alvinpe85: raises $0.50 to $0.75
Tom1999: folds 
fima00000007: folds 
chiyuki: folds 
JhonnyP1979: folds 
Rici47: folds 
WARIBANA7777: folds 
snejokCoxx: folds 
opie62: calls $0.50
*** FLOP *** [Jh 4d Tc]
opie62: checks 
Alvinpe85: bets $1.07
opie62: raises $1.43 to $2.50
Alvinpe85: folds 
Uncalled bet ($1.43) returned to opie62
opie62 collected $3.57 from pot
opie62: doesn't show hand 
*** SUMMARY ***
Total pot $3.74 | Rake $0.17 
Board [Jh 4d Tc]
Seat 1: WARIBANA7777 (button) folded before Flop (didn't bet)
Seat 2: snejokCoxx (small blind) folded before Flop
Seat 3: opie62 (big blind) collected ($3.57)
Seat 4: Alvinpe85 folded on the Flop
Seat 5: Tom1999 folded before Flop (didn't bet)
Seat 6: fima00000007 folded before Flop (didn't bet)
Seat 7: chiyuki folded before Flop (didn't bet)
Seat 8: JhonnyP1979 folded before Flop (didn't bet)
Seat 9: Rici47 folded before Flop (didn't bet)



PokerStars Zoom Hand #84300476264:  Hold'em No Limit ($0.10/$0.25) - 2012/08/05 15:30:38 JST [2012/08/05 2:30:38 ET]
Table 'Whirlpool' 9-max Seat #1 is the button
Seat 1: Dejacob ($25 in chips) 
Seat 2: Wilcox76607 ($12.67 in chips) 
Seat 3: drunk_bender ($16.40 in chips) 
Seat 4: Grishukps ($12.50 in chips) 
Seat 5: seula i ($25 in chips) 
Seat 6: Jene4kaBest ($15.84 in chips) 
Seat 7: GovGus ($25.67 in chips) 
Seat 8: hirozo ($89.41 in chips) 
Seat 9: chiyuki ($49.34 in chips) 
Wilcox76607: posts small blind $0.10
drunk_bender: posts big blind $0.25
*** HOLE CARDS ***
Dealt to chiyuki [Jd 3h]
Grishukps: folds 
seula i: folds 
Jene4kaBest: folds 
GovGus: folds 
hirozo: folds 
chiyuki: folds 
Dejacob: raises $0.50 to $0.75
Wilcox76607: folds 
drunk_bender: folds 
Uncalled bet ($0.50) returned to Dejacob
Dejacob collected $0.60 from pot
Dejacob: doesn't show hand 
*** SUMMARY ***
Total pot $0.60 | Rake $0 
Seat 1: Dejacob (button) collected ($0.60)
Seat 2: Wilcox76607 (small blind) folded before Flop
Seat 3: drunk_bender (big blind) folded before Flop
Seat 4: Grishukps folded before Flop (didn't bet)
Seat 5: seula i folded before Flop (didn't bet)
Seat 6: Jene4kaBest folded before Flop (didn't bet)
Seat 7: GovGus folded before Flop (didn't bet)
Seat 8: hirozo folded before Flop (didn't bet)
Seat 9: chiyuki folded before Flop (didn't bet)



PokerStars Zoom Hand #84300472791:  Hold'em No Limit ($0.10/$0.25) - 2012/08/05 15:30:23 JST [2012/08/05 2:30:23 ET]
Table 'Whirlpool' 9-max Seat #1 is the button
Seat 1: chiyuki ($49.34 in chips) 
Seat 2: tribunpdm ($28.95 in chips) 
Seat 3: 1Karina1 ($25.12 in chips) 
Seat 4: KrystalAA ($36.89 in chips) 
Seat 5: GovGus ($38.94 in chips) 
Seat 6: Dejacob ($25 in chips) 
Seat 7: seula i ($25 in chips) 
Seat 8: INSP!RON ($42.60 in chips) 
Seat 9: cofla tito ($9.04 in chips) 
tribunpdm: posts small blind $0.10
1Karina1: posts big blind $0.25
*** HOLE CARDS ***
Dealt to chiyuki [9s Tc]
KrystalAA: folds 
GovGus: folds 
Dejacob: folds 
seula i: folds 
INSP!RON: raises $0.50 to $0.75
cofla tito: folds 
chiyuki: folds 
tribunpdm: calls $0.65
1Karina1: folds 
*** FLOP *** [6c 4c Kc]
tribunpdm: checks 
INSP!RON: bets $1.20
tribunpdm: folds 
Uncalled bet ($1.20) returned to INSP!RON
INSP!RON collected $1.67 from pot
INSP!RON: doesn't show hand 
*** SUMMARY ***
Total pot $1.75 | Rake $0.08 
Board [6c 4c Kc]
Seat 1: chiyuki (button) folded before Flop (didn't bet)
Seat 2: tribunpdm (small blind) folded on the Flop
Seat 3: 1Karina1 (big blind) folded before Flop
Seat 4: KrystalAA folded before Flop (didn't bet)
Seat 5: GovGus folded before Flop (didn't bet)
Seat 6: Dejacob folded before Flop (didn't bet)
Seat 7: seula i folded before Flop (didn't bet)
Seat 8: INSP!RON collected ($1.67)
Seat 9: cofla tito folded before Flop (didn't bet)



PokerStars Zoom Hand #84300480809:  Hold'em No Limit ($0.10/$0.25) - 2012/08/05 15:30:56 JST [2012/08/05 2:30:56 ET]
Table 'Whirlpool' 9-max Seat #1 is the button
Seat 1: NuMetal88 ($26.10 in chips) 
Seat 2: Roglus ($10.79 in chips) 
Seat 3: chiyuki ($49.34 in chips) 
Seat 4: WARIBANA7777 ($14.08 in chips) 
Seat 5: wildy29 ($40.14 in chips) 
Seat 6: KeLevro0 ($10.14 in chips) 
Seat 7: 1Karina1 ($37.55 in chips) 
Seat 8: ZhukOFFskI ($81.05 in chips) 
Seat 9: God)Squall ($31.60 in chips) 
Roglus: posts small blind $0.10
chiyuki: posts big blind $0.25
*** HOLE CARDS ***
Dealt to chiyuki [Td Th]
WARIBANA7777: folds 
wildy29: folds 
KeLevro0: folds 
1Karina1: folds 
ZhukOFFskI: folds 
God)Squall: folds 
NuMetal88: folds 
Roglus: folds 
Uncalled bet ($0.15) returned to chiyuki
chiyuki collected $0.20 from pot
chiyuki: doesn't show hand 
*** SUMMARY ***
Total pot $0.20 | Rake $0 
Seat 1: NuMetal88 (button) folded before Flop (didn't bet)
Seat 2: Roglus (small blind) folded before Flop
Seat 3: chiyuki (big blind) collected ($0.20)
Seat 4: WARIBANA7777 folded before Flop (didn't bet)
Seat 5: wildy29 folded before Flop (didn't bet)
Seat 6: KeLevro0 folded before Flop (didn't bet)
Seat 7: 1Karina1 folded before Flop (didn't bet)
Seat 8: ZhukOFFskI folded before Flop (didn't bet)
Seat 9: God)Squall folded before Flop (didn't bet)



PokerStars Zoom Hand #84300489607:  Hold'em No Limit ($0.10/$0.25) - 2012/08/05 15:31:30 JST [2012/08/05 2:31:30 ET]
Table 'Whirlpool' 9-max Seat #1 is the button
Seat 1: Faraz ($13.96 in chips) 
Seat 2: DutchShultzs ($37.06 in chips) 
Seat 3: Grishukps ($12.85 in chips) 
Seat 4: KeLevro0 ($10.14 in chips) 
Seat 5: kaplya2010 ($18.76 in chips) 
Seat 6: chiyuki ($49.34 in chips) 
Seat 7: Dejacob ($36.19 in chips) 
Seat 8: kwkim73 ($25 in chips) 
Seat 9: phate-1up ($49.88 in chips) 
DutchShultzs: posts small blind $0.10
Grishukps: posts big blind $0.25
*** HOLE CARDS ***
Dealt to chiyuki [4h 8s]
KeLevro0: folds 
kaplya2010: folds 
chiyuki: folds 
Dejacob: folds 
kwkim73: folds 
phate-1up: raises $0.50 to $0.75
Faraz: folds 
DutchShultzs: folds 
Grishukps: folds 
Uncalled bet ($0.50) returned to phate-1up
phate-1up collected $0.60 from pot
phate-1up: doesn't show hand 
*** SUMMARY ***
Total pot $0.60 | Rake $0 
Seat 1: Faraz (button) folded before Flop (didn't bet)
Seat 2: DutchShultzs (small blind) folded before Flop
Seat 3: Grishukps (big blind) folded before Flop
Seat 4: KeLevro0 folded before Flop (didn't bet)
Seat 5: kaplya2010 folded before Flop (didn't bet)
Seat 6: chiyuki folded before Flop (didn't bet)
Seat 7: Dejacob folded before Flop (didn't bet)
Seat 8: kwkim73 folded before Flop (didn't bet)
Seat 9: phate-1up collected ($0.60)



PokerStars Zoom Hand #84300491670:  Hold'em No Limit ($0.10/$0.25) - 2012/08/05 15:31:38 JST [2012/08/05 2:31:38 ET]
Table 'Whirlpool' 9-max Seat #1 is the button
Seat 1: chiyuki ($49.34 in chips) 
Seat 2: Serge Claws ($25 in chips) 
Seat 3: hirozo ($89.41 in chips) 
Seat 4: snejokCoxx ($11 in chips) 
Seat 5: masterkoolb ($13.87 in chips) 
Seat 6: NuMetal88 ($25.35 in chips) 
Seat 7: phate-1up ($31.15 in chips) 
Seat 8: Silveystryk ($21 in chips) 
Seat 9: Lasutchik ($11.80 in chips) 
Serge Claws: posts small blind $0.10
hirozo: posts big blind $0.25
*** HOLE CARDS ***
Dealt to chiyuki [6d Qs]
snejokCoxx: folds 
masterkoolb: folds 
NuMetal88: folds 
phate-1up: folds 
Silveystryk: folds 
Lasutchik: raises $0.50 to $0.75
chiyuki: folds 
Serge Claws: folds 
hirozo: folds 
Uncalled bet ($0.50) returned to Lasutchik
Lasutchik collected $0.60 from pot
Lasutchik: doesn't show hand 
*** SUMMARY ***
Total pot $0.60 | Rake $0 
Seat 1: chiyuki (button) folded before Flop (didn't bet)
Seat 2: Serge Claws (small blind) folded before Flop
Seat 3: hirozo (big blind) folded before Flop
Seat 4: snejokCoxx folded before Flop (didn't bet)
Seat 5: masterkoolb folded before Flop (didn't bet)
Seat 6: NuMetal88 folded before Flop (didn't bet)
Seat 7: phate-1up folded before Flop (didn't bet)
Seat 8: Silveystryk folded before Flop (didn't bet)
Seat 9: Lasutchik collected ($0.60)



PokerStars Zoom Hand #84300488816:  Hold'em No Limit ($0.10/$0.25) - 2012/08/05 15:31:27 JST [2012/08/05 2:31:27 ET]
Table 'Whirlpool' 9-max Seat #1 is the button
Seat 1: fil740 ($8.48 in chips) 
Seat 2: chiyuki ($49.44 in chips) 
Seat 3: jacquelinewu ($34.28 in chips) 
Seat 4: 1Karina1 ($25 in chips) 
Seat 5: turbotom122 ($15.59 in chips) 
Seat 6: deadmoneykid ($24.88 in chips) 
Seat 7: ZhukOFFskI ($35.18 in chips) 
Seat 8: Faantomace ($36.96 in chips) 
Seat 9: seula i ($25 in chips) 
chiyuki: posts small blind $0.10
jacquelinewu: posts big blind $0.25
*** HOLE CARDS ***
Dealt to chiyuki [9c 3h]
1Karina1: folds 
turbotom122: folds 
deadmoneykid: raises $0.50 to $0.75
ZhukOFFskI: folds 
Faantomace: folds 
seula i: calls $0.75
fil740: folds 
chiyuki: folds 
jacquelinewu: folds 
*** FLOP *** [As Js 7h]
deadmoneykid: checks 
seula i: checks 
*** TURN *** [As Js 7h] [Ts]
deadmoneykid: checks 
seula i: checks 
*** RIVER *** [As Js 7h Ts] [Qh]
deadmoneykid: bets $1.25
seula i: folds 
Uncalled bet ($1.25) returned to deadmoneykid
deadmoneykid collected $1.77 from pot
deadmoneykid: doesn't show hand 
*** SUMMARY ***
Total pot $1.85 | Rake $0.08 
Board [As Js 7h Ts Qh]
Seat 1: fil740 (button) folded before Flop (didn't bet)
Seat 2: chiyuki (small blind) folded before Flop
Seat 3: jacquelinewu (big blind) folded before Flop
Seat 4: 1Karina1 folded before Flop (didn't bet)
Seat 5: turbotom122 folded before Flop (didn't bet)
Seat 6: deadmoneykid collected ($1.77)
Seat 7: ZhukOFFskI folded before Flop (didn't bet)
Seat 8: Faantomace folded before Flop (didn't bet)
Seat 9: seula i folded on the River



PokerStars Zoom Hand #84300492675:  Hold'em No Limit ($0.10/$0.25) - 2012/08/05 15:31:42 JST [2012/08/05 2:31:42 ET]
Table 'Whirlpool' 9-max Seat #1 is the button
Seat 1: NuMetal88 ($25.35 in chips) 
Seat 2: Serge Claws ($25 in chips) 
Seat 3: God)Squall ($29.80 in chips) 
Seat 4: DutchShultzs ($25 in chips) 
Seat 5: chiyuki ($49.34 in chips) 
Seat 6: jacquelinewu ($35.87 in chips) 
Seat 7: 4ydo yogurt ($21.55 in chips) 
Seat 8: Nerkit ($13.66 in chips) 
Seat 9: Dejacob ($25 in chips) 
Serge Claws: posts small blind $0.10
God)Squall: posts big blind $0.25
*** HOLE CARDS ***
Dealt to chiyuki [3d Ad]
DutchShultzs: folds 
chiyuki: folds 
jacquelinewu: raises $0.50 to $0.75
4ydo yogurt: folds 
Nerkit: folds 
Dejacob: folds 
NuMetal88: folds 
Serge Claws: folds 
God)Squall: calls $0.50
*** FLOP *** [3h 9c 2s]
God)Squall: checks 
jacquelinewu: bets $0.25
God)Squall: calls $0.25
*** TURN *** [3h 9c 2s] [Tc]
God)Squall: checks 
jacquelinewu: checks 
*** RIVER *** [3h 9c 2s Tc] [8s]
God)Squall: checks 
jacquelinewu: checks 
*** SHOW DOWN ***
God)Squall: shows [4c 6c] (high card Ten)
jacquelinewu: shows [Kc Ac] (high card Ace)
jacquelinewu collected $2.01 from pot
*** SUMMARY ***
Total pot $2.10 | Rake $0.09 
Board [3h 9c 2s Tc 8s]
Seat 1: NuMetal88 (button) folded before Flop (didn't bet)
Seat 2: Serge Claws (small blind) folded before Flop
Seat 3: God)Squall (big blind) showed [4c 6c] and lost with high card Ten
Seat 4: DutchShultzs folded before Flop (didn't bet)
Seat 5: chiyuki folded before Flop (didn't bet)
Seat 6: jacquelinewu showed [Kc Ac] and won ($2.01) with high card Ace
Seat 7: 4ydo yogurt folded before Flop (didn't bet)
Seat 8: Nerkit folded before Flop (didn't bet)
Seat 9: Dejacob folded before Flop (didn't bet)



PokerStars Zoom Hand #84300486488:  Hold'em No Limit ($0.10/$0.25) - 2012/08/05 15:31:18 JST [2012/08/05 2:31:18 ET]
Table 'Whirlpool' 9-max Seat #1 is the button
Seat 1: opie62 ($27 in chips) 
Seat 2: 1Karina1 ($28.17 in chips) 
Seat 3: jacquelinewu ($73.12 in chips) 
Seat 4: GSDP ($42.58 in chips) 
Seat 5: chiyuki ($49.44 in chips) 
Seat 6: yane73 ($10.26 in chips) 
Seat 7: KeLevro0 ($10.14 in chips) 
Seat 8: Gichboy ($26.98 in chips) 
Seat 9: Silveystryk ($22.77 in chips) 
1Karina1: posts small blind $0.10
jacquelinewu: posts big blind $0.25
*** HOLE CARDS ***
Dealt to chiyuki [9h 8s]
GSDP: folds 
chiyuki: folds 
yane73: folds 
KeLevro0: folds 
Gichboy: folds 
Silveystryk: calls $0.25
opie62: calls $0.25
1Karina1: calls $0.15
jacquelinewu: checks 
*** FLOP *** [3c Ah 6s]
1Karina1: checks 
jacquelinewu: checks 
Silveystryk: bets $0.50
opie62: raises $0.75 to $1.25
1Karina1: folds 
jacquelinewu: folds 
Silveystryk: calls $0.75
*** TURN *** [3c Ah 6s] [2s]
Silveystryk: checks 
opie62: checks 
*** RIVER *** [3c Ah 6s 2s] [4h]
Silveystryk: checks 
opie62: checks 
*** SHOW DOWN ***
Silveystryk: shows [Ac 8c] (a pair of Aces)
opie62: shows [As Jh] (a pair of Aces - Jack kicker)
opie62 collected $3.34 from pot
*** SUMMARY ***
Total pot $3.50 | Rake $0.16 
Board [3c Ah 6s 2s 4h]
Seat 1: opie62 (button) showed [As Jh] and won ($3.34) with a pair of Aces
Seat 2: 1Karina1 (small blind) folded on the Flop
Seat 3: jacquelinewu (big blind) folded on the Flop
Seat 4: GSDP folded before Flop (didn't bet)
Seat 5: chiyuki folded before Flop (didn't bet)
Seat 6: yane73 folded before Flop (didn't bet)
Seat 7: KeLevro0 folded before Flop (didn't bet)
Seat 8: Gichboy folded before Flop (didn't bet)
Seat 9: Silveystryk showed [Ac 8c] and lost with a pair of Aces



PokerStars Zoom Hand #84300509275:  Hold'em No Limit ($0.10/$0.25) - 2012/08/05 15:32:48 JST [2012/08/05 2:32:48 ET]
Table 'Whirlpool' 9-max Seat #1 is the button
Seat 1: deadmoneykid ($29.32 in chips) 
Seat 2: rey2040 ($8.06 in chips) 
Seat 3: GovGus ($39.65 in chips) 
Seat 4: jacquelinewu ($25 in chips) 
Seat 5: phate-1up ($71.16 in chips) 
Seat 6: yvasilik ($27.50 in chips) 
Seat 7: chiyuki ($49.34 in chips) 
Seat 8: Robchie ($21.16 in chips) 
Seat 9: PPP7SSS ($23.47 in chips) 
rey2040: posts small blind $0.10
GovGus: posts big blind $0.25
*** HOLE CARDS ***
Dealt to chiyuki [Qh Jh]
jacquelinewu: folds 
phate-1up: folds 
yvasilik: folds 
chiyuki: raises $0.50 to $0.75
Robchie: calls $0.75
PPP7SSS: folds 
deadmoneykid: folds 
rey2040: folds 
GovGus: folds 
*** FLOP *** [Ks Ac 3h]
chiyuki: bets $1
Robchie: calls $1
*** TURN *** [Ks Ac 3h] [7c]
chiyuki: checks 
Robchie: bets $1.75
chiyuki: folds 
Uncalled bet ($1.75) returned to Robchie
Robchie collected $3.68 from pot
Robchie: doesn't show hand 
*** SUMMARY ***
Total pot $3.85 | Rake $0.17 
Board [Ks Ac 3h 7c]
Seat 1: deadmoneykid (button) folded before Flop (didn't bet)
Seat 2: rey2040 (small blind) folded before Flop
Seat 3: GovGus (big blind) folded before Flop
Seat 4: jacquelinewu folded before Flop (didn't bet)
Seat 5: phate-1up folded before Flop (didn't bet)
Seat 6: yvasilik folded before Flop (didn't bet)
Seat 7: chiyuki folded on the Turn
Seat 8: Robchie collected ($3.68)
Seat 9: PPP7SSS folded before Flop (didn't bet)



PokerStars Zoom Hand #84300504994:  Hold'em No Limit ($0.10/$0.25) - 2012/08/05 15:32:31 JST [2012/08/05 2:32:31 ET]
Table 'Whirlpool' 9-max Seat #1 is the button
Seat 1: jacquelinewu ($36.88 in chips) 
Seat 2: crazycrown1 ($13.06 in chips) 
Seat 3: Saruotiss ($62.31 in chips) 
Seat 4: herkko11 ($8.87 in chips) 
Seat 5: soul_5577 ($14.88 in chips) 
Seat 6: kamikkaze ($13.21 in chips) 
Seat 7: WARIBANA7777 ($15.45 in chips) 
Seat 8: chiyuki ($49.34 in chips) 
Seat 9: silvno31 ($44.17 in chips) 
crazycrown1: posts small blind $0.10
Saruotiss: posts big blind $0.25
*** HOLE CARDS ***
Dealt to chiyuki [9s 4s]
herkko11: folds 
soul_5577: folds 
kamikkaze: folds 
WARIBANA7777: folds 
chiyuki: folds 
silvno31: folds 
jacquelinewu: raises $0.25 to $0.50
crazycrown1: calls $0.40
Saruotiss: calls $0.25
*** FLOP *** [Jc Kh Ah]
crazycrown1: checks 
Saruotiss: checks 
jacquelinewu: checks 
*** TURN *** [Jc Kh Ah] [6d]
crazycrown1: checks 
Saruotiss: checks 
jacquelinewu: checks 
*** RIVER *** [Jc Kh Ah 6d] [Th]
crazycrown1: checks 
Saruotiss: checks 
jacquelinewu: checks 
*** SHOW DOWN ***
crazycrown1: shows [7d 9h] (high card Ace)
Saruotiss: shows [As 4h] (a pair of Aces)
jacquelinewu: mucks hand 
Saruotiss collected $1.43 from pot
*** SUMMARY ***
Total pot $1.50 | Rake $0.07 
Board [Jc Kh Ah 6d Th]
Seat 1: jacquelinewu (button) mucked [6s 8c]
Seat 2: crazycrown1 (small blind) showed [7d 9h] and lost with high card Ace
Seat 3: Saruotiss (big blind) showed [As 4h] and won ($1.43) with a pair of Aces
Seat 4: herkko11 folded before Flop (didn't bet)
Seat 5: soul_5577 folded before Flop (didn't bet)
Seat 6: kamikkaze folded before Flop (didn't bet)
Seat 7: WARIBANA7777 folded before Flop (didn't bet)
Seat 8: chiyuki folded before Flop (didn't bet)
Seat 9: silvno31 folded before Flop (didn't bet)



PokerStars Zoom Hand #84300517648:  Hold'em No Limit ($0.10/$0.25) - 2012/08/05 15:33:22 JST [2012/08/05 2:33:22 ET]
Table 'Whirlpool' 9-max Seat #1 is the button
Seat 1: slapshot2011 ($16.18 in chips) 
Seat 2: Rilko1975 ($23.92 in chips) 
Seat 3: chiyuki ($47.59 in chips) 
Seat 4: ZhukOFFskI ($21.45 in chips) 
Seat 5: hirozo ($43.43 in chips) 
Seat 6: 4ydo yogurt ($22.68 in chips) 
Seat 7: leo2095 ($19.65 in chips) 
Seat 8: fil740 ($9.61 in chips) 
Seat 9: Silveystryk ($37.18 in chips) 
Rilko1975: posts small blind $0.10
chiyuki: posts big blind $0.25
*** HOLE CARDS ***
Dealt to chiyuki [6d Ac]
ZhukOFFskI: folds 
hirozo: folds 
4ydo yogurt: folds 
leo2095: folds 
fil740: folds 
Silveystryk: folds 
slapshot2011: folds 
Rilko1975: folds 
Uncalled bet ($0.15) returned to chiyuki
chiyuki collected $0.20 from pot
chiyuki: doesn't show hand 
*** SUMMARY ***
Total pot $0.20 | Rake $0 
Seat 1: slapshot2011 (button) folded before Flop (didn't bet)
Seat 2: Rilko1975 (small blind) folded before Flop
Seat 3: chiyuki (big blind) collected ($0.20)
Seat 4: ZhukOFFskI folded before Flop (didn't bet)
Seat 5: hirozo folded before Flop (didn't bet)
Seat 6: 4ydo yogurt folded before Flop (didn't bet)
Seat 7: leo2095 folded before Flop (didn't bet)
Seat 8: fil740 folded before Flop (didn't bet)
Seat 9: Silveystryk folded before Flop (didn't bet)



PokerStars Zoom Hand #84300506461:  Hold'em No Limit ($0.10/$0.25) - 2012/08/05 15:32:37 JST [2012/08/05 2:32:37 ET]
Table 'Whirlpool' 9-max Seat #1 is the button
Seat 1: hirozo ($43.43 in chips) 
Seat 2: ZhukOFFskI ($35.28 in chips) 
Seat 3: WARIBANA7777 ($15.45 in chips) 
Seat 4: phate-1up ($71.16 in chips) 
Seat 5: Grishukps ($12.50 in chips) 
Seat 6: 1Karina1 ($25 in chips) 
Seat 7: Vahe50 ($15.36 in chips) 
Seat 8: kwkim73 ($28.49 in chips) 
Seat 9: chiyuki ($49.34 in chips) 
ZhukOFFskI: posts small blind $0.10
WARIBANA7777: posts big blind $0.25
*** HOLE CARDS ***
Dealt to chiyuki [Ac Th]
phate-1up: folds 
Grishukps: folds 
1Karina1: calls $0.25
Vahe50: folds 
kwkim73: folds 
chiyuki: folds 
hirozo: folds 
ZhukOFFskI: folds 
WARIBANA7777: checks 
*** FLOP *** [Js 2c Jh]
WARIBANA7777: checks 
1Karina1: bets $0.50
WARIBANA7777: calls $0.50
*** TURN *** [Js 2c Jh] [7c]
WARIBANA7777: checks 
1Karina1: checks 
*** RIVER *** [Js 2c Jh 7c] [8s]
WARIBANA7777: bets $0.70
1Karina1: folds 
Uncalled bet ($0.70) returned to WARIBANA7777
WARIBANA7777 collected $1.53 from pot
WARIBANA7777: doesn't show hand 
*** SUMMARY ***
Total pot $1.60 | Rake $0.07 
Board [Js 2c Jh 7c 8s]
Seat 1: hirozo (button) folded before Flop (didn't bet)
Seat 2: ZhukOFFskI (small blind) folded before Flop
Seat 3: WARIBANA7777 (big blind) collected ($1.53)
Seat 4: phate-1up folded before Flop (didn't bet)
Seat 5: Grishukps folded before Flop (didn't bet)
Seat 6: 1Karina1 folded on the River
Seat 7: Vahe50 folded before Flop (didn't bet)
Seat 8: kwkim73 folded before Flop (didn't bet)
Seat 9: chiyuki folded before Flop (didn't bet)



PokerStars Zoom Hand #84300521367:  Hold'em No Limit ($0.10/$0.25) - 2012/08/05 15:33:36 JST [2012/08/05 2:33:36 ET]
Table 'Whirlpool' 9-max Seat #1 is the button
Seat 1: Roglus ($11.72 in chips) 
Seat 2: chiyuki ($47.69 in chips) 
Seat 3: kamikkaze ($12.86 in chips) 
Seat 4: ZhukOFFskI ($35.18 in chips) 
Seat 5: Dejacob ($35.09 in chips) 
Seat 6: DutchShultzs ($25 in chips) 
Seat 7: Silveystryk ($21.27 in chips) 
Seat 8: Serge Claws ($25.97 in chips) 
Seat 9: Faraz ($13.78 in chips) 
chiyuki: posts small blind $0.10
kamikkaze: posts big blind $0.25
*** HOLE CARDS ***
Dealt to chiyuki [9s 9c]
ZhukOFFskI: folds 
Dejacob: folds 
DutchShultzs: folds 
Silveystryk: folds 
Serge Claws: raises $0.50 to $0.75
Faraz: folds 
Roglus: folds 
chiyuki: calls $0.65
kamikkaze: folds 
*** FLOP *** [5h 6d 7d]
chiyuki: checks 
Serge Claws: checks 
*** TURN *** [5h 6d 7d] [Qh]
chiyuki: bets $0.83
Serge Claws: folds 
Uncalled bet ($0.83) returned to chiyuki
chiyuki collected $1.67 from pot
chiyuki: doesn't show hand 
*** SUMMARY ***
Total pot $1.75 | Rake $0.08 
Board [5h 6d 7d Qh]
Seat 1: Roglus (button) folded before Flop (didn't bet)
Seat 2: chiyuki (small blind) collected ($1.67)
Seat 3: kamikkaze (big blind) folded before Flop
Seat 4: ZhukOFFskI folded before Flop (didn't bet)
Seat 5: Dejacob folded before Flop (didn't bet)
Seat 6: DutchShultzs folded before Flop (didn't bet)
Seat 7: Silveystryk folded before Flop (didn't bet)
Seat 8: Serge Claws folded on the Turn
Seat 9: Faraz folded before Flop (didn't bet)



PokerStars Zoom Hand #84300531254:  Hold'em No Limit ($0.10/$0.25) - 2012/08/05 15:34:16 JST [2012/08/05 2:34:16 ET]
Table 'Whirlpool' 9-max Seat #1 is the button
Seat 1: NuMetal88 ($25.35 in chips) 
Seat 2: Roglus ($12.07 in chips) 
Seat 3: nice.franki ($11.10 in chips) 
Seat 4: chiyuki ($48.61 in chips) 
Seat 5: kwkim73 ($25.79 in chips) 
Seat 6: KeLevro0 ($12.25 in chips) 
Seat 7: xxx Spb xxx ($25.25 in chips) 
Seat 8: Serge Claws ($26.10 in chips) 
Seat 9: jacquelinewu ($71.27 in chips) 
Roglus: posts small blind $0.10
nice.franki: posts big blind $0.25
*** HOLE CARDS ***
Dealt to chiyuki [2h Td]
chiyuki: folds 
kwkim73: folds 
KeLevro0: folds 
xxx Spb xxx: folds 
Serge Claws: folds 
jacquelinewu: folds 
NuMetal88: folds 
Roglus: folds 
Uncalled bet ($0.15) returned to nice.franki
nice.franki collected $0.20 from pot
nice.franki: doesn't show hand 
*** SUMMARY ***
Total pot $0.20 | Rake $0 
Seat 1: NuMetal88 (button) folded before Flop (didn't bet)
Seat 2: Roglus (small blind) folded before Flop
Seat 3: nice.franki (big blind) collected ($0.20)
Seat 4: chiyuki folded before Flop (didn't bet)
Seat 5: kwkim73 folded before Flop (didn't bet)
Seat 6: KeLevro0 folded before Flop (didn't bet)
Seat 7: xxx Spb xxx folded before Flop (didn't bet)
Seat 8: Serge Claws folded before Flop (didn't bet)
Seat 9: jacquelinewu folded before Flop (didn't bet)



PokerStars Zoom Hand #84300532275:  Hold'em No Limit ($0.10/$0.25) - 2012/08/05 15:34:20 JST [2012/08/05 2:34:20 ET]
Table 'Whirlpool' 9-max Seat #1 is the button
Seat 1: hldtom ($25 in chips) 
Seat 2: Wilcox76607 ($13.64 in chips) 
Seat 3: DutchShultzs ($26.38 in chips) 
Seat 4: kwkim73 ($28.76 in chips) 
Seat 5: Dan Royal ($41.58 in chips) 
Seat 6: Silveystryk ($37.97 in chips) 
Seat 7: chiyuki ($48.61 in chips) 
Seat 8: fil740 ($9.61 in chips) 
Seat 9: slapshot2011 ($13.18 in chips) 
Wilcox76607: posts small blind $0.10
DutchShultzs: posts big blind $0.25
*** HOLE CARDS ***
Dealt to chiyuki [2c 2h]
kwkim73: folds 
Dan Royal: folds 
Silveystryk: calls $0.25
chiyuki: folds 
fil740: folds 
slapshot2011: folds 
hldtom: folds 
Wilcox76607: folds 
DutchShultzs: checks 
*** FLOP *** [4c 7h 9d]
DutchShultzs: checks 
Silveystryk: bets $0.25
DutchShultzs: folds 
Uncalled bet ($0.25) returned to Silveystryk
Silveystryk collected $0.57 from pot
Silveystryk: doesn't show hand 
*** SUMMARY ***
Total pot $0.60 | Rake $0.03 
Board [4c 7h 9d]
Seat 1: hldtom (button) folded before Flop (didn't bet)
Seat 2: Wilcox76607 (small blind) folded before Flop
Seat 3: DutchShultzs (big blind) folded on the Flop
Seat 4: kwkim73 folded before Flop (didn't bet)
Seat 5: Dan Royal folded before Flop (didn't bet)
Seat 6: Silveystryk collected ($0.57)
Seat 7: chiyuki folded before Flop (didn't bet)
Seat 8: fil740 folded before Flop (didn't bet)
Seat 9: slapshot2011 folded before Flop (didn't bet)



PokerStars Zoom Hand #84300537837:  Hold'em No Limit ($0.10/$0.25) - 2012/08/05 15:34:42 JST [2012/08/05 2:34:42 ET]
Table 'Whirlpool' 9-max Seat #1 is the button
Seat 1: snejokCoxx ($12.15 in chips) 
Seat 2: xxx Spb xxx ($26.50 in chips) 
Seat 3: Spheroff ($24.12 in chips) 
Seat 4: phate-1up ($73.86 in chips) 
Seat 5: chiyuki ($48.61 in chips) 
Seat 6: kesstukas25 ($14.65 in chips) 
Seat 7: drunk_bender ($19.38 in chips) 
Seat 8: Rici47 ($30.54 in chips) 
Seat 9: wildy29 ($40.13 in chips) 
xxx Spb xxx: posts small blind $0.10
Spheroff: posts big blind $0.25
*** HOLE CARDS ***
Dealt to chiyuki [As 9s]
phate-1up: folds 
chiyuki: folds 
kesstukas25: folds 
drunk_bender: folds 
Rici47: raises $0.25 to $0.50
wildy29: folds 
snejokCoxx: folds 
xxx Spb xxx: folds 
Spheroff: calls $0.25
*** FLOP *** [9d 6s 2c]
Spheroff: checks 
Rici47: bets $0.75
Spheroff: folds 
Uncalled bet ($0.75) returned to Rici47
Rici47 collected $1.05 from pot
Rici47: doesn't show hand 
*** SUMMARY ***
Total pot $1.10 | Rake $0.05 
Board [9d 6s 2c]
Seat 1: snejokCoxx (button) folded before Flop (didn't bet)
Seat 2: xxx Spb xxx (small blind) folded before Flop
Seat 3: Spheroff (big blind) folded on the Flop
Seat 4: phate-1up folded before Flop (didn't bet)
Seat 5: chiyuki folded before Flop (didn't bet)
Seat 6: kesstukas25 folded before Flop (didn't bet)
Seat 7: drunk_bender folded before Flop (didn't bet)
Seat 8: Rici47 collected ($1.05)
Seat 9: wildy29 folded before Flop (didn't bet)



PokerStars Zoom Hand #84300537142:  Hold'em No Limit ($0.10/$0.25) - 2012/08/05 15:34:39 JST [2012/08/05 2:34:39 ET]
Table 'Whirlpool' 9-max Seat #1 is the button
Seat 1: KeLevro0 ($12.15 in chips) 
Seat 2: nice.franki ($11.20 in chips) 
Seat 3: yvasilik ($26.39 in chips) 
Seat 4: NuMetal88 ($29.90 in chips) 
Seat 5: seula i ($25 in chips) 
Seat 6: chiyuki ($48.61 in chips) 
Seat 7: kamikkaze ($12.26 in chips) 
Seat 8: 4ydo yogurt ($23.86 in chips) 
Seat 9: Nerkit ($13.74 in chips) 
nice.franki: posts small blind $0.10
yvasilik: posts big blind $0.25
*** HOLE CARDS ***
Dealt to chiyuki [Jh 3d]
NuMetal88: folds 
seula i: folds 
chiyuki: folds 
kamikkaze: raises $0.38 to $0.63
4ydo yogurt: folds 
Nerkit: folds 
KeLevro0: calls $0.63
nice.franki: folds 
yvasilik: calls $0.38
*** FLOP *** [6d Ah Kd]
yvasilik: checks 
kamikkaze: checks 
KeLevro0: bets $1.06
yvasilik: calls $1.06
kamikkaze: folds 
*** TURN *** [6d Ah Kd] [4d]
yvasilik: checks 
KeLevro0: checks 
*** RIVER *** [6d Ah Kd 4d] [7s]
yvasilik: bets $1
KeLevro0: calls $1
*** SHOW DOWN ***
yvasilik: shows [Ac 3c] (a pair of Aces)
KeLevro0: shows [As Tc] (a pair of Aces - King+Ten kicker)
KeLevro0 collected $5.84 from pot
*** SUMMARY ***
Total pot $6.11 | Rake $0.27 
Board [6d Ah Kd 4d 7s]
Seat 1: KeLevro0 (button) showed [As Tc] and won ($5.84) with a pair of Aces
Seat 2: nice.franki (small blind) folded before Flop
Seat 3: yvasilik (big blind) showed [Ac 3c] and lost with a pair of Aces
Seat 4: NuMetal88 folded before Flop (didn't bet)
Seat 5: seula i folded before Flop (didn't bet)
Seat 6: chiyuki folded before Flop (didn't bet)
Seat 7: kamikkaze folded on the Flop
Seat 8: 4ydo yogurt folded before Flop (didn't bet)
Seat 9: Nerkit folded before Flop (didn't bet)



PokerStars Zoom Hand #84300538617:  Hold'em No Limit ($0.10/$0.25) - 2012/08/05 15:34:45 JST [2012/08/05 2:34:45 ET]
Table 'Whirlpool' 9-max Seat #1 is the button
Seat 1: nastya040 ($16.06 in chips) 
Seat 2: ChrisCDee ($32.04 in chips) 
Seat 3: Wilcox76607 ($13.54 in chips) 
Seat 4: INSP!RON ($49.71 in chips) 
Seat 5: KeLevro0 ($11.90 in chips) 
Seat 6: KrystalAA ($18.40 in chips) 
Seat 7: seula i ($25 in chips) 
Seat 8: 1Karina1 ($35.95 in chips) 
Seat 9: chiyuki ($48.61 in chips) 
ChrisCDee: posts small blind $0.10
Wilcox76607: posts big blind $0.25
*** HOLE CARDS ***
Dealt to chiyuki [Jd As]
INSP!RON: folds 
KeLevro0: folds 
KrystalAA: folds 
seula i: folds 
1Karina1: folds 
chiyuki: raises $0.50 to $0.75
nastya040: folds 
ChrisCDee: folds 
Wilcox76607: calls $0.50
*** FLOP *** [8d Ts 6s]
Wilcox76607: checks 
chiyuki: bets $0.76
Wilcox76607: calls $0.76
*** TURN *** [8d Ts 6s] [3d]
Wilcox76607: checks 
chiyuki: checks 
*** RIVER *** [8d Ts 6s 3d] [5h]
Wilcox76607: bets $3
chiyuki: folds 
Uncalled bet ($3) returned to Wilcox76607
Wilcox76607 collected $2.98 from pot
Wilcox76607: doesn't show hand 
*** SUMMARY ***
Total pot $3.12 | Rake $0.14 
Board [8d Ts 6s 3d 5h]
Seat 1: nastya040 (button) folded before Flop (didn't bet)
Seat 2: ChrisCDee (small blind) folded before Flop
Seat 3: Wilcox76607 (big blind) collected ($2.98)
Seat 4: INSP!RON folded before Flop (didn't bet)
Seat 5: KeLevro0 folded before Flop (didn't bet)
Seat 6: KrystalAA folded before Flop (didn't bet)
Seat 7: seula i folded before Flop (didn't bet)
Seat 8: 1Karina1 folded before Flop (didn't bet)
Seat 9: chiyuki folded on the River



PokerStars Zoom Hand #84300535647:  Hold'em No Limit ($0.10/$0.25) - 2012/08/05 15:34:33 JST [2012/08/05 2:34:33 ET]
Table 'Whirlpool' 9-max Seat #1 is the button
Seat 1: chiyuki ($48.61 in chips) 
Seat 2: ZhukOFFskI ($20.82 in chips) 
Seat 3: GovGus ($25 in chips) 
Seat 4: Grishukps ($12.50 in chips) 
Seat 5: NuMetal88 ($29.90 in chips) 
Seat 6: jacquelinewu ($36.03 in chips) 
Seat 7: pandaaaaaa ($9.99 in chips) 
Seat 8: ViTiV2010 ($12.35 in chips) 
Seat 9: soul_5577 ($29.39 in chips) 
ZhukOFFskI: posts small blind $0.10
GovGus: posts big blind $0.25
*** HOLE CARDS ***
Dealt to chiyuki [2d 7h]
Grishukps: folds 
NuMetal88: folds 
jacquelinewu: raises $0.50 to $0.75
pandaaaaaa: calls $0.75
ViTiV2010: folds 
soul_5577: calls $0.75
chiyuki: folds 
ZhukOFFskI: folds 
GovGus: calls $0.50
*** FLOP *** [As 9h 6d]
GovGus: checks 
jacquelinewu: checks 
pandaaaaaa: checks 
soul_5577: bets $1
GovGus: calls $1
jacquelinewu: folds 
pandaaaaaa: folds 
*** TURN *** [As 9h 6d] [Qc]
GovGus: checks 
soul_5577: checks 
*** RIVER *** [As 9h 6d Qc] [4c]
GovGus: bets $2.75
soul_5577: calls $2.75
*** SHOW DOWN ***
GovGus: shows [6s 5s] (a pair of Sixes)
soul_5577: shows [Ah Jh] (a pair of Aces)
soul_5577 collected $10.12 from pot
*** SUMMARY ***
Total pot $10.60 | Rake $0.48 
Board [As 9h 6d Qc 4c]
Seat 1: chiyuki (button) folded before Flop (didn't bet)
Seat 2: ZhukOFFskI (small blind) folded before Flop
Seat 3: GovGus (big blind) showed [6s 5s] and lost with a pair of Sixes
Seat 4: Grishukps folded before Flop (didn't bet)
Seat 5: NuMetal88 folded before Flop (didn't bet)
Seat 6: jacquelinewu folded on the Flop
Seat 7: pandaaaaaa folded on the Flop
Seat 8: ViTiV2010 folded before Flop (didn't bet)
Seat 9: soul_5577 showed [Ah Jh] and won ($10.12) with a pair of Aces



PokerStars Zoom Hand #84300552766:  Hold'em No Limit ($0.10/$0.25) - 2012/08/05 15:35:42 JST [2012/08/05 2:35:42 ET]
Table 'Whirlpool' 9-max Seat #1 is the button
Seat 1: kamikkaze ($11.63 in chips) 
Seat 2: laurentzu84 ($43 in chips) 
Seat 3: Jene4kaBest ($12 in chips) 
Seat 4: chiyuki ($47.10 in chips) 
Seat 5: DutchShultzs ($25 in chips) 
Seat 6: Grishukps ($12.50 in chips) 
Seat 7: moku36 ($25 in chips) 
Seat 8: 1Karina1 ($26.59 in chips) 
Seat 9: mjmichi ($41.34 in chips) 
laurentzu84: posts small blind $0.10
Jene4kaBest: posts big blind $0.25
*** HOLE CARDS ***
Dealt to chiyuki [Ad 2h]
chiyuki: folds 
DutchShultzs: folds 
Grishukps: folds 
moku36: folds 
1Karina1: folds 
mjmichi: folds 
kamikkaze: folds 
laurentzu84: calls $0.15
Jene4kaBest: checks 
*** FLOP *** [6d Ts Qc]
laurentzu84: bets $0.75
Jene4kaBest: folds 
Uncalled bet ($0.75) returned to laurentzu84
laurentzu84 collected $0.48 from pot
laurentzu84: doesn't show hand 
*** SUMMARY ***
Total pot $0.50 | Rake $0.02 
Board [6d Ts Qc]
Seat 1: kamikkaze (button) folded before Flop (didn't bet)
Seat 2: laurentzu84 (small blind) collected ($0.48)
Seat 3: Jene4kaBest (big blind) folded on the Flop
Seat 4: chiyuki folded before Flop (didn't bet)
Seat 5: DutchShultzs folded before Flop (didn't bet)
Seat 6: Grishukps folded before Flop (didn't bet)
Seat 7: moku36 folded before Flop (didn't bet)
Seat 8: 1Karina1 folded before Flop (didn't bet)
Seat 9: mjmichi folded before Flop (didn't bet)



PokerStars Zoom Hand #84300557080:  Hold'em No Limit ($0.10/$0.25) - 2012/08/05 15:35:59 JST [2012/08/05 2:35:59 ET]
Table 'Whirlpool' 9-max Seat #1 is the button
Seat 1: Robchie ($23.37 in chips) 
Seat 2: Vahe50 ($14.32 in chips) 
Seat 3: chiyuki ($47.10 in chips) 
Seat 4: seula i ($25 in chips) 
Seat 5: INSP!RON ($46.60 in chips) 
Seat 6: Faantomace ($30.91 in chips) 
Seat 7: hldtom ($25 in chips) 
Seat 8: Dan Royal ($43.62 in chips) 
Seat 9: Rici47 ($30.64 in chips) 
Vahe50: posts small blind $0.10
chiyuki: posts big blind $0.25
*** HOLE CARDS ***
Dealt to chiyuki [3d 5d]
seula i: folds 
INSP!RON: folds 
Faantomace: folds 
hldtom: folds 
Dan Royal: folds 
Rici47: folds 
Robchie: folds 
Vahe50: raises $0.50 to $0.75
chiyuki: folds 
Uncalled bet ($0.50) returned to Vahe50
Vahe50 collected $0.50 from pot
Vahe50: doesn't show hand 
*** SUMMARY ***
Total pot $0.50 | Rake $0 
Seat 1: Robchie (button) folded before Flop (didn't bet)
Seat 2: Vahe50 (small blind) collected ($0.50)
Seat 3: chiyuki (big blind) folded before Flop
Seat 4: seula i folded before Flop (didn't bet)
Seat 5: INSP!RON folded before Flop (didn't bet)
Seat 6: Faantomace folded before Flop (didn't bet)
Seat 7: hldtom folded before Flop (didn't bet)
Seat 8: Dan Royal folded before Flop (didn't bet)
Seat 9: Rici47 folded before Flop (didn't bet)



PokerStars Zoom Hand #84300563423:  Hold'em No Limit ($0.10/$0.25) - 2012/08/05 15:36:24 JST [2012/08/05 2:36:24 ET]
Table 'Whirlpool' 9-max Seat #1 is the button
Seat 1: Grishukps ($12.50 in chips) 
Seat 2: Serge Claws ($41.61 in chips) 
Seat 3: Rici47 ($30.64 in chips) 
Seat 4: Perstenev ($19.12 in chips) 
Seat 5: aivvo ($10.12 in chips) 
Seat 6: KeLevro0 ($13.30 in chips) 
Seat 7: ZhukOFFskI ($79.96 in chips) 
Seat 8: chiyuki ($46.85 in chips) 
Seat 9: INSP!RON ($46.60 in chips) 
Serge Claws: posts small blind $0.10
Rici47: posts big blind $0.25
*** HOLE CARDS ***
Dealt to chiyuki [2s 6h]
Perstenev: folds 
aivvo: calls $0.25
KeLevro0: folds 
ZhukOFFskI: folds 
chiyuki: folds 
INSP!RON: raises $0.75 to $1
Grishukps: folds 
Serge Claws: folds 
Rici47: folds 
aivvo: calls $0.75
*** FLOP *** [Qs 5h 9s]
aivvo: checks 
INSP!RON: bets $1.10
aivvo: folds 
Uncalled bet ($1.10) returned to INSP!RON
INSP!RON collected $2.24 from pot
INSP!RON: doesn't show hand 
*** SUMMARY ***
Total pot $2.35 | Rake $0.11 
Board [Qs 5h 9s]
Seat 1: Grishukps (button) folded before Flop (didn't bet)
Seat 2: Serge Claws (small blind) folded before Flop
Seat 3: Rici47 (big blind) folded before Flop
Seat 4: Perstenev folded before Flop (didn't bet)
Seat 5: aivvo folded on the Flop
Seat 6: KeLevro0 folded before Flop (didn't bet)
Seat 7: ZhukOFFskI folded before Flop (didn't bet)
Seat 8: chiyuki folded before Flop (didn't bet)
Seat 9: INSP!RON collected ($2.24)



PokerStars Zoom Hand #84300568255:  Hold'em No Limit ($0.10/$0.25) - 2012/08/05 15:36:44 JST [2012/08/05 2:36:44 ET]
Table 'Whirlpool' 9-max Seat #1 is the button
Seat 1: Serge Claws ($26.39 in chips) 
Seat 2: chiyuki ($46.85 in chips) 
Seat 3: KrystalAA ($15.58 in chips) 
Seat 4: panaam ($26.49 in chips) 
Seat 5: ZhukOFFskI ($79.96 in chips) 
Seat 6: seula i ($29.56 in chips) 
Seat 7: kamikkaze ($10.88 in chips) 
Seat 8: opie62 ($30.92 in chips) 
Seat 9: DutchShultzs ($35 in chips) 
chiyuki: posts small blind $0.10
KrystalAA: posts big blind $0.25
*** HOLE CARDS ***
Dealt to chiyuki [Kd 4s]
panaam: folds 
ZhukOFFskI: folds 
seula i: folds 
kamikkaze: folds 
opie62: folds 
DutchShultzs: raises $0.50 to $0.75
Serge Claws: folds 
chiyuki: folds 
KrystalAA: folds 
Uncalled bet ($0.50) returned to DutchShultzs
DutchShultzs collected $0.60 from pot
DutchShultzs: doesn't show hand 
*** SUMMARY ***
Total pot $0.60 | Rake $0 
Seat 1: Serge Claws (button) folded before Flop (didn't bet)
Seat 2: chiyuki (small blind) folded before Flop
Seat 3: KrystalAA (big blind) folded before Flop
Seat 4: panaam folded before Flop (didn't bet)
Seat 5: ZhukOFFskI folded before Flop (didn't bet)
Seat 6: seula i folded before Flop (didn't bet)
Seat 7: kamikkaze folded before Flop (didn't bet)
Seat 8: opie62 folded before Flop (didn't bet)
Seat 9: DutchShultzs collected ($0.60)



PokerStars Zoom Hand #84300571866:  Hold'em No Limit ($0.10/$0.25) - 2012/08/05 15:36:58 JST [2012/08/05 2:36:58 ET]
Table 'Whirlpool' 9-max Seat #1 is the button
Seat 1: macmauret ($14.45 in chips) 
Seat 2: romanian c4 ($22.85 in chips) 
Seat 3: 1Karina1 ($35.60 in chips) 
Seat 4: jacquelinewu ($25.46 in chips) 
Seat 5: chiyuki ($46.75 in chips) 
Seat 6: ShaninPeter ($14.25 in chips) 
Seat 7: NuMetal88 ($28.85 in chips) 
Seat 8: snejokCoxx ($23.29 in chips) 
Seat 9: moku36 ($23.25 in chips) 
romanian c4: posts small blind $0.10
1Karina1: posts big blind $0.25
*** HOLE CARDS ***
Dealt to chiyuki [As 2s]
jacquelinewu: folds 
chiyuki: folds 
ShaninPeter: folds 
NuMetal88: folds 
snejokCoxx: folds 
moku36: folds 
macmauret: folds 
romanian c4: folds 
Uncalled bet ($0.15) returned to 1Karina1
1Karina1 collected $0.20 from pot
1Karina1: doesn't show hand 
*** SUMMARY ***
Total pot $0.20 | Rake $0 
Seat 1: macmauret (button) folded before Flop (didn't bet)
Seat 2: romanian c4 (small blind) folded before Flop
Seat 3: 1Karina1 (big blind) collected ($0.20)
Seat 4: jacquelinewu folded before Flop (didn't bet)
Seat 5: chiyuki folded before Flop (didn't bet)
Seat 6: ShaninPeter folded before Flop (didn't bet)
Seat 7: NuMetal88 folded before Flop (didn't bet)
Seat 8: snejokCoxx folded before Flop (didn't bet)
Seat 9: moku36 folded before Flop (didn't bet)



PokerStars Zoom Hand #84300572608:  Hold'em No Limit ($0.10/$0.25) - 2012/08/05 15:37:01 JST [2012/08/05 2:37:01 ET]
Table 'Whirlpool' 9-max Seat #1 is the button
Seat 1: Saruotiss ($64.06 in chips) 
Seat 2: ZhukOFFskI ($79.96 in chips) 
Seat 3: KeLevro0 ($11.69 in chips) 
Seat 4: WARIBANA7777 ($15.78 in chips) 
Seat 5: nice.franki ($17.76 in chips) 
Seat 6: chiyuki ($46.75 in chips) 
Seat 7: kwkim73 ($25.97 in chips) 
Seat 8: banderas761 ($21.47 in chips) 
Seat 9: INSP!RON ($49.56 in chips) 
ZhukOFFskI: posts small blind $0.10
KeLevro0: posts big blind $0.25
*** HOLE CARDS ***
Dealt to chiyuki [Ks 9h]
WARIBANA7777: folds 
nice.franki: folds 
chiyuki: folds 
kwkim73: folds 
banderas761: folds 
INSP!RON: folds 
Saruotiss: raises $0.50 to $0.75
ZhukOFFskI: folds 
KeLevro0: folds 
Uncalled bet ($0.50) returned to Saruotiss
Saruotiss collected $0.60 from pot
Saruotiss: doesn't show hand 
*** SUMMARY ***
Total pot $0.60 | Rake $0 
Seat 1: Saruotiss (button) collected ($0.60)
Seat 2: ZhukOFFskI (small blind) folded before Flop
Seat 3: KeLevro0 (big blind) folded before Flop
Seat 4: WARIBANA7777 folded before Flop (didn't bet)
Seat 5: nice.franki folded before Flop (didn't bet)
Seat 6: chiyuki folded before Flop (didn't bet)
Seat 7: kwkim73 folded before Flop (didn't bet)
Seat 8: banderas761 folded before Flop (didn't bet)
Seat 9: INSP!RON folded before Flop (didn't bet)



PokerStars Zoom Hand #84300574690:  Hold'em No Limit ($0.10/$0.25) - 2012/08/05 15:37:09 JST [2012/08/05 2:37:09 ET]
Table 'Whirlpool' 9-max Seat #1 is the button
Seat 1: chiyuki ($46.75 in chips) 
Seat 2: mjmichi ($57.22 in chips) 
Seat 3: Rilko1975 ($24.50 in chips) 
Seat 4: KeLevro0 ($13.05 in chips) 
Seat 5: kkbruins0408 ($12.85 in chips) 
Seat 6: Limoilou ($25 in chips) 
Seat 7: phate-1up ($60.23 in chips) 
Seat 8: ViTiV2010 ($12.10 in chips) 
Seat 9: Gichboy ($32.93 in chips) 
mjmichi: posts small blind $0.10
Rilko1975: posts big blind $0.25
*** HOLE CARDS ***
Dealt to chiyuki [3s 8d]
KeLevro0: folds 
kkbruins0408: folds 
Limoilou: folds 
phate-1up: folds 
ViTiV2010: folds 
Gichboy: folds 
chiyuki: folds 
mjmichi: folds 
Uncalled bet ($0.15) returned to Rilko1975
Rilko1975 collected $0.20 from pot
Rilko1975: doesn't show hand 
*** SUMMARY ***
Total pot $0.20 | Rake $0 
Seat 1: chiyuki (button) folded before Flop (didn't bet)
Seat 2: mjmichi (small blind) folded before Flop
Seat 3: Rilko1975 (big blind) collected ($0.20)
Seat 4: KeLevro0 folded before Flop (didn't bet)
Seat 5: kkbruins0408 folded before Flop (didn't bet)
Seat 6: Limoilou folded before Flop (didn't bet)
Seat 7: phate-1up folded before Flop (didn't bet)
Seat 8: ViTiV2010 folded before Flop (didn't bet)
Seat 9: Gichboy folded before Flop (didn't bet)



PokerStars Zoom Hand #84300581754:  Hold'em No Limit ($0.10/$0.25) - 2012/08/05 15:37:37 JST [2012/08/05 2:37:37 ET]
Table 'Whirlpool' 9-max Seat #1 is the button
Seat 1: KeLevro0 ($12.95 in chips) 
Seat 2: NuMetal88 ($38.89 in chips) 
Seat 3: ChrisCDee ($40.19 in chips) 
Seat 4: Ellen1947 ($23.20 in chips) 
Seat 5: yvasilik ($20.75 in chips) 
Seat 6: Perstenev ($11.40 in chips) 
Seat 7: mjmichi ($42.79 in chips) 
Seat 8: panaam ($26.24 in chips) 
Seat 9: chiyuki ($46.75 in chips) 
NuMetal88: posts small blind $0.10
ChrisCDee: posts big blind $0.25
*** HOLE CARDS ***
Dealt to chiyuki [8h 7c]
Ellen1947: folds 
yvasilik: folds 
Perstenev: folds 
mjmichi: folds 
panaam: folds 
chiyuki: folds 
KeLevro0: folds 
NuMetal88: folds 
Uncalled bet ($0.15) returned to ChrisCDee
ChrisCDee collected $0.20 from pot
ChrisCDee: doesn't show hand 
*** SUMMARY ***
Total pot $0.20 | Rake $0 
Seat 1: KeLevro0 (button) folded before Flop (didn't bet)
Seat 2: NuMetal88 (small blind) folded before Flop
Seat 3: ChrisCDee (big blind) collected ($0.20)
Seat 4: Ellen1947 folded before Flop (didn't bet)
Seat 5: yvasilik folded before Flop (didn't bet)
Seat 6: Perstenev folded before Flop (didn't bet)
Seat 7: mjmichi folded before Flop (didn't bet)
Seat 8: panaam folded before Flop (didn't bet)
Seat 9: chiyuki folded before Flop (didn't bet)



PokerStars Zoom Hand #84300582799:  Hold'em No Limit ($0.10/$0.25) - 2012/08/05 15:37:41 JST [2012/08/05 2:37:41 ET]
Table 'Whirlpool' 9-max Seat #1 is the button
Seat 1: 1Karina1 ($31.96 in chips) 
Seat 2: jacquelinewu ($74.61 in chips) 
Seat 3: INSP!RON ($47.61 in chips) 
Seat 4: chiyuki ($46.75 in chips) 
Seat 5: KrystalAA ($23.06 in chips) 
Seat 6: Serge Claws ($41.16 in chips) 
Seat 7: slapshot2011 ($10.58 in chips) 
Seat 8: GSDP ($45.78 in chips) 
Seat 9: yvasilik ($20.75 in chips) 
jacquelinewu: posts small blind $0.10
INSP!RON: posts big blind $0.25
*** HOLE CARDS ***
Dealt to chiyuki [6d 9d]
chiyuki: folds 
KrystalAA: folds 
Serge Claws: folds 
slapshot2011: folds 
GSDP: folds 
yvasilik: folds 
1Karina1: folds 
jacquelinewu: raises $0.50 to $0.75
INSP!RON: folds 
Uncalled bet ($0.50) returned to jacquelinewu
jacquelinewu collected $0.50 from pot
jacquelinewu: doesn't show hand 
*** SUMMARY ***
Total pot $0.50 | Rake $0 
Seat 1: 1Karina1 (button) folded before Flop (didn't bet)
Seat 2: jacquelinewu (small blind) collected ($0.50)
Seat 3: INSP!RON (big blind) folded before Flop
Seat 4: chiyuki folded before Flop (didn't bet)
Seat 5: KrystalAA folded before Flop (didn't bet)
Seat 6: Serge Claws folded before Flop (didn't bet)
Seat 7: slapshot2011 folded before Flop (didn't bet)
Seat 8: GSDP folded before Flop (didn't bet)
Seat 9: yvasilik folded before Flop (didn't bet)



PokerStars Zoom Hand #84300580730:  Hold'em No Limit ($0.10/$0.25) - 2012/08/05 15:37:33 JST [2012/08/05 2:37:33 ET]
Table 'Whirlpool' 9-max Seat #1 is the button
Seat 1: yvasilik ($20.75 in chips) 
Seat 2: snejokCoxx ($23.29 in chips) 
Seat 3: Serge Claws ($25 in chips) 
Seat 4: chiyuki ($46.75 in chips) 
Seat 5: tribunpdm ($42.95 in chips) 
Seat 6: jacquelinewu ($25.46 in chips) 
Seat 7: fil740 ($23.33 in chips) 
Seat 8: Perstenev ($11.40 in chips) 
Seat 9: GSDP ($45.78 in chips) 
snejokCoxx: posts small blind $0.10
Serge Claws: posts big blind $0.25
*** HOLE CARDS ***
Dealt to chiyuki [5s 9s]
chiyuki: folds 
tribunpdm: raises $0.50 to $0.75
jacquelinewu: folds 
fil740: folds 
Perstenev: folds 
GSDP: folds 
yvasilik: folds 
snejokCoxx: calls $0.65
Serge Claws: calls $0.50
*** FLOP *** [5c 2c Kd]
snejokCoxx: bets $1.65
Serge Claws: folds 
tribunpdm: folds 
Uncalled bet ($1.65) returned to snejokCoxx
snejokCoxx collected $2.15 from pot
snejokCoxx: doesn't show hand 
*** SUMMARY ***
Total pot $2.25 | Rake $0.10 
Board [5c 2c Kd]
Seat 1: yvasilik (button) folded before Flop (didn't bet)
Seat 2: snejokCoxx (small blind) collected ($2.15)
Seat 3: Serge Claws (big blind) folded on the Flop
Seat 4: chiyuki folded before Flop (didn't bet)
Seat 5: tribunpdm folded on the Flop
Seat 6: jacquelinewu folded before Flop (didn't bet)
Seat 7: fil740 folded before Flop (didn't bet)
Seat 8: Perstenev folded before Flop (didn't bet)
Seat 9: GSDP folded before Flop (didn't bet)



PokerStars Zoom Hand #84300576691:  Hold'em No Limit ($0.10/$0.25) - 2012/08/05 15:37:17 JST [2012/08/05 2:37:17 ET]
Table 'Whirlpool' 9-max Seat #1 is the button
Seat 1: Tom1999 ($20.85 in chips) 
Seat 2: Serge Claws ($26.14 in chips) 
Seat 3: kesstukas25 ($13.45 in chips) 
Seat 4: ZhukOFFskI ($79.86 in chips) 
Seat 5: Nerkit ($13.79 in chips) 
Seat 6: INSP!RON ($38.13 in chips) 
Seat 7: chiyuki ($46.75 in chips) 
Seat 8: 1Karina1 ($26.24 in chips) 
Seat 9: KeLevro0 ($11.44 in chips) 
Serge Claws: posts small blind $0.10
kesstukas25: posts big blind $0.25
*** HOLE CARDS ***
Dealt to chiyuki [9c Td]
ZhukOFFskI: folds 
Nerkit: folds 
INSP!RON: raises $0.50 to $0.75
chiyuki: folds 
1Karina1: folds 
KeLevro0: folds 
Tom1999: calls $0.75
Serge Claws: folds 
kesstukas25: folds 
*** FLOP *** [8h Ks 2s]
INSP!RON: bets $1.20
Tom1999: calls $1.20
*** TURN *** [8h Ks 2s] [Jc]
INSP!RON: checks 
Tom1999: bets $1.50
INSP!RON: calls $1.50
*** RIVER *** [8h Ks 2s Jc] [9d]
INSP!RON: checks 
Tom1999: checks 
*** SHOW DOWN ***
INSP!RON: shows [Jh Th] (a pair of Jacks)
Tom1999: mucks hand 
INSP!RON collected $6.92 from pot
*** SUMMARY ***
Total pot $7.25 | Rake $0.33 
Board [8h Ks 2s Jc 9d]
Seat 1: Tom1999 (button) mucked [Ac 8c]
Seat 2: Serge Claws (small blind) folded before Flop
Seat 3: kesstukas25 (big blind) folded before Flop
Seat 4: ZhukOFFskI folded before Flop (didn't bet)
Seat 5: Nerkit folded before Flop (didn't bet)
Seat 6: INSP!RON showed [Jh Th] and won ($6.92) with a pair of Jacks
Seat 7: chiyuki folded before Flop (didn't bet)
Seat 8: 1Karina1 folded before Flop (didn't bet)
Seat 9: KeLevro0 folded before Flop (didn't bet)



PokerStars Zoom Hand #84300583837:  Hold'em No Limit ($0.10/$0.25) - 2012/08/05 15:37:45 JST [2012/08/05 2:37:45 ET]
Table 'Whirlpool' 9-max Seat #1 is the button
Seat 1: Rilko1975 ($24.50 in chips) 
Seat 2: WARIBANA7777 ($15.88 in chips) 
Seat 3: chiyuki ($46.75 in chips) 
Seat 4: hirozo ($72.89 in chips) 
Seat 5: GovGus ($38.20 in chips) 
Seat 6: Grishukps ($12.50 in chips) 
Seat 7: Ellen1947 ($25 in chips) 
Seat 8: slapshot2011 ($10.58 in chips) 
Seat 9: turbotom122 ($25 in chips) 
WARIBANA7777: posts small blind $0.10
chiyuki: posts big blind $0.25
*** HOLE CARDS ***
Dealt to chiyuki [Jd 9h]
hirozo: folds 
GovGus: folds 
Grishukps: folds 
Ellen1947: folds 
slapshot2011: folds 
turbotom122: folds 
Rilko1975: raises $0.25 to $0.50
WARIBANA7777: folds 
chiyuki: calls $0.25
*** FLOP *** [Th 3h 2s]
chiyuki: checks 
Rilko1975: bets $1
chiyuki: folds 
Uncalled bet ($1) returned to Rilko1975
Rilko1975 collected $1.05 from pot
Rilko1975: doesn't show hand 
*** SUMMARY ***
Total pot $1.10 | Rake $0.05 
Board [Th 3h 2s]
Seat 1: Rilko1975 (button) collected ($1.05)
Seat 2: WARIBANA7777 (small blind) folded before Flop
Seat 3: chiyuki (big blind) folded on the Flop
Seat 4: hirozo folded before Flop (didn't bet)
Seat 5: GovGus folded before Flop (didn't bet)
Seat 6: Grishukps folded before Flop (didn't bet)
Seat 7: Ellen1947 folded before Flop (didn't bet)
Seat 8: slapshot2011 folded before Flop (didn't bet)
Seat 9: turbotom122 folded before Flop (didn't bet)



PokerStars Zoom Hand #84300592205:  Hold'em No Limit ($0.10/$0.25) - 2012/08/05 15:38:19 JST [2012/08/05 2:38:19 ET]
Table 'Whirlpool' 9-max Seat #1 is the button
Seat 1: Faraz ($20.42 in chips) 
Seat 2: Serge Claws ($25 in chips) 
Seat 3: kamikkaze ($20.78 in chips) 
Seat 4: kwkim73 ($32.01 in chips) 
Seat 5: ViTiV2010 ($12 in chips) 
Seat 6: KeLevro0 ($10.45 in chips) 
Seat 7: hirozo ($72.89 in chips) 
Seat 8: chiyuki ($46.25 in chips) 
Seat 9: KrystalAA ($20.04 in chips) 
Serge Claws: posts small blind $0.10
kamikkaze: posts big blind $0.25
*** HOLE CARDS ***
Dealt to chiyuki [Jd 4c]
kwkim73: folds 
ViTiV2010: folds 
KeLevro0: folds 
hirozo: raises $0.50 to $0.75
chiyuki: folds 
KrystalAA: folds 
Faraz: folds 
Serge Claws: folds 
kamikkaze: folds 
Uncalled bet ($0.50) returned to hirozo
hirozo collected $0.60 from pot
hirozo: doesn't show hand 
*** SUMMARY ***
Total pot $0.60 | Rake $0 
Seat 1: Faraz (button) folded before Flop (didn't bet)
Seat 2: Serge Claws (small blind) folded before Flop
Seat 3: kamikkaze (big blind) folded before Flop
Seat 4: kwkim73 folded before Flop (didn't bet)
Seat 5: ViTiV2010 folded before Flop (didn't bet)
Seat 6: KeLevro0 folded before Flop (didn't bet)
Seat 7: hirozo collected ($0.60)
Seat 8: chiyuki folded before Flop (didn't bet)
Seat 9: KrystalAA folded before Flop (didn't bet)



PokerStars Zoom Hand #84300596007:  Hold'em No Limit ($0.10/$0.25) - 2012/08/05 15:38:34 JST [2012/08/05 2:38:34 ET]
Table 'Whirlpool' 9-max Seat #1 is the button
Seat 1: romanian c4 ($19.50 in chips) 
Seat 2: chiyuki ($46.25 in chips) 
Seat 3: KrystalAA ($20.04 in chips) 
Seat 4: kamikkaze ($20.53 in chips) 
Seat 5: KeLevro0 ($12.70 in chips) 
Seat 6: Ellen1947 ($22.95 in chips) 
Seat 7: jacquelinewu ($29.93 in chips) 
Seat 8: INSP!RON ($47.61 in chips) 
Seat 9: DutchShultzs ($45.96 in chips) 
chiyuki: posts small blind $0.10
KrystalAA: posts big blind $0.25
*** HOLE CARDS ***
Dealt to chiyuki [2d 6c]
kamikkaze: folds 
KeLevro0: folds 
Ellen1947: folds 
jacquelinewu: folds 
INSP!RON: raises $0.50 to $0.75
DutchShultzs: raises $2.05 to $2.80
romanian c4: folds 
chiyuki: folds 
KrystalAA: folds 
INSP!RON: folds 
Uncalled bet ($2.05) returned to DutchShultzs
DutchShultzs collected $1.85 from pot
DutchShultzs: doesn't show hand 
*** SUMMARY ***
Total pot $1.85 | Rake $0 
Seat 1: romanian c4 (button) folded before Flop (didn't bet)
Seat 2: chiyuki (small blind) folded before Flop
Seat 3: KrystalAA (big blind) folded before Flop
Seat 4: kamikkaze folded before Flop (didn't bet)
Seat 5: KeLevro0 folded before Flop (didn't bet)
Seat 6: Ellen1947 folded before Flop (didn't bet)
Seat 7: jacquelinewu folded before Flop (didn't bet)
Seat 8: INSP!RON folded before Flop
Seat 9: DutchShultzs collected ($1.85)



PokerStars Zoom Hand #84300593968:  Hold'em No Limit ($0.10/$0.25) - 2012/08/05 15:38:26 JST [2012/08/05 2:38:26 ET]
Table 'Whirlpool' 9-max Seat #1 is the button
Seat 1: masterkoolb ($15.71 in chips) 
Seat 2: jvds114 ($25 in chips) 
Seat 3: 1Karina1 ($32.31 in chips) 
Seat 4: AAAKK777 ($12.86 in chips) 
Seat 5: chiyuki ($46.25 in chips) 
Seat 6: silvno31 ($70.79 in chips) 
Seat 7: Serge Claws ($25 in chips) 
Seat 8: herkko11 ($4.97 in chips) 
Seat 9: pandaaaaaa ($11.12 in chips) 
jvds114: posts small blind $0.10
1Karina1: posts big blind $0.25
*** HOLE CARDS ***
Dealt to chiyuki [2s 4h]
AAAKK777: raises $0.25 to $0.50
chiyuki: folds 
silvno31: folds 
Serge Claws: folds 
herkko11: folds 
pandaaaaaa: folds 
masterkoolb: folds 
jvds114: calls $0.40
1Karina1: folds 
*** FLOP *** [8c Ad 3c]
jvds114: checks 
AAAKK777: checks 
*** TURN *** [8c Ad 3c] [7s]
jvds114: bets $0.50
AAAKK777: calls $0.50
*** RIVER *** [8c Ad 3c 7s] [Tc]
jvds114: bets $2.25
AAAKK777: calls $2.25
*** SHOW DOWN ***
jvds114: shows [Ah Th] (two pair, Aces and Tens)
AAAKK777: mucks hand 
jvds114 collected $6.45 from pot
*** SUMMARY ***
Total pot $6.75 | Rake $0.30 
Board [8c Ad 3c 7s Tc]
Seat 1: masterkoolb (button) folded before Flop (didn't bet)
Seat 2: jvds114 (small blind) showed [Ah Th] and won ($6.45) with two pair, Aces and Tens
Seat 3: 1Karina1 (big blind) folded before Flop
Seat 4: AAAKK777 mucked [8d Jh]
Seat 5: chiyuki folded before Flop (didn't bet)
Seat 6: silvno31 folded before Flop (didn't bet)
Seat 7: Serge Claws folded before Flop (didn't bet)
Seat 8: herkko11 folded before Flop (didn't bet)
Seat 9: pandaaaaaa folded before Flop (didn't bet)



PokerStars Zoom Hand #84300600047:  Hold'em No Limit ($0.10/$0.25) - 2012/08/05 15:38:50 JST [2012/08/05 2:38:50 ET]
Table 'Whirlpool' 9-max Seat #1 is the button
Seat 1: Grishukps ($12.50 in chips) 
Seat 2: Nerkit ($14.22 in chips) 
Seat 3: yvasilik ($20.40 in chips) 
Seat 4: KeLevro0 ($11.88 in chips) 
Seat 5: NENE54 ($19.35 in chips) 
Seat 6: chiyuki ($46.15 in chips) 
Seat 7: Perstenev ($24.18 in chips) 
Seat 8: masterkoolb ($15.46 in chips) 
Seat 9: Ellen1947 ($22.85 in chips) 
Nerkit: posts small blind $0.10
yvasilik: posts big blind $0.25
*** HOLE CARDS ***
Dealt to chiyuki [8d Ah]
KeLevro0: folds 
NENE54: folds 
chiyuki: folds 
Perstenev: calls $0.25
masterkoolb: folds 
Ellen1947: folds 
Grishukps: folds 
Nerkit: folds 
yvasilik: checks 
*** FLOP *** [5h Ad 9c]
yvasilik: checks 
Perstenev: bets $0.25
yvasilik: calls $0.25
*** TURN *** [5h Ad 9c] [5c]
yvasilik: checks 
Perstenev: checks 
*** RIVER *** [5h Ad 9c 5c] [7s]
yvasilik: checks 
Perstenev: checks 
*** SHOW DOWN ***
yvasilik: shows [Qc 9h] (two pair, Nines and Fives)
Perstenev: mucks hand 
yvasilik collected $1.05 from pot
*** SUMMARY ***
Total pot $1.10 | Rake $0.05 
Board [5h Ad 9c 5c 7s]
Seat 1: Grishukps (button) folded before Flop (didn't bet)
Seat 2: Nerkit (small blind) folded before Flop
Seat 3: yvasilik (big blind) showed [Qc 9h] and won ($1.05) with two pair, Nines and Fives
Seat 4: KeLevro0 folded before Flop (didn't bet)
Seat 5: NENE54 folded before Flop (didn't bet)
Seat 6: chiyuki folded before Flop (didn't bet)
Seat 7: Perstenev mucked [6s 6c]
Seat 8: masterkoolb folded before Flop (didn't bet)
Seat 9: Ellen1947 folded before Flop (didn't bet)



PokerStars Zoom Hand #84300598309:  Hold'em No Limit ($0.10/$0.25) - 2012/08/05 15:38:43 JST [2012/08/05 2:38:43 ET]
Table 'Whirlpool' 9-max Seat #1 is the button
Seat 1: chiyuki ($46.15 in chips) 
Seat 2: kesstukas25 ($23.29 in chips) 
Seat 3: wildy29 ($39.97 in chips) 
Seat 4: kwkim73 ($26.95 in chips) 
Seat 5: ViTiV2010 ($11.38 in chips) 
Seat 6: phate-1up ($62.73 in chips) 
Seat 7: Fructionar ($26.81 in chips) 
Seat 8: Rici47 ($30.79 in chips) 
Seat 9: yvasilik ($20.40 in chips) 
kesstukas25: posts small blind $0.10
wildy29: posts big blind $0.25
*** HOLE CARDS ***
Dealt to chiyuki [6c 5h]
kwkim73: folds 
ViTiV2010: folds 
phate-1up: folds 
Fructionar: folds 
Rici47: raises $0.25 to $0.50
yvasilik: folds 
chiyuki: folds 
kesstukas25: folds 
wildy29: calls $0.25
*** FLOP *** [6d 7h 8d]
wildy29: bets $0.25
Rici47: raises $0.50 to $0.75
wildy29: calls $0.50
*** TURN *** [6d 7h 8d] [3s]
wildy29: checks 
Rici47: bets $1
wildy29: folds 
Uncalled bet ($1) returned to Rici47
Rici47 collected $2.48 from pot
Rici47: doesn't show hand 
*** SUMMARY ***
Total pot $2.60 | Rake $0.12 
Board [6d 7h 8d 3s]
Seat 1: chiyuki (button) folded before Flop (didn't bet)
Seat 2: kesstukas25 (small blind) folded before Flop
Seat 3: wildy29 (big blind) folded on the Turn
Seat 4: kwkim73 folded before Flop (didn't bet)
Seat 5: ViTiV2010 folded before Flop (didn't bet)
Seat 6: phate-1up folded before Flop (didn't bet)
Seat 7: Fructionar folded before Flop (didn't bet)
Seat 8: Rici47 collected ($2.48)
Seat 9: yvasilik folded before Flop (didn't bet)



PokerStars Zoom Hand #84300603170:  Hold'em No Limit ($0.10/$0.25) - 2012/08/05 15:39:02 JST [2012/08/05 2:39:02 ET]
Table 'Whirlpool' 9-max Seat #1 is the button
Seat 1: 1Karina1 ($25.89 in chips) 
Seat 2: svg51 ($3.89 in chips) 
Seat 3: aivvo ($10.23 in chips) 
Seat 4: seula i ($26 in chips) 
Seat 5: Grishukps ($12.85 in chips) 
Seat 6: chiyuki ($46.15 in chips) 
Seat 7: Rilko1975 ($24.80 in chips) 
Seat 8: NuMetal88 ($28.50 in chips) 
Seat 9: Silveystryk ($38.11 in chips) 
svg51: posts small blind $0.10
aivvo: posts big blind $0.25
*** HOLE CARDS ***
Dealt to chiyuki [9h 7c]
seula i: folds 
Grishukps: folds 
chiyuki: folds 
Rilko1975: folds 
NuMetal88: folds 
Silveystryk: folds 
1Karina1: folds 
svg51: calls $0.15
aivvo: checks 
*** FLOP *** [7d Jc 8c]
svg51: checks 
aivvo: checks 
*** TURN *** [7d Jc 8c] [9s]
svg51: checks 
aivvo: bets $0.25
svg51: calls $0.25
*** RIVER *** [7d Jc 8c 9s] [Jd]
svg51: checks 
aivvo: checks 
*** SHOW DOWN ***
svg51: shows [Kd 6s] (a pair of Jacks)
aivvo: mucks hand 
svg51 collected $0.96 from pot
*** SUMMARY ***
Total pot $1 | Rake $0.04 
Board [7d Jc 8c 9s Jd]
Seat 1: 1Karina1 (button) folded before Flop (didn't bet)
Seat 2: svg51 (small blind) showed [Kd 6s] and won ($0.96) with a pair of Jacks
Seat 3: aivvo (big blind) mucked [4d Qc]
Seat 4: seula i folded before Flop (didn't bet)
Seat 5: Grishukps folded before Flop (didn't bet)
Seat 6: chiyuki folded before Flop (didn't bet)
Seat 7: Rilko1975 folded before Flop (didn't bet)
Seat 8: NuMetal88 folded before Flop (didn't bet)
Seat 9: Silveystryk folded before Flop (didn't bet)



PokerStars Zoom Hand #84300604188:  Hold'em No Limit ($0.10/$0.25) - 2012/08/05 15:39:07 JST [2012/08/05 2:39:07 ET]
Table 'Whirlpool' 9-max Seat #1 is the button
Seat 1: ZhukOFFskI ($35.53 in chips) 
Seat 2: INSP!RON ($41.70 in chips) 
Seat 3: chiyuki ($46.15 in chips) 
Seat 4: Alvinpe85 ($54.44 in chips) 
Seat 5: DutchShultzs ($35.10 in chips) 
Seat 6: kwkim73 ($32.01 in chips) 
Seat 7: 4plankton ($26.60 in chips) 
Seat 8: 500Ang ($24.65 in chips) 
Seat 9: GovGus ($41.45 in chips) 
INSP!RON: posts small blind $0.10
chiyuki: posts big blind $0.25
*** HOLE CARDS ***
Dealt to chiyuki [7c Js]
Alvinpe85: folds 
DutchShultzs: folds 
kwkim73: raises $0.50 to $0.75
4plankton: folds 
500Ang: folds 
GovGus: calls $0.75
ZhukOFFskI: folds 
INSP!RON: folds 
chiyuki: folds 
*** FLOP *** [5s Jd 4c]
kwkim73: checks 
GovGus: bets $1.15
kwkim73: folds 
Uncalled bet ($1.15) returned to GovGus
GovGus collected $1.77 from pot
GovGus: doesn't show hand 
*** SUMMARY ***
Total pot $1.85 | Rake $0.08 
Board [5s Jd 4c]
Seat 1: ZhukOFFskI (button) folded before Flop (didn't bet)
Seat 2: INSP!RON (small blind) folded before Flop
Seat 3: chiyuki (big blind) folded before Flop
Seat 4: Alvinpe85 folded before Flop (didn't bet)
Seat 5: DutchShultzs folded before Flop (didn't bet)
Seat 6: kwkim73 folded on the Flop
Seat 7: 4plankton folded before Flop (didn't bet)
Seat 8: 500Ang folded before Flop (didn't bet)
Seat 9: GovGus collected ($1.77)



PokerStars Zoom Hand #84300611324:  Hold'em No Limit ($0.10/$0.25) - 2012/08/05 15:39:35 JST [2012/08/05 2:39:35 ET]
Table 'Whirlpool' 9-max Seat #1 is the button
Seat 1: phate-1up ($61.95 in chips) 
Seat 2: chiyuki ($45.90 in chips) 
Seat 3: Alvinpe85 ($48.99 in chips) 
Seat 4: Silveystryk ($38.11 in chips) 
Seat 5: God)Squall ($32.29 in chips) 
Seat 6: 1Karina1 ($36.22 in chips) 
Seat 7: Faantomace ($30.54 in chips) 
Seat 8: 4plankton ($26.50 in chips) 
Seat 9: seula i ($25.75 in chips) 
chiyuki: posts small blind $0.10
Alvinpe85: posts big blind $0.25
*** HOLE CARDS ***
Dealt to chiyuki [5h Kh]
Silveystryk: folds 
God)Squall: folds 
1Karina1: folds 
Faantomace: folds 
4plankton: folds 
seula i: folds 
phate-1up: folds 
chiyuki: folds 
Uncalled bet ($0.15) returned to Alvinpe85
Alvinpe85 collected $0.20 from pot
Alvinpe85: doesn't show hand 
*** SUMMARY ***
Total pot $0.20 | Rake $0 
Seat 1: phate-1up (button) folded before Flop (didn't bet)
Seat 2: chiyuki (small blind) folded before Flop
Seat 3: Alvinpe85 (big blind) collected ($0.20)
Seat 4: Silveystryk folded before Flop (didn't bet)
Seat 5: God)Squall folded before Flop (didn't bet)
Seat 6: 1Karina1 folded before Flop (didn't bet)
Seat 7: Faantomace folded before Flop (didn't bet)
Seat 8: 4plankton folded before Flop (didn't bet)
Seat 9: seula i folded before Flop (didn't bet)



PokerStars Zoom Hand #84300610314:  Hold'em No Limit ($0.10/$0.25) - 2012/08/05 15:39:31 JST [2012/08/05 2:39:31 ET]
Table 'Whirlpool' 9-max Seat #1 is the button
Seat 1: jacquelinewu ($73.86 in chips) 
Seat 2: 4plankton ($26.60 in chips) 
Seat 3: kwkim73 ($27.95 in chips) 
Seat 4: seula i ($25.75 in chips) 
Seat 5: Grishukps ($13.61 in chips) 
Seat 6: Serge Claws ($42.75 in chips) 
Seat 7: jvds114 ($28.20 in chips) 
Seat 8: chiyuki ($45.90 in chips) 
Seat 9: INSP!RON ($41.60 in chips) 
4plankton: posts small blind $0.10
kwkim73: posts big blind $0.25
*** HOLE CARDS ***
Dealt to chiyuki [2d 4d]
seula i: folds 
Grishukps: folds 
Serge Claws: folds 
jvds114: raises $0.50 to $0.75
chiyuki: folds 
INSP!RON: folds 
jacquelinewu: folds 
4plankton: folds 
kwkim73: raises $1.75 to $2.50
jvds114: folds 
Uncalled bet ($1.75) returned to kwkim73
kwkim73 collected $1.60 from pot
kwkim73: doesn't show hand 
*** SUMMARY ***
Total pot $1.60 | Rake $0 
Seat 1: jacquelinewu (button) folded before Flop (didn't bet)
Seat 2: 4plankton (small blind) folded before Flop
Seat 3: kwkim73 (big blind) collected ($1.60)
Seat 4: seula i folded before Flop (didn't bet)
Seat 5: Grishukps folded before Flop (didn't bet)
Seat 6: Serge Claws folded before Flop (didn't bet)
Seat 7: jvds114 folded before Flop
Seat 8: chiyuki folded before Flop (didn't bet)
Seat 9: INSP!RON folded before Flop (didn't bet)



PokerStars Zoom Hand #84300599059:  Hold'em No Limit ($0.10/$0.25) - 2012/08/05 15:38:46 JST [2012/08/05 2:38:46 ET]
Table 'Whirlpool' 9-max Seat #1 is the button
Seat 1: Grishukps ($16.88 in chips) 
Seat 2: masterkoolb ($13.61 in chips) 
Seat 3: GovGus ($38.55 in chips) 
Seat 4: KeLevro0 ($11.88 in chips) 
Seat 5: Fructionar ($26.81 in chips) 
Seat 6: risekuku468 ($34.44 in chips) 
Seat 7: yvasilik ($20.40 in chips) 
Seat 8: soul_5577 ($34.08 in chips) 
Seat 9: chiyuki ($46.15 in chips) 
masterkoolb: posts small blind $0.10
GovGus: posts big blind $0.25
*** HOLE CARDS ***
Dealt to chiyuki [9h 8s]
KeLevro0: folds 
Fructionar: folds 
risekuku468: raises $0.50 to $0.75
yvasilik: folds 
soul_5577: calls $0.75
chiyuki: folds 
Grishukps: folds 
masterkoolb: folds 
GovGus: calls $0.50
*** FLOP *** [6s Kh 4d]
GovGus: checks 
risekuku468: checks 
soul_5577: checks 
*** TURN *** [6s Kh 4d] [8d]
GovGus: bets $1.45
risekuku468: calls $1.45
soul_5577: calls $1.45
*** RIVER *** [6s Kh 4d 8d] [5s]
GovGus: checks 
risekuku468: checks 
soul_5577: bets $2
GovGus: folds 
risekuku468: calls $2
*** SHOW DOWN ***
soul_5577: shows [7d Ad] (a straight, Four to Eight)
risekuku468: mucks hand 
soul_5577 collected $10.22 from pot
*** SUMMARY ***
Total pot $10.70 | Rake $0.48 
Board [6s Kh 4d 8d 5s]
Seat 1: Grishukps (button) folded before Flop (didn't bet)
Seat 2: masterkoolb (small blind) folded before Flop
Seat 3: GovGus (big blind) folded on the River
Seat 4: KeLevro0 folded before Flop (didn't bet)
Seat 5: Fructionar folded before Flop (didn't bet)
Seat 6: risekuku468 mucked [Qs Qh]
Seat 7: yvasilik folded before Flop (didn't bet)
Seat 8: soul_5577 showed [7d Ad] and won ($10.22) with a straight, Four to Eight
Seat 9: chiyuki folded before Flop (didn't bet)



PokerStars Zoom Hand #84300601823:  Hold'em No Limit ($0.10/$0.25) - 2012/08/05 15:38:57 JST [2012/08/05 2:38:57 ET]
Table 'Whirlpool' 9-max Seat #1 is the button
Seat 1: ChrisCDee ($62.67 in chips) 
Seat 2: Spheroff ($25.07 in chips) 
Seat 3: nice.franki ($12.45 in chips) 
Seat 4: Faraz ($12.80 in chips) 
Seat 5: KeLevro0 ($10.95 in chips) 
Seat 6: mjmichi ($59.99 in chips) 
Seat 7: chiyuki ($46.15 in chips) 
Seat 8: kwkim73 ($25.27 in chips) 
Seat 9: opie62 ($23.82 in chips) 
Spheroff: posts small blind $0.10
nice.franki: posts big blind $0.25
*** HOLE CARDS ***
Dealt to chiyuki [5s 2h]
Faraz: folds 
KeLevro0: raises $0.42 to $0.67
mjmichi: folds 
chiyuki: folds 
kwkim73: folds 
opie62: folds 
ChrisCDee: calls $0.67
Spheroff: folds 
nice.franki: folds 
*** FLOP *** [9h Ks Kd]
KeLevro0: bets $0.90
ChrisCDee: calls $0.90
*** TURN *** [9h Ks Kd] [As]
KeLevro0: checks 
ChrisCDee: bets $1.99
KeLevro0: folds 
Uncalled bet ($1.99) returned to ChrisCDee
ChrisCDee collected $3.33 from pot
ChrisCDee: doesn't show hand 
*** SUMMARY ***
Total pot $3.49 | Rake $0.16 
Board [9h Ks Kd As]
Seat 1: ChrisCDee (button) collected ($3.33)
Seat 2: Spheroff (small blind) folded before Flop
Seat 3: nice.franki (big blind) folded before Flop
Seat 4: Faraz folded before Flop (didn't bet)
Seat 5: KeLevro0 folded on the Turn
Seat 6: mjmichi folded before Flop (didn't bet)
Seat 7: chiyuki folded before Flop (didn't bet)
Seat 8: kwkim73 folded before Flop (didn't bet)
Seat 9: opie62 folded before Flop (didn't bet)



PokerStars Zoom Hand #84300612634:  Hold'em No Limit ($0.10/$0.25) - 2012/08/05 15:39:40 JST [2012/08/05 2:39:40 ET]
Table 'Whirlpool' 9-max Seat #1 is the button
Seat 1: hldtom ($26.60 in chips) 
Seat 2: ZhukOFFskI ($20.37 in chips) 
Seat 3: KrystalAA ($24.27 in chips) 
Seat 4: chiyuki ($45.80 in chips) 
Seat 5: DutchShultzs ($25 in chips) 
Seat 6: KeLevro0 ($10.35 in chips) 
Seat 7: Faraz ($20.17 in chips) 
Seat 8: Serge Claws ($42.75 in chips) 
Seat 9: jacquelinewu ($28.43 in chips) 
ZhukOFFskI: posts small blind $0.10
KrystalAA: posts big blind $0.25
*** HOLE CARDS ***
Dealt to chiyuki [5h 3s]
chiyuki: folds 
DutchShultzs: folds 
KeLevro0: folds 
Faraz: folds 
Serge Claws: folds 
jacquelinewu: folds 
hldtom: raises $0.50 to $0.75
ZhukOFFskI: folds 
KrystalAA: folds 
Uncalled bet ($0.50) returned to hldtom
hldtom collected $0.60 from pot
hldtom: doesn't show hand 
*** SUMMARY ***
Total pot $0.60 | Rake $0 
Seat 1: hldtom (button) collected ($0.60)
Seat 2: ZhukOFFskI (small blind) folded before Flop
Seat 3: KrystalAA (big blind) folded before Flop
Seat 4: chiyuki folded before Flop (didn't bet)
Seat 5: DutchShultzs folded before Flop (didn't bet)
Seat 6: KeLevro0 folded before Flop (didn't bet)
Seat 7: Faraz folded before Flop (didn't bet)
Seat 8: Serge Claws folded before Flop (didn't bet)
Seat 9: jacquelinewu folded before Flop (didn't bet)



PokerStars Zoom Hand #84300614133:  Hold'em No Limit ($0.10/$0.25) - 2012/08/05 15:39:46 JST [2012/08/05 2:39:46 ET]
Table 'Whirlpool' 9-max Seat #1 is the button
Seat 1: phate-1up ($50.87 in chips) 
Seat 2: Rilko1975 ($25.10 in chips) 
Seat 3: drunk_bender ($16.13 in chips) 
Seat 4: KeLevro0 ($10.35 in chips) 
Seat 5: chiyuki ($45.80 in chips) 
Seat 6: Silveystryk ($20.17 in chips) 
Seat 7: jacquelinewu ($73.86 in chips) 
Seat 8: Nerkit ($13.49 in chips) 
Seat 9: DutchShultzs ($35 in chips) 
Rilko1975: posts small blind $0.10
drunk_bender: posts big blind $0.25
*** HOLE CARDS ***
Dealt to chiyuki [9c 4h]
KeLevro0: folds 
chiyuki: folds 
Silveystryk: calls $0.25
jacquelinewu: folds 
Nerkit: folds 
DutchShultzs: folds 
phate-1up: raises $1 to $1.25
Rilko1975: folds 
drunk_bender: folds 
Silveystryk: folds 
Uncalled bet ($1) returned to phate-1up
phate-1up collected $0.85 from pot
phate-1up: doesn't show hand 
*** SUMMARY ***
Total pot $0.85 | Rake $0 
Seat 1: phate-1up (button) collected ($0.85)
Seat 2: Rilko1975 (small blind) folded before Flop
Seat 3: drunk_bender (big blind) folded before Flop
Seat 4: KeLevro0 folded before Flop (didn't bet)
Seat 5: chiyuki folded before Flop (didn't bet)
Seat 6: Silveystryk folded before Flop
Seat 7: jacquelinewu folded before Flop (didn't bet)
Seat 8: Nerkit folded before Flop (didn't bet)
Seat 9: DutchShultzs folded before Flop (didn't bet)



PokerStars Zoom Hand #84300615629:  Hold'em No Limit ($0.10/$0.25) - 2012/08/05 15:39:52 JST [2012/08/05 2:39:52 ET]
Table 'Whirlpool' 9-max Seat #1 is the button
Seat 1: chiyuki ($45.80 in chips) 
Seat 2: 1Karina1 ($36.47 in chips) 
Seat 3: Serge Claws ($42.75 in chips) 
Seat 4: INSP!RON ($45.86 in chips) 
Seat 5: Perstenev ($8.06 in chips) 
Seat 6: nice.franki ($9 in chips) 
Seat 7: Nerkit ($13.49 in chips) 
Seat 8: Gichboy ($16.40 in chips) 
Seat 9: Alvinpe85 ($49.09 in chips) 
1Karina1: posts small blind $0.10
Serge Claws: posts big blind $0.25
*** HOLE CARDS ***
Dealt to chiyuki [Kc 8c]
INSP!RON: folds 
Perstenev has timed out while being disconnected
Perstenev: folds 
nice.franki: folds 
Nerkit: folds 
Gichboy: raises $0.25 to $0.50
Alvinpe85: folds 
chiyuki: folds 
1Karina1: folds 
Serge Claws: folds 
Uncalled bet ($0.25) returned to Gichboy
Gichboy collected $0.60 from pot
Gichboy: doesn't show hand 
*** SUMMARY ***
Total pot $0.60 | Rake $0 
Seat 1: chiyuki (button) folded before Flop (didn't bet)
Seat 2: 1Karina1 (small blind) folded before Flop
Seat 3: Serge Claws (big blind) folded before Flop
Seat 4: INSP!RON folded before Flop (didn't bet)
Seat 5: Perstenev folded before Flop (didn't bet)
Seat 6: nice.franki folded before Flop (didn't bet)
Seat 7: Nerkit folded before Flop (didn't bet)
Seat 8: Gichboy collected ($0.60)
Seat 9: Alvinpe85 folded before Flop (didn't bet)



PokerStars Zoom Hand #84300624121:  Hold'em No Limit ($0.10/$0.25) - 2012/08/05 15:40:26 JST [2012/08/05 2:40:26 ET]
Table 'Whirlpool' 9-max Seat #1 is the button
Seat 1: seula i ($25.65 in chips) 
Seat 2: jacquelinewu ($30.41 in chips) 
Seat 3: River_GmbH ($13.35 in chips) 
Seat 4: Ozboy80 ($25.65 in chips) 
Seat 5: phate-1up ($51.47 in chips) 
Seat 6: nice.franki ($15.27 in chips) 
Seat 7: DutchShultzs ($29.33 in chips) 
Seat 8: chiyuki ($45.80 in chips) 
Seat 9: silvno31 ($69.79 in chips) 
jacquelinewu: posts small blind $0.10
River_GmbH: posts big blind $0.25
*** HOLE CARDS ***
Dealt to chiyuki [Kc Qc]
Ozboy80: folds 
phate-1up: folds 
nice.franki: folds 
DutchShultzs: folds 
chiyuki: raises $0.50 to $0.75
silvno31: folds 
seula i: folds 
jacquelinewu: folds 
River_GmbH: folds 
Uncalled bet ($0.50) returned to chiyuki
chiyuki collected $0.60 from pot
chiyuki: doesn't show hand 
*** SUMMARY ***
Total pot $0.60 | Rake $0 
Seat 1: seula i (button) folded before Flop (didn't bet)
Seat 2: jacquelinewu (small blind) folded before Flop
Seat 3: River_GmbH (big blind) folded before Flop
Seat 4: Ozboy80 folded before Flop (didn't bet)
Seat 5: phate-1up folded before Flop (didn't bet)
Seat 6: nice.franki folded before Flop (didn't bet)
Seat 7: DutchShultzs folded before Flop (didn't bet)
Seat 8: chiyuki collected ($0.60)
Seat 9: silvno31 folded before Flop (didn't bet)



PokerStars Zoom Hand #84300629737:  Hold'em No Limit ($0.10/$0.25) - 2012/08/05 15:40:48 JST [2012/08/05 2:40:48 ET]
Table 'Whirlpool' 9-max Seat #1 is the button
Seat 1: silvno31 ($70.14 in chips) 
Seat 2: Robchie ($19.50 in chips) 
Seat 3: kesstukas25 ($22.44 in chips) 
Seat 4: phate-1up ($51.47 in chips) 
Seat 5: GSDP ($49.45 in chips) 
Seat 6: Silveystryk ($36.36 in chips) 
Seat 7: 1Karina1 ($36.72 in chips) 
Seat 8: Lasutchik ($11.55 in chips) 
Seat 9: chiyuki ($46.15 in chips) 
Robchie: posts small blind $0.10
kesstukas25: posts big blind $0.25
*** HOLE CARDS ***
Dealt to chiyuki [Qh 6c]
phate-1up: raises $0.50 to $0.75
GSDP: folds 
Silveystryk: folds 
1Karina1: folds 
Lasutchik: folds 
chiyuki: folds 
silvno31: folds 
Robchie: raises $1.25 to $2
kesstukas25: folds 
phate-1up: raises $19 to $21
Robchie: calls $17.50 and is all-in
Uncalled bet ($1.50) returned to phate-1up
*** FLOP *** [9s 3d As]
*** TURN *** [9s 3d As] [Jd]
*** RIVER *** [9s 3d As Jd] [9d]
*** SHOW DOWN ***
Robchie: shows [Kd Kh] (two pair, Kings and Nines)
phate-1up: shows [Js Jh] (a full house, Jacks full of Nines)
Robchie said, "LOL"
phate-1up collected $37.48 from pot
*** SUMMARY ***
Total pot $39.25 | Rake $1.77 
Board [9s 3d As Jd 9d]
Seat 1: silvno31 (button) folded before Flop (didn't bet)
Seat 2: Robchie (small blind) showed [Kd Kh] and lost with two pair, Kings and Nines
Seat 3: kesstukas25 (big blind) folded before Flop
Seat 4: phate-1up showed [Js Jh] and won ($37.48) with a full house, Jacks full of Nines
Seat 5: GSDP folded before Flop (didn't bet)
Seat 6: Silveystryk folded before Flop (didn't bet)
Seat 7: 1Karina1 folded before Flop (didn't bet)
Seat 8: Lasutchik folded before Flop (didn't bet)
Seat 9: chiyuki folded before Flop (didn't bet)



PokerStars Zoom Hand #84300631790:  Hold'em No Limit ($0.10/$0.25) - 2012/08/05 15:40:56 JST [2012/08/05 2:40:56 ET]
Table 'Whirlpool' 9-max Seat #1 is the button
Seat 1: yvasilik ($20.60 in chips) 
Seat 2: AAAKK777 ($18.69 in chips) 
Seat 3: chiyuki ($46.15 in chips) 
Seat 4: jacquelinewu ($26.49 in chips) 
Seat 5: Silveystryk ($36.36 in chips) 
Seat 6: Spheroff ($22.47 in chips) 
Seat 7: silvno31 ($70.14 in chips) 
Seat 8: Grishukps ($12.50 in chips) 
Seat 9: westhavenbc ($19.60 in chips) 
AAAKK777: posts small blind $0.10
chiyuki: posts big blind $0.25
*** HOLE CARDS ***
Dealt to chiyuki [8d 9s]
jacquelinewu: folds 
Silveystryk: calls $0.25
Spheroff: folds 
silvno31: folds 
Grishukps: folds 
westhavenbc: folds 
yvasilik: folds 
AAAKK777: calls $0.15
chiyuki: checks 
*** FLOP *** [Ks 7d 7s]
AAAKK777: checks 
chiyuki: checks 
Silveystryk: bets $0.25
AAAKK777: raises $1 to $1.25
chiyuki: folds 
Silveystryk: folds 
Uncalled bet ($1) returned to AAAKK777
AAAKK777 collected $1.19 from pot
AAAKK777: doesn't show hand 
*** SUMMARY ***
Total pot $1.25 | Rake $0.06 
Board [Ks 7d 7s]
Seat 1: yvasilik (button) folded before Flop (didn't bet)
Seat 2: AAAKK777 (small blind) collected ($1.19)
Seat 3: chiyuki (big blind) folded on the Flop
Seat 4: jacquelinewu folded before Flop (didn't bet)
Seat 5: Silveystryk folded on the Flop
Seat 6: Spheroff folded before Flop (didn't bet)
Seat 7: silvno31 folded before Flop (didn't bet)
Seat 8: Grishukps folded before Flop (didn't bet)
Seat 9: westhavenbc folded before Flop (didn't bet)



PokerStars Zoom Hand #84300642474:  Hold'em No Limit ($0.10/$0.25) - 2012/08/05 15:41:39 JST [2012/08/05 2:41:39 ET]
Table 'Whirlpool' 9-max Seat #1 is the button
Seat 1: kwkim73 ($29.81 in chips) 
Seat 2: herkko11 ($2.62 in chips) 
Seat 3: laurentzu84 ($25.35 in chips) 
Seat 4: KeLevro0 ($9.51 in chips) 
Seat 5: jacquelinewu ($26.39 in chips) 
Seat 6: yvasilik ($20.50 in chips) 
Seat 7: chiyuki ($45.90 in chips) 
Seat 8: Gichboy ($15.25 in chips) 
Seat 9: ChrisCDee ($37.44 in chips) 
herkko11: posts small blind $0.10
laurentzu84: posts big blind $0.25
*** HOLE CARDS ***
Dealt to chiyuki [Qs 7c]
KeLevro0: folds 
jacquelinewu: folds 
yvasilik: folds 
chiyuki: folds 
Gichboy: folds 
ChrisCDee: folds 
kwkim73: folds 
herkko11: folds 
Uncalled bet ($0.15) returned to laurentzu84
laurentzu84 collected $0.20 from pot
laurentzu84: doesn't show hand 
*** SUMMARY ***
Total pot $0.20 | Rake $0 
Seat 1: kwkim73 (button) folded before Flop (didn't bet)
Seat 2: herkko11 (small blind) folded before Flop
Seat 3: laurentzu84 (big blind) collected ($0.20)
Seat 4: KeLevro0 folded before Flop (didn't bet)
Seat 5: jacquelinewu folded before Flop (didn't bet)
Seat 6: yvasilik folded before Flop (didn't bet)
Seat 7: chiyuki folded before Flop (didn't bet)
Seat 8: Gichboy folded before Flop (didn't bet)
Seat 9: ChrisCDee folded before Flop (didn't bet)



PokerStars Zoom Hand #84300643543:  Hold'em No Limit ($0.10/$0.25) - 2012/08/05 15:41:43 JST [2012/08/05 2:41:43 ET]
Table 'Whirlpool' 9-max Seat #1 is the button
Seat 1: herkko11 ($2.52 in chips) 
Seat 2: 1Karina1 ($32.03 in chips) 
Seat 3: yvasilik ($20.50 in chips) 
Seat 4: chiyuki ($45.90 in chips) 
Seat 5: snejokCoxx ($18.53 in chips) 
Seat 6: Dan Royal ($35.69 in chips) 
Seat 7: Serge Claws ($26.80 in chips) 
Seat 8: INSP!RON ($39.34 in chips) 
Seat 9: KrystalAA ($40.27 in chips) 
1Karina1: posts small blind $0.10
yvasilik: posts big blind $0.25
*** HOLE CARDS ***
Dealt to chiyuki [Td Jh]
chiyuki: folds 
snejokCoxx: raises $0.45 to $0.70
Dan Royal: folds 
Serge Claws: folds 
INSP!RON: folds 
KrystalAA: folds 
herkko11: folds 
1Karina1: folds 
yvasilik: folds 
Uncalled bet ($0.45) returned to snejokCoxx
snejokCoxx collected $0.60 from pot
snejokCoxx: doesn't show hand 
*** SUMMARY ***
Total pot $0.60 | Rake $0 
Seat 1: herkko11 (button) folded before Flop (didn't bet)
Seat 2: 1Karina1 (small blind) folded before Flop
Seat 3: yvasilik (big blind) folded before Flop
Seat 4: chiyuki folded before Flop (didn't bet)
Seat 5: snejokCoxx collected ($0.60)
Seat 6: Dan Royal folded before Flop (didn't bet)
Seat 7: Serge Claws folded before Flop (didn't bet)
Seat 8: INSP!RON folded before Flop (didn't bet)
Seat 9: KrystalAA folded before Flop (didn't bet)



PokerStars Zoom Hand #84300644292:  Hold'em No Limit ($0.10/$0.25) - 2012/08/05 15:41:46 JST [2012/08/05 2:41:46 ET]
Table 'Whirlpool' 9-max Seat #1 is the button
Seat 1: Ozboy80 ($27.74 in chips) 
Seat 2: chiyuki ($45.90 in chips) 
Seat 3: KrystalAA ($10.71 in chips) 
Seat 4: westhavenbc ($18.10 in chips) 
Seat 5: kwkim73 ($29.81 in chips) 
Seat 6: kesstukas25 ($22.19 in chips) 
Seat 7: Rilko1975 ($24.85 in chips) 
Seat 8: NuMetal88 ($33.50 in chips) 
Seat 9: TorTrade ($27.79 in chips) 
chiyuki: posts small blind $0.10
KrystalAA: posts big blind $0.25
*** HOLE CARDS ***
Dealt to chiyuki [4h 4s]
westhavenbc: folds 
kwkim73: folds 
kesstukas25: folds 
Rilko1975: folds 
NuMetal88: folds 
TorTrade: raises $0.50 to $0.75
Ozboy80: folds 
chiyuki: folds 
KrystalAA: folds 
Uncalled bet ($0.50) returned to TorTrade
TorTrade collected $0.60 from pot
TorTrade: doesn't show hand 
*** SUMMARY ***
Total pot $0.60 | Rake $0 
Seat 1: Ozboy80 (button) folded before Flop (didn't bet)
Seat 2: chiyuki (small blind) folded before Flop
Seat 3: KrystalAA (big blind) folded before Flop
Seat 4: westhavenbc folded before Flop (didn't bet)
Seat 5: kwkim73 folded before Flop (didn't bet)
Seat 6: kesstukas25 folded before Flop (didn't bet)
Seat 7: Rilko1975 folded before Flop (didn't bet)
Seat 8: NuMetal88 folded before Flop (didn't bet)
Seat 9: TorTrade collected ($0.60)



PokerStars Zoom Hand #84300648804:  Hold'em No Limit ($0.10/$0.25) - 2012/08/05 15:42:03 JST [2012/08/05 2:42:03 ET]
Table 'Whirlpool' 9-max Seat #1 is the button
Seat 1: chiyuki ($45.80 in chips) 
Seat 2: KrystalAA ($10.46 in chips) 
Seat 3: kamikkaze ($13.25 in chips) 
Seat 4: AntoineHunt ($21.60 in chips) 
Seat 5: Silveystryk ($24.09 in chips) 
Seat 6: 0 operator 0 ($31.20 in chips) 
Seat 7: Ozboy80 ($27.74 in chips) 
Seat 8: 1Karina1 ($36.42 in chips) 
Seat 9: KeLevro0 ($9.26 in chips) 
KrystalAA: posts small blind $0.10
kamikkaze: posts big blind $0.25
*** HOLE CARDS ***
Dealt to chiyuki [6s Jc]
AntoineHunt: folds 
Silveystryk: folds 
0 operator 0: raises $0.75 to $1
Ozboy80: folds 
1Karina1: folds 
KeLevro0: folds 
chiyuki: folds 
KrystalAA: folds 
kamikkaze: folds 
Uncalled bet ($0.75) returned to 0 operator 0
0 operator 0 collected $0.60 from pot
0 operator 0: doesn't show hand 
*** SUMMARY ***
Total pot $0.60 | Rake $0 
Seat 1: chiyuki (button) folded before Flop (didn't bet)
Seat 2: KrystalAA (small blind) folded before Flop
Seat 3: kamikkaze (big blind) folded before Flop
Seat 4: AntoineHunt folded before Flop (didn't bet)
Seat 5: Silveystryk folded before Flop (didn't bet)
Seat 6: 0 operator 0 collected ($0.60)
Seat 7: Ozboy80 folded before Flop (didn't bet)
Seat 8: 1Karina1 folded before Flop (didn't bet)
Seat 9: KeLevro0 folded before Flop (didn't bet)



PokerStars Zoom Hand #84300650306:  Hold'em No Limit ($0.10/$0.25) - 2012/08/05 15:42:09 JST [2012/08/05 2:42:09 ET]
Table 'Whirlpool' 9-max Seat #1 is the button
Seat 1: DutchShultzs ($46.61 in chips) 
Seat 2: Silveystryk ($24.09 in chips) 
Seat 3: 1Karina1 ($31.93 in chips) 
Seat 4: chiyuki ($45.80 in chips) 
Seat 5: Rici47 ($41.19 in chips) 
Seat 6: Ellen1947 ($22.50 in chips) 
Seat 7: DrunkTyphoon ($25 in chips) 
Seat 8: KeLevro0 ($9.08 in chips) 
Seat 9: nice.franki ($8.30 in chips) 
Silveystryk: posts small blind $0.10
1Karina1: posts big blind $0.25
*** HOLE CARDS ***
Dealt to chiyuki [Kh 8s]
chiyuki: folds 
Rici47: folds 
Ellen1947: folds 
DrunkTyphoon: folds 
KeLevro0: folds 
nice.franki: folds 
DutchShultzs: raises $0.35 to $0.60
Silveystryk: folds 
1Karina1: folds 
Uncalled bet ($0.35) returned to DutchShultzs
DutchShultzs collected $0.60 from pot
DutchShultzs: doesn't show hand 
*** SUMMARY ***
Total pot $0.60 | Rake $0 
Seat 1: DutchShultzs (button) collected ($0.60)
Seat 2: Silveystryk (small blind) folded before Flop
Seat 3: 1Karina1 (big blind) folded before Flop
Seat 4: chiyuki folded before Flop (didn't bet)
Seat 5: Rici47 folded before Flop (didn't bet)
Seat 6: Ellen1947 folded before Flop (didn't bet)
Seat 7: DrunkTyphoon folded before Flop (didn't bet)
Seat 8: KeLevro0 folded before Flop (didn't bet)
Seat 9: nice.franki folded before Flop (didn't bet)



PokerStars Zoom Hand #84300647270:  Hold'em No Limit ($0.10/$0.25) - 2012/08/05 15:41:58 JST [2012/08/05 2:41:58 ET]
Table 'Whirlpool' 9-max Seat #1 is the button
Seat 1: svg51 ($6.37 in chips) 
Seat 2: AntoineHunt ($21.70 in chips) 
Seat 3: Perstenev ($8.10 in chips) 
Seat 4: ZhukOFFskI ($19.77 in chips) 
Seat 5: chiyuki ($45.80 in chips) 
Seat 6: pawn909 ($14.30 in chips) 
Seat 7: kesstukas25 ($13.85 in chips) 
Seat 8: mjmichi ($64 in chips) 
Seat 9: 0 operator 0 ($31.20 in chips) 
AntoineHunt: posts small blind $0.10
Perstenev: posts big blind $0.25
*** HOLE CARDS ***
Dealt to chiyuki [Th 9c]
ZhukOFFskI: folds 
chiyuki: folds 
pawn909: raises $0.50 to $0.75
kesstukas25: folds 
mjmichi: folds 
0 operator 0: folds 
svg51: folds 
AntoineHunt: folds 
Perstenev: folds 
Uncalled bet ($0.50) returned to pawn909
pawn909 collected $0.60 from pot
pawn909: doesn't show hand 
*** SUMMARY ***
Total pot $0.60 | Rake $0 
Seat 1: svg51 (button) folded before Flop (didn't bet)
Seat 2: AntoineHunt (small blind) folded before Flop
Seat 3: Perstenev (big blind) folded before Flop
Seat 4: ZhukOFFskI folded before Flop (didn't bet)
Seat 5: chiyuki folded before Flop (didn't bet)
Seat 6: pawn909 collected ($0.60)
Seat 7: kesstukas25 folded before Flop (didn't bet)
Seat 8: mjmichi folded before Flop (didn't bet)
Seat 9: 0 operator 0 folded before Flop (didn't bet)



PokerStars Zoom Hand #84300651284:  Hold'em No Limit ($0.10/$0.25) - 2012/08/05 15:42:13 JST [2012/08/05 2:42:13 ET]
Table 'Whirlpool' 9-max Seat #1 is the button
Seat 1: xxx Spb xxx ($26.30 in chips) 
Seat 2: 1Karina1 ($26.20 in chips) 
Seat 3: Ellen1947 ($22.50 in chips) 
Seat 4: GovGus ($27.35 in chips) 
Seat 5: KrystalAA ($40.27 in chips) 
Seat 6: DrunkTyphoon ($25 in chips) 
Seat 7: Rici47 ($41.19 in chips) 
Seat 8: jacquelinewu ($29.81 in chips) 
Seat 9: chiyuki ($45.80 in chips) 
1Karina1: posts small blind $0.10
Ellen1947: posts big blind $0.25
*** HOLE CARDS ***
Dealt to chiyuki [Jh 5d]
GovGus: folds 
KrystalAA: folds 
DrunkTyphoon: folds 
Rici47: folds 
jacquelinewu: folds 
chiyuki: folds 
xxx Spb xxx: folds 
1Karina1: folds 
Uncalled bet ($0.15) returned to Ellen1947
Ellen1947 collected $0.20 from pot
Ellen1947: doesn't show hand 
*** SUMMARY ***
Total pot $0.20 | Rake $0 
Seat 1: xxx Spb xxx (button) folded before Flop (didn't bet)
Seat 2: 1Karina1 (small blind) folded before Flop
Seat 3: Ellen1947 (big blind) collected ($0.20)
Seat 4: GovGus folded before Flop (didn't bet)
Seat 5: KrystalAA folded before Flop (didn't bet)
Seat 6: DrunkTyphoon folded before Flop (didn't bet)
Seat 7: Rici47 folded before Flop (didn't bet)
Seat 8: jacquelinewu folded before Flop (didn't bet)
Seat 9: chiyuki folded before Flop (didn't bet)



PokerStars Zoom Hand #84300654551:  Hold'em No Limit ($0.10/$0.25) - 2012/08/05 15:42:26 JST [2012/08/05 2:42:26 ET]
Table 'Whirlpool' 9-max Seat #1 is the button
Seat 1: pawn909 ($14.65 in chips) 
Seat 2: GovGus ($42.67 in chips) 
Seat 3: WARIBANA7777 ($15.18 in chips) 
Seat 4: ShaninPeter ($11.50 in chips) 
Seat 5: TorTrade ($28.14 in chips) 
Seat 6: chiyuki ($45.80 in chips) 
Seat 7: PPP7SSS ($8.11 in chips) 
Seat 8: Nerkit ($16.14 in chips) 
Seat 9: ZhukOFFskI ($19.52 in chips) 
GovGus: posts small blind $0.10
WARIBANA7777: posts big blind $0.25
*** HOLE CARDS ***
Dealt to chiyuki [8h Kd]
ShaninPeter: folds 
TorTrade: folds 
chiyuki: folds 
PPP7SSS: folds 
Nerkit: folds 
ZhukOFFskI: folds 
pawn909: folds 
GovGus: raises $0.50 to $0.75
WARIBANA7777: folds 
Uncalled bet ($0.50) returned to GovGus
GovGus collected $0.50 from pot
GovGus: doesn't show hand 
*** SUMMARY ***
Total pot $0.50 | Rake $0 
Seat 1: pawn909 (button) folded before Flop (didn't bet)
Seat 2: GovGus (small blind) collected ($0.50)
Seat 3: WARIBANA7777 (big blind) folded before Flop
Seat 4: ShaninPeter folded before Flop (didn't bet)
Seat 5: TorTrade folded before Flop (didn't bet)
Seat 6: chiyuki folded before Flop (didn't bet)
Seat 7: PPP7SSS folded before Flop (didn't bet)
Seat 8: Nerkit folded before Flop (didn't bet)
Seat 9: ZhukOFFskI folded before Flop (didn't bet)



PokerStars Zoom Hand #84300653754:  Hold'em No Limit ($0.10/$0.25) - 2012/08/05 15:42:23 JST [2012/08/05 2:42:23 ET]
Table 'Whirlpool' 9-max Seat #1 is the button
Seat 1: 1Karina1 ($36.42 in chips) 
Seat 2: Fructionar ($32.86 in chips) 
Seat 3: DutchShultzs ($46.96 in chips) 
Seat 4: masterkoolb ($14.71 in chips) 
Seat 5: jacquelinewu ($29.81 in chips) 
Seat 6: Rici47 ($41.19 in chips) 
Seat 7: chiyuki ($45.80 in chips) 
Seat 8: KeLevro0 ($9.16 in chips) 
Seat 9: GSDP ($24.69 in chips) 
Fructionar: posts small blind $0.10
DutchShultzs: posts big blind $0.25
*** HOLE CARDS ***
Dealt to chiyuki [4s 3c]
masterkoolb: folds 
jacquelinewu: folds 
Rici47: folds 
chiyuki: folds 
KeLevro0: raises $0.42 to $0.67
GSDP: folds 
1Karina1: folds 
Fructionar: folds 
DutchShultzs: folds 
Uncalled bet ($0.42) returned to KeLevro0
KeLevro0 collected $0.60 from pot
KeLevro0: doesn't show hand 
*** SUMMARY ***
Total pot $0.60 | Rake $0 
Seat 1: 1Karina1 (button) folded before Flop (didn't bet)
Seat 2: Fructionar (small blind) folded before Flop
Seat 3: DutchShultzs (big blind) folded before Flop
Seat 4: masterkoolb folded before Flop (didn't bet)
Seat 5: jacquelinewu folded before Flop (didn't bet)
Seat 6: Rici47 folded before Flop (didn't bet)
Seat 7: chiyuki folded before Flop (didn't bet)
Seat 8: KeLevro0 collected ($0.60)
Seat 9: GSDP folded before Flop (didn't bet)



PokerStars Zoom Hand #84300659124:  Hold'em No Limit ($0.10/$0.25) - 2012/08/05 15:42:45 JST [2012/08/05 2:42:45 ET]
Table 'Whirlpool' 9-max Seat #1 is the button
Seat 1: yvasilik ($22.13 in chips) 
Seat 2: Serge Claws ($33.18 in chips) 
Seat 3: chiyuki ($45.80 in chips) 
Seat 4: DrunkTyphoon ($27.50 in chips) 
Seat 5: kamikkaze ($12.38 in chips) 
Seat 6: HighDuka ($33.06 in chips) 
Seat 7: hldtom ($13.63 in chips) 
Seat 8: 4plankton ($26.11 in chips) 
Seat 9: DutchShultzs ($46.71 in chips) 
Serge Claws: posts small blind $0.10
chiyuki: posts big blind $0.25
*** HOLE CARDS ***
Dealt to chiyuki [4s 2d]
DrunkTyphoon: folds 
kamikkaze: folds 
HighDuka: folds 
hldtom: folds 
4plankton: folds 
DutchShultzs: folds 
yvasilik: folds 
Serge Claws: folds 
Uncalled bet ($0.15) returned to chiyuki
chiyuki collected $0.20 from pot
chiyuki: doesn't show hand 
*** SUMMARY ***
Total pot $0.20 | Rake $0 
Seat 1: yvasilik (button) folded before Flop (didn't bet)
Seat 2: Serge Claws (small blind) folded before Flop
Seat 3: chiyuki (big blind) collected ($0.20)
Seat 4: DrunkTyphoon folded before Flop (didn't bet)
Seat 5: kamikkaze folded before Flop (didn't bet)
Seat 6: HighDuka folded before Flop (didn't bet)
Seat 7: hldtom folded before Flop (didn't bet)
Seat 8: 4plankton folded before Flop (didn't bet)
Seat 9: DutchShultzs folded before Flop (didn't bet)



PokerStars Zoom Hand #84300663917:  Hold'em No Limit ($0.10/$0.25) - 2012/08/05 15:43:04 JST [2012/08/05 2:43:04 ET]
Table 'Whirlpool' 9-max Seat #1 is the button
Seat 1: chiyuki ($45.90 in chips) 
Seat 2: snejokCoxx ($12.60 in chips) 
Seat 3: phate-1up ($69 in chips) 
Seat 4: pandaaaaaa ($11.34 in chips) 
Seat 5: opie62 ($18.82 in chips) 
Seat 6: Grishukps ($12.85 in chips) 
Seat 7: kwkim73 ($25 in chips) 
Seat 8: Rilko1975 ($25.99 in chips) 
Seat 9: kamikkaze ($18.75 in chips) 
snejokCoxx: posts small blind $0.10
phate-1up: posts big blind $0.25
*** HOLE CARDS ***
Dealt to chiyuki [4c Qs]
pandaaaaaa: folds 
opie62: folds 
Grishukps: folds 
kwkim73: folds 
Rilko1975: folds 
kamikkaze: folds 
chiyuki: folds 
snejokCoxx: folds 
Uncalled bet ($0.15) returned to phate-1up
phate-1up collected $0.20 from pot
phate-1up: doesn't show hand 
*** SUMMARY ***
Total pot $0.20 | Rake $0 
Seat 1: chiyuki (button) folded before Flop (didn't bet)
Seat 2: snejokCoxx (small blind) folded before Flop
Seat 3: phate-1up (big blind) collected ($0.20)
Seat 4: pandaaaaaa folded before Flop (didn't bet)
Seat 5: opie62 folded before Flop (didn't bet)
Seat 6: Grishukps folded before Flop (didn't bet)
Seat 7: kwkim73 folded before Flop (didn't bet)
Seat 8: Rilko1975 folded before Flop (didn't bet)
Seat 9: kamikkaze folded before Flop (didn't bet)



PokerStars Zoom Hand #84300666194:  Hold'em No Limit ($0.10/$0.25) - 2012/08/05 15:43:13 JST [2012/08/05 2:43:13 ET]
Table 'Whirlpool' 9-max Seat #1 is the button
Seat 1: NuMetal88 ($25 in chips) 
Seat 2: chiyuki ($45.90 in chips) 
Seat 3: 0 operator 0 ($31.65 in chips) 
Seat 4: Perstenev ($9.13 in chips) 
Seat 5: 1Karina1 ($36.07 in chips) 
Seat 6: nice.franki ($12.50 in chips) 
Seat 7: Trip_Krowns ($24.45 in chips) 
Seat 8: Limoilou ($34.07 in chips) 
Seat 9: DutchShultzs ($27.13 in chips) 
chiyuki: posts small blind $0.10
0 operator 0: posts big blind $0.25
*** HOLE CARDS ***
Dealt to chiyuki [7h 3s]
Perstenev: folds 
1Karina1: folds 
nice.franki: folds 
Trip_Krowns: folds 
Limoilou: folds 
DutchShultzs: folds 
NuMetal88: folds 
chiyuki: folds 
Uncalled bet ($0.15) returned to 0 operator 0
0 operator 0 collected $0.20 from pot
0 operator 0: doesn't show hand 
*** SUMMARY ***
Total pot $0.20 | Rake $0 
Seat 1: NuMetal88 (button) folded before Flop (didn't bet)
Seat 2: chiyuki (small blind) folded before Flop
Seat 3: 0 operator 0 (big blind) collected ($0.20)
Seat 4: Perstenev folded before Flop (didn't bet)
Seat 5: 1Karina1 folded before Flop (didn't bet)
Seat 6: nice.franki folded before Flop (didn't bet)
Seat 7: Trip_Krowns folded before Flop (didn't bet)
Seat 8: Limoilou folded before Flop (didn't bet)
Seat 9: DutchShultzs folded before Flop (didn't bet)



PokerStars Zoom Hand #84300662387:  Hold'em No Limit ($0.10/$0.25) - 2012/08/05 15:42:58 JST [2012/08/05 2:42:58 ET]
Table 'Whirlpool' 9-max Seat #1 is the button
Seat 1: Serge Claws ($27.47 in chips) 
Seat 2: Ozboy80 ($27.84 in chips) 
Seat 3: fil740 ($14.23 in chips) 
Seat 4: chiyuki ($45.90 in chips) 
Seat 5: risekuku468 ($28.39 in chips) 
Seat 6: kwkim73 ($25 in chips) 
Seat 7: NuMetal88 ($25 in chips) 
Seat 8: JhonnyP1979 ($21.51 in chips) 
Seat 9: Rici47 ($40.94 in chips) 
Ozboy80: posts small blind $0.10
fil740: posts big blind $0.25
*** HOLE CARDS ***
Dealt to chiyuki [Ks 7c]
chiyuki: folds 
risekuku468: folds 
kwkim73: folds 
NuMetal88: folds 
JhonnyP1979: folds 
Rici47: raises $0.50 to $0.75
Serge Claws: folds 
Ozboy80: calls $0.65
fil740: calls $0.50
*** FLOP *** [Qh 3h Jd]
Ozboy80: checks 
fil740: checks 
Rici47: checks 
*** TURN *** [Qh 3h Jd] [7d]
Ozboy80: checks 
fil740: checks 
Rici47: checks 
*** RIVER *** [Qh 3h Jd 7d] [Tc]
Ozboy80: checks 
fil740: checks 
Rici47: checks 
*** SHOW DOWN ***
Ozboy80: shows [6s 6c] (a pair of Sixes)
fil740: mucks hand 
Rici47: shows [Td Ac] (a pair of Tens)
Rici47 collected $2.15 from pot
*** SUMMARY ***
Total pot $2.25 | Rake $0.10 
Board [Qh 3h Jd 7d Tc]
Seat 1: Serge Claws (button) folded before Flop (didn't bet)
Seat 2: Ozboy80 (small blind) showed [6s 6c] and lost with a pair of Sixes
Seat 3: fil740 (big blind) mucked [5c Kc]
Seat 4: chiyuki folded before Flop (didn't bet)
Seat 5: risekuku468 folded before Flop (didn't bet)
Seat 6: kwkim73 folded before Flop (didn't bet)
Seat 7: NuMetal88 folded before Flop (didn't bet)
Seat 8: JhonnyP1979 folded before Flop (didn't bet)
Seat 9: Rici47 showed [Td Ac] and won ($2.15) with a pair of Tens



PokerStars Zoom Hand #84300657860:  Hold'em No Limit ($0.10/$0.25) - 2012/08/05 15:42:39 JST [2012/08/05 2:42:39 ET]
Table 'Whirlpool' 9-max Seat #1 is the button
Seat 1: kwkim73 ($55.13 in chips) 
Seat 2: ZhukOFFskI ($19.52 in chips) 
Seat 3: GovGus ($27.25 in chips) 
Seat 4: mjmichi ($65.49 in chips) 
Seat 5: Serge Claws ($41.65 in chips) 
Seat 6: pawn909 ($14.65 in chips) 
Seat 7: jvds114 ($25 in chips) 
Seat 8: chiyuki ($45.80 in chips) 
Seat 9: 1Karina1 ($35.91 in chips) 
ZhukOFFskI: posts small blind $0.10
GovGus: posts big blind $0.25
*** HOLE CARDS ***
Dealt to chiyuki [2c 2h]
mjmichi: raises $0.50 to $0.75
Serge Claws: folds 
pawn909: folds 
jvds114: folds 
chiyuki: folds 
1Karina1: folds 
kwkim73: folds 
ZhukOFFskI: folds 
GovGus: calls $0.50
*** FLOP *** [Kh Qh Ts]
GovGus: checks 
mjmichi: bets $1.50
GovGus: calls $1.50
*** TURN *** [Kh Qh Ts] [Ac]
GovGus: checks 
mjmichi: checks 
*** RIVER *** [Kh Qh Ts Ac] [Qd]
GovGus: bets $5.44
mjmichi: raises $57.80 to $63.24 and is all-in
GovGus: calls $19.56 and is all-in
Uncalled bet ($38.24) returned to mjmichi
*** SHOW DOWN ***
mjmichi: shows [As Qc] (a full house, Queens full of Aces)
GovGus: shows [Ah Qs] (a full house, Queens full of Aces)
GovGus collected $26.30 from pot
mjmichi collected $26.30 from pot
*** SUMMARY ***
Total pot $54.60 | Rake $2 
Board [Kh Qh Ts Ac Qd]
Seat 1: kwkim73 (button) folded before Flop (didn't bet)
Seat 2: ZhukOFFskI (small blind) folded before Flop
Seat 3: GovGus (big blind) showed [Ah Qs] and won ($26.30) with a full house, Queens full of Aces
Seat 4: mjmichi showed [As Qc] and won ($26.30) with a full house, Queens full of Aces
Seat 5: Serge Claws folded before Flop (didn't bet)
Seat 6: pawn909 folded before Flop (didn't bet)
Seat 7: jvds114 folded before Flop (didn't bet)
Seat 8: chiyuki folded before Flop (didn't bet)
Seat 9: 1Karina1 folded before Flop (didn't bet)



PokerStars Zoom Hand #84300668236:  Hold'em No Limit ($0.10/$0.25) - 2012/08/05 15:43:21 JST [2012/08/05 2:43:21 ET]
Table 'Whirlpool' 9-max Seat #1 is the button
Seat 1: phate-1up ($45.34 in chips) 
Seat 2: Vahe50 ($22.08 in chips) 
Seat 3: kamikkaze ($12.73 in chips) 
Seat 4: nice.franki ($12.50 in chips) 
Seat 5: Perstenev ($7.75 in chips) 
Seat 6: GovGus ($31.41 in chips) 
Seat 7: chiyuki ($45.80 in chips) 
Seat 8: INSP!RON ($50.04 in chips) 
Seat 9: jacquelinewu ($25.73 in chips) 
Vahe50: posts small blind $0.10
kamikkaze: posts big blind $0.25
*** HOLE CARDS ***
Dealt to chiyuki [9c 3s]
nice.franki: folds 
Perstenev: folds 
GovGus: raises $0.50 to $0.75
chiyuki: folds 
INSP!RON: folds 
jacquelinewu has timed out
jacquelinewu: folds 
phate-1up: folds 
Vahe50: folds 
kamikkaze: folds 
Uncalled bet ($0.50) returned to GovGus
GovGus collected $0.60 from pot
GovGus: doesn't show hand 
*** SUMMARY ***
Total pot $0.60 | Rake $0 
Seat 1: phate-1up (button) folded before Flop (didn't bet)
Seat 2: Vahe50 (small blind) folded before Flop
Seat 3: kamikkaze (big blind) folded before Flop
Seat 4: nice.franki folded before Flop (didn't bet)
Seat 5: Perstenev folded before Flop (didn't bet)
Seat 6: GovGus collected ($0.60)
Seat 7: chiyuki folded before Flop (didn't bet)
Seat 8: INSP!RON folded before Flop (didn't bet)
Seat 9: jacquelinewu folded before Flop (didn't bet)



PokerStars Zoom Hand #84300673682:  Hold'em No Limit ($0.10/$0.25) - 2012/08/05 15:43:42 JST [2012/08/05 2:43:42 ET]
Table 'Whirlpool' 9-max Seat #1 is the button
Seat 1: Perstenev ($8.88 in chips) 
Seat 2: Silveystryk ($37.10 in chips) 
Seat 3: ZhukOFFskI ($19.42 in chips) 
Seat 4: kamikkaze ($18.77 in chips) 
Seat 5: phate-1up ($42.04 in chips) 
Seat 6: macmauret ($10.51 in chips) 
Seat 7: 4plankton ($26.13 in chips) 
Seat 8: chiyuki ($45.80 in chips) 
Seat 9: GovGus ($43.60 in chips) 
Silveystryk: posts small blind $0.10
ZhukOFFskI: posts big blind $0.25
*** HOLE CARDS ***
Dealt to chiyuki [Qs 9d]
kamikkaze: folds 
phate-1up: raises $0.50 to $0.75
macmauret: folds 
4plankton: folds 
chiyuki: folds 
GovGus: folds 
Perstenev: folds 
Silveystryk: folds 
ZhukOFFskI: folds 
Uncalled bet ($0.50) returned to phate-1up
phate-1up collected $0.60 from pot
phate-1up: doesn't show hand 
*** SUMMARY ***
Total pot $0.60 | Rake $0 
Seat 1: Perstenev (button) folded before Flop (didn't bet)
Seat 2: Silveystryk (small blind) folded before Flop
Seat 3: ZhukOFFskI (big blind) folded before Flop
Seat 4: kamikkaze folded before Flop (didn't bet)
Seat 5: phate-1up collected ($0.60)
Seat 6: macmauret folded before Flop (didn't bet)
Seat 7: 4plankton folded before Flop (didn't bet)
Seat 8: chiyuki folded before Flop (didn't bet)
Seat 9: GovGus folded before Flop (didn't bet)



PokerStars Zoom Hand #84300669284:  Hold'em No Limit ($0.10/$0.25) - 2012/08/05 15:43:25 JST [2012/08/05 2:43:25 ET]
Table 'Whirlpool' 9-max Seat #1 is the button
Seat 1: KeLevro0 ($9.16 in chips) 
Seat 2: Perstenev ($13.07 in chips) 
Seat 3: Saruotiss ($62.50 in chips) 
Seat 4: kwkim73 ($28.31 in chips) 
Seat 5: chiyuki ($45.80 in chips) 
Seat 6: westhavenbc ($37.29 in chips) 
Seat 7: Gichboy ($12.40 in chips) 
Seat 8: DutchShultzs ($25 in chips) 
Seat 9: banderas761 ($21.85 in chips) 
Perstenev: posts small blind $0.10
Saruotiss: posts big blind $0.25
*** HOLE CARDS ***
Dealt to chiyuki [5h Ts]
kwkim73: folds 
chiyuki: folds 
westhavenbc: folds 
Gichboy: calls $0.25
DutchShultzs: folds 
banderas761: folds 
KeLevro0: folds 
Perstenev: folds 
Saruotiss: checks 
*** FLOP *** [9c Tc Qh]
Saruotiss: checks 
Gichboy: checks 
*** TURN *** [9c Tc Qh] [2d]
Saruotiss: checks 
Gichboy: checks 
*** RIVER *** [9c Tc Qh 2d] [Ac]
Saruotiss: bets $1.25
Gichboy: folds 
Uncalled bet ($1.25) returned to Saruotiss
Saruotiss collected $0.57 from pot
Saruotiss: doesn't show hand 
*** SUMMARY ***
Total pot $0.60 | Rake $0.03 
Board [9c Tc Qh 2d Ac]
Seat 1: KeLevro0 (button) folded before Flop (didn't bet)
Seat 2: Perstenev (small blind) folded before Flop
Seat 3: Saruotiss (big blind) collected ($0.57)
Seat 4: kwkim73 folded before Flop (didn't bet)
Seat 5: chiyuki folded before Flop (didn't bet)
Seat 6: westhavenbc folded before Flop (didn't bet)
Seat 7: Gichboy folded on the River
Seat 8: DutchShultzs folded before Flop (didn't bet)
Seat 9: banderas761 folded before Flop (didn't bet)



PokerStars Zoom Hand #84300671356:  Hold'em No Limit ($0.10/$0.25) - 2012/08/05 15:43:33 JST [2012/08/05 2:43:33 ET]
Table 'Whirlpool' 9-max Seat #1 is the button
Seat 1: moku36 ($38.88 in chips) 
Seat 2: Grishukps ($12.50 in chips) 
Seat 3: Serge Claws ($31.08 in chips) 
Seat 4: NuMetal88 ($25 in chips) 
Seat 5: God)Squall ($33.66 in chips) 
Seat 6: chiyuki ($45.80 in chips) 
Seat 7: ChrisCDee ($37.09 in chips) 
Seat 8: nastya040 ($7.73 in chips) 
Seat 9: Perstenev ($12.97 in chips) 
Grishukps: posts small blind $0.10
Serge Claws: posts big blind $0.25
*** HOLE CARDS ***
Dealt to chiyuki [5d 4h]
NuMetal88: folds 
God)Squall: raises $0.50 to $0.75
chiyuki: folds 
ChrisCDee: calls $0.75
nastya040: folds 
Perstenev: folds 
moku36: folds 
Grishukps: folds 
Serge Claws: folds 
*** FLOP *** [9h Td 9c]
God)Squall: checks 
ChrisCDee: bets $1.06
God)Squall: calls $1.06
*** TURN *** [9h Td 9c] [Ad]
God)Squall: checks 
ChrisCDee: bets $2.27
God)Squall: folds 
Uncalled bet ($2.27) returned to ChrisCDee
ChrisCDee collected $3.79 from pot
ChrisCDee: doesn't show hand 
*** SUMMARY ***
Total pot $3.97 | Rake $0.18 
Board [9h Td 9c Ad]
Seat 1: moku36 (button) folded before Flop (didn't bet)
Seat 2: Grishukps (small blind) folded before Flop
Seat 3: Serge Claws (big blind) folded before Flop
Seat 4: NuMetal88 folded before Flop (didn't bet)
Seat 5: God)Squall folded on the Turn
Seat 6: chiyuki folded before Flop (didn't bet)
Seat 7: ChrisCDee collected ($3.79)
Seat 8: nastya040 folded before Flop (didn't bet)
Seat 9: Perstenev folded before Flop (didn't bet)



PokerStars Zoom Hand #84300674700:  Hold'em No Limit ($0.10/$0.25) - 2012/08/05 15:43:46 JST [2012/08/05 2:43:46 ET]
Table 'Whirlpool' 9-max Seat #1 is the button
Seat 1: nice.franki ($11.40 in chips) 
Seat 2: 4plankton ($26.13 in chips) 
Seat 3: chiyuki ($45.80 in chips) 
Seat 4: macmauret ($10.51 in chips) 
Seat 5: tribunpdm ($90.77 in chips) 
Seat 6: Alvinpe85 ($56.39 in chips) 
Seat 7: Grishukps ($12.50 in chips) 
Seat 8: Serge Claws ($30.83 in chips) 
Seat 9: svg51 ($2.37 in chips) 
4plankton: posts small blind $0.10
chiyuki: posts big blind $0.25
*** HOLE CARDS ***
Dealt to chiyuki [7s Kd]
macmauret: folds 
tribunpdm: folds 
Alvinpe85: folds 
Grishukps: raises $0.50 to $0.75
Serge Claws: folds 
svg51: raises $0.50 to $1.25
nice.franki: folds 
4plankton: folds 
chiyuki: folds 
Grishukps: calls $0.50
*** FLOP *** [8c 3s 8h]
Grishukps: checks 
svg51: bets $1.12 and is all-in
Grishukps: folds 
Uncalled bet ($1.12) returned to svg51
svg51 collected $2.72 from pot
svg51: doesn't show hand 
*** SUMMARY ***
Total pot $2.85 | Rake $0.13 
Board [8c 3s 8h]
Seat 1: nice.franki (button) folded before Flop (didn't bet)
Seat 2: 4plankton (small blind) folded before Flop
Seat 3: chiyuki (big blind) folded before Flop
Seat 4: macmauret folded before Flop (didn't bet)
Seat 5: tribunpdm folded before Flop (didn't bet)
Seat 6: Alvinpe85 folded before Flop (didn't bet)
Seat 7: Grishukps folded on the Flop
Seat 8: Serge Claws folded before Flop (didn't bet)
Seat 9: svg51 collected ($2.72)



PokerStars Zoom Hand #84300678991:  Hold'em No Limit ($0.10/$0.25) - 2012/08/05 15:44:04 JST [2012/08/05 2:44:04 ET]
Table 'Whirlpool' 9-max Seat #1 is the button
Seat 1: snejokCoxx ($13.25 in chips) 
Seat 2: ZhukOFFskI ($19.17 in chips) 
Seat 3: ViTiV2010 ($13.07 in chips) 
Seat 4: Alvinpe85 ($47.50 in chips) 
Seat 5: Serge Claws ($26.72 in chips) 
Seat 6: risekuku468 ($28.39 in chips) 
Seat 7: Dejacob ($25 in chips) 
Seat 8: nice.franki ($12.15 in chips) 
Seat 9: chiyuki ($45.55 in chips) 
ZhukOFFskI: posts small blind $0.10
ViTiV2010: posts big blind $0.25
*** HOLE CARDS ***
Dealt to chiyuki [6s Qs]
Alvinpe85: folds 
Serge Claws: folds 
risekuku468: folds 
Dejacob: folds 
nice.franki: raises $0.50 to $0.75
chiyuki: folds 
snejokCoxx: folds 
ZhukOFFskI: raises $1.50 to $2.25
ViTiV2010: folds 
nice.franki: folds 
Uncalled bet ($1.50) returned to ZhukOFFskI
ZhukOFFskI collected $1.75 from pot
ZhukOFFskI: doesn't show hand 
*** SUMMARY ***
Total pot $1.75 | Rake $0 
Seat 1: snejokCoxx (button) folded before Flop (didn't bet)
Seat 2: ZhukOFFskI (small blind) collected ($1.75)
Seat 3: ViTiV2010 (big blind) folded before Flop
Seat 4: Alvinpe85 folded before Flop (didn't bet)
Seat 5: Serge Claws folded before Flop (didn't bet)
Seat 6: risekuku468 folded before Flop (didn't bet)
Seat 7: Dejacob folded before Flop (didn't bet)
Seat 8: nice.franki folded before Flop
Seat 9: chiyuki folded before Flop (didn't bet)



PokerStars Zoom Hand #84300682528:  Hold'em No Limit ($0.10/$0.25) - 2012/08/05 15:44:18 JST [2012/08/05 2:44:18 ET]
Table 'Whirlpool' 9-max Seat #1 is the button
Seat 1: phate-1up ($42.29 in chips) 
Seat 2: chiyuki ($45.55 in chips) 
Seat 3: snejokCoxx ($11.90 in chips) 
Seat 4: INSP!RON ($42.04 in chips) 
Seat 5: ChrisCDee ($39.07 in chips) 
Seat 6: Grishukps ($12.50 in chips) 
Seat 7: ShaninPeter ($11.50 in chips) 
Seat 8: DutchShultzs ($46.26 in chips) 
Seat 9: drunk_bender ($16.47 in chips) 
chiyuki: posts small blind $0.10
snejokCoxx: posts big blind $0.25
*** HOLE CARDS ***
Dealt to chiyuki [8c 8d]
INSP!RON: folds 
ChrisCDee: folds 
Grishukps: folds 
ShaninPeter: calls $0.25
DutchShultzs: folds 
drunk_bender: folds 
phate-1up: folds 
chiyuki: raises $0.75 to $1
snejokCoxx: folds 
ShaninPeter: folds 
Uncalled bet ($0.75) returned to chiyuki
chiyuki collected $0.75 from pot
chiyuki: doesn't show hand 
*** SUMMARY ***
Total pot $0.75 | Rake $0 
Seat 1: phate-1up (button) folded before Flop (didn't bet)
Seat 2: chiyuki (small blind) collected ($0.75)
Seat 3: snejokCoxx (big blind) folded before Flop
Seat 4: INSP!RON folded before Flop (didn't bet)
Seat 5: ChrisCDee folded before Flop (didn't bet)
Seat 6: Grishukps folded before Flop (didn't bet)
Seat 7: ShaninPeter folded before Flop
Seat 8: DutchShultzs folded before Flop (didn't bet)
Seat 9: drunk_bender folded before Flop (didn't bet)



PokerStars Zoom Hand #84300687967:  Hold'em No Limit ($0.10/$0.25) - 2012/08/05 15:44:39 JST [2012/08/05 2:44:39 ET]
Table 'Whirlpool' 9-max Seat #1 is the button
Seat 1: rey2040 ($19.35 in chips) 
Seat 2: DutchShultzs ($34.96 in chips) 
Seat 3: Dejacob ($25 in chips) 
Seat 4: JhonnyP1979 ($20.26 in chips) 
Seat 5: chiyuki ($46.05 in chips) 
Seat 6: romanian c4 ($20.32 in chips) 
Seat 7: kwkim73 ($27.96 in chips) 
Seat 8: opie62 ($19.73 in chips) 
Seat 9: Serge Claws ($26.37 in chips) 
DutchShultzs: posts small blind $0.10
Dejacob: posts big blind $0.25
*** HOLE CARDS ***
Dealt to chiyuki [6s 2c]
JhonnyP1979: raises $0.50 to $0.75
chiyuki: folds 
romanian c4: folds 
kwkim73: folds 
opie62: folds 
Serge Claws: folds 
rey2040: folds 
DutchShultzs: folds 
Dejacob: folds 
Uncalled bet ($0.50) returned to JhonnyP1979
JhonnyP1979 collected $0.60 from pot
JhonnyP1979: doesn't show hand 
*** SUMMARY ***
Total pot $0.60 | Rake $0 
Seat 1: rey2040 (button) folded before Flop (didn't bet)
Seat 2: DutchShultzs (small blind) folded before Flop
Seat 3: Dejacob (big blind) folded before Flop
Seat 4: JhonnyP1979 collected ($0.60)
Seat 5: chiyuki folded before Flop (didn't bet)
Seat 6: romanian c4 folded before Flop (didn't bet)
Seat 7: kwkim73 folded before Flop (didn't bet)
Seat 8: opie62 folded before Flop (didn't bet)
Seat 9: Serge Claws folded before Flop (didn't bet)



PokerStars Zoom Hand #84300689989:  Hold'em No Limit ($0.10/$0.25) - 2012/08/05 15:44:47 JST [2012/08/05 2:44:47 ET]
Table 'Whirlpool' 9-max Seat #1 is the button
Seat 1: chiyuki ($46.05 in chips) 
Seat 2: KeLevro0 ($8.81 in chips) 
Seat 3: kwkim73 ($27.96 in chips) 
Seat 4: Alvinpe85 ($56.14 in chips) 
Seat 5: ZhukOFFskI ($39.31 in chips) 
Seat 6: Dejacob ($26.70 in chips) 
Seat 7: Dan Royal ($24.65 in chips) 
Seat 8: NENE54 ($17.72 in chips) 
Seat 9: DutchShultzs ($46.26 in chips) 
KeLevro0: posts small blind $0.10
kwkim73: posts big blind $0.25
*** HOLE CARDS ***
Dealt to chiyuki [6s As]
Alvinpe85: folds 
ZhukOFFskI: folds 
Dejacob: folds 
Dan Royal: folds 
NENE54: folds 
DutchShultzs: folds 
chiyuki: raises $0.50 to $0.75
KeLevro0: folds 
kwkim73: folds 
Uncalled bet ($0.50) returned to chiyuki
chiyuki collected $0.60 from pot
chiyuki: doesn't show hand 
*** SUMMARY ***
Total pot $0.60 | Rake $0 
Seat 1: chiyuki (button) collected ($0.60)
Seat 2: KeLevro0 (small blind) folded before Flop
Seat 3: kwkim73 (big blind) folded before Flop
Seat 4: Alvinpe85 folded before Flop (didn't bet)
Seat 5: ZhukOFFskI folded before Flop (didn't bet)
Seat 6: Dejacob folded before Flop (didn't bet)
Seat 7: Dan Royal folded before Flop (didn't bet)
Seat 8: NENE54 folded before Flop (didn't bet)
Seat 9: DutchShultzs folded before Flop (didn't bet)



PokerStars Zoom Hand #84300688978:  Hold'em No Limit ($0.10/$0.25) - 2012/08/05 15:44:43 JST [2012/08/05 2:44:43 ET]
Table 'Whirlpool' 9-max Seat #1 is the button
Seat 1: Grishukps ($13.35 in chips) 
Seat 2: romanian c4 ($20.32 in chips) 
Seat 3: Perstenev ($8.78 in chips) 
Seat 4: chiyuki ($46.05 in chips) 
Seat 5: kwkim73 ($27.96 in chips) 
Seat 6: Ellen1947 ($29.27 in chips) 
Seat 7: Alvinpe85 ($56.14 in chips) 
Seat 8: HighDuka ($34.41 in chips) 
Seat 9: herkko11 ($6.18 in chips) 
romanian c4: posts small blind $0.10
Perstenev: posts big blind $0.25
*** HOLE CARDS ***
Dealt to chiyuki [5s 8c]
chiyuki: folds 
kwkim73: folds 
Ellen1947: raises $0.50 to $0.75
Alvinpe85: folds 
HighDuka: folds 
herkko11: folds 
Grishukps: folds 
romanian c4: folds 
Perstenev: folds 
Uncalled bet ($0.50) returned to Ellen1947
Ellen1947 collected $0.60 from pot
Ellen1947: doesn't show hand 
*** SUMMARY ***
Total pot $0.60 | Rake $0 
Seat 1: Grishukps (button) folded before Flop (didn't bet)
Seat 2: romanian c4 (small blind) folded before Flop
Seat 3: Perstenev (big blind) folded before Flop
Seat 4: chiyuki folded before Flop (didn't bet)
Seat 5: kwkim73 folded before Flop (didn't bet)
Seat 6: Ellen1947 collected ($0.60)
Seat 7: Alvinpe85 folded before Flop (didn't bet)
Seat 8: HighDuka folded before Flop (didn't bet)
Seat 9: herkko11 folded before Flop (didn't bet)



PokerStars Zoom Hand #84300695734:  Hold'em No Limit ($0.10/$0.25) - 2012/08/05 15:45:10 JST [2012/08/05 2:45:10 ET]
Table 'Whirlpool' 9-max Seat #1 is the button
Seat 1: kamikkaze ($12.38 in chips) 
Seat 2: nice.franki ($11.15 in chips) 
Seat 3: Grishukps ($13.35 in chips) 
Seat 4: moku36 ($46.95 in chips) 
Seat 5: DrunkTyphoon ($30.15 in chips) 
Seat 6: chiyuki ($46.40 in chips) 
Seat 7: seula i ($26.56 in chips) 
Seat 8: masterkoolb ($18.84 in chips) 
Seat 9: Dejacob ($25.79 in chips) 
nice.franki: posts small blind $0.10
Grishukps: posts big blind $0.25
*** HOLE CARDS ***
Dealt to chiyuki [4c Ts]
moku36: folds 
DrunkTyphoon: raises $0.50 to $0.75
chiyuki: folds 
seula i: folds 
masterkoolb: folds 
Dejacob: folds 
kamikkaze: folds 
nice.franki: folds 
Grishukps: folds 
Uncalled bet ($0.50) returned to DrunkTyphoon
DrunkTyphoon collected $0.60 from pot
DrunkTyphoon: doesn't show hand 
*** SUMMARY ***
Total pot $0.60 | Rake $0 
Seat 1: kamikkaze (button) folded before Flop (didn't bet)
Seat 2: nice.franki (small blind) folded before Flop
Seat 3: Grishukps (big blind) folded before Flop
Seat 4: moku36 folded before Flop (didn't bet)
Seat 5: DrunkTyphoon collected ($0.60)
Seat 6: chiyuki folded before Flop (didn't bet)
Seat 7: seula i folded before Flop (didn't bet)
Seat 8: masterkoolb folded before Flop (didn't bet)
Seat 9: Dejacob folded before Flop (didn't bet)



PokerStars Zoom Hand #84300697809:  Hold'em No Limit ($0.10/$0.25) - 2012/08/05 15:45:18 JST [2012/08/05 2:45:18 ET]
Table 'Whirlpool' 9-max Seat #1 is the button
Seat 1: kesstukas25 ($22.44 in chips) 
Seat 2: chiyuki ($46.40 in chips) 
Seat 3: Trip_Krowns ($23.53 in chips) 
Seat 4: Serge Claws ($42.13 in chips) 
Seat 5: GovGus ($37.65 in chips) 
Seat 6: KeLevro0 ($8.63 in chips) 
Seat 7: PPP7SSS ($19.48 in chips) 
Seat 8: Silveystryk ($24.79 in chips) 
Seat 9: mjmichi ($37.19 in chips) 
chiyuki: posts small blind $0.10
Trip_Krowns: posts big blind $0.25
*** HOLE CARDS ***
Dealt to chiyuki [Ts Qh]
Serge Claws: folds 
GovGus: folds 
KeLevro0: folds 
PPP7SSS: folds 
Silveystryk: folds 
mjmichi: folds 
kesstukas25: folds 
chiyuki: raises $0.50 to $0.75
Trip_Krowns: calls $0.50
*** FLOP *** [Ad 8h 4h]
chiyuki: bets $0.75
Trip_Krowns: folds 
Uncalled bet ($0.75) returned to chiyuki
chiyuki collected $1.43 from pot
chiyuki: doesn't show hand 
*** SUMMARY ***
Total pot $1.50 | Rake $0.07 
Board [Ad 8h 4h]
Seat 1: kesstukas25 (button) folded before Flop (didn't bet)
Seat 2: chiyuki (small blind) collected ($1.43)
Seat 3: Trip_Krowns (big blind) folded on the Flop
Seat 4: Serge Claws folded before Flop (didn't bet)
Seat 5: GovGus folded before Flop (didn't bet)
Seat 6: KeLevro0 folded before Flop (didn't bet)
Seat 7: PPP7SSS folded before Flop (didn't bet)
Seat 8: Silveystryk folded before Flop (didn't bet)
Seat 9: mjmichi folded before Flop (didn't bet)



PokerStars Zoom Hand #84300697052:  Hold'em No Limit ($0.10/$0.25) - 2012/08/05 15:45:15 JST [2012/08/05 2:45:15 ET]
Table 'Whirlpool' 9-max Seat #1 is the button
Seat 1: Femali54 ($24.65 in chips) 
Seat 2: panaam ($22.04 in chips) 
Seat 3: 1Karina1 ($37.39 in chips) 
Seat 4: seula i ($26.56 in chips) 
Seat 5: macmauret ($8.79 in chips) 
Seat 6: AntoineHunt ($40.94 in chips) 
Seat 7: chiyuki ($46.40 in chips) 
Seat 8: Rilko1975 ($24.65 in chips) 
Seat 9: snejokCoxx ($11.90 in chips) 
panaam: posts small blind $0.10
1Karina1: posts big blind $0.25
*** HOLE CARDS ***
Dealt to chiyuki [6d 2d]
seula i: folds 
macmauret: calls $0.25
AntoineHunt: folds 
chiyuki: folds 
Rilko1975: folds 
snejokCoxx: folds 
Femali54: folds 
panaam: folds 
1Karina1: checks 
*** FLOP *** [3h Jh Jc]
1Karina1: checks 
macmauret: bets $0.42
1Karina1: raises $1.08 to $1.50
macmauret: calls $1.08
*** TURN *** [3h Jh Jc] [Ts]
1Karina1: bets $1.72
macmauret: calls $1.72
*** RIVER *** [3h Jh Jc Ts] [Kh]
1Karina1: checks 
macmauret: checks 
*** SHOW DOWN ***
1Karina1: shows [4c Jd] (three of a kind, Jacks)
macmauret: mucks hand 
1Karina1 collected $6.72 from pot
*** SUMMARY ***
Total pot $7.04 | Rake $0.32 
Board [3h Jh Jc Ts Kh]
Seat 1: Femali54 (button) folded before Flop (didn't bet)
Seat 2: panaam (small blind) folded before Flop
Seat 3: 1Karina1 (big blind) showed [4c Jd] and won ($6.72) with three of a kind, Jacks
Seat 4: seula i folded before Flop (didn't bet)
Seat 5: macmauret mucked [Ac Ad]
Seat 6: AntoineHunt folded before Flop (didn't bet)
Seat 7: chiyuki folded before Flop (didn't bet)
Seat 8: Rilko1975 folded before Flop (didn't bet)
Seat 9: snejokCoxx folded before Flop (didn't bet)



PokerStars Zoom Hand #84300706080:  Hold'em No Limit ($0.10/$0.25) - 2012/08/05 15:45:50 JST [2012/08/05 2:45:50 ET]
Table 'Whirlpool' 9-max Seat #1 is the button
Seat 1: INSP!RON ($39.57 in chips) 
Seat 2: seula i ($26.66 in chips) 
Seat 3: Kasperlmusik ($25 in chips) 
Seat 4: Silveystryk ($24.76 in chips) 
Seat 5: KeLevro0 ($8.38 in chips) 
Seat 6: masterkoolb ($18.74 in chips) 
Seat 7: phate-1up ($57.62 in chips) 
Seat 8: Grishukps ($12.50 in chips) 
Seat 9: chiyuki ($47.08 in chips) 
seula i: posts small blind $0.10
Kasperlmusik: posts big blind $0.25
*** HOLE CARDS ***
Dealt to chiyuki [9d Kc]
Silveystryk: folds 
KeLevro0: folds 
masterkoolb: folds 
phate-1up: raises $0.50 to $0.75
Grishukps: folds 
chiyuki: folds 
INSP!RON: folds 
seula i: folds 
Kasperlmusik: folds 
Uncalled bet ($0.50) returned to phate-1up
phate-1up collected $0.60 from pot
phate-1up: doesn't show hand 
*** SUMMARY ***
Total pot $0.60 | Rake $0 
Seat 1: INSP!RON (button) folded before Flop (didn't bet)
Seat 2: seula i (small blind) folded before Flop
Seat 3: Kasperlmusik (big blind) folded before Flop
Seat 4: Silveystryk folded before Flop (didn't bet)
Seat 5: KeLevro0 folded before Flop (didn't bet)
Seat 6: masterkoolb folded before Flop (didn't bet)
Seat 7: phate-1up collected ($0.60)
Seat 8: Grishukps folded before Flop (didn't bet)
Seat 9: chiyuki folded before Flop (didn't bet)



PokerStars Zoom Hand #84300716219:  Hold'em No Limit ($0.10/$0.25) - 2012/08/05 15:46:30 JST [2012/08/05 2:46:30 ET]
Table 'Whirlpool' 9-max Seat #1 is the button
Seat 1: ShaninPeter ($11.72 in chips) 
Seat 2: leo2095 ($31.09 in chips) 
Seat 3: 1Karina1 ($36.07 in chips) 
Seat 4: snejokCoxx ($11.50 in chips) 
Seat 5: Kasperlmusik ($25.35 in chips) 
Seat 6: Grishukps ($12.90 in chips) 
Seat 7: hldtom ($28.29 in chips) 
Seat 8: chiyuki ($46.83 in chips) 
Seat 9: drunk_bender ($18.86 in chips) 
leo2095: posts small blind $0.10
1Karina1: posts big blind $0.25
*** HOLE CARDS ***
Dealt to chiyuki [Qs 6h]
snejokCoxx: folds 
Kasperlmusik: folds 
Grishukps: folds 
hldtom: raises $0.50 to $0.75
chiyuki: folds 
drunk_bender: folds 
ShaninPeter: folds 
leo2095: folds 
1Karina1: folds 
Uncalled bet ($0.50) returned to hldtom
hldtom collected $0.60 from pot
hldtom: doesn't show hand 
*** SUMMARY ***
Total pot $0.60 | Rake $0 
Seat 1: ShaninPeter (button) folded before Flop (didn't bet)
Seat 2: leo2095 (small blind) folded before Flop
Seat 3: 1Karina1 (big blind) folded before Flop
Seat 4: snejokCoxx folded before Flop (didn't bet)
Seat 5: Kasperlmusik folded before Flop (didn't bet)
Seat 6: Grishukps folded before Flop (didn't bet)
Seat 7: hldtom collected ($0.60)
Seat 8: chiyuki folded before Flop (didn't bet)
Seat 9: drunk_bender folded before Flop (didn't bet)



PokerStars Zoom Hand #84300707124:  Hold'em No Limit ($0.10/$0.25) - 2012/08/05 15:45:54 JST [2012/08/05 2:45:54 ET]
Table 'Whirlpool' 9-max Seat #1 is the button
Seat 1: River_GmbH ($12.95 in chips) 
Seat 2: KeLevro0 ($8.38 in chips) 
Seat 3: chiyuki ($47.08 in chips) 
Seat 4: Limoilou ($31.32 in chips) 
Seat 5: Alvinpe85 ($54.04 in chips) 
Seat 6: NENE54 ($19.45 in chips) 
Seat 7: ViTiV2010 ($12.82 in chips) 
Seat 8: fil740 ($6.82 in chips) 
Seat 9: Silveystryk ($24.76 in chips) 
KeLevro0: posts small blind $0.10
chiyuki: posts big blind $0.25
*** HOLE CARDS ***
Dealt to chiyuki [Qh 2h]
Limoilou: folds 
Alvinpe85: folds 
NENE54: calls $0.25
ViTiV2010: folds 
fil740: raises $0.25 to $0.50
Silveystryk: calls $0.50
River_GmbH: folds 
KeLevro0: calls $0.40
chiyuki: folds 
NENE54: calls $0.25
*** FLOP *** [Qd Jd Jh]
KeLevro0: checks 
NENE54: checks 
fil740: bets $0.50
Silveystryk: folds 
KeLevro0: folds 
NENE54: calls $0.50
*** TURN *** [Qd Jd Jh] [9s]
NENE54: checks 
fil740: bets $0.50
NENE54: calls $0.50
*** RIVER *** [Qd Jd Jh 9s] [3d]
NENE54: checks 
fil740: bets $1.25
NENE54: folds 
Uncalled bet ($1.25) returned to fil740
fil740 collected $4.06 from pot
fil740: doesn't show hand 
*** SUMMARY ***
Total pot $4.25 | Rake $0.19 
Board [Qd Jd Jh 9s 3d]
Seat 1: River_GmbH (button) folded before Flop (didn't bet)
Seat 2: KeLevro0 (small blind) folded on the Flop
Seat 3: chiyuki (big blind) folded before Flop
Seat 4: Limoilou folded before Flop (didn't bet)
Seat 5: Alvinpe85 folded before Flop (didn't bet)
Seat 6: NENE54 folded on the River
Seat 7: ViTiV2010 folded before Flop (didn't bet)
Seat 8: fil740 collected ($4.06)
Seat 9: Silveystryk folded on the Flop



PokerStars Zoom Hand #84300717557:  Hold'em No Limit ($0.10/$0.25) - 2012/08/05 15:46:35 JST [2012/08/05 2:46:35 ET]
Table 'Whirlpool' 9-max Seat #1 is the button
Seat 1: KeLevro0 ($12.82 in chips) 
Seat 2: pandaaaaaa ($21.85 in chips) 
Seat 3: kkbruins0408 ($20.95 in chips) 
Seat 4: jacquelinewu ($26.43 in chips) 
Seat 5: Rici47 ($30.12 in chips) 
Seat 6: 4ydo yogurt ($27.78 in chips) 
Seat 7: chiyuki ($46.83 in chips) 
Seat 8: TorTrade ($26.04 in chips) 
Seat 9: Fructionar ($35.33 in chips) 
pandaaaaaa: posts small blind $0.10
kkbruins0408: posts big blind $0.25
*** HOLE CARDS ***
Dealt to chiyuki [Qh Qc]
jacquelinewu: folds 
Rici47: folds 
4ydo yogurt: folds 
chiyuki: raises $0.50 to $0.75
TorTrade: folds 
Fructionar: folds 
KeLevro0: folds 
pandaaaaaa: folds 
kkbruins0408: calls $0.50
*** FLOP *** [Ks Qd Ts]
kkbruins0408: bets $1
chiyuki: raises $2.25 to $3.25
kkbruins0408: calls $2.25
*** TURN *** [Ks Qd Ts] [2h]
kkbruins0408: checks 
chiyuki: bets $5.75
kkbruins0408: folds 
Uncalled bet ($5.75) returned to chiyuki
chiyuki collected $7.74 from pot
chiyuki: doesn't show hand 
*** SUMMARY ***
Total pot $8.10 | Rake $0.36 
Board [Ks Qd Ts 2h]
Seat 1: KeLevro0 (button) folded before Flop (didn't bet)
Seat 2: pandaaaaaa (small blind) folded before Flop
Seat 3: kkbruins0408 (big blind) folded on the Turn
Seat 4: jacquelinewu folded before Flop (didn't bet)
Seat 5: Rici47 folded before Flop (didn't bet)
Seat 6: 4ydo yogurt folded before Flop (didn't bet)
Seat 7: chiyuki collected ($7.74)
Seat 8: TorTrade folded before Flop (didn't bet)
Seat 9: Fructionar folded before Flop (didn't bet)



PokerStars Zoom Hand #84300732181:  Hold'em No Limit ($0.10/$0.25) - 2012/08/05 15:47:32 JST [2012/08/05 2:47:32 ET]
Table 'Whirlpool' 9-max Seat #1 is the button
Seat 1: Alvinpe85 ($46.52 in chips) 
Seat 2: KrystalAA ($42.12 in chips) 
Seat 3: Serge Claws ($40.68 in chips) 
Seat 4: chiyuki ($50.57 in chips) 
Seat 5: Saruotiss ($65.11 in chips) 
Seat 6: snejokCoxx ($11.15 in chips) 
Seat 7: Kasperlmusik ($25.10 in chips) 
Seat 8: kesstukas25 ($15 in chips) 
Seat 9: nice.franki ($6.90 in chips) 
KrystalAA: posts small blind $0.10
Serge Claws: posts big blind $0.25
*** HOLE CARDS ***
Dealt to chiyuki [Jc 9d]
chiyuki: folds 
Saruotiss: raises $0.25 to $0.50
snejokCoxx: folds 
Kasperlmusik: folds 
kesstukas25: folds 
nice.franki: folds 
Alvinpe85: folds 
KrystalAA: folds 
Serge Claws: folds 
Uncalled bet ($0.25) returned to Saruotiss
Saruotiss collected $0.60 from pot
Saruotiss: doesn't show hand 
*** SUMMARY ***
Total pot $0.60 | Rake $0 
Seat 1: Alvinpe85 (button) folded before Flop (didn't bet)
Seat 2: KrystalAA (small blind) folded before Flop
Seat 3: Serge Claws (big blind) folded before Flop
Seat 4: chiyuki folded before Flop (didn't bet)
Seat 5: Saruotiss collected ($0.60)
Seat 6: snejokCoxx folded before Flop (didn't bet)
Seat 7: Kasperlmusik folded before Flop (didn't bet)
Seat 8: kesstukas25 folded before Flop (didn't bet)
Seat 9: nice.franki folded before Flop (didn't bet)



PokerStars Zoom Hand #84300733432:  Hold'em No Limit ($0.10/$0.25) - 2012/08/05 15:47:37 JST [2012/08/05 2:47:37 ET]
Table 'Whirlpool' 9-max Seat #1 is the button
Seat 1: chiyuki ($50.57 in chips) 
Seat 2: 1Karina1 ($25.10 in chips) 
Seat 3: nice.franki ($11.05 in chips) 
Seat 4: ShaninPeter ($11.62 in chips) 
Seat 5: DrunkTyphoon ($30.15 in chips) 
Seat 6: PPP7SSS ($18.58 in chips) 
Seat 7: kesstukas25 ($15 in chips) 
Seat 8: kamikkaze ($18.60 in chips) 
Seat 9: Spheroff ($17.67 in chips) 
1Karina1: posts small blind $0.10
nice.franki: posts big blind $0.25
*** HOLE CARDS ***
Dealt to chiyuki [Jh Qc]
ShaninPeter: folds 
DrunkTyphoon: folds 
PPP7SSS: folds 
kesstukas25: folds 
kamikkaze: folds 
Spheroff: raises $0.50 to $0.75
chiyuki: folds 
1Karina1: folds 
nice.franki: folds 
Uncalled bet ($0.50) returned to Spheroff
Spheroff collected $0.60 from pot
Spheroff: doesn't show hand 
*** SUMMARY ***
Total pot $0.60 | Rake $0 
Seat 1: chiyuki (button) folded before Flop (didn't bet)
Seat 2: 1Karina1 (small blind) folded before Flop
Seat 3: nice.franki (big blind) folded before Flop
Seat 4: ShaninPeter folded before Flop (didn't bet)
Seat 5: DrunkTyphoon folded before Flop (didn't bet)
Seat 6: PPP7SSS folded before Flop (didn't bet)
Seat 7: kesstukas25 folded before Flop (didn't bet)
Seat 8: kamikkaze folded before Flop (didn't bet)
Seat 9: Spheroff collected ($0.60)



PokerStars Zoom Hand #84300739151:  Hold'em No Limit ($0.10/$0.25) - 2012/08/05 15:47:59 JST [2012/08/05 2:47:59 ET]
Table 'Whirlpool' 9-max Seat #1 is the button
Seat 1: kesstukas25 ($16.72 in chips) 
Seat 2: GSDP ($49.64 in chips) 
Seat 3: 1Karina1 ($35.62 in chips) 
Seat 4: WARIBANA7777 ($15.02 in chips) 
Seat 5: Femali54 ($25 in chips) 
Seat 6: kamikkaze ($18.95 in chips) 
Seat 7: jacquelinewu ($32.99 in chips) 
Seat 8: chiyuki ($50.57 in chips) 
Seat 9: ShaninPeter ($11.72 in chips) 
GSDP: posts small blind $0.10
1Karina1: posts big blind $0.25
*** HOLE CARDS ***
Dealt to chiyuki [9d 6d]
WARIBANA7777: folds 
Femali54: folds 
kamikkaze: folds 
jacquelinewu: folds 
chiyuki: folds 
ShaninPeter: folds 
kesstukas25: folds 
GSDP: calls $0.15
1Karina1: checks 
*** FLOP *** [Qh Jh Kc]
GSDP: bets $0.25
1Karina1: calls $0.25
*** TURN *** [Qh Jh Kc] [Kh]
GSDP: bets $0.75
1Karina1: folds 
Uncalled bet ($0.75) returned to GSDP
GSDP collected $0.96 from pot
GSDP: doesn't show hand 
*** SUMMARY ***
Total pot $1 | Rake $0.04 
Board [Qh Jh Kc Kh]
Seat 1: kesstukas25 (button) folded before Flop (didn't bet)
Seat 2: GSDP (small blind) collected ($0.96)
Seat 3: 1Karina1 (big blind) folded on the Turn
Seat 4: WARIBANA7777 folded before Flop (didn't bet)
Seat 5: Femali54 folded before Flop (didn't bet)
Seat 6: kamikkaze folded before Flop (didn't bet)
Seat 7: jacquelinewu folded before Flop (didn't bet)
Seat 8: chiyuki folded before Flop (didn't bet)
Seat 9: ShaninPeter folded before Flop (didn't bet)



PokerStars Zoom Hand #84300740183:  Hold'em No Limit ($0.10/$0.25) - 2012/08/05 15:48:03 JST [2012/08/05 2:48:03 ET]
Table 'Whirlpool' 9-max Seat #1 is the button
Seat 1: KeLevro0 ($12.51 in chips) 
Seat 2: WARIBANA7777 ($15.02 in chips) 
Seat 3: xxx Spb xxx ($26.55 in chips) 
Seat 4: nice.franki ($10.80 in chips) 
Seat 5: chiyuki ($50.57 in chips) 
Seat 6: DutchShultzs ($26.03 in chips) 
Seat 7: ShaninPeter ($11.72 in chips) 
Seat 8: Perstenev ($7.18 in chips) 
Seat 9: hldtom ($12.50 in chips) 
WARIBANA7777: posts small blind $0.10
xxx Spb xxx: posts big blind $0.25
*** HOLE CARDS ***
Dealt to chiyuki [Jc 6h]
nice.franki: folds 
chiyuki: folds 
DutchShultzs: folds 
ShaninPeter: folds 
Perstenev: folds 
hldtom: folds 
KeLevro0: folds 
WARIBANA7777: folds 
Uncalled bet ($0.15) returned to xxx Spb xxx
xxx Spb xxx collected $0.20 from pot
xxx Spb xxx: doesn't show hand 
*** SUMMARY ***
Total pot $0.20 | Rake $0 
Seat 1: KeLevro0 (button) folded before Flop (didn't bet)
Seat 2: WARIBANA7777 (small blind) folded before Flop
Seat 3: xxx Spb xxx (big blind) collected ($0.20)
Seat 4: nice.franki folded before Flop (didn't bet)
Seat 5: chiyuki folded before Flop (didn't bet)
Seat 6: DutchShultzs folded before Flop (didn't bet)
Seat 7: ShaninPeter folded before Flop (didn't bet)
Seat 8: Perstenev folded before Flop (didn't bet)
Seat 9: hldtom folded before Flop (didn't bet)



PokerStars Zoom Hand #84300744439:  Hold'em No Limit ($0.10/$0.25) - 2012/08/05 15:48:19 JST [2012/08/05 2:48:19 ET]
Table 'Whirlpool' 9-max Seat #1 is the button
Seat 1: nice.franki ($6.65 in chips) 
Seat 2: DrunkTyphoon ($29.90 in chips) 
Seat 3: INSP!RON ($40.14 in chips) 
Seat 4: Nerkit ($12.50 in chips) 
Seat 5: Silveystryk ($23.26 in chips) 
Seat 6: phate-1up ($63.92 in chips) 
Seat 7: DutchShultzs ($25.38 in chips) 
Seat 8: seula i ($30.35 in chips) 
Seat 9: chiyuki ($50.57 in chips) 
DrunkTyphoon: posts small blind $0.10
INSP!RON: posts big blind $0.25
*** HOLE CARDS ***
Dealt to chiyuki [5c Kc]
Nerkit: folds 
Silveystryk: folds 
phate-1up: folds 
DutchShultzs: folds 
seula i: folds 
chiyuki: folds 
nice.franki: folds 
DrunkTyphoon: folds 
Uncalled bet ($0.15) returned to INSP!RON
INSP!RON collected $0.20 from pot
INSP!RON: doesn't show hand 
*** SUMMARY ***
Total pot $0.20 | Rake $0 
Seat 1: nice.franki (button) folded before Flop (didn't bet)
Seat 2: DrunkTyphoon (small blind) folded before Flop
Seat 3: INSP!RON (big blind) collected ($0.20)
Seat 4: Nerkit folded before Flop (didn't bet)
Seat 5: Silveystryk folded before Flop (didn't bet)
Seat 6: phate-1up folded before Flop (didn't bet)
Seat 7: DutchShultzs folded before Flop (didn't bet)
Seat 8: seula i folded before Flop (didn't bet)
Seat 9: chiyuki folded before Flop (didn't bet)



PokerStars Zoom Hand #84300745700:  Hold'em No Limit ($0.10/$0.25) - 2012/08/05 15:48:24 JST [2012/08/05 2:48:24 ET]
Table 'Whirlpool' 9-max Seat #1 is the button
Seat 1: 0 operator 0 ($28.62 in chips) 
Seat 2: KrystalAA ($37.27 in chips) 
Seat 3: SAILUSI ($25 in chips) 
Seat 4: chiyuki ($50.57 in chips) 
Seat 5: rey2040 ($23.62 in chips) 
Seat 6: Kreiler ($12.15 in chips) 
Seat 7: masterkoolb ($12.50 in chips) 
Seat 8: Alvinpe85 ($56.55 in chips) 
Seat 9: Trip_Krowns ($26.36 in chips) 
KrystalAA: posts small blind $0.10
SAILUSI: posts big blind $0.25
*** HOLE CARDS ***
Dealt to chiyuki [6s 9h]
chiyuki: folds 
rey2040: folds 
Kreiler: folds 
masterkoolb: folds 
Alvinpe85: raises $0.37 to $0.62
Trip_Krowns: folds 
0 operator 0: folds 
KrystalAA: folds 
SAILUSI: folds 
Uncalled bet ($0.37) returned to Alvinpe85
Alvinpe85 collected $0.60 from pot
Alvinpe85: doesn't show hand 
*** SUMMARY ***
Total pot $0.60 | Rake $0 
Seat 1: 0 operator 0 (button) folded before Flop (didn't bet)
Seat 2: KrystalAA (small blind) folded before Flop
Seat 3: SAILUSI (big blind) folded before Flop
Seat 4: chiyuki folded before Flop (didn't bet)
Seat 5: rey2040 folded before Flop (didn't bet)
Seat 6: Kreiler folded before Flop (didn't bet)
Seat 7: masterkoolb folded before Flop (didn't bet)
Seat 8: Alvinpe85 collected ($0.60)
Seat 9: Trip_Krowns folded before Flop (didn't bet)



PokerStars Zoom Hand #84300737354:  Hold'em No Limit ($0.10/$0.25) - 2012/08/05 15:47:52 JST [2012/08/05 2:47:52 ET]
Table 'Whirlpool' 9-max Seat #1 is the button
Seat 1: River_GmbH ($13.38 in chips) 
Seat 2: Serge Claws ($26.60 in chips) 
Seat 3: Limoilou ($32.75 in chips) 
Seat 4: 4ydo yogurt ($28.45 in chips) 
Seat 5: DutchShultzs ($45.91 in chips) 
Seat 6: chiyuki ($50.57 in chips) 
Seat 7: Femali54 ($25 in chips) 
Seat 8: jacquelinewu ($32.99 in chips) 
Seat 9: fwnaf ($18.61 in chips) 
Serge Claws: posts small blind $0.10
Limoilou: posts big blind $0.25
*** HOLE CARDS ***
Dealt to chiyuki [Ks 9d]
4ydo yogurt: raises $0.50 to $0.75
DutchShultzs: raises $1.75 to $2.50
chiyuki: folds 
Femali54: folds 
jacquelinewu: folds 
fwnaf: folds 
River_GmbH: folds 
Serge Claws: folds 
Limoilou: folds 
4ydo yogurt: calls $1.75
*** FLOP *** [4h Ad 8h]
4ydo yogurt: checks 
DutchShultzs: bets $3.70
4ydo yogurt: calls $3.70
*** TURN *** [4h Ad 8h] [5d]
4ydo yogurt: checks 
DutchShultzs: bets $39.71 and is all-in
4ydo yogurt: calls $22.25 and is all-in
Uncalled bet ($17.46) returned to DutchShultzs
*** RIVER *** [4h Ad 8h 5d] [Qd]
*** SHOW DOWN ***
4ydo yogurt: shows [5h 5c] (three of a kind, Fives)
DutchShultzs: shows [Kh As] (a pair of Aces)
4ydo yogurt collected $55.25 from pot
*** SUMMARY ***
Total pot $57.25 | Rake $2 
Board [4h Ad 8h 5d Qd]
Seat 1: River_GmbH (button) folded before Flop (didn't bet)
Seat 2: Serge Claws (small blind) folded before Flop
Seat 3: Limoilou (big blind) folded before Flop
Seat 4: 4ydo yogurt showed [5h 5c] and won ($55.25) with three of a kind, Fives
Seat 5: DutchShultzs showed [Kh As] and lost with a pair of Aces
Seat 6: chiyuki folded before Flop (didn't bet)
Seat 7: Femali54 folded before Flop (didn't bet)
Seat 8: jacquelinewu folded before Flop (didn't bet)
Seat 9: fwnaf folded before Flop (didn't bet)



PokerStars Zoom Hand #84300746746:  Hold'em No Limit ($0.10/$0.25) - 2012/08/05 15:48:28 JST [2012/08/05 2:48:28 ET]
Table 'Whirlpool' 9-max Seat #1 is the button
Seat 1: DrunkTyphoon ($29.80 in chips) 
Seat 2: Rici47 ($32.01 in chips) 
Seat 3: chiyuki ($50.57 in chips) 
Seat 4: phate-1up ($42.64 in chips) 
Seat 5: ShaninPeter ($12.07 in chips) 
Seat 6: masterkoolb ($12.50 in chips) 
Seat 7: KeLevro0 ($12.51 in chips) 
Seat 8: HighDuka ($31.40 in chips) 
Seat 9: 0 operator 0 ($28.62 in chips) 
Rici47: posts small blind $0.10
chiyuki: posts big blind $0.25
*** HOLE CARDS ***
Dealt to chiyuki [6s Kd]
phate-1up: folds 
ShaninPeter: folds 
masterkoolb: folds 
KeLevro0: folds 
HighDuka: raises $0.50 to $0.75
0 operator 0: folds 
DrunkTyphoon: folds 
Rici47: folds 
chiyuki: folds 
Uncalled bet ($0.50) returned to HighDuka
HighDuka collected $0.60 from pot
HighDuka: doesn't show hand 
*** SUMMARY ***
Total pot $0.60 | Rake $0 
Seat 1: DrunkTyphoon (button) folded before Flop (didn't bet)
Seat 2: Rici47 (small blind) folded before Flop
Seat 3: chiyuki (big blind) folded before Flop
Seat 4: phate-1up folded before Flop (didn't bet)
Seat 5: ShaninPeter folded before Flop (didn't bet)
Seat 6: masterkoolb folded before Flop (didn't bet)
Seat 7: KeLevro0 folded before Flop (didn't bet)
Seat 8: HighDuka collected ($0.60)
Seat 9: 0 operator 0 folded before Flop (didn't bet)



PokerStars Zoom Hand #84300751775:  Hold'em No Limit ($0.10/$0.25) - 2012/08/05 15:48:48 JST [2012/08/05 2:48:48 ET]
Table 'Whirlpool' 9-max Seat #1 is the button
Seat 1: INSP!RON ($40.14 in chips) 
Seat 2: chiyuki ($50.32 in chips) 
Seat 3: kesstukas25 ($13.15 in chips) 
Seat 4: mjmichi ($61.79 in chips) 
Seat 5: Alvinpe85 ($56.90 in chips) 
Seat 6: nice.franki ($10.45 in chips) 
Seat 7: Perstenev ($7.18 in chips) 
Seat 8: Grishukps ($12.50 in chips) 
Seat 9: kwkim73 ($29.08 in chips) 
chiyuki: posts small blind $0.10
kesstukas25: posts big blind $0.25
*** HOLE CARDS ***
Dealt to chiyuki [7c Ad]
mjmichi: folds 
Alvinpe85: raises $0.50 to $0.75
nice.franki: folds 
Perstenev: folds 
Grishukps: folds 
kwkim73: calls $0.75
INSP!RON: folds 
chiyuki: folds 
kesstukas25: folds 
*** FLOP *** [5s 9s 9h]
Alvinpe85: bets $1.06
kwkim73: folds 
Uncalled bet ($1.06) returned to Alvinpe85
Alvinpe85 collected $1.77 from pot
Alvinpe85: doesn't show hand 
*** SUMMARY ***
Total pot $1.85 | Rake $0.08 
Board [5s 9s 9h]
Seat 1: INSP!RON (button) folded before Flop (didn't bet)
Seat 2: chiyuki (small blind) folded before Flop
Seat 3: kesstukas25 (big blind) folded before Flop
Seat 4: mjmichi folded before Flop (didn't bet)
Seat 5: Alvinpe85 collected ($1.77)
Seat 6: nice.franki folded before Flop (didn't bet)
Seat 7: Perstenev folded before Flop (didn't bet)
Seat 8: Grishukps folded before Flop (didn't bet)
Seat 9: kwkim73 folded on the Flop



PokerStars Zoom Hand #84300754172:  Hold'em No Limit ($0.10/$0.25) - 2012/08/05 15:48:57 JST [2012/08/05 2:48:57 ET]
Table 'Whirlpool' 9-max Seat #1 is the button
Seat 1: SAILUSI ($24.65 in chips) 
Seat 2: moku36 ($44.88 in chips) 
Seat 3: laurentzu84 ($46.29 in chips) 
Seat 4: God)Squall ($27.72 in chips) 
Seat 5: banderas761 ($9.98 in chips) 
Seat 6: chiyuki ($50.22 in chips) 
Seat 7: HighDuka ($31.75 in chips) 
Seat 8: KeLevro0 ($13.25 in chips) 
Seat 9: INSP!RON ($39.94 in chips) 
moku36: posts small blind $0.10
laurentzu84: posts big blind $0.25
*** HOLE CARDS ***
Dealt to chiyuki [4s Qh]
God)Squall: folds 
banderas761: folds 
chiyuki: folds 
HighDuka: folds 
KeLevro0: raises $0.42 to $0.67
INSP!RON: folds 
SAILUSI: folds 
moku36: folds 
laurentzu84: folds 
Uncalled bet ($0.42) returned to KeLevro0
KeLevro0 collected $0.60 from pot
KeLevro0: doesn't show hand 
*** SUMMARY ***
Total pot $0.60 | Rake $0 
Seat 1: SAILUSI (button) folded before Flop (didn't bet)
Seat 2: moku36 (small blind) folded before Flop
Seat 3: laurentzu84 (big blind) folded before Flop
Seat 4: God)Squall folded before Flop (didn't bet)
Seat 5: banderas761 folded before Flop (didn't bet)
Seat 6: chiyuki folded before Flop (didn't bet)
Seat 7: HighDuka folded before Flop (didn't bet)
Seat 8: KeLevro0 collected ($0.60)
Seat 9: INSP!RON folded before Flop (didn't bet)



PokerStars Zoom Hand #84300755986:  Hold'em No Limit ($0.10/$0.25) - 2012/08/05 15:49:04 JST [2012/08/05 2:49:04 ET]
Table 'Whirlpool' 9-max Seat #1 is the button
Seat 1: God)Squall ($27.72 in chips) 
Seat 2: DutchShultzs ($25 in chips) 
Seat 3: slapshot2011 ($25.31 in chips) 
Seat 4: herkko11 ($9.78 in chips) 
Seat 5: Perstenev ($12.97 in chips) 
Seat 6: jvds114 ($38 in chips) 
Seat 7: chiyuki ($50.22 in chips) 
Seat 8: INSP!RON ($39.84 in chips) 
Seat 9: jacquelinewu ($32.64 in chips) 
DutchShultzs: posts small blind $0.10
slapshot2011: posts big blind $0.25
*** HOLE CARDS ***
Dealt to chiyuki [Qd Td]
herkko11: folds 
Perstenev: folds 
jvds114: folds 
chiyuki: folds 
INSP!RON: folds 
jacquelinewu: raises $0.50 to $0.75
God)Squall: folds 
DutchShultzs: folds 
slapshot2011: folds 
Uncalled bet ($0.50) returned to jacquelinewu
jacquelinewu collected $0.60 from pot
jacquelinewu: doesn't show hand 
*** SUMMARY ***
Total pot $0.60 | Rake $0 
Seat 1: God)Squall (button) folded before Flop (didn't bet)
Seat 2: DutchShultzs (small blind) folded before Flop
Seat 3: slapshot2011 (big blind) folded before Flop
Seat 4: herkko11 folded before Flop (didn't bet)
Seat 5: Perstenev folded before Flop (didn't bet)
Seat 6: jvds114 folded before Flop (didn't bet)
Seat 7: chiyuki folded before Flop (didn't bet)
Seat 8: INSP!RON folded before Flop (didn't bet)
Seat 9: jacquelinewu collected ($0.60)



PokerStars Zoom Hand #84300757329:  Hold'em No Limit ($0.10/$0.25) - 2012/08/05 15:49:09 JST [2012/08/05 2:49:09 ET]
Table 'Whirlpool' 9-max Seat #1 is the button
Seat 1: chiyuki ($50.22 in chips) 
Seat 2: macmauret ($5.02 in chips) 
Seat 3: kwkim73 ($28.33 in chips) 
Seat 4: KeLevro0 ($12.18 in chips) 
Seat 5: KrystalAA ($13.92 in chips) 
Seat 6: masterkoolb ($13.50 in chips) 
Seat 7: Silveystryk ($22.91 in chips) 
Seat 8: Rici47 ($38.81 in chips) 
Seat 9: kesstukas25 ($12.90 in chips) 
macmauret: posts small blind $0.10
kwkim73: posts big blind $0.25
*** HOLE CARDS ***
Dealt to chiyuki [8h Ts]
KeLevro0: folds 
KrystalAA: folds 
masterkoolb: folds 
Silveystryk: folds 
Rici47: folds 
kesstukas25: folds 
chiyuki: folds 
macmauret: folds 
Uncalled bet ($0.15) returned to kwkim73
kwkim73 collected $0.20 from pot
kwkim73: doesn't show hand 
*** SUMMARY ***
Total pot $0.20 | Rake $0 
Seat 1: chiyuki (button) folded before Flop (didn't bet)
Seat 2: macmauret (small blind) folded before Flop
Seat 3: kwkim73 (big blind) collected ($0.20)
Seat 4: KeLevro0 folded before Flop (didn't bet)
Seat 5: KrystalAA folded before Flop (didn't bet)
Seat 6: masterkoolb folded before Flop (didn't bet)
Seat 7: Silveystryk folded before Flop (didn't bet)
Seat 8: Rici47 folded before Flop (didn't bet)
Seat 9: kesstukas25 folded before Flop (didn't bet)



PokerStars Zoom Hand #84300758305:  Hold'em No Limit ($0.10/$0.25) - 2012/08/05 15:49:13 JST [2012/08/05 2:49:13 ET]
Table 'Whirlpool' 9-max Seat #1 is the button
Seat 1: jacquelinewu ($25.68 in chips) 
Seat 2: Lasutchik ($12.25 in chips) 
Seat 3: Perstenev ($12.78 in chips) 
Seat 4: Kozyavkin ($21.24 in chips) 
Seat 5: KeLevro0 ($12.26 in chips) 
Seat 6: chiyuki ($50.22 in chips) 
Seat 7: Grishukps ($12.50 in chips) 
Seat 8: Femali54 ($26.24 in chips) 
Seat 9: Saruotiss ($65.67 in chips) 
Lasutchik: posts small blind $0.10
Perstenev: posts big blind $0.25
*** HOLE CARDS ***
Dealt to chiyuki [2d 4h]
Kozyavkin: folds 
KeLevro0: folds 
chiyuki: folds 
Grishukps: folds 
Femali54: folds 
Saruotiss: folds 
jacquelinewu: raises $0.50 to $0.75
Lasutchik: folds 
Perstenev: folds 
Uncalled bet ($0.50) returned to jacquelinewu
jacquelinewu collected $0.60 from pot
jacquelinewu: doesn't show hand 
*** SUMMARY ***
Total pot $0.60 | Rake $0 
Seat 1: jacquelinewu (button) collected ($0.60)
Seat 2: Lasutchik (small blind) folded before Flop
Seat 3: Perstenev (big blind) folded before Flop
Seat 4: Kozyavkin folded before Flop (didn't bet)
Seat 5: KeLevro0 folded before Flop (didn't bet)
Seat 6: chiyuki folded before Flop (didn't bet)
Seat 7: Grishukps folded before Flop (didn't bet)
Seat 8: Femali54 folded before Flop (didn't bet)
Seat 9: Saruotiss folded before Flop (didn't bet)



PokerStars Zoom Hand #84300755183:  Hold'em No Limit ($0.10/$0.25) - 2012/08/05 15:49:01 JST [2012/08/05 2:49:01 ET]
Table 'Whirlpool' 9-max Seat #1 is the button
Seat 1: opie62 ($24.05 in chips) 
Seat 2: INSP!RON ($39.94 in chips) 
Seat 3: Afcawins25 ($22.03 in chips) 
Seat 4: chiyuki ($50.22 in chips) 
Seat 5: snejokCoxx ($10.75 in chips) 
Seat 6: xxx Spb xxx ($26.55 in chips) 
Seat 7: panaam ($30.32 in chips) 
Seat 8: hldtom ($27.54 in chips) 
Seat 9: masterkoolb ($13.50 in chips) 
INSP!RON: posts small blind $0.10
Afcawins25: posts big blind $0.25
*** HOLE CARDS ***
Dealt to chiyuki [9c Ac]
chiyuki: folds 
snejokCoxx: folds 
xxx Spb xxx: folds 
panaam: raises $0.25 to $0.50
hldtom: folds 
masterkoolb: folds 
opie62: folds 
INSP!RON: folds 
Afcawins25: calls $0.25
*** FLOP *** [4s Kd 9d]
Afcawins25: checks 
panaam: checks 
*** TURN *** [4s Kd 9d] [7d]
Afcawins25: bets $1.25
panaam: calls $1.25
*** RIVER *** [4s Kd 9d 7d] [5c]
Afcawins25: bets $3.25
panaam: raises $25.32 to $28.57 and is all-in
Afcawins25: folds 
Uncalled bet ($25.32) returned to panaam
panaam collected $9.65 from pot
panaam: doesn't show hand 
*** SUMMARY ***
Total pot $10.10 | Rake $0.45 
Board [4s Kd 9d 7d 5c]
Seat 1: opie62 (button) folded before Flop (didn't bet)
Seat 2: INSP!RON (small blind) folded before Flop
Seat 3: Afcawins25 (big blind) folded on the River
Seat 4: chiyuki folded before Flop (didn't bet)
Seat 5: snejokCoxx folded before Flop (didn't bet)
Seat 6: xxx Spb xxx folded before Flop (didn't bet)
Seat 7: panaam collected ($9.65)
Seat 8: hldtom folded before Flop (didn't bet)
Seat 9: masterkoolb folded before Flop (didn't bet)



PokerStars Zoom Hand #84300761443:  Hold'em No Limit ($0.10/$0.25) - 2012/08/05 15:49:25 JST [2012/08/05 2:49:25 ET]
Table 'Whirlpool' 9-max Seat #1 is the button
Seat 1: phate-1up ($63.05 in chips) 
Seat 2: Kozyavkin ($21.24 in chips) 
Seat 3: chiyuki ($50.22 in chips) 
Seat 4: Grishukps ($12.50 in chips) 
Seat 5: KrystalAA ($26.69 in chips) 
Seat 6: Silveystryk ($21.82 in chips) 
Seat 7: snejokCoxx ($12.35 in chips) 
Seat 8: seula i ($26.66 in chips) 
Seat 9: GovGus ($34.55 in chips) 
Kozyavkin: posts small blind $0.10
chiyuki: posts big blind $0.25
*** HOLE CARDS ***
Dealt to chiyuki [4d 8s]
Grishukps: folds 
KrystalAA: folds 
Silveystryk: folds 
snejokCoxx: folds 
seula i: folds 
GovGus: folds 
phate-1up: folds 
Kozyavkin: raises $0.50 to $0.75
chiyuki: folds 
Uncalled bet ($0.50) returned to Kozyavkin
Kozyavkin collected $0.50 from pot
Kozyavkin: doesn't show hand 
*** SUMMARY ***
Total pot $0.50 | Rake $0 
Seat 1: phate-1up (button) folded before Flop (didn't bet)
Seat 2: Kozyavkin (small blind) collected ($0.50)
Seat 3: chiyuki (big blind) folded before Flop
Seat 4: Grishukps folded before Flop (didn't bet)
Seat 5: KrystalAA folded before Flop (didn't bet)
Seat 6: Silveystryk folded before Flop (didn't bet)
Seat 7: snejokCoxx folded before Flop (didn't bet)
Seat 8: seula i folded before Flop (didn't bet)
Seat 9: GovGus folded before Flop (didn't bet)



PokerStars Zoom Hand #84300760121:  Hold'em No Limit ($0.10/$0.25) - 2012/08/05 15:49:20 JST [2012/08/05 2:49:20 ET]
Table 'Whirlpool' 9-max Seat #1 is the button
Seat 1: slapshot2011 ($24.96 in chips) 
Seat 2: leo2095 ($28.62 in chips) 
Seat 3: HighDuka ($31.75 in chips) 
Seat 4: Silveystryk ($21.82 in chips) 
Seat 5: chiyuki ($50.22 in chips) 
Seat 6: kesstukas25 ($12.90 in chips) 
Seat 7: Komissar82 ($18.80 in chips) 
Seat 8: GSDP ($21.44 in chips) 
Seat 9: Grishukps ($12.50 in chips) 
leo2095: posts small blind $0.10
HighDuka: posts big blind $0.25
*** HOLE CARDS ***
Dealt to chiyuki [3c 3h]
Silveystryk: folds 
chiyuki: folds 
kesstukas25: folds 
Komissar82: calls $0.25
GSDP: folds 
Grishukps: folds 
slapshot2011: folds 
leo2095: folds 
HighDuka: checks 
*** FLOP *** [Th Kh 2d]
HighDuka: bets $0.25
Komissar82: calls $0.25
*** TURN *** [Th Kh 2d] [7d]
HighDuka: bets $0.50
Komissar82: raises $0.50 to $1
HighDuka: calls $0.50
*** RIVER *** [Th Kh 2d 7d] [Qd]
HighDuka: checks 
Komissar82: checks 
*** SHOW DOWN ***
HighDuka: shows [Kd Jh] (a pair of Kings)
Komissar82: mucks hand 
HighDuka collected $2.96 from pot
*** SUMMARY ***
Total pot $3.10 | Rake $0.14 
Board [Th Kh 2d 7d Qd]
Seat 1: slapshot2011 (button) folded before Flop (didn't bet)
Seat 2: leo2095 (small blind) folded before Flop
Seat 3: HighDuka (big blind) showed [Kd Jh] and won ($2.96) with a pair of Kings
Seat 4: Silveystryk folded before Flop (didn't bet)
Seat 5: chiyuki folded before Flop (didn't bet)
Seat 6: kesstukas25 folded before Flop (didn't bet)
Seat 7: Komissar82 mucked [4h Qh]
Seat 8: GSDP folded before Flop (didn't bet)
Seat 9: Grishukps folded before Flop (didn't bet)



PokerStars Zoom Hand #84300766381:  Hold'em No Limit ($0.10/$0.25) - 2012/08/05 15:49:44 JST [2012/08/05 2:49:44 ET]
Table 'Whirlpool' 9-max Seat #1 is the button
Seat 1: Alvinpe85 ($57.57 in chips) 
Seat 2: Afcawins25 ($17.03 in chips) 
Seat 3: drunk_bender ($13.21 in chips) 
Seat 4: Perstenev ($23.76 in chips) 
Seat 5: KeLevro0 ($13.95 in chips) 
Seat 6: phate-1up ($53.12 in chips) 
Seat 7: jacquelinewu ($26.03 in chips) 
Seat 8: INSP!RON ($39.79 in chips) 
Seat 9: chiyuki ($49.97 in chips) 
Afcawins25: posts small blind $0.10
drunk_bender: posts big blind $0.25
*** HOLE CARDS ***
Dealt to chiyuki [As 5h]
Perstenev: folds 
KeLevro0: folds 
phate-1up: folds 
jacquelinewu: folds 
INSP!RON: folds 
chiyuki: raises $0.50 to $0.75
Alvinpe85: folds 
Afcawins25: calls $0.65
drunk_bender: folds 
*** FLOP *** [2s 5c Jd]
Afcawins25: checks 
chiyuki: bets $1
Afcawins25: folds 
Uncalled bet ($1) returned to chiyuki
chiyuki collected $1.67 from pot
chiyuki: doesn't show hand 
*** SUMMARY ***
Total pot $1.75 | Rake $0.08 
Board [2s 5c Jd]
Seat 1: Alvinpe85 (button) folded before Flop (didn't bet)
Seat 2: Afcawins25 (small blind) folded on the Flop
Seat 3: drunk_bender (big blind) folded before Flop
Seat 4: Perstenev folded before Flop (didn't bet)
Seat 5: KeLevro0 folded before Flop (didn't bet)
Seat 6: phate-1up folded before Flop (didn't bet)
Seat 7: jacquelinewu folded before Flop (didn't bet)
Seat 8: INSP!RON folded before Flop (didn't bet)
Seat 9: chiyuki collected ($1.67)



PokerStars Zoom Hand #84300771508:  Hold'em No Limit ($0.10/$0.25) - 2012/08/05 15:50:05 JST [2012/08/05 2:50:05 ET]
Table 'Whirlpool' 9-max Seat #1 is the button
Seat 1: Grishukps ($12.50 in chips) 
Seat 2: chiyuki ($50.89 in chips) 
Seat 3: NENE54 ($14.60 in chips) 
Seat 4: pandaaaaaa ($15.65 in chips) 
Seat 5: WARIBANA7777 ($16.82 in chips) 
Seat 6: rey2040 ($19.65 in chips) 
Seat 7: luyifei ($8.60 in chips) 
Seat 8: Dan Royal ($25.12 in chips) 
Seat 9: Serge Claws ($28.33 in chips) 
chiyuki: posts small blind $0.10
NENE54: posts big blind $0.25
*** HOLE CARDS ***
Dealt to chiyuki [Ks 4d]
pandaaaaaa: folds 
WARIBANA7777: folds 
rey2040: folds 
luyifei: folds 
Dan Royal: raises $0.50 to $0.75
Serge Claws: folds 
Grishukps: folds 
chiyuki: folds 
NENE54: folds 
Uncalled bet ($0.50) returned to Dan Royal
Dan Royal collected $0.60 from pot
Dan Royal: doesn't show hand 
*** SUMMARY ***
Total pot $0.60 | Rake $0 
Seat 1: Grishukps (button) folded before Flop (didn't bet)
Seat 2: chiyuki (small blind) folded before Flop
Seat 3: NENE54 (big blind) folded before Flop
Seat 4: pandaaaaaa folded before Flop (didn't bet)
Seat 5: WARIBANA7777 folded before Flop (didn't bet)
Seat 6: rey2040 folded before Flop (didn't bet)
Seat 7: luyifei folded before Flop (didn't bet)
Seat 8: Dan Royal collected ($0.60)
Seat 9: Serge Claws folded before Flop (didn't bet)



PokerStars Zoom Hand #84300775640:  Hold'em No Limit ($0.10/$0.25) - 2012/08/05 15:50:21 JST [2012/08/05 2:50:21 ET]
Table 'Whirlpool' 9-max Seat #1 is the button
Seat 1: nice.franki ($11.35 in chips) 
Seat 2: River_GmbH ($15.87 in chips) 
Seat 3: KeLevro0 ($11.83 in chips) 
Seat 4: kwkim73 ($32.27 in chips) 
Seat 5: chiyuki ($50.79 in chips) 
Seat 6: God)Squall ($27.72 in chips) 
Seat 7: ChrisCDee ($40.23 in chips) 
Seat 8: leo2095 ($26.77 in chips) 
Seat 9: Nerkit ($11.92 in chips) 
River_GmbH: posts small blind $0.10
KeLevro0: posts big blind $0.25
*** HOLE CARDS ***
Dealt to chiyuki [6s 2h]
kwkim73: folds 
chiyuki: folds 
God)Squall: folds 
ChrisCDee: raises $0.50 to $0.75
leo2095: folds 
Nerkit: folds 
nice.franki: folds 
River_GmbH: folds 
KeLevro0: folds 
Uncalled bet ($0.50) returned to ChrisCDee
ChrisCDee collected $0.60 from pot
ChrisCDee: doesn't show hand 
*** SUMMARY ***
Total pot $0.60 | Rake $0 
Seat 1: nice.franki (button) folded before Flop (didn't bet)
Seat 2: River_GmbH (small blind) folded before Flop
Seat 3: KeLevro0 (big blind) folded before Flop
Seat 4: kwkim73 folded before Flop (didn't bet)
Seat 5: chiyuki folded before Flop (didn't bet)
Seat 6: God)Squall folded before Flop (didn't bet)
Seat 7: ChrisCDee collected ($0.60)
Seat 8: leo2095 folded before Flop (didn't bet)
Seat 9: Nerkit folded before Flop (didn't bet)



PokerStars Zoom Hand #84300777486:  Hold'em No Limit ($0.10/$0.25) - 2012/08/05 15:50:28 JST [2012/08/05 2:50:28 ET]
Table 'Whirlpool' 9-max Seat #1 is the button
Seat 1: chiyuki ($50.79 in chips) 
Seat 2: munky3 ($25.10 in chips) 
Seat 3: Rici47 ($35.13 in chips) 
Seat 4: xxx Spb xxx ($27.79 in chips) 
Seat 5: 1Karina1 ($25.10 in chips) 
Seat 6: JhonnyP1979 ($13.72 in chips) 
Seat 7: seula i ($49.71 in chips) 
Seat 8: nastya040 ($20.49 in chips) 
Seat 9: kwkim73 ($25 in chips) 
munky3: posts small blind $0.10
Rici47: posts big blind $0.25
*** HOLE CARDS ***
Dealt to chiyuki [9h 4s]
xxx Spb xxx: raises $0.50 to $0.75
1Karina1: folds 
JhonnyP1979: calls $0.75
seula i: folds 
nastya040: folds 
kwkim73: folds 
chiyuki: folds 
munky3: folds 
Rici47: folds 
*** FLOP *** [6d 6h 3d]
xxx Spb xxx: bets $1
JhonnyP1979: raises $2.82 to $3.82
xxx Spb xxx: folds 
Uncalled bet ($2.82) returned to JhonnyP1979
JhonnyP1979 collected $3.68 from pot
JhonnyP1979: doesn't show hand 
*** SUMMARY ***
Total pot $3.85 | Rake $0.17 
Board [6d 6h 3d]
Seat 1: chiyuki (button) folded before Flop (didn't bet)
Seat 2: munky3 (small blind) folded before Flop
Seat 3: Rici47 (big blind) folded before Flop
Seat 4: xxx Spb xxx folded on the Flop
Seat 5: 1Karina1 folded before Flop (didn't bet)
Seat 6: JhonnyP1979 collected ($3.68)
Seat 7: seula i folded before Flop (didn't bet)
Seat 8: nastya040 folded before Flop (didn't bet)
Seat 9: kwkim73 folded before Flop (didn't bet)



PokerStars Zoom Hand #84300779798:  Hold'em No Limit ($0.10/$0.25) - 2012/08/05 15:50:37 JST [2012/08/05 2:50:37 ET]
Table 'Whirlpool' 9-max Seat #1 is the button
Seat 1: vpetrovi ($12.75 in chips) 
Seat 2: ShockLaMuc ($24.25 in chips) 
Seat 3: chiyuki ($50.79 in chips) 
Seat 4: KrystalAA ($26.44 in chips) 
Seat 5: 4plankton ($21.73 in chips) 
Seat 6: aivvo ($7.10 in chips) 
Seat 7: seula i ($26.91 in chips) 
Seat 8: TorTrade ($26.14 in chips) 
Seat 9: snejokCoxx ($12 in chips) 
ShockLaMuc: posts small blind $0.10
chiyuki: posts big blind $0.25
*** HOLE CARDS ***
Dealt to chiyuki [4c Ks]
KrystalAA: folds 
4plankton: folds 
aivvo: folds 
seula i: folds 
TorTrade: folds 
snejokCoxx: folds 
vpetrovi: folds 
ShockLaMuc: folds 
Uncalled bet ($0.15) returned to chiyuki
chiyuki collected $0.20 from pot
chiyuki: doesn't show hand 
*** SUMMARY ***
Total pot $0.20 | Rake $0 
Seat 1: vpetrovi (button) folded before Flop (didn't bet)
Seat 2: ShockLaMuc (small blind) folded before Flop
Seat 3: chiyuki (big blind) collected ($0.20)
Seat 4: KrystalAA folded before Flop (didn't bet)
Seat 5: 4plankton folded before Flop (didn't bet)
Seat 6: aivvo folded before Flop (didn't bet)
Seat 7: seula i folded before Flop (didn't bet)
Seat 8: TorTrade folded before Flop (didn't bet)
Seat 9: snejokCoxx folded before Flop (didn't bet)



PokerStars Zoom Hand #84300778542:  Hold'em No Limit ($0.10/$0.25) - 2012/08/05 15:50:32 JST [2012/08/05 2:50:32 ET]
Table 'Whirlpool' 9-max Seat #1 is the button
Seat 1: hldtom ($12.50 in chips) 
Seat 2: 4plankton ($21.83 in chips) 
Seat 3: INSP!RON ($41.34 in chips) 
Seat 4: phate-1up ($43.98 in chips) 
Seat 5: fwnaf ($21.31 in chips) 
Seat 6: Perstenev ($11.93 in chips) 
Seat 7: chiyuki ($50.79 in chips) 
Seat 8: 1Karina1 ($35.97 in chips) 
Seat 9: aivvo ($7.10 in chips) 
4plankton: posts small blind $0.10
INSP!RON: posts big blind $0.25
*** HOLE CARDS ***
Dealt to chiyuki [As 6h]
phate-1up: folds 
fwnaf: folds 
Perstenev: folds 
chiyuki: folds 
1Karina1: folds 
aivvo: folds 
hldtom: raises $0.50 to $0.75
4plankton: folds 
INSP!RON: folds 
Uncalled bet ($0.50) returned to hldtom
hldtom collected $0.60 from pot
hldtom: doesn't show hand 
*** SUMMARY ***
Total pot $0.60 | Rake $0 
Seat 1: hldtom (button) collected ($0.60)
Seat 2: 4plankton (small blind) folded before Flop
Seat 3: INSP!RON (big blind) folded before Flop
Seat 4: phate-1up folded before Flop (didn't bet)
Seat 5: fwnaf folded before Flop (didn't bet)
Seat 6: Perstenev folded before Flop (didn't bet)
Seat 7: chiyuki folded before Flop (didn't bet)
Seat 8: 1Karina1 folded before Flop (didn't bet)
Seat 9: aivvo folded before Flop (didn't bet)



PokerStars Zoom Hand #84300786220:  Hold'em No Limit ($0.10/$0.25) - 2012/08/05 15:51:02 JST [2012/08/05 2:51:02 ET]
Table 'Whirlpool' 9-max Seat #1 is the button
Seat 1: MurMurRu ($25 in chips) 
Seat 2: JhonnyP1979 ($15.65 in chips) 
Seat 3: Limoilou ($30.82 in chips) 
Seat 4: kesstukas25 ($18.08 in chips) 
Seat 5: jvds114 ($37.75 in chips) 
Seat 6: KrystalAA ($26.74 in chips) 
Seat 7: fil740 ($6.57 in chips) 
Seat 8: Rilko1975 ($25.25 in chips) 
Seat 9: chiyuki ($50.89 in chips) 
JhonnyP1979: posts small blind $0.10
Limoilou: posts big blind $0.25
*** HOLE CARDS ***
Dealt to chiyuki [9d 2c]
kesstukas25: folds 
jvds114: folds 
KrystalAA: folds 
fil740: raises $0.50 to $0.75
Rilko1975: folds 
chiyuki: folds 
MurMurRu: folds 
JhonnyP1979: folds 
Limoilou: folds 
Uncalled bet ($0.50) returned to fil740
fil740 collected $0.60 from pot
fil740: doesn't show hand 
*** SUMMARY ***
Total pot $0.60 | Rake $0 
Seat 1: MurMurRu (button) folded before Flop (didn't bet)
Seat 2: JhonnyP1979 (small blind) folded before Flop
Seat 3: Limoilou (big blind) folded before Flop
Seat 4: kesstukas25 folded before Flop (didn't bet)
Seat 5: jvds114 folded before Flop (didn't bet)
Seat 6: KrystalAA folded before Flop (didn't bet)
Seat 7: fil740 collected ($0.60)
Seat 8: Rilko1975 folded before Flop (didn't bet)
Seat 9: chiyuki folded before Flop (didn't bet)



PokerStars Zoom Hand #84300773868:  Hold'em No Limit ($0.10/$0.25) - 2012/08/05 15:50:14 JST [2012/08/05 2:50:14 ET]
Table 'Whirlpool' 9-max Seat #1 is the button
Seat 1: Rilko1975 ($24.90 in chips) 
Seat 2: Spheroff ($13.02 in chips) 
Seat 3: phate-1up ($53.02 in chips) 
Seat 4: wildy29 ($45.67 in chips) 
Seat 5: TorTrade ($26.39 in chips) 
Seat 6: nice.franki ($6.55 in chips) 
Seat 7: slapshot2011 ($24.21 in chips) 
Seat 8: chiyuki ($50.79 in chips) 
Seat 9: kwkim73 ($32.27 in chips) 
Spheroff: posts small blind $0.10
phate-1up: posts big blind $0.25
*** HOLE CARDS ***
Dealt to chiyuki [Kd 3c]
wildy29: raises $0.25 to $0.50
TorTrade: folds 
nice.franki: folds 
slapshot2011: folds 
chiyuki: folds 
kwkim73: folds 
Rilko1975: folds 
Spheroff: raises $1.25 to $1.75
phate-1up: folds 
wildy29: calls $1.25
*** FLOP *** [4d Ad Js]
Spheroff: bets $1.75
wildy29: calls $1.75
*** TURN *** [4d Ad Js] [Jc]
Spheroff: bets $2.25
wildy29: raises $39.92 to $42.17 and is all-in
Spheroff: folds 
Uncalled bet ($39.92) returned to wildy29
wildy29 collected $11.22 from pot
wildy29: doesn't show hand 
*** SUMMARY ***
Total pot $11.75 | Rake $0.53 
Board [4d Ad Js Jc]
Seat 1: Rilko1975 (button) folded before Flop (didn't bet)
Seat 2: Spheroff (small blind) folded on the Turn
Seat 3: phate-1up (big blind) folded before Flop
Seat 4: wildy29 collected ($11.22)
Seat 5: TorTrade folded before Flop (didn't bet)
Seat 6: nice.franki folded before Flop (didn't bet)
Seat 7: slapshot2011 folded before Flop (didn't bet)
Seat 8: chiyuki folded before Flop (didn't bet)
Seat 9: kwkim73 folded before Flop (didn't bet)



PokerStars Zoom Hand #84300787252:  Hold'em No Limit ($0.10/$0.25) - 2012/08/05 15:51:07 JST [2012/08/05 2:51:07 ET]
Table 'Whirlpool' 9-max Seat #1 is the button
Seat 1: GSDP ($48.85 in chips) 
Seat 2: jvds114 ($37.75 in chips) 
Seat 3: phate-1up ($42.58 in chips) 
Seat 4: seula i ($26.91 in chips) 
Seat 5: mjmichi ($38.51 in chips) 
Seat 6: 1Karina1 ($43.89 in chips) 
Seat 7: Rilko1975 ($25.25 in chips) 
Seat 8: chiyuki ($50.89 in chips) 
Seat 9: hldtom ($12.85 in chips) 
jvds114: posts small blind $0.10
phate-1up: posts big blind $0.25
*** HOLE CARDS ***
Dealt to chiyuki [2s Qh]
seula i: folds 
mjmichi: raises $0.50 to $0.75
1Karina1: folds 
Rilko1975: folds 
chiyuki: folds 
hldtom: raises $1.85 to $2.60
GSDP: folds 
jvds114: folds 
phate-1up: folds 
mjmichi: folds 
Uncalled bet ($1.85) returned to hldtom
hldtom collected $1.85 from pot
hldtom: doesn't show hand 
*** SUMMARY ***
Total pot $1.85 | Rake $0 
Seat 1: GSDP (button) folded before Flop (didn't bet)
Seat 2: jvds114 (small blind) folded before Flop
Seat 3: phate-1up (big blind) folded before Flop
Seat 4: seula i folded before Flop (didn't bet)
Seat 5: mjmichi folded before Flop
Seat 6: 1Karina1 folded before Flop (didn't bet)
Seat 7: Rilko1975 folded before Flop (didn't bet)
Seat 8: chiyuki folded before Flop (didn't bet)
Seat 9: hldtom collected ($1.85)



PokerStars Zoom Hand #84300792425:  Hold'em No Limit ($0.10/$0.25) - 2012/08/05 15:51:27 JST [2012/08/05 2:51:27 ET]
Table 'Whirlpool' 9-max Seat #1 is the button
Seat 1: masterkoolb ($12.50 in chips) 
Seat 2: misskitty354 ($10.43 in chips) 
Seat 3: JhonnyP1979 ($15.55 in chips) 
Seat 4: Ellen1947 ($29.90 in chips) 
Seat 5: chiyuki ($50.89 in chips) 
Seat 6: Nerkit ($11.71 in chips) 
Seat 7: laurentzu84 ($54.99 in chips) 
Seat 8: INSP!RON ($35.51 in chips) 
Seat 9: KrystalAA ($26.34 in chips) 
misskitty354: posts small blind $0.10
JhonnyP1979: posts big blind $0.25
*** HOLE CARDS ***
Dealt to chiyuki [Js Qd]
Ellen1947: folds 
chiyuki: folds 
Nerkit: folds 
laurentzu84: folds 
INSP!RON: folds 
KrystalAA: folds 
masterkoolb: folds 
misskitty354: folds 
Uncalled bet ($0.15) returned to JhonnyP1979
JhonnyP1979 collected $0.20 from pot
JhonnyP1979: doesn't show hand 
*** SUMMARY ***
Total pot $0.20 | Rake $0 
Seat 1: masterkoolb (button) folded before Flop (didn't bet)
Seat 2: misskitty354 (small blind) folded before Flop
Seat 3: JhonnyP1979 (big blind) collected ($0.20)
Seat 4: Ellen1947 folded before Flop (didn't bet)
Seat 5: chiyuki folded before Flop (didn't bet)
Seat 6: Nerkit folded before Flop (didn't bet)
Seat 7: laurentzu84 folded before Flop (didn't bet)
Seat 8: INSP!RON folded before Flop (didn't bet)
Seat 9: KrystalAA folded before Flop (didn't bet)



PokerStars Zoom Hand #84300793501:  Hold'em No Limit ($0.10/$0.25) - 2012/08/05 15:51:31 JST [2012/08/05 2:51:31 ET]
Table 'Whirlpool' 9-max Seat #1 is the button
Seat 1: Faantomace ($33.70 in chips) 
Seat 2: chiyuki ($50.89 in chips) 
Seat 3: GovGus ($42.76 in chips) 
Seat 4: River_GmbH ($16.12 in chips) 
Seat 5: kamikkaze ($19.50 in chips) 
Seat 6: Serge Claws ($39.13 in chips) 
Seat 7: KeLevro0 ($12.15 in chips) 
Seat 8: Kasperlmusik ($25.53 in chips) 
Seat 9: Perstenev ($12.55 in chips) 
chiyuki: posts small blind $0.10
GovGus: posts big blind $0.25
*** HOLE CARDS ***
Dealt to chiyuki [Tc As]
River_GmbH: folds 
kamikkaze: folds 
Serge Claws: folds 
KeLevro0: folds 
Kasperlmusik: folds 
Perstenev: folds 
Faantomace: folds 
chiyuki: raises $0.50 to $0.75
GovGus: folds 
Uncalled bet ($0.50) returned to chiyuki
chiyuki collected $0.50 from pot
chiyuki: doesn't show hand 
*** SUMMARY ***
Total pot $0.50 | Rake $0 
Seat 1: Faantomace (button) folded before Flop (didn't bet)
Seat 2: chiyuki (small blind) collected ($0.50)
Seat 3: GovGus (big blind) folded before Flop
Seat 4: River_GmbH folded before Flop (didn't bet)
Seat 5: kamikkaze folded before Flop (didn't bet)
Seat 6: Serge Claws folded before Flop (didn't bet)
Seat 7: KeLevro0 folded before Flop (didn't bet)
Seat 8: Kasperlmusik folded before Flop (didn't bet)
Seat 9: Perstenev folded before Flop (didn't bet)



PokerStars Zoom Hand #84300791369:  Hold'em No Limit ($0.10/$0.25) - 2012/08/05 15:51:23 JST [2012/08/05 2:51:23 ET]
Table 'Whirlpool' 9-max Seat #1 is the button
Seat 1: jacquelinewu ($26.36 in chips) 
Seat 2: Dejacob ($25.10 in chips) 
Seat 3: ShockLaMuc ($25.13 in chips) 
Seat 4: chiyuki ($50.89 in chips) 
Seat 5: kwkim73 ($27.98 in chips) 
Seat 6: nice.franki ($6.20 in chips) 
Seat 7: xxx Spb xxx ($29.11 in chips) 
Seat 8: kamikkaze ($19.50 in chips) 
Seat 9: GSDP ($48.85 in chips) 
Dejacob: posts small blind $0.10
ShockLaMuc: posts big blind $0.25
*** HOLE CARDS ***
Dealt to chiyuki [7d 3d]
chiyuki: folds 
kwkim73: folds 
nice.franki: folds 
xxx Spb xxx: folds 
kamikkaze: folds 
GSDP: raises $0.50 to $0.75
jacquelinewu: folds 
Dejacob: calls $0.65
ShockLaMuc: folds 
*** FLOP *** [9h Ac Ah]
Dejacob: checks 
GSDP: bets $1
Dejacob: raises $2 to $3
GSDP: folds 
Uncalled bet ($2) returned to Dejacob
Dejacob collected $3.58 from pot
Dejacob: doesn't show hand 
*** SUMMARY ***
Total pot $3.75 | Rake $0.17 
Board [9h Ac Ah]
Seat 1: jacquelinewu (button) folded before Flop (didn't bet)
Seat 2: Dejacob (small blind) collected ($3.58)
Seat 3: ShockLaMuc (big blind) folded before Flop
Seat 4: chiyuki folded before Flop (didn't bet)
Seat 5: kwkim73 folded before Flop (didn't bet)
Seat 6: nice.franki folded before Flop (didn't bet)
Seat 7: xxx Spb xxx folded before Flop (didn't bet)
Seat 8: kamikkaze folded before Flop (didn't bet)
Seat 9: GSDP folded on the Flop



PokerStars Zoom Hand #84300801985:  Hold'em No Limit ($0.10/$0.25) - 2012/08/05 15:52:04 JST [2012/08/05 2:52:04 ET]
Table 'Whirlpool' 9-max Seat #1 is the button
Seat 1: chiyuki ($51.14 in chips) 
Seat 2: Kasperlmusik ($25.28 in chips) 
Seat 3: hldtom ($13.75 in chips) 
Seat 4: ViTiV2010 ($10.04 in chips) 
Seat 5: Alvinpe85 ($44.90 in chips) 
Seat 6: Fructionar ($37.07 in chips) 
Seat 7: Rici47 ($34.43 in chips) 
Seat 8: DrunkTyphoon ($30.13 in chips) 
Seat 9: jvds114 ($36.90 in chips) 
Kasperlmusik: posts small blind $0.10
hldtom: posts big blind $0.25
*** HOLE CARDS ***
Dealt to chiyuki [7c Qh]
ViTiV2010: folds 
Alvinpe85: folds 
Fructionar: folds 
Rici47: folds 
DrunkTyphoon: folds 
jvds114: folds 
chiyuki: folds 
Kasperlmusik: folds 
Uncalled bet ($0.15) returned to hldtom
hldtom collected $0.20 from pot
hldtom: doesn't show hand 
*** SUMMARY ***
Total pot $0.20 | Rake $0 
Seat 1: chiyuki (button) folded before Flop (didn't bet)
Seat 2: Kasperlmusik (small blind) folded before Flop
Seat 3: hldtom (big blind) collected ($0.20)
Seat 4: ViTiV2010 folded before Flop (didn't bet)
Seat 5: Alvinpe85 folded before Flop (didn't bet)
Seat 6: Fructionar folded before Flop (didn't bet)
Seat 7: Rici47 folded before Flop (didn't bet)
Seat 8: DrunkTyphoon folded before Flop (didn't bet)
Seat 9: jvds114 folded before Flop (didn't bet)



PokerStars Zoom Hand #84300803014:  Hold'em No Limit ($0.10/$0.25) - 2012/08/05 15:52:08 JST [2012/08/05 2:52:08 ET]
Table 'Whirlpool' 9-max Seat #1 is the button
Seat 1: Fructionar ($37.07 in chips) 
Seat 2: kwkim73 ($32.27 in chips) 
Seat 3: snejokCoxx ($11.54 in chips) 
Seat 4: chiyuki ($51.14 in chips) 
Seat 5: MurMurRu ($25 in chips) 
Seat 6: Kasperlmusik ($25.18 in chips) 
Seat 7: seula i ($26.56 in chips) 
Seat 8: Dejacob ($25 in chips) 
Seat 9: xxx Spb xxx ($25.69 in chips) 
kwkim73: posts small blind $0.10
snejokCoxx: posts big blind $0.25
*** HOLE CARDS ***
Dealt to chiyuki [5s 4h]
chiyuki: folds 
MurMurRu: folds 
Kasperlmusik: folds 
seula i: folds 
Dejacob: folds 
xxx Spb xxx: raises $0.37 to $0.62
Fructionar: folds 
kwkim73: folds 
snejokCoxx: folds 
Uncalled bet ($0.37) returned to xxx Spb xxx
xxx Spb xxx collected $0.60 from pot
xxx Spb xxx: doesn't show hand 
*** SUMMARY ***
Total pot $0.60 | Rake $0 
Seat 1: Fructionar (button) folded before Flop (didn't bet)
Seat 2: kwkim73 (small blind) folded before Flop
Seat 3: snejokCoxx (big blind) folded before Flop
Seat 4: chiyuki folded before Flop (didn't bet)
Seat 5: MurMurRu folded before Flop (didn't bet)
Seat 6: Kasperlmusik folded before Flop (didn't bet)
Seat 7: seula i folded before Flop (didn't bet)
Seat 8: Dejacob folded before Flop (didn't bet)
Seat 9: xxx Spb xxx collected ($0.60)



PokerStars Zoom Hand #84300804290:  Hold'em No Limit ($0.10/$0.25) - 2012/08/05 15:52:13 JST [2012/08/05 2:52:13 ET]
Table 'Whirlpool' 9-max Seat #1 is the button
Seat 1: aivvo ($6.50 in chips) 
Seat 2: Silveystryk ($21.79 in chips) 
Seat 3: ShockLaMuc ($23.40 in chips) 
Seat 4: Serge Claws ($25 in chips) 
Seat 5: nice.franki ($11 in chips) 
Seat 6: MurMurRu ($25 in chips) 
Seat 7: kwkim73 ($32.17 in chips) 
Seat 8: chiyuki ($51.14 in chips) 
Seat 9: Perstenev ($10.83 in chips) 
Silveystryk: posts small blind $0.10
ShockLaMuc: posts big blind $0.25
*** HOLE CARDS ***
Dealt to chiyuki [3s Td]
Serge Claws: folds 
nice.franki: folds 
MurMurRu: folds 
kwkim73: folds 
chiyuki: folds 
Perstenev: folds 
aivvo: folds 
Silveystryk: folds 
Uncalled bet ($0.15) returned to ShockLaMuc
ShockLaMuc collected $0.20 from pot
ShockLaMuc: doesn't show hand 
*** SUMMARY ***
Total pot $0.20 | Rake $0 
Seat 1: aivvo (button) folded before Flop (didn't bet)
Seat 2: Silveystryk (small blind) folded before Flop
Seat 3: ShockLaMuc (big blind) collected ($0.20)
Seat 4: Serge Claws folded before Flop (didn't bet)
Seat 5: nice.franki folded before Flop (didn't bet)
Seat 6: MurMurRu folded before Flop (didn't bet)
Seat 7: kwkim73 folded before Flop (didn't bet)
Seat 8: chiyuki folded before Flop (didn't bet)
Seat 9: Perstenev folded before Flop (didn't bet)



PokerStars Zoom Hand #84300805829:  Hold'em No Limit ($0.10/$0.25) - 2012/08/05 15:52:20 JST [2012/08/05 2:52:20 ET]
Table 'Whirlpool' 9-max Seat #1 is the button
Seat 1: MurMurRu ($25 in chips) 
Seat 2: 1Karina1 ($25.10 in chips) 
Seat 3: chiyuki ($51.14 in chips) 
Seat 4: Kasperlmusik ($25.18 in chips) 
Seat 5: Dan Royal ($28.43 in chips) 
Seat 6: kesstukas25 ($15.07 in chips) 
Seat 7: nice.franki ($8.48 in chips) 
Seat 8: Alvinpe85 ($67.49 in chips) 
Seat 9: Dejacob ($25 in chips) 
1Karina1: posts small blind $0.10
chiyuki: posts big blind $0.25
*** HOLE CARDS ***
Dealt to chiyuki [Tc 6d]
Kasperlmusik: folds 
Dan Royal: folds 
kesstukas25: folds 
nice.franki: folds 
Alvinpe85: folds 
Dejacob: folds 
MurMurRu: folds 
1Karina1: folds 
Uncalled bet ($0.15) returned to chiyuki
chiyuki collected $0.20 from pot
chiyuki: doesn't show hand 
*** SUMMARY ***
Total pot $0.20 | Rake $0 
Seat 1: MurMurRu (button) folded before Flop (didn't bet)
Seat 2: 1Karina1 (small blind) folded before Flop
Seat 3: chiyuki (big blind) collected ($0.20)
Seat 4: Kasperlmusik folded before Flop (didn't bet)
Seat 5: Dan Royal folded before Flop (didn't bet)
Seat 6: kesstukas25 folded before Flop (didn't bet)
Seat 7: nice.franki folded before Flop (didn't bet)
Seat 8: Alvinpe85 folded before Flop (didn't bet)
Seat 9: Dejacob folded before Flop (didn't bet)



PokerStars Zoom Hand #84300799112:  Hold'em No Limit ($0.10/$0.25) - 2012/08/05 15:51:53 JST [2012/08/05 2:51:53 ET]
Table 'Whirlpool' 9-max Seat #1 is the button
Seat 1: misskitty354 ($10.68 in chips) 
Seat 2: INSP!RON ($41.44 in chips) 
Seat 3: ChrisCDee ($58.77 in chips) 
Seat 4: Silveystryk ($25.12 in chips) 
Seat 5: KeLevro0 ($11.41 in chips) 
Seat 6: chiyuki ($51.14 in chips) 
Seat 7: vpetrovi ($12.32 in chips) 
Seat 8: Perstenev ($12.08 in chips) 
Seat 9: Grishukps ($12.50 in chips) 
INSP!RON: posts small blind $0.10
ChrisCDee: posts big blind $0.25
*** HOLE CARDS ***
Dealt to chiyuki [6d 6h]
Silveystryk: raises $0.50 to $0.75
KeLevro0: folds 
chiyuki: folds 
vpetrovi: folds 
Perstenev: folds 
Grishukps: folds 
misskitty354: folds 
INSP!RON: calls $0.65
ChrisCDee: calls $0.50
*** FLOP *** [5s 3s 9d]
INSP!RON: checks 
ChrisCDee: checks 
Silveystryk: bets $1
INSP!RON: raises $2.20 to $3.20
ChrisCDee: folds 
Silveystryk: calls $2.20
*** TURN *** [5s 3s 9d] [4d]
INSP!RON: checks 
Silveystryk: bets $2.50
INSP!RON: calls $2.50
*** RIVER *** [5s 3s 9d 4d] [8d]
INSP!RON: checks 
Silveystryk: checks 
*** SHOW DOWN ***
INSP!RON: shows [Th Td] (a pair of Tens)
Silveystryk: shows [Js Jd] (a pair of Jacks)
Silveystryk collected $13.04 from pot
*** SUMMARY ***
Total pot $13.65 | Rake $0.61 
Board [5s 3s 9d 4d 8d]
Seat 1: misskitty354 (button) folded before Flop (didn't bet)
Seat 2: INSP!RON (small blind) showed [Th Td] and lost with a pair of Tens
Seat 3: ChrisCDee (big blind) folded on the Flop
Seat 4: Silveystryk showed [Js Jd] and won ($13.04) with a pair of Jacks
Seat 5: KeLevro0 folded before Flop (didn't bet)
Seat 6: chiyuki folded before Flop (didn't bet)
Seat 7: vpetrovi folded before Flop (didn't bet)
Seat 8: Perstenev folded before Flop (didn't bet)
Seat 9: Grishukps folded before Flop (didn't bet)



PokerStars Zoom Hand #84300801201:  Hold'em No Limit ($0.10/$0.25) - 2012/08/05 15:52:01 JST [2012/08/05 2:52:01 ET]
Table 'Whirlpool' 9-max Seat #1 is the button
Seat 1: Dejacob ($25 in chips) 
Seat 2: nice.franki ($8.58 in chips) 
Seat 3: Ozboy80 ($25.19 in chips) 
Seat 4: 1Karina1 ($35.97 in chips) 
Seat 5: Saruotiss ($64.92 in chips) 
Seat 6: KrystalAA ($13.57 in chips) 
Seat 7: chiyuki ($51.14 in chips) 
Seat 8: seula i ($26.56 in chips) 
Seat 9: INSP!RON ($35.16 in chips) 
nice.franki: posts small blind $0.10
Ozboy80: posts big blind $0.25
*** HOLE CARDS ***
Dealt to chiyuki [7d Jc]
1Karina1: folds 
Saruotiss: raises $0.25 to $0.50
KrystalAA: calls $0.50
chiyuki: folds 
seula i: folds 
INSP!RON: folds 
Dejacob: folds 
nice.franki: folds 
Ozboy80: folds 
*** FLOP *** [6h 6c Ah]
Saruotiss: checks 
KrystalAA: bets $0.99
Saruotiss: calls $0.99
*** TURN *** [6h 6c Ah] [8h]
Saruotiss: checks 
KrystalAA: bets $3.40
Saruotiss: folds 
Uncalled bet ($3.40) returned to KrystalAA
KrystalAA collected $3.18 from pot
KrystalAA: doesn't show hand 
*** SUMMARY ***
Total pot $3.33 | Rake $0.15 
Board [6h 6c Ah 8h]
Seat 1: Dejacob (button) folded before Flop (didn't bet)
Seat 2: nice.franki (small blind) folded before Flop
Seat 3: Ozboy80 (big blind) folded before Flop
Seat 4: 1Karina1 folded before Flop (didn't bet)
Seat 5: Saruotiss folded on the Turn
Seat 6: KrystalAA collected ($3.18)
Seat 7: chiyuki folded before Flop (didn't bet)
Seat 8: seula i folded before Flop (didn't bet)
Seat 9: INSP!RON folded before Flop (didn't bet)



PokerStars Zoom Hand #84300812887:  Hold'em No Limit ($0.10/$0.25) - 2012/08/05 15:52:47 JST [2012/08/05 2:52:47 ET]
Table 'Whirlpool' 9-max Seat #1 is the button
Seat 1: Silveystryk ($21.44 in chips) 
Seat 2: chiyuki ($51.24 in chips) 
Seat 3: 1Karina1 ($43.54 in chips) 
Seat 4: drunk_bender ($11.01 in chips) 
Seat 5: jacquelinewu ($34.59 in chips) 
Seat 6: INSP!RON ($34.99 in chips) 
Seat 7: masterkoolb ($13.90 in chips) 
Seat 8: Dejacob ($25 in chips) 
Seat 9: Serge Claws ($30.72 in chips) 
chiyuki: posts small blind $0.10
1Karina1: posts big blind $0.25
*** HOLE CARDS ***
Dealt to chiyuki [6c 3d]
drunk_bender: raises $0.50 to $0.75
jacquelinewu: folds 
INSP!RON: folds 
masterkoolb: folds 
Dejacob: folds 
Serge Claws: folds 
Silveystryk: folds 
chiyuki: folds 
1Karina1: folds 
Uncalled bet ($0.50) returned to drunk_bender
drunk_bender collected $0.60 from pot
drunk_bender: doesn't show hand 
*** SUMMARY ***
Total pot $0.60 | Rake $0 
Seat 1: Silveystryk (button) folded before Flop (didn't bet)
Seat 2: chiyuki (small blind) folded before Flop
Seat 3: 1Karina1 (big blind) folded before Flop
Seat 4: drunk_bender collected ($0.60)
Seat 5: jacquelinewu folded before Flop (didn't bet)
Seat 6: INSP!RON folded before Flop (didn't bet)
Seat 7: masterkoolb folded before Flop (didn't bet)
Seat 8: Dejacob folded before Flop (didn't bet)
Seat 9: Serge Claws folded before Flop (didn't bet)



PokerStars Zoom Hand #84300815185:  Hold'em No Limit ($0.10/$0.25) - 2012/08/05 15:52:56 JST [2012/08/05 2:52:56 ET]
Table 'Whirlpool' 9-max Seat #1 is the button
Seat 1: masterkoolb ($13.17 in chips) 
Seat 2: Nerkit ($12.37 in chips) 
Seat 3: Fructionar ($38.33 in chips) 
Seat 4: ShockLaMuc ($24.53 in chips) 
Seat 5: Grishukps ($12.50 in chips) 
Seat 6: kwkim73 ($25.35 in chips) 
Seat 7: chiyuki ($51.14 in chips) 
Seat 8: jacquelinewu ($34.59 in chips) 
Seat 9: Perstenev ($13.25 in chips) 
Nerkit: posts small blind $0.10
Fructionar: posts big blind $0.25
*** HOLE CARDS ***
Dealt to chiyuki [Td Kh]
ShockLaMuc: folds 
Grishukps: folds 
kwkim73: folds 
chiyuki: folds 
jacquelinewu: folds 
Perstenev: folds 
masterkoolb: folds 
Nerkit: raises $0.50 to $0.75
Fructionar: folds 
Uncalled bet ($0.50) returned to Nerkit
Nerkit collected $0.50 from pot
Nerkit: doesn't show hand 
*** SUMMARY ***
Total pot $0.50 | Rake $0 
Seat 1: masterkoolb (button) folded before Flop (didn't bet)
Seat 2: Nerkit (small blind) collected ($0.50)
Seat 3: Fructionar (big blind) folded before Flop
Seat 4: ShockLaMuc folded before Flop (didn't bet)
Seat 5: Grishukps folded before Flop (didn't bet)
Seat 6: kwkim73 folded before Flop (didn't bet)
Seat 7: chiyuki folded before Flop (didn't bet)
Seat 8: jacquelinewu folded before Flop (didn't bet)
Seat 9: Perstenev folded before Flop (didn't bet)



PokerStars Zoom Hand #84300816991:  Hold'em No Limit ($0.10/$0.25) - 2012/08/05 15:53:03 JST [2012/08/05 2:53:03 ET]
Table 'Whirlpool' 9-max Seat #1 is the button
Seat 1: chiyuki ($51.14 in chips) 
Seat 2: Dejacob ($26.68 in chips) 
Seat 3: KrystalAA ($15.26 in chips) 
Seat 4: Rilko1975 ($23.72 in chips) 
Seat 5: Perstenev ($11.73 in chips) 
Seat 6: munky3 ($25.78 in chips) 
Seat 7: snejokCoxx ($11.19 in chips) 
Seat 8: ShockLaMuc ($23.40 in chips) 
Seat 9: Rici47 ($41.88 in chips) 
Dejacob: posts small blind $0.10
KrystalAA: posts big blind $0.25
*** HOLE CARDS ***
Dealt to chiyuki [Kc 5h]
Rilko1975: folds 
Perstenev: folds 
munky3: folds 
snejokCoxx: folds 
ShockLaMuc: folds 
Rici47: raises $0.50 to $0.75
chiyuki: folds 
Dejacob: folds 
KrystalAA: folds 
Uncalled bet ($0.50) returned to Rici47
Rici47 collected $0.60 from pot
Rici47: doesn't show hand 
*** SUMMARY ***
Total pot $0.60 | Rake $0 
Seat 1: chiyuki (button) folded before Flop (didn't bet)
Seat 2: Dejacob (small blind) folded before Flop
Seat 3: KrystalAA (big blind) folded before Flop
Seat 4: Rilko1975 folded before Flop (didn't bet)
Seat 5: Perstenev folded before Flop (didn't bet)
Seat 6: munky3 folded before Flop (didn't bet)
Seat 7: snejokCoxx folded before Flop (didn't bet)
Seat 8: ShockLaMuc folded before Flop (didn't bet)
Seat 9: Rici47 collected ($0.60)



PokerStars Zoom Hand #84300814133:  Hold'em No Limit ($0.10/$0.25) - 2012/08/05 15:52:52 JST [2012/08/05 2:52:52 ET]
Table 'Whirlpool' 9-max Seat #1 is the button
Seat 1: DrunkTyphoon ($28.99 in chips) 
Seat 2: fil740 ($7.22 in chips) 
Seat 3: AntoineHunt ($38.10 in chips) 
Seat 4: masterkoolb ($13.17 in chips) 
Seat 5: kesstukas25 ($18.43 in chips) 
Seat 6: opie62 ($20.05 in chips) 
Seat 7: Limoilou ($28.57 in chips) 
Seat 8: Nerkit ($12.37 in chips) 
Seat 9: chiyuki ($51.14 in chips) 
fil740: posts small blind $0.10
AntoineHunt: posts big blind $0.25
*** HOLE CARDS ***
Dealt to chiyuki [3d 5d]
masterkoolb: folds 
kesstukas25: folds 
opie62: folds 
Limoilou: folds 
Nerkit: folds 
chiyuki: folds 
DrunkTyphoon: folds 
fil740: raises $0.25 to $0.50
AntoineHunt: calls $0.25
*** FLOP *** [Js Kh 8h]
fil740: bets $0.25
AntoineHunt: calls $0.25
*** TURN *** [Js Kh 8h] [Qd]
fil740: checks 
AntoineHunt: bets $0.75
fil740: calls $0.75
*** RIVER *** [Js Kh 8h Qd] [9s]
fil740: checks 
AntoineHunt: bets $1
fil740: folds 
Uncalled bet ($1) returned to AntoineHunt
AntoineHunt collected $2.86 from pot
AntoineHunt: doesn't show hand 
*** SUMMARY ***
Total pot $3 | Rake $0.14 
Board [Js Kh 8h Qd 9s]
Seat 1: DrunkTyphoon (button) folded before Flop (didn't bet)
Seat 2: fil740 (small blind) folded on the River
Seat 3: AntoineHunt (big blind) collected ($2.86)
Seat 4: masterkoolb folded before Flop (didn't bet)
Seat 5: kesstukas25 folded before Flop (didn't bet)
Seat 6: opie62 folded before Flop (didn't bet)
Seat 7: Limoilou folded before Flop (didn't bet)
Seat 8: Nerkit folded before Flop (didn't bet)
Seat 9: chiyuki folded before Flop (didn't bet)



PokerStars Zoom Hand #84300821212:  Hold'em No Limit ($0.10/$0.25) - 2012/08/05 15:53:19 JST [2012/08/05 2:53:19 ET]
Table 'Whirlpool' 9-max Seat #1 is the button
Seat 1: nice.franki ($8.48 in chips) 
Seat 2: leo2095 ($28.25 in chips) 
Seat 3: INSP!RON ($37.54 in chips) 
Seat 4: snejokCoxx ($11.19 in chips) 
Seat 5: masterkoolb ($13.17 in chips) 
Seat 6: GovGus ($40.51 in chips) 
Seat 7: kamikkaze ($22.48 in chips) 
Seat 8: chiyuki ($51.14 in chips) 
Seat 9: Perstenev ($11.73 in chips) 
leo2095: posts small blind $0.10
INSP!RON: posts big blind $0.25
*** HOLE CARDS ***
Dealt to chiyuki [9d Qc]
snejokCoxx: folds 
masterkoolb: folds 
GovGus: folds 
kamikkaze: folds 
chiyuki: folds 
Perstenev: folds 
nice.franki: folds 
leo2095: folds 
Uncalled bet ($0.15) returned to INSP!RON
INSP!RON collected $0.20 from pot
INSP!RON: doesn't show hand 
*** SUMMARY ***
Total pot $0.20 | Rake $0 
Seat 1: nice.franki (button) folded before Flop (didn't bet)
Seat 2: leo2095 (small blind) folded before Flop
Seat 3: INSP!RON (big blind) collected ($0.20)
Seat 4: snejokCoxx folded before Flop (didn't bet)
Seat 5: masterkoolb folded before Flop (didn't bet)
Seat 6: GovGus folded before Flop (didn't bet)
Seat 7: kamikkaze folded before Flop (didn't bet)
Seat 8: chiyuki folded before Flop (didn't bet)
Seat 9: Perstenev folded before Flop (didn't bet)



PokerStars Zoom Hand #84300824487:  Hold'em No Limit ($0.10/$0.25) - 2012/08/05 15:53:33 JST [2012/08/05 2:53:33 ET]
Table 'Whirlpool' 9-max Seat #1 is the button
Seat 1: SAILUSI ($33.09 in chips) 
Seat 2: kamikkaze ($22.48 in chips) 
Seat 3: ShockLaMuc ($23.40 in chips) 
Seat 4: masterkoolb ($13.65 in chips) 
Seat 5: chiyuki ($51.14 in chips) 
Seat 6: MurMurRu ($25.35 in chips) 
Seat 7: Lasutchik ($10.82 in chips) 
Seat 8: Kasperlmusik ($25 in chips) 
Seat 9: God)Squall ($28.24 in chips) 
kamikkaze: posts small blind $0.10
ShockLaMuc: posts big blind $0.25
*** HOLE CARDS ***
Dealt to chiyuki [3s 5c]
masterkoolb: folds 
chiyuki: folds 
MurMurRu: raises $0.42 to $0.67
Lasutchik: folds 
Kasperlmusik: folds 
God)Squall: folds 
SAILUSI: calls $0.67
kamikkaze: folds 
ShockLaMuc: folds 
*** FLOP *** [2h 3h Td]
MurMurRu: bets $1.37
SAILUSI: folds 
Uncalled bet ($1.37) returned to MurMurRu
MurMurRu collected $1.61 from pot
MurMurRu: doesn't show hand 
*** SUMMARY ***
Total pot $1.69 | Rake $0.08 
Board [2h 3h Td]
Seat 1: SAILUSI (button) folded on the Flop
Seat 2: kamikkaze (small blind) folded before Flop
Seat 3: ShockLaMuc (big blind) folded before Flop
Seat 4: masterkoolb folded before Flop (didn't bet)
Seat 5: chiyuki folded before Flop (didn't bet)
Seat 6: MurMurRu collected ($1.61)
Seat 7: Lasutchik folded before Flop (didn't bet)
Seat 8: Kasperlmusik folded before Flop (didn't bet)
Seat 9: God)Squall folded before Flop (didn't bet)



PokerStars Zoom Hand #84300827795:  Hold'em No Limit ($0.10/$0.25) - 2012/08/05 15:53:46 JST [2012/08/05 2:53:46 ET]
Table 'Whirlpool' 9-max Seat #1 is the button
Seat 1: Jene4kaBest ($16.08 in chips) 
Seat 2: chiyuki ($51.14 in chips) 
Seat 3: mjmichi ($86.16 in chips) 
Seat 4: Perstenev ($9.63 in chips) 
Seat 5: masterkoolb ($13.65 in chips) 
Seat 6: ShockLaMuc ($23.15 in chips) 
Seat 7: westhavenbc ($19.23 in chips) 
Seat 8: Limoilou ($28.22 in chips) 
Seat 9: CrittHunter ($29.54 in chips) 
chiyuki: posts small blind $0.10
mjmichi: posts big blind $0.25
*** HOLE CARDS ***
Dealt to chiyuki [Qd 6h]
Perstenev: folds 
masterkoolb: folds 
ShockLaMuc: folds 
westhavenbc: raises $0.25 to $0.50
Limoilou: folds 
CrittHunter: folds 
Jene4kaBest: folds 
chiyuki: folds 
mjmichi: folds 
Uncalled bet ($0.25) returned to westhavenbc
westhavenbc collected $0.60 from pot
westhavenbc: doesn't show hand 
*** SUMMARY ***
Total pot $0.60 | Rake $0 
Seat 1: Jene4kaBest (button) folded before Flop (didn't bet)
Seat 2: chiyuki (small blind) folded before Flop
Seat 3: mjmichi (big blind) folded before Flop
Seat 4: Perstenev folded before Flop (didn't bet)
Seat 5: masterkoolb folded before Flop (didn't bet)
Seat 6: ShockLaMuc folded before Flop (didn't bet)
Seat 7: westhavenbc collected ($0.60)
Seat 8: Limoilou folded before Flop (didn't bet)
Seat 9: CrittHunter folded before Flop (didn't bet)



PokerStars Zoom Hand #84300825796:  Hold'em No Limit ($0.10/$0.25) - 2012/08/05 15:53:38 JST [2012/08/05 2:53:38 ET]
Table 'Whirlpool' 9-max Seat #1 is the button
Seat 1: crazycrown1 ($12.15 in chips) 
Seat 2: dergeb ($21.29 in chips) 
Seat 3: Kasperlmusik ($25 in chips) 
Seat 4: Dejacob ($26.49 in chips) 
Seat 5: 1Karina1 ($25 in chips) 
Seat 6: chiyuki ($51.14 in chips) 
Seat 7: leo2095 ($28.15 in chips) 
Seat 8: rey2040 ($14.50 in chips) 
Seat 9: masterkoolb ($13.65 in chips) 
dergeb: posts small blind $0.10
Kasperlmusik: posts big blind $0.25
*** HOLE CARDS ***
Dealt to chiyuki [5d Qc]
Dejacob: raises $0.50 to $0.75
1Karina1: folds 
chiyuki: folds 
leo2095: folds 
rey2040: raises $13.75 to $14.50 and is all-in
masterkoolb: folds 
crazycrown1: folds 
dergeb: folds 
Kasperlmusik: folds 
Dejacob: folds 
Uncalled bet ($13.75) returned to rey2040
rey2040 collected $1.85 from pot
rey2040: doesn't show hand 
*** SUMMARY ***
Total pot $1.85 | Rake $0 
Seat 1: crazycrown1 (button) folded before Flop (didn't bet)
Seat 2: dergeb (small blind) folded before Flop
Seat 3: Kasperlmusik (big blind) folded before Flop
Seat 4: Dejacob folded before Flop
Seat 5: 1Karina1 folded before Flop (didn't bet)
Seat 6: chiyuki folded before Flop (didn't bet)
Seat 7: leo2095 folded before Flop (didn't bet)
Seat 8: rey2040 collected ($1.85)
Seat 9: masterkoolb folded before Flop (didn't bet)



PokerStars Zoom Hand #84300826807:  Hold'em No Limit ($0.10/$0.25) - 2012/08/05 15:53:42 JST [2012/08/05 2:53:42 ET]
Table 'Whirlpool' 9-max Seat #1 is the button
Seat 1: Silveystryk ($31.36 in chips) 
Seat 2: seula i ($49.01 in chips) 
Seat 3: Grishukps ($12.50 in chips) 
Seat 4: 1Karina1 ($25 in chips) 
Seat 5: masterkoolb ($13.65 in chips) 
Seat 6: yoube ($24.15 in chips) 
Seat 7: INSP!RON ($36.26 in chips) 
Seat 8: phate-1up ($42.23 in chips) 
Seat 9: chiyuki ($51.14 in chips) 
seula i: posts small blind $0.10
Grishukps: posts big blind $0.25
*** HOLE CARDS ***
Dealt to chiyuki [5s 2h]
1Karina1: folds 
masterkoolb: folds 
yoube: folds 
INSP!RON: raises $0.50 to $0.75
phate-1up: folds 
chiyuki: folds 
Silveystryk: folds 
seula i: folds 
Grishukps: raises $1.35 to $2.10
INSP!RON: folds 
Uncalled bet ($1.35) returned to Grishukps
Grishukps collected $1.60 from pot
Grishukps: doesn't show hand 
*** SUMMARY ***
Total pot $1.60 | Rake $0 
Seat 1: Silveystryk (button) folded before Flop (didn't bet)
Seat 2: seula i (small blind) folded before Flop
Seat 3: Grishukps (big blind) collected ($1.60)
Seat 4: 1Karina1 folded before Flop (didn't bet)
Seat 5: masterkoolb folded before Flop (didn't bet)
Seat 6: yoube folded before Flop (didn't bet)
Seat 7: INSP!RON folded before Flop
Seat 8: phate-1up folded before Flop (didn't bet)
Seat 9: chiyuki folded before Flop (didn't bet)



PokerStars Zoom Hand #84300817759:  Hold'em No Limit ($0.10/$0.25) - 2012/08/05 15:53:06 JST [2012/08/05 2:53:06 ET]
Table 'Whirlpool' 9-max Seat #1 is the button
Seat 1: jacquelinewu ($34.59 in chips) 
Seat 2: crazycrown1 ($12.25 in chips) 
Seat 3: kwkim73 ($30.35 in chips) 
Seat 4: kkbruins0408 ($9.42 in chips) 
Seat 5: KeLevro0 ($12.50 in chips) 
Seat 6: chiyuki ($51.14 in chips) 
Seat 7: opie62 ($19.95 in chips) 
Seat 8: pawn909 ($24.48 in chips) 
Seat 9: nice.franki ($12.58 in chips) 
crazycrown1: posts small blind $0.10
kwkim73: posts big blind $0.25
*** HOLE CARDS ***
Dealt to chiyuki [9s Qs]
kkbruins0408: folds 
KeLevro0: folds 
chiyuki: folds 
opie62: raises $0.50 to $0.75
pawn909: folds 
nice.franki: folds 
jacquelinewu: raises $1.50 to $2.25
crazycrown1: folds 
kwkim73: folds 
opie62: calls $1.50
*** FLOP *** [Jc Qh 2c]
opie62: checks 
jacquelinewu: bets $3.24
opie62: calls $3.24
*** TURN *** [Jc Qh 2c] [8c]
opie62: checks 
jacquelinewu: checks 
*** RIVER *** [Jc Qh 2c 8c] [2s]
opie62: bets $8.50
jacquelinewu: folds 
Uncalled bet ($8.50) returned to opie62
opie62 collected $10.82 from pot
opie62: doesn't show hand 
*** SUMMARY ***
Total pot $11.33 | Rake $0.51 
Board [Jc Qh 2c 8c 2s]
Seat 1: jacquelinewu (button) folded on the River
Seat 2: crazycrown1 (small blind) folded before Flop
Seat 3: kwkim73 (big blind) folded before Flop
Seat 4: kkbruins0408 folded before Flop (didn't bet)
Seat 5: KeLevro0 folded before Flop (didn't bet)
Seat 6: chiyuki folded before Flop (didn't bet)
Seat 7: opie62 collected ($10.82)
Seat 8: pawn909 folded before Flop (didn't bet)
Seat 9: nice.franki folded before Flop (didn't bet)



PokerStars Zoom Hand #84300835544:  Hold'em No Limit ($0.10/$0.25) - 2012/08/05 15:54:16 JST [2012/08/05 2:54:16 ET]
Table 'Whirlpool' 9-max Seat #1 is the button
Seat 1: Dan Royal ($32.93 in chips) 
Seat 2: Kasperlmusik ($32.45 in chips) 
Seat 3: Nerkit ($12.50 in chips) 
Seat 4: chiyuki ($50.79 in chips) 
Seat 5: gatorswamp ($18.12 in chips) 
Seat 6: tribunpdm ($78.41 in chips) 
Seat 7: Silveystryk ($31.36 in chips) 
Seat 8: MurMurRu ($26.64 in chips) 
Seat 9: GSDP ($21.04 in chips) 
Kasperlmusik: posts small blind $0.10
Nerkit: posts big blind $0.25
*** HOLE CARDS ***
Dealt to chiyuki [5h Ts]
chiyuki: folds 
gatorswamp: folds 
tribunpdm: folds 
Silveystryk: folds 
MurMurRu: raises $0.42 to $0.67
GSDP: folds 
Dan Royal: folds 
Kasperlmusik: folds 
Nerkit: folds 
Uncalled bet ($0.42) returned to MurMurRu
MurMurRu collected $0.60 from pot
MurMurRu: doesn't show hand 
*** SUMMARY ***
Total pot $0.60 | Rake $0 
Seat 1: Dan Royal (button) folded before Flop (didn't bet)
Seat 2: Kasperlmusik (small blind) folded before Flop
Seat 3: Nerkit (big blind) folded before Flop
Seat 4: chiyuki folded before Flop (didn't bet)
Seat 5: gatorswamp folded before Flop (didn't bet)
Seat 6: tribunpdm folded before Flop (didn't bet)
Seat 7: Silveystryk folded before Flop (didn't bet)
Seat 8: MurMurRu collected ($0.60)
Seat 9: GSDP folded before Flop (didn't bet)



PokerStars Zoom Hand #84300836587:  Hold'em No Limit ($0.10/$0.25) - 2012/08/05 15:54:20 JST [2012/08/05 2:54:20 ET]
Table 'Whirlpool' 9-max Seat #1 is the button
Seat 1: GSDP ($21.04 in chips) 
Seat 2: schoof 2 ($26.19 in chips) 
Seat 3: Grishukps ($12.50 in chips) 
Seat 4: tribunpdm ($78.41 in chips) 
Seat 5: silvno31 ($54.35 in chips) 
Seat 6: seula i ($28.94 in chips) 
Seat 7: chiyuki ($50.79 in chips) 
Seat 8: Dan Royal ($32.93 in chips) 
Seat 9: phate-1up ($62.22 in chips) 
schoof 2: posts small blind $0.10
Grishukps: posts big blind $0.25
*** HOLE CARDS ***
Dealt to chiyuki [7c Kd]
tribunpdm: folds 
silvno31: raises $0.75 to $1
seula i: folds 
chiyuki: folds 
Dan Royal: folds 
phate-1up: folds 
GSDP: folds 
schoof 2: folds 
Grishukps: folds 
Uncalled bet ($0.75) returned to silvno31
silvno31 collected $0.60 from pot
silvno31: doesn't show hand 
*** SUMMARY ***
Total pot $0.60 | Rake $0 
Seat 1: GSDP (button) folded before Flop (didn't bet)
Seat 2: schoof 2 (small blind) folded before Flop
Seat 3: Grishukps (big blind) folded before Flop
Seat 4: tribunpdm folded before Flop (didn't bet)
Seat 5: silvno31 collected ($0.60)
Seat 6: seula i folded before Flop (didn't bet)
Seat 7: chiyuki folded before Flop (didn't bet)
Seat 8: Dan Royal folded before Flop (didn't bet)
Seat 9: phate-1up folded before Flop (didn't bet)



PokerStars Zoom Hand #84300839730:  Hold'em No Limit ($0.10/$0.25) - 2012/08/05 15:54:32 JST [2012/08/05 2:54:32 ET]
Table 'Whirlpool' 9-max Seat #1 is the button
Seat 1: kwkim73 ($25 in chips) 
Seat 2: 6nikola9 ($18.46 in chips) 
Seat 3: mjmichi ($37.68 in chips) 
Seat 4: Grishukps ($12.50 in chips) 
Seat 5: chiyuki ($50.79 in chips) 
Seat 6: kesstukas25 ($17.81 in chips) 
Seat 7: 4plankton ($20.78 in chips) 
Seat 8: pandaaaaaa ($15.65 in chips) 
Seat 9: Perstenev ($9.38 in chips) 
6nikola9: posts small blind $0.10
mjmichi: posts big blind $0.25
*** HOLE CARDS ***
Dealt to chiyuki [6s 2h]
Grishukps: folds 
chiyuki: folds 
kesstukas25: folds 
4plankton: folds 
pandaaaaaa: folds 
Perstenev: folds 
kwkim73: folds 
6nikola9: folds 
Uncalled bet ($0.15) returned to mjmichi
mjmichi collected $0.20 from pot
mjmichi: doesn't show hand 
*** SUMMARY ***
Total pot $0.20 | Rake $0 
Seat 1: kwkim73 (button) folded before Flop (didn't bet)
Seat 2: 6nikola9 (small blind) folded before Flop
Seat 3: mjmichi (big blind) collected ($0.20)
Seat 4: Grishukps folded before Flop (didn't bet)
Seat 5: chiyuki folded before Flop (didn't bet)
Seat 6: kesstukas25 folded before Flop (didn't bet)
Seat 7: 4plankton folded before Flop (didn't bet)
Seat 8: pandaaaaaa folded before Flop (didn't bet)
Seat 9: Perstenev folded before Flop (didn't bet)



PokerStars Zoom Hand #84300840485:  Hold'em No Limit ($0.10/$0.25) - 2012/08/05 15:54:35 JST [2012/08/05 2:54:35 ET]
Table 'Whirlpool' 9-max Seat #1 is the button
Seat 1: nice.franki ($12.23 in chips) 
Seat 2: Bahia gyn ($24.25 in chips) 
Seat 3: Kasperlmusik ($32.35 in chips) 
Seat 4: Spheroff ($10.02 in chips) 
Seat 5: TorTrade ($25.68 in chips) 
Seat 6: Grishukps ($12.50 in chips) 
Seat 7: Nerkit ($12.25 in chips) 
Seat 8: chiyuki ($50.79 in chips) 
Seat 9: kwkim73 ($30 in chips) 
Bahia gyn: posts small blind $0.10
Kasperlmusik: posts big blind $0.25
*** HOLE CARDS ***
Dealt to chiyuki [Th 3h]
Spheroff: folds 
TorTrade: folds 
Grishukps: folds 
Nerkit: folds 
chiyuki: folds 
kwkim73: folds 
nice.franki: folds 
Bahia gyn: folds 
Uncalled bet ($0.15) returned to Kasperlmusik
Kasperlmusik collected $0.20 from pot
Kasperlmusik: doesn't show hand 
*** SUMMARY ***
Total pot $0.20 | Rake $0 
Seat 1: nice.franki (button) folded before Flop (didn't bet)
Seat 2: Bahia gyn (small blind) folded before Flop
Seat 3: Kasperlmusik (big blind) collected ($0.20)
Seat 4: Spheroff folded before Flop (didn't bet)
Seat 5: TorTrade folded before Flop (didn't bet)
Seat 6: Grishukps folded before Flop (didn't bet)
Seat 7: Nerkit folded before Flop (didn't bet)
Seat 8: chiyuki folded before Flop (didn't bet)
Seat 9: kwkim73 folded before Flop (didn't bet)



PokerStars Zoom Hand #84300832160:  Hold'em No Limit ($0.10/$0.25) - 2012/08/05 15:54:03 JST [2012/08/05 2:54:03 ET]
Table 'Whirlpool' 9-max Seat #1 is the button
Seat 1: herkko11 ($10.80 in chips) 
Seat 2: nice.franki ($7.05 in chips) 
Seat 3: chiyuki ($51.04 in chips) 
Seat 4: vpetrovi ($10.72 in chips) 
Seat 5: yoube ($24.05 in chips) 
Seat 6: hldtom ($13.95 in chips) 
Seat 7: 1Karina1 ($35.82 in chips) 
Seat 8: jacquelinewu ($32.36 in chips) 
Seat 9: kamikkaze ($18.40 in chips) 
nice.franki: posts small blind $0.10
chiyuki: posts big blind $0.25
*** HOLE CARDS ***
Dealt to chiyuki [3c 8d]
vpetrovi: folds 
yoube: raises $0.25 to $0.50
hldtom: raises $0.25 to $0.75
1Karina1: folds 
jacquelinewu: folds 
kamikkaze: folds 
herkko11: folds 
nice.franki: folds 
chiyuki: folds 
yoube: calls $0.25
*** FLOP *** [6c Kd Kh]
yoube: checks 
hldtom: bets $1.34
yoube: calls $1.34
*** TURN *** [6c Kd Kh] [4s]
yoube: checks 
hldtom: bets $2.16
yoube: raises $2.66 to $4.82
hldtom: calls $2.66
*** RIVER *** [6c Kd Kh 4s] [5h]
yoube: bets $7.50
hldtom: folds 
Uncalled bet ($7.50) returned to yoube
yoube collected $13.53 from pot
yoube: doesn't show hand 
*** SUMMARY ***
Total pot $14.17 | Rake $0.64 
Board [6c Kd Kh 4s 5h]
Seat 1: herkko11 (button) folded before Flop (didn't bet)
Seat 2: nice.franki (small blind) folded before Flop
Seat 3: chiyuki (big blind) folded before Flop
Seat 4: vpetrovi folded before Flop (didn't bet)
Seat 5: yoube collected ($13.53)
Seat 6: hldtom folded on the River
Seat 7: 1Karina1 folded before Flop (didn't bet)
Seat 8: jacquelinewu folded before Flop (didn't bet)
Seat 9: kamikkaze folded before Flop (didn't bet)



PokerStars Zoom Hand #84300837355:  Hold'em No Limit ($0.10/$0.25) - 2012/08/05 15:54:23 JST [2012/08/05 2:54:23 ET]
Table 'Whirlpool' 9-max Seat #1 is the button
Seat 1: chiyuki ($50.79 in chips) 
Seat 2: Alvinpe85 ($43.58 in chips) 
Seat 3: fil740 ($7.19 in chips) 
Seat 4: 1Karina1 ($35.82 in chips) 
Seat 5: kamikkaze ($22.03 in chips) 
Seat 6: nice.franki ($12.23 in chips) 
Seat 7: gatorswamp ($18.12 in chips) 
Seat 8: opie62 ($25.28 in chips) 
Seat 9: Perstenev ($14.72 in chips) 
Alvinpe85: posts small blind $0.10
fil740: posts big blind $0.25
*** HOLE CARDS ***
Dealt to chiyuki [9c 2c]
1Karina1: folds 
kamikkaze: folds 
nice.franki: folds 
gatorswamp: raises $0.50 to $0.75
opie62: folds 
Perstenev: folds 
chiyuki: folds 
Alvinpe85: folds 
fil740: calls $0.50
*** FLOP *** [7h 4h 4s]
fil740: checks 
gatorswamp: bets $1.25
fil740: calls $1.25
*** TURN *** [7h 4h 4s] [4c]
fil740: checks 
gatorswamp: checks 
*** RIVER *** [7h 4h 4s 4c] [Th]
fil740: bets $1.25
gatorswamp: calls $1.25
*** SHOW DOWN ***
fil740: shows [6s 6h] (a full house, Fours full of Sixes)
gatorswamp: mucks hand 
fil740 collected $6.30 from pot
*** SUMMARY ***
Total pot $6.60 | Rake $0.30 
Board [7h 4h 4s 4c Th]
Seat 1: chiyuki (button) folded before Flop (didn't bet)
Seat 2: Alvinpe85 (small blind) folded before Flop
Seat 3: fil740 (big blind) showed [6s 6h] and won ($6.30) with a full house, Fours full of Sixes
Seat 4: 1Karina1 folded before Flop (didn't bet)
Seat 5: kamikkaze folded before Flop (didn't bet)
Seat 6: nice.franki folded before Flop (didn't bet)
Seat 7: gatorswamp mucked [Qd Ah]
Seat 8: opie62 folded before Flop (didn't bet)
Seat 9: Perstenev folded before Flop (didn't bet)



PokerStars Zoom Hand #84300842474:  Hold'em No Limit ($0.10/$0.25) - 2012/08/05 15:54:44 JST [2012/08/05 2:54:44 ET]
Table 'Whirlpool' 9-max Seat #1 is the button
Seat 1: Serge Claws ($26.11 in chips) 
Seat 2: KrystalAA ($25.99 in chips) 
Seat 3: FoRlan77 ($25 in chips) 
Seat 4: chiyuki ($50.79 in chips) 
Seat 5: MurMurRu ($25.25 in chips) 
Seat 6: Fructionar ($37.73 in chips) 
Seat 7: Grishukps ($13.25 in chips) 
Seat 8: westhavenbc ($16.80 in chips) 
Seat 9: GovGus ($30.34 in chips) 
KrystalAA: posts small blind $0.10
FoRlan77: posts big blind $0.25
*** HOLE CARDS ***
Dealt to chiyuki [Kc 8c]
chiyuki: folds 
MurMurRu: folds 
Fructionar: folds 
Grishukps: folds 
westhavenbc: raises $0.50 to $0.75
GovGus: folds 
Serge Claws: folds 
KrystalAA: folds 
FoRlan77: folds 
Uncalled bet ($0.50) returned to westhavenbc
westhavenbc collected $0.60 from pot
westhavenbc: doesn't show hand 
*** SUMMARY ***
Total pot $0.60 | Rake $0 
Seat 1: Serge Claws (button) folded before Flop (didn't bet)
Seat 2: KrystalAA (small blind) folded before Flop
Seat 3: FoRlan77 (big blind) folded before Flop
Seat 4: chiyuki folded before Flop (didn't bet)
Seat 5: MurMurRu folded before Flop (didn't bet)
Seat 6: Fructionar folded before Flop (didn't bet)
Seat 7: Grishukps folded before Flop (didn't bet)
Seat 8: westhavenbc collected ($0.60)
Seat 9: GovGus folded before Flop (didn't bet)



PokerStars Zoom Hand #84300843527:  Hold'em No Limit ($0.10/$0.25) - 2012/08/05 15:54:48 JST [2012/08/05 2:54:48 ET]
Table 'Whirlpool' 9-max Seat #1 is the button
Seat 1: Komissar82 ($11.64 in chips) 
Seat 2: kwkim73 ($25 in chips) 
Seat 3: Lasutchik ($21.48 in chips) 
Seat 4: Fructionar ($37.73 in chips) 
Seat 5: GSDP ($20.94 in chips) 
Seat 6: Dan Royal ($32.58 in chips) 
Seat 7: kesstukas25 ($17.81 in chips) 
Seat 8: PPP7SSS ($18.78 in chips) 
Seat 9: chiyuki ($50.79 in chips) 
kwkim73: posts small blind $0.10
Lasutchik: posts big blind $0.25
*** HOLE CARDS ***
Dealt to chiyuki [3h Ad]
Fructionar: calls $0.25
GSDP: folds 
Dan Royal: folds 
kesstukas25: folds 
PPP7SSS: folds 
chiyuki: folds 
Komissar82: folds 
kwkim73: folds 
Lasutchik: checks 
*** FLOP *** [3d 4s 8h]
Lasutchik: checks 
Fructionar: bets $0.28
Lasutchik: calls $0.28
*** TURN *** [3d 4s 8h] [6h]
Lasutchik: checks 
Fructionar: bets $0.55
Lasutchik: raises $1.12 to $1.67
Fructionar: calls $1.12
*** RIVER *** [3d 4s 8h 6h] [9h]
Lasutchik: checks 
Fructionar: checks 
*** SHOW DOWN ***
Lasutchik: shows [6c 4d] (two pair, Sixes and Fours)
Fructionar: mucks hand 
Lasutchik collected $4.30 from pot
*** SUMMARY ***
Total pot $4.50 | Rake $0.20 
Board [3d 4s 8h 6h 9h]
Seat 1: Komissar82 (button) folded before Flop (didn't bet)
Seat 2: kwkim73 (small blind) folded before Flop
Seat 3: Lasutchik (big blind) showed [6c 4d] and won ($4.30) with two pair, Sixes and Fours
Seat 4: Fructionar mucked [7s 7h]
Seat 5: GSDP folded before Flop (didn't bet)
Seat 6: Dan Royal folded before Flop (didn't bet)
Seat 7: kesstukas25 folded before Flop (didn't bet)
Seat 8: PPP7SSS folded before Flop (didn't bet)
Seat 9: chiyuki folded before Flop (didn't bet)



PokerStars Zoom Hand #84300853061:  Hold'em No Limit ($0.10/$0.25) - 2012/08/05 15:55:30 JST [2012/08/05 2:55:30 ET]
Table 'Whirlpool' 9-max Seat #1 is the button
Seat 1: chiyuki ($50.44 in chips) 
Seat 2: jacquelinewu ($32.81 in chips) 
Seat 3: JhonnyP1979 ($17.73 in chips) 
Seat 4: westhavenbc ($19.93 in chips) 
Seat 5: dergeb ($27.84 in chips) 
Seat 6: Alvinpe85 ($43.23 in chips) 
Seat 7: Silveystryk ($15.89 in chips) 
Seat 8: risekuku468 ($34.16 in chips) 
Seat 9: Serge Claws ($25.86 in chips) 
jacquelinewu: posts small blind $0.10
JhonnyP1979: posts big blind $0.25
*** HOLE CARDS ***
Dealt to chiyuki [Ks 3d]
westhavenbc: folds 
dergeb: raises $0.50 to $0.75
Alvinpe85: folds 
Silveystryk: folds 
risekuku468: folds 
Serge Claws: folds 
chiyuki: folds 
jacquelinewu: folds 
JhonnyP1979: folds 
Uncalled bet ($0.50) returned to dergeb
dergeb collected $0.60 from pot
dergeb: doesn't show hand 
*** SUMMARY ***
Total pot $0.60 | Rake $0 
Seat 1: chiyuki (button) folded before Flop (didn't bet)
Seat 2: jacquelinewu (small blind) folded before Flop
Seat 3: JhonnyP1979 (big blind) folded before Flop
Seat 4: westhavenbc folded before Flop (didn't bet)
Seat 5: dergeb collected ($0.60)
Seat 6: Alvinpe85 folded before Flop (didn't bet)
Seat 7: Silveystryk folded before Flop (didn't bet)
Seat 8: risekuku468 folded before Flop (didn't bet)
Seat 9: Serge Claws folded before Flop (didn't bet)



PokerStars Zoom Hand #84300844555:  Hold'em No Limit ($0.10/$0.25) - 2012/08/05 15:54:52 JST [2012/08/05 2:54:52 ET]
Table 'Whirlpool' 9-max Seat #1 is the button
Seat 1: MurMurRu ($25 in chips) 
Seat 2: 1Karina1 ($34.87 in chips) 
Seat 3: chiyuki ($50.79 in chips) 
Seat 4: snejokCoxx ($9.85 in chips) 
Seat 5: seula i ($47.66 in chips) 
Seat 6: mjmichi ($37.78 in chips) 
Seat 7: Perstenev ($12.40 in chips) 
Seat 8: Alvinpe85 ($43.48 in chips) 
Seat 9: Spheroff ($9.92 in chips) 
1Karina1: posts small blind $0.10
chiyuki: posts big blind $0.25
*** HOLE CARDS ***
Dealt to chiyuki [9d Qc]
snejokCoxx: folds 
seula i: folds 
mjmichi: folds 
Perstenev: calls $0.25
Alvinpe85: folds 
Spheroff: raises $0.75 to $1
MurMurRu: folds 
1Karina1: calls $0.90
chiyuki: folds 
Perstenev: calls $0.75
*** FLOP *** [Tc Kc 6h]
1Karina1: checks 
Perstenev: checks 
Spheroff: bets $1.50
1Karina1: raises $31.75 to $33.25
Perstenev: folds 
Spheroff: folds 
Uncalled bet ($31.75) returned to 1Karina1
1Karina1 collected $5.97 from pot
1Karina1: doesn't show hand 
*** SUMMARY ***
Total pot $6.25 | Rake $0.28 
Board [Tc Kc 6h]
Seat 1: MurMurRu (button) folded before Flop (didn't bet)
Seat 2: 1Karina1 (small blind) collected ($5.97)
Seat 3: chiyuki (big blind) folded before Flop
Seat 4: snejokCoxx folded before Flop (didn't bet)
Seat 5: seula i folded before Flop (didn't bet)
Seat 6: mjmichi folded before Flop (didn't bet)
Seat 7: Perstenev folded on the Flop
Seat 8: Alvinpe85 folded before Flop (didn't bet)
Seat 9: Spheroff folded on the Flop



PokerStars Zoom Hand #84300851196:  Hold'em No Limit ($0.10/$0.25) - 2012/08/05 15:55:21 JST [2012/08/05 2:55:21 ET]
Table 'Whirlpool' 9-max Seat #1 is the button
Seat 1: fil740 ($10.14 in chips) 
Seat 2: chiyuki ($50.54 in chips) 
Seat 3: Grishukps ($13.25 in chips) 
Seat 4: snejokCoxx ($11.85 in chips) 
Seat 5: jvds114 ($35.98 in chips) 
Seat 6: Dejacob ($25.74 in chips) 
Seat 7: 1Karina1 ($35.47 in chips) 
Seat 8: misskitty354 ($11.80 in chips) 
Seat 9: ShockLaMuc ($25 in chips) 
chiyuki: posts small blind $0.10
Grishukps: posts big blind $0.25
*** HOLE CARDS ***
Dealt to chiyuki [Ks 3h]
snejokCoxx: folds 
jvds114: folds 
Dejacob: folds 
1Karina1: folds 
misskitty354: folds 
ShockLaMuc: folds 
fil740: raises $0.25 to $0.50
chiyuki: folds 
Grishukps: folds 
Uncalled bet ($0.25) returned to fil740
fil740 collected $0.60 from pot
fil740: doesn't show hand 
*** SUMMARY ***
Total pot $0.60 | Rake $0 
Seat 1: fil740 (button) collected ($0.60)
Seat 2: chiyuki (small blind) folded before Flop
Seat 3: Grishukps (big blind) folded before Flop
Seat 4: snejokCoxx folded before Flop (didn't bet)
Seat 5: jvds114 folded before Flop (didn't bet)
Seat 6: Dejacob folded before Flop (didn't bet)
Seat 7: 1Karina1 folded before Flop (didn't bet)
Seat 8: misskitty354 folded before Flop (didn't bet)
Seat 9: ShockLaMuc folded before Flop (didn't bet)



PokerStars Zoom Hand #84300857088:  Hold'em No Limit ($0.10/$0.25) - 2012/08/05 15:55:49 JST [2012/08/05 2:55:49 ET]
Table 'Whirlpool' 9-max Seat #1 is the button
Seat 1: seula i ($29.61 in chips) 
Seat 2: Limoilou ($25.48 in chips) 
Seat 3: INSP!RON ($34.66 in chips) 
Seat 4: nice.franki ($6.60 in chips) 
Seat 5: chiyuki ($50.44 in chips) 
Seat 6: Jene4kaBest ($13.83 in chips) 
Seat 7: Serge Claws ($65.88 in chips) 
Seat 8: Spheroff ($7.42 in chips) 
Seat 9: Kasperlmusik ($25 in chips) 
Limoilou: posts small blind $0.10
INSP!RON: posts big blind $0.25
*** HOLE CARDS ***
Dealt to chiyuki [Ad 8c]
nice.franki: folds 
chiyuki: folds 
Jene4kaBest: folds 
Serge Claws: folds 
Spheroff: folds 
Kasperlmusik: raises $0.50 to $0.75
seula i: folds 
Limoilou: folds 
INSP!RON: folds 
Uncalled bet ($0.50) returned to Kasperlmusik
Kasperlmusik collected $0.60 from pot
Kasperlmusik: doesn't show hand 
*** SUMMARY ***
Total pot $0.60 | Rake $0 
Seat 1: seula i (button) folded before Flop (didn't bet)
Seat 2: Limoilou (small blind) folded before Flop
Seat 3: INSP!RON (big blind) folded before Flop
Seat 4: nice.franki folded before Flop (didn't bet)
Seat 5: chiyuki folded before Flop (didn't bet)
Seat 6: Jene4kaBest folded before Flop (didn't bet)
Seat 7: Serge Claws folded before Flop (didn't bet)
Seat 8: Spheroff folded before Flop (didn't bet)
Seat 9: Kasperlmusik collected ($0.60)



PokerStars Zoom Hand #84300857933:  Hold'em No Limit ($0.10/$0.25) - 2012/08/05 15:55:54 JST [2012/08/05 2:55:54 ET]
Table 'Whirlpool' 9-max Seat #1 is the button
Seat 1: snejokCoxx ($11.60 in chips) 
Seat 2: nice.franki ($11.73 in chips) 
Seat 3: Rici47 ($27.96 in chips) 
Seat 4: Jene4kaBest ($13.83 in chips) 
Seat 5: Grishukps ($14.85 in chips) 
Seat 6: jacquelinewu ($26.24 in chips) 
Seat 7: masterkoolb ($18.29 in chips) 
Seat 8: chiyuki ($50.44 in chips) 
Seat 9: fil740 ($10.49 in chips) 
nice.franki: posts small blind $0.10
Rici47: posts big blind $0.25
*** HOLE CARDS ***
Dealt to chiyuki [Jd Ks]
Jene4kaBest: folds 
Grishukps: folds 
jacquelinewu: raises $0.50 to $0.75
masterkoolb: folds 
chiyuki: folds 
fil740: folds 
snejokCoxx: folds 
nice.franki: folds 
Rici47: folds 
Uncalled bet ($0.50) returned to jacquelinewu
jacquelinewu collected $0.60 from pot
jacquelinewu: doesn't show hand 
*** SUMMARY ***
Total pot $0.60 | Rake $0 
Seat 1: snejokCoxx (button) folded before Flop (didn't bet)
Seat 2: nice.franki (small blind) folded before Flop
Seat 3: Rici47 (big blind) folded before Flop
Seat 4: Jene4kaBest folded before Flop (didn't bet)
Seat 5: Grishukps folded before Flop (didn't bet)
Seat 6: jacquelinewu collected ($0.60)
Seat 7: masterkoolb folded before Flop (didn't bet)
Seat 8: chiyuki folded before Flop (didn't bet)
Seat 9: fil740 folded before Flop (didn't bet)



PokerStars Zoom Hand #84300854316:  Hold'em No Limit ($0.10/$0.25) - 2012/08/05 15:55:36 JST [2012/08/05 2:55:36 ET]
Table 'Whirlpool' 9-max Seat #1 is the button
Seat 1: kwkim73 ($25 in chips) 
Seat 2: TorTrade ($23.93 in chips) 
Seat 3: Dejacob ($25.74 in chips) 
Seat 4: seula i ($29.61 in chips) 
Seat 5: risekuku468 ($34.16 in chips) 
Seat 6: chiyuki ($50.44 in chips) 
Seat 7: jacquelinewu ($71.09 in chips) 
Seat 8: Kasperlmusik ($25 in chips) 
Seat 9: nice.franki ($6.70 in chips) 
TorTrade: posts small blind $0.10
Dejacob: posts big blind $0.25
*** HOLE CARDS ***
Dealt to chiyuki [Ad 8h]
seula i: folds 
risekuku468: folds 
chiyuki: folds 
jacquelinewu: folds 
Kasperlmusik: folds 
nice.franki: folds 
kwkim73: folds 
TorTrade: raises $0.75 to $1
Dejacob: calls $0.75
*** FLOP *** [8d 4h 3d]
TorTrade: bets $1.43
Dejacob: raises $2.57 to $4
TorTrade: folds 
Uncalled bet ($2.57) returned to Dejacob
Dejacob collected $4.64 from pot
Dejacob: doesn't show hand 
*** SUMMARY ***
Total pot $4.86 | Rake $0.22 
Board [8d 4h 3d]
Seat 1: kwkim73 (button) folded before Flop (didn't bet)
Seat 2: TorTrade (small blind) folded on the Flop
Seat 3: Dejacob (big blind) collected ($4.64)
Seat 4: seula i folded before Flop (didn't bet)
Seat 5: risekuku468 folded before Flop (didn't bet)
Seat 6: chiyuki folded before Flop (didn't bet)
Seat 7: jacquelinewu folded before Flop (didn't bet)
Seat 8: Kasperlmusik folded before Flop (didn't bet)
Seat 9: nice.franki folded before Flop (didn't bet)



PokerStars Zoom Hand #84300861709:  Hold'em No Limit ($0.10/$0.25) - 2012/08/05 15:56:12 JST [2012/08/05 2:56:12 ET]
Table 'Whirlpool' 9-max Seat #1 is the button
Seat 1: jacquelinewu ($26.59 in chips) 
Seat 2: Serge Claws ($27.70 in chips) 
Seat 3: chiyuki ($50.44 in chips) 
Seat 4: fil740 ($10.49 in chips) 
Seat 5: Perstenev ($8.43 in chips) 
Seat 6: Ellen1947 ($29.80 in chips) 
Seat 7: snejokCoxx ($9.85 in chips) 
Seat 8: nice.franki ($11.63 in chips) 
Seat 9: GovGus ($61.65 in chips) 
Serge Claws: posts small blind $0.10
chiyuki: posts big blind $0.25
*** HOLE CARDS ***
Dealt to chiyuki [8h Qh]
fil740: folds 
Perstenev: folds 
Ellen1947: folds 
snejokCoxx: folds 
nice.franki: folds 
GovGus: raises $0.75 to $1
jacquelinewu: folds 
Serge Claws: folds 
chiyuki: folds 
Uncalled bet ($0.75) returned to GovGus
GovGus collected $0.60 from pot
GovGus: doesn't show hand 
*** SUMMARY ***
Total pot $0.60 | Rake $0 
Seat 1: jacquelinewu (button) folded before Flop (didn't bet)
Seat 2: Serge Claws (small blind) folded before Flop
Seat 3: chiyuki (big blind) folded before Flop
Seat 4: fil740 folded before Flop (didn't bet)
Seat 5: Perstenev folded before Flop (didn't bet)
Seat 6: Ellen1947 folded before Flop (didn't bet)
Seat 7: snejokCoxx folded before Flop (didn't bet)
Seat 8: nice.franki folded before Flop (didn't bet)
Seat 9: GovGus collected ($0.60)



PokerStars Zoom Hand #84300858770:  Hold'em No Limit ($0.10/$0.25) - 2012/08/05 15:55:58 JST [2012/08/05 2:55:58 ET]
Table 'Whirlpool' 9-max Seat #1 is the button
Seat 1: ShockLaMuc ($25.22 in chips) 
Seat 2: kwkim73 ($25.45 in chips) 
Seat 3: Saruotiss ($62.26 in chips) 
Seat 4: GovGus ($41.24 in chips) 
Seat 5: ChrisCDee ($58.34 in chips) 
Seat 6: westhavenbc ($16.65 in chips) 
Seat 7: chiyuki ($50.44 in chips) 
Seat 8: mjmichi ($38.92 in chips) 
Seat 9: xxx Spb xxx ($28.01 in chips) 
kwkim73: posts small blind $0.10
Saruotiss: posts big blind $0.25
*** HOLE CARDS ***
Dealt to chiyuki [9c 4s]
GovGus: folds 
ChrisCDee: folds 
westhavenbc: folds 
chiyuki: folds 
mjmichi: folds 
xxx Spb xxx: folds 
ShockLaMuc: raises $0.50 to $0.75
kwkim73: folds 
Saruotiss: calls $0.50
*** FLOP *** [2s Jh Ts]
Saruotiss: checks 
ShockLaMuc: bets $1.05
Saruotiss: folds 
Uncalled bet ($1.05) returned to ShockLaMuc
ShockLaMuc collected $1.53 from pot
ShockLaMuc: doesn't show hand 
*** SUMMARY ***
Total pot $1.60 | Rake $0.07 
Board [2s Jh Ts]
Seat 1: ShockLaMuc (button) collected ($1.53)
Seat 2: kwkim73 (small blind) folded before Flop
Seat 3: Saruotiss (big blind) folded on the Flop
Seat 4: GovGus folded before Flop (didn't bet)
Seat 5: ChrisCDee folded before Flop (didn't bet)
Seat 6: westhavenbc folded before Flop (didn't bet)
Seat 7: chiyuki folded before Flop (didn't bet)
Seat 8: mjmichi folded before Flop (didn't bet)
Seat 9: xxx Spb xxx folded before Flop (didn't bet)



PokerStars Zoom Hand #84300865272:  Hold'em No Limit ($0.10/$0.25) - 2012/08/05 15:56:29 JST [2012/08/05 2:56:29 ET]
Table 'Whirlpool' 9-max Seat #1 is the button
Seat 1: God)Squall ($27.24 in chips) 
Seat 2: nice.franki ($6.35 in chips) 
Seat 3: Perstenev ($8.43 in chips) 
Seat 4: GSDP ($21.04 in chips) 
Seat 5: MurMurRu ($25 in chips) 
Seat 6: Grishukps ($12.90 in chips) 
Seat 7: 1Karina1 ($37.59 in chips) 
Seat 8: ChrisCDee ($58.34 in chips) 
Seat 9: chiyuki ($50.19 in chips) 
nice.franki: posts small blind $0.10
Perstenev: posts big blind $0.25
*** HOLE CARDS ***
Dealt to chiyuki [8h Qs]
GSDP: folds 
MurMurRu: folds 
Grishukps: folds 
1Karina1: folds 
ChrisCDee: folds 
chiyuki: folds 
God)Squall: folds 
nice.franki: folds 
Uncalled bet ($0.15) returned to Perstenev
Perstenev collected $0.20 from pot
Perstenev: doesn't show hand 
*** SUMMARY ***
Total pot $0.20 | Rake $0 
Seat 1: God)Squall (button) folded before Flop (didn't bet)
Seat 2: nice.franki (small blind) folded before Flop
Seat 3: Perstenev (big blind) collected ($0.20)
Seat 4: GSDP folded before Flop (didn't bet)
Seat 5: MurMurRu folded before Flop (didn't bet)
Seat 6: Grishukps folded before Flop (didn't bet)
Seat 7: 1Karina1 folded before Flop (didn't bet)
Seat 8: ChrisCDee folded before Flop (didn't bet)
Seat 9: chiyuki folded before Flop (didn't bet)



PokerStars Zoom Hand #84300867990:  Hold'em No Limit ($0.10/$0.25) - 2012/08/05 15:56:42 JST [2012/08/05 2:56:42 ET]
Table 'Whirlpool' 9-max Seat #1 is the button
Seat 1: phate-1up ($40.58 in chips) 
Seat 2: MurMurRu ($25 in chips) 
Seat 3: ChrisCDee ($58.34 in chips) 
Seat 4: Afcawins25 ($15.74 in chips) 
Seat 5: hldtom ($12.50 in chips) 
Seat 6: chiyuki ($50.19 in chips) 
Seat 7: ShockLaMuc ($26 in chips) 
Seat 8: nice.franki ($6.25 in chips) 
Seat 9: 1Karina1 ($25 in chips) 
MurMurRu: posts small blind $0.10
ChrisCDee: posts big blind $0.25
*** HOLE CARDS ***
Dealt to chiyuki [2c 4d]
Afcawins25: raises $0.50 to $0.75
hldtom: folds 
chiyuki: folds 
ShockLaMuc: folds 
nice.franki: folds 
1Karina1: folds 
phate-1up: folds 
MurMurRu: folds 
ChrisCDee: folds 
Uncalled bet ($0.50) returned to Afcawins25
Afcawins25 collected $0.60 from pot
Afcawins25: doesn't show hand 
*** SUMMARY ***
Total pot $0.60 | Rake $0 
Seat 1: phate-1up (button) folded before Flop (didn't bet)
Seat 2: MurMurRu (small blind) folded before Flop
Seat 3: ChrisCDee (big blind) folded before Flop
Seat 4: Afcawins25 collected ($0.60)
Seat 5: hldtom folded before Flop (didn't bet)
Seat 6: chiyuki folded before Flop (didn't bet)
Seat 7: ShockLaMuc folded before Flop (didn't bet)
Seat 8: nice.franki folded before Flop (didn't bet)
Seat 9: 1Karina1 folded before Flop (didn't bet)



PokerStars Zoom Hand #84300866536:  Hold'em No Limit ($0.10/$0.25) - 2012/08/05 15:56:35 JST [2012/08/05 2:56:35 ET]
Table 'Whirlpool' 9-max Seat #1 is the button
Seat 1: westhavenbc ($17.11 in chips) 
Seat 2: GSDP ($21.04 in chips) 
Seat 3: Dionisko ($12.50 in chips) 
Seat 4: ChrisCDee ($58.34 in chips) 
Seat 5: chiyuki ($50.19 in chips) 
Seat 6: God)Squall ($27.24 in chips) 
Seat 7: drunk_bender ($13.21 in chips) 
Seat 8: yvasilik ($25.43 in chips) 
Seat 9: dergeb ($17.84 in chips) 
GSDP: posts small blind $0.10
Dionisko: posts big blind $0.25
*** HOLE CARDS ***
Dealt to chiyuki [8s 4h]
ChrisCDee: folds 
chiyuki: folds 
God)Squall: raises $0.50 to $0.75
drunk_bender: raises $1.25 to $2
yvasilik: folds 
dergeb: folds 
westhavenbc: folds 
GSDP: folds 
Dionisko: folds 
God)Squall: calls $1.25
*** FLOP *** [Ts 3s 7c]
God)Squall: checks 
drunk_bender: bets $2.25
God)Squall: raises $22.99 to $25.24 and is all-in
drunk_bender: calls $8.96 and is all-in
Uncalled bet ($14.03) returned to God)Squall
*** TURN *** [Ts 3s 7c] [5h]
*** RIVER *** [Ts 3s 7c 5h] [Qd]
*** SHOW DOWN ***
God)Squall: shows [Ks Js] (high card King)
drunk_bender: shows [As Ad] (a pair of Aces)
drunk_bender collected $25.57 from pot
*** SUMMARY ***
Total pot $26.77 | Rake $1.20 
Board [Ts 3s 7c 5h Qd]
Seat 1: westhavenbc (button) folded before Flop (didn't bet)
Seat 2: GSDP (small blind) folded before Flop
Seat 3: Dionisko (big blind) folded before Flop
Seat 4: ChrisCDee folded before Flop (didn't bet)
Seat 5: chiyuki folded before Flop (didn't bet)
Seat 6: God)Squall showed [Ks Js] and lost with high card King
Seat 7: drunk_bender showed [As Ad] and won ($25.57) with a pair of Aces
Seat 8: yvasilik folded before Flop (didn't bet)
Seat 9: dergeb folded before Flop (didn't bet)



PokerStars Zoom Hand #84300868669:  Hold'em No Limit ($0.10/$0.25) - 2012/08/05 15:56:45 JST [2012/08/05 2:56:45 ET]
Table 'Whirlpool' 9-max Seat #1 is the button
Seat 1: Silveystryk ($46.14 in chips) 
Seat 2: chiyuki ($50.19 in chips) 
Seat 3: fil740 ($9.99 in chips) 
Seat 4: Spheroff ($7.52 in chips) 
Seat 5: 6nikola9 ($21.20 in chips) 
Seat 6: TorTrade ($21.85 in chips) 
Seat 7: dergeb ($17.84 in chips) 
Seat 8: Fructionar ($35.53 in chips) 
Seat 9: Bahia gyn ($19.27 in chips) 
chiyuki: posts small blind $0.10
fil740: posts big blind $0.25
*** HOLE CARDS ***
Dealt to chiyuki [Ad Ks]
Spheroff: folds 
6nikola9: raises $0.50 to $0.75
TorTrade: folds 
dergeb: calls $0.75
Fructionar: folds 
Bahia gyn: folds 
Silveystryk: calls $0.75
chiyuki: raises $2.25 to $3
fil740: folds 
6nikola9: folds 
dergeb: folds 
Silveystryk: folds 
Uncalled bet ($2.25) returned to chiyuki
chiyuki collected $3.25 from pot
chiyuki: doesn't show hand 
*** SUMMARY ***
Total pot $3.25 | Rake $0 
Seat 1: Silveystryk (button) folded before Flop
Seat 2: chiyuki (small blind) collected ($3.25)
Seat 3: fil740 (big blind) folded before Flop
Seat 4: Spheroff folded before Flop (didn't bet)
Seat 5: 6nikola9 folded before Flop
Seat 6: TorTrade folded before Flop (didn't bet)
Seat 7: dergeb folded before Flop
Seat 8: Fructionar folded before Flop (didn't bet)
Seat 9: Bahia gyn folded before Flop (didn't bet)



PokerStars Zoom Hand #84300876365:  Hold'em No Limit ($0.10/$0.25) - 2012/08/05 15:57:22 JST [2012/08/05 2:57:22 ET]
Table 'Whirlpool' 9-max Seat #1 is the button
Seat 1: Lasutchik ($28.08 in chips) 
Seat 2: Silveystryk ($30.01 in chips) 
Seat 3: KrystalAA ($17.81 in chips) 
Seat 4: chiyuki ($52.69 in chips) 
Seat 5: dergeb ($17.09 in chips) 
Seat 6: Rici47 ($31.62 in chips) 
Seat 7: nice.franki ($12.40 in chips) 
Seat 8: FoRlan77 ($25 in chips) 
Seat 9: ChrisCDee ($30.11 in chips) 
Silveystryk: posts small blind $0.10
KrystalAA: posts big blind $0.25
*** HOLE CARDS ***
Dealt to chiyuki [Kd 8c]
chiyuki: folds 
dergeb: folds 
Rici47: folds 
nice.franki: folds 
FoRlan77: folds 
ChrisCDee: folds 
Lasutchik: raises $0.50 to $0.75
Silveystryk: folds 
KrystalAA: folds 
Uncalled bet ($0.50) returned to Lasutchik
Lasutchik collected $0.60 from pot
Lasutchik: doesn't show hand 
*** SUMMARY ***
Total pot $0.60 | Rake $0 
Seat 1: Lasutchik (button) collected ($0.60)
Seat 2: Silveystryk (small blind) folded before Flop
Seat 3: KrystalAA (big blind) folded before Flop
Seat 4: chiyuki folded before Flop (didn't bet)
Seat 5: dergeb folded before Flop (didn't bet)
Seat 6: Rici47 folded before Flop (didn't bet)
Seat 7: nice.franki folded before Flop (didn't bet)
Seat 8: FoRlan77 folded before Flop (didn't bet)
Seat 9: ChrisCDee folded before Flop (didn't bet)



PokerStars Zoom Hand #84300880527:  Hold'em No Limit ($0.10/$0.25) - 2012/08/05 15:57:41 JST [2012/08/05 2:57:41 ET]
Table 'Whirlpool' 9-max Seat #1 is the button
Seat 1: mjmichi ($36.28 in chips) 
Seat 2: SAILUSI ($32.56 in chips) 
Seat 3: wildy29 ($56.49 in chips) 
Seat 4: crazycrown1 ($4.55 in chips) 
Seat 5: Perstenev ($10.49 in chips) 
Seat 6: GovGus ($62.13 in chips) 
Seat 7: Grishukps ($12.50 in chips) 
Seat 8: ShockLaMuc ($22.90 in chips) 
Seat 9: chiyuki ($52.69 in chips) 
SAILUSI: posts small blind $0.10
wildy29: posts big blind $0.25
*** HOLE CARDS ***
Dealt to chiyuki [9s 5s]
crazycrown1: raises $4.30 to $4.55 and is all-in
Perstenev: folds 
GovGus: folds 
Grishukps: folds 
ShockLaMuc: folds 
chiyuki: folds 
mjmichi: folds 
SAILUSI: folds 
wildy29: folds 
Uncalled bet ($4.30) returned to crazycrown1
crazycrown1 collected $0.60 from pot
crazycrown1: doesn't show hand 
*** SUMMARY ***
Total pot $0.60 | Rake $0 
Seat 1: mjmichi (button) folded before Flop (didn't bet)
Seat 2: SAILUSI (small blind) folded before Flop
Seat 3: wildy29 (big blind) folded before Flop
Seat 4: crazycrown1 collected ($0.60)
Seat 5: Perstenev folded before Flop (didn't bet)
Seat 6: GovGus folded before Flop (didn't bet)
Seat 7: Grishukps folded before Flop (didn't bet)
Seat 8: ShockLaMuc folded before Flop (didn't bet)
Seat 9: chiyuki folded before Flop (didn't bet)



PokerStars Zoom Hand #84300877230:  Hold'em No Limit ($0.10/$0.25) - 2012/08/05 15:57:26 JST [2012/08/05 2:57:26 ET]
Table 'Whirlpool' 9-max Seat #1 is the button
Seat 1: Perstenev ($17.32 in chips) 
Seat 2: phate-1up ($57.58 in chips) 
Seat 3: Grishukps ($12.50 in chips) 
Seat 4: silvno31 ($52.70 in chips) 
Seat 5: jacquelinewu ($28.73 in chips) 
Seat 6: drunk_bender ($25.57 in chips) 
Seat 7: chiyuki ($52.69 in chips) 
Seat 8: nice.franki ($12.40 in chips) 
Seat 9: Silveystryk ($29.91 in chips) 
phate-1up: posts small blind $0.10
Grishukps: posts big blind $0.25
*** HOLE CARDS ***
Dealt to chiyuki [3s 5h]
silvno31: folds 
jacquelinewu: folds 
drunk_bender: folds 
chiyuki: folds 
nice.franki: folds 
Silveystryk: folds 
Perstenev: calls $0.25
phate-1up: folds 
Grishukps: checks 
*** FLOP *** [Kc As Th]
Grishukps: checks 
Perstenev: checks 
*** TURN *** [Kc As Th] [Qd]
Grishukps: checks 
Perstenev: checks 
*** RIVER *** [Kc As Th Qd] [2s]
Grishukps: checks 
Perstenev: checks 
*** SHOW DOWN ***
Grishukps: shows [2d 6s] (a pair of Deuces)
Perstenev: shows [Tc 9c] (a pair of Tens)
Perstenev collected $0.57 from pot
*** SUMMARY ***
Total pot $0.60 | Rake $0.03 
Board [Kc As Th Qd 2s]
Seat 1: Perstenev (button) showed [Tc 9c] and won ($0.57) with a pair of Tens
Seat 2: phate-1up (small blind) folded before Flop
Seat 3: Grishukps (big blind) showed [2d 6s] and lost with a pair of Deuces
Seat 4: silvno31 folded before Flop (didn't bet)
Seat 5: jacquelinewu folded before Flop (didn't bet)
Seat 6: drunk_bender folded before Flop (didn't bet)
Seat 7: chiyuki folded before Flop (didn't bet)
Seat 8: nice.franki folded before Flop (didn't bet)
Seat 9: Silveystryk folded before Flop (didn't bet)



PokerStars Zoom Hand #84300878765:  Hold'em No Limit ($0.10/$0.25) - 2012/08/05 15:57:33 JST [2012/08/05 2:57:33 ET]
Table 'Whirlpool' 9-max Seat #1 is the button
Seat 1: chiyuki ($52.69 in chips) 
Seat 2: azizmimi ($12.25 in chips) 
Seat 3: Faantomace ($31.07 in chips) 
Seat 4: Trip_Krowns ($34.26 in chips) 
Seat 5: ShockLaMuc ($16.70 in chips) 
Seat 6: crazycrown1 ($4.55 in chips) 
Seat 7: FoRlan77 ($25 in chips) 
Seat 8: Serge Claws ($39.92 in chips) 
Seat 9: Grishukps ($12.50 in chips) 
azizmimi: posts small blind $0.10
Faantomace: posts big blind $0.25
*** HOLE CARDS ***
Dealt to chiyuki [Jh 5d]
Trip_Krowns: folds 
ShockLaMuc: folds 
crazycrown1: folds 
FoRlan77: folds 
Serge Claws: folds 
Grishukps: folds 
chiyuki: folds 
azizmimi: raises $0.50 to $0.75
Faantomace: calls $0.50
*** FLOP *** [Kh 3d Kc]
azizmimi: bets $1
Faantomace: folds 
Uncalled bet ($1) returned to azizmimi
azizmimi collected $1.43 from pot
azizmimi: doesn't show hand 
*** SUMMARY ***
Total pot $1.50 | Rake $0.07 
Board [Kh 3d Kc]
Seat 1: chiyuki (button) folded before Flop (didn't bet)
Seat 2: azizmimi (small blind) collected ($1.43)
Seat 3: Faantomace (big blind) folded on the Flop
Seat 4: Trip_Krowns folded before Flop (didn't bet)
Seat 5: ShockLaMuc folded before Flop (didn't bet)
Seat 6: crazycrown1 folded before Flop (didn't bet)
Seat 7: FoRlan77 folded before Flop (didn't bet)
Seat 8: Serge Claws folded before Flop (didn't bet)
Seat 9: Grishukps folded before Flop (didn't bet)



PokerStars Zoom Hand #84300882300:  Hold'em No Limit ($0.10/$0.25) - 2012/08/05 15:57:49 JST [2012/08/05 2:57:49 ET]
Table 'Whirlpool' 9-max Seat #1 is the button
Seat 1: herkko11 ($5.35 in chips) 
Seat 2: kwkim73 ($26.26 in chips) 
Seat 3: chiyuki ($52.69 in chips) 
Seat 4: fwnaf ($24.01 in chips) 
Seat 5: xxx Spb xxx ($27.66 in chips) 
Seat 6: PPP7SSS ($28.08 in chips) 
Seat 7: Alvinpe85 ($95.69 in chips) 
Seat 8: Fructionar ($34.72 in chips) 
Seat 9: Rici47 ($37.50 in chips) 
kwkim73: posts small blind $0.10
chiyuki: posts big blind $0.25
*** HOLE CARDS ***
Dealt to chiyuki [5s 6s]
fwnaf: folds 
xxx Spb xxx: folds 
PPP7SSS: folds 
Alvinpe85: folds 
Fructionar: folds 
Rici47: folds 
herkko11: folds 
kwkim73: folds 
Uncalled bet ($0.15) returned to chiyuki
chiyuki collected $0.20 from pot
chiyuki: doesn't show hand 
*** SUMMARY ***
Total pot $0.20 | Rake $0 
Seat 1: herkko11 (button) folded before Flop (didn't bet)
Seat 2: kwkim73 (small blind) folded before Flop
Seat 3: chiyuki (big blind) collected ($0.20)
Seat 4: fwnaf folded before Flop (didn't bet)
Seat 5: xxx Spb xxx folded before Flop (didn't bet)
Seat 6: PPP7SSS folded before Flop (didn't bet)
Seat 7: Alvinpe85 folded before Flop (didn't bet)
Seat 8: Fructionar folded before Flop (didn't bet)
Seat 9: Rici47 folded before Flop (didn't bet)



PokerStars Zoom Hand #84300884847:  Hold'em No Limit ($0.10/$0.25) - 2012/08/05 15:58:01 JST [2012/08/05 2:58:01 ET]
Table 'Whirlpool' 9-max Seat #1 is the button
Seat 1: 6nikola9 ($19.70 in chips) 
Seat 2: soul_5577 ($40.67 in chips) 
Seat 3: Serge Claws ($28.30 in chips) 
Seat 4: kesstukas25 ($31.16 in chips) 
Seat 5: westhavenbc ($18.47 in chips) 
Seat 6: KrystalAA ($17.46 in chips) 
Seat 7: Dejacob ($43.09 in chips) 
Seat 8: chiyuki ($52.79 in chips) 
Seat 9: Kasperlmusik ($25 in chips) 
soul_5577: posts small blind $0.10
Serge Claws: posts big blind $0.25
*** HOLE CARDS ***
Dealt to chiyuki [6d 7d]
kesstukas25: folds 
westhavenbc: folds 
KrystalAA: folds 
Dejacob: folds 
chiyuki: folds 
Kasperlmusik: folds 
6nikola9: folds 
soul_5577: folds 
Uncalled bet ($0.15) returned to Serge Claws
Serge Claws collected $0.20 from pot
Serge Claws: doesn't show hand 
*** SUMMARY ***
Total pot $0.20 | Rake $0 
Seat 1: 6nikola9 (button) folded before Flop (didn't bet)
Seat 2: soul_5577 (small blind) folded before Flop
Seat 3: Serge Claws (big blind) collected ($0.20)
Seat 4: kesstukas25 folded before Flop (didn't bet)
Seat 5: westhavenbc folded before Flop (didn't bet)
Seat 6: KrystalAA folded before Flop (didn't bet)
Seat 7: Dejacob folded before Flop (didn't bet)
Seat 8: chiyuki folded before Flop (didn't bet)
Seat 9: Kasperlmusik folded before Flop (didn't bet)



PokerStars Zoom Hand #84300885919:  Hold'em No Limit ($0.10/$0.25) - 2012/08/05 15:58:06 JST [2012/08/05 2:58:06 ET]
Table 'Whirlpool' 9-max Seat #1 is the button
Seat 1: rey2040 ($13.65 in chips) 
Seat 2: DrunkTyphoon ($37.41 in chips) 
Seat 3: Grishukps ($12.55 in chips) 
Seat 4: chiyuki ($52.79 in chips) 
Seat 5: hldtom ($42.67 in chips) 
Seat 6: ChrisCDee ($56.33 in chips) 
Seat 7: tribunpdm ($67.97 in chips) 
Seat 8: Bahia gyn ($19.27 in chips) 
Seat 9: masterkoolb ($18.66 in chips) 
DrunkTyphoon: posts small blind $0.10
Grishukps: posts big blind $0.25
*** HOLE CARDS ***
Dealt to chiyuki [As 6c]
chiyuki: folds 
hldtom: folds 
ChrisCDee: folds 
tribunpdm: folds 
Bahia gyn: folds 
masterkoolb: folds 
rey2040: folds 
DrunkTyphoon: folds 
Uncalled bet ($0.15) returned to Grishukps
Grishukps collected $0.20 from pot
Grishukps: doesn't show hand 
*** SUMMARY ***
Total pot $0.20 | Rake $0 
Seat 1: rey2040 (button) folded before Flop (didn't bet)
Seat 2: DrunkTyphoon (small blind) folded before Flop
Seat 3: Grishukps (big blind) collected ($0.20)
Seat 4: chiyuki folded before Flop (didn't bet)
Seat 5: hldtom folded before Flop (didn't bet)
Seat 6: ChrisCDee folded before Flop (didn't bet)
Seat 7: tribunpdm folded before Flop (didn't bet)
Seat 8: Bahia gyn folded before Flop (didn't bet)
Seat 9: masterkoolb folded before Flop (didn't bet)



PokerStars Zoom Hand #84300887266:  Hold'em No Limit ($0.10/$0.25) - 2012/08/05 15:58:12 JST [2012/08/05 2:58:12 ET]
Table 'Whirlpool' 9-max Seat #1 is the button
Seat 1: DrunkTyphoon ($37.31 in chips) 
Seat 2: Perstenev ($14.79 in chips) 
Seat 3: nice.franki ($7.78 in chips) 
Seat 4: tribunpdm ($67.97 in chips) 
Seat 5: mjmichi ($36.28 in chips) 
Seat 6: chiyuki ($52.79 in chips) 
Seat 7: Bahia gyn ($19.27 in chips) 
Seat 8: boboshooter ($24.52 in chips) 
Seat 9: Kasperlmusik ($28.50 in chips) 
Perstenev: posts small blind $0.10
nice.franki: posts big blind $0.25
*** HOLE CARDS ***
Dealt to chiyuki [Jh 8h]
tribunpdm: folds 
mjmichi: folds 
chiyuki: folds 
Bahia gyn: folds 
boboshooter: raises $0.50 to $0.75
Kasperlmusik: folds 
DrunkTyphoon: folds 
Perstenev: folds 
nice.franki: folds 
Uncalled bet ($0.50) returned to boboshooter
boboshooter collected $0.60 from pot
boboshooter: doesn't show hand 
*** SUMMARY ***
Total pot $0.60 | Rake $0 
Seat 1: DrunkTyphoon (button) folded before Flop (didn't bet)
Seat 2: Perstenev (small blind) folded before Flop
Seat 3: nice.franki (big blind) folded before Flop
Seat 4: tribunpdm folded before Flop (didn't bet)
Seat 5: mjmichi folded before Flop (didn't bet)
Seat 6: chiyuki folded before Flop (didn't bet)
Seat 7: Bahia gyn folded before Flop (didn't bet)
Seat 8: boboshooter collected ($0.60)
Seat 9: Kasperlmusik folded before Flop (didn't bet)



PokerStars Zoom Hand #84300888556:  Hold'em No Limit ($0.10/$0.25) - 2012/08/05 15:58:19 JST [2012/08/05 2:58:19 ET]
Table 'Whirlpool' 9-max Seat #1 is the button
Seat 1: drunk_bender ($24.95 in chips) 
Seat 2: nice.franki ($5.38 in chips) 
Seat 3: kesstukas25 ($31.16 in chips) 
Seat 4: 1Karina1 ($37.49 in chips) 
Seat 5: pandaaaaaa ($15.89 in chips) 
Seat 6: Alvinpe85 ($40.81 in chips) 
Seat 7: kwkim73 ($26.16 in chips) 
Seat 8: chiyuki ($52.79 in chips) 
Seat 9: snejokCoxx ($9.23 in chips) 
nice.franki: posts small blind $0.10
kesstukas25: posts big blind $0.25
*** HOLE CARDS ***
Dealt to chiyuki [7s 5h]
1Karina1: folds 
pandaaaaaa: folds 
Alvinpe85: folds 
kwkim73: folds 
chiyuki: folds 
snejokCoxx: folds 
drunk_bender: raises $0.50 to $0.75
nice.franki: folds 
kesstukas25: folds 
Uncalled bet ($0.50) returned to drunk_bender
drunk_bender collected $0.60 from pot
drunk_bender: doesn't show hand 
*** SUMMARY ***
Total pot $0.60 | Rake $0 
Seat 1: drunk_bender (button) collected ($0.60)
Seat 2: nice.franki (small blind) folded before Flop
Seat 3: kesstukas25 (big blind) folded before Flop
Seat 4: 1Karina1 folded before Flop (didn't bet)
Seat 5: pandaaaaaa folded before Flop (didn't bet)
Seat 6: Alvinpe85 folded before Flop (didn't bet)
Seat 7: kwkim73 folded before Flop (didn't bet)
Seat 8: chiyuki folded before Flop (didn't bet)
Seat 9: snejokCoxx folded before Flop (didn't bet)



PokerStars Zoom Hand #84300890074:  Hold'em No Limit ($0.10/$0.25) - 2012/08/05 15:58:26 JST [2012/08/05 2:58:26 ET]
Table 'Whirlpool' 9-max Seat #1 is the button
Seat 1: Grishukps ($12.65 in chips) 
Seat 2: chiyuki ($52.79 in chips) 
Seat 3: deepakmbh ($25 in chips) 
Seat 4: Alvinpe85 ($95.59 in chips) 
Seat 5: gatorswamp ($17.05 in chips) 
Seat 6: nice.franki ($5.28 in chips) 
Seat 7: mjmichi ($36.28 in chips) 
Seat 8: GovGus ($25 in chips) 
Seat 9: ChrisCDee ($56.23 in chips) 
chiyuki: posts small blind $0.10
deepakmbh: posts big blind $0.25
*** HOLE CARDS ***
Dealt to chiyuki [3d 5s]
Alvinpe85: folds 
gatorswamp: folds 
nice.franki: folds 
mjmichi: folds 
GovGus: folds 
ChrisCDee: folds 
Grishukps: raises $0.37 to $0.62
chiyuki: folds 
deepakmbh: folds 
Uncalled bet ($0.37) returned to Grishukps
Grishukps collected $0.60 from pot
Grishukps: doesn't show hand 
*** SUMMARY ***
Total pot $0.60 | Rake $0 
Seat 1: Grishukps (button) collected ($0.60)
Seat 2: chiyuki (small blind) folded before Flop
Seat 3: deepakmbh (big blind) folded before Flop
Seat 4: Alvinpe85 folded before Flop (didn't bet)
Seat 5: gatorswamp folded before Flop (didn't bet)
Seat 6: nice.franki folded before Flop (didn't bet)
Seat 7: mjmichi folded before Flop (didn't bet)
Seat 8: GovGus folded before Flop (didn't bet)
Seat 9: ChrisCDee folded before Flop (didn't bet)



PokerStars Zoom Hand #84300892449:  Hold'em No Limit ($0.10/$0.25) - 2012/08/05 15:58:37 JST [2012/08/05 2:58:37 ET]
Table 'Whirlpool' 9-max Seat #1 is the button
Seat 1: chiyuki ($52.69 in chips) 
Seat 2: Rici47 ($30.77 in chips) 
Seat 3: TorTrade ($21.85 in chips) 
Seat 4: Perstenev ($17.29 in chips) 
Seat 5: NoWurriz ($18.88 in chips) 
Seat 6: phate-1up ($38.98 in chips) 
Seat 7: snejokCoxx ($9.23 in chips) 
Seat 8: AAAKK777 ($15.50 in chips) 
Seat 9: JhonnyP1979 ($16.85 in chips) 
Rici47: posts small blind $0.10
TorTrade: posts big blind $0.25
*** HOLE CARDS ***
Dealt to chiyuki [9c Ac]
Perstenev: folds 
NoWurriz: folds 
phate-1up: folds 
snejokCoxx: folds 
AAAKK777: raises $0.25 to $0.50
JhonnyP1979: folds 
chiyuki: folds 
Rici47: folds 
TorTrade: folds 
Uncalled bet ($0.25) returned to AAAKK777
AAAKK777 collected $0.60 from pot
AAAKK777: doesn't show hand 
*** SUMMARY ***
Total pot $0.60 | Rake $0 
Seat 1: chiyuki (button) folded before Flop (didn't bet)
Seat 2: Rici47 (small blind) folded before Flop
Seat 3: TorTrade (big blind) folded before Flop
Seat 4: Perstenev folded before Flop (didn't bet)
Seat 5: NoWurriz folded before Flop (didn't bet)
Seat 6: phate-1up folded before Flop (didn't bet)
Seat 7: snejokCoxx folded before Flop (didn't bet)
Seat 8: AAAKK777 collected ($0.60)
Seat 9: JhonnyP1979 folded before Flop (didn't bet)



PokerStars Zoom Hand #84300896425:  Hold'em No Limit ($0.10/$0.25) - 2012/08/05 15:58:55 JST [2012/08/05 2:58:55 ET]
Table 'Whirlpool' 9-max Seat #1 is the button
Seat 1: hldtom ($25 in chips) 
Seat 2: Femali54 ($28.03 in chips) 
Seat 3: chiyuki ($52.69 in chips) 
Seat 4: ShockLaMuc ($22.65 in chips) 
Seat 5: drunk_bender ($25.30 in chips) 
Seat 6: kesstukas25 ($30.81 in chips) 
Seat 7: Grishukps ($13 in chips) 
Seat 8: herkko11 ($5 in chips) 
Seat 9: Limoilou ($27.76 in chips) 
Femali54: posts small blind $0.10
chiyuki: posts big blind $0.25
*** HOLE CARDS ***
Dealt to chiyuki [4c 7s]
ShockLaMuc: folds 
drunk_bender: folds 
kesstukas25: folds 
Grishukps: folds 
herkko11: raises $0.25 to $0.50
Limoilou: folds 
hldtom: folds 
Femali54: folds 
chiyuki: folds 
Uncalled bet ($0.25) returned to herkko11
herkko11 collected $0.60 from pot
herkko11: doesn't show hand 
*** SUMMARY ***
Total pot $0.60 | Rake $0 
Seat 1: hldtom (button) folded before Flop (didn't bet)
Seat 2: Femali54 (small blind) folded before Flop
Seat 3: chiyuki (big blind) folded before Flop
Seat 4: ShockLaMuc folded before Flop (didn't bet)
Seat 5: drunk_bender folded before Flop (didn't bet)
Seat 6: kesstukas25 folded before Flop (didn't bet)
Seat 7: Grishukps folded before Flop (didn't bet)
Seat 8: herkko11 collected ($0.60)
Seat 9: Limoilou folded before Flop (didn't bet)



PokerStars Zoom Hand #84300900161:  Hold'em No Limit ($0.10/$0.25) - 2012/08/05 15:59:12 JST [2012/08/05 2:59:12 ET]
Table 'Whirlpool' 9-max Seat #1 is the button
Seat 1: GovGus ($34.49 in chips) 
Seat 2: Dejacob ($26.45 in chips) 
Seat 3: schoof 2 ($28.71 in chips) 
Seat 4: Femali54 ($27.93 in chips) 
Seat 5: kkbruins0408 ($9.84 in chips) 
Seat 6: xxASSO124xx ($11.40 in chips) 
Seat 7: chiyuki ($52.44 in chips) 
Seat 8: 1Karina1 ($37.24 in chips) 
Seat 9: GSDP ($38.68 in chips) 
Dejacob: posts small blind $0.10
schoof 2: posts big blind $0.25
*** HOLE CARDS ***
Dealt to chiyuki [Qc Ac]
Femali54: raises $0.50 to $0.75
kkbruins0408: folds 
xxASSO124xx: folds 
chiyuki: raises $1.50 to $2.25
1Karina1: folds 
GSDP: folds 
GovGus: folds 
Dejacob: folds 
schoof 2: calls $2
Femali54: folds 
*** FLOP *** [7c 9h Td]
schoof 2: bets $2.75
chiyuki: calls $2.75
*** TURN *** [7c 9h Td] [8d]
schoof 2: bets $5.75
chiyuki: folds 
Uncalled bet ($5.75) returned to schoof 2
schoof 2 collected $10.36 from pot
schoof 2: doesn't show hand 
*** SUMMARY ***
Total pot $10.85 | Rake $0.49 
Board [7c 9h Td 8d]
Seat 1: GovGus (button) folded before Flop (didn't bet)
Seat 2: Dejacob (small blind) folded before Flop
Seat 3: schoof 2 (big blind) collected ($10.36)
Seat 4: Femali54 folded before Flop
Seat 5: kkbruins0408 folded before Flop (didn't bet)
Seat 6: xxASSO124xx folded before Flop (didn't bet)
Seat 7: chiyuki folded on the Turn
Seat 8: 1Karina1 folded before Flop (didn't bet)
Seat 9: GSDP folded before Flop (didn't bet)



PokerStars Zoom Hand #84300916517:  Hold'em No Limit ($0.10/$0.25) - 2012/08/05 16:00:27 JST [2012/08/05 3:00:27 ET]
Table 'Whirlpool' 9-max Seat #1 is the button
Seat 1: jvds114 ($66.01 in chips) 
Seat 2: Dejacob ($25.89 in chips) 
Seat 3: ViTiV2010 ($12.50 in chips) 
Seat 4: ShockLaMuc ($15.20 in chips) 
Seat 5: Perstenev ($16.19 in chips) 
Seat 6: chiyuki ($47.44 in chips) 
Seat 7: Rici47 ($27.40 in chips) 
Seat 8: Rilko1975 ($24.32 in chips) 
Seat 9: nice.franki ($7.08 in chips) 
Dejacob: posts small blind $0.10
ViTiV2010: posts big blind $0.25
*** HOLE CARDS ***
Dealt to chiyuki [Td 6h]
ShockLaMuc: folds 
Perstenev: folds 
chiyuki: folds 
Rici47: folds 
Rilko1975: folds 
nice.franki: folds 
jvds114: folds 
Dejacob: folds 
Uncalled bet ($0.15) returned to ViTiV2010
ViTiV2010 collected $0.20 from pot
ViTiV2010: doesn't show hand 
*** SUMMARY ***
Total pot $0.20 | Rake $0 
Seat 1: jvds114 (button) folded before Flop (didn't bet)
Seat 2: Dejacob (small blind) folded before Flop
Seat 3: ViTiV2010 (big blind) collected ($0.20)
Seat 4: ShockLaMuc folded before Flop (didn't bet)
Seat 5: Perstenev folded before Flop (didn't bet)
Seat 6: chiyuki folded before Flop (didn't bet)
Seat 7: Rici47 folded before Flop (didn't bet)
Seat 8: Rilko1975 folded before Flop (didn't bet)
Seat 9: nice.franki folded before Flop (didn't bet)



PokerStars Zoom Hand #84300917228:  Hold'em No Limit ($0.10/$0.25) - 2012/08/05 16:00:30 JST [2012/08/05 3:00:30 ET]
Table 'Whirlpool' 9-max Seat #1 is the button
Seat 1: Rici47 ($27.40 in chips) 
Seat 2: chiyuki ($47.44 in chips) 
Seat 3: seula i ($72.47 in chips) 
Seat 4: Grishukps ($12.50 in chips) 
Seat 5: Perstenev ($16.19 in chips) 
Seat 6: silvno31 ($55.99 in chips) 
Seat 7: hldtom ($25 in chips) 
Seat 8: westhavenbc ($18.89 in chips) 
Seat 9: jvds114 ($66.01 in chips) 
chiyuki: posts small blind $0.10
seula i: posts big blind $0.25
*** HOLE CARDS ***
Dealt to chiyuki [3d 5h]
Grishukps: folds 
Perstenev: folds 
silvno31: folds 
hldtom: folds 
westhavenbc: folds 
jvds114: folds 
Rici47: raises $0.75 to $1
chiyuki: folds 
seula i: folds 
Uncalled bet ($0.75) returned to Rici47
Rici47 collected $0.60 from pot
Rici47: doesn't show hand 
*** SUMMARY ***
Total pot $0.60 | Rake $0 
Seat 1: Rici47 (button) collected ($0.60)
Seat 2: chiyuki (small blind) folded before Flop
Seat 3: seula i (big blind) folded before Flop
Seat 4: Grishukps folded before Flop (didn't bet)
Seat 5: Perstenev folded before Flop (didn't bet)
Seat 6: silvno31 folded before Flop (didn't bet)
Seat 7: hldtom folded before Flop (didn't bet)
Seat 8: westhavenbc folded before Flop (didn't bet)
Seat 9: jvds114 folded before Flop (didn't bet)



PokerStars Zoom Hand #84300915828:  Hold'em No Limit ($0.10/$0.25) - 2012/08/05 16:00:24 JST [2012/08/05 3:00:24 ET]
Table 'Whirlpool' 9-max Seat #1 is the button
Seat 1: dergeb ($7.71 in chips) 
Seat 2: Grishukps ($12.85 in chips) 
Seat 3: 4plankton ($13.48 in chips) 
Seat 4: chiyuki ($47.44 in chips) 
Seat 5: Dan Royal ($32.38 in chips) 
Seat 6: Perstenev ($16.19 in chips) 
Seat 7: jvds114 ($66.01 in chips) 
Seat 8: romanian c4 ($13.10 in chips) 
Seat 9: westhavenbc ($18.01 in chips) 
Grishukps: posts small blind $0.10
4plankton: posts big blind $0.25
*** HOLE CARDS ***
Dealt to chiyuki [2d 5c]
chiyuki: folds 
Dan Royal: folds 
Perstenev: folds 
jvds114: folds 
romanian c4: raises $0.25 to $0.50
westhavenbc: calls $0.50
dergeb: folds 
Grishukps: folds 
4plankton: folds 
*** FLOP *** [2h 7d Kh]
romanian c4: checks 
westhavenbc: bets $0.25
romanian c4: calls $0.25
*** TURN *** [2h 7d Kh] [Ac]
romanian c4: checks 
westhavenbc: checks 
*** RIVER *** [2h 7d Kh Ac] [4c]
romanian c4: bets $0.25
westhavenbc: calls $0.25
*** SHOW DOWN ***
romanian c4: shows [Ah 8c] (a pair of Aces)
westhavenbc: mucks hand 
romanian c4 collected $2.24 from pot
*** SUMMARY ***
Total pot $2.35 | Rake $0.11 
Board [2h 7d Kh Ac 4c]
Seat 1: dergeb (button) folded before Flop (didn't bet)
Seat 2: Grishukps (small blind) folded before Flop
Seat 3: 4plankton (big blind) folded before Flop
Seat 4: chiyuki folded before Flop (didn't bet)
Seat 5: Dan Royal folded before Flop (didn't bet)
Seat 6: Perstenev folded before Flop (didn't bet)
Seat 7: jvds114 folded before Flop (didn't bet)
Seat 8: romanian c4 showed [Ah 8c] and won ($2.24) with a pair of Aces
Seat 9: westhavenbc mucked [Kd Qd]



PokerStars Zoom Hand #84300918342:  Hold'em No Limit ($0.10/$0.25) - 2012/08/05 16:00:35 JST [2012/08/05 3:00:35 ET]
Table 'Whirlpool' 9-max Seat #1 is the button
Seat 1: Kasperlmusik ($28.52 in chips) 
Seat 2: ViTiV2010 ($12.60 in chips) 
Seat 3: MurMurRu ($25 in chips) 
Seat 4: snejokCoxx ($17.68 in chips) 
Seat 5: CrittHunter ($24.90 in chips) 
Seat 6: GovGus ($58.83 in chips) 
Seat 7: silvno31 ($55.99 in chips) 
Seat 8: 1Karina1 ($33.12 in chips) 
Seat 9: chiyuki ($47.34 in chips) 
ViTiV2010: posts small blind $0.10
MurMurRu: posts big blind $0.25
*** HOLE CARDS ***
Dealt to chiyuki [As 6h]
snejokCoxx: folds 
CrittHunter: folds 
GovGus: folds 
silvno31: folds 
1Karina1: folds 
chiyuki: raises $0.50 to $0.75
Kasperlmusik: folds 
ViTiV2010: folds 
MurMurRu: folds 
Uncalled bet ($0.50) returned to chiyuki
chiyuki collected $0.60 from pot
chiyuki: doesn't show hand 
*** SUMMARY ***
Total pot $0.60 | Rake $0 
Seat 1: Kasperlmusik (button) folded before Flop (didn't bet)
Seat 2: ViTiV2010 (small blind) folded before Flop
Seat 3: MurMurRu (big blind) folded before Flop
Seat 4: snejokCoxx folded before Flop (didn't bet)
Seat 5: CrittHunter folded before Flop (didn't bet)
Seat 6: GovGus folded before Flop (didn't bet)
Seat 7: silvno31 folded before Flop (didn't bet)
Seat 8: 1Karina1 folded before Flop (didn't bet)
Seat 9: chiyuki collected ($0.60)



PokerStars Zoom Hand #84300915127:  Hold'em No Limit ($0.10/$0.25) - 2012/08/05 16:00:21 JST [2012/08/05 3:00:21 ET]
Table 'Whirlpool' 9-max Seat #1 is the button
Seat 1: PPP7SSS ($27.75 in chips) 
Seat 2: jacquelinewu ($25 in chips) 
Seat 3: mjmichi ($81.11 in chips) 
Seat 4: masterkoolb ($12.50 in chips) 
Seat 5: chiyuki ($47.44 in chips) 
Seat 6: Dejacob ($44.91 in chips) 
Seat 7: opie62 ($25.16 in chips) 
Seat 8: Femali54 ($26.93 in chips) 
Seat 9: slapshot2011 ($30.22 in chips) 
jacquelinewu: posts small blind $0.10
mjmichi: posts big blind $0.25
*** HOLE CARDS ***
Dealt to chiyuki [Qd 9d]
masterkoolb: folds 
chiyuki: folds 
Dejacob: folds 
opie62: folds 
Femali54: folds 
slapshot2011: folds 
PPP7SSS: folds 
jacquelinewu: raises $0.50 to $0.75
mjmichi: calls $0.50
*** FLOP *** [5c 8h Jd]
jacquelinewu: checks 
mjmichi: bets $1
jacquelinewu: raises $1.75 to $2.75
mjmichi: folds 
Uncalled bet ($1.75) returned to jacquelinewu
jacquelinewu collected $3.34 from pot
jacquelinewu: doesn't show hand 
*** SUMMARY ***
Total pot $3.50 | Rake $0.16 
Board [5c 8h Jd]
Seat 1: PPP7SSS (button) folded before Flop (didn't bet)
Seat 2: jacquelinewu (small blind) collected ($3.34)
Seat 3: mjmichi (big blind) folded on the Flop
Seat 4: masterkoolb folded before Flop (didn't bet)
Seat 5: chiyuki folded before Flop (didn't bet)
Seat 6: Dejacob folded before Flop (didn't bet)
Seat 7: opie62 folded before Flop (didn't bet)
Seat 8: Femali54 folded before Flop (didn't bet)
Seat 9: slapshot2011 folded before Flop (didn't bet)



PokerStars Zoom Hand #84300927485:  Hold'em No Limit ($0.10/$0.25) - 2012/08/05 16:01:14 JST [2012/08/05 3:01:14 ET]
Table 'Whirlpool' 9-max Seat #1 is the button
Seat 1: Blue-GumBum ($12 in chips) 
Seat 2: GovGus ($42.01 in chips) 
Seat 3: ChrisCDee ($55.23 in chips) 
Seat 4: Kasperlmusik ($31.79 in chips) 
Seat 5: pawn909 ($22.71 in chips) 
Seat 6: 6nikola9 ($7.71 in chips) 
Seat 7: HighDuka ($19.48 in chips) 
Seat 8: Fructionar ($44.24 in chips) 
Seat 9: chiyuki ($47.69 in chips) 
GovGus: posts small blind $0.10
ChrisCDee: posts big blind $0.25
*** HOLE CARDS ***
Dealt to chiyuki [7h 2c]
Kasperlmusik: raises $0.50 to $0.75
pawn909: folds 
6nikola9: folds 
HighDuka: folds 
Fructionar: folds 
chiyuki: folds 
Blue-GumBum: folds 
GovGus: folds 
ChrisCDee: folds 
Uncalled bet ($0.50) returned to Kasperlmusik
Kasperlmusik collected $0.60 from pot
Kasperlmusik: doesn't show hand 
*** SUMMARY ***
Total pot $0.60 | Rake $0 
Seat 1: Blue-GumBum (button) folded before Flop (didn't bet)
Seat 2: GovGus (small blind) folded before Flop
Seat 3: ChrisCDee (big blind) folded before Flop
Seat 4: Kasperlmusik collected ($0.60)
Seat 5: pawn909 folded before Flop (didn't bet)
Seat 6: 6nikola9 folded before Flop (didn't bet)
Seat 7: HighDuka folded before Flop (didn't bet)
Seat 8: Fructionar folded before Flop (didn't bet)
Seat 9: chiyuki folded before Flop (didn't bet)



PokerStars Zoom Hand #84300926511:  Hold'em No Limit ($0.10/$0.25) - 2012/08/05 16:01:10 JST [2012/08/05 3:01:10 ET]
Table 'Whirlpool' 9-max Seat #1 is the button
Seat 1: fil740 ($11.79 in chips) 
Seat 2: KsuhaLove ($11.39 in chips) 
Seat 3: Cripple86 ($25 in chips) 
Seat 4: KrystalAA ($11.86 in chips) 
Seat 5: andy0815r ($34.38 in chips) 
Seat 6: pawn909 ($22.71 in chips) 
Seat 7: snejokCoxx ($12.50 in chips) 
Seat 8: chiyuki ($47.69 in chips) 
Seat 9: Grishukps ($12.85 in chips) 
KsuhaLove: posts small blind $0.10
Cripple86: posts big blind $0.25
*** HOLE CARDS ***
Dealt to chiyuki [Qd 6h]
KrystalAA: folds 
andy0815r: folds 
pawn909: folds 
snejokCoxx: folds 
chiyuki: folds 
Grishukps: folds 
fil740: raises $0.25 to $0.50
KsuhaLove: folds 
Cripple86: folds 
Uncalled bet ($0.25) returned to fil740
fil740 collected $0.60 from pot
fil740: doesn't show hand 
*** SUMMARY ***
Total pot $0.60 | Rake $0 
Seat 1: fil740 (button) collected ($0.60)
Seat 2: KsuhaLove (small blind) folded before Flop
Seat 3: Cripple86 (big blind) folded before Flop
Seat 4: KrystalAA folded before Flop (didn't bet)
Seat 5: andy0815r folded before Flop (didn't bet)
Seat 6: pawn909 folded before Flop (didn't bet)
Seat 7: snejokCoxx folded before Flop (didn't bet)
Seat 8: chiyuki folded before Flop (didn't bet)
Seat 9: Grishukps folded before Flop (didn't bet)



PokerStars Zoom Hand #84300928246:  Hold'em No Limit ($0.10/$0.25) - 2012/08/05 16:01:17 JST [2012/08/05 3:01:17 ET]
Table 'Whirlpool' 9-max Seat #1 is the button
Seat 1: Trip_Krowns ($26.37 in chips) 
Seat 2: Limoilou ($28.76 in chips) 
Seat 3: KrystalAA ($11.86 in chips) 
Seat 4: jacquelinewu ($31.04 in chips) 
Seat 5: chiyuki ($47.69 in chips) 
Seat 6: Dejacob ($25.95 in chips) 
Seat 7: xxASSO124xx ($11.05 in chips) 
Seat 8: DrunkTyphoon ($36.09 in chips) 
Seat 9: pawn909 ($22.71 in chips) 
Limoilou: posts small blind $0.10
KrystalAA: posts big blind $0.25
*** HOLE CARDS ***
Dealt to chiyuki [6d 2c]
jacquelinewu: raises $0.50 to $0.75
chiyuki: folds 
Dejacob: folds 
xxASSO124xx: folds 
DrunkTyphoon: folds 
pawn909: folds 
Trip_Krowns: folds 
Limoilou: folds 
KrystalAA: folds 
Uncalled bet ($0.50) returned to jacquelinewu
jacquelinewu collected $0.60 from pot
jacquelinewu: doesn't show hand 
*** SUMMARY ***
Total pot $0.60 | Rake $0 
Seat 1: Trip_Krowns (button) folded before Flop (didn't bet)
Seat 2: Limoilou (small blind) folded before Flop
Seat 3: KrystalAA (big blind) folded before Flop
Seat 4: jacquelinewu collected ($0.60)
Seat 5: chiyuki folded before Flop (didn't bet)
Seat 6: Dejacob folded before Flop (didn't bet)
Seat 7: xxASSO124xx folded before Flop (didn't bet)
Seat 8: DrunkTyphoon folded before Flop (didn't bet)
Seat 9: pawn909 folded before Flop (didn't bet)



PokerStars Zoom Hand #84300929631:  Hold'em No Limit ($0.10/$0.25) - 2012/08/05 16:01:22 JST [2012/08/05 3:01:22 ET]
Table 'Whirlpool' 9-max Seat #1 is the button
Seat 1: Dan Royal ($32.88 in chips) 
Seat 2: kkbruins0408 ($15.40 in chips) 
Seat 3: Femali54 ($27.18 in chips) 
Seat 4: chiyuki ($47.69 in chips) 
Seat 5: Alvinpe85 ($47.28 in chips) 
Seat 6: Rici47 ($30.67 in chips) 
Seat 7: Trip_Krowns ($26.37 in chips) 
Seat 8: MurMurRu ($25 in chips) 
Seat 9: Jene4kaBest ($12.42 in chips) 
kkbruins0408: posts small blind $0.10
Femali54: posts big blind $0.25
*** HOLE CARDS ***
Dealt to chiyuki [Qh 3c]
chiyuki: folds 
Alvinpe85: folds 
Rici47: folds 
Trip_Krowns: raises $0.50 to $0.75
MurMurRu: folds 
Jene4kaBest: calls $0.75
Dan Royal: folds 
kkbruins0408: folds 
Femali54: folds 
*** FLOP *** [8s 9s 7s]
Trip_Krowns: bets $1.25
Jene4kaBest: folds 
Uncalled bet ($1.25) returned to Trip_Krowns
Trip_Krowns collected $1.77 from pot
Trip_Krowns: doesn't show hand 
*** SUMMARY ***
Total pot $1.85 | Rake $0.08 
Board [8s 9s 7s]
Seat 1: Dan Royal (button) folded before Flop (didn't bet)
Seat 2: kkbruins0408 (small blind) folded before Flop
Seat 3: Femali54 (big blind) folded before Flop
Seat 4: chiyuki folded before Flop (didn't bet)
Seat 5: Alvinpe85 folded before Flop (didn't bet)
Seat 6: Rici47 folded before Flop (didn't bet)
Seat 7: Trip_Krowns collected ($1.77)
Seat 8: MurMurRu folded before Flop (didn't bet)
Seat 9: Jene4kaBest folded on the Flop



PokerStars Zoom Hand #84300925277:  Hold'em No Limit ($0.10/$0.25) - 2012/08/05 16:01:05 JST [2012/08/05 3:01:05 ET]
Table 'Whirlpool' 9-max Seat #1 is the button
Seat 1: chiyuki ($47.69 in chips) 
Seat 2: ShockLaMuc ($14.95 in chips) 
Seat 3: Spheroff ($24.90 in chips) 
Seat 4: masterkoolb ($19.02 in chips) 
Seat 5: Faantomace ($40.30 in chips) 
Seat 6: pandaaaaaa ($15.44 in chips) 
Seat 7: romanian c4 ($14.34 in chips) 
Seat 8: pawn909 ($22.71 in chips) 
Seat 9: MurMurRu ($25 in chips) 
ShockLaMuc: posts small blind $0.10
Spheroff: posts big blind $0.25
*** HOLE CARDS ***
Dealt to chiyuki [5h 6d]
masterkoolb: folds 
Faantomace: raises $0.50 to $0.75
pandaaaaaa: raises $3.25 to $4
romanian c4: folds 
pawn909: folds 
MurMurRu: folds 
chiyuki: folds 
ShockLaMuc: folds 
Spheroff: folds 
Faantomace: calls $3.25
*** FLOP *** [Kh 9d Td]
Faantomace: checks 
pandaaaaaa: bets $6
Faantomace: folds 
Uncalled bet ($6) returned to pandaaaaaa
pandaaaaaa collected $7.97 from pot
pandaaaaaa: doesn't show hand 
*** SUMMARY ***
Total pot $8.35 | Rake $0.38 
Board [Kh 9d Td]
Seat 1: chiyuki (button) folded before Flop (didn't bet)
Seat 2: ShockLaMuc (small blind) folded before Flop
Seat 3: Spheroff (big blind) folded before Flop
Seat 4: masterkoolb folded before Flop (didn't bet)
Seat 5: Faantomace folded on the Flop
Seat 6: pandaaaaaa collected ($7.97)
Seat 7: romanian c4 folded before Flop (didn't bet)
Seat 8: pawn909 folded before Flop (didn't bet)
Seat 9: MurMurRu folded before Flop (didn't bet)



PokerStars Zoom Hand #84300930600:  Hold'em No Limit ($0.10/$0.25) - 2012/08/05 16:01:26 JST [2012/08/05 3:01:26 ET]
Table 'Whirlpool' 9-max Seat #1 is the button
Seat 1: Kasperlmusik ($32.14 in chips) 
Seat 2: INSP!RON ($33 in chips) 
Seat 3: chiyuki ($47.69 in chips) 
Seat 4: Alvinpe85 ($47.28 in chips) 
Seat 5: kwkim73 ($35.60 in chips) 
Seat 6: Rilko1975 ($23.72 in chips) 
Seat 7: ShockLaMuc ($21.30 in chips) 
Seat 8: Dan Royal ($32.88 in chips) 
Seat 9: Serge Claws ($65.69 in chips) 
INSP!RON: posts small blind $0.10
chiyuki: posts big blind $0.25
*** HOLE CARDS ***
Dealt to chiyuki [3c 8h]
Alvinpe85: raises $0.50 to $0.75
kwkim73: calls $0.75
Rilko1975: folds 
ShockLaMuc: raises $2.52 to $3.27
Dan Royal: folds 
Serge Claws: folds 
Kasperlmusik: folds 
INSP!RON: folds 
chiyuki: folds 
Alvinpe85: folds 
kwkim73: folds 
Uncalled bet ($2.52) returned to ShockLaMuc
ShockLaMuc collected $2.60 from pot
ShockLaMuc: doesn't show hand 
*** SUMMARY ***
Total pot $2.60 | Rake $0 
Seat 1: Kasperlmusik (button) folded before Flop (didn't bet)
Seat 2: INSP!RON (small blind) folded before Flop
Seat 3: chiyuki (big blind) folded before Flop
Seat 4: Alvinpe85 folded before Flop
Seat 5: kwkim73 folded before Flop
Seat 6: Rilko1975 folded before Flop (didn't bet)
Seat 7: ShockLaMuc collected ($2.60)
Seat 8: Dan Royal folded before Flop (didn't bet)
Seat 9: Serge Claws folded before Flop (didn't bet)



PokerStars Zoom Hand #84300933065:  Hold'em No Limit ($0.10/$0.25) - 2012/08/05 16:01:36 JST [2012/08/05 3:01:36 ET]
Table 'Whirlpool' 9-max Seat #1 is the button
Seat 1: phate-1up ($65.91 in chips) 
Seat 2: romanian c4 ($14.34 in chips) 
Seat 3: jvds114 ($63.26 in chips) 
Seat 4: Perstenev ($8.68 in chips) 
Seat 5: INSP!RON ($32.90 in chips) 
Seat 6: boboshooter ($27.82 in chips) 
Seat 7: chiyuki ($47.44 in chips) 
Seat 8: GovGus ($37.14 in chips) 
Seat 9: TorTrade ($21.82 in chips) 
romanian c4: posts small blind $0.10
jvds114: posts big blind $0.25
*** HOLE CARDS ***
Dealt to chiyuki [Kd 9s]
Perstenev: raises $0.50 to $0.75
INSP!RON: folds 
boboshooter: folds 
chiyuki: folds 
GovGus: folds 
TorTrade: folds 
phate-1up: folds 
romanian c4: folds 
jvds114: folds 
Uncalled bet ($0.50) returned to Perstenev
Perstenev collected $0.60 from pot
Perstenev: doesn't show hand 
*** SUMMARY ***
Total pot $0.60 | Rake $0 
Seat 1: phate-1up (button) folded before Flop (didn't bet)
Seat 2: romanian c4 (small blind) folded before Flop
Seat 3: jvds114 (big blind) folded before Flop
Seat 4: Perstenev collected ($0.60)
Seat 5: INSP!RON folded before Flop (didn't bet)
Seat 6: boboshooter folded before Flop (didn't bet)
Seat 7: chiyuki folded before Flop (didn't bet)
Seat 8: GovGus folded before Flop (didn't bet)
Seat 9: TorTrade folded before Flop (didn't bet)



PokerStars Zoom Hand #84300934844:  Hold'em No Limit ($0.10/$0.25) - 2012/08/05 16:01:43 JST [2012/08/05 3:01:43 ET]
Table 'Whirlpool' 9-max Seat #1 is the button
Seat 1: INSP!RON ($32.90 in chips) 
Seat 2: chiyuki ($47.44 in chips) 
Seat 3: Limoilou ($28.66 in chips) 
Seat 4: FoRlan77 ($25 in chips) 
Seat 5: dergeb ($8.38 in chips) 
Seat 6: Perstenev ($7.04 in chips) 
Seat 7: boboshooter ($27.82 in chips) 
Seat 8: Grishukps ($12.50 in chips) 
Seat 9: Blue-GumBum ($11.75 in chips) 
chiyuki: posts small blind $0.10
Limoilou: posts big blind $0.25
*** HOLE CARDS ***
Dealt to chiyuki [6c 8c]
FoRlan77: folds 
dergeb: folds 
Perstenev: folds 
boboshooter: raises $0.25 to $0.50
Grishukps: folds 
Blue-GumBum: calls $0.50
INSP!RON: folds 
chiyuki: calls $0.40
Limoilou: folds 
*** FLOP *** [3d 3h 4s]
chiyuki: checks 
boboshooter: bets $0.75
Blue-GumBum: calls $0.75
chiyuki: folds 
*** TURN *** [3d 3h 4s] [Kc]
boboshooter: bets $1
Blue-GumBum: folds 
Uncalled bet ($1) returned to boboshooter
boboshooter collected $3.10 from pot
boboshooter: doesn't show hand 
*** SUMMARY ***
Total pot $3.25 | Rake $0.15 
Board [3d 3h 4s Kc]
Seat 1: INSP!RON (button) folded before Flop (didn't bet)
Seat 2: chiyuki (small blind) folded on the Flop
Seat 3: Limoilou (big blind) folded before Flop
Seat 4: FoRlan77 folded before Flop (didn't bet)
Seat 5: dergeb folded before Flop (didn't bet)
Seat 6: Perstenev folded before Flop (didn't bet)
Seat 7: boboshooter collected ($3.10)
Seat 8: Grishukps folded before Flop (didn't bet)
Seat 9: Blue-GumBum folded on the Turn



PokerStars Zoom Hand #84300942381:  Hold'em No Limit ($0.10/$0.25) - 2012/08/05 16:02:14 JST [2012/08/05 3:02:14 ET]
Table 'Whirlpool' 9-max Seat #1 is the button
Seat 1: 1Karina1 ($54.80 in chips) 
Seat 2: Rilko1975 ($23.82 in chips) 
Seat 3: Alvinpe85 ($46.53 in chips) 
Seat 4: chiyuki ($46.94 in chips) 
Seat 5: Jene4kaBest ($15.86 in chips) 
Seat 6: kwkim73 ($34.10 in chips) 
Seat 7: ViTiV2010 ($12.50 in chips) 
Seat 8: Perstenev ($9.03 in chips) 
Seat 9: INSP!RON ($35.16 in chips) 
Rilko1975: posts small blind $0.10
Alvinpe85: posts big blind $0.25
*** HOLE CARDS ***
Dealt to chiyuki [2c 5s]
chiyuki: folds 
Jene4kaBest: raises $0.50 to $0.75
kwkim73: folds 
ViTiV2010: folds 
Perstenev: folds 
INSP!RON: folds 
1Karina1: calls $0.75
Rilko1975: folds 
Alvinpe85: folds 
*** FLOP *** [Tc 4c 8d]
Jene4kaBest: bets $0.70
1Karina1: folds 
Uncalled bet ($0.70) returned to Jene4kaBest
Jene4kaBest collected $1.77 from pot
Jene4kaBest: doesn't show hand 
*** SUMMARY ***
Total pot $1.85 | Rake $0.08 
Board [Tc 4c 8d]
Seat 1: 1Karina1 (button) folded on the Flop
Seat 2: Rilko1975 (small blind) folded before Flop
Seat 3: Alvinpe85 (big blind) folded before Flop
Seat 4: chiyuki folded before Flop (didn't bet)
Seat 5: Jene4kaBest collected ($1.77)
Seat 6: kwkim73 folded before Flop (didn't bet)
Seat 7: ViTiV2010 folded before Flop (didn't bet)
Seat 8: Perstenev folded before Flop (didn't bet)
Seat 9: INSP!RON folded before Flop (didn't bet)



PokerStars Zoom Hand #84300934131:  Hold'em No Limit ($0.10/$0.25) - 2012/08/05 16:01:40 JST [2012/08/05 3:01:40 ET]
Table 'Whirlpool' 9-max Seat #1 is the button
Seat 1: DrunkTyphoon ($35.99 in chips) 
Seat 2: pawn909 ($22.46 in chips) 
Seat 3: masterkoolb ($20.03 in chips) 
Seat 4: chiyuki ($47.44 in chips) 
Seat 5: soul_5577 ($41.11 in chips) 
Seat 6: slapshot2011 ($28.62 in chips) 
Seat 7: 4ydo yogurt ($64.29 in chips) 
Seat 8: Afcawins25 ($9.94 in chips) 
Seat 9: ViTiV2010 ($12.50 in chips) 
pawn909: posts small blind $0.10
masterkoolb: posts big blind $0.25
*** HOLE CARDS ***
Dealt to chiyuki [Tc 3h]
chiyuki: folds 
soul_5577: folds 
slapshot2011: calls $0.25
4ydo yogurt: raises $0.25 to $0.50
Afcawins25: folds 
ViTiV2010: folds 
DrunkTyphoon: folds 
pawn909: calls $0.40
masterkoolb: folds 
slapshot2011: calls $0.25
*** FLOP *** [Th 7h 6d]
pawn909: checks 
slapshot2011: checks 
4ydo yogurt: bets $0.83
pawn909: calls $0.83
slapshot2011: folds 
*** TURN *** [Th 7h 6d] [8c]
pawn909: checks 
4ydo yogurt: bets $0.90
pawn909: calls $0.90
*** RIVER *** [Th 7h 6d 8c] [6c]
pawn909: checks 
4ydo yogurt: bets $1.20
pawn909: folds 
Uncalled bet ($1.20) returned to 4ydo yogurt
4ydo yogurt collected $4.98 from pot
4ydo yogurt: doesn't show hand 
*** SUMMARY ***
Total pot $5.21 | Rake $0.23 
Board [Th 7h 6d 8c 6c]
Seat 1: DrunkTyphoon (button) folded before Flop (didn't bet)
Seat 2: pawn909 (small blind) folded on the River
Seat 3: masterkoolb (big blind) folded before Flop
Seat 4: chiyuki folded before Flop (didn't bet)
Seat 5: soul_5577 folded before Flop (didn't bet)
Seat 6: slapshot2011 folded on the Flop
Seat 7: 4ydo yogurt collected ($4.98)
Seat 8: Afcawins25 folded before Flop (didn't bet)
Seat 9: ViTiV2010 folded before Flop (didn't bet)



PokerStars Zoom Hand #84300941351:  Hold'em No Limit ($0.10/$0.25) - 2012/08/05 16:02:10 JST [2012/08/05 3:02:10 ET]
Table 'Whirlpool' 9-max Seat #1 is the button
Seat 1: Rici47 ($25.40 in chips) 
Seat 2: xxASSO124xx ($11.15 in chips) 
Seat 3: FoRlan77 ($25 in chips) 
Seat 4: phate-1up ($65.91 in chips) 
Seat 5: INSP!RON ($35.16 in chips) 
Seat 6: chiyuki ($46.94 in chips) 
Seat 7: drunk_bender ($18.80 in chips) 
Seat 8: Roglus ($12.30 in chips) 
Seat 9: Serge Claws ($25 in chips) 
xxASSO124xx: posts small blind $0.10
FoRlan77: posts big blind $0.25
*** HOLE CARDS ***
Dealt to chiyuki [9c 5d]
phate-1up: folds 
INSP!RON: folds 
chiyuki: folds 
drunk_bender: folds 
Roglus: folds 
Serge Claws: raises $0.50 to $0.75
Rici47: folds 
xxASSO124xx: raises $0.50 to $1.25
FoRlan77: folds 
Serge Claws: calls $0.50
*** FLOP *** [4s Td Kh]
xxASSO124xx: checks 
Serge Claws: checks 
*** TURN *** [4s Td Kh] [Ks]
xxASSO124xx: bets $0.50
Serge Claws: calls $0.50
*** RIVER *** [4s Td Kh Ks] [Kd]
xxASSO124xx: bets $1
Serge Claws: calls $1
*** SHOW DOWN ***
xxASSO124xx: shows [Qs Ah] (three of a kind, Kings)
Serge Claws: shows [Tc Qc] (a full house, Kings full of Tens)
Serge Claws collected $5.49 from pot
*** SUMMARY ***
Total pot $5.75 | Rake $0.26 
Board [4s Td Kh Ks Kd]
Seat 1: Rici47 (button) folded before Flop (didn't bet)
Seat 2: xxASSO124xx (small blind) showed [Qs Ah] and lost with three of a kind, Kings
Seat 3: FoRlan77 (big blind) folded before Flop
Seat 4: phate-1up folded before Flop (didn't bet)
Seat 5: INSP!RON folded before Flop (didn't bet)
Seat 6: chiyuki folded before Flop (didn't bet)
Seat 7: drunk_bender folded before Flop (didn't bet)
Seat 8: Roglus folded before Flop (didn't bet)
Seat 9: Serge Claws showed [Tc Qc] and won ($5.49) with a full house, Kings full of Tens



PokerStars Zoom Hand #84300949041:  Hold'em No Limit ($0.10/$0.25) - 2012/08/05 16:02:40 JST [2012/08/05 3:02:40 ET]
Table 'Whirlpool' 9-max Seat #1 is the button
Seat 1: scaredsare ($31.19 in chips) 
Seat 2: kesstukas25 ($30.93 in chips) 
Seat 3: Cripple86 ($25 in chips) 
Seat 4: phate-1up ($50.76 in chips) 
Seat 5: seula i ($72.31 in chips) 
Seat 6: Dejacob ($29.09 in chips) 
Seat 7: chiyuki ($46.94 in chips) 
Seat 8: Faantomace ($36.30 in chips) 
Seat 9: MurMurRu ($26.39 in chips) 
kesstukas25: posts small blind $0.10
Cripple86: posts big blind $0.25
*** HOLE CARDS ***
Dealt to chiyuki [3d Ah]
phate-1up: folds 
seula i: folds 
Dejacob: folds 
chiyuki: folds 
Faantomace: folds 
MurMurRu: raises $0.42 to $0.67
scaredsare: folds 
kesstukas25: folds 
Cripple86: folds 
Uncalled bet ($0.42) returned to MurMurRu
MurMurRu collected $0.60 from pot
MurMurRu: doesn't show hand 
*** SUMMARY ***
Total pot $0.60 | Rake $0 
Seat 1: scaredsare (button) folded before Flop (didn't bet)
Seat 2: kesstukas25 (small blind) folded before Flop
Seat 3: Cripple86 (big blind) folded before Flop
Seat 4: phate-1up folded before Flop (didn't bet)
Seat 5: seula i folded before Flop (didn't bet)
Seat 6: Dejacob folded before Flop (didn't bet)
Seat 7: chiyuki folded before Flop (didn't bet)
Seat 8: Faantomace folded before Flop (didn't bet)
Seat 9: MurMurRu collected ($0.60)



PokerStars Zoom Hand #84300945563:  Hold'em No Limit ($0.10/$0.25) - 2012/08/05 16:02:26 JST [2012/08/05 3:02:26 ET]
Table 'Whirlpool' 9-max Seat #1 is the button
Seat 1: Kasperlmusik ($25 in chips) 
Seat 2: HighDuka ($20.53 in chips) 
Seat 3: jacquelinewu ($30.64 in chips) 
Seat 4: Dionisko ($33.07 in chips) 
Seat 5: Perstenev ($9.03 in chips) 
Seat 6: seula i ($44.88 in chips) 
Seat 7: kwkim73 ($34.10 in chips) 
Seat 8: chiyuki ($46.94 in chips) 
Seat 9: Nerkit ($15.35 in chips) 
HighDuka: posts small blind $0.10
jacquelinewu: posts big blind $0.25
*** HOLE CARDS ***
Dealt to chiyuki [9c Jc]
Dionisko: folds 
Perstenev: folds 
seula i: folds 
kwkim73: folds 
chiyuki: folds 
Nerkit: folds 
Kasperlmusik: raises $0.50 to $0.75
HighDuka: calls $0.65
jacquelinewu: folds 
*** FLOP *** [5h 8c As]
HighDuka: bets $1
Kasperlmusik: calls $1
*** TURN *** [5h 8c As] [4d]
HighDuka: bets $1.50
Kasperlmusik: calls $1.50
*** RIVER *** [5h 8c As 4d] [Td]
HighDuka: bets $2.25
Kasperlmusik: calls $2.25
*** SHOW DOWN ***
HighDuka: shows [6s Ks] (high card Ace)
Kasperlmusik: shows [Ah 2h] (a pair of Aces)
Kasperlmusik collected $10.74 from pot
*** SUMMARY ***
Total pot $11.25 | Rake $0.51 
Board [5h 8c As 4d Td]
Seat 1: Kasperlmusik (button) showed [Ah 2h] and won ($10.74) with a pair of Aces
Seat 2: HighDuka (small blind) showed [6s Ks] and lost with high card Ace
Seat 3: jacquelinewu (big blind) folded before Flop
Seat 4: Dionisko folded before Flop (didn't bet)
Seat 5: Perstenev folded before Flop (didn't bet)
Seat 6: seula i folded before Flop (didn't bet)
Seat 7: kwkim73 folded before Flop (didn't bet)
Seat 8: chiyuki folded before Flop (didn't bet)
Seat 9: Nerkit folded before Flop (didn't bet)



PokerStars Zoom Hand #84300943754:  Hold'em No Limit ($0.10/$0.25) - 2012/08/05 16:02:19 JST [2012/08/05 3:02:19 ET]
Table 'Whirlpool' 9-max Seat #1 is the button
Seat 1: chiyuki ($46.94 in chips) 
Seat 2: nice.franki ($12.25 in chips) 
Seat 3: ShockLaMuc ($25 in chips) 
Seat 4: INSP!RON ($35.16 in chips) 
Seat 5: snejokCoxx ($12.25 in chips) 
Seat 6: jacquelinewu ($77.09 in chips) 
Seat 7: Cripple86 ($25 in chips) 
Seat 8: HighDuka ($20.53 in chips) 
Seat 9: Serge Claws ($65.44 in chips) 
nice.franki: posts small blind $0.10
ShockLaMuc: posts big blind $0.25
*** HOLE CARDS ***
Dealt to chiyuki [8d Kh]
INSP!RON: raises $0.50 to $0.75
snejokCoxx: calls $0.75
jacquelinewu: folds 
Cripple86: folds 
HighDuka: folds 
Serge Claws: calls $0.75
chiyuki: folds 
nice.franki: folds 
ShockLaMuc: calls $0.50
*** FLOP *** [2h 3h 4h]
ShockLaMuc: checks 
INSP!RON: checks 
snejokCoxx: checks 
Serge Claws: checks 
*** TURN *** [2h 3h 4h] [9c]
ShockLaMuc: checks 
INSP!RON: checks 
snejokCoxx: checks 
Serge Claws: bets $1.75
ShockLaMuc: folds 
INSP!RON: folds 
snejokCoxx: folds 
Uncalled bet ($1.75) returned to Serge Claws
Serge Claws collected $2.96 from pot
Serge Claws: doesn't show hand 
*** SUMMARY ***
Total pot $3.10 | Rake $0.14 
Board [2h 3h 4h 9c]
Seat 1: chiyuki (button) folded before Flop (didn't bet)
Seat 2: nice.franki (small blind) folded before Flop
Seat 3: ShockLaMuc (big blind) folded on the Turn
Seat 4: INSP!RON folded on the Turn
Seat 5: snejokCoxx folded on the Turn
Seat 6: jacquelinewu folded before Flop (didn't bet)
Seat 7: Cripple86 folded before Flop (didn't bet)
Seat 8: HighDuka folded before Flop (didn't bet)
Seat 9: Serge Claws collected ($2.96)



PokerStars Zoom Hand #84300950057:  Hold'em No Limit ($0.10/$0.25) - 2012/08/05 16:02:44 JST [2012/08/05 3:02:44 ET]
Table 'Whirlpool' 9-max Seat #1 is the button
Seat 1: Limoilou ($28.31 in chips) 
Seat 2: kwkim73 ($34.10 in chips) 
Seat 3: chiyuki ($46.94 in chips) 
Seat 4: Dejacob ($29.09 in chips) 
Seat 5: 6nikola9 ($7.19 in chips) 
Seat 6: Serge Claws ($41.95 in chips) 
Seat 7: 1Karina1 ($25 in chips) 
Seat 8: 4plankton ($11.38 in chips) 
Seat 9: Nerkit ($12.15 in chips) 
kwkim73: posts small blind $0.10
chiyuki: posts big blind $0.25
*** HOLE CARDS ***
Dealt to chiyuki [6d As]
Dejacob: folds 
6nikola9: folds 
Serge Claws: folds 
1Karina1: folds 
4plankton: folds 
Nerkit: folds 
Limoilou: folds 
kwkim73: raises $0.50 to $0.75
chiyuki: folds 
Uncalled bet ($0.50) returned to kwkim73
kwkim73 collected $0.50 from pot
kwkim73: doesn't show hand 
*** SUMMARY ***
Total pot $0.50 | Rake $0 
Seat 1: Limoilou (button) folded before Flop (didn't bet)
Seat 2: kwkim73 (small blind) collected ($0.50)
Seat 3: chiyuki (big blind) folded before Flop
Seat 4: Dejacob folded before Flop (didn't bet)
Seat 5: 6nikola9 folded before Flop (didn't bet)
Seat 6: Serge Claws folded before Flop (didn't bet)
Seat 7: 1Karina1 folded before Flop (didn't bet)
Seat 8: 4plankton folded before Flop (didn't bet)
Seat 9: Nerkit folded before Flop (didn't bet)



PokerStars Zoom Hand #84300963292:  Hold'em No Limit ($0.10/$0.25) - 2012/08/05 16:03:35 JST [2012/08/05 3:03:35 ET]
Table 'Whirlpool' 9-max Seat #1 is the button
Seat 1: Femali54 ($23.33 in chips) 
Seat 2: munky3 ($39.27 in chips) 
Seat 3: pawn909 ($20.58 in chips) 
Seat 4: poorpoor6551 ($10.15 in chips) 
Seat 5: Cripple86 ($25.10 in chips) 
Seat 6: kesstukas25 ($30.08 in chips) 
Seat 7: ivan130 ($23.75 in chips) 
Seat 8: nice.franki ($11.80 in chips) 
Seat 9: chiyuki ($46.59 in chips) 
munky3: posts small blind $0.10
pawn909: posts big blind $0.25
*** HOLE CARDS ***
Dealt to chiyuki [6d 2c]
poorpoor6551: calls $0.25
Cripple86: folds 
kesstukas25: folds 
ivan130: folds 
nice.franki: folds 
chiyuki: folds 
Femali54: folds 
munky3: folds 
pawn909: checks 
*** FLOP *** [Ac 6s Kc]
pawn909: checks 
poorpoor6551: bets $0.50
pawn909: folds 
Uncalled bet ($0.50) returned to poorpoor6551
poorpoor6551 collected $0.57 from pot
poorpoor6551: doesn't show hand 
*** SUMMARY ***
Total pot $0.60 | Rake $0.03 
Board [Ac 6s Kc]
Seat 1: Femali54 (button) folded before Flop (didn't bet)
Seat 2: munky3 (small blind) folded before Flop
Seat 3: pawn909 (big blind) folded on the Flop
Seat 4: poorpoor6551 collected ($0.57)
Seat 5: Cripple86 folded before Flop (didn't bet)
Seat 6: kesstukas25 folded before Flop (didn't bet)
Seat 7: ivan130 folded before Flop (didn't bet)
Seat 8: nice.franki folded before Flop (didn't bet)
Seat 9: chiyuki folded before Flop (didn't bet)



PokerStars Zoom Hand #84300972909:  Hold'em No Limit ($0.10/$0.25) - 2012/08/05 16:04:12 JST [2012/08/05 3:04:12 ET]
Table 'Whirlpool' 9-max Seat #1 is the button
Seat 1: Dejacob ($28.84 in chips) 
Seat 2: ShockLaMuc ($26.30 in chips) 
Seat 3: nice.franki ($13.65 in chips) 
Seat 4: Cripple86 ($26.49 in chips) 
Seat 5: scaredsare ($16.87 in chips) 
Seat 6: chiyuki ($46.59 in chips) 
Seat 7: Grishukps ($12.50 in chips) 
Seat 8: snejokCoxx ($12.15 in chips) 
Seat 9: Serge Claws ($27.39 in chips) 
ShockLaMuc: posts small blind $0.10
nice.franki: posts big blind $0.25
*** HOLE CARDS ***
Dealt to chiyuki [6h Th]
Cripple86: folds 
scaredsare: folds 
chiyuki: folds 
Grishukps: folds 
snejokCoxx: folds 
Serge Claws: raises $0.50 to $0.75
Dejacob: folds 
ShockLaMuc: folds 
nice.franki: folds 
Uncalled bet ($0.50) returned to Serge Claws
Serge Claws collected $0.60 from pot
Serge Claws: doesn't show hand 
*** SUMMARY ***
Total pot $0.60 | Rake $0 
Seat 1: Dejacob (button) folded before Flop (didn't bet)
Seat 2: ShockLaMuc (small blind) folded before Flop
Seat 3: nice.franki (big blind) folded before Flop
Seat 4: Cripple86 folded before Flop (didn't bet)
Seat 5: scaredsare folded before Flop (didn't bet)
Seat 6: chiyuki folded before Flop (didn't bet)
Seat 7: Grishukps folded before Flop (didn't bet)
Seat 8: snejokCoxx folded before Flop (didn't bet)
Seat 9: Serge Claws collected ($0.60)



PokerStars Zoom Hand #84300964339:  Hold'em No Limit ($0.10/$0.25) - 2012/08/05 16:03:39 JST [2012/08/05 3:03:39 ET]
Table 'Whirlpool' 9-max Seat #1 is the button
Seat 1: chiyuki ($46.59 in chips) 
Seat 2: kwkim73 ($26.02 in chips) 
Seat 3: INSP!RON ($32.87 in chips) 
Seat 4: CrittHunter ($23.71 in chips) 
Seat 5: ivan130 ($23.75 in chips) 
Seat 6: Ellen1947 ($31.81 in chips) 
Seat 7: Grishukps ($12.85 in chips) 
Seat 8: MurMurRu ($25 in chips) 
Seat 9: 1Karina1 ($53.95 in chips) 
kwkim73: posts small blind $0.10
INSP!RON: posts big blind $0.25
*** HOLE CARDS ***
Dealt to chiyuki [6s Ah]
CrittHunter: folds 
ivan130: folds 
Ellen1947: folds 
Grishukps: folds 
MurMurRu: folds 
1Karina1: folds 
chiyuki: folds 
kwkim73: folds 
Uncalled bet ($0.15) returned to INSP!RON
INSP!RON collected $0.20 from pot
INSP!RON: doesn't show hand 
*** SUMMARY ***
Total pot $0.20 | Rake $0 
Seat 1: chiyuki (button) folded before Flop (didn't bet)
Seat 2: kwkim73 (small blind) folded before Flop
Seat 3: INSP!RON (big blind) collected ($0.20)
Seat 4: CrittHunter folded before Flop (didn't bet)
Seat 5: ivan130 folded before Flop (didn't bet)
Seat 6: Ellen1947 folded before Flop (didn't bet)
Seat 7: Grishukps folded before Flop (didn't bet)
Seat 8: MurMurRu folded before Flop (didn't bet)
Seat 9: 1Karina1 folded before Flop (didn't bet)



PokerStars Zoom Hand #84300975261:  Hold'em No Limit ($0.10/$0.25) - 2012/08/05 16:04:22 JST [2012/08/05 3:04:22 ET]
Table 'Whirlpool' 9-max Seat #1 is the button
Seat 1: Vall179 ($24.65 in chips) 
Seat 2: GovGus ($35.47 in chips) 
Seat 3: andy0815r ($32.35 in chips) 
Seat 4: Grishukps ($12.50 in chips) 
Seat 5: chiyuki ($46.59 in chips) 
Seat 6: Nerkit ($15 in chips) 
Seat 7: codan23 ($12.15 in chips) 
Seat 8: slapshot2011 ($32.90 in chips) 
Seat 9: nice.franki ($6.57 in chips) 
GovGus: posts small blind $0.10
andy0815r: posts big blind $0.25
*** HOLE CARDS ***
Dealt to chiyuki [Ac Qs]
Grishukps: folds 
chiyuki: raises $0.50 to $0.75
Nerkit: folds 
codan23: folds 
slapshot2011: folds 
nice.franki: folds 
Vall179: folds 
GovGus: folds 
andy0815r: folds 
Uncalled bet ($0.50) returned to chiyuki
chiyuki collected $0.60 from pot
chiyuki: doesn't show hand 
*** SUMMARY ***
Total pot $0.60 | Rake $0 
Seat 1: Vall179 (button) folded before Flop (didn't bet)
Seat 2: GovGus (small blind) folded before Flop
Seat 3: andy0815r (big blind) folded before Flop
Seat 4: Grishukps folded before Flop (didn't bet)
Seat 5: chiyuki collected ($0.60)
Seat 6: Nerkit folded before Flop (didn't bet)
Seat 7: codan23 folded before Flop (didn't bet)
Seat 8: slapshot2011 folded before Flop (didn't bet)
Seat 9: nice.franki folded before Flop (didn't bet)



PokerStars Zoom Hand #84300974475:  Hold'em No Limit ($0.10/$0.25) - 2012/08/05 16:04:18 JST [2012/08/05 3:04:18 ET]
Table 'Whirlpool' 9-max Seat #1 is the button
Seat 1: ShockLaMuc ($26.20 in chips) 
Seat 2: pawn909 ($20.23 in chips) 
Seat 3: seula i ($44.53 in chips) 
Seat 4: Perstenev ($11.66 in chips) 
Seat 5: chiyuki ($46.59 in chips) 
Seat 6: kesstukas25 ($14.04 in chips) 
Seat 7: hldtom ($28.48 in chips) 
Seat 8: snejokCoxx ($12.50 in chips) 
Seat 9: fil740 ($33.78 in chips) 
pawn909: posts small blind $0.10
seula i: posts big blind $0.25
*** HOLE CARDS ***
Dealt to chiyuki [Qd 6d]
Perstenev: folds 
chiyuki: folds 
kesstukas25: folds 
hldtom: folds 
snejokCoxx: folds 
fil740: folds 
ShockLaMuc: folds 
pawn909: raises $0.50 to $0.75
seula i: folds 
Uncalled bet ($0.50) returned to pawn909
pawn909 collected $0.50 from pot
pawn909: doesn't show hand 
*** SUMMARY ***
Total pot $0.50 | Rake $0 
Seat 1: ShockLaMuc (button) folded before Flop (didn't bet)
Seat 2: pawn909 (small blind) collected ($0.50)
Seat 3: seula i (big blind) folded before Flop
Seat 4: Perstenev folded before Flop (didn't bet)
Seat 5: chiyuki folded before Flop (didn't bet)
Seat 6: kesstukas25 folded before Flop (didn't bet)
Seat 7: hldtom folded before Flop (didn't bet)
Seat 8: snejokCoxx folded before Flop (didn't bet)
Seat 9: fil740 folded before Flop (didn't bet)



PokerStars Zoom Hand #84300961131:  Hold'em No Limit ($0.10/$0.25) - 2012/08/05 16:03:27 JST [2012/08/05 3:03:27 ET]
Table 'Whirlpool' 9-max Seat #1 is the button
Seat 1: Dejacob ($25.95 in chips) 
Seat 2: chiyuki ($46.69 in chips) 
Seat 3: Nerkit ($12.50 in chips) 
Seat 4: Rici47 ($27.09 in chips) 
Seat 5: Rilko1975 ($20.32 in chips) 
Seat 6: phate-1up ($67.28 in chips) 
Seat 7: GovGus ($55.38 in chips) 
Seat 8: Grishukps ($12.50 in chips) 
Seat 9: CrittHunter ($23.71 in chips) 
chiyuki: posts small blind $0.10
Nerkit: posts big blind $0.25
*** HOLE CARDS ***
Dealt to chiyuki [Ks 2h]
Rici47: folds 
Rilko1975: raises $0.25 to $0.50
phate-1up: raises $1.75 to $2.25
GovGus: calls $2.25
Grishukps: folds 
CrittHunter: folds 
Dejacob: calls $2.25
chiyuki: folds 
Nerkit: folds 
Rilko1975: calls $1.75
*** FLOP *** [7h Ts 7s]
Rilko1975: checks 
phate-1up: bets $4
GovGus: folds 
Dejacob: raises $6.25 to $10.25
Rilko1975: folds 
phate-1up: folds 
Uncalled bet ($6.25) returned to Dejacob
Dejacob collected $16.57 from pot
Dejacob: doesn't show hand 
*** SUMMARY ***
Total pot $17.35 | Rake $0.78 
Board [7h Ts 7s]
Seat 1: Dejacob (button) collected ($16.57)
Seat 2: chiyuki (small blind) folded before Flop
Seat 3: Nerkit (big blind) folded before Flop
Seat 4: Rici47 folded before Flop (didn't bet)
Seat 5: Rilko1975 folded on the Flop
Seat 6: phate-1up folded on the Flop
Seat 7: GovGus folded on the Flop
Seat 8: Grishukps folded before Flop (didn't bet)
Seat 9: CrittHunter folded before Flop (didn't bet)



PokerStars Zoom Hand #84300981157:  Hold'em No Limit ($0.10/$0.25) - 2012/08/05 16:04:43 JST [2012/08/05 3:04:43 ET]
Table 'Whirlpool' 9-max Seat #1 is the button
Seat 1: Nerkit ($12.25 in chips) 
Seat 2: PPP7SSS ($51.04 in chips) 
Seat 3: Kasperlmusik ($32.52 in chips) 
Seat 4: pandaaaaaa ($18.46 in chips) 
Seat 5: chiyuki ($46.94 in chips) 
Seat 6: roksmokndonk ($25.99 in chips) 
Seat 7: ShockLaMuc ($26.20 in chips) 
Seat 8: azizmimi ($31.80 in chips) 
Seat 9: andy0815r ($32 in chips) 
PPP7SSS: posts small blind $0.10
Kasperlmusik: posts big blind $0.25
*** HOLE CARDS ***
Dealt to chiyuki [Ks 8s]
pandaaaaaa: folds 
chiyuki: folds 
roksmokndonk: folds 
ShockLaMuc: folds 
azizmimi: folds 
andy0815r: folds 
Nerkit: folds 
PPP7SSS: raises $1 to $1.25
Kasperlmusik: calls $1
*** FLOP *** [2h Qh 9d]
PPP7SSS: bets $2.75
Kasperlmusik: calls $2.75
*** TURN *** [2h Qh 9d] [5c]
PPP7SSS: bets $47.04 and is all-in
Kasperlmusik: folds 
Uncalled bet ($47.04) returned to PPP7SSS
PPP7SSS collected $7.64 from pot
PPP7SSS: doesn't show hand 
*** SUMMARY ***
Total pot $8 | Rake $0.36 
Board [2h Qh 9d 5c]
Seat 1: Nerkit (button) folded before Flop (didn't bet)
Seat 2: PPP7SSS (small blind) collected ($7.64)
Seat 3: Kasperlmusik (big blind) folded on the Turn
Seat 4: pandaaaaaa folded before Flop (didn't bet)
Seat 5: chiyuki folded before Flop (didn't bet)
Seat 6: roksmokndonk folded before Flop (didn't bet)
Seat 7: ShockLaMuc folded before Flop (didn't bet)
Seat 8: azizmimi folded before Flop (didn't bet)
Seat 9: andy0815r folded before Flop (didn't bet)



PokerStars Zoom Hand #84300991345:  Hold'em No Limit ($0.10/$0.25) - 2012/08/05 16:05:21 JST [2012/08/05 3:05:21 ET]
Table 'Whirlpool' 9-max Seat #1 is the button
Seat 1: Lasutchik ($29.19 in chips) 
Seat 2: DrunkTyphoon ($36.95 in chips) 
Seat 3: phate-1up ($59.64 in chips) 
Seat 4: Ellen1947 ($33.02 in chips) 
Seat 5: ShockLaMuc ($21.95 in chips) 
Seat 6: pawn909 ($20.23 in chips) 
Seat 7: Rici47 ($39.07 in chips) 
Seat 8: chiyuki ($46.69 in chips) 
Seat 9: Dan Royal ($29.89 in chips) 
DrunkTyphoon: posts small blind $0.10
phate-1up: posts big blind $0.25
*** HOLE CARDS ***
Dealt to chiyuki [2h 3h]
Ellen1947: folds 
ShockLaMuc: folds 
pawn909: folds 
Rici47: folds 
chiyuki: folds 
Dan Royal: folds 
Lasutchik: folds 
DrunkTyphoon: raises $0.50 to $0.75
phate-1up: folds 
Uncalled bet ($0.50) returned to DrunkTyphoon
DrunkTyphoon collected $0.50 from pot
DrunkTyphoon: doesn't show hand 
*** SUMMARY ***
Total pot $0.50 | Rake $0 
Seat 1: Lasutchik (button) folded before Flop (didn't bet)
Seat 2: DrunkTyphoon (small blind) collected ($0.50)
Seat 3: phate-1up (big blind) folded before Flop
Seat 4: Ellen1947 folded before Flop (didn't bet)
Seat 5: ShockLaMuc folded before Flop (didn't bet)
Seat 6: pawn909 folded before Flop (didn't bet)
Seat 7: Rici47 folded before Flop (didn't bet)
Seat 8: chiyuki folded before Flop (didn't bet)
Seat 9: Dan Royal folded before Flop (didn't bet)



PokerStars Zoom Hand #84300989190:  Hold'em No Limit ($0.10/$0.25) - 2012/08/05 16:05:13 JST [2012/08/05 3:05:13 ET]
Table 'Whirlpool' 9-max Seat #1 is the button
Seat 1: nice.franki ($5.38 in chips) 
Seat 2: codan23 ($10.45 in chips) 
Seat 3: Rici47 ($26.39 in chips) 
Seat 4: Roglus ($12.81 in chips) 
Seat 5: roksmokndonk ($25.64 in chips) 
Seat 6: poorpoor6551 ($20.14 in chips) 
Seat 7: phate-1up ($57.39 in chips) 
Seat 8: Lasutchik ($29.19 in chips) 
Seat 9: chiyuki ($46.69 in chips) 
codan23: posts small blind $0.10
Rici47: posts big blind $0.25
*** HOLE CARDS ***
Dealt to chiyuki [Kd Th]
Roglus: folds 
roksmokndonk: folds 
poorpoor6551: folds 
phate-1up: raises $0.50 to $0.75
Lasutchik: folds 
chiyuki: folds 
nice.franki: folds 
codan23: calls $0.65
Rici47: calls $0.50
*** FLOP *** [Td Ah Kc]
codan23: checks 
Rici47: checks 
phate-1up: checks 
*** TURN *** [Td Ah Kc] [Qs]
codan23: checks 
Rici47: checks 
phate-1up: checks 
*** RIVER *** [Td Ah Kc Qs] [Ad]
codan23: checks 
Rici47: checks 
phate-1up: checks 
*** SHOW DOWN ***
codan23: shows [Kh Qh] (two pair, Aces and Kings)
Rici47: mucks hand 
phate-1up: mucks hand 
codan23 collected $2.15 from pot
*** SUMMARY ***
Total pot $2.25 | Rake $0.10 
Board [Td Ah Kc Qs Ad]
Seat 1: nice.franki (button) folded before Flop (didn't bet)
Seat 2: codan23 (small blind) showed [Kh Qh] and won ($2.15) with two pair, Aces and Kings
Seat 3: Rici47 (big blind) mucked [6c Qc]
Seat 4: Roglus folded before Flop (didn't bet)
Seat 5: roksmokndonk folded before Flop (didn't bet)
Seat 6: poorpoor6551 folded before Flop (didn't bet)
Seat 7: phate-1up mucked [4d 4c]
Seat 8: Lasutchik folded before Flop (didn't bet)
Seat 9: chiyuki folded before Flop (didn't bet)



PokerStars Zoom Hand #84300981949:  Hold'em No Limit ($0.10/$0.25) - 2012/08/05 16:04:46 JST [2012/08/05 3:04:46 ET]
Table 'Whirlpool' 9-max Seat #1 is the button
Seat 1: phate-1up ($57.49 in chips) 
Seat 2: Cripple86 ($26.59 in chips) 
Seat 3: chiyuki ($46.94 in chips) 
Seat 4: kesstukas25 ($30.73 in chips) 
Seat 5: Lindikor ($5.36 in chips) 
Seat 6: GSDP ($19.39 in chips) 
Seat 7: DrunkTyphoon ($36.34 in chips) 
Seat 8: kwkim73 ($25 in chips) 
Seat 9: snejokCoxx ($11.10 in chips) 
Cripple86: posts small blind $0.10
chiyuki: posts big blind $0.25
*** HOLE CARDS ***
Dealt to chiyuki [Kd 7s]
kesstukas25: folds 
Lindikor: folds 
GSDP: calls $0.25
DrunkTyphoon: folds 
kwkim73: folds 
snejokCoxx: folds 
phate-1up: folds 
Cripple86: raises $1 to $1.25
chiyuki: folds 
GSDP: calls $1
*** FLOP *** [4d As 5s]
Cripple86: bets $1.73
GSDP: calls $1.73
*** TURN *** [4d As 5s] [6d]
Cripple86: checks 
GSDP: bets $2.75
Cripple86: calls $2.75
*** RIVER *** [4d As 5s 6d] [3c]
Cripple86: checks 
GSDP: checks 
*** SHOW DOWN ***
Cripple86: shows [Jh Ac] (a pair of Aces)
GSDP: shows [4h 4c] (three of a kind, Fours)
GSDP collected $11.18 from pot
*** SUMMARY ***
Total pot $11.71 | Rake $0.53 
Board [4d As 5s 6d 3c]
Seat 1: phate-1up (button) folded before Flop (didn't bet)
Seat 2: Cripple86 (small blind) showed [Jh Ac] and lost with a pair of Aces
Seat 3: chiyuki (big blind) folded before Flop
Seat 4: kesstukas25 folded before Flop (didn't bet)
Seat 5: Lindikor folded before Flop (didn't bet)
Seat 6: GSDP showed [4h 4c] and won ($11.18) with three of a kind, Fours
Seat 7: DrunkTyphoon folded before Flop (didn't bet)
Seat 8: kwkim73 folded before Flop (didn't bet)
Seat 9: snejokCoxx folded before Flop (didn't bet)



PokerStars Zoom Hand #84300992400:  Hold'em No Limit ($0.10/$0.25) - 2012/08/05 16:05:25 JST [2012/08/05 3:05:25 ET]
Table 'Whirlpool' 9-max Seat #1 is the button
Seat 1: Kasperlmusik ($28.52 in chips) 
Seat 2: masterkoolb ($12.50 in chips) 
Seat 3: Perstenev ($12.96 in chips) 
Seat 4: pawn909 ($20.23 in chips) 
Seat 5: GovGus ($52.38 in chips) 
Seat 6: Dejacob ($48.28 in chips) 
Seat 7: chiyuki ($46.69 in chips) 
Seat 8: Dan Royal ($29.89 in chips) 
Seat 9: fwnaf ($22.61 in chips) 
masterkoolb: posts small blind $0.10
Perstenev: posts big blind $0.25
*** HOLE CARDS ***
Dealt to chiyuki [Ks Ah]
pawn909: folds 
GovGus: raises $0.50 to $0.75
Dejacob: folds 
chiyuki: raises $1.50 to $2.25
Dan Royal: folds 
fwnaf: folds 
Kasperlmusik: folds 
masterkoolb: folds 
Perstenev: folds 
GovGus: calls $1.50
*** FLOP *** [5s 5c 8d]
GovGus: checks 
chiyuki: bets $2.50
GovGus: calls $2.50
*** TURN *** [5s 5c 8d] [Ad]
GovGus: checks 
chiyuki: checks 
*** RIVER *** [5s 5c 8d Ad] [4d]
GovGus: checks 
chiyuki: bets $5.50
GovGus: folds 
Uncalled bet ($5.50) returned to chiyuki
chiyuki collected $9.41 from pot
chiyuki: doesn't show hand 
*** SUMMARY ***
Total pot $9.85 | Rake $0.44 
Board [5s 5c 8d Ad 4d]
Seat 1: Kasperlmusik (button) folded before Flop (didn't bet)
Seat 2: masterkoolb (small blind) folded before Flop
Seat 3: Perstenev (big blind) folded before Flop
Seat 4: pawn909 folded before Flop (didn't bet)
Seat 5: GovGus folded on the River
Seat 6: Dejacob folded before Flop (didn't bet)
Seat 7: chiyuki collected ($9.41)
Seat 8: Dan Royal folded before Flop (didn't bet)
Seat 9: fwnaf folded before Flop (didn't bet)



PokerStars Zoom Hand #84301012855:  Hold'em No Limit ($0.10/$0.25) - 2012/08/05 16:06:43 JST [2012/08/05 3:06:43 ET]
Table 'Whirlpool' 9-max Seat #1 is the button
Seat 1: Jene4kaBest ($12.25 in chips) 
Seat 2: chiyuki ($51.35 in chips) 
Seat 3: Cripple86 ($30.23 in chips) 
Seat 4: seula i ($70.86 in chips) 
Seat 5: zongo1 ($23.85 in chips) 
Seat 6: Dejacob ($47.93 in chips) 
Seat 7: phate-1up ($56.29 in chips) 
Seat 8: Grumpy as 2 ($11.65 in chips) 
Seat 9: kwkim73 ($30.84 in chips) 
chiyuki: posts small blind $0.10
Cripple86: posts big blind $0.25
*** HOLE CARDS ***
Dealt to chiyuki [8d 7c]
seula i: folds 
zongo1: raises $0.25 to $0.50
Dejacob: folds 
phate-1up: folds 
Grumpy as 2: folds 
kwkim73: folds 
Jene4kaBest: folds 
chiyuki: folds 
Cripple86: folds 
Uncalled bet ($0.25) returned to zongo1
zongo1 collected $0.60 from pot
zongo1: doesn't show hand 
*** SUMMARY ***
Total pot $0.60 | Rake $0 
Seat 1: Jene4kaBest (button) folded before Flop (didn't bet)
Seat 2: chiyuki (small blind) folded before Flop
Seat 3: Cripple86 (big blind) folded before Flop
Seat 4: seula i folded before Flop (didn't bet)
Seat 5: zongo1 collected ($0.60)
Seat 6: Dejacob folded before Flop (didn't bet)
Seat 7: phate-1up folded before Flop (didn't bet)
Seat 8: Grumpy as 2 folded before Flop (didn't bet)
Seat 9: kwkim73 folded before Flop (didn't bet)



PokerStars Zoom Hand #84301008791:  Hold'em No Limit ($0.10/$0.25) - 2012/08/05 16:06:27 JST [2012/08/05 3:06:27 ET]
Table 'Whirlpool' 9-max Seat #1 is the button
Seat 1: chiyuki ($51.35 in chips) 
Seat 2: teaser07 ($25 in chips) 
Seat 3: Limoilou ($28.48 in chips) 
Seat 4: silvno31 ($66.89 in chips) 
Seat 5: hldtom ($24.35 in chips) 
Seat 6: Lindikor ($17.69 in chips) 
Seat 7: Dejacob ($32.89 in chips) 
Seat 8: fwnaf ($22.61 in chips) 
Seat 9: fil740 ($13 in chips) 
teaser07: posts small blind $0.10
Limoilou: posts big blind $0.25
*** HOLE CARDS ***
Dealt to chiyuki [8d Td]
silvno31: folds 
hldtom: raises $0.50 to $0.75
Lindikor: calls $0.75
Dejacob: folds 
fwnaf: folds 
fil740: calls $0.75
chiyuki: folds 
teaser07: folds 
Limoilou: folds 
*** FLOP *** [Qh 3h 6h]
hldtom: bets $1.88
Lindikor: folds 
fil740: calls $1.88
*** TURN *** [Qh 3h 6h] [5s]
hldtom: bets $4.61
fil740: folds 
Uncalled bet ($4.61) returned to hldtom
hldtom collected $6.07 from pot
hldtom: doesn't show hand 
*** SUMMARY ***
Total pot $6.36 | Rake $0.29 
Board [Qh 3h 6h 5s]
Seat 1: chiyuki (button) folded before Flop (didn't bet)
Seat 2: teaser07 (small blind) folded before Flop
Seat 3: Limoilou (big blind) folded before Flop
Seat 4: silvno31 folded before Flop (didn't bet)
Seat 5: hldtom collected ($6.07)
Seat 6: Lindikor folded on the Flop
Seat 7: Dejacob folded before Flop (didn't bet)
Seat 8: fwnaf folded before Flop (didn't bet)
Seat 9: fil740 folded on the Turn



PokerStars Zoom Hand #84301021356:  Hold'em No Limit ($0.10/$0.25) - 2012/08/05 16:07:15 JST [2012/08/05 3:07:15 ET]
Table 'Whirlpool' 9-max Seat #1 is the button
Seat 1: Lindikor ($16.84 in chips) 
Seat 2: CrittHunter ($21.71 in chips) 
Seat 3: Nerkit ($8.80 in chips) 
Seat 4: nice.franki ($11.20 in chips) 
Seat 5: Kasperlmusik ($34.81 in chips) 
Seat 6: Alvinpe85 ($94.52 in chips) 
Seat 7: ShockLaMuc ($21.88 in chips) 
Seat 8: Limoilou ($28.13 in chips) 
Seat 9: chiyuki ($51.25 in chips) 
CrittHunter: posts small blind $0.10
Nerkit: posts big blind $0.25
*** HOLE CARDS ***
Dealt to chiyuki [6c 8s]
nice.franki: folds 
Kasperlmusik: folds 
Alvinpe85: folds 
ShockLaMuc: folds 
Limoilou: folds 
chiyuki: folds 
Lindikor: folds 
CrittHunter: folds 
Uncalled bet ($0.15) returned to Nerkit
Nerkit collected $0.20 from pot
Nerkit: doesn't show hand 
*** SUMMARY ***
Total pot $0.20 | Rake $0 
Seat 1: Lindikor (button) folded before Flop (didn't bet)
Seat 2: CrittHunter (small blind) folded before Flop
Seat 3: Nerkit (big blind) collected ($0.20)
Seat 4: nice.franki folded before Flop (didn't bet)
Seat 5: Kasperlmusik folded before Flop (didn't bet)
Seat 6: Alvinpe85 folded before Flop (didn't bet)
Seat 7: ShockLaMuc folded before Flop (didn't bet)
Seat 8: Limoilou folded before Flop (didn't bet)
Seat 9: chiyuki folded before Flop (didn't bet)



PokerStars Zoom Hand #84301018095:  Hold'em No Limit ($0.10/$0.25) - 2012/08/05 16:07:03 JST [2012/08/05 3:07:03 ET]
Table 'Whirlpool' 9-max Seat #1 is the button
Seat 1: seula i ($39.96 in chips) 
Seat 2: soul_5577 ($42.98 in chips) 
Seat 3: mjmichi ($25.95 in chips) 
Seat 4: pawn909 ($22.07 in chips) 
Seat 5: leo2095 ($26.41 in chips) 
Seat 6: NEZZA177 ($24.15 in chips) 
Seat 7: slapshot2011 ($33.51 in chips) 
Seat 8: chiyuki ($51.25 in chips) 
Seat 9: Bahia gyn ($19.91 in chips) 
soul_5577: posts small blind $0.10
mjmichi: posts big blind $0.25
*** HOLE CARDS ***
Dealt to chiyuki [4h 8c]
pawn909: raises $0.25 to $0.50
leo2095: folds 
NEZZA177: folds 
slapshot2011: folds 
chiyuki: folds 
Bahia gyn: folds 
seula i: calls $0.50
soul_5577: folds 
mjmichi: folds 
*** FLOP *** [8d 2s Qd]
pawn909: bets $2
seula i: calls $2
*** TURN *** [8d 2s Qd] [5d]
pawn909: checks 
seula i: bets $3
pawn909: calls $3
*** RIVER *** [8d 2s Qd 5d] [9c]
pawn909: checks 
seula i: bets $9
pawn909: raises $7.57 to $16.57 and is all-in
seula i: calls $7.57
*** SHOW DOWN ***
pawn909: shows [Kd Kc] (a pair of Kings)
seula i: shows [Ad Td] (a flush, Ace high)
seula i collected $42.49 from pot
*** SUMMARY ***
Total pot $44.49 | Rake $2 
Board [8d 2s Qd 5d 9c]
Seat 1: seula i (button) showed [Ad Td] and won ($42.49) with a flush, Ace high
Seat 2: soul_5577 (small blind) folded before Flop
Seat 3: mjmichi (big blind) folded before Flop
Seat 4: pawn909 showed [Kd Kc] and lost with a pair of Kings
Seat 5: leo2095 folded before Flop (didn't bet)
Seat 6: NEZZA177 folded before Flop (didn't bet)
Seat 7: slapshot2011 folded before Flop (didn't bet)
Seat 8: chiyuki folded before Flop (didn't bet)
Seat 9: Bahia gyn folded before Flop (didn't bet)



PokerStars Zoom Hand #84301025133:  Hold'em No Limit ($0.10/$0.25) - 2012/08/05 16:07:29 JST [2012/08/05 3:07:29 ET]
Table 'Whirlpool' 9-max Seat #1 is the button
Seat 1: Grishukps ($13.86 in chips) 
Seat 2: Alvinpe85 ($94.52 in chips) 
Seat 3: masterkoolb ($12.50 in chips) 
Seat 4: GovGus ($30.12 in chips) 
Seat 5: chiyuki ($51.25 in chips) 
Seat 6: Dejacob ($33.42 in chips) 
Seat 7: Roglus ($4.21 in chips) 
Seat 8: Ellen1947 ($32.69 in chips) 
Seat 9: ShockLaMuc ($21.88 in chips) 
Alvinpe85: posts small blind $0.10
masterkoolb: posts big blind $0.25
*** HOLE CARDS ***
Dealt to chiyuki [2h Qd]
GovGus: folds 
chiyuki: folds 
Dejacob: folds 
Roglus: folds 
Ellen1947: folds 
ShockLaMuc: folds 
Grishukps: raises $0.37 to $0.62
Alvinpe85: folds 
masterkoolb: folds 
Uncalled bet ($0.37) returned to Grishukps
Grishukps collected $0.60 from pot
Grishukps: doesn't show hand 
*** SUMMARY ***
Total pot $0.60 | Rake $0 
Seat 1: Grishukps (button) collected ($0.60)
Seat 2: Alvinpe85 (small blind) folded before Flop
Seat 3: masterkoolb (big blind) folded before Flop
Seat 4: GovGus folded before Flop (didn't bet)
Seat 5: chiyuki folded before Flop (didn't bet)
Seat 6: Dejacob folded before Flop (didn't bet)
Seat 7: Roglus folded before Flop (didn't bet)
Seat 8: Ellen1947 folded before Flop (didn't bet)
Seat 9: ShockLaMuc folded before Flop (didn't bet)



PokerStars Zoom Hand #84301026218:  Hold'em No Limit ($0.10/$0.25) - 2012/08/05 16:07:33 JST [2012/08/05 3:07:33 ET]
Table 'Whirlpool' 9-max Seat #1 is the button
Seat 1: DrunkTyphoon ($39.06 in chips) 
Seat 2: Cripple86 ($25 in chips) 
Seat 3: Angi858 ($21.13 in chips) 
Seat 4: chiyuki ($51.25 in chips) 
Seat 5: DanielWhyte ($34.67 in chips) 
Seat 6: Roglus ($4.21 in chips) 
Seat 7: Serge Claws ($39.68 in chips) 
Seat 8: 1Karina1 ($37.61 in chips) 
Seat 9: Loholov ($15 in chips) 
Cripple86: posts small blind $0.10
Angi858: posts big blind $0.25
*** HOLE CARDS ***
Dealt to chiyuki [8h Jc]
chiyuki: folds 
DanielWhyte: folds 
Roglus: folds 
Serge Claws: folds 
1Karina1: folds 
Loholov: raises $0.50 to $0.75
DrunkTyphoon: folds 
Cripple86: raises $1.75 to $2.50
Angi858: folds 
Loholov: calls $1.75
*** FLOP *** [Qh 8s As]
Cripple86: bets $2.80
Loholov: folds 
Uncalled bet ($2.80) returned to Cripple86
Cripple86 collected $5.01 from pot
Cripple86: doesn't show hand 
*** SUMMARY ***
Total pot $5.25 | Rake $0.24 
Board [Qh 8s As]
Seat 1: DrunkTyphoon (button) folded before Flop (didn't bet)
Seat 2: Cripple86 (small blind) collected ($5.01)
Seat 3: Angi858 (big blind) folded before Flop
Seat 4: chiyuki folded before Flop (didn't bet)
Seat 5: DanielWhyte folded before Flop (didn't bet)
Seat 6: Roglus folded before Flop (didn't bet)
Seat 7: Serge Claws folded before Flop (didn't bet)
Seat 8: 1Karina1 folded before Flop (didn't bet)
Seat 9: Loholov folded on the Flop



PokerStars Zoom Hand #84301016263:  Hold'em No Limit ($0.10/$0.25) - 2012/08/05 16:06:56 JST [2012/08/05 3:06:56 ET]
Table 'Whirlpool' 9-max Seat #1 is the button
Seat 1: Perstenev ($16 in chips) 
Seat 2: pandaaaaaa ($18.21 in chips) 
Seat 3: Ellen1947 ($30.91 in chips) 
Seat 4: phate-1up ($60.78 in chips) 
Seat 5: kwkim73 ($30.84 in chips) 
Seat 6: hldtom ($18.98 in chips) 
Seat 7: chiyuki ($51.25 in chips) 
Seat 8: Vall179 ($24.65 in chips) 
Seat 9: Jene4kaBest ($12.15 in chips) 
pandaaaaaa: posts small blind $0.10
Ellen1947: posts big blind $0.25
*** HOLE CARDS ***
Dealt to chiyuki [3h 8c]
phate-1up: folds 
kwkim73: raises $0.50 to $0.75
hldtom: folds 
chiyuki: folds 
Vall179: folds 
Jene4kaBest: calls $0.75
Perstenev: folds 
pandaaaaaa: folds 
Ellen1947: folds 
*** FLOP *** [As Tc 3s]
kwkim73: checks 
Jene4kaBest: bets $1
kwkim73: calls $1
*** TURN *** [As Tc 3s] [Kd]
kwkim73: checks 
Jene4kaBest: bets $1.47
kwkim73: calls $1.47
*** RIVER *** [As Tc 3s Kd] [Td]
kwkim73: checks 
Jene4kaBest: checks 
*** SHOW DOWN ***
kwkim73: shows [Jh Ah] (two pair, Aces and Tens)
Jene4kaBest: mucks hand 
kwkim73 collected $6.48 from pot
*** SUMMARY ***
Total pot $6.79 | Rake $0.31 
Board [As Tc 3s Kd Td]
Seat 1: Perstenev (button) folded before Flop (didn't bet)
Seat 2: pandaaaaaa (small blind) folded before Flop
Seat 3: Ellen1947 (big blind) folded before Flop
Seat 4: phate-1up folded before Flop (didn't bet)
Seat 5: kwkim73 showed [Jh Ah] and won ($6.48) with two pair, Aces and Tens
Seat 6: hldtom folded before Flop (didn't bet)
Seat 7: chiyuki folded before Flop (didn't bet)
Seat 8: Vall179 folded before Flop (didn't bet)
Seat 9: Jene4kaBest mucked [Ks Js]



PokerStars Zoom Hand #84301019176:  Hold'em No Limit ($0.10/$0.25) - 2012/08/05 16:07:07 JST [2012/08/05 3:07:07 ET]
Table 'Whirlpool' 9-max Seat #1 is the button
Seat 1: 4plankton ($8.78 in chips) 
Seat 2: phate-1up ($60.78 in chips) 
Seat 3: Grishukps ($12.75 in chips) 
Seat 4: kesstukas25 ($30.70 in chips) 
Seat 5: Rici47 ($39.65 in chips) 
Seat 6: chiyuki ($51.25 in chips) 
Seat 7: soul_5577 ($42.88 in chips) 
Seat 8: andy0815r ($31.36 in chips) 
Seat 9: leo2095 ($26.41 in chips) 
phate-1up: posts small blind $0.10
Grishukps: posts big blind $0.25
*** HOLE CARDS ***
Dealt to chiyuki [Jc 3c]
kesstukas25: folds 
Rici47: folds 
chiyuki: folds 
soul_5577: calls $0.25
andy0815r: calls $0.25
leo2095: folds 
4plankton: folds 
phate-1up: calls $0.15
Grishukps: checks 
*** FLOP *** [9s 5c 4c]
phate-1up: checks 
Grishukps: checks 
soul_5577: checks 
andy0815r: checks 
*** TURN *** [9s 5c 4c] [5s]
phate-1up: checks 
Grishukps: checks 
soul_5577: checks 
andy0815r: bets $0.48
phate-1up: folds 
Grishukps: folds 
soul_5577: folds 
Uncalled bet ($0.48) returned to andy0815r
andy0815r collected $0.96 from pot
andy0815r: doesn't show hand 
*** SUMMARY ***
Total pot $1 | Rake $0.04 
Board [9s 5c 4c 5s]
Seat 1: 4plankton (button) folded before Flop (didn't bet)
Seat 2: phate-1up (small blind) folded on the Turn
Seat 3: Grishukps (big blind) folded on the Turn
Seat 4: kesstukas25 folded before Flop (didn't bet)
Seat 5: Rici47 folded before Flop (didn't bet)
Seat 6: chiyuki folded before Flop (didn't bet)
Seat 7: soul_5577 folded on the Turn
Seat 8: andy0815r collected ($0.96)
Seat 9: leo2095 folded before Flop (didn't bet)



PokerStars Zoom Hand #84301037534:  Hold'em No Limit ($0.10/$0.25) - 2012/08/05 16:08:16 JST [2012/08/05 3:08:16 ET]
Table 'Whirlpool' 9-max Seat #1 is the button
Seat 1: laurentzu84 ($27.55 in chips) 
Seat 2: silvno31 ($66.64 in chips) 
Seat 3: slapshot2011 ($36.36 in chips) 
Seat 4: chiyuki ($51 in chips) 
Seat 5: Vall179 ($22.55 in chips) 
Seat 6: Angi858 ($22.88 in chips) 
Seat 7: Serge Claws ($64.60 in chips) 
Seat 8: DanielWhyte ($32.92 in chips) 
Seat 9: ShockLaMuc ($21.53 in chips) 
silvno31: posts small blind $0.10
slapshot2011: posts big blind $0.25
*** HOLE CARDS ***
Dealt to chiyuki [Th 6c]
chiyuki: folds 
Vall179: folds 
Angi858: folds 
Serge Claws: folds 
DanielWhyte: folds 
ShockLaMuc: folds 
laurentzu84: folds 
silvno31: folds 
Uncalled bet ($0.15) returned to slapshot2011
slapshot2011 collected $0.20 from pot
slapshot2011: doesn't show hand 
*** SUMMARY ***
Total pot $0.20 | Rake $0 
Seat 1: laurentzu84 (button) folded before Flop (didn't bet)
Seat 2: silvno31 (small blind) folded before Flop
Seat 3: slapshot2011 (big blind) collected ($0.20)
Seat 4: chiyuki folded before Flop (didn't bet)
Seat 5: Vall179 folded before Flop (didn't bet)
Seat 6: Angi858 folded before Flop (didn't bet)
Seat 7: Serge Claws folded before Flop (didn't bet)
Seat 8: DanielWhyte folded before Flop (didn't bet)
Seat 9: ShockLaMuc folded before Flop (didn't bet)



PokerStars Zoom Hand #84301035369:  Hold'em No Limit ($0.10/$0.25) - 2012/08/05 16:08:08 JST [2012/08/05 3:08:08 ET]
Table 'Whirlpool' 9-max Seat #1 is the button
Seat 1: Mytea88 ($13.96 in chips) 
Seat 2: deepakmbh ($32.31 in chips) 
Seat 3: Grumpy as 2 ($12.17 in chips) 
Seat 4: Nerkit ($20.45 in chips) 
Seat 5: Loholov ($15 in chips) 
Seat 6: chiyuki ($51 in chips) 
Seat 7: INSP!RON ($31.17 in chips) 
Seat 8: Bahia gyn ($19.56 in chips) 
Seat 9: 1Karina1 ($36.01 in chips) 
deepakmbh: posts small blind $0.10
Grumpy as 2: posts big blind $0.25
*** HOLE CARDS ***
Dealt to chiyuki [8s 3d]
Nerkit: raises $0.50 to $0.75
Loholov: folds 
chiyuki: folds 
INSP!RON: folds 
Bahia gyn: folds 
1Karina1: folds 
Mytea88: folds 
deepakmbh: calls $0.65
Grumpy as 2: folds 
*** FLOP *** [Kd Qh Ac]
deepakmbh: checks 
Nerkit: checks 
*** TURN *** [Kd Qh Ac] [Td]
deepakmbh: checks 
Nerkit: checks 
*** RIVER *** [Kd Qh Ac Td] [Ks]
deepakmbh: checks 
Nerkit: checks 
*** SHOW DOWN ***
deepakmbh: shows [6s 6d] (two pair, Kings and Sixes)
Nerkit: shows [7d 7h] (two pair, Kings and Sevens)
Nerkit collected $1.67 from pot
*** SUMMARY ***
Total pot $1.75 | Rake $0.08 
Board [Kd Qh Ac Td Ks]
Seat 1: Mytea88 (button) folded before Flop (didn't bet)
Seat 2: deepakmbh (small blind) showed [6s 6d] and lost with two pair, Kings and Sixes
Seat 3: Grumpy as 2 (big blind) folded before Flop
Seat 4: Nerkit showed [7d 7h] and won ($1.67) with two pair, Kings and Sevens
Seat 5: Loholov folded before Flop (didn't bet)
Seat 6: chiyuki folded before Flop (didn't bet)
Seat 7: INSP!RON folded before Flop (didn't bet)
Seat 8: Bahia gyn folded before Flop (didn't bet)
Seat 9: 1Karina1 folded before Flop (didn't bet)



PokerStars Zoom Hand #84301042055:  Hold'em No Limit ($0.10/$0.25) - 2012/08/05 16:08:33 JST [2012/08/05 3:08:33 ET]
Table 'Whirlpool' 9-max Seat #1 is the button
Seat 1: slapshot2011 ($36.46 in chips) 
Seat 2: drunk_bender ($27.56 in chips) 
Seat 3: men1989 ($23.54 in chips) 
Seat 4: pikhtovnikov ($19.63 in chips) 
Seat 5: Spheroff ($14.85 in chips) 
Seat 6: Lindikor ($6.11 in chips) 
Seat 7: ShockLaMuc ($21.85 in chips) 
Seat 8: chiyuki ($50.90 in chips) 
Seat 9: 4plankton ($8.33 in chips) 
drunk_bender: posts small blind $0.10
men1989: posts big blind $0.25
*** HOLE CARDS ***
Dealt to chiyuki [9s Jh]
pikhtovnikov: folds 
Spheroff: raises $0.50 to $0.75
Lindikor: folds 
ShockLaMuc: folds 
chiyuki: folds 
4plankton: folds 
slapshot2011: folds 
drunk_bender: folds 
men1989: folds 
Uncalled bet ($0.50) returned to Spheroff
Spheroff collected $0.60 from pot
Spheroff: doesn't show hand 
*** SUMMARY ***
Total pot $0.60 | Rake $0 
Seat 1: slapshot2011 (button) folded before Flop (didn't bet)
Seat 2: drunk_bender (small blind) folded before Flop
Seat 3: men1989 (big blind) folded before Flop
Seat 4: pikhtovnikov folded before Flop (didn't bet)
Seat 5: Spheroff collected ($0.60)
Seat 6: Lindikor folded before Flop (didn't bet)
Seat 7: ShockLaMuc folded before Flop (didn't bet)
Seat 8: chiyuki folded before Flop (didn't bet)
Seat 9: 4plankton folded before Flop (didn't bet)



PokerStars Zoom Hand #84301019992:  Hold'em No Limit ($0.10/$0.25) - 2012/08/05 16:07:10 JST [2012/08/05 3:07:10 ET]
Table 'Whirlpool' 9-max Seat #1 is the button
Seat 1: snejokCoxx ($10 in chips) 
Seat 2: Vall179 ($24.40 in chips) 
Seat 3: 4ydo yogurt ($64.81 in chips) 
Seat 4: chiyuki ($51.25 in chips) 
Seat 5: silvno31 ($66.54 in chips) 
Seat 6: Perstenev ($16 in chips) 
Seat 7: mjmichi ($25.70 in chips) 
Seat 8: ShockLaMuc ($21.88 in chips) 
Seat 9: pikhtovnikov ($25.13 in chips) 
Vall179: posts small blind $0.10
4ydo yogurt: posts big blind $0.25
*** HOLE CARDS ***
Dealt to chiyuki [3h 9c]
chiyuki: folds 
silvno31: folds 
Perstenev: folds 
mjmichi: folds 
ShockLaMuc: folds 
pikhtovnikov: folds 
snejokCoxx: raises $0.25 to $0.50
Vall179: folds 
4ydo yogurt: calls $0.25
*** FLOP *** [6d 4s 3s]
4ydo yogurt: checks 
snejokCoxx: checks 
*** TURN *** [6d 4s 3s] [Kh]
4ydo yogurt: checks 
snejokCoxx: checks 
*** RIVER *** [6d 4s 3s Kh] [6h]
4ydo yogurt: bets $0.52
snejokCoxx has timed out
snejokCoxx: folds 
Uncalled bet ($0.52) returned to 4ydo yogurt
4ydo yogurt collected $1.05 from pot
4ydo yogurt: doesn't show hand 
*** SUMMARY ***
Total pot $1.10 | Rake $0.05 
Board [6d 4s 3s Kh 6h]
Seat 1: snejokCoxx (button) folded on the River
Seat 2: Vall179 (small blind) folded before Flop
Seat 3: 4ydo yogurt (big blind) collected ($1.05)
Seat 4: chiyuki folded before Flop (didn't bet)
Seat 5: silvno31 folded before Flop (didn't bet)
Seat 6: Perstenev folded before Flop (didn't bet)
Seat 7: mjmichi folded before Flop (didn't bet)
Seat 8: ShockLaMuc folded before Flop (didn't bet)
Seat 9: pikhtovnikov folded before Flop (didn't bet)



PokerStars Zoom Hand #84301028349:  Hold'em No Limit ($0.10/$0.25) - 2012/08/05 16:07:41 JST [2012/08/05 3:07:41 ET]
Table 'Whirlpool' 9-max Seat #1 is the button
Seat 1: teaser07 ($25 in chips) 
Seat 2: andy0815r ($47.87 in chips) 
Seat 3: chiyuki ($51.25 in chips) 
Seat 4: Spheroff ($15.20 in chips) 
Seat 5: pandaaaaaa ($18.11 in chips) 
Seat 6: FoRlan77 ($25 in chips) 
Seat 7: ShockLaMuc ($25.60 in chips) 
Seat 8: Loholov ($15 in chips) 
Seat 9: ivan130 ($25.10 in chips) 
andy0815r: posts small blind $0.10
chiyuki: posts big blind $0.25
*** HOLE CARDS ***
Dealt to chiyuki [As 2h]
Spheroff: folds 
pandaaaaaa: folds 
FoRlan77: folds 
ShockLaMuc: folds 
Loholov: folds 
ivan130: folds 
teaser07: raises $0.37 to $0.62
andy0815r: raises $0.88 to $1.50
chiyuki: folds 
teaser07: calls $0.88
*** FLOP *** [9s Kd Ad]
andy0815r: checks 
teaser07: checks 
*** TURN *** [9s Kd Ad] [3c]
andy0815r: checks 
teaser07: checks 
*** RIVER *** [9s Kd Ad 3c] [Jd]
andy0815r: checks 
teaser07: checks 
*** SHOW DOWN ***
andy0815r: shows [Qh Qd] (a pair of Queens)
teaser07: mucks hand 
andy0815r collected $3.10 from pot
*** SUMMARY ***
Total pot $3.25 | Rake $0.15 
Board [9s Kd Ad 3c Jd]
Seat 1: teaser07 (button) mucked [5d 5h]
Seat 2: andy0815r (small blind) showed [Qh Qd] and won ($3.10) with a pair of Queens
Seat 3: chiyuki (big blind) folded before Flop
Seat 4: Spheroff folded before Flop (didn't bet)
Seat 5: pandaaaaaa folded before Flop (didn't bet)
Seat 6: FoRlan77 folded before Flop (didn't bet)
Seat 7: ShockLaMuc folded before Flop (didn't bet)
Seat 8: Loholov folded before Flop (didn't bet)
Seat 9: ivan130 folded before Flop (didn't bet)



PokerStars Zoom Hand #84301039916:  Hold'em No Limit ($0.10/$0.25) - 2012/08/05 16:08:25 JST [2012/08/05 3:08:25 ET]
Table 'Whirlpool' 9-max Seat #1 is the button
Seat 1: chiyuki ($50.90 in chips) 
Seat 2: Spheroff ($14.95 in chips) 
Seat 3: Loholov ($15 in chips) 
Seat 4: Lindikor ($17.19 in chips) 
Seat 5: silvno31 ($66.54 in chips) 
Seat 6: GSDP ($26.19 in chips) 
Seat 7: 1Karina1 ($30.16 in chips) 
Seat 8: Grishukps ($19.39 in chips) 
Seat 9: kesstukas25 ($12.50 in chips) 
Spheroff: posts small blind $0.10
Loholov: posts big blind $0.25
*** HOLE CARDS ***
Dealt to chiyuki [Td 6d]
Lindikor: folds 
silvno31: folds 
GSDP: folds 
1Karina1: folds 
Grishukps: folds 
kesstukas25: folds 
chiyuki: folds 
Spheroff: folds 
Uncalled bet ($0.15) returned to Loholov
Loholov collected $0.20 from pot
Loholov: doesn't show hand 
*** SUMMARY ***
Total pot $0.20 | Rake $0 
Seat 1: chiyuki (button) folded before Flop (didn't bet)
Seat 2: Spheroff (small blind) folded before Flop
Seat 3: Loholov (big blind) collected ($0.20)
Seat 4: Lindikor folded before Flop (didn't bet)
Seat 5: silvno31 folded before Flop (didn't bet)
Seat 6: GSDP folded before Flop (didn't bet)
Seat 7: 1Karina1 folded before Flop (didn't bet)
Seat 8: Grishukps folded before Flop (didn't bet)
Seat 9: kesstukas25 folded before Flop (didn't bet)



PokerStars Zoom Hand #84301038886:  Hold'em No Limit ($0.10/$0.25) - 2012/08/05 16:08:21 JST [2012/08/05 3:08:21 ET]
Table 'Whirlpool' 9-max Seat #1 is the button
Seat 1: hldtom ($19.56 in chips) 
Seat 2: chiyuki ($51 in chips) 
Seat 3: phate-1up ($75.51 in chips) 
Seat 4: Perstenev ($5.03 in chips) 
Seat 5: Vall179 ($25.67 in chips) 
Seat 6: DrunkTyphoon ($38.41 in chips) 
Seat 7: top gun 2950 ($39.82 in chips) 
Seat 8: GovGus ($47.04 in chips) 
Seat 9: mjmichi ($76.36 in chips) 
chiyuki: posts small blind $0.10
phate-1up: posts big blind $0.25
*** HOLE CARDS ***
Dealt to chiyuki [5d Js]
Perstenev: folds 
Vall179: folds 
DrunkTyphoon: raises $0.50 to $0.75
top gun 2950: folds 
GovGus: calls $0.75
mjmichi: folds 
hldtom: folds 
chiyuki: folds 
phate-1up: folds 
*** FLOP *** [2d 2h Kd]
DrunkTyphoon: checks 
GovGus: checks 
*** TURN *** [2d 2h Kd] [Ad]
DrunkTyphoon: bets $1.18
GovGus: folds 
Uncalled bet ($1.18) returned to DrunkTyphoon
DrunkTyphoon collected $1.77 from pot
DrunkTyphoon: doesn't show hand 
*** SUMMARY ***
Total pot $1.85 | Rake $0.08 
Board [2d 2h Kd Ad]
Seat 1: hldtom (button) folded before Flop (didn't bet)
Seat 2: chiyuki (small blind) folded before Flop
Seat 3: phate-1up (big blind) folded before Flop
Seat 4: Perstenev folded before Flop (didn't bet)
Seat 5: Vall179 folded before Flop (didn't bet)
Seat 6: DrunkTyphoon collected ($1.77)
Seat 7: top gun 2950 folded before Flop (didn't bet)
Seat 8: GovGus folded on the Turn
Seat 9: mjmichi folded before Flop (didn't bet)



PokerStars Zoom Hand #84301043662:  Hold'em No Limit ($0.10/$0.25) - 2012/08/05 16:08:39 JST [2012/08/05 3:08:39 ET]
Table 'Whirlpool' 9-max Seat #1 is the button
Seat 1: xxx Spb xxx ($27.11 in chips) 
Seat 2: phate-1up ($75.26 in chips) 
Seat 3: chiyuki ($50.90 in chips) 
Seat 4: andy0815r ($30.44 in chips) 
Seat 5: Serge Claws ($25 in chips) 
Seat 6: kwkim73 ($26.03 in chips) 
Seat 7: 4plankton ($8.33 in chips) 
Seat 8: CrittHunter ($21.26 in chips) 
Seat 9: Nerkit ($12.40 in chips) 
phate-1up: posts small blind $0.10
chiyuki: posts big blind $0.25
*** HOLE CARDS ***
Dealt to chiyuki [Jd Jc]
andy0815r: folds 
Serge Claws: folds 
kwkim73: folds 
4plankton: folds 
CrittHunter: folds 
Nerkit: folds 
xxx Spb xxx: folds 
phate-1up: raises $0.50 to $0.75
chiyuki: raises $1.50 to $2.25
phate-1up: raises $2.50 to $4.75
chiyuki: raises $4.50 to $9.25
phate-1up: raises $66.01 to $75.26 and is all-in
chiyuki: folds 
Uncalled bet ($66.01) returned to phate-1up
phate-1up collected $18.50 from pot
phate-1up: doesn't show hand 
*** SUMMARY ***
Total pot $18.50 | Rake $0 
Seat 1: xxx Spb xxx (button) folded before Flop (didn't bet)
Seat 2: phate-1up (small blind) collected ($18.50)
Seat 3: chiyuki (big blind) folded before Flop
Seat 4: andy0815r folded before Flop (didn't bet)
Seat 5: Serge Claws folded before Flop (didn't bet)
Seat 6: kwkim73 folded before Flop (didn't bet)
Seat 7: 4plankton folded before Flop (didn't bet)
Seat 8: CrittHunter folded before Flop (didn't bet)
Seat 9: Nerkit folded before Flop (didn't bet)



PokerStars Zoom Hand #84301075405:  Hold'em No Limit ($0.10/$0.25) - 2012/08/05 16:10:38 JST [2012/08/05 3:10:38 ET]
Table 'Whirlpool' 9-max Seat #1 is the button
Seat 1: romanian c4 ($23.26 in chips) 
Seat 2: Loholov ($15 in chips) 
Seat 3: Vall179 ($30.34 in chips) 
Seat 4: 1Karina1 ($35.56 in chips) 
Seat 5: phate-1up ($84.51 in chips) 
Seat 6: Mytea88 ($6.43 in chips) 
Seat 7: chiyuki ($41.65 in chips) 
Seat 8: Serge Claws ($25 in chips) 
Seat 9: Angi858 ($20.68 in chips) 
Loholov: posts small blind $0.10
Vall179: posts big blind $0.25
*** HOLE CARDS ***
Dealt to chiyuki [8s 8h]
1Karina1: folds 
phate-1up: folds 
Mytea88: folds 
chiyuki: raises $0.50 to $0.75
Serge Claws: folds 
Angi858: folds 
romanian c4: folds 
Loholov: folds 
Vall179: calls $0.50
*** FLOP *** [Ah Jd Kc]
Vall179: checks 
chiyuki: bets $1
Vall179: folds 
Uncalled bet ($1) returned to chiyuki
chiyuki collected $1.53 from pot
chiyuki: doesn't show hand 
*** SUMMARY ***
Total pot $1.60 | Rake $0.07 
Board [Ah Jd Kc]
Seat 1: romanian c4 (button) folded before Flop (didn't bet)
Seat 2: Loholov (small blind) folded before Flop
Seat 3: Vall179 (big blind) folded on the Flop
Seat 4: 1Karina1 folded before Flop (didn't bet)
Seat 5: phate-1up folded before Flop (didn't bet)
Seat 6: Mytea88 folded before Flop (didn't bet)
Seat 7: chiyuki collected ($1.53)
Seat 8: Serge Claws folded before Flop (didn't bet)
Seat 9: Angi858 folded before Flop (didn't bet)



PokerStars Zoom Hand #84301084343:  Hold'em No Limit ($0.10/$0.25) - 2012/08/05 16:11:11 JST [2012/08/05 3:11:11 ET]
Table 'Whirlpool' 9-max Seat #1 is the button
Seat 1: pandaaaaaa ($19.26 in chips) 
Seat 2: 4ydo yogurt ($61.86 in chips) 
Seat 3: Serge Claws ($73.91 in chips) 
Seat 4: slapshot2011 ($35.95 in chips) 
Seat 5: chiyuki ($42.43 in chips) 
Seat 6: nice.franki ($3.56 in chips) 
Seat 7: xxx Spb xxx ($27.58 in chips) 
Seat 8: Cripple86 ($29.23 in chips) 
Seat 9: laurentzu84 ($31.09 in chips) 
4ydo yogurt: posts small blind $0.10
Serge Claws: posts big blind $0.25
*** HOLE CARDS ***
Dealt to chiyuki [Td 7c]
slapshot2011: folds 
chiyuki: folds 
nice.franki: folds 
xxx Spb xxx: folds 
Cripple86: folds 
laurentzu84: folds 
pandaaaaaa: folds 
4ydo yogurt: raises $0.25 to $0.50
Serge Claws: folds 
Uncalled bet ($0.25) returned to 4ydo yogurt
4ydo yogurt collected $0.50 from pot
4ydo yogurt: doesn't show hand 
*** SUMMARY ***
Total pot $0.50 | Rake $0 
Seat 1: pandaaaaaa (button) folded before Flop (didn't bet)
Seat 2: 4ydo yogurt (small blind) collected ($0.50)
Seat 3: Serge Claws (big blind) folded before Flop
Seat 4: slapshot2011 folded before Flop (didn't bet)
Seat 5: chiyuki folded before Flop (didn't bet)
Seat 6: nice.franki folded before Flop (didn't bet)
Seat 7: xxx Spb xxx folded before Flop (didn't bet)
Seat 8: Cripple86 folded before Flop (didn't bet)
Seat 9: laurentzu84 folded before Flop (didn't bet)



PokerStars Zoom Hand #84301087297:  Hold'em No Limit ($0.10/$0.25) - 2012/08/05 16:11:22 JST [2012/08/05 3:11:22 ET]
Table 'Whirlpool' 9-max Seat #1 is the button
Seat 1: d4dda ($22.40 in chips) 
Seat 2: Vall179 ($22.73 in chips) 
Seat 3: DanielWhyte ($30.62 in chips) 
Seat 4: snejokCoxx ($11.72 in chips) 
Seat 5: GovGus ($40.80 in chips) 
Seat 6: chiyuki ($42.43 in chips) 
Seat 7: Rici47 ($45.39 in chips) 
Seat 8: mjmichi ($78.52 in chips) 
Seat 9: fwnaf ($20.78 in chips) 
Vall179: posts small blind $0.10
DanielWhyte: posts big blind $0.25
*** HOLE CARDS ***
Dealt to chiyuki [Ah 3c]
snejokCoxx: folds 
GovGus: folds 
chiyuki: folds 
Rici47: folds 
mjmichi: folds 
fwnaf: folds 
d4dda: folds 
Vall179: folds 
Uncalled bet ($0.15) returned to DanielWhyte
DanielWhyte collected $0.20 from pot
DanielWhyte: doesn't show hand 
*** SUMMARY ***
Total pot $0.20 | Rake $0 
Seat 1: d4dda (button) folded before Flop (didn't bet)
Seat 2: Vall179 (small blind) folded before Flop
Seat 3: DanielWhyte (big blind) collected ($0.20)
Seat 4: snejokCoxx folded before Flop (didn't bet)
Seat 5: GovGus folded before Flop (didn't bet)
Seat 6: chiyuki folded before Flop (didn't bet)
Seat 7: Rici47 folded before Flop (didn't bet)
Seat 8: mjmichi folded before Flop (didn't bet)
Seat 9: fwnaf folded before Flop (didn't bet)



PokerStars Zoom Hand #84301091081:  Hold'em No Limit ($0.10/$0.25) - 2012/08/05 16:11:37 JST [2012/08/05 3:11:37 ET]
Table 'Whirlpool' 9-max Seat #1 is the button
Seat 1: chiyuki ($42.33 in chips) 
Seat 2: Nerkit ($12.25 in chips) 
Seat 3: phate-1up ($60.03 in chips) 
Seat 4: codan23 ($12.01 in chips) 
Seat 5: Alvinpe85 ($103.46 in chips) 
Seat 6: Serge Claws ($73.56 in chips) 
Seat 7: snejokCoxx ($11.72 in chips) 
Seat 8: ivan130 ($28.66 in chips) 
Seat 9: xxx Spb xxx ($27.33 in chips) 
Nerkit: posts small blind $0.10
phate-1up: posts big blind $0.25
*** HOLE CARDS ***
Dealt to chiyuki [5s Kc]
codan23: folds 
Alvinpe85: folds 
Serge Claws: folds 
snejokCoxx: folds 
ivan130: folds 
xxx Spb xxx: raises $0.50 to $0.75
chiyuki: folds 
Nerkit: folds 
phate-1up: folds 
Uncalled bet ($0.50) returned to xxx Spb xxx
xxx Spb xxx collected $0.60 from pot
xxx Spb xxx: doesn't show hand 
*** SUMMARY ***
Total pot $0.60 | Rake $0 
Seat 1: chiyuki (button) folded before Flop (didn't bet)
Seat 2: Nerkit (small blind) folded before Flop
Seat 3: phate-1up (big blind) folded before Flop
Seat 4: codan23 folded before Flop (didn't bet)
Seat 5: Alvinpe85 folded before Flop (didn't bet)
Seat 6: Serge Claws folded before Flop (didn't bet)
Seat 7: snejokCoxx folded before Flop (didn't bet)
Seat 8: ivan130 folded before Flop (didn't bet)
Seat 9: xxx Spb xxx collected ($0.60)



PokerStars Zoom Hand #84301090036:  Hold'em No Limit ($0.10/$0.25) - 2012/08/05 16:11:32 JST [2012/08/05 3:11:32 ET]
Table 'Whirlpool' 9-max Seat #1 is the button
Seat 1: Loholov ($15 in chips) 
Seat 2: chiyuki ($42.43 in chips) 
Seat 3: seula i ($60.40 in chips) 
Seat 4: Angi858 ($20.68 in chips) 
Seat 5: Kasperlmusik ($39.58 in chips) 
Seat 6: Fructionar ($44.35 in chips) 
Seat 7: ivan130 ($28.66 in chips) 
Seat 8: Lasutchik ($11.80 in chips) 
Seat 9: d4dda ($25 in chips) 
chiyuki: posts small blind $0.10
seula i: posts big blind $0.25
*** HOLE CARDS ***
Dealt to chiyuki [Kd 7h]
Angi858: calls $0.25
Kasperlmusik: folds 
Fructionar: folds 
ivan130: folds 
Lasutchik: folds 
d4dda: folds 
Loholov: calls $0.25
chiyuki: folds 
seula i: checks 
*** FLOP *** [Jh 6s 3h]
seula i: checks 
Angi858: checks 
Loholov: checks 
*** TURN *** [Jh 6s 3h] [Qh]
seula i: bets $0.50
Angi858: calls $0.50
Loholov: folds 
*** RIVER *** [Jh 6s 3h Qh] [Ah]
seula i: checks 
Angi858: bets $4.25
seula i: folds 
Uncalled bet ($4.25) returned to Angi858
Angi858 collected $1.77 from pot
Angi858: doesn't show hand 
*** SUMMARY ***
Total pot $1.85 | Rake $0.08 
Board [Jh 6s 3h Qh Ah]
Seat 1: Loholov (button) folded on the Turn
Seat 2: chiyuki (small blind) folded before Flop
Seat 3: seula i (big blind) folded on the River
Seat 4: Angi858 collected ($1.77)
Seat 5: Kasperlmusik folded before Flop (didn't bet)
Seat 6: Fructionar folded before Flop (didn't bet)
Seat 7: ivan130 folded before Flop (didn't bet)
Seat 8: Lasutchik folded before Flop (didn't bet)
Seat 9: d4dda folded before Flop (didn't bet)



PokerStars Zoom Hand #84301082412:  Hold'em No Limit ($0.10/$0.25) - 2012/08/05 16:11:04 JST [2012/08/05 3:11:04 ET]
Table 'Whirlpool' 9-max Seat #1 is the button
Seat 1: 4ydo yogurt ($61.86 in chips) 
Seat 2: d4dda ($12.50 in chips) 
Seat 3: Lindikor ($6.46 in chips) 
Seat 4: scaredsare ($25.50 in chips) 
Seat 5: Angi858 ($20.68 in chips) 
Seat 6: xxx Spb xxx ($27.58 in chips) 
Seat 7: Perstenev ($15.78 in chips) 
Seat 8: 1Karina1 ($30.91 in chips) 
Seat 9: chiyuki ($42.43 in chips) 
d4dda: posts small blind $0.10
Lindikor: posts big blind $0.25
*** HOLE CARDS ***
Dealt to chiyuki [8d 7s]
scaredsare: raises $0.25 to $0.50
Angi858: folds 
xxx Spb xxx: folds 
Perstenev: calls $0.50
1Karina1: folds 
chiyuki: folds 
4ydo yogurt: folds 
d4dda: folds 
Lindikor: calls $0.25
*** FLOP *** [9d Jd 4s]
Lindikor: checks 
scaredsare: checks 
Perstenev: checks 
*** TURN *** [9d Jd 4s] [5c]
Lindikor: checks 
scaredsare: checks 
Perstenev: checks 
*** RIVER *** [9d Jd 4s 5c] [Ac]
Lindikor: checks 
scaredsare: checks 
Perstenev: checks 
*** SHOW DOWN ***
Lindikor: shows [8h Kd] (high card Ace)
scaredsare: shows [Tc As] (a pair of Aces)
Perstenev: mucks hand 
scaredsare collected $1.53 from pot
*** SUMMARY ***
Total pot $1.60 | Rake $0.07 
Board [9d Jd 4s 5c Ac]
Seat 1: 4ydo yogurt (button) folded before Flop (didn't bet)
Seat 2: d4dda (small blind) folded before Flop
Seat 3: Lindikor (big blind) showed [8h Kd] and lost with high card Ace
Seat 4: scaredsare showed [Tc As] and won ($1.53) with a pair of Aces
Seat 5: Angi858 folded before Flop (didn't bet)
Seat 6: xxx Spb xxx folded before Flop (didn't bet)
Seat 7: Perstenev mucked [6h 6d]
Seat 8: 1Karina1 folded before Flop (didn't bet)
Seat 9: chiyuki folded before Flop (didn't bet)



PokerStars Zoom Hand #84301088393:  Hold'em No Limit ($0.10/$0.25) - 2012/08/05 16:11:26 JST [2012/08/05 3:11:26 ET]
Table 'Whirlpool' 9-max Seat #1 is the button
Seat 1: DrunkTyphoon ($47.10 in chips) 
Seat 2: AAAKK777 ($13.08 in chips) 
Seat 3: xxx Spb xxx ($29.81 in chips) 
Seat 4: chiyuki ($42.43 in chips) 
Seat 5: laurentzu84 ($31.09 in chips) 
Seat 6: Rici47 ($45.39 in chips) 
Seat 7: Tonychanman ($22.81 in chips) 
Seat 8: kwkim73 ($35.13 in chips) 
Seat 9: Lasutchik ($33.74 in chips) 
AAAKK777: posts small blind $0.10
xxx Spb xxx: posts big blind $0.25
*** HOLE CARDS ***
Dealt to chiyuki [Qh 2h]
chiyuki: folds 
laurentzu84: folds 
Rici47: folds 
Tonychanman: folds 
kwkim73: folds 
Lasutchik: raises $0.50 to $0.75
DrunkTyphoon: folds 
AAAKK777: calls $0.65
xxx Spb xxx: folds 
*** FLOP *** [Jd 9c Jh]
AAAKK777: checks 
Lasutchik: bets $0.85
AAAKK777: calls $0.85
*** TURN *** [Jd 9c Jh] [9s]
AAAKK777: checks 
Lasutchik: bets $2.30
AAAKK777: raises $2.30 to $4.60
Lasutchik: folds 
Uncalled bet ($2.30) returned to AAAKK777
AAAKK777 collected $7.69 from pot
AAAKK777: doesn't show hand 
AAAKK777 is disconnected 
*** SUMMARY ***
Total pot $8.05 | Rake $0.36 
Board [Jd 9c Jh 9s]
Seat 1: DrunkTyphoon (button) folded before Flop (didn't bet)
Seat 2: AAAKK777 (small blind) collected ($7.69)
Seat 3: xxx Spb xxx (big blind) folded before Flop
Seat 4: chiyuki folded before Flop (didn't bet)
Seat 5: laurentzu84 folded before Flop (didn't bet)
Seat 6: Rici47 folded before Flop (didn't bet)
Seat 7: Tonychanman folded before Flop (didn't bet)
Seat 8: kwkim73 folded before Flop (didn't bet)
Seat 9: Lasutchik folded on the Turn



PokerStars Zoom Hand #84301092435:  Hold'em No Limit ($0.10/$0.25) - 2012/08/05 16:11:42 JST [2012/08/05 3:11:42 ET]
Table 'Whirlpool' 9-max Seat #1 is the button
Seat 1: Alvinpe85 ($103.46 in chips) 
Seat 2: Cripple86 ($29.23 in chips) 
Seat 3: chiyuki ($42.33 in chips) 
Seat 4: GSDP ($28.89 in chips) 
Seat 5: roksmokndonk ($20.05 in chips) 
Seat 6: ivan130 ($28.66 in chips) 
Seat 7: mjmichi ($78.52 in chips) 
Seat 8: kwkim73 ($25 in chips) 
Seat 9: Kasperlmusik ($33.21 in chips) 
Cripple86: posts small blind $0.10
chiyuki: posts big blind $0.25
*** HOLE CARDS ***
Dealt to chiyuki [2d 9d]
GSDP: folds 
roksmokndonk: folds 
ivan130: raises $0.25 to $0.50
mjmichi: folds 
kwkim73: folds 
Kasperlmusik: folds 
Alvinpe85: calls $0.50
Cripple86: folds 
chiyuki: calls $0.25
*** FLOP *** [Js 3c Ks]
chiyuki: checks 
ivan130: checks 
Alvinpe85: bets $1
chiyuki: folds 
ivan130: folds 
Uncalled bet ($1) returned to Alvinpe85
Alvinpe85 collected $1.53 from pot
Alvinpe85: doesn't show hand 
*** SUMMARY ***
Total pot $1.60 | Rake $0.07 
Board [Js 3c Ks]
Seat 1: Alvinpe85 (button) collected ($1.53)
Seat 2: Cripple86 (small blind) folded before Flop
Seat 3: chiyuki (big blind) folded on the Flop
Seat 4: GSDP folded before Flop (didn't bet)
Seat 5: roksmokndonk folded before Flop (didn't bet)
Seat 6: ivan130 folded on the Flop
Seat 7: mjmichi folded before Flop (didn't bet)
Seat 8: kwkim73 folded before Flop (didn't bet)
Seat 9: Kasperlmusik folded before Flop (didn't bet)



PokerStars Zoom Hand #84301110678:  Hold'em No Limit ($0.10/$0.25) - 2012/08/05 16:12:50 JST [2012/08/05 3:12:50 ET]
Table 'Whirlpool' 9-max Seat #1 is the button
Seat 1: Perstenev ($14.93 in chips) 
Seat 2: 1Karina1 ($31.44 in chips) 
Seat 3: nice.franki ($12.50 in chips) 
Seat 4: Vall179 ($28.33 in chips) 
Seat 5: d4dda ($24.65 in chips) 
Seat 6: kesstukas25 ($12.50 in chips) 
Seat 7: DrunkTyphoon ($46.65 in chips) 
Seat 8: scaredsare ($25.78 in chips) 
Seat 9: chiyuki ($41.83 in chips) 
1Karina1: posts small blind $0.10
nice.franki: posts big blind $0.25
*** HOLE CARDS ***
Dealt to chiyuki [7c 9c]
Vall179: folds 
d4dda: folds 
kesstukas25: folds 
DrunkTyphoon: folds 
scaredsare: folds 
chiyuki: folds 
Perstenev: folds 
1Karina1: folds 
Uncalled bet ($0.15) returned to nice.franki
nice.franki collected $0.20 from pot
nice.franki: doesn't show hand 
*** SUMMARY ***
Total pot $0.20 | Rake $0 
Seat 1: Perstenev (button) folded before Flop (didn't bet)
Seat 2: 1Karina1 (small blind) folded before Flop
Seat 3: nice.franki (big blind) collected ($0.20)
Seat 4: Vall179 folded before Flop (didn't bet)
Seat 5: d4dda folded before Flop (didn't bet)
Seat 6: kesstukas25 folded before Flop (didn't bet)
Seat 7: DrunkTyphoon folded before Flop (didn't bet)
Seat 8: scaredsare folded before Flop (didn't bet)
Seat 9: chiyuki folded before Flop (didn't bet)



PokerStars Zoom Hand #84301107417:  Hold'em No Limit ($0.10/$0.25) - 2012/08/05 16:12:37 JST [2012/08/05 3:12:37 ET]
Table 'Whirlpool' 9-max Seat #1 is the button
Seat 1: AntoineHunt ($37.46 in chips) 
Seat 2: CrittHunter ($27.47 in chips) 
Seat 3: Spheroff ($10.30 in chips) 
Seat 4: kwkim73 ($37.40 in chips) 
Seat 5: snejokCoxx ($11.72 in chips) 
Seat 6: Nerkit ($11.90 in chips) 
Seat 7: Grishukps ($18.34 in chips) 
Seat 8: chiyuki ($41.83 in chips) 
Seat 9: Alvinpe85 ($104.49 in chips) 
CrittHunter: posts small blind $0.10
Spheroff: posts big blind $0.25
*** HOLE CARDS ***
Dealt to chiyuki [Ts 6d]
kwkim73: folds 
snejokCoxx: folds 
Nerkit: raises $0.50 to $0.75
Grishukps: folds 
chiyuki: folds 
Alvinpe85: folds 
AntoineHunt: folds 
CrittHunter: folds 
Spheroff: folds 
Uncalled bet ($0.50) returned to Nerkit
Nerkit collected $0.60 from pot
Nerkit: doesn't show hand 
*** SUMMARY ***
Total pot $0.60 | Rake $0 
Seat 1: AntoineHunt (button) folded before Flop (didn't bet)
Seat 2: CrittHunter (small blind) folded before Flop
Seat 3: Spheroff (big blind) folded before Flop
Seat 4: kwkim73 folded before Flop (didn't bet)
Seat 5: snejokCoxx folded before Flop (didn't bet)
Seat 6: Nerkit collected ($0.60)
Seat 7: Grishukps folded before Flop (didn't bet)
Seat 8: chiyuki folded before Flop (didn't bet)
Seat 9: Alvinpe85 folded before Flop (didn't bet)



PokerStars Zoom Hand #84301113656:  Hold'em No Limit ($0.10/$0.25) - 2012/08/05 16:13:01 JST [2012/08/05 3:13:01 ET]
Table 'Whirlpool' 9-max Seat #1 is the button
Seat 1: Serge Claws ($39.31 in chips) 
Seat 2: Alvinpe85 ($28.39 in chips) 
Seat 3: Loholov ($15 in chips) 
Seat 4: Tonychanman ($22.81 in chips) 
Seat 5: Perstenev ($10.50 in chips) 
Seat 6: chiyuki ($41.73 in chips) 
Seat 7: Vall179 ($22.38 in chips) 
Seat 8: Nerkit ($17.40 in chips) 
Seat 9: Cripple86 ($25.84 in chips) 
Alvinpe85: posts small blind $0.10
Loholov: posts big blind $0.25
*** HOLE CARDS ***
Dealt to chiyuki [7s 9s]
Tonychanman: folds 
Perstenev: folds 
chiyuki: folds 
Vall179: folds 
Nerkit: folds 
Cripple86: folds 
Serge Claws: folds 
Alvinpe85: folds 
Uncalled bet ($0.15) returned to Loholov
Loholov collected $0.20 from pot
Loholov: doesn't show hand 
*** SUMMARY ***
Total pot $0.20 | Rake $0 
Seat 1: Serge Claws (button) folded before Flop (didn't bet)
Seat 2: Alvinpe85 (small blind) folded before Flop
Seat 3: Loholov (big blind) collected ($0.20)
Seat 4: Tonychanman folded before Flop (didn't bet)
Seat 5: Perstenev folded before Flop (didn't bet)
Seat 6: chiyuki folded before Flop (didn't bet)
Seat 7: Vall179 folded before Flop (didn't bet)
Seat 8: Nerkit folded before Flop (didn't bet)
Seat 9: Cripple86 folded before Flop (didn't bet)



PokerStars Zoom Hand #84301114764:  Hold'em No Limit ($0.10/$0.25) - 2012/08/05 16:13:05 JST [2012/08/05 3:13:05 ET]
Table 'Whirlpool' 9-max Seat #1 is the button
Seat 1: leo2095 ($25.60 in chips) 
Seat 2: Nerkit ($12.25 in chips) 
Seat 3: kwkim73 ($37.30 in chips) 
Seat 4: DrunkTyphoon ($46.40 in chips) 
Seat 5: Grishukps ($12.50 in chips) 
Seat 6: men1989 ($23.25 in chips) 
Seat 7: chiyuki ($41.73 in chips) 
Seat 8: schoof 2 ($23.93 in chips) 
Seat 9: Perstenev ($10.50 in chips) 
Nerkit: posts small blind $0.10
kwkim73: posts big blind $0.25
*** HOLE CARDS ***
Dealt to chiyuki [9s Td]
DrunkTyphoon: folds 
Grishukps: folds 
men1989: folds 
chiyuki: folds 
schoof 2: folds 
Perstenev: folds 
leo2095: folds 
Nerkit: raises $0.37 to $0.62
kwkim73: folds 
Uncalled bet ($0.37) returned to Nerkit
Nerkit collected $0.50 from pot
Nerkit: doesn't show hand 
*** SUMMARY ***
Total pot $0.50 | Rake $0 
Seat 1: leo2095 (button) folded before Flop (didn't bet)
Seat 2: Nerkit (small blind) collected ($0.50)
Seat 3: kwkim73 (big blind) folded before Flop
Seat 4: DrunkTyphoon folded before Flop (didn't bet)
Seat 5: Grishukps folded before Flop (didn't bet)
Seat 6: men1989 folded before Flop (didn't bet)
Seat 7: chiyuki folded before Flop (didn't bet)
Seat 8: schoof 2 folded before Flop (didn't bet)
Seat 9: Perstenev folded before Flop (didn't bet)



PokerStars Zoom Hand #84301112330:  Hold'em No Limit ($0.10/$0.25) - 2012/08/05 16:12:56 JST [2012/08/05 3:12:56 ET]
Table 'Whirlpool' 9-max Seat #1 is the button
Seat 1: TSAL7 ($21.58 in chips) 
Seat 2: chiyuki ($41.83 in chips) 
Seat 3: Angi858 ($25.44 in chips) 
Seat 4: Loholov ($15 in chips) 
Seat 5: DanielWhyte ($30.97 in chips) 
Seat 6: Tonychanman ($22.81 in chips) 
Seat 7: deepakmbh ($26.11 in chips) 
Seat 8: Perstenev ($12.57 in chips) 
Seat 9: yoube ($71.93 in chips) 
chiyuki: posts small blind $0.10
Angi858: posts big blind $0.25
*** HOLE CARDS ***
Dealt to chiyuki [2c Ks]
Loholov: folds 
DanielWhyte: raises $0.25 to $0.50
Tonychanman: folds 
deepakmbh: folds 
Perstenev: folds 
yoube: folds 
TSAL7: folds 
chiyuki: folds 
Angi858: calls $0.25
*** FLOP *** [9s Jh Tc]
Angi858: checks 
DanielWhyte: bets $0.50
Angi858: raises $3 to $3.50
DanielWhyte: folds 
Uncalled bet ($3) returned to Angi858
Angi858 collected $2.01 from pot
Angi858: doesn't show hand 
*** SUMMARY ***
Total pot $2.10 | Rake $0.09 
Board [9s Jh Tc]
Seat 1: TSAL7 (button) folded before Flop (didn't bet)
Seat 2: chiyuki (small blind) folded before Flop
Seat 3: Angi858 (big blind) collected ($2.01)
Seat 4: Loholov folded before Flop (didn't bet)
Seat 5: DanielWhyte folded on the Flop
Seat 6: Tonychanman folded before Flop (didn't bet)
Seat 7: deepakmbh folded before Flop (didn't bet)
Seat 8: Perstenev folded before Flop (didn't bet)
Seat 9: yoube folded before Flop (didn't bet)



PokerStars Zoom Hand #84301108253:  Hold'em No Limit ($0.10/$0.25) - 2012/08/05 16:12:40 JST [2012/08/05 3:12:40 ET]
Table 'Whirlpool' 9-max Seat #1 is the button
Seat 1: CrittHunter ($27.37 in chips) 
Seat 2: nice.franki ($10.42 in chips) 
Seat 3: Roglus ($8.93 in chips) 
Seat 4: phate-1up ($54.09 in chips) 
Seat 5: silvno31 ($65.27 in chips) 
Seat 6: Cripple86 ($25.70 in chips) 
Seat 7: chiyuki ($41.83 in chips) 
Seat 8: Loholov ($15 in chips) 
Seat 9: poorpoor6551 ($16.28 in chips) 
nice.franki: posts small blind $0.10
Roglus: posts big blind $0.25
*** HOLE CARDS ***
Dealt to chiyuki [Th Kh]
phate-1up: folds 
silvno31: folds 
Cripple86: folds 
chiyuki: folds 
Loholov: folds 
poorpoor6551: folds 
CrittHunter: folds 
nice.franki: raises $0.50 to $0.75
Roglus: calls $0.50
*** FLOP *** [3d 4d 7s]
nice.franki: checks 
Roglus: bets $0.97
nice.franki: raises $2.03 to $3
Roglus: calls $2.03
*** TURN *** [3d 4d 7s] [9c]
nice.franki: bets $6.67 and is all-in
Roglus: calls $5.18 and is all-in
Uncalled bet ($1.49) returned to nice.franki
*** RIVER *** [3d 4d 7s 9c] [Ks]
*** SHOW DOWN ***
nice.franki: shows [As Ad] (a pair of Aces)
Roglus: shows [7h 5s] (a pair of Sevens)
nice.franki collected $17.06 from pot
nice.franki is disconnected 
*** SUMMARY ***
Total pot $17.86 | Rake $0.80 
Board [3d 4d 7s 9c Ks]
Seat 1: CrittHunter (button) folded before Flop (didn't bet)
Seat 2: nice.franki (small blind) showed [As Ad] and won ($17.06) with a pair of Aces
Seat 3: Roglus (big blind) showed [7h 5s] and lost with a pair of Sevens
Seat 4: phate-1up folded before Flop (didn't bet)
Seat 5: silvno31 folded before Flop (didn't bet)
Seat 6: Cripple86 folded before Flop (didn't bet)
Seat 7: chiyuki folded before Flop (didn't bet)
Seat 8: Loholov folded before Flop (didn't bet)
Seat 9: poorpoor6551 folded before Flop (didn't bet)



PokerStars Zoom Hand #84301115806:  Hold'em No Limit ($0.10/$0.25) - 2012/08/05 16:13:09 JST [2012/08/05 3:13:09 ET]
Table 'Whirlpool' 9-max Seat #1 is the button
Seat 1: chiyuki ($41.73 in chips) 
Seat 2: DrunkTyphoon ($46.40 in chips) 
Seat 3: ivan130 ($28.16 in chips) 
Seat 4: GovGus ($28.22 in chips) 
Seat 5: men1989 ($23.25 in chips) 
Seat 6: Cripple86 ($29.23 in chips) 
Seat 7: Alvinpe85 ($28.29 in chips) 
Seat 8: zongo1 ($24.69 in chips) 
Seat 9: leo2095 ($25.60 in chips) 
DrunkTyphoon: posts small blind $0.10
ivan130: posts big blind $0.25
*** HOLE CARDS ***
Dealt to chiyuki [2c 8s]
GovGus: folds 
men1989: folds 
Cripple86: raises $0.50 to $0.75
Alvinpe85: folds 
zongo1: folds 
leo2095: folds 
chiyuki: folds 
DrunkTyphoon: folds 
ivan130: calls $0.50
*** FLOP *** [5h Jh 8d]
ivan130: checks 
Cripple86: bets $1
ivan130: calls $1
*** TURN *** [5h Jh 8d] [5s]
ivan130: checks 
Cripple86: checks 
*** RIVER *** [5h Jh 8d 5s] [4h]
ivan130: checks 
Cripple86: checks 
*** SHOW DOWN ***
ivan130: shows [Qd Td] (a pair of Fives)
Cripple86: shows [9h 9c] (two pair, Nines and Fives)
Cripple86 collected $3.44 from pot
*** SUMMARY ***
Total pot $3.60 | Rake $0.16 
Board [5h Jh 8d 5s 4h]
Seat 1: chiyuki (button) folded before Flop (didn't bet)
Seat 2: DrunkTyphoon (small blind) folded before Flop
Seat 3: ivan130 (big blind) showed [Qd Td] and lost with a pair of Fives
Seat 4: GovGus folded before Flop (didn't bet)
Seat 5: men1989 folded before Flop (didn't bet)
Seat 6: Cripple86 showed [9h 9c] and won ($3.44) with two pair, Nines and Fives
Seat 7: Alvinpe85 folded before Flop (didn't bet)
Seat 8: zongo1 folded before Flop (didn't bet)
Seat 9: leo2095 folded before Flop (didn't bet)



PokerStars Zoom Hand #84301117204:  Hold'em No Limit ($0.10/$0.25) - 2012/08/05 16:13:14 JST [2012/08/05 3:13:14 ET]
Table 'Whirlpool' 9-max Seat #1 is the button
Seat 1: snejokCoxx ($13.08 in chips) 
Seat 2: Serge Claws ($73.83 in chips) 
Seat 3: Perstenev ($10.50 in chips) 
Seat 4: Grishukps ($12.50 in chips) 
Seat 5: kwkim73 ($25 in chips) 
Seat 6: Grumpy as 2 ($12.48 in chips) 
Seat 7: Kozyavkin ($8.18 in chips) 
Seat 8: chiyuki ($41.73 in chips) 
Seat 9: GovGus ($55.05 in chips) 
Serge Claws: posts small blind $0.10
Perstenev: posts big blind $0.25
*** HOLE CARDS ***
Dealt to chiyuki [5c 5d]
Grishukps: folds 
kwkim73: folds 
Grumpy as 2: folds 
Kozyavkin: folds 
chiyuki: raises $0.50 to $0.75
GovGus: raises $1.50 to $2.25
snejokCoxx: folds 
Serge Claws: calls $2.15
Perstenev: folds 
chiyuki: calls $1.50
*** FLOP *** [5h Ts 8c]
Serge Claws: checks 
chiyuki: checks 
GovGus: checks 
*** TURN *** [5h Ts 8c] [6h]
Serge Claws: bets $4
chiyuki: calls $4
GovGus: folds 
*** RIVER *** [5h Ts 8c 6h] [9h]
Serge Claws: checks 
chiyuki: bets $7
Serge Claws: folds 
Uncalled bet ($7) returned to chiyuki
chiyuki collected $14.32 from pot
chiyuki: doesn't show hand 
*** SUMMARY ***
Total pot $15 | Rake $0.68 
Board [5h Ts 8c 6h 9h]
Seat 1: snejokCoxx (button) folded before Flop (didn't bet)
Seat 2: Serge Claws (small blind) folded on the River
Seat 3: Perstenev (big blind) folded before Flop
Seat 4: Grishukps folded before Flop (didn't bet)
Seat 5: kwkim73 folded before Flop (didn't bet)
Seat 6: Grumpy as 2 folded before Flop (didn't bet)
Seat 7: Kozyavkin folded before Flop (didn't bet)
Seat 8: chiyuki collected ($14.32)
Seat 9: GovGus folded on the Turn



PokerStars Zoom Hand #84301137421:  Hold'em No Limit ($0.10/$0.25) - 2012/08/05 16:14:30 JST [2012/08/05 3:14:30 ET]
Table 'Whirlpool' 9-max Seat #1 is the button
Seat 1: men1989 ($22.50 in chips) 
Seat 2: poorpoor6551 ($10.78 in chips) 
Seat 3: TorTrade ($25 in chips) 
Seat 4: chiyuki ($49.80 in chips) 
Seat 5: Limoilou ($31.56 in chips) 
Seat 6: silvno31 ($68.71 in chips) 
Seat 7: pandaaaaaa ($17.91 in chips) 
Seat 8: Loholov ($15 in chips) 
Seat 9: svg51 ($14.65 in chips) 
poorpoor6551: posts small blind $0.10
TorTrade: posts big blind $0.25
*** HOLE CARDS ***
Dealt to chiyuki [9h Qd]
chiyuki: folds 
Limoilou: folds 
silvno31: folds 
pandaaaaaa: folds 
Loholov: folds 
svg51: folds 
men1989: folds 
poorpoor6551: folds 
Uncalled bet ($0.15) returned to TorTrade
TorTrade collected $0.20 from pot
TorTrade: doesn't show hand 
*** SUMMARY ***
Total pot $0.20 | Rake $0 
Seat 1: men1989 (button) folded before Flop (didn't bet)
Seat 2: poorpoor6551 (small blind) folded before Flop
Seat 3: TorTrade (big blind) collected ($0.20)
Seat 4: chiyuki folded before Flop (didn't bet)
Seat 5: Limoilou folded before Flop (didn't bet)
Seat 6: silvno31 folded before Flop (didn't bet)
Seat 7: pandaaaaaa folded before Flop (didn't bet)
Seat 8: Loholov folded before Flop (didn't bet)
Seat 9: svg51 folded before Flop (didn't bet)



PokerStars Zoom Hand #84301139331:  Hold'em No Limit ($0.10/$0.25) - 2012/08/05 16:14:37 JST [2012/08/05 3:14:37 ET]
Table 'Whirlpool' 9-max Seat #1 is the button
Seat 1: Kasperlmusik ($32.56 in chips) 
Seat 2: mjmichi ($25 in chips) 
Seat 3: chiyuki ($49.80 in chips) 
Seat 4: munky3 ($29.04 in chips) 
Seat 5: Grishukps ($13.30 in chips) 
Seat 6: codan23 ($14.03 in chips) 
Seat 7: INSP!RON ($25.96 in chips) 
Seat 8: GovGus ($29.59 in chips) 
Seat 9: Perstenev ($10.15 in chips) 
mjmichi: posts small blind $0.10
chiyuki: posts big blind $0.25
*** HOLE CARDS ***
Dealt to chiyuki [7c Kh]
munky3: folds 
Grishukps: folds 
codan23: folds 
INSP!RON: raises $0.50 to $0.75
GovGus: folds 
Perstenev: folds 
Kasperlmusik: folds 
mjmichi: folds 
chiyuki: folds 
Uncalled bet ($0.50) returned to INSP!RON
INSP!RON collected $0.60 from pot
INSP!RON: doesn't show hand 
*** SUMMARY ***
Total pot $0.60 | Rake $0 
Seat 1: Kasperlmusik (button) folded before Flop (didn't bet)
Seat 2: mjmichi (small blind) folded before Flop
Seat 3: chiyuki (big blind) folded before Flop
Seat 4: munky3 folded before Flop (didn't bet)
Seat 5: Grishukps folded before Flop (didn't bet)
Seat 6: codan23 folded before Flop (didn't bet)
Seat 7: INSP!RON collected ($0.60)
Seat 8: GovGus folded before Flop (didn't bet)
Seat 9: Perstenev folded before Flop (didn't bet)



PokerStars Zoom Hand #84301136095:  Hold'em No Limit ($0.10/$0.25) - 2012/08/05 16:14:25 JST [2012/08/05 3:14:25 ET]
Table 'Whirlpool' 9-max Seat #1 is the button
Seat 1: galaxe ($24 in chips) 
Seat 2: Dejacob ($31.13 in chips) 
Seat 3: Nerkit ($9.32 in chips) 
Seat 4: Blue-GumBum ($14.86 in chips) 
Seat 5: Vall179 ($27.98 in chips) 
Seat 6: chiyuki ($49.80 in chips) 
Seat 7: 1Karina1 ($35.93 in chips) 
Seat 8: pandaaaaaa ($17.91 in chips) 
Seat 9: nice.franki ($12.52 in chips) 
Dejacob: posts small blind $0.10
Nerkit: posts big blind $0.25
*** HOLE CARDS ***
Dealt to chiyuki [3d Jd]
Blue-GumBum: calls $0.25
Vall179: folds 
chiyuki: folds 
1Karina1: folds 
pandaaaaaa: folds 
nice.franki: folds 
galaxe: folds 
Dejacob: folds 
Nerkit: checks 
*** FLOP *** [6h 7s 5d]
Nerkit: checks 
Blue-GumBum: checks 
*** TURN *** [6h 7s 5d] [Qh]
Nerkit: bets $0.25
Blue-GumBum: calls $0.25
*** RIVER *** [6h 7s 5d Qh] [Kd]
Nerkit: bets $0.65
Blue-GumBum: folds 
Uncalled bet ($0.65) returned to Nerkit
Nerkit collected $1.05 from pot
Nerkit: doesn't show hand 
*** SUMMARY ***
Total pot $1.10 | Rake $0.05 
Board [6h 7s 5d Qh Kd]
Seat 1: galaxe (button) folded before Flop (didn't bet)
Seat 2: Dejacob (small blind) folded before Flop
Seat 3: Nerkit (big blind) collected ($1.05)
Seat 4: Blue-GumBum folded on the River
Seat 5: Vall179 folded before Flop (didn't bet)
Seat 6: chiyuki folded before Flop (didn't bet)
Seat 7: 1Karina1 folded before Flop (didn't bet)
Seat 8: pandaaaaaa folded before Flop (didn't bet)
Seat 9: nice.franki folded before Flop (didn't bet)



PokerStars Zoom Hand #84301142648:  Hold'em No Limit ($0.10/$0.25) - 2012/08/05 16:14:49 JST [2012/08/05 3:14:49 ET]
Table 'Whirlpool' 9-max Seat #1 is the button
Seat 1: theo0630 ($11.40 in chips) 
Seat 2: 280128si ($15.15 in chips) 
Seat 3: 4plankton ($4.18 in chips) 
Seat 4: Vall179 ($22.38 in chips) 
Seat 5: Lindikor ($9.78 in chips) 
Seat 6: leo2095 ($26.48 in chips) 
Seat 7: teaser07 ($25.50 in chips) 
Seat 8: deepakmbh ($29.83 in chips) 
Seat 9: chiyuki ($49.55 in chips) 
280128si: posts small blind $0.10
4plankton: posts big blind $0.25
*** HOLE CARDS ***
Dealt to chiyuki [Ad 8h]
Vall179: folds 
Lindikor: folds 
leo2095: folds 
teaser07: folds 
deepakmbh: folds 
chiyuki: folds 
theo0630: folds 
280128si: folds 
Uncalled bet ($0.15) returned to 4plankton
4plankton collected $0.20 from pot
4plankton: doesn't show hand 
*** SUMMARY ***
Total pot $0.20 | Rake $0 
Seat 1: theo0630 (button) folded before Flop (didn't bet)
Seat 2: 280128si (small blind) folded before Flop
Seat 3: 4plankton (big blind) collected ($0.20)
Seat 4: Vall179 folded before Flop (didn't bet)
Seat 5: Lindikor folded before Flop (didn't bet)
Seat 6: leo2095 folded before Flop (didn't bet)
Seat 7: teaser07 folded before Flop (didn't bet)
Seat 8: deepakmbh folded before Flop (didn't bet)
Seat 9: chiyuki folded before Flop (didn't bet)



PokerStars Zoom Hand #84301144038:  Hold'em No Limit ($0.10/$0.25) - 2012/08/05 16:14:54 JST [2012/08/05 3:14:54 ET]
Table 'Whirlpool' 9-max Seat #1 is the button
Seat 1: chiyuki ($49.55 in chips) 
Seat 2: snejokCoxx ($10.88 in chips) 
Seat 3: pandaaaaaa ($17.81 in chips) 
Seat 4: Cripple86 ($32.82 in chips) 
Seat 5: top gun 2950 ($39.51 in chips) 
Seat 6: CrittHunter ($26.50 in chips) 
Seat 7: Alvinpe85 ($28.96 in chips) 
Seat 8: AntoineHunt ($35.86 in chips) 
Seat 9: Perstenev ($14.53 in chips) 
snejokCoxx: posts small blind $0.10
pandaaaaaa: posts big blind $0.25
*** HOLE CARDS ***
Dealt to chiyuki [5s 9c]
Cripple86: folds 
top gun 2950: folds 
CrittHunter: folds 
Alvinpe85: folds 
AntoineHunt: raises $0.50 to $0.75
Perstenev: folds 
chiyuki: folds 
snejokCoxx: folds 
pandaaaaaa: folds 
Uncalled bet ($0.50) returned to AntoineHunt
AntoineHunt collected $0.60 from pot
AntoineHunt: doesn't show hand 
*** SUMMARY ***
Total pot $0.60 | Rake $0 
Seat 1: chiyuki (button) folded before Flop (didn't bet)
Seat 2: snejokCoxx (small blind) folded before Flop
Seat 3: pandaaaaaa (big blind) folded before Flop
Seat 4: Cripple86 folded before Flop (didn't bet)
Seat 5: top gun 2950 folded before Flop (didn't bet)
Seat 6: CrittHunter folded before Flop (didn't bet)
Seat 7: Alvinpe85 folded before Flop (didn't bet)
Seat 8: AntoineHunt collected ($0.60)
Seat 9: Perstenev folded before Flop (didn't bet)



PokerStars Zoom Hand #84301149046:  Hold'em No Limit ($0.10/$0.25) - 2012/08/05 16:15:13 JST [2012/08/05 3:15:13 ET]
Table 'Whirlpool' 9-max Seat #1 is the button
Seat 1: drunk_bender ($28.41 in chips) 
Seat 2: AntoineHunt ($36.21 in chips) 
Seat 3: roksmokndonk ($24.06 in chips) 
Seat 4: Kasperlmusik ($32.21 in chips) 
Seat 5: chiyuki ($49.45 in chips) 
Seat 6: MurMurRu ($41.84 in chips) 
Seat 7: codan23 ($13.93 in chips) 
Seat 8: nice.franki ($2.81 in chips) 
Seat 9: kesstukas25 ($30.01 in chips) 
AntoineHunt: posts small blind $0.10
roksmokndonk: posts big blind $0.25
*** HOLE CARDS ***
Dealt to chiyuki [Ks Jc]
Kasperlmusik: folds 
chiyuki: folds 
MurMurRu: raises $0.42 to $0.67
codan23: folds 
nice.franki: folds 
kesstukas25: folds 
drunk_bender: folds 
AntoineHunt: folds 
roksmokndonk: folds 
Uncalled bet ($0.42) returned to MurMurRu
MurMurRu collected $0.60 from pot
MurMurRu: doesn't show hand 
*** SUMMARY ***
Total pot $0.60 | Rake $0 
Seat 1: drunk_bender (button) folded before Flop (didn't bet)
Seat 2: AntoineHunt (small blind) folded before Flop
Seat 3: roksmokndonk (big blind) folded before Flop
Seat 4: Kasperlmusik folded before Flop (didn't bet)
Seat 5: chiyuki folded before Flop (didn't bet)
Seat 6: MurMurRu collected ($0.60)
Seat 7: codan23 folded before Flop (didn't bet)
Seat 8: nice.franki folded before Flop (didn't bet)
Seat 9: kesstukas25 folded before Flop (didn't bet)



PokerStars Zoom Hand #84301147917:  Hold'em No Limit ($0.10/$0.25) - 2012/08/05 16:15:08 JST [2012/08/05 3:15:08 ET]
Table 'Whirlpool' 9-max Seat #1 is the button
Seat 1: phate-1up ($52.99 in chips) 
Seat 2: mamlind ($14.94 in chips) 
Seat 3: RRMM_again ($26.89 in chips) 
Seat 4: roksmokndonk ($24.06 in chips) 
Seat 5: pandaaaaaa ($17.56 in chips) 
Seat 6: Alvinpe85 ($28.96 in chips) 
Seat 7: chiyuki ($49.45 in chips) 
Seat 8: codan23 ($13.93 in chips) 
Seat 9: DanielWhyte ($29.97 in chips) 
mamlind: posts small blind $0.10
RRMM_again: posts big blind $0.25
*** HOLE CARDS ***
Dealt to chiyuki [3s Kc]
roksmokndonk: folds 
pandaaaaaa: folds 
Alvinpe85: folds 
chiyuki: folds 
codan23: folds 
DanielWhyte: raises $0.25 to $0.50
phate-1up: folds 
mamlind: folds 
RRMM_again: folds 
Uncalled bet ($0.25) returned to DanielWhyte
DanielWhyte collected $0.60 from pot
DanielWhyte: doesn't show hand 
*** SUMMARY ***
Total pot $0.60 | Rake $0 
Seat 1: phate-1up (button) folded before Flop (didn't bet)
Seat 2: mamlind (small blind) folded before Flop
Seat 3: RRMM_again (big blind) folded before Flop
Seat 4: roksmokndonk folded before Flop (didn't bet)
Seat 5: pandaaaaaa folded before Flop (didn't bet)
Seat 6: Alvinpe85 folded before Flop (didn't bet)
Seat 7: chiyuki folded before Flop (didn't bet)
Seat 8: codan23 folded before Flop (didn't bet)
Seat 9: DanielWhyte collected ($0.60)



PokerStars Zoom Hand #84301134983:  Hold'em No Limit ($0.10/$0.25) - 2012/08/05 16:14:21 JST [2012/08/05 3:14:21 ET]
Table 'Whirlpool' 9-max Seat #1 is the button
Seat 1: INSP!RON ($32.55 in chips) 
Seat 2: fil740 ($13.84 in chips) 
Seat 3: 280128si ($15.40 in chips) 
Seat 4: Nerkit ($9.32 in chips) 
Seat 5: chiyuki ($49.80 in chips) 
Seat 6: opie62 ($19.84 in chips) 
Seat 7: Grumpy as 2 ($12.38 in chips) 
Seat 8: Dejacob ($32.28 in chips) 
Seat 9: GovGus ($29.59 in chips) 
fil740: posts small blind $0.10
280128si: posts big blind $0.25
*** HOLE CARDS ***
Dealt to chiyuki [3s 8c]
Nerkit: folds 
chiyuki: folds 
opie62: calls $0.25
Grumpy as 2: folds 
Dejacob: folds 
GovGus: folds 
INSP!RON: raises $0.88 to $1.13
fil740: calls $1.03
280128si: folds 
opie62: calls $0.88
*** FLOP *** [Jd 9h 9d]
fil740: checks 
opie62: checks 
INSP!RON: bets $1.85
fil740: calls $1.85
opie62: folds 
*** TURN *** [Jd 9h 9d] [Ts]
fil740: checks 
INSP!RON: checks 
*** RIVER *** [Jd 9h 9d Ts] [7h]
fil740: bets $1.75
INSP!RON: folds 
Uncalled bet ($1.75) returned to fil740
fil740 collected $7.01 from pot
fil740: doesn't show hand 
*** SUMMARY ***
Total pot $7.34 | Rake $0.33 
Board [Jd 9h 9d Ts 7h]
Seat 1: INSP!RON (button) folded on the River
Seat 2: fil740 (small blind) collected ($7.01)
Seat 3: 280128si (big blind) folded before Flop
Seat 4: Nerkit folded before Flop (didn't bet)
Seat 5: chiyuki folded before Flop (didn't bet)
Seat 6: opie62 folded on the Flop
Seat 7: Grumpy as 2 folded before Flop (didn't bet)
Seat 8: Dejacob folded before Flop (didn't bet)
Seat 9: GovGus folded before Flop (didn't bet)



PokerStars Zoom Hand #84301152029:  Hold'em No Limit ($0.10/$0.25) - 2012/08/05 16:15:24 JST [2012/08/05 3:15:24 ET]
Table 'Whirlpool' 9-max Seat #1 is the button
Seat 1: RRMM_again ($26.64 in chips) 
Seat 2: benjuer ($25 in chips) 
Seat 3: Dejacob ($32.63 in chips) 
Seat 4: Spheroff ($10.65 in chips) 
Seat 5: roksmokndonk ($23.81 in chips) 
Seat 6: chiyuki ($49.45 in chips) 
Seat 7: Faantomace ($34.31 in chips) 
Seat 8: phate-1up ($52.89 in chips) 
Seat 9: theo0630 ($10.55 in chips) 
benjuer: posts small blind $0.10
Dejacob: posts big blind $0.25
*** HOLE CARDS ***
Dealt to chiyuki [2d Jh]
Spheroff: folds 
roksmokndonk: folds 
chiyuki: folds 
Faantomace: folds 
phate-1up: folds 
theo0630: folds 
RRMM_again: folds 
benjuer: folds 
Uncalled bet ($0.15) returned to Dejacob
Dejacob collected $0.20 from pot
Dejacob: doesn't show hand 
*** SUMMARY ***
Total pot $0.20 | Rake $0 
Seat 1: RRMM_again (button) folded before Flop (didn't bet)
Seat 2: benjuer (small blind) folded before Flop
Seat 3: Dejacob (big blind) collected ($0.20)
Seat 4: Spheroff folded before Flop (didn't bet)
Seat 5: roksmokndonk folded before Flop (didn't bet)
Seat 6: chiyuki folded before Flop (didn't bet)
Seat 7: Faantomace folded before Flop (didn't bet)
Seat 8: phate-1up folded before Flop (didn't bet)
Seat 9: theo0630 folded before Flop (didn't bet)



PokerStars Zoom Hand #84301154264:  Hold'em No Limit ($0.10/$0.25) - 2012/08/05 16:15:32 JST [2012/08/05 3:15:32 ET]
Table 'Whirlpool' 9-max Seat #1 is the button
Seat 1: Serge Claws ($40.42 in chips) 
Seat 2: roksmokndonk ($23.81 in chips) 
Seat 3: chiyuki ($49.45 in chips) 
Seat 4: Vall179 ($24.44 in chips) 
Seat 5: Blue-GumBum ($13.61 in chips) 
Seat 6: slapshot2011 ($33.54 in chips) 
Seat 7: 280128si ($15.40 in chips) 
Seat 8: INSP!RON ($29.57 in chips) 
Seat 9: kwkim73 ($46.62 in chips) 
roksmokndonk: posts small blind $0.10
chiyuki: posts big blind $0.25
*** HOLE CARDS ***
Dealt to chiyuki [2d 7c]
Vall179: folds 
Blue-GumBum: folds 
slapshot2011: folds 
280128si: folds 
INSP!RON: folds 
kwkim73: raises $0.50 to $0.75
Serge Claws: folds 
roksmokndonk: folds 
chiyuki: folds 
Uncalled bet ($0.50) returned to kwkim73
kwkim73 collected $0.60 from pot
kwkim73: doesn't show hand 
*** SUMMARY ***
Total pot $0.60 | Rake $0 
Seat 1: Serge Claws (button) folded before Flop (didn't bet)
Seat 2: roksmokndonk (small blind) folded before Flop
Seat 3: chiyuki (big blind) folded before Flop
Seat 4: Vall179 folded before Flop (didn't bet)
Seat 5: Blue-GumBum folded before Flop (didn't bet)
Seat 6: slapshot2011 folded before Flop (didn't bet)
Seat 7: 280128si folded before Flop (didn't bet)
Seat 8: INSP!RON folded before Flop (didn't bet)
Seat 9: kwkim73 collected ($0.60)



PokerStars Zoom Hand #84301145121:  Hold'em No Limit ($0.10/$0.25) - 2012/08/05 16:14:58 JST [2012/08/05 3:14:58 ET]
Table 'Whirlpool' 9-max Seat #1 is the button
Seat 1: scaredsare ($21.45 in chips) 
Seat 2: codan23 ($14.03 in chips) 
Seat 3: Cripple86 ($32.82 in chips) 
Seat 4: Grishukps ($13.65 in chips) 
Seat 5: CrittHunter ($26.50 in chips) 
Seat 6: nice.franki ($12.52 in chips) 
Seat 7: 1Karina1 ($35.68 in chips) 
Seat 8: chiyuki ($49.55 in chips) 
Seat 9: top gun 2950 ($39.51 in chips) 
codan23: posts small blind $0.10
Cripple86: posts big blind $0.25
*** HOLE CARDS ***
Dealt to chiyuki [4s Tc]
Grishukps: folds 
CrittHunter: folds 
nice.franki: folds 
1Karina1: raises $0.50 to $0.75
chiyuki: folds 
top gun 2950: folds 
scaredsare: calls $0.75
codan23: folds 
Cripple86: calls $0.50
*** FLOP *** [2h 8h 8c]
Cripple86: checks 
1Karina1: bets $1.25
scaredsare: calls $1.25
Cripple86: folds 
*** TURN *** [2h 8h 8c] [6s]
1Karina1: checks 
scaredsare: bets $3.50
1Karina1: folds 
Uncalled bet ($3.50) returned to scaredsare
scaredsare collected $4.63 from pot
scaredsare: doesn't show hand 
*** SUMMARY ***
Total pot $4.85 | Rake $0.22 
Board [2h 8h 8c 6s]
Seat 1: scaredsare (button) collected ($4.63)
Seat 2: codan23 (small blind) folded before Flop
Seat 3: Cripple86 (big blind) folded on the Flop
Seat 4: Grishukps folded before Flop (didn't bet)
Seat 5: CrittHunter folded before Flop (didn't bet)
Seat 6: nice.franki folded before Flop (didn't bet)
Seat 7: 1Karina1 folded on the Turn
Seat 8: chiyuki folded before Flop (didn't bet)
Seat 9: top gun 2950 folded before Flop (didn't bet)



PokerStars Zoom Hand #84301150120:  Hold'em No Limit ($0.10/$0.25) - 2012/08/05 16:15:17 JST [2012/08/05 3:15:17 ET]
Table 'Whirlpool' 9-max Seat #1 is the button
Seat 1: kwkim73 ($46.62 in chips) 
Seat 2: Ellen1947 ($22.01 in chips) 
Seat 3: svg51 ($13.65 in chips) 
Seat 4: Ih8niknames ($20 in chips) 
Seat 5: chiyuki ($49.45 in chips) 
Seat 6: codan23 ($13.93 in chips) 
Seat 7: deepakmbh ($29.83 in chips) 
Seat 8: Dejacob ($32.63 in chips) 
Seat 9: Loholov ($15 in chips) 
Ellen1947: posts small blind $0.10
svg51: posts big blind $0.25
*** HOLE CARDS ***
Dealt to chiyuki [Qc 4s]
Ih8niknames: folds 
chiyuki: folds 
codan23: raises $0.37 to $0.62
deepakmbh: folds 
Dejacob: folds 
Loholov: folds 
kwkim73: folds 
Ellen1947: calls $0.52
svg51: folds 
*** FLOP *** [3d Ks 5s]
Ellen1947: checks 
codan23: bets $0.85
Ellen1947: raises $1.56 to $2.41
codan23: folds 
Uncalled bet ($1.56) returned to Ellen1947
Ellen1947 collected $3.05 from pot
Ellen1947: doesn't show hand 
*** SUMMARY ***
Total pot $3.19 | Rake $0.14 
Board [3d Ks 5s]
Seat 1: kwkim73 (button) folded before Flop (didn't bet)
Seat 2: Ellen1947 (small blind) collected ($3.05)
Seat 3: svg51 (big blind) folded before Flop
Seat 4: Ih8niknames folded before Flop (didn't bet)
Seat 5: chiyuki folded before Flop (didn't bet)
Seat 6: codan23 folded on the Flop
Seat 7: deepakmbh folded before Flop (didn't bet)
Seat 8: Dejacob folded before Flop (didn't bet)
Seat 9: Loholov folded before Flop (didn't bet)



PokerStars Zoom Hand #84301146566:  Hold'em No Limit ($0.10/$0.25) - 2012/08/05 16:15:03 JST [2012/08/05 3:15:03 ET]
Table 'Whirlpool' 9-max Seat #1 is the button
Seat 1: Nerkit ($9.87 in chips) 
Seat 2: chiyuki ($49.55 in chips) 
Seat 3: Wolfgang03 ($25 in chips) 
Seat 4: xxx Spb xxx ($28.82 in chips) 
Seat 5: mamlind ($14.94 in chips) 
Seat 6: PAMBOS.L ($21.29 in chips) 
Seat 7: GovGus ($45.74 in chips) 
Seat 8: kwkim73 ($34.16 in chips) 
Seat 9: Kozyavkin ($7.58 in chips) 
chiyuki: posts small blind $0.10
Wolfgang03: posts big blind $0.25
*** HOLE CARDS ***
Dealt to chiyuki [Js 2c]
xxx Spb xxx: folds 
mamlind: folds 
PAMBOS.L: folds 
GovGus: raises $0.75 to $1
kwkim73: folds 
Kozyavkin: folds 
Nerkit: folds 
chiyuki: folds 
Wolfgang03: calls $0.75
*** FLOP *** [7d Qs 3h]
Wolfgang03 is disconnected 
Wolfgang03 is connected 
Wolfgang03: checks 
GovGus: bets $1.25
Wolfgang03: folds 
Uncalled bet ($1.25) returned to GovGus
GovGus collected $2.01 from pot
GovGus: doesn't show hand 
*** SUMMARY ***
Total pot $2.10 | Rake $0.09 
Board [7d Qs 3h]
Seat 1: Nerkit (button) folded before Flop (didn't bet)
Seat 2: chiyuki (small blind) folded before Flop
Seat 3: Wolfgang03 (big blind) folded on the Flop
Seat 4: xxx Spb xxx folded before Flop (didn't bet)
Seat 5: mamlind folded before Flop (didn't bet)
Seat 6: PAMBOS.L folded before Flop (didn't bet)
Seat 7: GovGus collected ($2.01)
Seat 8: kwkim73 folded before Flop (didn't bet)
Seat 9: Kozyavkin folded before Flop (didn't bet)



PokerStars Zoom Hand #84301161686:  Hold'em No Limit ($0.10/$0.25) - 2012/08/05 16:15:59 JST [2012/08/05 3:15:59 ET]
Table 'Whirlpool' 9-max Seat #1 is the button
Seat 1: Cripple86 ($31.97 in chips) 
Seat 2: Patient90122 ($28.82 in chips) 
Seat 3: kwkim73 ($34.06 in chips) 
Seat 4: Serge Claws ($26.77 in chips) 
Seat 5: GovGus ($25 in chips) 
Seat 6: munky3 ($28.44 in chips) 
Seat 7: Spheroff ($10.40 in chips) 
Seat 8: 1Karina1 ($66.89 in chips) 
Seat 9: chiyuki ($49.10 in chips) 
Patient90122: posts small blind $0.10
kwkim73: posts big blind $0.25
*** HOLE CARDS ***
Dealt to chiyuki [2s Ks]
Serge Claws: folds 
GovGus: folds 
munky3: folds 
Spheroff: raises $0.50 to $0.75
1Karina1: folds 
chiyuki: folds 
Cripple86: folds 
Patient90122: folds 
kwkim73: folds 
Uncalled bet ($0.50) returned to Spheroff
Spheroff collected $0.60 from pot
Spheroff: doesn't show hand 
*** SUMMARY ***
Total pot $0.60 | Rake $0 
Seat 1: Cripple86 (button) folded before Flop (didn't bet)
Seat 2: Patient90122 (small blind) folded before Flop
Seat 3: kwkim73 (big blind) folded before Flop
Seat 4: Serge Claws folded before Flop (didn't bet)
Seat 5: GovGus folded before Flop (didn't bet)
Seat 6: munky3 folded before Flop (didn't bet)
Seat 7: Spheroff collected ($0.60)
Seat 8: 1Karina1 folded before Flop (didn't bet)
Seat 9: chiyuki folded before Flop (didn't bet)



PokerStars Zoom Hand #84301163868:  Hold'em No Limit ($0.10/$0.25) - 2012/08/05 16:16:07 JST [2012/08/05 3:16:07 ET]
Table 'Whirlpool' 9-max Seat #1 is the button
Seat 1: Vall179 ($28.33 in chips) 
Seat 2: silvno31 ($67.74 in chips) 
Seat 3: .7.DanDan.7. ($16.47 in chips) 
Seat 4: chiyuki ($49.10 in chips) 
Seat 5: loszavera ($29.46 in chips) 
Seat 6: Loholov ($18.12 in chips) 
Seat 7: kesstukas25 ($29.26 in chips) 
Seat 8: Kasperlmusik ($31.36 in chips) 
Seat 9: Patient90122 ($28.72 in chips) 
silvno31: posts small blind $0.10
.7.DanDan.7.: posts big blind $0.25
*** HOLE CARDS ***
Dealt to chiyuki [5h Jc]
chiyuki: folds 
loszavera: folds 
Loholov: folds 
kesstukas25: folds 
Kasperlmusik: folds 
Patient90122: folds 
Vall179: folds 
silvno31: folds 
Uncalled bet ($0.15) returned to .7.DanDan.7.
.7.DanDan.7. collected $0.20 from pot
.7.DanDan.7.: doesn't show hand 
*** SUMMARY ***
Total pot $0.20 | Rake $0 
Seat 1: Vall179 (button) folded before Flop (didn't bet)
Seat 2: silvno31 (small blind) folded before Flop
Seat 3: .7.DanDan.7. (big blind) collected ($0.20)
Seat 4: chiyuki folded before Flop (didn't bet)
Seat 5: loszavera folded before Flop (didn't bet)
Seat 6: Loholov folded before Flop (didn't bet)
Seat 7: kesstukas25 folded before Flop (didn't bet)
Seat 8: Kasperlmusik folded before Flop (didn't bet)
Seat 9: Patient90122 folded before Flop (didn't bet)



PokerStars Zoom Hand #84301162813:  Hold'em No Limit ($0.10/$0.25) - 2012/08/05 16:16:03 JST [2012/08/05 3:16:03 ET]
Table 'Whirlpool' 9-max Seat #1 is the button
Seat 1: chiyuki ($49.10 in chips) 
Seat 2: Serge Claws ($65.08 in chips) 
Seat 3: deepakmbh ($31.37 in chips) 
Seat 4: 1Karina1 ($33.68 in chips) 
Seat 5: Ellen1947 ($23.59 in chips) 
Seat 6: 19MJJ21 ($16.20 in chips) 
Seat 7: Patient90122 ($28.72 in chips) 
Seat 8: laurentzu84 ($41.72 in chips) 
Seat 9: nice.franki ($12.17 in chips) 
Serge Claws: posts small blind $0.10
deepakmbh: posts big blind $0.25
*** HOLE CARDS ***
Dealt to chiyuki [3s Qs]
1Karina1: folds 
Ellen1947: folds 
19MJJ21: raises $0.45 to $0.70
Patient90122: folds 
laurentzu84: folds 
nice.franki: folds 
chiyuki: folds 
Serge Claws: folds 
deepakmbh: folds 
Uncalled bet ($0.45) returned to 19MJJ21
19MJJ21 collected $0.60 from pot
19MJJ21: doesn't show hand 
*** SUMMARY ***
Total pot $0.60 | Rake $0 
Seat 1: chiyuki (button) folded before Flop (didn't bet)
Seat 2: Serge Claws (small blind) folded before Flop
Seat 3: deepakmbh (big blind) folded before Flop
Seat 4: 1Karina1 folded before Flop (didn't bet)
Seat 5: Ellen1947 folded before Flop (didn't bet)
Seat 6: 19MJJ21 collected ($0.60)
Seat 7: Patient90122 folded before Flop (didn't bet)
Seat 8: laurentzu84 folded before Flop (didn't bet)
Seat 9: nice.franki folded before Flop (didn't bet)



PokerStars Zoom Hand #84301165560:  Hold'em No Limit ($0.10/$0.25) - 2012/08/05 16:16:13 JST [2012/08/05 3:16:13 ET]
Table 'Whirlpool' 9-max Seat #1 is the button
Seat 1: Grumpy as 2 ($10.88 in chips) 
Seat 2: 1Karina1 ($33.68 in chips) 
Seat 3: d4dda ($20.20 in chips) 
Seat 4: 280128si ($15.05 in chips) 
Seat 5: poorpoor6551 ($11.38 in chips) 
Seat 6: GovGus ($40.31 in chips) 
Seat 7: chiyuki ($49.10 in chips) 
Seat 8: svg51 ($13.30 in chips) 
Seat 9: Vall179 ($37.75 in chips) 
1Karina1: posts small blind $0.10
d4dda: posts big blind $0.25
*** HOLE CARDS ***
Dealt to chiyuki [4d Td]
280128si: folds 
poorpoor6551: folds 
GovGus: folds 
chiyuki: folds 
svg51: folds 
Vall179: folds 
Grumpy as 2: folds 
1Karina1: raises $0.50 to $0.75
d4dda: folds 
Uncalled bet ($0.50) returned to 1Karina1
1Karina1 collected $0.50 from pot
1Karina1: doesn't show hand 
*** SUMMARY ***
Total pot $0.50 | Rake $0 
Seat 1: Grumpy as 2 (button) folded before Flop (didn't bet)
Seat 2: 1Karina1 (small blind) collected ($0.50)
Seat 3: d4dda (big blind) folded before Flop
Seat 4: 280128si folded before Flop (didn't bet)
Seat 5: poorpoor6551 folded before Flop (didn't bet)
Seat 6: GovGus folded before Flop (didn't bet)
Seat 7: chiyuki folded before Flop (didn't bet)
Seat 8: svg51 folded before Flop (didn't bet)
Seat 9: Vall179 folded before Flop (didn't bet)



PokerStars Zoom Hand #84301166371:  Hold'em No Limit ($0.10/$0.25) - 2012/08/05 16:16:16 JST [2012/08/05 3:16:16 ET]
Table 'Whirlpool' 9-max Seat #1 is the button
Seat 1: Ih8niknames ($20 in chips) 
Seat 2: top gun 2950 ($38.16 in chips) 
Seat 3: men1989 ($25 in chips) 
Seat 4: loszavera ($29.46 in chips) 
Seat 5: Patient90122 ($28.72 in chips) 
Seat 6: seula i ($39.70 in chips) 
Seat 7: Kasperlmusik ($31.36 in chips) 
Seat 8: chiyuki ($49.10 in chips) 
Seat 9: Dejacob ($32.63 in chips) 
top gun 2950: posts small blind $0.10
men1989: posts big blind $0.25
*** HOLE CARDS ***
Dealt to chiyuki [Ad 6d]
loszavera: folds 
Patient90122: folds 
seula i: folds 
Kasperlmusik: folds 
chiyuki: folds 
Dejacob: folds 
Ih8niknames: folds 
top gun 2950: folds 
Uncalled bet ($0.15) returned to men1989
men1989 collected $0.20 from pot
men1989: doesn't show hand 
*** SUMMARY ***
Total pot $0.20 | Rake $0 
Seat 1: Ih8niknames (button) folded before Flop (didn't bet)
Seat 2: top gun 2950 (small blind) folded before Flop
Seat 3: men1989 (big blind) collected ($0.20)
Seat 4: loszavera folded before Flop (didn't bet)
Seat 5: Patient90122 folded before Flop (didn't bet)
Seat 6: seula i folded before Flop (didn't bet)
Seat 7: Kasperlmusik folded before Flop (didn't bet)
Seat 8: chiyuki folded before Flop (didn't bet)
Seat 9: Dejacob folded before Flop (didn't bet)



PokerStars Zoom Hand #84301167454:  Hold'em No Limit ($0.10/$0.25) - 2012/08/05 16:16:20 JST [2012/08/05 3:16:20 ET]
Table 'Whirlpool' 9-max Seat #1 is the button
Seat 1: loszavera ($29.46 in chips) 
Seat 2: Nerkit ($11.08 in chips) 
Seat 3: Kasperlmusik ($31.36 in chips) 
Seat 4: chiyuki ($49.10 in chips) 
Seat 5: Dejacob ($29.72 in chips) 
Seat 6: INSP!RON ($29.22 in chips) 
Seat 7: 4plankton ($3.83 in chips) 
Seat 8: teaser07 ($25.78 in chips) 
Seat 9: soul_5577 ($35.58 in chips) 
Nerkit: posts small blind $0.10
Kasperlmusik: posts big blind $0.25
*** HOLE CARDS ***
Dealt to chiyuki [9c Ks]
chiyuki: folds 
Dejacob: raises $0.50 to $0.75
INSP!RON: folds 
4plankton: folds 
teaser07: folds 
soul_5577: folds 
loszavera: folds 
Nerkit: folds 
Kasperlmusik: folds 
Uncalled bet ($0.50) returned to Dejacob
Dejacob collected $0.60 from pot
Dejacob: doesn't show hand 
*** SUMMARY ***
Total pot $0.60 | Rake $0 
Seat 1: loszavera (button) folded before Flop (didn't bet)
Seat 2: Nerkit (small blind) folded before Flop
Seat 3: Kasperlmusik (big blind) folded before Flop
Seat 4: chiyuki folded before Flop (didn't bet)
Seat 5: Dejacob collected ($0.60)
Seat 6: INSP!RON folded before Flop (didn't bet)
Seat 7: 4plankton folded before Flop (didn't bet)
Seat 8: teaser07 folded before Flop (didn't bet)
Seat 9: soul_5577 folded before Flop (didn't bet)



PokerStars Zoom Hand #84301157568:  Hold'em No Limit ($0.10/$0.25) - 2012/08/05 16:15:44 JST [2012/08/05 3:15:44 ET]
Table 'Whirlpool' 9-max Seat #1 is the button
Seat 1: opie62 ($19.46 in chips) 
Seat 2: chiyuki ($49.20 in chips) 
Seat 3: olligol123 ($25 in chips) 
Seat 4: theo0630 ($10.55 in chips) 
Seat 5: Kasperlmusik ($31.46 in chips) 
Seat 6: RRMM_again ($26.64 in chips) 
Seat 7: kwkim73 ($34.06 in chips) 
Seat 8: loszavera ($29.46 in chips) 
Seat 9: masterkoolb ($13.20 in chips) 
chiyuki: posts small blind $0.10
olligol123: posts big blind $0.25
*** HOLE CARDS ***
Dealt to chiyuki [7s 6s]
theo0630: folds 
Kasperlmusik: folds 
RRMM_again: raises $0.25 to $0.50
kwkim73: folds 
loszavera: folds 
masterkoolb: folds 
opie62: calls $0.50
chiyuki: folds 
olligol123: calls $0.25
*** FLOP *** [8d 8c 3s]
olligol123: checks 
RRMM_again: checks 
opie62: checks 
*** TURN *** [8d 8c 3s] [7h]
olligol123: bets $1.25
RRMM_again: folds 
opie62: folds 
Uncalled bet ($1.25) returned to olligol123
olligol123 collected $1.53 from pot
olligol123: doesn't show hand 
*** SUMMARY ***
Total pot $1.60 | Rake $0.07 
Board [8d 8c 3s 7h]
Seat 1: opie62 (button) folded on the Turn
Seat 2: chiyuki (small blind) folded before Flop
Seat 3: olligol123 (big blind) collected ($1.53)
Seat 4: theo0630 folded before Flop (didn't bet)
Seat 5: Kasperlmusik folded before Flop (didn't bet)
Seat 6: RRMM_again folded on the Turn
Seat 7: kwkim73 folded before Flop (didn't bet)
Seat 8: loszavera folded before Flop (didn't bet)
Seat 9: masterkoolb folded before Flop (didn't bet)



PokerStars Zoom Hand #84301169170:  Hold'em No Limit ($0.10/$0.25) - 2012/08/05 16:16:27 JST [2012/08/05 3:16:27 ET]
Table 'Whirlpool' 9-max Seat #1 is the button
Seat 1: nice.franki ($3.81 in chips) 
Seat 2: masterkoolb ($12.50 in chips) 
Seat 3: Loholov ($15 in chips) 
Seat 4: chiyuki ($49.10 in chips) 
Seat 5: INSP!RON ($29.22 in chips) 
Seat 6: wildy29 ($106.33 in chips) 
Seat 7: MurMurRu ($25.93 in chips) 
Seat 8: benjuer ($25 in chips) 
Seat 9: hldtom ($21.80 in chips) 
masterkoolb: posts small blind $0.10
Loholov: posts big blind $0.25
*** HOLE CARDS ***
Dealt to chiyuki [Kd 9h]
chiyuki: folds 
INSP!RON: folds 
wildy29: calls $0.25
MurMurRu: folds 
benjuer: folds 
hldtom: folds 
nice.franki: folds 
masterkoolb: calls $0.15
Loholov: checks 
*** FLOP *** [Qs 3s 5h]
masterkoolb: bets $0.50
Loholov: calls $0.50
wildy29: calls $0.50
*** TURN *** [Qs 3s 5h] [4d]
masterkoolb: checks 
Loholov: checks 
wildy29: bets $0.50
masterkoolb: calls $0.50
Loholov: calls $0.50
*** RIVER *** [Qs 3s 5h 4d] [7s]
masterkoolb: checks 
Loholov: checks 
wildy29: bets $1.25
masterkoolb: folds 
Loholov: calls $1.25
*** SHOW DOWN ***
wildy29: shows [6h 6c] (a straight, Three to Seven)
Loholov: mucks hand 
wildy29 collected $5.97 from pot
*** SUMMARY ***
Total pot $6.25 | Rake $0.28 
Board [Qs 3s 5h 4d 7s]
Seat 1: nice.franki (button) folded before Flop (didn't bet)
Seat 2: masterkoolb (small blind) folded on the River
Seat 3: Loholov (big blind) mucked [Qd Jd]
Seat 4: chiyuki folded before Flop (didn't bet)
Seat 5: INSP!RON folded before Flop (didn't bet)
Seat 6: wildy29 showed [6h 6c] and won ($5.97) with a straight, Three to Seven
Seat 7: MurMurRu folded before Flop (didn't bet)
Seat 8: benjuer folded before Flop (didn't bet)
Seat 9: hldtom folded before Flop (didn't bet)



PokerStars Zoom Hand #84301169981:  Hold'em No Limit ($0.10/$0.25) - 2012/08/05 16:16:30 JST [2012/08/05 3:16:30 ET]
Table 'Whirlpool' 9-max Seat #1 is the button
Seat 1: benjuer ($25.10 in chips) 
Seat 2: Cripple86 ($25 in chips) 
Seat 3: chiyuki ($49.10 in chips) 
Seat 4: Vall179 ($28.33 in chips) 
Seat 5: INSP!RON ($34.49 in chips) 
Seat 6: Grumpy as 2 ($10.88 in chips) 
Seat 7: hldtom ($35.15 in chips) 
Seat 8: kwkim73 ($47.07 in chips) 
Seat 9: Nerkit ($10.98 in chips) 
Cripple86: posts small blind $0.10
chiyuki: posts big blind $0.25
*** HOLE CARDS ***
Dealt to chiyuki [7d 8c]
Vall179: folds 
INSP!RON: folds 
Grumpy as 2: calls $0.25
hldtom: folds 
kwkim73: folds 
Nerkit: folds 
benjuer: folds 
Cripple86: calls $0.15
chiyuki: checks 
*** FLOP *** [Js Jh 7s]
Cripple86: checks 
chiyuki: checks 
Grumpy as 2: bets $0.25
Cripple86: folds 
chiyuki: calls $0.25
*** TURN *** [Js Jh 7s] [2h]
chiyuki: checks 
Grumpy as 2: checks 
*** RIVER *** [Js Jh 7s 2h] [Ac]
chiyuki: checks 
Grumpy as 2: checks 
*** SHOW DOWN ***
chiyuki: shows [7d 8c] (two pair, Jacks and Sevens)
Grumpy as 2: mucks hand 
chiyuki collected $1.19 from pot
*** SUMMARY ***
Total pot $1.25 | Rake $0.06 
Board [Js Jh 7s 2h Ac]
Seat 1: benjuer (button) folded before Flop (didn't bet)
Seat 2: Cripple86 (small blind) folded on the Flop
Seat 3: chiyuki (big blind) showed [7d 8c] and won ($1.19) with two pair, Jacks and Sevens
Seat 4: Vall179 folded before Flop (didn't bet)
Seat 5: INSP!RON folded before Flop (didn't bet)
Seat 6: Grumpy as 2 mucked [9d Qd]
Seat 7: hldtom folded before Flop (didn't bet)
Seat 8: kwkim73 folded before Flop (didn't bet)
Seat 9: Nerkit folded before Flop (didn't bet)



PokerStars Zoom Hand #84301184858:  Hold'em No Limit ($0.10/$0.25) - 2012/08/05 16:17:24 JST [2012/08/05 3:17:24 ET]
Table 'Whirlpool' 9-max Seat #1 is the button
Seat 1: Dejacob ($28.63 in chips) 
Seat 2: Grishukps ($16.32 in chips) 
Seat 3: MurMurRu ($41.84 in chips) 
Seat 4: 1Karina1 ($66.54 in chips) 
Seat 5: loszavera ($28.86 in chips) 
Seat 6: nice.franki ($12.28 in chips) 
Seat 7: Angi858 ($25.47 in chips) 
Seat 8: GSDP ($24.50 in chips) 
Seat 9: chiyuki ($49.79 in chips) 
Grishukps: posts small blind $0.10
MurMurRu: posts big blind $0.25
*** HOLE CARDS ***
Dealt to chiyuki [Ac Ad]
1Karina1: raises $0.50 to $0.75
loszavera: folds 
nice.franki: folds 
Angi858: folds 
GSDP: folds 
chiyuki: raises $1.50 to $2.25
Dejacob: folds 
Grishukps: folds 
MurMurRu: folds 
1Karina1: calls $1.50
*** FLOP *** [8s 4s 3d]
1Karina1: checks 
chiyuki: bets $3.75
1Karina1: calls $3.75
*** TURN *** [8s 4s 3d] [3c]
1Karina1: checks 
chiyuki: bets $9.75
1Karina1: folds 
Uncalled bet ($9.75) returned to chiyuki
chiyuki collected $11.79 from pot
chiyuki: doesn't show hand 
*** SUMMARY ***
Total pot $12.35 | Rake $0.56 
Board [8s 4s 3d 3c]
Seat 1: Dejacob (button) folded before Flop (didn't bet)
Seat 2: Grishukps (small blind) folded before Flop
Seat 3: MurMurRu (big blind) folded before Flop
Seat 4: 1Karina1 folded on the Turn
Seat 5: loszavera folded before Flop (didn't bet)
Seat 6: nice.franki folded before Flop (didn't bet)
Seat 7: Angi858 folded before Flop (didn't bet)
Seat 8: GSDP folded before Flop (didn't bet)
Seat 9: chiyuki collected ($11.79)



PokerStars Zoom Hand #84301205096:  Hold'em No Limit ($0.10/$0.25) - 2012/08/05 16:18:38 JST [2012/08/05 3:18:38 ET]
Table 'Whirlpool' 9-max Seat #1 is the button
Seat 1: teaser07 ($26.77 in chips) 
Seat 2: mungroo ($23.65 in chips) 
Seat 3: Bondvsta ($26.30 in chips) 
Seat 4: kwkim73 ($45.22 in chips) 
Seat 5: <BlaaKKnite> ($24.25 in chips) 
Seat 6: chiyuki ($55.58 in chips) 
Seat 7: Dejacob ($35.89 in chips) 
Seat 8: nice.franki ($12.63 in chips) 
Seat 9: FoRlan77 ($25.10 in chips) 
mungroo: posts small blind $0.10
Bondvsta: posts big blind $0.25
*** HOLE CARDS ***
Dealt to chiyuki [2s 4d]
kwkim73: folds 
<BlaaKKnite>: folds 
chiyuki: folds 
Dejacob: folds 
nice.franki: folds 
FoRlan77: folds 
teaser07 has timed out
teaser07: folds 
mungroo: folds 
Uncalled bet ($0.15) returned to Bondvsta
Bondvsta collected $0.20 from pot
Bondvsta: doesn't show hand 
*** SUMMARY ***
Total pot $0.20 | Rake $0 
Seat 1: teaser07 (button) folded before Flop (didn't bet)
Seat 2: mungroo (small blind) folded before Flop
Seat 3: Bondvsta (big blind) collected ($0.20)
Seat 4: kwkim73 folded before Flop (didn't bet)
Seat 5: <BlaaKKnite> folded before Flop (didn't bet)
Seat 6: chiyuki folded before Flop (didn't bet)
Seat 7: Dejacob folded before Flop (didn't bet)
Seat 8: nice.franki folded before Flop (didn't bet)
Seat 9: FoRlan77 folded before Flop (didn't bet)



PokerStars Zoom Hand #84301203477:  Hold'em No Limit ($0.10/$0.25) - 2012/08/05 16:18:32 JST [2012/08/05 3:18:32 ET]
Table 'Whirlpool' 9-max Seat #1 is the button
Seat 1: scaredsare ($26.99 in chips) 
Seat 2: Nerkit ($15.17 in chips) 
Seat 3: xxx Spb xxx ($34.11 in chips) 
Seat 4: yoube ($99.03 in chips) 
Seat 5: codan23 ($13.60 in chips) 
Seat 6: FoRlan77 ($25.10 in chips) 
Seat 7: chiyuki ($55.58 in chips) 
Seat 8: d4dda ($24.65 in chips) 
Seat 9: hldtom ($18.21 in chips) 
Nerkit: posts small blind $0.10
xxx Spb xxx: posts big blind $0.25
*** HOLE CARDS ***
Dealt to chiyuki [5h Jc]
yoube: folds 
codan23: raises $0.25 to $0.50
FoRlan77: folds 
chiyuki: folds 
d4dda: folds 
hldtom: folds 
scaredsare: calls $0.50
Nerkit: folds 
xxx Spb xxx: folds 
*** FLOP *** [6c Ac Jh]
codan23: checks 
scaredsare: checks 
*** TURN *** [6c Ac Jh] [2h]
codan23: checks 
scaredsare: checks 
*** RIVER *** [6c Ac Jh 2h] [4h]
codan23: checks 
scaredsare: checks 
*** SHOW DOWN ***
codan23: shows [9s Qs] (high card Ace)
scaredsare: shows [Qh Js] (a pair of Jacks)
scaredsare collected $1.29 from pot
*** SUMMARY ***
Total pot $1.35 | Rake $0.06 
Board [6c Ac Jh 2h 4h]
Seat 1: scaredsare (button) showed [Qh Js] and won ($1.29) with a pair of Jacks
Seat 2: Nerkit (small blind) folded before Flop
Seat 3: xxx Spb xxx (big blind) folded before Flop
Seat 4: yoube folded before Flop (didn't bet)
Seat 5: codan23 showed [9s Qs] and lost with high card Ace
Seat 6: FoRlan77 folded before Flop (didn't bet)
Seat 7: chiyuki folded before Flop (didn't bet)
Seat 8: d4dda folded before Flop (didn't bet)
Seat 9: hldtom folded before Flop (didn't bet)



PokerStars Zoom Hand #84301206492:  Hold'em No Limit ($0.10/$0.25) - 2012/08/05 16:18:43 JST [2012/08/05 3:18:43 ET]
Table 'Whirlpool' 9-max Seat #1 is the button
Seat 1: nice.franki ($11.80 in chips) 
Seat 2: chiyuki ($55.58 in chips) 
Seat 3: AAT Shark ($12.50 in chips) 
Seat 4: Vall179 ($31.29 in chips) 
Seat 5: Nerkit ($10.73 in chips) 
Seat 6: GSDP ($34.07 in chips) 
Seat 7: kwkim73 ($45.22 in chips) 
Seat 8: olligol123 ($26.01 in chips) 
Seat 9: Loholov ($15 in chips) 
chiyuki: posts small blind $0.10
AAT Shark: posts big blind $0.25
*** HOLE CARDS ***
Dealt to chiyuki [Td Tc]
Vall179: folds 
Nerkit: folds 
GSDP: raises $0.50 to $0.75
kwkim73: folds 
olligol123: folds 
Loholov: folds 
nice.franki: folds 
chiyuki: calls $0.65
AAT Shark: folds 
*** FLOP *** [8h 7c 9c]
chiyuki: checks 
GSDP: bets $1
chiyuki: calls $1
*** TURN *** [8h 7c 9c] [Ah]
chiyuki: checks 
GSDP: checks 
*** RIVER *** [8h 7c 9c Ah] [4h]
chiyuki: checks 
GSDP: checks 
*** SHOW DOWN ***
chiyuki: shows [Td Tc] (a pair of Tens)
GSDP: mucks hand 
chiyuki collected $3.58 from pot
*** SUMMARY ***
Total pot $3.75 | Rake $0.17 
Board [8h 7c 9c Ah 4h]
Seat 1: nice.franki (button) folded before Flop (didn't bet)
Seat 2: chiyuki (small blind) showed [Td Tc] and won ($3.58) with a pair of Tens
Seat 3: AAT Shark (big blind) folded before Flop
Seat 4: Vall179 folded before Flop (didn't bet)
Seat 5: Nerkit folded before Flop (didn't bet)
Seat 6: GSDP mucked [Qd Kh]
Seat 7: kwkim73 folded before Flop (didn't bet)
Seat 8: olligol123 folded before Flop (didn't bet)
Seat 9: Loholov folded before Flop (didn't bet)



PokerStars Zoom Hand #84301221970:  Hold'em No Limit ($0.10/$0.25) - 2012/08/05 16:19:40 JST [2012/08/05 3:19:40 ET]
Table 'Whirlpool' 9-max Seat #1 is the button
Seat 1: chiyuki ($57.41 in chips) 
Seat 2: Perstenev ($9.43 in chips) 
Seat 3: RRMM_again ($24.65 in chips) 
Seat 4: leo2095 ($27.78 in chips) 
Seat 5: 1Karina1 ($29.99 in chips) 
Seat 6: benjuer ($25 in chips) 
Seat 7: DanielWhyte ($33.22 in chips) 
Seat 8: ivan130 ($28.01 in chips) 
Seat 9: Dejacob ($36.14 in chips) 
Perstenev: posts small blind $0.10
RRMM_again: posts big blind $0.25
*** HOLE CARDS ***
Dealt to chiyuki [Ts Qd]
leo2095: folds 
1Karina1: folds 
benjuer: raises $0.50 to $0.75
DanielWhyte: folds 
ivan130: folds 
Dejacob: folds 
chiyuki: folds 
Perstenev: calls $0.65
RRMM_again: folds 
*** FLOP *** [7d 9c Ac]
Perstenev: checks 
benjuer: bets $1
Perstenev: raises $1 to $2
benjuer: calls $1
*** TURN *** [7d 9c Ac] [5h]
Perstenev: bets $4.11
benjuer: calls $4.11
*** RIVER *** [7d 9c Ac 5h] [3d]
Perstenev: bets $2.57 and is all-in
benjuer: calls $2.57
*** SHOW DOWN ***
Perstenev: shows [Ad Qc] (a pair of Aces)
benjuer: shows [Ah Qs] (a pair of Aces)
Perstenev collected $9.13 from pot
benjuer collected $9.12 from pot
*** SUMMARY ***
Total pot $19.11 | Rake $0.86 
Board [7d 9c Ac 5h 3d]
Seat 1: chiyuki (button) folded before Flop (didn't bet)
Seat 2: Perstenev (small blind) showed [Ad Qc] and won ($9.13) with a pair of Aces
Seat 3: RRMM_again (big blind) folded before Flop
Seat 4: leo2095 folded before Flop (didn't bet)
Seat 5: 1Karina1 folded before Flop (didn't bet)
Seat 6: benjuer showed [Ah Qs] and won ($9.12) with a pair of Aces
Seat 7: DanielWhyte folded before Flop (didn't bet)
Seat 8: ivan130 folded before Flop (didn't bet)
Seat 9: Dejacob folded before Flop (didn't bet)



PokerStars Zoom Hand #84301224733:  Hold'em No Limit ($0.10/$0.25) - 2012/08/05 16:19:50 JST [2012/08/05 3:19:50 ET]
Table 'Whirlpool' 9-max Seat #1 is the button
Seat 1: INSP!RON ($25.79 in chips) 
Seat 2: KeLevro0 ($12.25 in chips) 
Seat 3: FoRlan77 ($26 in chips) 
Seat 4: Vall179 ($37.05 in chips) 
Seat 5: kesstukas25 ($23.84 in chips) 
Seat 6: deepakmbh ($37.76 in chips) 
Seat 7: pikhtovnikov ($34.04 in chips) 
Seat 8: chiyuki ($57.41 in chips) 
Seat 9: Grishukps ($12.50 in chips) 
KeLevro0: posts small blind $0.10
FoRlan77: posts big blind $0.25
*** HOLE CARDS ***
Dealt to chiyuki [9c Ac]
Vall179: folds 
kesstukas25: folds 
deepakmbh: raises $0.55 to $0.80
pikhtovnikov: calls $0.80
chiyuki: folds 
Grishukps: folds 
INSP!RON: folds 
KeLevro0: folds 
FoRlan77: folds 
*** FLOP *** [4d 5c 6h]
deepakmbh: bets $1.40
pikhtovnikov: folds 
Uncalled bet ($1.40) returned to deepakmbh
deepakmbh collected $1.86 from pot
deepakmbh: doesn't show hand 
*** SUMMARY ***
Total pot $1.95 | Rake $0.09 
Board [4d 5c 6h]
Seat 1: INSP!RON (button) folded before Flop (didn't bet)
Seat 2: KeLevro0 (small blind) folded before Flop
Seat 3: FoRlan77 (big blind) folded before Flop
Seat 4: Vall179 folded before Flop (didn't bet)
Seat 5: kesstukas25 folded before Flop (didn't bet)
Seat 6: deepakmbh collected ($1.86)
Seat 7: pikhtovnikov folded on the Flop
Seat 8: chiyuki folded before Flop (didn't bet)
Seat 9: Grishukps folded before Flop (didn't bet)



PokerStars Zoom Hand #84301232475:  Hold'em No Limit ($0.10/$0.25) - 2012/08/05 16:20:19 JST [2012/08/05 3:20:19 ET]
Table 'Whirlpool' 9-max Seat #1 is the button
Seat 1: xxx Spb xxx ($29.27 in chips) 
Seat 2: G_warrior23 ($15.55 in chips) 
Seat 3: pandaaaaaa ($16.02 in chips) 
Seat 4: Loholov ($15.66 in chips) 
Seat 5: Grumpy as 2 ($8.78 in chips) 
Seat 6: INSP!RON ($25.54 in chips) 
Seat 7: Fructionar ($32.75 in chips) 
Seat 8: KeLevro0 ($12.88 in chips) 
Seat 9: chiyuki ($57.16 in chips) 
G_warrior23: posts small blind $0.10
pandaaaaaa: posts big blind $0.25
*** HOLE CARDS ***
Dealt to chiyuki [Kd Jd]
Loholov: folds 
Grumpy as 2: folds 
INSP!RON: raises $0.50 to $0.75
Fructionar: folds 
KeLevro0: folds 
chiyuki: folds 
xxx Spb xxx: folds 
G_warrior23: folds 
pandaaaaaa: folds 
Uncalled bet ($0.50) returned to INSP!RON
INSP!RON collected $0.60 from pot
INSP!RON: doesn't show hand 
*** SUMMARY ***
Total pot $0.60 | Rake $0 
Seat 1: xxx Spb xxx (button) folded before Flop (didn't bet)
Seat 2: G_warrior23 (small blind) folded before Flop
Seat 3: pandaaaaaa (big blind) folded before Flop
Seat 4: Loholov folded before Flop (didn't bet)
Seat 5: Grumpy as 2 folded before Flop (didn't bet)
Seat 6: INSP!RON collected ($0.60)
Seat 7: Fructionar folded before Flop (didn't bet)
Seat 8: KeLevro0 folded before Flop (didn't bet)
Seat 9: chiyuki folded before Flop (didn't bet)



PokerStars Zoom Hand #84301231631:  Hold'em No Limit ($0.10/$0.25) - 2012/08/05 16:20:16 JST [2012/08/05 3:20:16 ET]
Table 'Whirlpool' 9-max Seat #1 is the button
Seat 1: Ih8niknames ($20.10 in chips) 
Seat 2: GSDP ($32.07 in chips) 
Seat 3: Cripple86 ($33.91 in chips) 
Seat 4: svg51 ($19.48 in chips) 
Seat 5: chiyuki ($57.16 in chips) 
Seat 6: DrunkTyphoon ($32.86 in chips) 
Seat 7: FoRlan77 ($25.75 in chips) 
Seat 8: seula i ($61.51 in chips) 
Seat 9: kesstukas25 ($23.74 in chips) 
GSDP: posts small blind $0.10
Cripple86: posts big blind $0.25
*** HOLE CARDS ***
Dealt to chiyuki [4c 5c]
svg51: calls $0.25
chiyuki: folds 
DrunkTyphoon: folds 
FoRlan77: folds 
seula i: raises $1 to $1.25
kesstukas25: folds 
Ih8niknames: folds 
GSDP: folds 
Cripple86: folds 
svg51: calls $1
*** FLOP *** [5h 5s 8h]
svg51: checks 
seula i: bets $1.75
svg51: calls $1.75
*** TURN *** [5h 5s 8h] [9h]
svg51: checks 
seula i: checks 
*** RIVER *** [5h 5s 8h 9h] [7c]
svg51: checks 
seula i: checks 
*** SHOW DOWN ***
svg51: shows [Ks Ah] (a pair of Fives)
seula i: mucks hand 
svg51 collected $6.06 from pot
svg51 is disconnected 
*** SUMMARY ***
Total pot $6.35 | Rake $0.29 
Board [5h 5s 8h 9h 7c]
Seat 1: Ih8niknames (button) folded before Flop (didn't bet)
Seat 2: GSDP (small blind) folded before Flop
Seat 3: Cripple86 (big blind) folded before Flop
Seat 4: svg51 showed [Ks Ah] and won ($6.06) with a pair of Fives
Seat 5: chiyuki folded before Flop (didn't bet)
Seat 6: DrunkTyphoon folded before Flop (didn't bet)
Seat 7: FoRlan77 folded before Flop (didn't bet)
Seat 8: seula i mucked [Kc Qc]
Seat 9: kesstukas25 folded before Flop (didn't bet)



PokerStars Zoom Hand #84301237207:  Hold'em No Limit ($0.10/$0.25) - 2012/08/05 16:20:36 JST [2012/08/05 3:20:36 ET]
Table 'Whirlpool' 9-max Seat #1 is the button
Seat 1: Serge Claws ($25 in chips) 
Seat 2: soul_5577 ($41.09 in chips) 
Seat 3: deepakmbh ($26.16 in chips) 
Seat 4: Dejacob ($25 in chips) 
Seat 5: kesstukas25 ($36.49 in chips) 
Seat 6: d4dda ($28.38 in chips) 
Seat 7: chiyuki ($57.16 in chips) 
Seat 8: 19MJJ21 ($14.33 in chips) 
Seat 9: roksmokndonk ($15.80 in chips) 
soul_5577: posts small blind $0.10
deepakmbh: posts big blind $0.25
*** HOLE CARDS ***
Dealt to chiyuki [Jd 8s]
Dejacob: raises $0.50 to $0.75
kesstukas25: folds 
d4dda: folds 
chiyuki: folds 
19MJJ21: folds 
roksmokndonk: folds 
Serge Claws: folds 
soul_5577: folds 
deepakmbh: folds 
Uncalled bet ($0.50) returned to Dejacob
Dejacob collected $0.60 from pot
Dejacob: doesn't show hand 
*** SUMMARY ***
Total pot $0.60 | Rake $0 
Seat 1: Serge Claws (button) folded before Flop (didn't bet)
Seat 2: soul_5577 (small blind) folded before Flop
Seat 3: deepakmbh (big blind) folded before Flop
Seat 4: Dejacob collected ($0.60)
Seat 5: kesstukas25 folded before Flop (didn't bet)
Seat 6: d4dda folded before Flop (didn't bet)
Seat 7: chiyuki folded before Flop (didn't bet)
Seat 8: 19MJJ21 folded before Flop (didn't bet)
Seat 9: roksmokndonk folded before Flop (didn't bet)



PokerStars Zoom Hand #84301239376:  Hold'em No Limit ($0.10/$0.25) - 2012/08/05 16:20:44 JST [2012/08/05 3:20:44 ET]
Table 'Whirlpool' 9-max Seat #1 is the button
Seat 1: soul_5577 ($40.99 in chips) 
Seat 2: chiyuki ($57.16 in chips) 
Seat 3: KeLevro0 ($12.88 in chips) 
Seat 4: Serge Claws ($41.70 in chips) 
Seat 5: mungroo ($25.78 in chips) 
Seat 6: masterkoolb ($17.07 in chips) 
Seat 7: Perstenev ($9.13 in chips) 
Seat 8: yoube ($99.91 in chips) 
Seat 9: Kozyavkin ($15.16 in chips) 
chiyuki: posts small blind $0.10
KeLevro0: posts big blind $0.25
*** HOLE CARDS ***
Dealt to chiyuki [Ks 7d]
Serge Claws: folds 
mungroo: folds 
masterkoolb: folds 
Perstenev: folds 
yoube: folds 
Kozyavkin: folds 
soul_5577: calls $0.25
chiyuki: folds 
KeLevro0: checks 
*** FLOP *** [Jc Js Ts]
KeLevro0: checks 
soul_5577: bets $0.75
KeLevro0: folds 
Uncalled bet ($0.75) returned to soul_5577
soul_5577 collected $0.57 from pot
soul_5577: doesn't show hand 
*** SUMMARY ***
Total pot $0.60 | Rake $0.03 
Board [Jc Js Ts]
Seat 1: soul_5577 (button) collected ($0.57)
Seat 2: chiyuki (small blind) folded before Flop
Seat 3: KeLevro0 (big blind) folded on the Flop
Seat 4: Serge Claws folded before Flop (didn't bet)
Seat 5: mungroo folded before Flop (didn't bet)
Seat 6: masterkoolb folded before Flop (didn't bet)
Seat 7: Perstenev folded before Flop (didn't bet)
Seat 8: yoube folded before Flop (didn't bet)
Seat 9: Kozyavkin folded before Flop (didn't bet)



PokerStars Zoom Hand #84301245470:  Hold'em No Limit ($0.10/$0.25) - 2012/08/05 16:21:06 JST [2012/08/05 3:21:06 ET]
Table 'Whirlpool' 9-max Seat #1 is the button
Seat 1: yoube ($99.91 in chips) 
Seat 2: Limoilou ($32.36 in chips) 
Seat 3: INSP!RON ($27.06 in chips) 
Seat 4: 4ydo yogurt ($57.59 in chips) 
Seat 5: chiyuki ($57.06 in chips) 
Seat 6: Grumpy as 2 ($8.43 in chips) 
Seat 7: mjmichi ($26.27 in chips) 
Seat 8: dlogic27 ($14.40 in chips) 
Seat 9: laurentzu84 ($47.11 in chips) 
Limoilou: posts small blind $0.10
INSP!RON: posts big blind $0.25
*** HOLE CARDS ***
Dealt to chiyuki [8h Jh]
4ydo yogurt: folds 
chiyuki: folds 
Grumpy as 2: folds 
mjmichi: folds 
dlogic27: folds 
laurentzu84: folds 
yoube: raises $0.25 to $0.50
Limoilou: folds 
INSP!RON: folds 
Uncalled bet ($0.25) returned to yoube
yoube collected $0.60 from pot
yoube: doesn't show hand 
*** SUMMARY ***
Total pot $0.60 | Rake $0 
Seat 1: yoube (button) collected ($0.60)
Seat 2: Limoilou (small blind) folded before Flop
Seat 3: INSP!RON (big blind) folded before Flop
Seat 4: 4ydo yogurt folded before Flop (didn't bet)
Seat 5: chiyuki folded before Flop (didn't bet)
Seat 6: Grumpy as 2 folded before Flop (didn't bet)
Seat 7: mjmichi folded before Flop (didn't bet)
Seat 8: dlogic27 folded before Flop (didn't bet)
Seat 9: laurentzu84 folded before Flop (didn't bet)



PokerStars Zoom Hand #84301228129:  Hold'em No Limit ($0.10/$0.25) - 2012/08/05 16:20:03 JST [2012/08/05 3:20:03 ET]
Table 'Whirlpool' 9-max Seat #1 is the button
Seat 1: PAMBOS.L ($9.99 in chips) 
Seat 2: leo2095 ($27.78 in chips) 
Seat 3: chiyuki ($57.41 in chips) 
Seat 4: INSP!RON ($27.06 in chips) 
Seat 5: men1989 ($23.02 in chips) 
Seat 6: xxx Spb xxx ($29.37 in chips) 
Seat 7: codan23 ($14.37 in chips) 
Seat 8: new85new85 ($23.80 in chips) 
Seat 9: nice.franki ($11.82 in chips) 
leo2095: posts small blind $0.10
chiyuki: posts big blind $0.25
*** HOLE CARDS ***
Dealt to chiyuki [Kd 2d]
INSP!RON: folds 
men1989: raises $0.50 to $0.75
xxx Spb xxx: folds 
codan23: folds 
new85new85: folds 
nice.franki: folds 
PAMBOS.L: calls $0.75
leo2095: folds 
chiyuki: folds 
*** FLOP *** [Jd 2s 6s]
men1989: bets $1.23
PAMBOS.L: calls $1.23
*** TURN *** [Jd 2s 6s] [6h]
men1989: checks 
PAMBOS.L: checks 
*** RIVER *** [Jd 2s 6s 6h] [Ac]
men1989 is connected 
men1989: checks 
PAMBOS.L: bets $2.10
men1989: calls $2.10
*** SHOW DOWN ***
PAMBOS.L: shows [6d 4d] (three of a kind, Sixes)
men1989: mucks hand 
PAMBOS.L collected $8.13 from pot
*** SUMMARY ***
Total pot $8.51 | Rake $0.38 
Board [Jd 2s 6s 6h Ac]
Seat 1: PAMBOS.L (button) showed [6d 4d] and won ($8.13) with three of a kind, Sixes
Seat 2: leo2095 (small blind) folded before Flop
Seat 3: chiyuki (big blind) folded before Flop
Seat 4: INSP!RON folded before Flop (didn't bet)
Seat 5: men1989 mucked [Jh Qd]
Seat 6: xxx Spb xxx folded before Flop (didn't bet)
Seat 7: codan23 folded before Flop (didn't bet)
Seat 8: new85new85 folded before Flop (didn't bet)
Seat 9: nice.franki folded before Flop (didn't bet)



PokerStars Zoom Hand #84301240500:  Hold'em No Limit ($0.10/$0.25) - 2012/08/05 16:20:48 JST [2012/08/05 3:20:48 ET]
Table 'Whirlpool' 9-max Seat #1 is the button
Seat 1: chiyuki ($57.06 in chips) 
Seat 2: seula i ($39.05 in chips) 
Seat 3: xxx Spb xxx ($29.27 in chips) 
Seat 4: new85new85 ($23.30 in chips) 
Seat 5: Grishukps ($12.50 in chips) 
Seat 6: Perstenev ($9.13 in chips) 
Seat 7: hldtom ($35.93 in chips) 
Seat 8: Serge Claws ($41.70 in chips) 
Seat 9: leo2095 ($25.18 in chips) 
seula i: posts small blind $0.10
xxx Spb xxx: posts big blind $0.25
*** HOLE CARDS ***
Dealt to chiyuki [Tc Qh]
new85new85: folds 
Grishukps: folds 
Perstenev: folds 
hldtom: folds 
Serge Claws: folds 
leo2095: raises $0.25 to $0.50
chiyuki: folds 
seula i: folds 
xxx Spb xxx: calls $0.25
*** FLOP *** [9h 9c 4h]
xxx Spb xxx: checks 
leo2095: checks 
*** TURN *** [9h 9c 4h] [8h]
xxx Spb xxx: bets $0.78
leo2095: folds 
Uncalled bet ($0.78) returned to xxx Spb xxx
xxx Spb xxx collected $1.05 from pot
xxx Spb xxx: doesn't show hand 
*** SUMMARY ***
Total pot $1.10 | Rake $0.05 
Board [9h 9c 4h 8h]
Seat 1: chiyuki (button) folded before Flop (didn't bet)
Seat 2: seula i (small blind) folded before Flop
Seat 3: xxx Spb xxx (big blind) collected ($1.05)
Seat 4: new85new85 folded before Flop (didn't bet)
Seat 5: Grishukps folded before Flop (didn't bet)
Seat 6: Perstenev folded before Flop (didn't bet)
Seat 7: hldtom folded before Flop (didn't bet)
Seat 8: Serge Claws folded before Flop (didn't bet)
Seat 9: leo2095 folded on the Turn



PokerStars Zoom Hand #84301250440:  Hold'em No Limit ($0.10/$0.25) - 2012/08/05 16:21:25 JST [2012/08/05 3:21:25 ET]
Table 'Whirlpool' 9-max Seat #1 is the button
Seat 1: masterkoolb ($13.95 in chips) 
Seat 2: benjuer ($27.84 in chips) 
Seat 3: phate-1up ($107.58 in chips) 
Seat 4: kwkim73 ($29.86 in chips) 
Seat 5: fwnaf ($29.93 in chips) 
Seat 6: Serge Claws ($41.35 in chips) 
Seat 7: Grumpy as 2 ($8.43 in chips) 
Seat 8: Limoilou ($32.26 in chips) 
Seat 9: chiyuki ($56.96 in chips) 
benjuer: posts small blind $0.10
phate-1up: posts big blind $0.25
*** HOLE CARDS ***
Dealt to chiyuki [2s 6s]
kwkim73: folds 
fwnaf: folds 
Serge Claws: folds 
Grumpy as 2: folds 
Limoilou: folds 
chiyuki: folds 
masterkoolb: folds 
benjuer: folds 
Uncalled bet ($0.15) returned to phate-1up
phate-1up collected $0.20 from pot
phate-1up: doesn't show hand 
*** SUMMARY ***
Total pot $0.20 | Rake $0 
Seat 1: masterkoolb (button) folded before Flop (didn't bet)
Seat 2: benjuer (small blind) folded before Flop
Seat 3: phate-1up (big blind) collected ($0.20)
Seat 4: kwkim73 folded before Flop (didn't bet)
Seat 5: fwnaf folded before Flop (didn't bet)
Seat 6: Serge Claws folded before Flop (didn't bet)
Seat 7: Grumpy as 2 folded before Flop (didn't bet)
Seat 8: Limoilou folded before Flop (didn't bet)
Seat 9: chiyuki folded before Flop (didn't bet)



PokerStars Zoom Hand #84301238246:  Hold'em No Limit ($0.10/$0.25) - 2012/08/05 16:20:40 JST [2012/08/05 3:20:40 ET]
Table 'Whirlpool' 9-max Seat #1 is the button
Seat 1: Loholov ($20.69 in chips) 
Seat 2: nice.franki ($11.82 in chips) 
Seat 3: drunk_bender ($28.51 in chips) 
Seat 4: soul_5577 ($40.99 in chips) 
Seat 5: 1Karina1 ($32.42 in chips) 
Seat 6: chiyuki ($57.16 in chips) 
Seat 7: KeLevro0 ($12.88 in chips) 
Seat 8: INSP!RON ($29.51 in chips) 
Seat 9: GovGus ($52.23 in chips) 
nice.franki: posts small blind $0.10
drunk_bender: posts big blind $0.25
*** HOLE CARDS ***
Dealt to chiyuki [7h Qh]
soul_5577: folds 
1Karina1: raises $0.50 to $0.75
chiyuki: folds 
KeLevro0: folds 
INSP!RON: folds 
GovGus: folds 
Loholov: folds 
nice.franki: folds 
drunk_bender: calls $0.50
*** FLOP *** [Ad 4c 4d]
drunk_bender: checks 
1Karina1: checks 
*** TURN *** [Ad 4c 4d] [5s]
drunk_bender: bets $1.50
1Karina1: calls $1.50
*** RIVER *** [Ad 4c 4d 5s] [Kd]
drunk_bender: checks 
1Karina1: checks 
*** SHOW DOWN ***
drunk_bender: shows [Jc Qc] (a pair of Fours)
1Karina1: shows [Qs Qd] (two pair, Queens and Fours)
1Karina1 collected $4.39 from pot
*** SUMMARY ***
Total pot $4.60 | Rake $0.21 
Board [Ad 4c 4d 5s Kd]
Seat 1: Loholov (button) folded before Flop (didn't bet)
Seat 2: nice.franki (small blind) folded before Flop
Seat 3: drunk_bender (big blind) showed [Jc Qc] and lost with a pair of Fours
Seat 4: soul_5577 folded before Flop (didn't bet)
Seat 5: 1Karina1 showed [Qs Qd] and won ($4.39) with two pair, Queens and Fours
Seat 6: chiyuki folded before Flop (didn't bet)
Seat 7: KeLevro0 folded before Flop (didn't bet)
Seat 8: INSP!RON folded before Flop (didn't bet)
Seat 9: GovGus folded before Flop (didn't bet)



PokerStars Zoom Hand #84301251874:  Hold'em No Limit ($0.10/$0.25) - 2012/08/05 16:21:30 JST [2012/08/05 3:21:30 ET]
Table 'Whirlpool' 9-max Seat #1 is the button
Seat 1: RRMM_again ($23.65 in chips) 
Seat 2: 4plankton ($3.39 in chips) 
Seat 3: Limoilou ($32.26 in chips) 
Seat 4: mungroo ($24.15 in chips) 
Seat 5: CBR1000RR890 ($13.26 in chips) 
Seat 6: KeLevro0 ($12.15 in chips) 
Seat 7: chiyuki ($56.96 in chips) 
Seat 8: benjuer ($48.87 in chips) 
Seat 9: Mytea88 ($7.94 in chips) 
4plankton: posts small blind $0.10
Limoilou: posts big blind $0.25
*** HOLE CARDS ***
Dealt to chiyuki [5h Tc]
mungroo: folds 
CBR1000RR890: calls $0.25
KeLevro0: folds 
chiyuki: folds 
benjuer: folds 
Mytea88: folds 
RRMM_again: folds 
4plankton: folds 
Limoilou: checks 
*** FLOP *** [Jh Kc Jc]
Limoilou: checks 
CBR1000RR890: bets $0.25
Limoilou: folds 
Uncalled bet ($0.25) returned to CBR1000RR890
CBR1000RR890 collected $0.57 from pot
CBR1000RR890: doesn't show hand 
*** SUMMARY ***
Total pot $0.60 | Rake $0.03 
Board [Jh Kc Jc]
Seat 1: RRMM_again (button) folded before Flop (didn't bet)
Seat 2: 4plankton (small blind) folded before Flop
Seat 3: Limoilou (big blind) folded on the Flop
Seat 4: mungroo folded before Flop (didn't bet)
Seat 5: CBR1000RR890 collected ($0.57)
Seat 6: KeLevro0 folded before Flop (didn't bet)
Seat 7: chiyuki folded before Flop (didn't bet)
Seat 8: benjuer folded before Flop (didn't bet)
Seat 9: Mytea88 folded before Flop (didn't bet)



