PokerStars Zoom Hand #84298198880:  Hold'em No Limit ($0.10/$0.25) - 2012/08/05 13:00:03 JST [2012/08/05 0:00:03 ET]
Table 'Whirlpool' 9-max Seat #1 is the button
Seat 1: Medic8681 ($12.60 in chips) 
Seat 2: Seadogvcd ($13.59 in chips) 
Seat 3: Oswulf ($14.58 in chips) 
Seat 4: chiyuki ($23.13 in chips) 
Seat 5: AndiM64 ($28.65 in chips) 
Seat 6: seula i ($49.95 in chips) 
Seat 7: silvno31 ($30.73 in chips) 
Seat 8: leo2095 ($16.74 in chips) 
Seat 9: Danishrubel ($129.37 in chips) 
Seadogvcd: posts small blind $0.10
Oswulf: posts big blind $0.25
*** HOLE CARDS ***
Dealt to chiyuki [Tc Kh]
chiyuki: folds 
AndiM64: folds 
seula i: raises $0.50 to $0.75
silvno31: folds 
leo2095: folds 
Danishrubel: folds 
Medic8681: folds 
Seadogvcd: calls $0.65
Oswulf: folds 
*** FLOP *** [As 4d Kc]
Seadogvcd: checks 
seula i: bets $1.25
Seadogvcd: folds 
Uncalled bet ($1.25) returned to seula i
seula i collected $1.67 from pot
seula i: doesn't show hand 
*** SUMMARY ***
Total pot $1.75 | Rake $0.08 
Board [As 4d Kc]
Seat 1: Medic8681 (button) folded before Flop (didn't bet)
Seat 2: Seadogvcd (small blind) folded on the Flop
Seat 3: Oswulf (big blind) folded before Flop
Seat 4: chiyuki folded before Flop (didn't bet)
Seat 5: AndiM64 folded before Flop (didn't bet)
Seat 6: seula i collected ($1.67)
Seat 7: silvno31 folded before Flop (didn't bet)
Seat 8: leo2095 folded before Flop (didn't bet)
Seat 9: Danishrubel folded before Flop (didn't bet)



PokerStars Zoom Hand #84298201573:  Hold'em No Limit ($0.10/$0.25) - 2012/08/05 13:00:15 JST [2012/08/05 0:00:15 ET]
Table 'Whirlpool' 9-max Seat #1 is the button
Seat 1: RomarioJa ($12.10 in chips) 
Seat 2: fwani ($33.34 in chips) 
Seat 3: KrystalAA ($29.17 in chips) 
Seat 4: slickthis ($23.26 in chips) 
Seat 5: DooMSDaY1337 ($39.19 in chips) 
Seat 6: AndiM64 ($77.13 in chips) 
Seat 7: Sørbråten ($67.86 in chips) 
Seat 8: Assassin365 ($29.98 in chips) 
Seat 9: chiyuki ($23.13 in chips) 
fwani: posts small blind $0.10
KrystalAA: posts big blind $0.25
*** HOLE CARDS ***
Dealt to chiyuki [Tc Jh]
slickthis: folds 
DooMSDaY1337: folds 
AndiM64: folds 
Sørbråten: folds 
Assassin365: folds 
chiyuki: folds 
RomarioJa: folds 
fwani: folds 
Uncalled bet ($0.15) returned to KrystalAA
KrystalAA collected $0.20 from pot
KrystalAA: doesn't show hand 
*** SUMMARY ***
Total pot $0.20 | Rake $0 
Seat 1: RomarioJa (button) folded before Flop (didn't bet)
Seat 2: fwani (small blind) folded before Flop
Seat 3: KrystalAA (big blind) collected ($0.20)
Seat 4: slickthis folded before Flop (didn't bet)
Seat 5: DooMSDaY1337 folded before Flop (didn't bet)
Seat 6: AndiM64 folded before Flop (didn't bet)
Seat 7: Sørbråten folded before Flop (didn't bet)
Seat 8: Assassin365 folded before Flop (didn't bet)
Seat 9: chiyuki folded before Flop (didn't bet)



PokerStars Zoom Hand #84298203480:  Hold'em No Limit ($0.10/$0.25) - 2012/08/05 13:00:23 JST [2012/08/05 0:00:23 ET]
Table 'Whirlpool' 9-max Seat #1 is the button
Seat 1: nice.franki ($10.20 in chips) 
Seat 2: chiyuki ($23.13 in chips) 
Seat 3: slickthis ($23.26 in chips) 
Seat 4: AndiM64 ($30.78 in chips) 
Seat 5: Th3Fog ($21.99 in chips) 
Seat 6: TErr18 ($20.57 in chips) 
Seat 7: DooMSDaY1337 ($32.99 in chips) 
Seat 8: JAMES3FINGER ($322.04 in chips) 
Seat 9: TraderYao ($26.92 in chips) 
chiyuki: posts small blind $0.10
slickthis: posts big blind $0.25
*** HOLE CARDS ***
Dealt to chiyuki [2d Js]
AndiM64: folds 
Th3Fog: folds 
TErr18: folds 
DooMSDaY1337: raises $0.50 to $0.75
JAMES3FINGER: folds 
TraderYao: folds 
nice.franki: folds 
chiyuki: folds 
slickthis: folds 
Uncalled bet ($0.50) returned to DooMSDaY1337
DooMSDaY1337 collected $0.60 from pot
DooMSDaY1337: doesn't show hand 
*** SUMMARY ***
Total pot $0.60 | Rake $0 
Seat 1: nice.franki (button) folded before Flop (didn't bet)
Seat 2: chiyuki (small blind) folded before Flop
Seat 3: slickthis (big blind) folded before Flop
Seat 4: AndiM64 folded before Flop (didn't bet)
Seat 5: Th3Fog folded before Flop (didn't bet)
Seat 6: TErr18 folded before Flop (didn't bet)
Seat 7: DooMSDaY1337 collected ($0.60)
Seat 8: JAMES3FINGER folded before Flop (didn't bet)
Seat 9: TraderYao folded before Flop (didn't bet)



PokerStars Zoom Hand #84298202545:  Hold'em No Limit ($0.10/$0.25) - 2012/08/05 13:00:19 JST [2012/08/05 0:00:19 ET]
Table 'Whirlpool' 9-max Seat #1 is the button
Seat 1: 2997qwer ($13.80 in chips) 
Seat 2: AndiM64 ($77.13 in chips) 
Seat 3: agurio ($25.05 in chips) 
Seat 4: DooMSDaY1337 ($39.19 in chips) 
Seat 5: Medic8681 ($14.14 in chips) 
Seat 6: KeLevro0 ($12.50 in chips) 
Seat 7: Sharks_Nica ($66.43 in chips) 
Seat 8: chiyuki ($23.13 in chips) 
Seat 9: wtu1986 ($24.90 in chips) 
AndiM64: posts small blind $0.10
agurio: posts big blind $0.25
*** HOLE CARDS ***
Dealt to chiyuki [5h 8c]
DooMSDaY1337: folds 
Medic8681: folds 
KeLevro0: folds 
Sharks_Nica: raises $0.75 to $1
chiyuki: folds 
wtu1986: folds 
2997qwer: folds 
AndiM64: folds 
agurio: folds 
Uncalled bet ($0.75) returned to Sharks_Nica
Sharks_Nica collected $0.60 from pot
Sharks_Nica: doesn't show hand 
*** SUMMARY ***
Total pot $0.60 | Rake $0 
Seat 1: 2997qwer (button) folded before Flop (didn't bet)
Seat 2: AndiM64 (small blind) folded before Flop
Seat 3: agurio (big blind) folded before Flop
Seat 4: DooMSDaY1337 folded before Flop (didn't bet)
Seat 5: Medic8681 folded before Flop (didn't bet)
Seat 6: KeLevro0 folded before Flop (didn't bet)
Seat 7: Sharks_Nica collected ($0.60)
Seat 8: chiyuki folded before Flop (didn't bet)
Seat 9: wtu1986 folded before Flop (didn't bet)



PokerStars Zoom Hand #84298205560:  Hold'em No Limit ($0.10/$0.25) - 2012/08/05 13:00:32 JST [2012/08/05 0:00:32 ET]
Table 'Whirlpool' 9-max Seat #1 is the button
Seat 1: polk11 ($22.63 in chips) 
Seat 2: TraderYao ($26.92 in chips) 
Seat 3: gunbowler ($96.34 in chips) 
Seat 4: BlOnDhOlIc ($28.27 in chips) 
Seat 5: doanut13 ($27.82 in chips) 
Seat 6: Flower-Wang ($15 in chips) 
Seat 7: chiyuki ($23.03 in chips) 
Seat 8: ll_LaMeR_ll ($15.51 in chips) 
Seat 9: AndiM64 ($30.78 in chips) 
TraderYao: posts small blind $0.10
gunbowler: posts big blind $0.25
*** HOLE CARDS ***
Dealt to chiyuki [Qh Qd]
BlOnDhOlIc: folds 
doanut13: calls $0.25
Flower-Wang: folds 
chiyuki: raises $1 to $1.25
ll_LaMeR_ll: folds 
AndiM64: folds 
polk11: folds 
TraderYao: folds 
gunbowler: folds 
doanut13: calls $1
*** FLOP *** [4c 5h 9h]
doanut13: checks 
chiyuki: bets $2
doanut13: folds 
Uncalled bet ($2) returned to chiyuki
chiyuki collected $2.72 from pot
chiyuki: doesn't show hand 
*** SUMMARY ***
Total pot $2.85 | Rake $0.13 
Board [4c 5h 9h]
Seat 1: polk11 (button) folded before Flop (didn't bet)
Seat 2: TraderYao (small blind) folded before Flop
Seat 3: gunbowler (big blind) folded before Flop
Seat 4: BlOnDhOlIc folded before Flop (didn't bet)
Seat 5: doanut13 folded on the Flop
Seat 6: Flower-Wang folded before Flop (didn't bet)
Seat 7: chiyuki collected ($2.72)
Seat 8: ll_LaMeR_ll folded before Flop (didn't bet)
Seat 9: AndiM64 folded before Flop (didn't bet)



PokerStars Zoom Hand #84298212689:  Hold'em No Limit ($0.10/$0.25) - 2012/08/05 13:01:01 JST [2012/08/05 0:01:01 ET]
Table 'Whirlpool' 9-max Seat #1 is the button
Seat 1: adshoshan7 ($24.81 in chips) 
Seat 2: agurio ($25 in chips) 
Seat 3: mikifeio ($35.44 in chips) 
Seat 4: cR!Ma*aRm ($22.71 in chips) 
Seat 5: ll_LaMeR_ll ($16.43 in chips) 
Seat 6: chiyuki ($24.50 in chips) 
Seat 7: nice.franki ($9.95 in chips) 
Seat 8: BlOnDhOlIc ($28.17 in chips) 
Seat 9: TErr18 ($20.22 in chips) 
agurio: posts small blind $0.10
mikifeio: posts big blind $0.25
*** HOLE CARDS ***
Dealt to chiyuki [3d 8d]
cR!Ma*aRm: folds 
ll_LaMeR_ll: folds 
chiyuki: folds 
nice.franki: folds 
BlOnDhOlIc: folds 
TErr18: folds 
adshoshan7: raises $0.25 to $0.50
agurio: folds 
mikifeio: folds 
Uncalled bet ($0.25) returned to adshoshan7
adshoshan7 collected $0.60 from pot
adshoshan7: doesn't show hand 
*** SUMMARY ***
Total pot $0.60 | Rake $0 
Seat 1: adshoshan7 (button) collected ($0.60)
Seat 2: agurio (small blind) folded before Flop
Seat 3: mikifeio (big blind) folded before Flop
Seat 4: cR!Ma*aRm folded before Flop (didn't bet)
Seat 5: ll_LaMeR_ll folded before Flop (didn't bet)
Seat 6: chiyuki folded before Flop (didn't bet)
Seat 7: nice.franki folded before Flop (didn't bet)
Seat 8: BlOnDhOlIc folded before Flop (didn't bet)
Seat 9: TErr18 folded before Flop (didn't bet)



PokerStars Zoom Hand #84298217011:  Hold'em No Limit ($0.10/$0.25) - 2012/08/05 13:01:19 JST [2012/08/05 0:01:19 ET]
Table 'Whirlpool' 9-max Seat #1 is the button
Seat 1: Sørbråten ($66.97 in chips) 
Seat 2: DooMSDaY1337 ($56.96 in chips) 
Seat 3: 2997qwer ($10.05 in chips) 
Seat 4: chiyuki ($24.50 in chips) 
Seat 5: RomarioJa ($11.66 in chips) 
Seat 6: nice.franki ($9.85 in chips) 
Seat 7: Th3Fog ($52.80 in chips) 
Seat 8: agurio ($25 in chips) 
Seat 9: Sharks_Nica ($66.78 in chips) 
DooMSDaY1337: posts small blind $0.10
2997qwer: posts big blind $0.25
*** HOLE CARDS ***
Dealt to chiyuki [6c 9d]
chiyuki: folds 
RomarioJa: folds 
nice.franki: folds 
Th3Fog: folds 
agurio: raises $0.75 to $1
Sharks_Nica: folds 
Sørbråten: folds 
DooMSDaY1337: folds 
2997qwer: folds 
Uncalled bet ($0.75) returned to agurio
agurio collected $0.60 from pot
agurio: doesn't show hand 
*** SUMMARY ***
Total pot $0.60 | Rake $0 
Seat 1: Sørbråten (button) folded before Flop (didn't bet)
Seat 2: DooMSDaY1337 (small blind) folded before Flop
Seat 3: 2997qwer (big blind) folded before Flop
Seat 4: chiyuki folded before Flop (didn't bet)
Seat 5: RomarioJa folded before Flop (didn't bet)
Seat 6: nice.franki folded before Flop (didn't bet)
Seat 7: Th3Fog folded before Flop (didn't bet)
Seat 8: agurio collected ($0.60)
Seat 9: Sharks_Nica folded before Flop (didn't bet)



PokerStars Zoom Hand #84298215215:  Hold'em No Limit ($0.10/$0.25) - 2012/08/05 13:01:12 JST [2012/08/05 0:01:12 ET]
Table 'Whirlpool' 9-max Seat #1 is the button
Seat 1: Ring Circus ($24.57 in chips) 
Seat 2: masterkoolb ($13.70 in chips) 
Seat 3: TErr18 ($20.74 in chips) 
Seat 4: RomarioJa ($8.30 in chips) 
Seat 5: pug2012 ($19.19 in chips) 
Seat 6: lolos21 ($18.56 in chips) 
Seat 7: chiyuki ($24.50 in chips) 
Seat 8: leo2095 ($15.27 in chips) 
Seat 9: JAMES3FINGER ($323.89 in chips) 
masterkoolb: posts small blind $0.10
TErr18: posts big blind $0.25
*** HOLE CARDS ***
Dealt to chiyuki [Ac 5d]
RomarioJa: folds 
pug2012: folds 
lolos21: folds 
chiyuki: folds 
leo2095: folds 
JAMES3FINGER: calls $0.25
Ring Circus: folds 
masterkoolb: calls $0.15
TErr18: checks 
*** FLOP *** [As 4c Js]
masterkoolb: bets $0.50
TErr18: calls $0.50
JAMES3FINGER: raises $2.50 to $3
masterkoolb: raises $6.49 to $9.49
TErr18: folds 
JAMES3FINGER: raises $6.49 to $15.98
masterkoolb: calls $3.96 and is all-in
Uncalled bet ($2.53) returned to JAMES3FINGER
*** TURN *** [As 4c Js] [5s]
*** RIVER *** [As 4c Js 5s] [9h]
*** SHOW DOWN ***
masterkoolb: shows [4h 4d] (three of a kind, Fours)
JAMES3FINGER: shows [Jd Jh] (three of a kind, Jacks)
JAMES3FINGER collected $26.88 from pot
*** SUMMARY ***
Total pot $28.15 | Rake $1.27 
Board [As 4c Js 5s 9h]
Seat 1: Ring Circus (button) folded before Flop (didn't bet)
Seat 2: masterkoolb (small blind) showed [4h 4d] and lost with three of a kind, Fours
Seat 3: TErr18 (big blind) folded on the Flop
Seat 4: RomarioJa folded before Flop (didn't bet)
Seat 5: pug2012 folded before Flop (didn't bet)
Seat 6: lolos21 folded before Flop (didn't bet)
Seat 7: chiyuki folded before Flop (didn't bet)
Seat 8: leo2095 folded before Flop (didn't bet)
Seat 9: JAMES3FINGER showed [Jd Jh] and won ($26.88) with three of a kind, Jacks



PokerStars Zoom Hand #84298217783:  Hold'em No Limit ($0.10/$0.25) - 2012/08/05 13:01:22 JST [2012/08/05 0:01:22 ET]
Table 'Whirlpool' 9-max Seat #1 is the button
Seat 1: TraderYao ($28.30 in chips) 
Seat 2: BlOnDhOlIc ($44.42 in chips) 
Seat 3: ll_LaMeR_ll ($16.43 in chips) 
Seat 4: wtu1986 ($25 in chips) 
Seat 5: KeLevro0 ($11.80 in chips) 
Seat 6: Oswulf ($14.23 in chips) 
Seat 7: DooMSDaY1337 ($37.94 in chips) 
Seat 8: Lasutchik ($27.10 in chips) 
Seat 9: chiyuki ($24.50 in chips) 
BlOnDhOlIc: posts small blind $0.10
ll_LaMeR_ll: posts big blind $0.25
*** HOLE CARDS ***
Dealt to chiyuki [Kc Ah]
wtu1986: folds 
KeLevro0: folds 
Oswulf: folds 
DooMSDaY1337: folds 
Lasutchik: raises $0.37 to $0.62
chiyuki: raises $1.37 to $1.99
TraderYao: folds 
BlOnDhOlIc: folds 
ll_LaMeR_ll: folds 
Lasutchik: folds 
Uncalled bet ($1.37) returned to chiyuki
chiyuki collected $1.59 from pot
chiyuki: doesn't show hand 
*** SUMMARY ***
Total pot $1.59 | Rake $0 
Seat 1: TraderYao (button) folded before Flop (didn't bet)
Seat 2: BlOnDhOlIc (small blind) folded before Flop
Seat 3: ll_LaMeR_ll (big blind) folded before Flop
Seat 4: wtu1986 folded before Flop (didn't bet)
Seat 5: KeLevro0 folded before Flop (didn't bet)
Seat 6: Oswulf folded before Flop (didn't bet)
Seat 7: DooMSDaY1337 folded before Flop (didn't bet)
Seat 8: Lasutchik folded before Flop
Seat 9: chiyuki collected ($1.59)



PokerStars Zoom Hand #84298226330:  Hold'em No Limit ($0.10/$0.25) - 2012/08/05 13:01:54 JST [2012/08/05 0:01:54 ET]
Table 'Whirlpool' 9-max Seat #1 is the button
Seat 1: Jene4kaBest ($11.99 in chips) 
Seat 2: 2997qwer ($13.55 in chips) 
Seat 3: chiyuki ($25.47 in chips) 
Seat 4: leo2095 ($14.77 in chips) 
Seat 5: RomarioJa ($12.66 in chips) 
Seat 6: DooMSDaY1337 ($32.99 in chips) 
Seat 7: TraderYao ($25.35 in chips) 
Seat 8: KeLevro0 ($11.68 in chips) 
Seat 9: monst3r4119 ($21.58 in chips) 
2997qwer: posts small blind $0.10
chiyuki: posts big blind $0.25
*** HOLE CARDS ***
Dealt to chiyuki [5c 3d]
leo2095: folds 
RomarioJa: folds 
DooMSDaY1337: folds 
TraderYao: folds 
KeLevro0: folds 
monst3r4119: folds 
Jene4kaBest: folds 
2997qwer: folds 
Uncalled bet ($0.15) returned to chiyuki
chiyuki collected $0.20 from pot
chiyuki: doesn't show hand 
*** SUMMARY ***
Total pot $0.20 | Rake $0 
Seat 1: Jene4kaBest (button) folded before Flop (didn't bet)
Seat 2: 2997qwer (small blind) folded before Flop
Seat 3: chiyuki (big blind) collected ($0.20)
Seat 4: leo2095 folded before Flop (didn't bet)
Seat 5: RomarioJa folded before Flop (didn't bet)
Seat 6: DooMSDaY1337 folded before Flop (didn't bet)
Seat 7: TraderYao folded before Flop (didn't bet)
Seat 8: KeLevro0 folded before Flop (didn't bet)
Seat 9: monst3r4119 folded before Flop (didn't bet)



PokerStars Zoom Hand #84298213689:  Hold'em No Limit ($0.10/$0.25) - 2012/08/05 13:01:05 JST [2012/08/05 0:01:05 ET]
Table 'Whirlpool' 9-max Seat #1 is the button
Seat 1: chiyuki ($24.50 in chips) 
Seat 2: Lasutchik ($27.20 in chips) 
Seat 3: AndiM64 ($30.68 in chips) 
Seat 4: ll_LaMeR_ll ($16.43 in chips) 
Seat 5: agurio ($30.56 in chips) 
Seat 6: pug2012 ($19.19 in chips) 
Seat 7: masterkoolb ($13.70 in chips) 
Seat 8: fwani ($33.24 in chips) 
Seat 9: Connor82002 ($8.24 in chips) 
Lasutchik: posts small blind $0.10
AndiM64: posts big blind $0.25
*** HOLE CARDS ***
Dealt to chiyuki [Kh 3d]
ll_LaMeR_ll: folds 
agurio: folds 
pug2012: folds 
masterkoolb: folds 
fwani: raises $0.35 to $0.60
Connor82002: calls $0.60
chiyuki: folds 
Lasutchik: folds 
AndiM64: calls $0.35
*** FLOP *** [Jc 6s Qs]
AndiM64: checks 
fwani: bets $1.35
Connor82002: calls $1.35
AndiM64: folds 
*** TURN *** [Jc 6s Qs] [7s]
fwani: bets $2.40
Connor82002: calls $2.40
*** RIVER *** [Jc 6s Qs 7s] [As]
fwani: bets $4.49
Connor82002: calls $3.89 and is all-in
Uncalled bet ($0.60) returned to fwani
*** SHOW DOWN ***
fwani: shows [Ac Ks] (a flush, Ace high)
Connor82002: shows [4s 5s] (a flush, Ace high - lower cards)
fwani collected $16.41 from pot
*** SUMMARY ***
Total pot $17.18 | Rake $0.77 
Board [Jc 6s Qs 7s As]
Seat 1: chiyuki (button) folded before Flop (didn't bet)
Seat 2: Lasutchik (small blind) folded before Flop
Seat 3: AndiM64 (big blind) folded on the Flop
Seat 4: ll_LaMeR_ll folded before Flop (didn't bet)
Seat 5: agurio folded before Flop (didn't bet)
Seat 6: pug2012 folded before Flop (didn't bet)
Seat 7: masterkoolb folded before Flop (didn't bet)
Seat 8: fwani showed [Ac Ks] and won ($16.41) with a flush, Ace high
Seat 9: Connor82002 showed [4s 5s] and lost with a flush, Ace high



PokerStars Zoom Hand #84298232770:  Hold'em No Limit ($0.10/$0.25) - 2012/08/05 13:02:14 JST [2012/08/05 0:02:14 ET]
Table 'Whirlpool' 9-max Seat #1 is the button
Seat 1: JAMES3FINGER ($336.82 in chips) 
Seat 2: chiyuki ($25.57 in chips) 
Seat 3: Jippyflip ($18.86 in chips) 
Seat 4: Assassin365 ($29.88 in chips) 
Seat 5: TraderYao ($28.30 in chips) 
Seat 6: Seadogvcd ($6.33 in chips) 
Seat 7: Th3Fog ($60.54 in chips) 
Seat 8: monst3r4119 ($21.58 in chips) 
Seat 9: nice.franki ($4.47 in chips) 
chiyuki: posts small blind $0.10
Jippyflip: posts big blind $0.25
*** HOLE CARDS ***
Dealt to chiyuki [Jh 6c]
Assassin365: folds 
TraderYao: folds 
Seadogvcd: folds 
Th3Fog: raises $0.50 to $0.75
monst3r4119: folds 
nice.franki: folds 
JAMES3FINGER: folds 
chiyuki: folds 
Jippyflip: folds 
Uncalled bet ($0.50) returned to Th3Fog
Th3Fog collected $0.60 from pot
Th3Fog: doesn't show hand 
*** SUMMARY ***
Total pot $0.60 | Rake $0 
Seat 1: JAMES3FINGER (button) folded before Flop (didn't bet)
Seat 2: chiyuki (small blind) folded before Flop
Seat 3: Jippyflip (big blind) folded before Flop
Seat 4: Assassin365 folded before Flop (didn't bet)
Seat 5: TraderYao folded before Flop (didn't bet)
Seat 6: Seadogvcd folded before Flop (didn't bet)
Seat 7: Th3Fog collected ($0.60)
Seat 8: monst3r4119 folded before Flop (didn't bet)
Seat 9: nice.franki folded before Flop (didn't bet)



PokerStars Zoom Hand #84298233616:  Hold'em No Limit ($0.10/$0.25) - 2012/08/05 13:02:17 JST [2012/08/05 0:02:17 ET]
Table 'Whirlpool' 9-max Seat #1 is the button
Seat 1: AUGH-AUGH ($25.74 in chips) 
Seat 2: wtu1986 ($25.10 in chips) 
Seat 3: a_tasmanian ($60.11 in chips) 
Seat 4: Lasutchik ($26.48 in chips) 
Seat 5: agurio ($25.10 in chips) 
Seat 6: Chevydale ($20.80 in chips) 
Seat 7: fwani ($25 in chips) 
Seat 8: chiyuki ($25.47 in chips) 
Seat 9: TErr18 ($19.99 in chips) 
wtu1986: posts small blind $0.10
a_tasmanian: posts big blind $0.25
*** HOLE CARDS ***
Dealt to chiyuki [Qs Ts]
Lasutchik: folds 
agurio: folds 
Chevydale: folds 
fwani: folds 
chiyuki: folds 
TErr18: folds 
AUGH-AUGH: raises $0.50 to $0.75
wtu1986: folds 
a_tasmanian: folds 
Uncalled bet ($0.50) returned to AUGH-AUGH
AUGH-AUGH collected $0.60 from pot
AUGH-AUGH: doesn't show hand 
*** SUMMARY ***
Total pot $0.60 | Rake $0 
Seat 1: AUGH-AUGH (button) collected ($0.60)
Seat 2: wtu1986 (small blind) folded before Flop
Seat 3: a_tasmanian (big blind) folded before Flop
Seat 4: Lasutchik folded before Flop (didn't bet)
Seat 5: agurio folded before Flop (didn't bet)
Seat 6: Chevydale folded before Flop (didn't bet)
Seat 7: fwani folded before Flop (didn't bet)
Seat 8: chiyuki folded before Flop (didn't bet)
Seat 9: TErr18 folded before Flop (didn't bet)



PokerStars Zoom Hand #84298238209:  Hold'em No Limit ($0.10/$0.25) - 2012/08/05 13:02:35 JST [2012/08/05 0:02:35 ET]
Table 'Whirlpool' 9-max Seat #1 is the button
Seat 1: chiyuki ($25.47 in chips) 
Seat 2: DooMSDaY1337 ($38.04 in chips) 
Seat 3: Seadogvcd ($6.09 in chips) 
Seat 4: RomarioJa ($11.66 in chips) 
Seat 5: Th3Fog ($52.70 in chips) 
Seat 6: Catrban ($26.55 in chips) 
Seat 7: AndiM64 ($28.40 in chips) 
Seat 8: ll_LaMeR_ll ($18.68 in chips) 
Seat 9: eagie20 ($144.59 in chips) 
DooMSDaY1337: posts small blind $0.10
Seadogvcd: posts big blind $0.25
*** HOLE CARDS ***
Dealt to chiyuki [2h 5d]
RomarioJa: folds 
Th3Fog: folds 
Catrban: folds 
AndiM64: folds 
ll_LaMeR_ll: folds 
eagie20: raises $0.50 to $0.75
chiyuki: folds 
DooMSDaY1337: folds 
Seadogvcd: folds 
Uncalled bet ($0.50) returned to eagie20
eagie20 collected $0.60 from pot
eagie20: doesn't show hand 
*** SUMMARY ***
Total pot $0.60 | Rake $0 
Seat 1: chiyuki (button) folded before Flop (didn't bet)
Seat 2: DooMSDaY1337 (small blind) folded before Flop
Seat 3: Seadogvcd (big blind) folded before Flop
Seat 4: RomarioJa folded before Flop (didn't bet)
Seat 5: Th3Fog folded before Flop (didn't bet)
Seat 6: Catrban folded before Flop (didn't bet)
Seat 7: AndiM64 folded before Flop (didn't bet)
Seat 8: ll_LaMeR_ll folded before Flop (didn't bet)
Seat 9: eagie20 collected ($0.60)



PokerStars Zoom Hand #84298237406:  Hold'em No Limit ($0.10/$0.25) - 2012/08/05 13:02:32 JST [2012/08/05 0:02:32 ET]
Table 'Whirlpool' 9-max Seat #1 is the button
Seat 1: monst3r4119 ($21.58 in chips) 
Seat 2: TErr18 ($19.99 in chips) 
Seat 3: taksist889 ($20.86 in chips) 
Seat 4: Anafim ($18.13 in chips) 
Seat 5: chiyuki ($25.47 in chips) 
Seat 6: masterkoolb ($13.92 in chips) 
Seat 7: Shugana ($25 in chips) 
Seat 8: petersmiths ($25.68 in chips) 
Seat 9: deadmoneykid ($24.65 in chips) 
TErr18: posts small blind $0.10
taksist889: posts big blind $0.25
*** HOLE CARDS ***
Dealt to chiyuki [3s Ah]
Anafim: folds 
chiyuki: folds 
masterkoolb: folds 
Shugana: folds 
petersmiths: raises $0.25 to $0.50
deadmoneykid: folds 
monst3r4119: folds 
TErr18: folds 
taksist889: folds 
Uncalled bet ($0.25) returned to petersmiths
petersmiths collected $0.60 from pot
petersmiths: doesn't show hand 
*** SUMMARY ***
Total pot $0.60 | Rake $0 
Seat 1: monst3r4119 (button) folded before Flop (didn't bet)
Seat 2: TErr18 (small blind) folded before Flop
Seat 3: taksist889 (big blind) folded before Flop
Seat 4: Anafim folded before Flop (didn't bet)
Seat 5: chiyuki folded before Flop (didn't bet)
Seat 6: masterkoolb folded before Flop (didn't bet)
Seat 7: Shugana folded before Flop (didn't bet)
Seat 8: petersmiths collected ($0.60)
Seat 9: deadmoneykid folded before Flop (didn't bet)



PokerStars Zoom Hand #84298239317:  Hold'em No Limit ($0.10/$0.25) - 2012/08/05 13:02:39 JST [2012/08/05 0:02:39 ET]
Table 'Whirlpool' 9-max Seat #1 is the button
Seat 1: a_tasmanian ($59.86 in chips) 
Seat 2: mikifeio ($30.14 in chips) 
Seat 3: BlOnDhOlIc ($44.32 in chips) 
Seat 4: fwani ($28.03 in chips) 
Seat 5: chiyuki ($25.47 in chips) 
Seat 6: ll_LaMeR_ll ($18.68 in chips) 
Seat 7: KrystalAA ($34.84 in chips) 
Seat 8: masterkoolb ($13.92 in chips) 
Seat 9: Anafim ($12.50 in chips) 
mikifeio: posts small blind $0.10
BlOnDhOlIc: posts big blind $0.25
*** HOLE CARDS ***
Dealt to chiyuki [5s 6c]
fwani: folds 
chiyuki: folds 
ll_LaMeR_ll: raises $0.75 to $1
KrystalAA: folds 
masterkoolb: folds 
Anafim: folds 
a_tasmanian: folds 
mikifeio: folds 
BlOnDhOlIc: folds 
Uncalled bet ($0.75) returned to ll_LaMeR_ll
ll_LaMeR_ll collected $0.60 from pot
ll_LaMeR_ll: doesn't show hand 
*** SUMMARY ***
Total pot $0.60 | Rake $0 
Seat 1: a_tasmanian (button) folded before Flop (didn't bet)
Seat 2: mikifeio (small blind) folded before Flop
Seat 3: BlOnDhOlIc (big blind) folded before Flop
Seat 4: fwani folded before Flop (didn't bet)
Seat 5: chiyuki folded before Flop (didn't bet)
Seat 6: ll_LaMeR_ll collected ($0.60)
Seat 7: KrystalAA folded before Flop (didn't bet)
Seat 8: masterkoolb folded before Flop (didn't bet)
Seat 9: Anafim folded before Flop (didn't bet)



PokerStars Zoom Hand #84298241284:  Hold'em No Limit ($0.10/$0.25) - 2012/08/05 13:02:46 JST [2012/08/05 0:02:46 ET]
Table 'Whirlpool' 9-max Seat #1 is the button
Seat 1: wtu1986 ($25 in chips) 
Seat 2: BlOnDhOlIc ($33.15 in chips) 
Seat 3: chiyuki ($25.47 in chips) 
Seat 4: Th3Fog ($60.89 in chips) 
Seat 5: Sharks_Nica ($66.43 in chips) 
Seat 6: RomarioJa ($8.30 in chips) 
Seat 7: AUGH-AUGH ($30.82 in chips) 
Seat 8: TErr18 ($21.91 in chips) 
Seat 9: deadmoneykid ($22.40 in chips) 
BlOnDhOlIc: posts small blind $0.10
chiyuki: posts big blind $0.25
*** HOLE CARDS ***
Dealt to chiyuki [2h Td]
Th3Fog: folds 
Sharks_Nica: folds 
RomarioJa: raises $0.37 to $0.62
AUGH-AUGH: folds 
TErr18: folds 
deadmoneykid: folds 
wtu1986: folds 
BlOnDhOlIc: folds 
chiyuki: folds 
Uncalled bet ($0.37) returned to RomarioJa
RomarioJa collected $0.60 from pot
RomarioJa: doesn't show hand 
*** SUMMARY ***
Total pot $0.60 | Rake $0 
Seat 1: wtu1986 (button) folded before Flop (didn't bet)
Seat 2: BlOnDhOlIc (small blind) folded before Flop
Seat 3: chiyuki (big blind) folded before Flop
Seat 4: Th3Fog folded before Flop (didn't bet)
Seat 5: Sharks_Nica folded before Flop (didn't bet)
Seat 6: RomarioJa collected ($0.60)
Seat 7: AUGH-AUGH folded before Flop (didn't bet)
Seat 8: TErr18 folded before Flop (didn't bet)
Seat 9: deadmoneykid folded before Flop (didn't bet)



PokerStars Zoom Hand #84298235243:  Hold'em No Limit ($0.10/$0.25) - 2012/08/05 13:02:24 JST [2012/08/05 0:02:24 ET]
Table 'Whirlpool' 9-max Seat #1 is the button
Seat 1: masterkoolb ($14.02 in chips) 
Seat 2: leo2095 ($14.52 in chips) 
Seat 3: KeLevro0 ($12 in chips) 
Seat 4: taksist889 ($20.86 in chips) 
Seat 5: Rsonal ($36.64 in chips) 
Seat 6: chiyuki ($25.47 in chips) 
Seat 7: 2997qwer ($10.15 in chips) 
Seat 8: nice.franki ($19.79 in chips) 
Seat 9: MATT361 ($13.58 in chips) 
leo2095: posts small blind $0.10
KeLevro0: posts big blind $0.25
*** HOLE CARDS ***
Dealt to chiyuki [4s Kc]
taksist889: folds 
Rsonal: raises $0.25 to $0.50
chiyuki: folds 
2997qwer: folds 
nice.franki: raises $1 to $1.50
MATT361: folds 
masterkoolb: folds 
leo2095: folds 
KeLevro0: folds 
Rsonal: raises $1 to $2.50
nice.franki: calls $1
*** FLOP *** [2c 8d Ac]
Rsonal: bets $3.25
nice.franki: folds 
Uncalled bet ($3.25) returned to Rsonal
Rsonal collected $5.11 from pot
Rsonal: doesn't show hand 
*** SUMMARY ***
Total pot $5.35 | Rake $0.24 
Board [2c 8d Ac]
Seat 1: masterkoolb (button) folded before Flop (didn't bet)
Seat 2: leo2095 (small blind) folded before Flop
Seat 3: KeLevro0 (big blind) folded before Flop
Seat 4: taksist889 folded before Flop (didn't bet)
Seat 5: Rsonal collected ($5.11)
Seat 6: chiyuki folded before Flop (didn't bet)
Seat 7: 2997qwer folded before Flop (didn't bet)
Seat 8: nice.franki folded on the Flop
Seat 9: MATT361 folded before Flop (didn't bet)



PokerStars Zoom Hand #84298245549:  Hold'em No Limit ($0.10/$0.25) - 2012/08/05 13:03:01 JST [2012/08/05 0:03:01 ET]
Table 'Whirlpool' 9-max Seat #1 is the button
Seat 1: s9999999 ($17.34 in chips) 
Seat 2: Th3Fog ($52.80 in chips) 
Seat 3: ll_LaMeR_ll ($19.03 in chips) 
Seat 4: Anafim ($12.50 in chips) 
Seat 5: deadmoneykid ($22.40 in chips) 
Seat 6: fwani ($28.03 in chips) 
Seat 7: KeLevro0 ($11.90 in chips) 
Seat 8: jtedecaliss ($175.79 in chips) 
Seat 9: chiyuki ($25.22 in chips) 
Th3Fog: posts small blind $0.10
ll_LaMeR_ll: posts big blind $0.25
*** HOLE CARDS ***
Dealt to chiyuki [8d 8c]
Anafim: folds 
deadmoneykid: folds 
fwani: folds 
KeLevro0: folds 
jtedecaliss: folds 
chiyuki: raises $0.50 to $0.75
s9999999: folds 
Th3Fog: folds 
ll_LaMeR_ll: calls $0.50
*** FLOP *** [Ts 3c 7d]
ll_LaMeR_ll: checks 
chiyuki: bets $0.76
ll_LaMeR_ll: raises $1.74 to $2.50
chiyuki: folds 
Uncalled bet ($1.74) returned to ll_LaMeR_ll
ll_LaMeR_ll collected $2.98 from pot
ll_LaMeR_ll: doesn't show hand 
*** SUMMARY ***
Total pot $3.12 | Rake $0.14 
Board [Ts 3c 7d]
Seat 1: s9999999 (button) folded before Flop (didn't bet)
Seat 2: Th3Fog (small blind) folded before Flop
Seat 3: ll_LaMeR_ll (big blind) collected ($2.98)
Seat 4: Anafim folded before Flop (didn't bet)
Seat 5: deadmoneykid folded before Flop (didn't bet)
Seat 6: fwani folded before Flop (didn't bet)
Seat 7: KeLevro0 folded before Flop (didn't bet)
Seat 8: jtedecaliss folded before Flop (didn't bet)
Seat 9: chiyuki folded on the Flop



PokerStars Zoom Hand #84298263048:  Hold'em No Limit ($0.10/$0.25) - 2012/08/05 13:04:01 JST [2012/08/05 0:04:01 ET]
Table 'Whirlpool' 9-max Seat #1 is the button
Seat 1: Medic8681 ($14.32 in chips) 
Seat 2: polk11 ($20.13 in chips) 
Seat 3: BlOnDhOlIc ($43.97 in chips) 
Seat 4: Jippyflip ($21.13 in chips) 
Seat 5: a_tasmanian ($59.01 in chips) 
Seat 6: chiyuki ($23.71 in chips) 
Seat 7: Oswulf ($13.98 in chips) 
Seat 8: AUGH-AUGH ($30.47 in chips) 
Seat 9: deadmoneykid ($24.30 in chips) 
polk11: posts small blind $0.10
BlOnDhOlIc: posts big blind $0.25
*** HOLE CARDS ***
Dealt to chiyuki [Tc Ts]
Jippyflip: folds 
a_tasmanian: folds 
chiyuki: raises $0.50 to $0.75
Oswulf: folds 
AUGH-AUGH: folds 
deadmoneykid: folds 
Medic8681: calls $0.75
polk11: folds 
BlOnDhOlIc: folds 
*** FLOP *** [5c 9d 8d]
chiyuki: bets $1
Medic8681: folds 
Uncalled bet ($1) returned to chiyuki
chiyuki collected $1.77 from pot
chiyuki: doesn't show hand 
*** SUMMARY ***
Total pot $1.85 | Rake $0.08 
Board [5c 9d 8d]
Seat 1: Medic8681 (button) folded on the Flop
Seat 2: polk11 (small blind) folded before Flop
Seat 3: BlOnDhOlIc (big blind) folded before Flop
Seat 4: Jippyflip folded before Flop (didn't bet)
Seat 5: a_tasmanian folded before Flop (didn't bet)
Seat 6: chiyuki collected ($1.77)
Seat 7: Oswulf folded before Flop (didn't bet)
Seat 8: AUGH-AUGH folded before Flop (didn't bet)
Seat 9: deadmoneykid folded before Flop (didn't bet)



PokerStars Zoom Hand #84298277961:  Hold'em No Limit ($0.10/$0.25) - 2012/08/05 13:04:52 JST [2012/08/05 0:04:52 ET]
Table 'Whirlpool' 9-max Seat #1 is the button
Seat 1: Anafim ($12.50 in chips) 
Seat 2: petersmiths ($29.93 in chips) 
Seat 3: AndiM64 ($26.50 in chips) 
Seat 4: Lasutchik ($10.40 in chips) 
Seat 5: TraderYao ($25 in chips) 
Seat 6: BlOnDhOlIc ($43.62 in chips) 
Seat 7: chiyuki ($24.63 in chips) 
Seat 8: DooMSDaY1337 ($63.45 in chips) 
Seat 9: pyty_82 ($50.49 in chips) 
petersmiths: posts small blind $0.10
AndiM64: posts big blind $0.25
*** HOLE CARDS ***
Dealt to chiyuki [Jh Qs]
Lasutchik: raises $0.37 to $0.62
TraderYao: folds 
BlOnDhOlIc: folds 
chiyuki: folds 
DooMSDaY1337: folds 
pyty_82: folds 
Anafim: folds 
petersmiths: folds 
AndiM64: folds 
Uncalled bet ($0.37) returned to Lasutchik
Lasutchik collected $0.60 from pot
Lasutchik: doesn't show hand 
*** SUMMARY ***
Total pot $0.60 | Rake $0 
Seat 1: Anafim (button) folded before Flop (didn't bet)
Seat 2: petersmiths (small blind) folded before Flop
Seat 3: AndiM64 (big blind) folded before Flop
Seat 4: Lasutchik collected ($0.60)
Seat 5: TraderYao folded before Flop (didn't bet)
Seat 6: BlOnDhOlIc folded before Flop (didn't bet)
Seat 7: chiyuki folded before Flop (didn't bet)
Seat 8: DooMSDaY1337 folded before Flop (didn't bet)
Seat 9: pyty_82 folded before Flop (didn't bet)



PokerStars Zoom Hand #84298270779:  Hold'em No Limit ($0.10/$0.25) - 2012/08/05 13:04:27 JST [2012/08/05 0:04:27 ET]
Table 'Whirlpool' 9-max Seat #1 is the button
Seat 1: KeLevro0 ($12.78 in chips) 
Seat 2: chiyuki ($24.73 in chips) 
Seat 3: mayathebee83 ($9.85 in chips) 
Seat 4: Loholov ($15.35 in chips) 
Seat 5: eagie20 ($142.27 in chips) 
Seat 6: Th3Fog ($21.04 in chips) 
Seat 7: DooMSDaY1337 ($63.45 in chips) 
Seat 8: wtu1986 ($24.75 in chips) 
Seat 9: ShevchukAI ($12.15 in chips) 
chiyuki: posts small blind $0.10
mayathebee83: posts big blind $0.25
*** HOLE CARDS ***
Dealt to chiyuki [8h 4c]
Loholov: raises $0.50 to $0.75
eagie20: folds 
Th3Fog: folds 
DooMSDaY1337: folds 
wtu1986: folds 
ShevchukAI: folds 
KeLevro0: calls $0.75
chiyuki: folds 
mayathebee83: folds 
*** FLOP *** [Kd Tc Js]
Loholov: bets $1.50
KeLevro0: folds 
Uncalled bet ($1.50) returned to Loholov
Loholov collected $1.77 from pot
Loholov: doesn't show hand 
*** SUMMARY ***
Total pot $1.85 | Rake $0.08 
Board [Kd Tc Js]
Seat 1: KeLevro0 (button) folded on the Flop
Seat 2: chiyuki (small blind) folded before Flop
Seat 3: mayathebee83 (big blind) folded before Flop
Seat 4: Loholov collected ($1.77)
Seat 5: eagie20 folded before Flop (didn't bet)
Seat 6: Th3Fog folded before Flop (didn't bet)
Seat 7: DooMSDaY1337 folded before Flop (didn't bet)
Seat 8: wtu1986 folded before Flop (didn't bet)
Seat 9: ShevchukAI folded before Flop (didn't bet)



PokerStars Zoom Hand #84298279154:  Hold'em No Limit ($0.10/$0.25) - 2012/08/05 13:04:56 JST [2012/08/05 0:04:56 ET]
Table 'Whirlpool' 9-max Seat #1 is the button
Seat 1: petersmiths ($29.83 in chips) 
Seat 2: DT_Jesus ($28.41 in chips) 
Seat 3: eagie20 ($142.17 in chips) 
Seat 4: chiyuki ($24.63 in chips) 
Seat 5: softdesign ($42.57 in chips) 
Seat 6: Jene4kaBest ($10.89 in chips) 
Seat 7: DooMSDaY1337 ($63.45 in chips) 
Seat 8: fwani ($42.51 in chips) 
Seat 9: wtu1986 ($24.90 in chips) 
DT_Jesus: posts small blind $0.10
eagie20: posts big blind $0.25
*** HOLE CARDS ***
Dealt to chiyuki [6d 6c]
chiyuki: raises $0.50 to $0.75
softdesign: folds 
Jene4kaBest: folds 
DooMSDaY1337: folds 
fwani: folds 
wtu1986: folds 
petersmiths: calls $0.75
DT_Jesus: folds 
eagie20: folds 
*** FLOP *** [Td 8c Qc]
chiyuki: bets $1
petersmiths: folds 
Uncalled bet ($1) returned to chiyuki
chiyuki collected $1.77 from pot
chiyuki: doesn't show hand 
*** SUMMARY ***
Total pot $1.85 | Rake $0.08 
Board [Td 8c Qc]
Seat 1: petersmiths (button) folded on the Flop
Seat 2: DT_Jesus (small blind) folded before Flop
Seat 3: eagie20 (big blind) folded before Flop
Seat 4: chiyuki collected ($1.77)
Seat 5: softdesign folded before Flop (didn't bet)
Seat 6: Jene4kaBest folded before Flop (didn't bet)
Seat 7: DooMSDaY1337 folded before Flop (didn't bet)
Seat 8: fwani folded before Flop (didn't bet)
Seat 9: wtu1986 folded before Flop (didn't bet)



PokerStars Zoom Hand #84298276390:  Hold'em No Limit ($0.10/$0.25) - 2012/08/05 13:04:46 JST [2012/08/05 0:04:46 ET]
Table 'Whirlpool' 9-max Seat #1 is the button
Seat 1: ll_LaMeR_ll ($20.75 in chips) 
Seat 2: taksist889 ($25.27 in chips) 
Seat 3: bigrasbig ($12.50 in chips) 
Seat 4: kamikkaze ($43.49 in chips) 
Seat 5: pyty_82 ($50.49 in chips) 
Seat 6: jtedecaliss ($175.77 in chips) 
Seat 7: fwani ($42.51 in chips) 
Seat 8: chiyuki ($24.63 in chips) 
Seat 9: TankAbbott1 ($30.26 in chips) 
taksist889: posts small blind $0.10
bigrasbig: posts big blind $0.25
*** HOLE CARDS ***
Dealt to chiyuki [Js 9d]
kamikkaze: folds 
pyty_82: folds 
jtedecaliss: folds 
fwani: folds 
chiyuki: folds 
TankAbbott1: raises $0.50 to $0.75
ll_LaMeR_ll: folds 
taksist889: folds 
bigrasbig: calls $0.50
*** FLOP *** [5d 7s Td]
bigrasbig: checks 
TankAbbott1: checks 
*** TURN *** [5d 7s Td] [3c]
bigrasbig: checks 
TankAbbott1: bets $0.50
bigrasbig: calls $0.50
*** RIVER *** [5d 7s Td 3c] [Tc]
bigrasbig: checks 
TankAbbott1: checks 
*** SHOW DOWN ***
bigrasbig: shows [3h Qh] (two pair, Tens and Threes)
TankAbbott1: mucks hand 
bigrasbig collected $2.48 from pot
*** SUMMARY ***
Total pot $2.60 | Rake $0.12 
Board [5d 7s Td 3c Tc]
Seat 1: ll_LaMeR_ll (button) folded before Flop (didn't bet)
Seat 2: taksist889 (small blind) folded before Flop
Seat 3: bigrasbig (big blind) showed [3h Qh] and won ($2.48) with two pair, Tens and Threes
Seat 4: kamikkaze folded before Flop (didn't bet)
Seat 5: pyty_82 folded before Flop (didn't bet)
Seat 6: jtedecaliss folded before Flop (didn't bet)
Seat 7: fwani folded before Flop (didn't bet)
Seat 8: chiyuki folded before Flop (didn't bet)
Seat 9: TankAbbott1 mucked [Ah Kd]



PokerStars Zoom Hand #84298287399:  Hold'em No Limit ($0.10/$0.25) - 2012/08/05 13:05:24 JST [2012/08/05 0:05:24 ET]
Table 'Whirlpool' 9-max Seat #1 is the button
Seat 1: chiyuki ($25.65 in chips) 
Seat 2: Lab50att ($15.78 in chips) 
Seat 3: PetitAlejo ($25 in chips) 
Seat 4: masterkoolb ($12.50 in chips) 
Seat 5: RomarioJa ($12.66 in chips) 
Seat 6: DooMSDaY1337 ($25.35 in chips) 
Seat 7: fwani ($25 in chips) 
Seat 8: AUGH-AUGH ($30.22 in chips) 
Seat 9: deadmoneykid ($24.05 in chips) 
Lab50att: posts small blind $0.10
PetitAlejo: posts big blind $0.25
*** HOLE CARDS ***
Dealt to chiyuki [5s Kd]
masterkoolb: folds 
RomarioJa: folds 
DooMSDaY1337: raises $0.50 to $0.75
fwani: calls $0.75
AUGH-AUGH: folds 
deadmoneykid: folds 
chiyuki: folds 
Lab50att: folds 
PetitAlejo: folds 
*** FLOP *** [Qs 5d 7d]
DooMSDaY1337: bets $0.88
fwani: calls $0.88
*** TURN *** [Qs 5d 7d] [8d]
DooMSDaY1337: checks 
fwani: checks 
*** RIVER *** [Qs 5d 7d 8d] [8h]
DooMSDaY1337: bets $2.50
fwani: folds 
Uncalled bet ($2.50) returned to DooMSDaY1337
DooMSDaY1337 collected $3.45 from pot
DooMSDaY1337: doesn't show hand 
*** SUMMARY ***
Total pot $3.61 | Rake $0.16 
Board [Qs 5d 7d 8d 8h]
Seat 1: chiyuki (button) folded before Flop (didn't bet)
Seat 2: Lab50att (small blind) folded before Flop
Seat 3: PetitAlejo (big blind) folded before Flop
Seat 4: masterkoolb folded before Flop (didn't bet)
Seat 5: RomarioJa folded before Flop (didn't bet)
Seat 6: DooMSDaY1337 collected ($3.45)
Seat 7: fwani folded on the River
Seat 8: AUGH-AUGH folded before Flop (didn't bet)
Seat 9: deadmoneykid folded before Flop (didn't bet)



PokerStars Zoom Hand #84298290058:  Hold'em No Limit ($0.10/$0.25) - 2012/08/05 13:05:33 JST [2012/08/05 0:05:33 ET]
Table 'Whirlpool' 9-max Seat #1 is the button
Seat 1: RomarioJa ($16.66 in chips) 
Seat 2: PetitAlejo ($25 in chips) 
Seat 3: Lasutchik ($12.50 in chips) 
Seat 4: KeLevro0 ($11.30 in chips) 
Seat 5: s9999999 ($13.65 in chips) 
Seat 6: Sharks_Nica ($67.90 in chips) 
Seat 7: chiyuki ($25.65 in chips) 
Seat 8: TraderYao ($25.37 in chips) 
Seat 9: agurio ($25 in chips) 
PetitAlejo: posts small blind $0.10
Lasutchik: posts big blind $0.25
*** HOLE CARDS ***
Dealt to chiyuki [4h 4c]
KeLevro0: folds 
s9999999: folds 
Sharks_Nica: folds 
chiyuki: raises $0.50 to $0.75
TraderYao: folds 
agurio: folds 
RomarioJa: folds 
PetitAlejo: folds 
Lasutchik: folds 
Uncalled bet ($0.50) returned to chiyuki
chiyuki collected $0.60 from pot
chiyuki: doesn't show hand 
*** SUMMARY ***
Total pot $0.60 | Rake $0 
Seat 1: RomarioJa (button) folded before Flop (didn't bet)
Seat 2: PetitAlejo (small blind) folded before Flop
Seat 3: Lasutchik (big blind) folded before Flop
Seat 4: KeLevro0 folded before Flop (didn't bet)
Seat 5: s9999999 folded before Flop (didn't bet)
Seat 6: Sharks_Nica folded before Flop (didn't bet)
Seat 7: chiyuki collected ($0.60)
Seat 8: TraderYao folded before Flop (didn't bet)
Seat 9: agurio folded before Flop (didn't bet)



PokerStars Zoom Hand #84298306538:  Hold'em No Limit ($0.10/$0.25) - 2012/08/05 13:06:30 JST [2012/08/05 0:06:30 ET]
Table 'Whirlpool' 9-max Seat #1 is the button
Seat 1: DT_Jesus ($27.56 in chips) 
Seat 2: Lasutchik ($12.25 in chips) 
Seat 3: Zugrug ($25 in chips) 
Seat 4: KrystalAA ($34.26 in chips) 
Seat 5: chiyuki ($26 in chips) 
Seat 6: jtedecaliss ($183.38 in chips) 
Seat 7: PetitAlejo ($25.37 in chips) 
Seat 8: Chevydale ($14.80 in chips) 
Seat 9: seula i ($50.52 in chips) 
Lasutchik: posts small blind $0.10
Zugrug: posts big blind $0.25
*** HOLE CARDS ***
Dealt to chiyuki [3d Qc]
KrystalAA: folds 
chiyuki: folds 
jtedecaliss: folds 
PetitAlejo: folds 
Chevydale: raises $0.50 to $0.75
seula i: folds 
DT_Jesus: calls $0.75
Lasutchik: folds 
Zugrug: folds 
*** FLOP *** [2s 6s 7c]
Chevydale: bets $1
DT_Jesus: calls $1
*** TURN *** [2s 6s 7c] [6d]
Chevydale: bets $1.69
DT_Jesus: raises $3.53 to $5.22
Chevydale: folds 
Uncalled bet ($3.53) returned to DT_Jesus
DT_Jesus collected $6.90 from pot
DT_Jesus: doesn't show hand 
*** SUMMARY ***
Total pot $7.23 | Rake $0.33 
Board [2s 6s 7c 6d]
Seat 1: DT_Jesus (button) collected ($6.90)
Seat 2: Lasutchik (small blind) folded before Flop
Seat 3: Zugrug (big blind) folded before Flop
Seat 4: KrystalAA folded before Flop (didn't bet)
Seat 5: chiyuki folded before Flop (didn't bet)
Seat 6: jtedecaliss folded before Flop (didn't bet)
Seat 7: PetitAlejo folded before Flop (didn't bet)
Seat 8: Chevydale folded on the Turn
Seat 9: seula i folded before Flop (didn't bet)



PokerStars Zoom Hand #84298308924:  Hold'em No Limit ($0.10/$0.25) - 2012/08/05 13:06:38 JST [2012/08/05 0:06:38 ET]
Table 'Whirlpool' 9-max Seat #1 is the button
Seat 1: D@vidMed ($28.36 in chips) 
Seat 2: Medic8681 ($17.62 in chips) 
Seat 3: chiyuki ($26 in chips) 
Seat 4: cR!Ma*aRm ($24.75 in chips) 
Seat 5: masterkoolb ($12.50 in chips) 
Seat 6: PetitAlejo ($25.37 in chips) 
Seat 7: 2997qwer ($8.57 in chips) 
Seat 8: KrystalAA ($28.15 in chips) 
Seat 9: Lasutchik ($26.92 in chips) 
Medic8681: posts small blind $0.10
chiyuki: posts big blind $0.25
*** HOLE CARDS ***
Dealt to chiyuki [Kd Jd]
cR!Ma*aRm: folds 
masterkoolb: raises $0.60 to $0.85
PetitAlejo: calls $0.85
2997qwer: folds 
KrystalAA: folds 
Lasutchik: folds 
D@vidMed: calls $0.85
Medic8681: calls $0.75
chiyuki: calls $0.60
*** FLOP *** [8c 8h 3h]
Medic8681: checks 
chiyuki: checks 
masterkoolb: checks 
PetitAlejo: bets $1.21
D@vidMed: calls $1.21
Medic8681: calls $1.21
chiyuki: folds 
masterkoolb: folds 
*** TURN *** [8c 8h 3h] [8d]
Medic8681: checks 
PetitAlejo: checks 
D@vidMed: checks 
*** RIVER *** [8c 8h 3h 8d] [7s]
Medic8681: checks 
PetitAlejo: checks 
D@vidMed: bets $3.38
Medic8681: calls $3.38
PetitAlejo: folds 
*** SHOW DOWN ***
D@vidMed: shows [Js Ts] (three of a kind, Eights)
Medic8681: shows [5s 5h] (a full house, Eights full of Fives)
Medic8681 collected $13.98 from pot
*** SUMMARY ***
Total pot $14.64 | Rake $0.66 
Board [8c 8h 3h 8d 7s]
Seat 1: D@vidMed (button) showed [Js Ts] and lost with three of a kind, Eights
Seat 2: Medic8681 (small blind) showed [5s 5h] and won ($13.98) with a full house, Eights full of Fives
Seat 3: chiyuki (big blind) folded on the Flop
Seat 4: cR!Ma*aRm folded before Flop (didn't bet)
Seat 5: masterkoolb folded on the Flop
Seat 6: PetitAlejo folded on the River
Seat 7: 2997qwer folded before Flop (didn't bet)
Seat 8: KrystalAA folded before Flop (didn't bet)
Seat 9: Lasutchik folded before Flop (didn't bet)



PokerStars Zoom Hand #84298344375:  Hold'em No Limit ($0.10/$0.25) - 2012/08/05 13:08:40 JST [2012/08/05 0:08:40 ET]
Table 'Whirlpool' 9-max Seat #1 is the button
Seat 1: ShevchukAI ($13.12 in chips) 
Seat 2: chiyuki ($25.15 in chips) 
Seat 3: JAMES3FINGER ($331.52 in chips) 
Seat 4: wtu1986 ($25 in chips) 
Seat 5: MATT361 ($11.98 in chips) 
Seat 6: Lab50att ($16.57 in chips) 
Seat 7: Alvinpe85 ($25.82 in chips) 
Seat 8: Jene4kaBest ($9.13 in chips) 
Seat 9: BlOnDhOlIc ($25 in chips) 
chiyuki: posts small blind $0.10
JAMES3FINGER: posts big blind $0.25
*** HOLE CARDS ***
Dealt to chiyuki [6c 4h]
wtu1986: folds 
MATT361: folds 
Lab50att: folds 
Alvinpe85: folds 
Jene4kaBest: raises $0.50 to $0.75
BlOnDhOlIc: folds 
ShevchukAI: folds 
chiyuki: folds 
JAMES3FINGER: raises $2.25 to $3
Jene4kaBest: folds 
Uncalled bet ($2.25) returned to JAMES3FINGER
JAMES3FINGER collected $1.60 from pot
JAMES3FINGER: doesn't show hand 
*** SUMMARY ***
Total pot $1.60 | Rake $0 
Seat 1: ShevchukAI (button) folded before Flop (didn't bet)
Seat 2: chiyuki (small blind) folded before Flop
Seat 3: JAMES3FINGER (big blind) collected ($1.60)
Seat 4: wtu1986 folded before Flop (didn't bet)
Seat 5: MATT361 folded before Flop (didn't bet)
Seat 6: Lab50att folded before Flop (didn't bet)
Seat 7: Alvinpe85 folded before Flop (didn't bet)
Seat 8: Jene4kaBest folded before Flop
Seat 9: BlOnDhOlIc folded before Flop (didn't bet)



PokerStars Zoom Hand #84298350185:  Hold'em No Limit ($0.10/$0.25) - 2012/08/05 13:09:00 JST [2012/08/05 0:09:00 ET]
Table 'Whirlpool' 9-max Seat #1 is the button
Seat 1: Loholov ($15 in chips) 
Seat 2: DanyArdaggo ($24.40 in chips) 
Seat 3: KeLevro0 ($12.50 in chips) 
Seat 4: doanut13 ($18.70 in chips) 
Seat 5: chiyuki ($25.05 in chips) 
Seat 6: fwani ($32.18 in chips) 
Seat 7: Medic8681 ($15.52 in chips) 
Seat 8: polk11 ($24.65 in chips) 
Seat 9: Lab50att ($16.57 in chips) 
DanyArdaggo: posts small blind $0.10
KeLevro0: posts big blind $0.25
*** HOLE CARDS ***
Dealt to chiyuki [8d Tc]
doanut13: folds 
chiyuki: folds 
fwani: folds 
Medic8681: folds 
polk11: folds 
Lab50att: raises $0.50 to $0.75
Loholov: folds 
DanyArdaggo: folds 
KeLevro0: folds 
Uncalled bet ($0.50) returned to Lab50att
Lab50att collected $0.60 from pot
Lab50att: doesn't show hand 
*** SUMMARY ***
Total pot $0.60 | Rake $0 
Seat 1: Loholov (button) folded before Flop (didn't bet)
Seat 2: DanyArdaggo (small blind) folded before Flop
Seat 3: KeLevro0 (big blind) folded before Flop
Seat 4: doanut13 folded before Flop (didn't bet)
Seat 5: chiyuki folded before Flop (didn't bet)
Seat 6: fwani folded before Flop (didn't bet)
Seat 7: Medic8681 folded before Flop (didn't bet)
Seat 8: polk11 folded before Flop (didn't bet)
Seat 9: Lab50att collected ($0.60)



PokerStars Zoom Hand #84298351914:  Hold'em No Limit ($0.10/$0.25) - 2012/08/05 13:09:06 JST [2012/08/05 0:09:06 ET]
Table 'Whirlpool' 9-max Seat #1 is the button
Seat 1: chiyuki ($25.05 in chips) 
Seat 2: gunbowler ($92.14 in chips) 
Seat 3: fwani ($32.18 in chips) 
Seat 4: DooMSDaY1337 ($25.45 in chips) 
Seat 5: JAMES3FINGER ($332.37 in chips) 
Seat 6: BlOnDhOlIc ($50.05 in chips) 
Seat 7: Alvinpe85 ($25 in chips) 
Seat 8: mollybally1 ($13.73 in chips) 
Seat 9: PetitAlejo ($40.62 in chips) 
gunbowler: posts small blind $0.10
fwani: posts big blind $0.25
*** HOLE CARDS ***
Dealt to chiyuki [6h Qh]
DooMSDaY1337: folds 
JAMES3FINGER: folds 
BlOnDhOlIc: folds 
Alvinpe85: folds 
mollybally1: folds 
PetitAlejo: folds 
chiyuki: raises $0.50 to $0.75
gunbowler: folds 
fwani: folds 
Uncalled bet ($0.50) returned to chiyuki
chiyuki collected $0.60 from pot
chiyuki: doesn't show hand 
*** SUMMARY ***
Total pot $0.60 | Rake $0 
Seat 1: chiyuki (button) collected ($0.60)
Seat 2: gunbowler (small blind) folded before Flop
Seat 3: fwani (big blind) folded before Flop
Seat 4: DooMSDaY1337 folded before Flop (didn't bet)
Seat 5: JAMES3FINGER folded before Flop (didn't bet)
Seat 6: BlOnDhOlIc folded before Flop (didn't bet)
Seat 7: Alvinpe85 folded before Flop (didn't bet)
Seat 8: mollybally1 folded before Flop (didn't bet)
Seat 9: PetitAlejo folded before Flop (didn't bet)



PokerStars Zoom Hand #84298341382:  Hold'em No Limit ($0.10/$0.25) - 2012/08/05 13:08:30 JST [2012/08/05 0:08:30 ET]
Table 'Whirlpool' 9-max Seat #1 is the button
Seat 1: Lab50att ($16.67 in chips) 
Seat 2: cR!Ma*aRm ($19.48 in chips) 
Seat 3: nice.franki ($6.56 in chips) 
Seat 4: mollybally1 ($13.83 in chips) 
Seat 5: BlOnDhOlIc ($25 in chips) 
Seat 6: chiyuki ($25.15 in chips) 
Seat 7: Zugrug ($25 in chips) 
Seat 8: 2997qwer ($8.22 in chips) 
Seat 9: Th3Fog ($61.46 in chips) 
cR!Ma*aRm: posts small blind $0.10
nice.franki: posts big blind $0.25
*** HOLE CARDS ***
Dealt to chiyuki [8s 5c]
mollybally1: folds 
BlOnDhOlIc: folds 
chiyuki: folds 
Zugrug: folds 
2997qwer: folds 
Th3Fog: folds 
Lab50att: folds 
cR!Ma*aRm: calls $0.15
nice.franki: checks 
*** FLOP *** [4d Ah 8d]
cR!Ma*aRm: bets $0.25
nice.franki: raises $0.50 to $0.75
cR!Ma*aRm: calls $0.50
*** TURN *** [4d Ah 8d] [3h]
cR!Ma*aRm: checks 
nice.franki: bets $1.25
cR!Ma*aRm: folds 
Uncalled bet ($1.25) returned to nice.franki
nice.franki collected $1.91 from pot
nice.franki: doesn't show hand 
*** SUMMARY ***
Total pot $2 | Rake $0.09 
Board [4d Ah 8d 3h]
Seat 1: Lab50att (button) folded before Flop (didn't bet)
Seat 2: cR!Ma*aRm (small blind) folded on the Turn
Seat 3: nice.franki (big blind) collected ($1.91)
Seat 4: mollybally1 folded before Flop (didn't bet)
Seat 5: BlOnDhOlIc folded before Flop (didn't bet)
Seat 6: chiyuki folded before Flop (didn't bet)
Seat 7: Zugrug folded before Flop (didn't bet)
Seat 8: 2997qwer folded before Flop (didn't bet)
Seat 9: Th3Fog folded before Flop (didn't bet)



PokerStars Zoom Hand #84298342547:  Hold'em No Limit ($0.10/$0.25) - 2012/08/05 13:08:34 JST [2012/08/05 0:08:34 ET]
Table 'Whirlpool' 9-max Seat #1 is the button
Seat 1: BlOnDhOlIc ($25 in chips) 
Seat 2: Zugrug ($25 in chips) 
Seat 3: PetitAlejo ($25 in chips) 
Seat 4: KrystalAA ($18.53 in chips) 
Seat 5: Loholov ($17.20 in chips) 
Seat 6: wtu1986 ($25 in chips) 
Seat 7: seula i ($25.68 in chips) 
Seat 8: DooMSDaY1337 ($64.99 in chips) 
Seat 9: chiyuki ($25.15 in chips) 
Zugrug: posts small blind $0.10
PetitAlejo: posts big blind $0.25
*** HOLE CARDS ***
Dealt to chiyuki [Kd 5d]
KrystalAA: folds 
Loholov: raises $0.50 to $0.75
wtu1986: folds 
seula i: folds 
DooMSDaY1337: calls $0.75
chiyuki: folds 
BlOnDhOlIc: folds 
Zugrug: folds 
PetitAlejo: calls $0.50
*** FLOP *** [Jh 9s 2d]
PetitAlejo: checks 
Loholov: checks 
DooMSDaY1337: bets $1.12
PetitAlejo: calls $1.12
Loholov: folds 
*** TURN *** [Jh 9s 2d] [Qh]
PetitAlejo: checks 
DooMSDaY1337: bets $2.19
PetitAlejo: calls $2.19
*** RIVER *** [Jh 9s 2d Qh] [Js]
PetitAlejo: checks 
DooMSDaY1337: bets $6
PetitAlejo: folds 
Uncalled bet ($6) returned to DooMSDaY1337
DooMSDaY1337 collected $8.57 from pot
DooMSDaY1337: doesn't show hand 
*** SUMMARY ***
Total pot $8.97 | Rake $0.40 
Board [Jh 9s 2d Qh Js]
Seat 1: BlOnDhOlIc (button) folded before Flop (didn't bet)
Seat 2: Zugrug (small blind) folded before Flop
Seat 3: PetitAlejo (big blind) folded on the River
Seat 4: KrystalAA folded before Flop (didn't bet)
Seat 5: Loholov folded on the Flop
Seat 6: wtu1986 folded before Flop (didn't bet)
Seat 7: seula i folded before Flop (didn't bet)
Seat 8: DooMSDaY1337 collected ($8.57)
Seat 9: chiyuki folded before Flop (didn't bet)



PokerStars Zoom Hand #84298347857:  Hold'em No Limit ($0.10/$0.25) - 2012/08/05 13:08:52 JST [2012/08/05 0:08:52 ET]
Table 'Whirlpool' 9-max Seat #1 is the button
Seat 1: THE_BIG_BOTT ($17.84 in chips) 
Seat 2: BlOnDhOlIc ($50.15 in chips) 
Seat 3: wtu1986 ($25 in chips) 
Seat 4: MibNe ($29.79 in chips) 
Seat 5: ShevchukAI ($13.12 in chips) 
Seat 6: TErr18 ($19.39 in chips) 
Seat 7: TraderYao ($25 in chips) 
Seat 8: chiyuki ($25.05 in chips) 
Seat 9: mollybally1 ($13.73 in chips) 
BlOnDhOlIc: posts small blind $0.10
wtu1986: posts big blind $0.25
*** HOLE CARDS ***
Dealt to chiyuki [3s Kd]
MibNe: folds 
ShevchukAI: raises $0.50 to $0.75
TErr18: calls $0.75
TraderYao: folds 
chiyuki: folds 
mollybally1: folds 
THE_BIG_BOTT: calls $0.75
BlOnDhOlIc: folds 
wtu1986: folds 
*** FLOP *** [7c 9h Kh]
ShevchukAI: bets $0.25
TErr18: raises $1.50 to $1.75
THE_BIG_BOTT: raises $2.25 to $4
ShevchukAI: raises $8.37 to $12.37 and is all-in
TErr18: folds 
THE_BIG_BOTT: folds 
Uncalled bet ($8.37) returned to ShevchukAI
ShevchukAI collected $11.79 from pot
ShevchukAI: doesn't show hand 
*** SUMMARY ***
Total pot $12.35 | Rake $0.56 
Board [7c 9h Kh]
Seat 1: THE_BIG_BOTT (button) folded on the Flop
Seat 2: BlOnDhOlIc (small blind) folded before Flop
Seat 3: wtu1986 (big blind) folded before Flop
Seat 4: MibNe folded before Flop (didn't bet)
Seat 5: ShevchukAI collected ($11.79)
Seat 6: TErr18 folded on the Flop
Seat 7: TraderYao folded before Flop (didn't bet)
Seat 8: chiyuki folded before Flop (didn't bet)
Seat 9: mollybally1 folded before Flop (didn't bet)



PokerStars Zoom Hand #84298357843:  Hold'em No Limit ($0.10/$0.25) - 2012/08/05 13:09:26 JST [2012/08/05 0:09:26 ET]
Table 'Whirlpool' 9-max Seat #1 is the button
Seat 1: deadmoneykid ($25.14 in chips) 
Seat 2: Jippyflip ($24.87 in chips) 
Seat 3: TraderYao ($25 in chips) 
Seat 4: BlOnDhOlIc ($50.05 in chips) 
Seat 5: Jene4kaBest ($8.28 in chips) 
Seat 6: chiyuki ($25.40 in chips) 
Seat 7: DooMSDaY1337 ($25.45 in chips) 
Seat 8: gunbowler ($92.04 in chips) 
Seat 9: nice.franki ($12.15 in chips) 
Jippyflip: posts small blind $0.10
TraderYao: posts big blind $0.25
*** HOLE CARDS ***
Dealt to chiyuki [As Ad]
BlOnDhOlIc: folds 
Jene4kaBest: folds 
chiyuki: raises $0.50 to $0.75
DooMSDaY1337: calls $0.75
gunbowler: folds 
nice.franki: folds 
deadmoneykid: folds 
Jippyflip: folds 
TraderYao: folds 
*** FLOP *** [4c 9h Kc]
chiyuki: bets $1
DooMSDaY1337: raises $1.75 to $2.75
chiyuki: calls $1.75
*** TURN *** [4c 9h Kc] [4d]
chiyuki: checks 
DooMSDaY1337: bets $5
chiyuki: folds 
Uncalled bet ($5) returned to DooMSDaY1337
DooMSDaY1337 collected $7.02 from pot
DooMSDaY1337: doesn't show hand 
*** SUMMARY ***
Total pot $7.35 | Rake $0.33 
Board [4c 9h Kc 4d]
Seat 1: deadmoneykid (button) folded before Flop (didn't bet)
Seat 2: Jippyflip (small blind) folded before Flop
Seat 3: TraderYao (big blind) folded before Flop
Seat 4: BlOnDhOlIc folded before Flop (didn't bet)
Seat 5: Jene4kaBest folded before Flop (didn't bet)
Seat 6: chiyuki folded on the Turn
Seat 7: DooMSDaY1337 collected ($7.02)
Seat 8: gunbowler folded before Flop (didn't bet)
Seat 9: nice.franki folded before Flop (didn't bet)



PokerStars Zoom Hand #84298384426:  Hold'em No Limit ($0.10/$0.25) - 2012/08/05 13:10:59 JST [2012/08/05 0:10:59 ET]
Table 'Whirlpool' 9-max Seat #1 is the button
Seat 1: Roglus ($21.94 in chips) 
Seat 2: KeLevro0 ($10.35 in chips) 
Seat 3: simonzez ($29.55 in chips) 
Seat 4: chiyuki ($21.90 in chips) 
Seat 5: puffy5533 ($19.93 in chips) 
Seat 6: Rodina-Kr ($25 in chips) 
Seat 7: Zugrug ($25 in chips) 
Seat 8: masterkoolb ($13.28 in chips) 
Seat 9: Loholov ($15 in chips) 
KeLevro0: posts small blind $0.10
simonzez: posts big blind $0.25
*** HOLE CARDS ***
Dealt to chiyuki [3h 6c]
chiyuki: folds 
puffy5533: folds 
Rodina-Kr: folds 
Zugrug: folds 
masterkoolb: raises $0.60 to $0.85
Loholov: folds 
Roglus: folds 
KeLevro0: folds 
simonzez: calls $0.60
*** FLOP *** [4s 3s 7d]
simonzez: bets $1
masterkoolb: folds 
Uncalled bet ($1) returned to simonzez
simonzez collected $1.72 from pot
simonzez: doesn't show hand 
*** SUMMARY ***
Total pot $1.80 | Rake $0.08 
Board [4s 3s 7d]
Seat 1: Roglus (button) folded before Flop (didn't bet)
Seat 2: KeLevro0 (small blind) folded before Flop
Seat 3: simonzez (big blind) collected ($1.72)
Seat 4: chiyuki folded before Flop (didn't bet)
Seat 5: puffy5533 folded before Flop (didn't bet)
Seat 6: Rodina-Kr folded before Flop (didn't bet)
Seat 7: Zugrug folded before Flop (didn't bet)
Seat 8: masterkoolb folded on the Flop
Seat 9: Loholov folded before Flop (didn't bet)



PokerStars Zoom Hand #84298385625:  Hold'em No Limit ($0.10/$0.25) - 2012/08/05 13:11:03 JST [2012/08/05 0:11:03 ET]
Table 'Whirlpool' 9-max Seat #1 is the button
Seat 1: fwani ($25 in chips) 
Seat 2: DooMSDaY1337 ($28.97 in chips) 
Seat 3: chiyuki ($21.90 in chips) 
Seat 4: DT_Jesus ($34.27 in chips) 
Seat 5: Alvinpe85 ($25.40 in chips) 
Seat 6: ShevchukAI ($19.81 in chips) 
Seat 7: Loholov ($15 in chips) 
Seat 8: leo2095 ($19.40 in chips) 
Seat 9: Roglus ($21.94 in chips) 
DooMSDaY1337: posts small blind $0.10
chiyuki: posts big blind $0.25
*** HOLE CARDS ***
Dealt to chiyuki [7s 2c]
DT_Jesus: folds 
Alvinpe85: folds 
ShevchukAI: folds 
Loholov: folds 
leo2095: folds 
Roglus: raises $0.50 to $0.75
fwani: folds 
DooMSDaY1337: folds 
chiyuki: folds 
Uncalled bet ($0.50) returned to Roglus
Roglus collected $0.60 from pot
Roglus: doesn't show hand 
*** SUMMARY ***
Total pot $0.60 | Rake $0 
Seat 1: fwani (button) folded before Flop (didn't bet)
Seat 2: DooMSDaY1337 (small blind) folded before Flop
Seat 3: chiyuki (big blind) folded before Flop
Seat 4: DT_Jesus folded before Flop (didn't bet)
Seat 5: Alvinpe85 folded before Flop (didn't bet)
Seat 6: ShevchukAI folded before Flop (didn't bet)
Seat 7: Loholov folded before Flop (didn't bet)
Seat 8: leo2095 folded before Flop (didn't bet)
Seat 9: Roglus collected ($0.60)



PokerStars Zoom Hand #84298390546:  Hold'em No Limit ($0.10/$0.25) - 2012/08/05 13:11:20 JST [2012/08/05 0:11:20 ET]
Table 'Whirlpool' 9-max Seat #1 is the button
Seat 1: seula i ($26.38 in chips) 
Seat 2: chiyuki ($21.65 in chips) 
Seat 3: KrystalAA ($14.59 in chips) 
Seat 4: PetitAlejo ($25.70 in chips) 
Seat 5: BlOnDhOlIc ($37.33 in chips) 
Seat 6: nice.franki ($13.20 in chips) 
Seat 7: Zugrug ($26.49 in chips) 
Seat 8: Medic8681 ($12.50 in chips) 
Seat 9: TankAbbott1 ($26.37 in chips) 
chiyuki: posts small blind $0.10
KrystalAA: posts big blind $0.25
*** HOLE CARDS ***
Dealt to chiyuki [Ks 7s]
PetitAlejo: folds 
BlOnDhOlIc: raises $0.25 to $0.50
nice.franki: folds 
Zugrug: folds 
Medic8681: folds 
TankAbbott1: folds 
seula i: calls $0.50
chiyuki: folds 
KrystalAA: folds 
*** FLOP *** [3s 6c 5d]
BlOnDhOlIc: bets $0.64
seula i: folds 
Uncalled bet ($0.64) returned to BlOnDhOlIc
BlOnDhOlIc collected $1.29 from pot
BlOnDhOlIc: doesn't show hand 
*** SUMMARY ***
Total pot $1.35 | Rake $0.06 
Board [3s 6c 5d]
Seat 1: seula i (button) folded on the Flop
Seat 2: chiyuki (small blind) folded before Flop
Seat 3: KrystalAA (big blind) folded before Flop
Seat 4: PetitAlejo folded before Flop (didn't bet)
Seat 5: BlOnDhOlIc collected ($1.29)
Seat 6: nice.franki folded before Flop (didn't bet)
Seat 7: Zugrug folded before Flop (didn't bet)
Seat 8: Medic8681 folded before Flop (didn't bet)
Seat 9: TankAbbott1 folded before Flop (didn't bet)



PokerStars Zoom Hand #84298394566:  Hold'em No Limit ($0.10/$0.25) - 2012/08/05 13:11:34 JST [2012/08/05 0:11:34 ET]
Table 'Whirlpool' 9-max Seat #1 is the button
Seat 1: eagie20 ($142.55 in chips) 
Seat 2: slickthis ($27.10 in chips) 
Seat 3: taksist889 ($34.40 in chips) 
Seat 4: PetitAlejo ($40.97 in chips) 
Seat 5: pyty_82 ($57.59 in chips) 
Seat 6: wtu1986 ($25.35 in chips) 
Seat 7: MATT361 ($13.58 in chips) 
Seat 8: MibNe ($31.32 in chips) 
Seat 9: chiyuki ($21.55 in chips) 
slickthis: posts small blind $0.10
taksist889: posts big blind $0.25
*** HOLE CARDS ***
Dealt to chiyuki [3s 6c]
PetitAlejo: folds 
pyty_82: folds 
wtu1986: folds 
MATT361: folds 
MibNe: raises $0.62 to $0.87
chiyuki: folds 
eagie20: calls $0.87
slickthis: folds 
taksist889: folds 
*** FLOP *** [8d As Qc]
MibNe: checks 
eagie20: bets $1.25
MibNe: folds 
Uncalled bet ($1.25) returned to eagie20
eagie20 collected $2 from pot
eagie20: doesn't show hand 
*** SUMMARY ***
Total pot $2.09 | Rake $0.09 
Board [8d As Qc]
Seat 1: eagie20 (button) collected ($2)
Seat 2: slickthis (small blind) folded before Flop
Seat 3: taksist889 (big blind) folded before Flop
Seat 4: PetitAlejo folded before Flop (didn't bet)
Seat 5: pyty_82 folded before Flop (didn't bet)
Seat 6: wtu1986 folded before Flop (didn't bet)
Seat 7: MATT361 folded before Flop (didn't bet)
Seat 8: MibNe folded on the Flop
Seat 9: chiyuki folded before Flop (didn't bet)



PokerStars Zoom Hand #84298398911:  Hold'em No Limit ($0.10/$0.25) - 2012/08/05 13:11:49 JST [2012/08/05 0:11:49 ET]
Table 'Whirlpool' 9-max Seat #1 is the button
Seat 1: cR!Ma*aRm ($18.90 in chips) 
Seat 2: nice.franki ($7.47 in chips) 
Seat 3: fwani ($45.29 in chips) 
Seat 4: TraderYao ($25 in chips) 
Seat 5: BlOnDhOlIc ($25 in chips) 
Seat 6: 2997qwer ($8.97 in chips) 
Seat 7: chiyuki ($21.55 in chips) 
Seat 8: slickthis ($27 in chips) 
Seat 9: taksist889 ($34.15 in chips) 
nice.franki: posts small blind $0.10
fwani: posts big blind $0.25
*** HOLE CARDS ***
Dealt to chiyuki [5d 4c]
TraderYao: folds 
BlOnDhOlIc: folds 
2997qwer: folds 
chiyuki: folds 
slickthis: folds 
taksist889: raises $0.50 to $0.75
cR!Ma*aRm: folds 
nice.franki: folds 
fwani: folds 
Uncalled bet ($0.50) returned to taksist889
taksist889 collected $0.60 from pot
taksist889: doesn't show hand 
*** SUMMARY ***
Total pot $0.60 | Rake $0 
Seat 1: cR!Ma*aRm (button) folded before Flop (didn't bet)
Seat 2: nice.franki (small blind) folded before Flop
Seat 3: fwani (big blind) folded before Flop
Seat 4: TraderYao folded before Flop (didn't bet)
Seat 5: BlOnDhOlIc folded before Flop (didn't bet)
Seat 6: 2997qwer folded before Flop (didn't bet)
Seat 7: chiyuki folded before Flop (didn't bet)
Seat 8: slickthis folded before Flop (didn't bet)
Seat 9: taksist889 collected ($0.60)



PokerStars Zoom Hand #84298396568:  Hold'em No Limit ($0.10/$0.25) - 2012/08/05 13:11:41 JST [2012/08/05 0:11:41 ET]
Table 'Whirlpool' 9-max Seat #1 is the button
Seat 1: TankAbbott1 ($26.27 in chips) 
Seat 2: kamikkaze ($45.15 in chips) 
Seat 3: BlOnDhOlIc ($25 in chips) 
Seat 4: Rsonal ($60.70 in chips) 
Seat 5: deadmoneykid ($46.85 in chips) 
Seat 6: DooMSDaY1337 ($28.87 in chips) 
Seat 7: masterkoolb ($12.50 in chips) 
Seat 8: chiyuki ($21.55 in chips) 
Seat 9: TErr18 ($20.30 in chips) 
kamikkaze: posts small blind $0.10
BlOnDhOlIc: posts big blind $0.25
*** HOLE CARDS ***
Dealt to chiyuki [Ah 2c]
Rsonal: raises $0.25 to $0.50
deadmoneykid: folds 
DooMSDaY1337: folds 
masterkoolb: folds 
chiyuki: folds 
TErr18: folds 
TankAbbott1: folds 
kamikkaze: calls $0.40
BlOnDhOlIc: folds 
*** FLOP *** [Qh 4d 5h]
kamikkaze: checks 
Rsonal: bets $1.19
kamikkaze: calls $1.19
*** TURN *** [Qh 4d 5h] [4c]
kamikkaze: checks 
Rsonal: bets $3.47
kamikkaze: calls $3.47
*** RIVER *** [Qh 4d 5h 4c] [6h]
kamikkaze: checks 
Rsonal: checks 
*** SHOW DOWN ***
kamikkaze: shows [5s 5d] (a full house, Fives full of Fours)
Rsonal: mucks hand 
kamikkaze collected $10.09 from pot
*** SUMMARY ***
Total pot $10.57 | Rake $0.48 
Board [Qh 4d 5h 4c 6h]
Seat 1: TankAbbott1 (button) folded before Flop (didn't bet)
Seat 2: kamikkaze (small blind) showed [5s 5d] and won ($10.09) with a full house, Fives full of Fours
Seat 3: BlOnDhOlIc (big blind) folded before Flop
Seat 4: Rsonal mucked [Ks Qd]
Seat 5: deadmoneykid folded before Flop (didn't bet)
Seat 6: DooMSDaY1337 folded before Flop (didn't bet)
Seat 7: masterkoolb folded before Flop (didn't bet)
Seat 8: chiyuki folded before Flop (didn't bet)
Seat 9: TErr18 folded before Flop (didn't bet)



PokerStars Zoom Hand #84298401011:  Hold'em No Limit ($0.10/$0.25) - 2012/08/05 13:11:56 JST [2012/08/05 0:11:56 ET]
Table 'Whirlpool' 9-max Seat #1 is the button
Seat 1: envious_0007 ($10.05 in chips) 
Seat 2: TErr18 ($15.54 in chips) 
Seat 3: masterkoolb ($12.50 in chips) 
Seat 4: DooMSDaY1337 ($66.65 in chips) 
Seat 5: chiyuki ($21.55 in chips) 
Seat 6: THE_BIG_BOTT ($15.76 in chips) 
Seat 7: doanut13 ($50.91 in chips) 
Seat 8: JAMES3FINGER ($315.55 in chips) 
Seat 9: MATT361 ($13.48 in chips) 
TErr18: posts small blind $0.10
masterkoolb: posts big blind $0.25
*** HOLE CARDS ***
Dealt to chiyuki [Kh 3d]
DooMSDaY1337: folds 
chiyuki: folds 
THE_BIG_BOTT: folds 
doanut13: calls $0.25
JAMES3FINGER: calls $0.25
MATT361: calls $0.25
envious_0007: folds 
TErr18: folds 
masterkoolb: checks 
*** FLOP *** [7h As 7s]
masterkoolb: checks 
doanut13: bets $0.25
JAMES3FINGER: folds 
MATT361: calls $0.25
masterkoolb: folds 
*** TURN *** [7h As 7s] [3c]
doanut13: checks 
MATT361: checks 
*** RIVER *** [7h As 7s 3c] [5s]
doanut13: checks 
MATT361: bets $0.75
doanut13: calls $0.75
*** SHOW DOWN ***
MATT361: shows [Ts Ah] (two pair, Aces and Sevens)
doanut13: mucks hand 
MATT361 collected $2.96 from pot
*** SUMMARY ***
Total pot $3.10 | Rake $0.14 
Board [7h As 7s 3c 5s]
Seat 1: envious_0007 (button) folded before Flop (didn't bet)
Seat 2: TErr18 (small blind) folded before Flop
Seat 3: masterkoolb (big blind) folded on the Flop
Seat 4: DooMSDaY1337 folded before Flop (didn't bet)
Seat 5: chiyuki folded before Flop (didn't bet)
Seat 6: THE_BIG_BOTT folded before Flop (didn't bet)
Seat 7: doanut13 mucked [Ac 9c]
Seat 8: JAMES3FINGER folded on the Flop
Seat 9: MATT361 showed [Ts Ah] and won ($2.96) with two pair, Aces and Sevens



PokerStars Zoom Hand #84298402384:  Hold'em No Limit ($0.10/$0.25) - 2012/08/05 13:12:01 JST [2012/08/05 0:12:01 ET]
Table 'Whirlpool' 9-max Seat #1 is the button
Seat 1: chiyuki ($21.55 in chips) 
Seat 2: DanyArdaggo ($27.60 in chips) 
Seat 3: cR!Ma*aRm ($18.90 in chips) 
Seat 4: nice.franki ($11.80 in chips) 
Seat 5: KeLevro0 ($13.64 in chips) 
Seat 6: TErr18 ($20.30 in chips) 
Seat 7: petersmiths ($34.41 in chips) 
Seat 8: KINGKILERACE ($42.58 in chips) 
Seat 9: THE_BIG_BOTT ($15.76 in chips) 
DanyArdaggo: posts small blind $0.10
cR!Ma*aRm: posts big blind $0.25
*** HOLE CARDS ***
Dealt to chiyuki [Ah Ks]
nice.franki: folds 
KeLevro0: folds 
TErr18: folds 
petersmiths: raises $0.25 to $0.50
KINGKILERACE: raises $0.25 to $0.75
THE_BIG_BOTT: folds 
chiyuki: calls $0.75
DanyArdaggo: folds 
cR!Ma*aRm: calls $0.50
petersmiths: calls $0.25
*** FLOP *** [9h Jc Ad]
cR!Ma*aRm: checks 
petersmiths: checks 
KINGKILERACE: bets $0.75
chiyuki: raises $2 to $2.75
cR!Ma*aRm: folds 
petersmiths: folds 
KINGKILERACE: calls $2
*** TURN *** [9h Jc Ad] [8d]
KINGKILERACE: bets $2.75
chiyuki: calls $2.75
*** RIVER *** [9h Jc Ad 8d] [3h]
KINGKILERACE: checks 
chiyuki: bets $5
KINGKILERACE: calls $5
*** SHOW DOWN ***
chiyuki: shows [Ah Ks] (a pair of Aces)
KINGKILERACE: mucks hand 
chiyuki collected $23.02 from pot
*** SUMMARY ***
Total pot $24.10 | Rake $1.08 
Board [9h Jc Ad 8d 3h]
Seat 1: chiyuki (button) showed [Ah Ks] and won ($23.02) with a pair of Aces
Seat 2: DanyArdaggo (small blind) folded before Flop
Seat 3: cR!Ma*aRm (big blind) folded on the Flop
Seat 4: nice.franki folded before Flop (didn't bet)
Seat 5: KeLevro0 folded before Flop (didn't bet)
Seat 6: TErr18 folded before Flop (didn't bet)
Seat 7: petersmiths folded on the Flop
Seat 8: KINGKILERACE mucked [As Qh]
Seat 9: THE_BIG_BOTT folded before Flop (didn't bet)



PokerStars Zoom Hand #84298423385:  Hold'em No Limit ($0.10/$0.25) - 2012/08/05 13:13:16 JST [2012/08/05 0:13:16 ET]
Table 'Whirlpool' 9-max Seat #1 is the button
Seat 1: s9999999 ($31.73 in chips) 
Seat 2: nice.franki ($12.40 in chips) 
Seat 3: MibNe ($30.10 in chips) 
Seat 4: silvno31 ($14.72 in chips) 
Seat 5: RomarioJa ($9.35 in chips) 
Seat 6: chiyuki ($33.32 in chips) 
Seat 7: wtu1986 ($25 in chips) 
Seat 8: fwani ($30.88 in chips) 
Seat 9: puffy5533 ($19.68 in chips) 
nice.franki: posts small blind $0.10
MibNe: posts big blind $0.25
*** HOLE CARDS ***
Dealt to chiyuki [2d Qc]
silvno31: raises $1 to $1.25
RomarioJa: folds 
chiyuki: folds 
wtu1986: folds 
fwani: folds 
puffy5533: folds 
s9999999: folds 
nice.franki: folds 
MibNe: folds 
Uncalled bet ($1) returned to silvno31
silvno31 collected $0.60 from pot
silvno31: doesn't show hand 
*** SUMMARY ***
Total pot $0.60 | Rake $0 
Seat 1: s9999999 (button) folded before Flop (didn't bet)
Seat 2: nice.franki (small blind) folded before Flop
Seat 3: MibNe (big blind) folded before Flop
Seat 4: silvno31 collected ($0.60)
Seat 5: RomarioJa folded before Flop (didn't bet)
Seat 6: chiyuki folded before Flop (didn't bet)
Seat 7: wtu1986 folded before Flop (didn't bet)
Seat 8: fwani folded before Flop (didn't bet)
Seat 9: puffy5533 folded before Flop (didn't bet)



PokerStars Zoom Hand #84298425699:  Hold'em No Limit ($0.10/$0.25) - 2012/08/05 13:13:24 JST [2012/08/05 0:13:24 ET]
Table 'Whirlpool' 9-max Seat #1 is the button
Seat 1: hassantas ($25 in chips) 
Seat 2: BlOnDhOlIc ($39.71 in chips) 
Seat 3: KeLevro0 ($8.45 in chips) 
Seat 4: chiyuki ($33.32 in chips) 
Seat 5: RomarioJa ($11.17 in chips) 
Seat 6: Th3Fog ($54.58 in chips) 
Seat 7: PetitAlejo ($25.52 in chips) 
Seat 8: Medic8681 ($14.02 in chips) 
Seat 9: Tasman007 ($8.33 in chips) 
BlOnDhOlIc: posts small blind $0.10
KeLevro0: posts big blind $0.25
*** HOLE CARDS ***
Dealt to chiyuki [Js 9c]
chiyuki: folds 
RomarioJa: raises $0.50 to $0.75
Th3Fog: folds 
PetitAlejo: folds 
Medic8681: raises $1.50 to $2.25
Tasman007: folds 
hassantas: calls $2.25
BlOnDhOlIc: folds 
KeLevro0: folds 
RomarioJa: folds 
*** FLOP *** [7h Th 5h]
Medic8681: checks 
hassantas: checks 
*** TURN *** [7h Th 5h] [8d]
Medic8681: bets $2
hassantas: raises $5.61 to $7.61
Medic8681: raises $4.16 to $11.77 and is all-in
hassantas: calls $4.16
*** RIVER *** [7h Th 5h 8d] [Ac]
*** SHOW DOWN ***
Medic8681: shows [Ah Kh] (a flush, Ace high)
hassantas: shows [8h 8s] (three of a kind, Eights)
Medic8681 collected $27.83 from pot
*** SUMMARY ***
Total pot $29.14 | Rake $1.31 
Board [7h Th 5h 8d Ac]
Seat 1: hassantas (button) showed [8h 8s] and lost with three of a kind, Eights
Seat 2: BlOnDhOlIc (small blind) folded before Flop
Seat 3: KeLevro0 (big blind) folded before Flop
Seat 4: chiyuki folded before Flop (didn't bet)
Seat 5: RomarioJa folded before Flop
Seat 6: Th3Fog folded before Flop (didn't bet)
Seat 7: PetitAlejo folded before Flop (didn't bet)
Seat 8: Medic8681 showed [Ah Kh] and won ($27.83) with a flush, Ace high
Seat 9: Tasman007 folded before Flop (didn't bet)



PokerStars Zoom Hand #84298427130:  Hold'em No Limit ($0.10/$0.25) - 2012/08/05 13:13:29 JST [2012/08/05 0:13:29 ET]
Table 'Whirlpool' 9-max Seat #1 is the button
Seat 1: PetitAlejo ($25.52 in chips) 
Seat 2: MATT361 ($15.26 in chips) 
Seat 3: chiyuki ($33.32 in chips) 
Seat 4: nice.franki ($12.30 in chips) 
Seat 5: DooMSDaY1337 ($28.62 in chips) 
Seat 6: 2997qwer ($14.62 in chips) 
Seat 7: fwani ($30.88 in chips) 
Seat 8: Rodina-Kr ($25 in chips) 
Seat 9: wtu1986 ($25 in chips) 
MATT361: posts small blind $0.10
chiyuki: posts big blind $0.25
*** HOLE CARDS ***
Dealt to chiyuki [Jc 3s]
nice.franki: folds 
DooMSDaY1337: folds 
2997qwer: folds 
fwani: folds 
Rodina-Kr: folds 
wtu1986: raises $0.50 to $0.75
PetitAlejo: folds 
MATT361: folds 
chiyuki: folds 
Uncalled bet ($0.50) returned to wtu1986
wtu1986 collected $0.60 from pot
wtu1986: doesn't show hand 
*** SUMMARY ***
Total pot $0.60 | Rake $0 
Seat 1: PetitAlejo (button) folded before Flop (didn't bet)
Seat 2: MATT361 (small blind) folded before Flop
Seat 3: chiyuki (big blind) folded before Flop
Seat 4: nice.franki folded before Flop (didn't bet)
Seat 5: DooMSDaY1337 folded before Flop (didn't bet)
Seat 6: 2997qwer folded before Flop (didn't bet)
Seat 7: fwani folded before Flop (didn't bet)
Seat 8: Rodina-Kr folded before Flop (didn't bet)
Seat 9: wtu1986 collected ($0.60)



PokerStars Zoom Hand #84298441686:  Hold'em No Limit ($0.10/$0.25) - 2012/08/05 13:14:20 JST [2012/08/05 0:14:20 ET]
Table 'Whirlpool' 9-max Seat #1 is the button
Seat 1: Th3Fog ($54.23 in chips) 
Seat 2: agurio ($44.32 in chips) 
Seat 3: Loholov ($19.89 in chips) 
Seat 4: deadmoneykid ($20.40 in chips) 
Seat 5: TraderYao ($24.90 in chips) 
Seat 6: puffy5533 ($19.58 in chips) 
Seat 7: chiyuki ($33.07 in chips) 
Seat 8: Medic8681 ($15.39 in chips) 
Seat 9: TErr18 ($19.10 in chips) 
agurio: posts small blind $0.10
Loholov: posts big blind $0.25
*** HOLE CARDS ***
Dealt to chiyuki [2d 9h]
deadmoneykid: folds 
TraderYao: folds 
puffy5533: folds 
chiyuki: folds 
Medic8681: folds 
TErr18: folds 
Th3Fog: folds 
agurio: raises $0.50 to $0.75
Loholov: calls $0.50
*** FLOP *** [4s 4d Jh]
agurio: bets $0.85
Loholov: folds 
Uncalled bet ($0.85) returned to agurio
agurio collected $1.43 from pot
agurio: doesn't show hand 
*** SUMMARY ***
Total pot $1.50 | Rake $0.07 
Board [4s 4d Jh]
Seat 1: Th3Fog (button) folded before Flop (didn't bet)
Seat 2: agurio (small blind) collected ($1.43)
Seat 3: Loholov (big blind) folded on the Flop
Seat 4: deadmoneykid folded before Flop (didn't bet)
Seat 5: TraderYao folded before Flop (didn't bet)
Seat 6: puffy5533 folded before Flop (didn't bet)
Seat 7: chiyuki folded before Flop (didn't bet)
Seat 8: Medic8681 folded before Flop (didn't bet)
Seat 9: TErr18 folded before Flop (didn't bet)



PokerStars Zoom Hand #84298444533:  Hold'em No Limit ($0.10/$0.25) - 2012/08/05 13:14:31 JST [2012/08/05 0:14:31 ET]
Table 'Whirlpool' 9-max Seat #1 is the button
Seat 1: fwani ($27.05 in chips) 
Seat 2: Roglus ($35.04 in chips) 
Seat 3: envious_0007 ($21.71 in chips) 
Seat 4: Zugrug ($25.35 in chips) 
Seat 5: PetitAlejo ($25.52 in chips) 
Seat 6: Suhoff76 ($25 in chips) 
Seat 7: 5zzzz33 ($19.05 in chips) 
Seat 8: KrystalAA ($12.50 in chips) 
Seat 9: chiyuki ($33.07 in chips) 
Roglus: posts small blind $0.10
envious_0007: posts big blind $0.25
*** HOLE CARDS ***
Dealt to chiyuki [4d 4h]
Zugrug: folds 
PetitAlejo: folds 
Suhoff76: raises $0.50 to $0.75
5zzzz33: folds 
KrystalAA: folds 
chiyuki: folds 
fwani: folds 
Roglus: folds 
envious_0007: folds 
Uncalled bet ($0.50) returned to Suhoff76
Suhoff76 collected $0.60 from pot
Suhoff76: doesn't show hand 
*** SUMMARY ***
Total pot $0.60 | Rake $0 
Seat 1: fwani (button) folded before Flop (didn't bet)
Seat 2: Roglus (small blind) folded before Flop
Seat 3: envious_0007 (big blind) folded before Flop
Seat 4: Zugrug folded before Flop (didn't bet)
Seat 5: PetitAlejo folded before Flop (didn't bet)
Seat 6: Suhoff76 collected ($0.60)
Seat 7: 5zzzz33 folded before Flop (didn't bet)
Seat 8: KrystalAA folded before Flop (didn't bet)
Seat 9: chiyuki folded before Flop (didn't bet)



PokerStars Zoom Hand #84298451145:  Hold'em No Limit ($0.10/$0.25) - 2012/08/05 13:14:54 JST [2012/08/05 0:14:54 ET]
Table 'Whirlpool' 9-max Seat #1 is the button
Seat 1: seula i ($60.21 in chips) 
Seat 2: RomarioJa ($10.52 in chips) 
Seat 3: wtu1986 ($25.25 in chips) 
Seat 4: PetitAlejo ($25 in chips) 
Seat 5: bigrasbig ($35.28 in chips) 
Seat 6: chiyuki ($32.97 in chips) 
Seat 7: TErr18 ($14.09 in chips) 
Seat 8: fwani ($45.77 in chips) 
Seat 9: leo2095 ($16.20 in chips) 
RomarioJa: posts small blind $0.10
wtu1986: posts big blind $0.25
*** HOLE CARDS ***
Dealt to chiyuki [Qd Kc]
PetitAlejo: folds 
bigrasbig: folds 
chiyuki: folds 
TErr18: raises $0.50 to $0.75
fwani: folds 
leo2095: folds 
seula i: folds 
RomarioJa: folds 
wtu1986: folds 
Uncalled bet ($0.50) returned to TErr18
TErr18 collected $0.60 from pot
TErr18: doesn't show hand 
*** SUMMARY ***
Total pot $0.60 | Rake $0 
Seat 1: seula i (button) folded before Flop (didn't bet)
Seat 2: RomarioJa (small blind) folded before Flop
Seat 3: wtu1986 (big blind) folded before Flop
Seat 4: PetitAlejo folded before Flop (didn't bet)
Seat 5: bigrasbig folded before Flop (didn't bet)
Seat 6: chiyuki folded before Flop (didn't bet)
Seat 7: TErr18 collected ($0.60)
Seat 8: fwani folded before Flop (didn't bet)
Seat 9: leo2095 folded before Flop (didn't bet)



PokerStars Zoom Hand #84298443114:  Hold'em No Limit ($0.10/$0.25) - 2012/08/05 13:14:25 JST [2012/08/05 0:14:25 ET]
Table 'Whirlpool' 9-max Seat #1 is the button
Seat 1: deadmoneykid ($23.29 in chips) 
Seat 2: PetitAlejo ($27.70 in chips) 
Seat 3: puffy5533 ($19.58 in chips) 
Seat 4: chiyuki ($33.07 in chips) 
Seat 5: Th3Fog ($54.23 in chips) 
Seat 6: Alvinpe85 ($27.86 in chips) 
Seat 7: DooMSDaY1337 ($68.26 in chips) 
Seat 8: nice.franki ($14.57 in chips) 
Seat 9: eagie20 ($148.81 in chips) 
PetitAlejo: posts small blind $0.10
puffy5533: posts big blind $0.25
*** HOLE CARDS ***
Dealt to chiyuki [3h Ah]
chiyuki: folds 
Th3Fog: raises $0.35 to $0.60
Alvinpe85: folds 
DooMSDaY1337: calls $0.60
nice.franki: folds 
eagie20: calls $0.60
deadmoneykid: folds 
PetitAlejo: folds 
puffy5533: folds 
*** FLOP *** [Tc 3s 4s]
Th3Fog: bets $1.20
DooMSDaY1337: raises $2.05 to $3.25
eagie20: folds 
Th3Fog: folds 
Uncalled bet ($2.05) returned to DooMSDaY1337
DooMSDaY1337 collected $4.35 from pot
DooMSDaY1337: doesn't show hand 
*** SUMMARY ***
Total pot $4.55 | Rake $0.20 
Board [Tc 3s 4s]
Seat 1: deadmoneykid (button) folded before Flop (didn't bet)
Seat 2: PetitAlejo (small blind) folded before Flop
Seat 3: puffy5533 (big blind) folded before Flop
Seat 4: chiyuki folded before Flop (didn't bet)
Seat 5: Th3Fog folded on the Flop
Seat 6: Alvinpe85 folded before Flop (didn't bet)
Seat 7: DooMSDaY1337 collected ($4.35)
Seat 8: nice.franki folded before Flop (didn't bet)
Seat 9: eagie20 folded on the Flop



PokerStars Zoom Hand #84298453987:  Hold'em No Limit ($0.10/$0.25) - 2012/08/05 13:15:04 JST [2012/08/05 0:15:04 ET]
Table 'Whirlpool' 9-max Seat #1 is the button
Seat 1: KeLevro0 ($8.80 in chips) 
Seat 2: Suhoff76 ($25 in chips) 
Seat 3: RomarioJa ($9.44 in chips) 
Seat 4: deadmoneykid ($39.25 in chips) 
Seat 5: Loholov ($15 in chips) 
Seat 6: Paranoix1990 ($22.25 in chips) 
Seat 7: chiyuki ($32.97 in chips) 
Seat 8: nice.franki ($8.32 in chips) 
Seat 9: TraderYao ($24.90 in chips) 
Suhoff76: posts small blind $0.10
RomarioJa: posts big blind $0.25
*** HOLE CARDS ***
Dealt to chiyuki [6s Kc]
deadmoneykid: folds 
Loholov: folds 
Paranoix1990: folds 
chiyuki: folds 
nice.franki: folds 
TraderYao: folds 
KeLevro0: folds 
Suhoff76: folds 
Uncalled bet ($0.15) returned to RomarioJa
RomarioJa collected $0.20 from pot
RomarioJa: doesn't show hand 
*** SUMMARY ***
Total pot $0.20 | Rake $0 
Seat 1: KeLevro0 (button) folded before Flop (didn't bet)
Seat 2: Suhoff76 (small blind) folded before Flop
Seat 3: RomarioJa (big blind) collected ($0.20)
Seat 4: deadmoneykid folded before Flop (didn't bet)
Seat 5: Loholov folded before Flop (didn't bet)
Seat 6: Paranoix1990 folded before Flop (didn't bet)
Seat 7: chiyuki folded before Flop (didn't bet)
Seat 8: nice.franki folded before Flop (didn't bet)
Seat 9: TraderYao folded before Flop (didn't bet)



PokerStars Zoom Hand #84298445961:  Hold'em No Limit ($0.10/$0.25) - 2012/08/05 13:14:36 JST [2012/08/05 0:14:36 ET]
Table 'Whirlpool' 9-max Seat #1 is the button
Seat 1: Roglus ($34.94 in chips) 
Seat 2: cR!Ma*aRm ($20.35 in chips) 
Seat 3: PetitAlejo ($25.52 in chips) 
Seat 4: masterkoolb ($12.50 in chips) 
Seat 5: jtedecaliss ($187.63 in chips) 
Seat 6: Zugrug ($27.47 in chips) 
Seat 7: nice.franki ($11.55 in chips) 
Seat 8: chiyuki ($33.07 in chips) 
Seat 9: gunbowler ($94.60 in chips) 
cR!Ma*aRm: posts small blind $0.10
PetitAlejo: posts big blind $0.25
*** HOLE CARDS ***
Dealt to chiyuki [6h 9s]
masterkoolb: folds 
jtedecaliss: folds 
Zugrug: raises $0.37 to $0.62
nice.franki: folds 
chiyuki: folds 
gunbowler: folds 
Roglus: folds 
cR!Ma*aRm: calls $0.52
PetitAlejo: raises $1.88 to $2.50
Zugrug: folds 
cR!Ma*aRm: calls $1.88
*** FLOP *** [Js Ts 2d]
cR!Ma*aRm: checks 
PetitAlejo: bets $2.88
cR!Ma*aRm: calls $2.88
*** TURN *** [Js Ts 2d] [4d]
cR!Ma*aRm: checks 
PetitAlejo: checks 
*** RIVER *** [Js Ts 2d 4d] [4s]
cR!Ma*aRm: bets $4
PetitAlejo: folds 
Uncalled bet ($4) returned to cR!Ma*aRm
cR!Ma*aRm collected $10.87 from pot
cR!Ma*aRm: doesn't show hand 
*** SUMMARY ***
Total pot $11.38 | Rake $0.51 
Board [Js Ts 2d 4d 4s]
Seat 1: Roglus (button) folded before Flop (didn't bet)
Seat 2: cR!Ma*aRm (small blind) collected ($10.87)
Seat 3: PetitAlejo (big blind) folded on the River
Seat 4: masterkoolb folded before Flop (didn't bet)
Seat 5: jtedecaliss folded before Flop (didn't bet)
Seat 6: Zugrug folded before Flop
Seat 7: nice.franki folded before Flop (didn't bet)
Seat 8: chiyuki folded before Flop (didn't bet)
Seat 9: gunbowler folded before Flop (didn't bet)



PokerStars Zoom Hand #84298447422:  Hold'em No Limit ($0.10/$0.25) - 2012/08/05 13:14:41 JST [2012/08/05 0:14:41 ET]
Table 'Whirlpool' 9-max Seat #1 is the button
Seat 1: fwani ($30.88 in chips) 
Seat 2: chiyuki ($33.07 in chips) 
Seat 3: KeLevro0 ($8.10 in chips) 
Seat 4: masterkoolb ($12.50 in chips) 
Seat 5: ll_LaMeR_ll ($21.95 in chips) 
Seat 6: RomarioJa ($10.52 in chips) 
Seat 7: gunbowler ($94.60 in chips) 
Seat 8: TraderYao ($25 in chips) 
Seat 9: Roglus ($34.94 in chips) 
chiyuki: posts small blind $0.10
KeLevro0: posts big blind $0.25
*** HOLE CARDS ***
Dealt to chiyuki [5h 5d]
masterkoolb: folds 
ll_LaMeR_ll: folds 
RomarioJa: folds 
gunbowler: raises $0.50 to $0.75
TraderYao: folds 
Roglus: folds 
fwani: folds 
chiyuki: folds 
KeLevro0: calls $0.50
*** FLOP *** [5s 4d 7c]
KeLevro0: bets $0.85
gunbowler: calls $0.85
*** TURN *** [5s 4d 7c] [6s]
KeLevro0: bets $1.76
gunbowler: folds 
Uncalled bet ($1.76) returned to KeLevro0
KeLevro0 collected $3.15 from pot
KeLevro0: doesn't show hand 
*** SUMMARY ***
Total pot $3.30 | Rake $0.15 
Board [5s 4d 7c 6s]
Seat 1: fwani (button) folded before Flop (didn't bet)
Seat 2: chiyuki (small blind) folded before Flop
Seat 3: KeLevro0 (big blind) collected ($3.15)
Seat 4: masterkoolb folded before Flop (didn't bet)
Seat 5: ll_LaMeR_ll folded before Flop (didn't bet)
Seat 6: RomarioJa folded before Flop (didn't bet)
Seat 7: gunbowler folded on the Turn
Seat 8: TraderYao folded before Flop (didn't bet)
Seat 9: Roglus folded before Flop (didn't bet)



PokerStars Zoom Hand #84298455070:  Hold'em No Limit ($0.10/$0.25) - 2012/08/05 13:15:08 JST [2012/08/05 0:15:08 ET]
Table 'Whirlpool' 9-max Seat #1 is the button
Seat 1: mikifeio ($47.99 in chips) 
Seat 2: Th3Fog ($60.40 in chips) 
Seat 3: chiyuki ($32.97 in chips) 
Seat 4: envious_0007 ($21.46 in chips) 
Seat 5: Roglus ($35.29 in chips) 
Seat 6: eagie20 ($148.21 in chips) 
Seat 7: TankAbbott1 ($40.74 in chips) 
Seat 8: wtu1986 ($25.25 in chips) 
Seat 9: DooMSDaY1337 ($34.02 in chips) 
Th3Fog: posts small blind $0.10
chiyuki: posts big blind $0.25
*** HOLE CARDS ***
Dealt to chiyuki [3d 9s]
envious_0007: folds 
Roglus: raises $0.50 to $0.75
eagie20: calls $0.75
TankAbbott1: folds 
wtu1986: folds 
DooMSDaY1337: folds 
mikifeio: folds 
Th3Fog: folds 
chiyuki: folds 
*** FLOP *** [6c 8c 5s]
Roglus: bets $1
eagie20: calls $1
*** TURN *** [6c 8c 5s] [Js]
Roglus: bets $1.50
eagie20: calls $1.50
*** RIVER *** [6c 8c 5s Js] [6h]
Roglus: bets $1.75
eagie20: calls $1.75
*** SHOW DOWN ***
Roglus: shows [7h 7d] (two pair, Sevens and Sixes)
eagie20: mucks hand 
Roglus collected $9.88 from pot
*** SUMMARY ***
Total pot $10.35 | Rake $0.47 
Board [6c 8c 5s Js 6h]
Seat 1: mikifeio (button) folded before Flop (didn't bet)
Seat 2: Th3Fog (small blind) folded before Flop
Seat 3: chiyuki (big blind) folded before Flop
Seat 4: envious_0007 folded before Flop (didn't bet)
Seat 5: Roglus showed [7h 7d] and won ($9.88) with two pair, Sevens and Sixes
Seat 6: eagie20 mucked [5c 4c]
Seat 7: TankAbbott1 folded before Flop (didn't bet)
Seat 8: wtu1986 folded before Flop (didn't bet)
Seat 9: DooMSDaY1337 folded before Flop (didn't bet)



PokerStars Zoom Hand #84298463825:  Hold'em No Limit ($0.10/$0.25) - 2012/08/05 13:15:39 JST [2012/08/05 0:15:39 ET]
Table 'Whirlpool' 9-max Seat #1 is the button
Seat 1: masterkoolb ($12.50 in chips) 
Seat 2: chiyuki ($32.72 in chips) 
Seat 3: polk11 ($21.80 in chips) 
Seat 4: Zugrug ($26.85 in chips) 
Seat 5: gAm813r ($28.62 in chips) 
Seat 6: Suhoff76 ($25.35 in chips) 
Seat 7: TErr18 ($24.44 in chips) 
Seat 8: PetitAlejo ($25 in chips) 
Seat 9: Rodina-Kr ($25.35 in chips) 
chiyuki: posts small blind $0.10
polk11: posts big blind $0.25
*** HOLE CARDS ***
Dealt to chiyuki [4s 3h]
Zugrug: folds 
gAm813r: folds 
Suhoff76: folds 
TErr18: folds 
PetitAlejo: folds 
Rodina-Kr: folds 
masterkoolb: folds 
chiyuki: folds 
Uncalled bet ($0.15) returned to polk11
polk11 collected $0.20 from pot
polk11: doesn't show hand 
*** SUMMARY ***
Total pot $0.20 | Rake $0 
Seat 1: masterkoolb (button) folded before Flop (didn't bet)
Seat 2: chiyuki (small blind) folded before Flop
Seat 3: polk11 (big blind) collected ($0.20)
Seat 4: Zugrug folded before Flop (didn't bet)
Seat 5: gAm813r folded before Flop (didn't bet)
Seat 6: Suhoff76 folded before Flop (didn't bet)
Seat 7: TErr18 folded before Flop (didn't bet)
Seat 8: PetitAlejo folded before Flop (didn't bet)
Seat 9: Rodina-Kr folded before Flop (didn't bet)



PokerStars Zoom Hand #84298458943:  Hold'em No Limit ($0.10/$0.25) - 2012/08/05 13:15:21 JST [2012/08/05 0:15:21 ET]
Table 'Whirlpool' 9-max Seat #1 is the button
Seat 1: chiyuki ($32.72 in chips) 
Seat 2: hassantas ($25 in chips) 
Seat 3: DT_Jesus ($29.02 in chips) 
Seat 4: D@vidMed ($30.72 in chips) 
Seat 5: DooMSDaY1337 ($25.97 in chips) 
Seat 6: masterkoolb ($12.50 in chips) 
Seat 7: petersmiths ($33.38 in chips) 
Seat 8: nice.franki ($14.47 in chips) 
Seat 9: KrystalAA ($17.12 in chips) 
hassantas: posts small blind $0.10
DT_Jesus: posts big blind $0.25
*** HOLE CARDS ***
Dealt to chiyuki [4c 5c]
D@vidMed: folds 
DooMSDaY1337: folds 
masterkoolb: folds 
petersmiths: raises $0.25 to $0.50
nice.franki: folds 
KrystalAA: folds 
chiyuki: folds 
hassantas: calls $0.40
DT_Jesus: folds 
*** FLOP *** [3d 7c Td]
hassantas: checks 
petersmiths: checks 
*** TURN *** [3d 7c Td] [Ks]
hassantas: bets $0.95
petersmiths: calls $0.95
*** RIVER *** [3d 7c Td Ks] [Ac]
hassantas: checks 
petersmiths: bets $1.20
hassantas: calls $1.20
*** SHOW DOWN ***
petersmiths: shows [Jh Qc] (a straight, Ten to Ace)
hassantas: mucks hand 
petersmiths collected $5.30 from pot
*** SUMMARY ***
Total pot $5.55 | Rake $0.25 
Board [3d 7c Td Ks Ac]
Seat 1: chiyuki (button) folded before Flop (didn't bet)
Seat 2: hassantas (small blind) mucked [9d Kd]
Seat 3: DT_Jesus (big blind) folded before Flop
Seat 4: D@vidMed folded before Flop (didn't bet)
Seat 5: DooMSDaY1337 folded before Flop (didn't bet)
Seat 6: masterkoolb folded before Flop (didn't bet)
Seat 7: petersmiths showed [Jh Qc] and won ($5.30) with a straight, Ten to Ace
Seat 8: nice.franki folded before Flop (didn't bet)
Seat 9: KrystalAA folded before Flop (didn't bet)



PokerStars Zoom Hand #84298468080:  Hold'em No Limit ($0.10/$0.25) - 2012/08/05 13:15:54 JST [2012/08/05 0:15:54 ET]
Table 'Whirlpool' 9-max Seat #1 is the button
Seat 1: RomarioJa ($9.44 in chips) 
Seat 2: gedavaca ($27.28 in chips) 
Seat 3: Zugrug ($26.85 in chips) 
Seat 4: eagie20 ($143.11 in chips) 
Seat 5: TErr18 ($13.69 in chips) 
Seat 6: pyty_82 ($59.84 in chips) 
Seat 7: Suhoff76 ($25.35 in chips) 
Seat 8: chiyuki ($32.62 in chips) 
Seat 9: D@vidMed ($30.72 in chips) 
gedavaca: posts small blind $0.10
Zugrug: posts big blind $0.25
*** HOLE CARDS ***
Dealt to chiyuki [Qc Jd]
eagie20: folds 
TErr18: folds 
pyty_82: raises $0.37 to $0.62
Suhoff76: folds 
chiyuki: folds 
D@vidMed: folds 
RomarioJa: folds 
gedavaca: folds 
Zugrug: folds 
Uncalled bet ($0.37) returned to pyty_82
pyty_82 collected $0.60 from pot
pyty_82: doesn't show hand 
*** SUMMARY ***
Total pot $0.60 | Rake $0 
Seat 1: RomarioJa (button) folded before Flop (didn't bet)
Seat 2: gedavaca (small blind) folded before Flop
Seat 3: Zugrug (big blind) folded before Flop
Seat 4: eagie20 folded before Flop (didn't bet)
Seat 5: TErr18 folded before Flop (didn't bet)
Seat 6: pyty_82 collected ($0.60)
Seat 7: Suhoff76 folded before Flop (didn't bet)
Seat 8: chiyuki folded before Flop (didn't bet)
Seat 9: D@vidMed folded before Flop (didn't bet)



PokerStars Zoom Hand #84298462947:  Hold'em No Limit ($0.10/$0.25) - 2012/08/05 13:15:35 JST [2012/08/05 0:15:35 ET]
Table 'Whirlpool' 9-max Seat #1 is the button
Seat 1: BlOnDhOlIc ($39.77 in chips) 
Seat 2: KINGKILERACE ($21.58 in chips) 
Seat 3: slickthis ($23.67 in chips) 
Seat 4: 5zzzz33 ($20.87 in chips) 
Seat 5: chiyuki ($32.72 in chips) 
Seat 6: RomarioJa ($6.24 in chips) 
Seat 7: mikifeio ($47.74 in chips) 
Seat 8: Th3Fog ($52.43 in chips) 
Seat 9: wtu1986 ($25.25 in chips) 
KINGKILERACE: posts small blind $0.10
slickthis: posts big blind $0.25
*** HOLE CARDS ***
Dealt to chiyuki [8c 7d]
5zzzz33: folds 
chiyuki: folds 
RomarioJa: folds 
mikifeio: raises $0.25 to $0.50
Th3Fog: folds 
wtu1986: folds 
BlOnDhOlIc: folds 
KINGKILERACE: folds 
slickthis: calls $0.25
*** FLOP *** [Ts 8h 8s]
slickthis: bets $0.25
mikifeio: calls $0.25
*** TURN *** [Ts 8h 8s] [Jh]
slickthis: bets $0.75
mikifeio: folds 
Uncalled bet ($0.75) returned to slickthis
slickthis collected $1.53 from pot
slickthis: doesn't show hand 
*** SUMMARY ***
Total pot $1.60 | Rake $0.07 
Board [Ts 8h 8s Jh]
Seat 1: BlOnDhOlIc (button) folded before Flop (didn't bet)
Seat 2: KINGKILERACE (small blind) folded before Flop
Seat 3: slickthis (big blind) collected ($1.53)
Seat 4: 5zzzz33 folded before Flop (didn't bet)
Seat 5: chiyuki folded before Flop (didn't bet)
Seat 6: RomarioJa folded before Flop (didn't bet)
Seat 7: mikifeio folded on the Turn
Seat 8: Th3Fog folded before Flop (didn't bet)
Seat 9: wtu1986 folded before Flop (didn't bet)



PokerStars Zoom Hand #84298466625:  Hold'em No Limit ($0.10/$0.25) - 2012/08/05 13:15:49 JST [2012/08/05 0:15:49 ET]
Table 'Whirlpool' 9-max Seat #1 is the button
Seat 1: gedavaca ($27.28 in chips) 
Seat 2: eagie20 ($143.21 in chips) 
Seat 3: Alvinpe85 ($31.10 in chips) 
Seat 4: fwani ($29.37 in chips) 
Seat 5: Suhoff76 ($25.35 in chips) 
Seat 6: cR!Ma*aRm ($25.84 in chips) 
Seat 7: Rodina-Kr ($25.35 in chips) 
Seat 8: KeLevro0 ($9.65 in chips) 
Seat 9: chiyuki ($32.62 in chips) 
eagie20: posts small blind $0.10
Alvinpe85: posts big blind $0.25
*** HOLE CARDS ***
Dealt to chiyuki [6c Kh]
fwani has timed out
fwani: folds 
Suhoff76: folds 
cR!Ma*aRm: folds 
Rodina-Kr: folds 
KeLevro0: folds 
chiyuki: folds 
gedavaca: folds 
eagie20: folds 
Uncalled bet ($0.15) returned to Alvinpe85
Alvinpe85 collected $0.20 from pot
Alvinpe85: doesn't show hand 
*** SUMMARY ***
Total pot $0.20 | Rake $0 
Seat 1: gedavaca (button) folded before Flop (didn't bet)
Seat 2: eagie20 (small blind) folded before Flop
Seat 3: Alvinpe85 (big blind) collected ($0.20)
Seat 4: fwani folded before Flop (didn't bet)
Seat 5: Suhoff76 folded before Flop (didn't bet)
Seat 6: cR!Ma*aRm folded before Flop (didn't bet)
Seat 7: Rodina-Kr folded before Flop (didn't bet)
Seat 8: KeLevro0 folded before Flop (didn't bet)
Seat 9: chiyuki folded before Flop (didn't bet)



PokerStars Zoom Hand #84298472257:  Hold'em No Limit ($0.10/$0.25) - 2012/08/05 13:16:09 JST [2012/08/05 0:16:09 ET]
Table 'Whirlpool' 9-max Seat #1 is the button
Seat 1: DooMSDaY1337 ($33.67 in chips) 
Seat 2: TraderYao ($25 in chips) 
Seat 3: Roglus ($12.99 in chips) 
Seat 4: kamikkaze ($49.48 in chips) 
Seat 5: chiyuki ($32.62 in chips) 
Seat 6: gedavaca ($27.18 in chips) 
Seat 7: Loholov ($16.53 in chips) 
Seat 8: MATT361 ($7.73 in chips) 
Seat 9: Th3Fog ($24.33 in chips) 
TraderYao: posts small blind $0.10
Roglus: posts big blind $0.25
*** HOLE CARDS ***
Dealt to chiyuki [3c 9h]
kamikkaze: folds 
chiyuki: folds 
gedavaca: folds 
Loholov: folds 
MATT361: folds 
Th3Fog: folds 
DooMSDaY1337: folds 
TraderYao: folds 
Uncalled bet ($0.15) returned to Roglus
Roglus collected $0.20 from pot
Roglus: doesn't show hand 
*** SUMMARY ***
Total pot $0.20 | Rake $0 
Seat 1: DooMSDaY1337 (button) folded before Flop (didn't bet)
Seat 2: TraderYao (small blind) folded before Flop
Seat 3: Roglus (big blind) collected ($0.20)
Seat 4: kamikkaze folded before Flop (didn't bet)
Seat 5: chiyuki folded before Flop (didn't bet)
Seat 6: gedavaca folded before Flop (didn't bet)
Seat 7: Loholov folded before Flop (didn't bet)
Seat 8: MATT361 folded before Flop (didn't bet)
Seat 9: Th3Fog folded before Flop (didn't bet)



PokerStars Zoom Hand #84298470871:  Hold'em No Limit ($0.10/$0.25) - 2012/08/05 13:16:04 JST [2012/08/05 0:16:04 ET]
Table 'Whirlpool' 9-max Seat #1 is the button
Seat 1: chiyuki ($32.62 in chips) 
Seat 2: puffy5533 ($18.73 in chips) 
Seat 3: seula i ($25.93 in chips) 
Seat 4: RomarioJa ($9.44 in chips) 
Seat 5: nice.franki ($11.20 in chips) 
Seat 6: wtu1986 ($25.15 in chips) 
Seat 7: gedavaca ($27.18 in chips) 
Seat 8: PetitAlejo ($27.35 in chips) 
Seat 9: Roglus ($12.99 in chips) 
puffy5533: posts small blind $0.10
seula i: posts big blind $0.25
*** HOLE CARDS ***
Dealt to chiyuki [7s 5d]
RomarioJa: folds 
nice.franki: folds 
wtu1986: folds 
gedavaca: folds 
PetitAlejo: raises $0.50 to $0.75
Roglus: folds 
chiyuki: folds 
puffy5533: folds 
seula i: folds 
Uncalled bet ($0.50) returned to PetitAlejo
PetitAlejo collected $0.60 from pot
PetitAlejo: doesn't show hand 
*** SUMMARY ***
Total pot $0.60 | Rake $0 
Seat 1: chiyuki (button) folded before Flop (didn't bet)
Seat 2: puffy5533 (small blind) folded before Flop
Seat 3: seula i (big blind) folded before Flop
Seat 4: RomarioJa folded before Flop (didn't bet)
Seat 5: nice.franki folded before Flop (didn't bet)
Seat 6: wtu1986 folded before Flop (didn't bet)
Seat 7: gedavaca folded before Flop (didn't bet)
Seat 8: PetitAlejo collected ($0.60)
Seat 9: Roglus folded before Flop (didn't bet)



PokerStars Zoom Hand #84298469215:  Hold'em No Limit ($0.10/$0.25) - 2012/08/05 13:15:58 JST [2012/08/05 0:15:58 ET]
Table 'Whirlpool' 9-max Seat #1 is the button
Seat 1: deadmoneykid ($20.50 in chips) 
Seat 2: RomarioJa ($6.24 in chips) 
Seat 3: slapshot2011 ($38.37 in chips) 
Seat 4: Th3Fog ($52.43 in chips) 
Seat 5: BlOnDhOlIc ($39.77 in chips) 
Seat 6: Roglus ($12.99 in chips) 
Seat 7: chiyuki ($32.62 in chips) 
Seat 8: puffy5533 ($18.73 in chips) 
Seat 9: gedavaca ($27.18 in chips) 
RomarioJa: posts small blind $0.10
slapshot2011: posts big blind $0.25
*** HOLE CARDS ***
Dealt to chiyuki [Js Ts]
Th3Fog: raises $0.35 to $0.60
BlOnDhOlIc: folds 
Roglus: folds 
chiyuki: folds 
puffy5533: folds 
gedavaca: folds 
deadmoneykid: folds 
RomarioJa: folds 
slapshot2011: calls $0.35
*** FLOP *** [4h Qh 5d]
slapshot2011: bets $0.50
Th3Fog: folds 
Uncalled bet ($0.50) returned to slapshot2011
slapshot2011 collected $1.24 from pot
slapshot2011: doesn't show hand 
*** SUMMARY ***
Total pot $1.30 | Rake $0.06 
Board [4h Qh 5d]
Seat 1: deadmoneykid (button) folded before Flop (didn't bet)
Seat 2: RomarioJa (small blind) folded before Flop
Seat 3: slapshot2011 (big blind) collected ($1.24)
Seat 4: Th3Fog folded on the Flop
Seat 5: BlOnDhOlIc folded before Flop (didn't bet)
Seat 6: Roglus folded before Flop (didn't bet)
Seat 7: chiyuki folded before Flop (didn't bet)
Seat 8: puffy5533 folded before Flop (didn't bet)
Seat 9: gedavaca folded before Flop (didn't bet)



PokerStars Zoom Hand #84298473095:  Hold'em No Limit ($0.10/$0.25) - 2012/08/05 13:16:12 JST [2012/08/05 0:16:12 ET]
Table 'Whirlpool' 9-max Seat #1 is the button
Seat 1: Suhoff76 ($25.10 in chips) 
Seat 2: chiyuki ($32.62 in chips) 
Seat 3: goldstone ($25 in chips) 
Seat 4: softdesign ($52.17 in chips) 
Seat 5: wtu1986 ($25.15 in chips) 
Seat 6: RomarioJa ($9.44 in chips) 
Seat 7: bigrasbig ($68.73 in chips) 
Seat 8: fwani ($29.37 in chips) 
Seat 9: KeLevro0 ($9.65 in chips) 
chiyuki: posts small blind $0.10
goldstone: posts big blind $0.25
*** HOLE CARDS ***
Dealt to chiyuki [5s 5d]
softdesign: folds 
wtu1986: folds 
RomarioJa: folds 
bigrasbig: folds 
fwani: folds 
KeLevro0: folds 
Suhoff76: folds 
chiyuki: raises $0.50 to $0.75
goldstone: calls $0.50
*** FLOP *** [Kc Qc 3d]
chiyuki: bets $0.75
goldstone: folds 
Uncalled bet ($0.75) returned to chiyuki
chiyuki collected $1.43 from pot
chiyuki: doesn't show hand 
*** SUMMARY ***
Total pot $1.50 | Rake $0.07 
Board [Kc Qc 3d]
Seat 1: Suhoff76 (button) folded before Flop (didn't bet)
Seat 2: chiyuki (small blind) collected ($1.43)
Seat 3: goldstone (big blind) folded on the Flop
Seat 4: softdesign folded before Flop (didn't bet)
Seat 5: wtu1986 folded before Flop (didn't bet)
Seat 6: RomarioJa folded before Flop (didn't bet)
Seat 7: bigrasbig folded before Flop (didn't bet)
Seat 8: fwani folded before Flop (didn't bet)
Seat 9: KeLevro0 folded before Flop (didn't bet)



PokerStars Zoom Hand #84298483251:  Hold'em No Limit ($0.10/$0.25) - 2012/08/05 13:16:47 JST [2012/08/05 0:16:47 ET]
Table 'Whirlpool' 9-max Seat #1 is the button
Seat 1: Tasman007 ($8.08 in chips) 
Seat 2: Zugrug ($27.19 in chips) 
Seat 3: KeLevro0 ($12.57 in chips) 
Seat 4: Suhoff76 ($25 in chips) 
Seat 5: seula i ($58.66 in chips) 
Seat 6: chiyuki ($33.30 in chips) 
Seat 7: envious_0007 ($20.86 in chips) 
Seat 8: Alvinpe85 ($31.45 in chips) 
Seat 9: BlOnDhOlIc ($51.63 in chips) 
Zugrug: posts small blind $0.10
KeLevro0: posts big blind $0.25
*** HOLE CARDS ***
Dealt to chiyuki [7d 8d]
Suhoff76: folds 
seula i: folds 
chiyuki: folds 
envious_0007: folds 
Alvinpe85: raises $0.50 to $0.75
BlOnDhOlIc: folds 
Tasman007: calls $0.75
Zugrug: folds 
KeLevro0: folds 
*** FLOP *** [Tc 4d 8h]
Alvinpe85: bets $1.06
Tasman007: calls $1.06
*** TURN *** [Tc 4d 8h] [Jd]
Alvinpe85: checks 
Tasman007: checks 
*** RIVER *** [Tc 4d 8h Jd] [9h]
Alvinpe85: checks 
Tasman007: checks 
*** SHOW DOWN ***
Alvinpe85: shows [8s 8c] (three of a kind, Eights)
Tasman007: mucks hand 
Alvinpe85 collected $3.79 from pot
*** SUMMARY ***
Total pot $3.97 | Rake $0.18 
Board [Tc 4d 8h Jd 9h]
Seat 1: Tasman007 (button) mucked [Kd Th]
Seat 2: Zugrug (small blind) folded before Flop
Seat 3: KeLevro0 (big blind) folded before Flop
Seat 4: Suhoff76 folded before Flop (didn't bet)
Seat 5: seula i folded before Flop (didn't bet)
Seat 6: chiyuki folded before Flop (didn't bet)
Seat 7: envious_0007 folded before Flop (didn't bet)
Seat 8: Alvinpe85 showed [8s 8c] and won ($3.79) with three of a kind, Eights
Seat 9: BlOnDhOlIc folded before Flop (didn't bet)



PokerStars Zoom Hand #84298485127:  Hold'em No Limit ($0.10/$0.25) - 2012/08/05 13:16:55 JST [2012/08/05 0:16:55 ET]
Table 'Whirlpool' 9-max Seat #1 is the button
Seat 1: petersmiths ($36.23 in chips) 
Seat 2: NastyMcNast ($42.52 in chips) 
Seat 3: eagie20 ($143.46 in chips) 
Seat 4: DooMSDaY1337 ($69.81 in chips) 
Seat 5: MATT361 ($7.63 in chips) 
Seat 6: Suhoff76 ($25 in chips) 
Seat 7: Loholov ($20.42 in chips) 
Seat 8: wtu1986 ($25.89 in chips) 
Seat 9: chiyuki ($33.30 in chips) 
NastyMcNast: posts small blind $0.10
eagie20: posts big blind $0.25
*** HOLE CARDS ***
Dealt to chiyuki [Qc 9s]
DooMSDaY1337: folds 
MATT361: calls $0.25
Suhoff76: folds 
Loholov: folds 
wtu1986: folds 
chiyuki: folds 
petersmiths: folds 
NastyMcNast: folds 
eagie20: checks 
*** FLOP *** [Kd 7s 5h]
eagie20: checks 
MATT361: bets $0.25
eagie20: calls $0.25
*** TURN *** [Kd 7s 5h] [Jd]
eagie20: checks 
MATT361: checks 
*** RIVER *** [Kd 7s 5h Jd] [Kh]
eagie20: checks 
MATT361: checks 
*** SHOW DOWN ***
eagie20: shows [6h 5d] (two pair, Kings and Fives)
MATT361: mucks hand 
eagie20 collected $1.05 from pot
*** SUMMARY ***
Total pot $1.10 | Rake $0.05 
Board [Kd 7s 5h Jd Kh]
Seat 1: petersmiths (button) folded before Flop (didn't bet)
Seat 2: NastyMcNast (small blind) folded before Flop
Seat 3: eagie20 (big blind) showed [6h 5d] and won ($1.05) with two pair, Kings and Fives
Seat 4: DooMSDaY1337 folded before Flop (didn't bet)
Seat 5: MATT361 mucked [Ah Tc]
Seat 6: Suhoff76 folded before Flop (didn't bet)
Seat 7: Loholov folded before Flop (didn't bet)
Seat 8: wtu1986 folded before Flop (didn't bet)
Seat 9: chiyuki folded before Flop (didn't bet)



PokerStars Zoom Hand #84298492759:  Hold'em No Limit ($0.10/$0.25) - 2012/08/05 13:17:22 JST [2012/08/05 0:17:22 ET]
Table 'Whirlpool' 9-max Seat #1 is the button
Seat 1: KeLevro0 ($9.30 in chips) 
Seat 2: fwani ($29.12 in chips) 
Seat 3: seula i ($65.47 in chips) 
Seat 4: chiyuki ($33.05 in chips) 
Seat 5: a_tasmanian ($67.77 in chips) 
Seat 6: ShockLaMuc ($24.05 in chips) 
Seat 7: PetitAlejo ($29.85 in chips) 
Seat 8: pyty_82 ($57.57 in chips) 
Seat 9: silvno31 ($21.48 in chips) 
fwani: posts small blind $0.10
seula i: posts big blind $0.25
*** HOLE CARDS ***
Dealt to chiyuki [3d Kh]
chiyuki: folds 
a_tasmanian: folds 
ShockLaMuc: folds 
PetitAlejo: folds 
pyty_82: raises $0.37 to $0.62
silvno31: folds 
KeLevro0: folds 
fwani: folds 
seula i: folds 
Uncalled bet ($0.37) returned to pyty_82
pyty_82 collected $0.60 from pot
pyty_82: doesn't show hand 
*** SUMMARY ***
Total pot $0.60 | Rake $0 
Seat 1: KeLevro0 (button) folded before Flop (didn't bet)
Seat 2: fwani (small blind) folded before Flop
Seat 3: seula i (big blind) folded before Flop
Seat 4: chiyuki folded before Flop (didn't bet)
Seat 5: a_tasmanian folded before Flop (didn't bet)
Seat 6: ShockLaMuc folded before Flop (didn't bet)
Seat 7: PetitAlejo folded before Flop (didn't bet)
Seat 8: pyty_82 collected ($0.60)
Seat 9: silvno31 folded before Flop (didn't bet)



PokerStars Zoom Hand #84298493617:  Hold'em No Limit ($0.10/$0.25) - 2012/08/05 13:17:25 JST [2012/08/05 0:17:25 ET]
Table 'Whirlpool' 9-max Seat #1 is the button
Seat 1: ryanjp2323 ($32.37 in chips) 
Seat 2: TraderYao ($25 in chips) 
Seat 3: MATT361 ($7.13 in chips) 
Seat 4: KeLevro0 ($12.40 in chips) 
Seat 5: Rodina-Kr ($25 in chips) 
Seat 6: ShockLaMuc ($24.65 in chips) 
Seat 7: BlOnDhOlIc ($26.08 in chips) 
Seat 8: chiyuki ($33.05 in chips) 
Seat 9: PetitAlejo ($25 in chips) 
TraderYao: posts small blind $0.10
MATT361: posts big blind $0.25
*** HOLE CARDS ***
Dealt to chiyuki [Jh 8c]
KeLevro0: folds 
Rodina-Kr: folds 
ShockLaMuc: folds 
BlOnDhOlIc: folds 
chiyuki: folds 
PetitAlejo: raises $0.50 to $0.75
ryanjp2323: folds 
TraderYao: folds 
MATT361: folds 
Uncalled bet ($0.50) returned to PetitAlejo
PetitAlejo collected $0.60 from pot
PetitAlejo: doesn't show hand 
*** SUMMARY ***
Total pot $0.60 | Rake $0 
Seat 1: ryanjp2323 (button) folded before Flop (didn't bet)
Seat 2: TraderYao (small blind) folded before Flop
Seat 3: MATT361 (big blind) folded before Flop
Seat 4: KeLevro0 folded before Flop (didn't bet)
Seat 5: Rodina-Kr folded before Flop (didn't bet)
Seat 6: ShockLaMuc folded before Flop (didn't bet)
Seat 7: BlOnDhOlIc folded before Flop (didn't bet)
Seat 8: chiyuki folded before Flop (didn't bet)
Seat 9: PetitAlejo collected ($0.60)



PokerStars Zoom Hand #84298485978:  Hold'em No Limit ($0.10/$0.25) - 2012/08/05 13:16:58 JST [2012/08/05 0:16:58 ET]
Table 'Whirlpool' 9-max Seat #1 is the button
Seat 1: simonzez ($44.24 in chips) 
Seat 2: Alvinpe85 ($26.88 in chips) 
Seat 3: chiyuki ($33.30 in chips) 
Seat 4: polk11 ($20.15 in chips) 
Seat 5: puffy5533 ($18.38 in chips) 
Seat 6: BlOnDhOlIc ($51.63 in chips) 
Seat 7: KeLevro0 ($12.50 in chips) 
Seat 8: Lasutchik ($26.27 in chips) 
Seat 9: luyifei ($22.55 in chips) 
Alvinpe85: posts small blind $0.10
chiyuki: posts big blind $0.25
*** HOLE CARDS ***
Dealt to chiyuki [4h 8d]
polk11: folds 
puffy5533: folds 
BlOnDhOlIc: folds 
KeLevro0: folds 
Lasutchik: folds 
luyifei: raises $0.50 to $0.75
simonzez: calls $0.75
Alvinpe85: raises $2.25 to $3
chiyuki: folds 
luyifei: folds 
simonzez: calls $2.25
*** FLOP *** [9s Kc 6s]
Alvinpe85: bets $4
simonzez: raises $37.24 to $41.24 and is all-in
Alvinpe85: calls $19.88 and is all-in
Uncalled bet ($17.36) returned to simonzez
*** TURN *** [9s Kc 6s] [7h]
*** RIVER *** [9s Kc 6s 7h] [8s]
*** SHOW DOWN ***
Alvinpe85: shows [Kh Ad] (a pair of Kings)
simonzez: shows [Kd 9d] (two pair, Kings and Nines)
simonzez collected $52.76 from pot
*** SUMMARY ***
Total pot $54.76 | Rake $2 
Board [9s Kc 6s 7h 8s]
Seat 1: simonzez (button) showed [Kd 9d] and won ($52.76) with two pair, Kings and Nines
Seat 2: Alvinpe85 (small blind) showed [Kh Ad] and lost with a pair of Kings
Seat 3: chiyuki (big blind) folded before Flop
Seat 4: polk11 folded before Flop (didn't bet)
Seat 5: puffy5533 folded before Flop (didn't bet)
Seat 6: BlOnDhOlIc folded before Flop (didn't bet)
Seat 7: KeLevro0 folded before Flop (didn't bet)
Seat 8: Lasutchik folded before Flop (didn't bet)
Seat 9: luyifei folded before Flop



PokerStars Zoom Hand #84298495036:  Hold'em No Limit ($0.10/$0.25) - 2012/08/05 13:17:30 JST [2012/08/05 0:17:30 ET]
Table 'Whirlpool' 9-max Seat #1 is the button
Seat 1: BlOnDhOlIc ($51.53 in chips) 
Seat 2: cR!Ma*aRm ($23.14 in chips) 
Seat 3: KeLevro0 ($12.40 in chips) 
Seat 4: fwani ($25 in chips) 
Seat 5: chiyuki ($33.05 in chips) 
Seat 6: seula i ($59.67 in chips) 
Seat 7: gAm813r ($28.27 in chips) 
Seat 8: ShockLaMuc ($25.68 in chips) 
Seat 9: ryanjp2323 ($32.37 in chips) 
cR!Ma*aRm: posts small blind $0.10
KeLevro0: posts big blind $0.25
*** HOLE CARDS ***
Dealt to chiyuki [9s 9c]
fwani: folds 
chiyuki: raises $0.50 to $0.75
seula i: folds 
gAm813r: calls $0.75
ShockLaMuc: calls $0.75
ryanjp2323: calls $0.75
BlOnDhOlIc: folds 
cR!Ma*aRm: folds 
KeLevro0: calls $0.50
*** FLOP *** [2c 8c Kc]
KeLevro0: checks 
chiyuki: bets $3
gAm813r: folds 
ShockLaMuc: folds 
ryanjp2323: folds 
KeLevro0: folds 
Uncalled bet ($3) returned to chiyuki
chiyuki collected $3.68 from pot
chiyuki: doesn't show hand 
*** SUMMARY ***
Total pot $3.85 | Rake $0.17 
Board [2c 8c Kc]
Seat 1: BlOnDhOlIc (button) folded before Flop (didn't bet)
Seat 2: cR!Ma*aRm (small blind) folded before Flop
Seat 3: KeLevro0 (big blind) folded on the Flop
Seat 4: fwani folded before Flop (didn't bet)
Seat 5: chiyuki collected ($3.68)
Seat 6: seula i folded before Flop (didn't bet)
Seat 7: gAm813r folded on the Flop
Seat 8: ShockLaMuc folded on the Flop
Seat 9: ryanjp2323 folded on the Flop



PokerStars Zoom Hand #84298515246:  Hold'em No Limit ($0.10/$0.25) - 2012/08/05 13:18:43 JST [2012/08/05 0:18:43 ET]
Table 'Whirlpool' 9-max Seat #1 is the button
Seat 1: chiyuki ($35.98 in chips) 
Seat 2: Loholov ($15 in chips) 
Seat 3: seula i ($25.58 in chips) 
Seat 4: NastyMcNast ($47.97 in chips) 
Seat 5: nice.franki ($10.85 in chips) 
Seat 6: bigrasbig ($69.92 in chips) 
Seat 7: TraderYao ($26.13 in chips) 
Seat 8: KeLevro0 ($11.65 in chips) 
Seat 9: Roglus ($19.16 in chips) 
Loholov: posts small blind $0.10
seula i: posts big blind $0.25
*** HOLE CARDS ***
Dealt to chiyuki [Jh 2c]
NastyMcNast: raises $0.50 to $0.75
nice.franki: folds 
bigrasbig: folds 
TraderYao: folds 
KeLevro0: folds 
Roglus: folds 
chiyuki: folds 
Loholov: folds 
seula i: folds 
Uncalled bet ($0.50) returned to NastyMcNast
NastyMcNast collected $0.60 from pot
NastyMcNast: doesn't show hand 
*** SUMMARY ***
Total pot $0.60 | Rake $0 
Seat 1: chiyuki (button) folded before Flop (didn't bet)
Seat 2: Loholov (small blind) folded before Flop
Seat 3: seula i (big blind) folded before Flop
Seat 4: NastyMcNast collected ($0.60)
Seat 5: nice.franki folded before Flop (didn't bet)
Seat 6: bigrasbig folded before Flop (didn't bet)
Seat 7: TraderYao folded before Flop (didn't bet)
Seat 8: KeLevro0 folded before Flop (didn't bet)
Seat 9: Roglus folded before Flop (didn't bet)



PokerStars Zoom Hand #84298516337:  Hold'em No Limit ($0.10/$0.25) - 2012/08/05 13:18:47 JST [2012/08/05 0:18:47 ET]
Table 'Whirlpool' 9-max Seat #1 is the button
Seat 1: luyifei ($21.33 in chips) 
Seat 2: PetitAlejo ($25.10 in chips) 
Seat 3: RomarioJa ($8.66 in chips) 
Seat 4: bigrasbig ($69.92 in chips) 
Seat 5: gAm813r ($27.52 in chips) 
Seat 6: chiyuki ($35.98 in chips) 
Seat 7: Jene4kaBest ($12.18 in chips) 
Seat 8: BlackZafiro ($25.35 in chips) 
Seat 9: Zugrug ($36.42 in chips) 
PetitAlejo: posts small blind $0.10
RomarioJa: posts big blind $0.25
*** HOLE CARDS ***
Dealt to chiyuki [Jc 8h]
bigrasbig: folds 
gAm813r: folds 
chiyuki: folds 
Jene4kaBest: folds 
BlackZafiro: folds 
Zugrug: folds 
luyifei: raises $0.50 to $0.75
PetitAlejo: folds 
RomarioJa: folds 
Uncalled bet ($0.50) returned to luyifei
luyifei collected $0.60 from pot
luyifei: doesn't show hand 
*** SUMMARY ***
Total pot $0.60 | Rake $0 
Seat 1: luyifei (button) collected ($0.60)
Seat 2: PetitAlejo (small blind) folded before Flop
Seat 3: RomarioJa (big blind) folded before Flop
Seat 4: bigrasbig folded before Flop (didn't bet)
Seat 5: gAm813r folded before Flop (didn't bet)
Seat 6: chiyuki folded before Flop (didn't bet)
Seat 7: Jene4kaBest folded before Flop (didn't bet)
Seat 8: BlackZafiro folded before Flop (didn't bet)
Seat 9: Zugrug folded before Flop (didn't bet)



PokerStars Zoom Hand #84298514118:  Hold'em No Limit ($0.10/$0.25) - 2012/08/05 13:18:39 JST [2012/08/05 0:18:39 ET]
Table 'Whirlpool' 9-max Seat #1 is the button
Seat 1: gunbowler ($99.08 in chips) 
Seat 2: Catrban ($33.22 in chips) 
Seat 3: Loholov ($20.32 in chips) 
Seat 4: chiyuki ($35.98 in chips) 
Seat 5: seula i ($65.82 in chips) 
Seat 6: deadmoneykid ($23.45 in chips) 
Seat 7: Suhoff76 ($25.12 in chips) 
Seat 8: Jene4kaBest ($12.18 in chips) 
Seat 9: BlackZafiro ($25.35 in chips) 
Catrban: posts small blind $0.10
Loholov: posts big blind $0.25
*** HOLE CARDS ***
Dealt to chiyuki [7c Ts]
chiyuki: folds 
seula i: folds 
deadmoneykid: raises $0.50 to $0.75
Suhoff76: folds 
Jene4kaBest: folds 
BlackZafiro: folds 
gunbowler: calls $0.75
Catrban: calls $0.65
Loholov: folds 
*** FLOP *** [4s 4c 5s]
Catrban: checks 
deadmoneykid: bets $1.79
gunbowler: folds 
Catrban: folds 
Uncalled bet ($1.79) returned to deadmoneykid
deadmoneykid collected $2.39 from pot
deadmoneykid: doesn't show hand 
*** SUMMARY ***
Total pot $2.50 | Rake $0.11 
Board [4s 4c 5s]
Seat 1: gunbowler (button) folded on the Flop
Seat 2: Catrban (small blind) folded on the Flop
Seat 3: Loholov (big blind) folded before Flop
Seat 4: chiyuki folded before Flop (didn't bet)
Seat 5: seula i folded before Flop (didn't bet)
Seat 6: deadmoneykid collected ($2.39)
Seat 7: Suhoff76 folded before Flop (didn't bet)
Seat 8: Jene4kaBest folded before Flop (didn't bet)
Seat 9: BlackZafiro folded before Flop (didn't bet)



PokerStars Zoom Hand #84298521869:  Hold'em No Limit ($0.10/$0.25) - 2012/08/05 13:19:07 JST [2012/08/05 0:19:07 ET]
Table 'Whirlpool' 9-max Seat #1 is the button
Seat 1: KeLevro0 ($13.67 in chips) 
Seat 2: Zugrug ($25.35 in chips) 
Seat 3: chiyuki ($35.98 in chips) 
Seat 4: agurio ($25 in chips) 
Seat 5: Alvinpe85 ($25 in chips) 
Seat 6: 4ydo yogurt ($19.75 in chips) 
Seat 7: PetitAlejo ($25 in chips) 
Seat 8: Suhoff76 ($25 in chips) 
Seat 9: fwani ($27.66 in chips) 
Zugrug: posts small blind $0.10
chiyuki: posts big blind $0.25
*** HOLE CARDS ***
Dealt to chiyuki [Js 2h]
agurio: folds 
Alvinpe85: folds 
4ydo yogurt: raises $0.35 to $0.60
PetitAlejo: folds 
Suhoff76: folds 
fwani: folds 
KeLevro0: folds 
Zugrug: folds 
chiyuki: folds 
Uncalled bet ($0.35) returned to 4ydo yogurt
4ydo yogurt collected $0.60 from pot
4ydo yogurt: doesn't show hand 
*** SUMMARY ***
Total pot $0.60 | Rake $0 
Seat 1: KeLevro0 (button) folded before Flop (didn't bet)
Seat 2: Zugrug (small blind) folded before Flop
Seat 3: chiyuki (big blind) folded before Flop
Seat 4: agurio folded before Flop (didn't bet)
Seat 5: Alvinpe85 folded before Flop (didn't bet)
Seat 6: 4ydo yogurt collected ($0.60)
Seat 7: PetitAlejo folded before Flop (didn't bet)
Seat 8: Suhoff76 folded before Flop (didn't bet)
Seat 9: fwani folded before Flop (didn't bet)



PokerStars Zoom Hand #84298518522:  Hold'em No Limit ($0.10/$0.25) - 2012/08/05 13:18:55 JST [2012/08/05 0:18:55 ET]
Table 'Whirlpool' 9-max Seat #1 is the button
Seat 1: Th3Fog ($54.96 in chips) 
Seat 2: Zugrug ($25.35 in chips) 
Seat 3: bigrasbig ($69.82 in chips) 
Seat 4: softdesign ($50.92 in chips) 
Seat 5: Jippyflip ($25.65 in chips) 
Seat 6: RomarioJa ($7.37 in chips) 
Seat 7: chiyuki ($35.98 in chips) 
Seat 8: Alvinpe85 ($32.14 in chips) 
Seat 9: kamikkaze ($48.33 in chips) 
Zugrug: posts small blind $0.10
bigrasbig: posts big blind $0.25
*** HOLE CARDS ***
Dealt to chiyuki [Ah 9d]
softdesign: calls $0.25
Jippyflip: folds 
RomarioJa: folds 
chiyuki: folds 
Alvinpe85: folds 
kamikkaze: folds 
Th3Fog: raises $0.35 to $0.60
Zugrug: folds 
bigrasbig: calls $0.35
softdesign: calls $0.35
*** FLOP *** [7h 8c Qc]
bigrasbig: checks 
softdesign: bets $0.50
Th3Fog: calls $0.50
bigrasbig: folds 
*** TURN *** [7h 8c Qc] [5c]
softdesign: bets $0.50
Th3Fog: raises $1.65 to $2.15
softdesign: folds 
Uncalled bet ($1.65) returned to Th3Fog
Th3Fog collected $3.72 from pot
Th3Fog: doesn't show hand 
*** SUMMARY ***
Total pot $3.90 | Rake $0.18 
Board [7h 8c Qc 5c]
Seat 1: Th3Fog (button) collected ($3.72)
Seat 2: Zugrug (small blind) folded before Flop
Seat 3: bigrasbig (big blind) folded on the Flop
Seat 4: softdesign folded on the Turn
Seat 5: Jippyflip folded before Flop (didn't bet)
Seat 6: RomarioJa folded before Flop (didn't bet)
Seat 7: chiyuki folded before Flop (didn't bet)
Seat 8: Alvinpe85 folded before Flop (didn't bet)
Seat 9: kamikkaze folded before Flop (didn't bet)



PokerStars Zoom Hand #84298526101:  Hold'em No Limit ($0.10/$0.25) - 2012/08/05 13:19:23 JST [2012/08/05 0:19:23 ET]
Table 'Whirlpool' 9-max Seat #1 is the button
Seat 1: RomarioJa ($10.77 in chips) 
Seat 2: chiyuki ($35.73 in chips) 
Seat 3: Th3Fog ($31 in chips) 
Seat 4: polk11 ($20.82 in chips) 
Seat 5: TErr18 ($12.02 in chips) 
Seat 6: gunbowler ($98.33 in chips) 
Seat 7: deadmoneykid ($24.40 in chips) 
Seat 8: pyty_82 ($56.95 in chips) 
Seat 9: Zugrug ($28.34 in chips) 
chiyuki: posts small blind $0.10
Th3Fog: posts big blind $0.25
*** HOLE CARDS ***
Dealt to chiyuki [3s 9c]
polk11: folds 
TErr18: folds 
gunbowler: raises $0.35 to $0.60
deadmoneykid: folds 
pyty_82: folds 
Zugrug: folds 
RomarioJa: folds 
chiyuki: folds 
Th3Fog: folds 
Uncalled bet ($0.35) returned to gunbowler
gunbowler collected $0.60 from pot
gunbowler: doesn't show hand 
*** SUMMARY ***
Total pot $0.60 | Rake $0 
Seat 1: RomarioJa (button) folded before Flop (didn't bet)
Seat 2: chiyuki (small blind) folded before Flop
Seat 3: Th3Fog (big blind) folded before Flop
Seat 4: polk11 folded before Flop (didn't bet)
Seat 5: TErr18 folded before Flop (didn't bet)
Seat 6: gunbowler collected ($0.60)
Seat 7: deadmoneykid folded before Flop (didn't bet)
Seat 8: pyty_82 folded before Flop (didn't bet)
Seat 9: Zugrug folded before Flop (didn't bet)



PokerStars Zoom Hand #84298517674:  Hold'em No Limit ($0.10/$0.25) - 2012/08/05 13:18:52 JST [2012/08/05 0:18:52 ET]
Table 'Whirlpool' 9-max Seat #1 is the button
Seat 1: BlOnDhOlIc ($26.08 in chips) 
Seat 2: PetitAlejo ($29.10 in chips) 
Seat 3: wtu1986 ($25.25 in chips) 
Seat 4: chiyuki ($35.98 in chips) 
Seat 5: BlackZafiro ($25.35 in chips) 
Seat 6: masterkoolb ($12.85 in chips) 
Seat 7: kamikkaze ($48.33 in chips) 
Seat 8: nice.franki ($7.62 in chips) 
Seat 9: MATT361 ($8.27 in chips) 
PetitAlejo: posts small blind $0.10
wtu1986: posts big blind $0.25
*** HOLE CARDS ***
Dealt to chiyuki [2h 4d]
chiyuki: folds 
BlackZafiro: folds 
masterkoolb: folds 
kamikkaze: folds 
nice.franki: folds 
MATT361: folds 
BlOnDhOlIc: folds 
PetitAlejo: raises $0.50 to $0.75
wtu1986: calls $0.50
*** FLOP *** [Jc As Ac]
PetitAlejo: checks 
wtu1986: checks 
*** TURN *** [Jc As Ac] [7h]
PetitAlejo: checks 
wtu1986: bets $1.07
PetitAlejo: folds 
Uncalled bet ($1.07) returned to wtu1986
wtu1986 collected $1.43 from pot
wtu1986: doesn't show hand 
*** SUMMARY ***
Total pot $1.50 | Rake $0.07 
Board [Jc As Ac 7h]
Seat 1: BlOnDhOlIc (button) folded before Flop (didn't bet)
Seat 2: PetitAlejo (small blind) folded on the Turn
Seat 3: wtu1986 (big blind) collected ($1.43)
Seat 4: chiyuki folded before Flop (didn't bet)
Seat 5: BlackZafiro folded before Flop (didn't bet)
Seat 6: masterkoolb folded before Flop (didn't bet)
Seat 7: kamikkaze folded before Flop (didn't bet)
Seat 8: nice.franki folded before Flop (didn't bet)
Seat 9: MATT361 folded before Flop (didn't bet)



PokerStars Zoom Hand #84298527218:  Hold'em No Limit ($0.10/$0.25) - 2012/08/05 13:19:27 JST [2012/08/05 0:19:27 ET]
Table 'Whirlpool' 9-max Seat #1 is the button
Seat 1: Alvinpe85 ($25 in chips) 
Seat 2: Loholov ($20.07 in chips) 
Seat 3: DooMSDaY1337 ($27.29 in chips) 
Seat 4: 5zzzz33 ($17.74 in chips) 
Seat 5: silvno31 ($27.38 in chips) 
Seat 6: pyty_82 ($56.95 in chips) 
Seat 7: DT_Jesus ($15.52 in chips) 
Seat 8: goldstone ($24.10 in chips) 
Seat 9: chiyuki ($35.63 in chips) 
Loholov: posts small blind $0.10
DooMSDaY1337: posts big blind $0.25
*** HOLE CARDS ***
Dealt to chiyuki [6d 9d]
5zzzz33: folds 
silvno31: folds 
pyty_82: folds 
DT_Jesus: folds 
goldstone: folds 
chiyuki: folds 
Alvinpe85: folds 
Loholov: raises $0.50 to $0.75
DooMSDaY1337: folds 
Uncalled bet ($0.50) returned to Loholov
Loholov collected $0.50 from pot
Loholov: doesn't show hand 
*** SUMMARY ***
Total pot $0.50 | Rake $0 
Seat 1: Alvinpe85 (button) folded before Flop (didn't bet)
Seat 2: Loholov (small blind) collected ($0.50)
Seat 3: DooMSDaY1337 (big blind) folded before Flop
Seat 4: 5zzzz33 folded before Flop (didn't bet)
Seat 5: silvno31 folded before Flop (didn't bet)
Seat 6: pyty_82 folded before Flop (didn't bet)
Seat 7: DT_Jesus folded before Flop (didn't bet)
Seat 8: goldstone folded before Flop (didn't bet)
Seat 9: chiyuki folded before Flop (didn't bet)



PokerStars Zoom Hand #84298528330:  Hold'em No Limit ($0.10/$0.25) - 2012/08/05 13:19:31 JST [2012/08/05 0:19:31 ET]
Table 'Whirlpool' 9-max Seat #1 is the button
Seat 1: chiyuki ($35.63 in chips) 
Seat 2: silvno31 ($27.38 in chips) 
Seat 3: Suhoff76 ($25 in chips) 
Seat 4: DT_Jesus ($15.52 in chips) 
Seat 5: masterkoolb ($14.39 in chips) 
Seat 6: pyty_82 ($56.95 in chips) 
Seat 7: nice.franki ($9.90 in chips) 
Seat 8: TErr18 ($28.95 in chips) 
Seat 9: Rodina-Kr ($25 in chips) 
silvno31: posts small blind $0.10
Suhoff76: posts big blind $0.25
*** HOLE CARDS ***
Dealt to chiyuki [Qh Ah]
DT_Jesus: folds 
masterkoolb: folds 
pyty_82: folds 
nice.franki: raises $0.50 to $0.75
TErr18: folds 
Rodina-Kr: folds 
chiyuki: raises $1.50 to $2.25
silvno31: folds 
Suhoff76: folds 
nice.franki: folds 
Uncalled bet ($1.50) returned to chiyuki
chiyuki collected $1.85 from pot
chiyuki: doesn't show hand 
*** SUMMARY ***
Total pot $1.85 | Rake $0 
Seat 1: chiyuki (button) collected ($1.85)
Seat 2: silvno31 (small blind) folded before Flop
Seat 3: Suhoff76 (big blind) folded before Flop
Seat 4: DT_Jesus folded before Flop (didn't bet)
Seat 5: masterkoolb folded before Flop (didn't bet)
Seat 6: pyty_82 folded before Flop (didn't bet)
Seat 7: nice.franki folded before Flop
Seat 8: TErr18 folded before Flop (didn't bet)
Seat 9: Rodina-Kr folded before Flop (didn't bet)



PokerStars Zoom Hand #84298537359:  Hold'em No Limit ($0.10/$0.25) - 2012/08/05 13:20:03 JST [2012/08/05 0:20:03 ET]
Table 'Whirlpool' 9-max Seat #1 is the button
Seat 1: cR!Ma*aRm ($18.87 in chips) 
Seat 2: KeLevro0 ($9.71 in chips) 
Seat 3: nice.franki ($11.10 in chips) 
Seat 4: doanut13 ($36.68 in chips) 
Seat 5: Alvinpe85 ($30.64 in chips) 
Seat 6: chiyuki ($36.73 in chips) 
Seat 7: Zugrug ($36.07 in chips) 
Seat 8: gunbowler ($98.58 in chips) 
Seat 9: masterkoolb ($12.60 in chips) 
KeLevro0: posts small blind $0.10
nice.franki: posts big blind $0.25
*** HOLE CARDS ***
Dealt to chiyuki [6c Js]
doanut13: folds 
Alvinpe85: folds 
chiyuki: folds 
Zugrug: folds 
gunbowler: folds 
masterkoolb: folds 
cR!Ma*aRm: folds 
KeLevro0: folds 
Uncalled bet ($0.15) returned to nice.franki
nice.franki collected $0.20 from pot
nice.franki: doesn't show hand 
*** SUMMARY ***
Total pot $0.20 | Rake $0 
Seat 1: cR!Ma*aRm (button) folded before Flop (didn't bet)
Seat 2: KeLevro0 (small blind) folded before Flop
Seat 3: nice.franki (big blind) collected ($0.20)
Seat 4: doanut13 folded before Flop (didn't bet)
Seat 5: Alvinpe85 folded before Flop (didn't bet)
Seat 6: chiyuki folded before Flop (didn't bet)
Seat 7: Zugrug folded before Flop (didn't bet)
Seat 8: gunbowler folded before Flop (didn't bet)
Seat 9: masterkoolb folded before Flop (didn't bet)



PokerStars Zoom Hand #84298538117:  Hold'em No Limit ($0.10/$0.25) - 2012/08/05 13:20:06 JST [2012/08/05 0:20:06 ET]
Table 'Whirlpool' 9-max Seat #1 is the button
Seat 1: DooMSDaY1337 ($71.71 in chips) 
Seat 2: hirozo ($25.10 in chips) 
Seat 3: NastyMcNast ($26.72 in chips) 
Seat 4: bigrasbig ($69.22 in chips) 
Seat 5: chiyuki ($36.73 in chips) 
Seat 6: Suhoff76 ($25 in chips) 
Seat 7: BlackZafiro ($25.35 in chips) 
Seat 8: MibNe ($29.64 in chips) 
Seat 9: RomarioJa ($5.64 in chips) 
hirozo: posts small blind $0.10
NastyMcNast: posts big blind $0.25
*** HOLE CARDS ***
Dealt to chiyuki [Ks Ts]
bigrasbig: folds 
chiyuki: folds 
Suhoff76: folds 
BlackZafiro: folds 
MibNe: folds 
RomarioJa: folds 
DooMSDaY1337: folds 
hirozo: raises $0.50 to $0.75
NastyMcNast: folds 
Uncalled bet ($0.50) returned to hirozo
hirozo collected $0.50 from pot
hirozo: doesn't show hand 
*** SUMMARY ***
Total pot $0.50 | Rake $0 
Seat 1: DooMSDaY1337 (button) folded before Flop (didn't bet)
Seat 2: hirozo (small blind) collected ($0.50)
Seat 3: NastyMcNast (big blind) folded before Flop
Seat 4: bigrasbig folded before Flop (didn't bet)
Seat 5: chiyuki folded before Flop (didn't bet)
Seat 6: Suhoff76 folded before Flop (didn't bet)
Seat 7: BlackZafiro folded before Flop (didn't bet)
Seat 8: MibNe folded before Flop (didn't bet)
Seat 9: RomarioJa folded before Flop (didn't bet)



PokerStars Zoom Hand #84298539810:  Hold'em No Limit ($0.10/$0.25) - 2012/08/05 13:20:12 JST [2012/08/05 0:20:12 ET]
Table 'Whirlpool' 9-max Seat #1 is the button
Seat 1: ShockLaMuc ($24.18 in chips) 
Seat 2: fwani ($25.45 in chips) 
Seat 3: bigrasbig ($69.22 in chips) 
Seat 4: PetitAlejo ($27.46 in chips) 
Seat 5: kamikkaze ($48.55 in chips) 
Seat 6: kkbruins0408 ($11.27 in chips) 
Seat 7: chiyuki ($36.73 in chips) 
Seat 8: DT_Jesus ($15.17 in chips) 
Seat 9: BlackZafiro ($25 in chips) 
fwani: posts small blind $0.10
bigrasbig: posts big blind $0.25
*** HOLE CARDS ***
Dealt to chiyuki [7d 5h]
PetitAlejo: folds 
kamikkaze: folds 
kkbruins0408: folds 
chiyuki: folds 
DT_Jesus: folds 
BlackZafiro: raises $0.37 to $0.62
ShockLaMuc: folds 
fwani: folds 
bigrasbig: folds 
Uncalled bet ($0.37) returned to BlackZafiro
BlackZafiro collected $0.60 from pot
BlackZafiro: doesn't show hand 
*** SUMMARY ***
Total pot $0.60 | Rake $0 
Seat 1: ShockLaMuc (button) folded before Flop (didn't bet)
Seat 2: fwani (small blind) folded before Flop
Seat 3: bigrasbig (big blind) folded before Flop
Seat 4: PetitAlejo folded before Flop (didn't bet)
Seat 5: kamikkaze folded before Flop (didn't bet)
Seat 6: kkbruins0408 folded before Flop (didn't bet)
Seat 7: chiyuki folded before Flop (didn't bet)
Seat 8: DT_Jesus folded before Flop (didn't bet)
Seat 9: BlackZafiro collected ($0.60)



PokerStars Zoom Hand #84298541808:  Hold'em No Limit ($0.10/$0.25) - 2012/08/05 13:20:19 JST [2012/08/05 0:20:19 ET]
Table 'Whirlpool' 9-max Seat #1 is the button
Seat 1: SlimeyGash ($22.66 in chips) 
Seat 2: Zugrug ($36.07 in chips) 
Seat 3: chiyuki ($36.73 in chips) 
Seat 4: PetitAlejo ($25 in chips) 
Seat 5: BlOnDhOlIc ($25.73 in chips) 
Seat 6: Rodina-Kr ($25 in chips) 
Seat 7: taksist889 ($33.28 in chips) 
Seat 8: BlackZafiro ($25.35 in chips) 
Seat 9: seula i ($55.07 in chips) 
Zugrug: posts small blind $0.10
chiyuki: posts big blind $0.25
*** HOLE CARDS ***
Dealt to chiyuki [7c 5s]
PetitAlejo: folds 
BlOnDhOlIc: folds 
Rodina-Kr: folds 
taksist889: folds 
BlackZafiro: folds 
seula i: folds 
SlimeyGash: folds 
Zugrug: folds 
Uncalled bet ($0.15) returned to chiyuki
chiyuki collected $0.20 from pot
chiyuki: doesn't show hand 
*** SUMMARY ***
Total pot $0.20 | Rake $0 
Seat 1: SlimeyGash (button) folded before Flop (didn't bet)
Seat 2: Zugrug (small blind) folded before Flop
Seat 3: chiyuki (big blind) collected ($0.20)
Seat 4: PetitAlejo folded before Flop (didn't bet)
Seat 5: BlOnDhOlIc folded before Flop (didn't bet)
Seat 6: Rodina-Kr folded before Flop (didn't bet)
Seat 7: taksist889 folded before Flop (didn't bet)
Seat 8: BlackZafiro folded before Flop (didn't bet)
Seat 9: seula i folded before Flop (didn't bet)



PokerStars Zoom Hand #84298535671:  Hold'em No Limit ($0.10/$0.25) - 2012/08/05 13:19:57 JST [2012/08/05 0:19:57 ET]
Table 'Whirlpool' 9-max Seat #1 is the button
Seat 1: nice.franki ($13.42 in chips) 
Seat 2: RomarioJa ($5.74 in chips) 
Seat 3: Medic8681 ($15.43 in chips) 
Seat 4: deadmoneykid ($22.41 in chips) 
Seat 5: Alvinpe85 ($25 in chips) 
Seat 6: cR!Ma*aRm ($18.87 in chips) 
Seat 7: agurio ($25.25 in chips) 
Seat 8: chiyuki ($36.73 in chips) 
Seat 9: fwani ($28.02 in chips) 
RomarioJa: posts small blind $0.10
Medic8681: posts big blind $0.25
*** HOLE CARDS ***
Dealt to chiyuki [5d Tc]
deadmoneykid: calls $0.25
Alvinpe85: folds 
cR!Ma*aRm: folds 
agurio: folds 
chiyuki: folds 
fwani: folds 
nice.franki: folds 
RomarioJa: folds 
Medic8681: checks 
*** FLOP *** [4h 5h 2c]
Medic8681: bets $0.25
deadmoneykid: calls $0.25
*** TURN *** [4h 5h 2c] [Td]
Medic8681: bets $0.75
deadmoneykid: calls $0.75
*** RIVER *** [4h 5h 2c Td] [3h]
Medic8681: checks 
deadmoneykid: checks 
*** SHOW DOWN ***
Medic8681: shows [3s Qc] (a pair of Threes)
deadmoneykid: shows [8h 8s] (a pair of Eights)
deadmoneykid collected $2.48 from pot
*** SUMMARY ***
Total pot $2.60 | Rake $0.12 
Board [4h 5h 2c Td 3h]
Seat 1: nice.franki (button) folded before Flop (didn't bet)
Seat 2: RomarioJa (small blind) folded before Flop
Seat 3: Medic8681 (big blind) showed [3s Qc] and lost with a pair of Threes
Seat 4: deadmoneykid showed [8h 8s] and won ($2.48) with a pair of Eights
Seat 5: Alvinpe85 folded before Flop (didn't bet)
Seat 6: cR!Ma*aRm folded before Flop (didn't bet)
Seat 7: agurio folded before Flop (didn't bet)
Seat 8: chiyuki folded before Flop (didn't bet)
Seat 9: fwani folded before Flop (didn't bet)



PokerStars Zoom Hand #84298549687:  Hold'em No Limit ($0.10/$0.25) - 2012/08/05 13:20:48 JST [2012/08/05 0:20:48 ET]
Table 'Whirlpool' 9-max Seat #1 is the button
Seat 1: seula i ($55.07 in chips) 
Seat 2: ShockLaMuc ($26.88 in chips) 
Seat 3: gAm813r ($26.92 in chips) 
Seat 4: silvno31 ($30.26 in chips) 
Seat 5: wtu1986 ($25.08 in chips) 
Seat 6: TraderYao ($25 in chips) 
Seat 7: BlackZafiro ($25.35 in chips) 
Seat 8: goldstone ($25.27 in chips) 
Seat 9: chiyuki ($36.83 in chips) 
ShockLaMuc: posts small blind $0.10
gAm813r: posts big blind $0.25
*** HOLE CARDS ***
Dealt to chiyuki [Kh Ac]
silvno31: calls $0.25
wtu1986: folds 
TraderYao: folds 
BlackZafiro: raises $0.75 to $1
goldstone: folds 
chiyuki: raises $2 to $3
seula i: folds 
ShockLaMuc: folds 
gAm813r: calls $2.75
silvno31: folds 
BlackZafiro: calls $2
*** FLOP *** [Jc 5s Ks]
gAm813r: checks 
BlackZafiro: checks 
chiyuki: bets $4.50
gAm813r: folds 
BlackZafiro: folds 
Uncalled bet ($4.50) returned to chiyuki
chiyuki collected $8.93 from pot
chiyuki: doesn't show hand 
*** SUMMARY ***
Total pot $9.35 | Rake $0.42 
Board [Jc 5s Ks]
Seat 1: seula i (button) folded before Flop (didn't bet)
Seat 2: ShockLaMuc (small blind) folded before Flop
Seat 3: gAm813r (big blind) folded on the Flop
Seat 4: silvno31 folded before Flop
Seat 5: wtu1986 folded before Flop (didn't bet)
Seat 6: TraderYao folded before Flop (didn't bet)
Seat 7: BlackZafiro folded on the Flop
Seat 8: goldstone folded before Flop (didn't bet)
Seat 9: chiyuki collected ($8.93)



PokerStars Zoom Hand #84298572589:  Hold'em No Limit ($0.10/$0.25) - 2012/08/05 13:22:11 JST [2012/08/05 0:22:11 ET]
Table 'Whirlpool' 9-max Seat #1 is the button
Seat 1: SlimeyGash ($22.41 in chips) 
Seat 2: chiyuki ($42.76 in chips) 
Seat 3: RomarioJa ($5.99 in chips) 
Seat 4: fwani ($28.32 in chips) 
Seat 5: ShockLaMuc ($27.43 in chips) 
Seat 6: wtu1986 ($25.95 in chips) 
Seat 7: goldstone ($25.86 in chips) 
Seat 8: nice.franki ($6.42 in chips) 
Seat 9: doanut13 ($33.37 in chips) 
chiyuki: posts small blind $0.10
RomarioJa: posts big blind $0.25
*** HOLE CARDS ***
Dealt to chiyuki [Ks 8s]
fwani: folds 
ShockLaMuc: folds 
wtu1986: folds 
goldstone: raises $0.30 to $0.55
nice.franki: folds 
doanut13: folds 
SlimeyGash: folds 
chiyuki: folds 
RomarioJa: folds 
Uncalled bet ($0.30) returned to goldstone
goldstone collected $0.60 from pot
goldstone: doesn't show hand 
*** SUMMARY ***
Total pot $0.60 | Rake $0 
Seat 1: SlimeyGash (button) folded before Flop (didn't bet)
Seat 2: chiyuki (small blind) folded before Flop
Seat 3: RomarioJa (big blind) folded before Flop
Seat 4: fwani folded before Flop (didn't bet)
Seat 5: ShockLaMuc folded before Flop (didn't bet)
Seat 6: wtu1986 folded before Flop (didn't bet)
Seat 7: goldstone collected ($0.60)
Seat 8: nice.franki folded before Flop (didn't bet)
Seat 9: doanut13 folded before Flop (didn't bet)



PokerStars Zoom Hand #84298580824:  Hold'em No Limit ($0.10/$0.25) - 2012/08/05 13:22:40 JST [2012/08/05 0:22:40 ET]
Table 'Whirlpool' 9-max Seat #1 is the button
Seat 1: chiyuki ($42.66 in chips) 
Seat 2: wtu1986 ($25.70 in chips) 
Seat 3: Loholov ($16.27 in chips) 
Seat 4: nice.franki ($13.42 in chips) 
Seat 5: D@vidMed ($33.33 in chips) 
Seat 6: Medic8681 ($14.43 in chips) 
Seat 7: Alvinpe85 ($28.66 in chips) 
Seat 8: diez007 ($24.65 in chips) 
Seat 9: SlimeyGash ($22.41 in chips) 
wtu1986: posts small blind $0.10
Loholov: posts big blind $0.25
*** HOLE CARDS ***
Dealt to chiyuki [Ks Ts]
nice.franki: folds 
D@vidMed: folds 
Medic8681: folds 
Alvinpe85: folds 
diez007: folds 
SlimeyGash: raises $0.50 to $0.75
chiyuki: folds 
wtu1986: folds 
Loholov: folds 
Uncalled bet ($0.50) returned to SlimeyGash
SlimeyGash collected $0.60 from pot
SlimeyGash: doesn't show hand 
*** SUMMARY ***
Total pot $0.60 | Rake $0 
Seat 1: chiyuki (button) folded before Flop (didn't bet)
Seat 2: wtu1986 (small blind) folded before Flop
Seat 3: Loholov (big blind) folded before Flop
Seat 4: nice.franki folded before Flop (didn't bet)
Seat 5: D@vidMed folded before Flop (didn't bet)
Seat 6: Medic8681 folded before Flop (didn't bet)
Seat 7: Alvinpe85 folded before Flop (didn't bet)
Seat 8: diez007 folded before Flop (didn't bet)
Seat 9: SlimeyGash collected ($0.60)



PokerStars Zoom Hand #84298588008:  Hold'em No Limit ($0.10/$0.25) - 2012/08/05 13:23:07 JST [2012/08/05 0:23:07 ET]
Table 'Whirlpool' 9-max Seat #1 is the button
Seat 1: Roglus ($44.09 in chips) 
Seat 2: RomarioJa ($8.92 in chips) 
Seat 3: Medic8681 ($14.43 in chips) 
Seat 4: chiyuki ($42.66 in chips) 
Seat 5: slapshot2011 ($37.71 in chips) 
Seat 6: deadmoneykid ($27.19 in chips) 
Seat 7: munky3 ($5.86 in chips) 
Seat 8: Suhoff76 ($30.98 in chips) 
Seat 9: Zugrug ($33.91 in chips) 
RomarioJa: posts small blind $0.10
Medic8681: posts big blind $0.25
*** HOLE CARDS ***
Dealt to chiyuki [6c 2h]
chiyuki: folds 
slapshot2011: folds 
deadmoneykid: folds 
munky3: folds 
Suhoff76: folds 
Zugrug: raises $0.37 to $0.62
Roglus: folds 
RomarioJa: folds 
Medic8681: folds 
Uncalled bet ($0.37) returned to Zugrug
Zugrug collected $0.60 from pot
Zugrug: doesn't show hand 
*** SUMMARY ***
Total pot $0.60 | Rake $0 
Seat 1: Roglus (button) folded before Flop (didn't bet)
Seat 2: RomarioJa (small blind) folded before Flop
Seat 3: Medic8681 (big blind) folded before Flop
Seat 4: chiyuki folded before Flop (didn't bet)
Seat 5: slapshot2011 folded before Flop (didn't bet)
Seat 6: deadmoneykid folded before Flop (didn't bet)
Seat 7: munky3 folded before Flop (didn't bet)
Seat 8: Suhoff76 folded before Flop (didn't bet)
Seat 9: Zugrug collected ($0.60)



PokerStars Zoom Hand #84298590530:  Hold'em No Limit ($0.10/$0.25) - 2012/08/05 13:23:16 JST [2012/08/05 0:23:16 ET]
Table 'Whirlpool' 9-max Seat #1 is the button
Seat 1: KeLevro0 ($13.07 in chips) 
Seat 2: TraderYao ($27.37 in chips) 
Seat 3: TErr18 ($11.84 in chips) 
Seat 4: Th3Fog ($28.27 in chips) 
Seat 5: wtu1986 ($25.60 in chips) 
Seat 6: ShockLaMuc ($27.08 in chips) 
Seat 7: chiyuki ($42.66 in chips) 
Seat 8: DooMSDaY1337 ($89.61 in chips) 
Seat 9: BlOnDhOlIc ($25.35 in chips) 
TraderYao: posts small blind $0.10
TErr18: posts big blind $0.25
*** HOLE CARDS ***
Dealt to chiyuki [2h Ts]
Th3Fog: folds 
wtu1986: folds 
ShockLaMuc: folds 
chiyuki: folds 
DooMSDaY1337: folds 
BlOnDhOlIc: raises $0.25 to $0.50
KeLevro0: folds 
TraderYao: folds 
TErr18: folds 
Uncalled bet ($0.25) returned to BlOnDhOlIc
BlOnDhOlIc collected $0.60 from pot
BlOnDhOlIc: doesn't show hand 
*** SUMMARY ***
Total pot $0.60 | Rake $0 
Seat 1: KeLevro0 (button) folded before Flop (didn't bet)
Seat 2: TraderYao (small blind) folded before Flop
Seat 3: TErr18 (big blind) folded before Flop
Seat 4: Th3Fog folded before Flop (didn't bet)
Seat 5: wtu1986 folded before Flop (didn't bet)
Seat 6: ShockLaMuc folded before Flop (didn't bet)
Seat 7: chiyuki folded before Flop (didn't bet)
Seat 8: DooMSDaY1337 folded before Flop (didn't bet)
Seat 9: BlOnDhOlIc collected ($0.60)



PokerStars Zoom Hand #84298589435:  Hold'em No Limit ($0.10/$0.25) - 2012/08/05 13:23:12 JST [2012/08/05 0:23:12 ET]
Table 'Whirlpool' 9-max Seat #1 is the button
Seat 1: Suhoff76 ($25 in chips) 
Seat 2: Alvinpe85 ($26.77 in chips) 
Seat 3: slapshot2011 ($37.71 in chips) 
Seat 4: Lasutchik ($7.71 in chips) 
Seat 5: Roglus ($44.09 in chips) 
Seat 6: BlackZafiro ($25 in chips) 
Seat 7: DooMSDaY1337 ($89.61 in chips) 
Seat 8: chiyuki ($42.66 in chips) 
Seat 9: PetitAlejo ($26.76 in chips) 
Alvinpe85: posts small blind $0.10
slapshot2011: posts big blind $0.25
*** HOLE CARDS ***
Dealt to chiyuki [7h 6s]
Lasutchik: folds 
Roglus: folds 
BlackZafiro: folds 
DooMSDaY1337: folds 
chiyuki: folds 
PetitAlejo: raises $0.50 to $0.75
Suhoff76: folds 
Alvinpe85: calls $0.65
slapshot2011: folds 
*** FLOP *** [Ah 5d 6d]
Alvinpe85: checks 
PetitAlejo: bets $1.25
Alvinpe85: calls $1.25
*** TURN *** [Ah 5d 6d] [7s]
Alvinpe85: checks 
PetitAlejo: checks 
*** RIVER *** [Ah 5d 6d 7s] [6h]
Alvinpe85: checks 
PetitAlejo: checks 
*** SHOW DOWN ***
Alvinpe85: shows [Ac Qd] (two pair, Aces and Sixes)
PetitAlejo: mucks hand 
Alvinpe85 collected $4.06 from pot
*** SUMMARY ***
Total pot $4.25 | Rake $0.19 
Board [Ah 5d 6d 7s 6h]
Seat 1: Suhoff76 (button) folded before Flop (didn't bet)
Seat 2: Alvinpe85 (small blind) showed [Ac Qd] and won ($4.06) with two pair, Aces and Sixes
Seat 3: slapshot2011 (big blind) folded before Flop
Seat 4: Lasutchik folded before Flop (didn't bet)
Seat 5: Roglus folded before Flop (didn't bet)
Seat 6: BlackZafiro folded before Flop (didn't bet)
Seat 7: DooMSDaY1337 folded before Flop (didn't bet)
Seat 8: chiyuki folded before Flop (didn't bet)
Seat 9: PetitAlejo mucked [Kc Ks]



PokerStars Zoom Hand #84298596034:  Hold'em No Limit ($0.10/$0.25) - 2012/08/05 13:23:36 JST [2012/08/05 0:23:36 ET]
Table 'Whirlpool' 9-max Seat #1 is the button
Seat 1: ShockLaMuc ($27.08 in chips) 
Seat 2: agurio ($25 in chips) 
Seat 3: Lasutchik ($27.53 in chips) 
Seat 4: TErr18 ($11.59 in chips) 
Seat 5: chiyuki ($42.66 in chips) 
Seat 6: wtu1986 ($25.60 in chips) 
Seat 7: Jene4kaBest ($16.81 in chips) 
Seat 8: Suhoff76 ($25 in chips) 
Seat 9: 4ydo yogurt ($7.68 in chips) 
agurio: posts small blind $0.10
Lasutchik: posts big blind $0.25
*** HOLE CARDS ***
Dealt to chiyuki [6d Td]
TErr18: folds 
chiyuki: folds 
wtu1986: folds 
Jene4kaBest: folds 
Suhoff76: folds 
4ydo yogurt: raises $0.50 to $0.75
ShockLaMuc: folds 
agurio: folds 
Lasutchik: folds 
Uncalled bet ($0.50) returned to 4ydo yogurt
4ydo yogurt collected $0.60 from pot
4ydo yogurt: doesn't show hand 
*** SUMMARY ***
Total pot $0.60 | Rake $0 
Seat 1: ShockLaMuc (button) folded before Flop (didn't bet)
Seat 2: agurio (small blind) folded before Flop
Seat 3: Lasutchik (big blind) folded before Flop
Seat 4: TErr18 folded before Flop (didn't bet)
Seat 5: chiyuki folded before Flop (didn't bet)
Seat 6: wtu1986 folded before Flop (didn't bet)
Seat 7: Jene4kaBest folded before Flop (didn't bet)
Seat 8: Suhoff76 folded before Flop (didn't bet)
Seat 9: 4ydo yogurt collected ($0.60)



PokerStars Zoom Hand #84298597767:  Hold'em No Limit ($0.10/$0.25) - 2012/08/05 13:23:42 JST [2012/08/05 0:23:42 ET]
Table 'Whirlpool' 9-max Seat #1 is the button
Seat 1: fwani ($32.78 in chips) 
Seat 2: deadmoneykid ($27.19 in chips) 
Seat 3: chiyuki ($42.66 in chips) 
Seat 4: Jene4kaBest ($16.81 in chips) 
Seat 5: leo2095 ($15.70 in chips) 
Seat 6: Suhoff76 ($25 in chips) 
Seat 7: BlOnDhOlIc ($25.70 in chips) 
Seat 8: Zugrug ($34.26 in chips) 
Seat 9: nice.franki ($10.85 in chips) 
deadmoneykid: posts small blind $0.10
chiyuki: posts big blind $0.25
*** HOLE CARDS ***
Dealt to chiyuki [Tc 9c]
Jene4kaBest: folds 
leo2095: raises $0.25 to $0.50
Suhoff76: folds 
BlOnDhOlIc: folds 
Zugrug: folds 
nice.franki: folds 
fwani: folds 
deadmoneykid: folds 
chiyuki: calls $0.25
*** FLOP *** [As 3c Kd]
chiyuki: checks 
leo2095: checks 
*** TURN *** [As 3c Kd] [Ks]
chiyuki: checks 
leo2095: checks 
*** RIVER *** [As 3c Kd Ks] [4c]
chiyuki: checks 
leo2095: checks 
*** SHOW DOWN ***
chiyuki: shows [Tc 9c] (a pair of Kings)
leo2095: shows [5s 5d] (two pair, Kings and Fives)
leo2095 collected $1.05 from pot
*** SUMMARY ***
Total pot $1.10 | Rake $0.05 
Board [As 3c Kd Ks 4c]
Seat 1: fwani (button) folded before Flop (didn't bet)
Seat 2: deadmoneykid (small blind) folded before Flop
Seat 3: chiyuki (big blind) showed [Tc 9c] and lost with a pair of Kings
Seat 4: Jene4kaBest folded before Flop (didn't bet)
Seat 5: leo2095 showed [5s 5d] and won ($1.05) with two pair, Kings and Fives
Seat 6: Suhoff76 folded before Flop (didn't bet)
Seat 7: BlOnDhOlIc folded before Flop (didn't bet)
Seat 8: Zugrug folded before Flop (didn't bet)
Seat 9: nice.franki folded before Flop (didn't bet)



PokerStars Zoom Hand #84298592752:  Hold'em No Limit ($0.10/$0.25) - 2012/08/05 13:23:24 JST [2012/08/05 0:23:24 ET]
Table 'Whirlpool' 9-max Seat #1 is the button
Seat 1: slapshot2011 ($37.46 in chips) 
Seat 2: Suhoff76 ($25 in chips) 
Seat 3: ryanjp2323 ($39.20 in chips) 
Seat 4: DooMSDaY1337 ($29.22 in chips) 
Seat 5: agurio ($25 in chips) 
Seat 6: chiyuki ($42.66 in chips) 
Seat 7: kkbruins0408 ($11.49 in chips) 
Seat 8: nice.franki ($6.42 in chips) 
Seat 9: Th3Fog ($69.36 in chips) 
Suhoff76: posts small blind $0.10
ryanjp2323: posts big blind $0.25
*** HOLE CARDS ***
Dealt to chiyuki [7d 2d]
DooMSDaY1337: raises $0.50 to $0.75
agurio: folds 
chiyuki: folds 
kkbruins0408: calls $0.75
nice.franki: folds 
Th3Fog: calls $0.75
slapshot2011: calls $0.75
Suhoff76: folds 
ryanjp2323: raises $1.25 to $2
DooMSDaY1337: calls $1.25
kkbruins0408: folds 
Th3Fog: calls $1.25
slapshot2011: calls $1.25
*** FLOP *** [9c 7c 6s]
ryanjp2323: bets $4
DooMSDaY1337: raises $10 to $14
Th3Fog: folds 
slapshot2011: folds 
ryanjp2323: raises $23.20 to $37.20 and is all-in
DooMSDaY1337: calls $13.22 and is all-in
Uncalled bet ($9.98) returned to ryanjp2323
*** TURN *** [9c 7c 6s] [Kd]
*** RIVER *** [9c 7c 6s Kd] [9d]
*** SHOW DOWN ***
ryanjp2323: shows [Qc Qs] (two pair, Queens and Nines)
DooMSDaY1337: shows [Th 8h] (a straight, Six to Ten)
DooMSDaY1337 collected $61.29 from pot
*** SUMMARY ***
Total pot $63.29 | Rake $2 
Board [9c 7c 6s Kd 9d]
Seat 1: slapshot2011 (button) folded on the Flop
Seat 2: Suhoff76 (small blind) folded before Flop
Seat 3: ryanjp2323 (big blind) showed [Qc Qs] and lost with two pair, Queens and Nines
Seat 4: DooMSDaY1337 showed [Th 8h] and won ($61.29) with a straight, Six to Ten
Seat 5: agurio folded before Flop (didn't bet)
Seat 6: chiyuki folded before Flop (didn't bet)
Seat 7: kkbruins0408 folded before Flop
Seat 8: nice.franki folded before Flop (didn't bet)
Seat 9: Th3Fog folded on the Flop



PokerStars Zoom Hand #84298594472:  Hold'em No Limit ($0.10/$0.25) - 2012/08/05 13:23:30 JST [2012/08/05 0:23:30 ET]
Table 'Whirlpool' 9-max Seat #1 is the button
Seat 1: seula i ($73.92 in chips) 
Seat 2: Pkdave ($22.99 in chips) 
Seat 3: wtu1986 ($24.73 in chips) 
Seat 4: luyifei ($28.81 in chips) 
Seat 5: chiyuki ($42.66 in chips) 
Seat 6: Lasutchik ($27.53 in chips) 
Seat 7: Medic8681 ($13.01 in chips) 
Seat 8: vit 111 ($36.06 in chips) 
Seat 9: Suhoff76 ($25 in chips) 
Pkdave: posts small blind $0.10
wtu1986: posts big blind $0.25
*** HOLE CARDS ***
Dealt to chiyuki [8d Td]
luyifei: folds 
chiyuki: folds 
Lasutchik: folds 
Medic8681: folds 
vit 111: calls $0.25
Suhoff76: folds 
seula i: calls $0.25
Pkdave: calls $0.15
wtu1986: checks 
*** FLOP *** [4d 3h Th]
Pkdave: checks 
wtu1986: checks 
vit 111: bets $1.25
seula i: folds 
Pkdave: folds 
wtu1986: folds 
Uncalled bet ($1.25) returned to vit 111
vit 111 collected $0.96 from pot
vit 111: doesn't show hand 
*** SUMMARY ***
Total pot $1 | Rake $0.04 
Board [4d 3h Th]
Seat 1: seula i (button) folded on the Flop
Seat 2: Pkdave (small blind) folded on the Flop
Seat 3: wtu1986 (big blind) folded on the Flop
Seat 4: luyifei folded before Flop (didn't bet)
Seat 5: chiyuki folded before Flop (didn't bet)
Seat 6: Lasutchik folded before Flop (didn't bet)
Seat 7: Medic8681 folded before Flop (didn't bet)
Seat 8: vit 111 collected ($0.96)
Seat 9: Suhoff76 folded before Flop (didn't bet)



PokerStars Zoom Hand #84298609346:  Hold'em No Limit ($0.10/$0.25) - 2012/08/05 13:24:25 JST [2012/08/05 0:24:25 ET]
Table 'Whirlpool' 9-max Seat #1 is the button
Seat 1: TraderYao ($25.10 in chips) 
Seat 2: chiyuki ($42.16 in chips) 
Seat 3: nice.franki ($10.75 in chips) 
Seat 4: Lasutchik ($7.36 in chips) 
Seat 5: Suhoff76 ($26.34 in chips) 
Seat 6: wtu1986 ($25 in chips) 
Seat 7: leo2095 ($16.25 in chips) 
Seat 8: TErr18 ($11.59 in chips) 
Seat 9: RomarioJa ($8.57 in chips) 
chiyuki: posts small blind $0.10
nice.franki: posts big blind $0.25
*** HOLE CARDS ***
Dealt to chiyuki [3s 6s]
Lasutchik: folds 
Suhoff76: folds 
wtu1986: folds 
leo2095: folds 
TErr18: folds 
RomarioJa: folds 
TraderYao: raises $0.37 to $0.62
chiyuki: folds 
nice.franki: raises $1.38 to $2
TraderYao: folds 
Uncalled bet ($1.38) returned to nice.franki
nice.franki collected $1.34 from pot
nice.franki: doesn't show hand 
*** SUMMARY ***
Total pot $1.34 | Rake $0 
Seat 1: TraderYao (button) folded before Flop
Seat 2: chiyuki (small blind) folded before Flop
Seat 3: nice.franki (big blind) collected ($1.34)
Seat 4: Lasutchik folded before Flop (didn't bet)
Seat 5: Suhoff76 folded before Flop (didn't bet)
Seat 6: wtu1986 folded before Flop (didn't bet)
Seat 7: leo2095 folded before Flop (didn't bet)
Seat 8: TErr18 folded before Flop (didn't bet)
Seat 9: RomarioJa folded before Flop (didn't bet)



PokerStars Zoom Hand #84298613226:  Hold'em No Limit ($0.10/$0.25) - 2012/08/05 13:24:39 JST [2012/08/05 0:24:39 ET]
Table 'Whirlpool' 9-max Seat #1 is the button
Seat 1: de harlekijn ($17.03 in chips) 
Seat 2: Loholov ($16.12 in chips) 
Seat 3: RomarioJa ($8.95 in chips) 
Seat 4: Zugrug ($35.41 in chips) 
Seat 5: cR!Ma*aRm ($13.57 in chips) 
Seat 6: kamikkaze ($49.91 in chips) 
Seat 7: seula i ($54.37 in chips) 
Seat 8: BlOnDhOlIc ($25.35 in chips) 
Seat 9: chiyuki ($42.06 in chips) 
Loholov: posts small blind $0.10
RomarioJa: posts big blind $0.25
*** HOLE CARDS ***
Dealt to chiyuki [Th 6d]
Zugrug: folds 
cR!Ma*aRm: folds 
kamikkaze: raises $0.38 to $0.63
seula i: folds 
BlOnDhOlIc: folds 
chiyuki: folds 
de harlekijn: calls $0.63
Loholov: folds 
RomarioJa: folds 
*** FLOP *** [Ah As 9d]
kamikkaze: checks 
de harlekijn: bets $0.50
kamikkaze: folds 
Uncalled bet ($0.50) returned to de harlekijn
de harlekijn collected $1.54 from pot
de harlekijn: doesn't show hand 
*** SUMMARY ***
Total pot $1.61 | Rake $0.07 
Board [Ah As 9d]
Seat 1: de harlekijn (button) collected ($1.54)
Seat 2: Loholov (small blind) folded before Flop
Seat 3: RomarioJa (big blind) folded before Flop
Seat 4: Zugrug folded before Flop (didn't bet)
Seat 5: cR!Ma*aRm folded before Flop (didn't bet)
Seat 6: kamikkaze folded on the Flop
Seat 7: seula i folded before Flop (didn't bet)
Seat 8: BlOnDhOlIc folded before Flop (didn't bet)
Seat 9: chiyuki folded before Flop (didn't bet)



PokerStars Zoom Hand #84298614948:  Hold'em No Limit ($0.10/$0.25) - 2012/08/05 13:24:45 JST [2012/08/05 0:24:45 ET]
Table 'Whirlpool' 9-max Seat #1 is the button
Seat 1: chiyuki ($42.06 in chips) 
Seat 2: goldstone ($30.69 in chips) 
Seat 3: Dejacob ($25 in chips) 
Seat 4: DooMSDaY1337 ($95.11 in chips) 
Seat 5: ShockLaMuc ($24.49 in chips) 
Seat 6: Lasutchik ($7.36 in chips) 
Seat 7: Loholov ($16.02 in chips) 
Seat 8: gedavaca ($38.04 in chips) 
Seat 9: TraderYao ($31.59 in chips) 
goldstone: posts small blind $0.10
Dejacob: posts big blind $0.25
*** HOLE CARDS ***
Dealt to chiyuki [Jc 8h]
DooMSDaY1337: folds 
ShockLaMuc: calls $0.25
Lasutchik: folds 
Loholov: raises $1 to $1.25
gedavaca: folds 
TraderYao: folds 
chiyuki: folds 
goldstone: folds 
Dejacob: folds 
ShockLaMuc: folds 
Uncalled bet ($1) returned to Loholov
Loholov collected $0.85 from pot
Loholov: doesn't show hand 
*** SUMMARY ***
Total pot $0.85 | Rake $0 
Seat 1: chiyuki (button) folded before Flop (didn't bet)
Seat 2: goldstone (small blind) folded before Flop
Seat 3: Dejacob (big blind) folded before Flop
Seat 4: DooMSDaY1337 folded before Flop (didn't bet)
Seat 5: ShockLaMuc folded before Flop
Seat 6: Lasutchik folded before Flop (didn't bet)
Seat 7: Loholov collected ($0.85)
Seat 8: gedavaca folded before Flop (didn't bet)
Seat 9: TraderYao folded before Flop (didn't bet)



PokerStars Zoom Hand #84298617950:  Hold'em No Limit ($0.10/$0.25) - 2012/08/05 13:24:56 JST [2012/08/05 0:24:56 ET]
Table 'Whirlpool' 9-max Seat #1 is the button
Seat 1: Zugrug ($34.22 in chips) 
Seat 2: TraderYao ($25 in chips) 
Seat 3: TErr18 ($10.84 in chips) 
Seat 4: PetitAlejo ($25 in chips) 
Seat 5: Suhoff76 ($31.47 in chips) 
Seat 6: RomarioJa ($8.70 in chips) 
Seat 7: BlackZafiro ($26.24 in chips) 
Seat 8: chiyuki ($42.06 in chips) 
Seat 9: seula i ($62.93 in chips) 
TraderYao: posts small blind $0.10
TErr18: posts big blind $0.25
*** HOLE CARDS ***
Dealt to chiyuki [Ac Kc]
PetitAlejo: folds 
Suhoff76: folds 
RomarioJa: folds 
BlackZafiro: raises $0.50 to $0.75
chiyuki: raises $1.50 to $2.25
seula i: folds 
Zugrug: folds 
TraderYao: folds 
TErr18: folds 
BlackZafiro: folds 
Uncalled bet ($1.50) returned to chiyuki
chiyuki collected $1.85 from pot
chiyuki: doesn't show hand 
*** SUMMARY ***
Total pot $1.85 | Rake $0 
Seat 1: Zugrug (button) folded before Flop (didn't bet)
Seat 2: TraderYao (small blind) folded before Flop
Seat 3: TErr18 (big blind) folded before Flop
Seat 4: PetitAlejo folded before Flop (didn't bet)
Seat 5: Suhoff76 folded before Flop (didn't bet)
Seat 6: RomarioJa folded before Flop (didn't bet)
Seat 7: BlackZafiro folded before Flop
Seat 8: chiyuki collected ($1.85)
Seat 9: seula i folded before Flop (didn't bet)



PokerStars Zoom Hand #84298629648:  Hold'em No Limit ($0.10/$0.25) - 2012/08/05 13:25:39 JST [2012/08/05 0:25:39 ET]
Table 'Whirlpool' 9-max Seat #1 is the button
Seat 1: KeLevro0 ($8.20 in chips) 
Seat 2: masterkoolb ($12.50 in chips) 
Seat 3: agurio ($25 in chips) 
Seat 4: Lasutchik ($25.86 in chips) 
Seat 5: nice.franki ($11.82 in chips) 
Seat 6: TErr18 ($28.55 in chips) 
Seat 7: chiyuki ($43.16 in chips) 
Seat 8: RomarioJa ($8.60 in chips) 
Seat 9: NastyMcNast ($54.76 in chips) 
masterkoolb: posts small blind $0.10
agurio: posts big blind $0.25
*** HOLE CARDS ***
Dealt to chiyuki [3h 3s]
Lasutchik: folds 
nice.franki: folds 
TErr18: folds 
chiyuki: raises $0.50 to $0.75
RomarioJa: folds 
NastyMcNast: folds 
KeLevro0: raises $2 to $2.75
masterkoolb: folds 
agurio: folds 
chiyuki: folds 
Uncalled bet ($2) returned to KeLevro0
KeLevro0 collected $1.85 from pot
KeLevro0: doesn't show hand 
*** SUMMARY ***
Total pot $1.85 | Rake $0 
Seat 1: KeLevro0 (button) collected ($1.85)
Seat 2: masterkoolb (small blind) folded before Flop
Seat 3: agurio (big blind) folded before Flop
Seat 4: Lasutchik folded before Flop (didn't bet)
Seat 5: nice.franki folded before Flop (didn't bet)
Seat 6: TErr18 folded before Flop (didn't bet)
Seat 7: chiyuki folded before Flop
Seat 8: RomarioJa folded before Flop (didn't bet)
Seat 9: NastyMcNast folded before Flop (didn't bet)



PokerStars Zoom Hand #84298636704:  Hold'em No Limit ($0.10/$0.25) - 2012/08/05 13:26:05 JST [2012/08/05 0:26:05 ET]
Table 'Whirlpool' 9-max Seat #1 is the button
Seat 1: masterkoolb ($12.50 in chips) 
Seat 2: jtedecaliss ($145.04 in chips) 
Seat 3: Roglus ($16.65 in chips) 
Seat 4: PetitAlejo ($28.52 in chips) 
Seat 5: Medic8681 ($13.01 in chips) 
Seat 6: nice.franki ($9.65 in chips) 
Seat 7: DooMSDaY1337 ($94.76 in chips) 
Seat 8: seula i ($62.68 in chips) 
Seat 9: chiyuki ($42.41 in chips) 
jtedecaliss: posts small blind $0.10
Roglus: posts big blind $0.25
*** HOLE CARDS ***
Dealt to chiyuki [Kd 4h]
PetitAlejo: folds 
Medic8681: folds 
nice.franki: folds 
DooMSDaY1337: folds 
seula i: folds 
chiyuki: folds 
masterkoolb: folds 
jtedecaliss: folds 
Uncalled bet ($0.15) returned to Roglus
Roglus collected $0.20 from pot
Roglus: doesn't show hand 
*** SUMMARY ***
Total pot $0.20 | Rake $0 
Seat 1: masterkoolb (button) folded before Flop (didn't bet)
Seat 2: jtedecaliss (small blind) folded before Flop
Seat 3: Roglus (big blind) collected ($0.20)
Seat 4: PetitAlejo folded before Flop (didn't bet)
Seat 5: Medic8681 folded before Flop (didn't bet)
Seat 6: nice.franki folded before Flop (didn't bet)
Seat 7: DooMSDaY1337 folded before Flop (didn't bet)
Seat 8: seula i folded before Flop (didn't bet)
Seat 9: chiyuki folded before Flop (didn't bet)



PokerStars Zoom Hand #84298639199:  Hold'em No Limit ($0.10/$0.25) - 2012/08/05 13:26:14 JST [2012/08/05 0:26:14 ET]
Table 'Whirlpool' 9-max Seat #1 is the button
Seat 1: wtu1986 ($25 in chips) 
Seat 2: MATT361 ($5.05 in chips) 
Seat 3: chiyuki ($42.41 in chips) 
Seat 4: agurio ($25 in chips) 
Seat 5: D@vidMed ($40.18 in chips) 
Seat 6: jtedecaliss ($144.94 in chips) 
Seat 7: RomarioJa ($4.74 in chips) 
Seat 8: polk11 ($20.35 in chips) 
Seat 9: Zugrug ($39.06 in chips) 
MATT361: posts small blind $0.10
chiyuki: posts big blind $0.25
*** HOLE CARDS ***
Dealt to chiyuki [Ah Th]
agurio: folds 
D@vidMed: raises $0.57 to $0.82
jtedecaliss: folds 
RomarioJa: folds 
polk11: folds 
Zugrug: folds 
wtu1986: folds 
MATT361: folds 
chiyuki: folds 
Uncalled bet ($0.57) returned to D@vidMed
D@vidMed collected $0.60 from pot
D@vidMed: doesn't show hand 
*** SUMMARY ***
Total pot $0.60 | Rake $0 
Seat 1: wtu1986 (button) folded before Flop (didn't bet)
Seat 2: MATT361 (small blind) folded before Flop
Seat 3: chiyuki (big blind) folded before Flop
Seat 4: agurio folded before Flop (didn't bet)
Seat 5: D@vidMed collected ($0.60)
Seat 6: jtedecaliss folded before Flop (didn't bet)
Seat 7: RomarioJa folded before Flop (didn't bet)
Seat 8: polk11 folded before Flop (didn't bet)
Seat 9: Zugrug folded before Flop (didn't bet)



PokerStars Zoom Hand #84298637778:  Hold'em No Limit ($0.10/$0.25) - 2012/08/05 13:26:09 JST [2012/08/05 0:26:09 ET]
Table 'Whirlpool' 9-max Seat #1 is the button
Seat 1: jtedecaliss ($144.94 in chips) 
Seat 2: PetitAlejo ($28.52 in chips) 
Seat 3: a_tasmanian ($88.16 in chips) 
Seat 4: Zugrug ($34.93 in chips) 
Seat 5: RomarioJa ($4.74 in chips) 
Seat 6: chiyuki ($42.41 in chips) 
Seat 7: Medic8681 ($13.01 in chips) 
Seat 8: KeLevro0 ($9.30 in chips) 
Seat 9: masterkoolb ($12.50 in chips) 
PetitAlejo: posts small blind $0.10
a_tasmanian: posts big blind $0.25
*** HOLE CARDS ***
Dealt to chiyuki [2s 5h]
Zugrug: folds 
RomarioJa: folds 
chiyuki: folds 
Medic8681: folds 
KeLevro0: folds 
masterkoolb: raises $0.60 to $0.85
jtedecaliss: folds 
PetitAlejo: folds 
a_tasmanian: calls $0.60
*** FLOP *** [8h Kh 9h]
a_tasmanian: checks 
masterkoolb: bets $1.29
a_tasmanian: folds 
Uncalled bet ($1.29) returned to masterkoolb
masterkoolb collected $1.72 from pot
masterkoolb: doesn't show hand 
*** SUMMARY ***
Total pot $1.80 | Rake $0.08 
Board [8h Kh 9h]
Seat 1: jtedecaliss (button) folded before Flop (didn't bet)
Seat 2: PetitAlejo (small blind) folded before Flop
Seat 3: a_tasmanian (big blind) folded on the Flop
Seat 4: Zugrug folded before Flop (didn't bet)
Seat 5: RomarioJa folded before Flop (didn't bet)
Seat 6: chiyuki folded before Flop (didn't bet)
Seat 7: Medic8681 folded before Flop (didn't bet)
Seat 8: KeLevro0 folded before Flop (didn't bet)
Seat 9: masterkoolb collected ($1.72)



PokerStars Zoom Hand #84298644913:  Hold'em No Limit ($0.10/$0.25) - 2012/08/05 13:26:36 JST [2012/08/05 0:26:36 ET]
Table 'Whirlpool' 9-max Seat #1 is the button
Seat 1: fwani ($25 in chips) 
Seat 2: Suhoff76 ($26.07 in chips) 
Seat 3: agurio ($30.01 in chips) 
Seat 4: seula i ($52.77 in chips) 
Seat 5: jtedecaliss ($144.94 in chips) 
Seat 6: NastyMcNast ($37.75 in chips) 
Seat 7: chiyuki ($42.16 in chips) 
Seat 8: PetitAlejo ($25.17 in chips) 
Seat 9: BlackZafiro ($26.95 in chips) 
Suhoff76: posts small blind $0.10
agurio: posts big blind $0.25
*** HOLE CARDS ***
Dealt to chiyuki [8c 6h]
seula i: folds 
jtedecaliss: folds 
NastyMcNast: folds 
chiyuki: folds 
PetitAlejo: folds 
BlackZafiro: folds 
fwani: folds 
Suhoff76: folds 
Uncalled bet ($0.15) returned to agurio
agurio collected $0.20 from pot
agurio: doesn't show hand 
*** SUMMARY ***
Total pot $0.20 | Rake $0 
Seat 1: fwani (button) folded before Flop (didn't bet)
Seat 2: Suhoff76 (small blind) folded before Flop
Seat 3: agurio (big blind) collected ($0.20)
Seat 4: seula i folded before Flop (didn't bet)
Seat 5: jtedecaliss folded before Flop (didn't bet)
Seat 6: NastyMcNast folded before Flop (didn't bet)
Seat 7: chiyuki folded before Flop (didn't bet)
Seat 8: PetitAlejo folded before Flop (didn't bet)
Seat 9: BlackZafiro folded before Flop (didn't bet)



PokerStars Zoom Hand #84298646088:  Hold'em No Limit ($0.10/$0.25) - 2012/08/05 13:26:40 JST [2012/08/05 0:26:40 ET]
Table 'Whirlpool' 9-max Seat #1 is the button
Seat 1: goldstone ($26.38 in chips) 
Seat 2: hirozo ($25 in chips) 
Seat 3: DooMSDaY1337 ($62.24 in chips) 
Seat 4: chiyuki ($42.16 in chips) 
Seat 5: luyifei ($27.64 in chips) 
Seat 6: KeLevro0 ($9.99 in chips) 
Seat 7: Zugrug ($39.06 in chips) 
Seat 8: Medic8681 ($17.38 in chips) 
Seat 9: gedavaca ($37.47 in chips) 
hirozo: posts small blind $0.10
DooMSDaY1337: posts big blind $0.25
*** HOLE CARDS ***
Dealt to chiyuki [Kd 7c]
chiyuki: folds 
luyifei: folds 
KeLevro0: raises $0.42 to $0.67
Zugrug: folds 
Medic8681: folds 
gedavaca: folds 
goldstone: folds 
hirozo: folds 
DooMSDaY1337: folds 
Uncalled bet ($0.42) returned to KeLevro0
KeLevro0 collected $0.60 from pot
KeLevro0: doesn't show hand 
*** SUMMARY ***
Total pot $0.60 | Rake $0 
Seat 1: goldstone (button) folded before Flop (didn't bet)
Seat 2: hirozo (small blind) folded before Flop
Seat 3: DooMSDaY1337 (big blind) folded before Flop
Seat 4: chiyuki folded before Flop (didn't bet)
Seat 5: luyifei folded before Flop (didn't bet)
Seat 6: KeLevro0 collected ($0.60)
Seat 7: Zugrug folded before Flop (didn't bet)
Seat 8: Medic8681 folded before Flop (didn't bet)
Seat 9: gedavaca folded before Flop (didn't bet)



PokerStars Zoom Hand #84298647715:  Hold'em No Limit ($0.10/$0.25) - 2012/08/05 13:26:46 JST [2012/08/05 0:26:46 ET]
Table 'Whirlpool' 9-max Seat #1 is the button
Seat 1: Suhoff76 ($31.57 in chips) 
Seat 2: chiyuki ($42.16 in chips) 
Seat 3: Alvinpe85 ($30.10 in chips) 
Seat 4: Loholov ($15 in chips) 
Seat 5: wtu1986 ($25 in chips) 
Seat 6: hirozo ($27.75 in chips) 
Seat 7: Roglus ($16.65 in chips) 
Seat 8: Jene4kaBest ($16.46 in chips) 
Seat 9: BlOnDhOlIc ($28.13 in chips) 
chiyuki: posts small blind $0.10
Alvinpe85: posts big blind $0.25
*** HOLE CARDS ***
Dealt to chiyuki [7h Kh]
Loholov: folds 
wtu1986: folds 
hirozo: folds 
Roglus: folds 
Jene4kaBest: raises $0.50 to $0.75
BlOnDhOlIc: calls $0.75
Suhoff76: folds 
chiyuki: folds 
Alvinpe85: folds 
*** FLOP *** [Td Qc 4d]
Jene4kaBest: bets $0.50
BlOnDhOlIc: calls $0.50
*** TURN *** [Td Qc 4d] [Qh]
Jene4kaBest: checks 
BlOnDhOlIc: bets $1.36
Jene4kaBest: folds 
Uncalled bet ($1.36) returned to BlOnDhOlIc
BlOnDhOlIc collected $2.72 from pot
BlOnDhOlIc: doesn't show hand 
*** SUMMARY ***
Total pot $2.85 | Rake $0.13 
Board [Td Qc 4d Qh]
Seat 1: Suhoff76 (button) folded before Flop (didn't bet)
Seat 2: chiyuki (small blind) folded before Flop
Seat 3: Alvinpe85 (big blind) folded before Flop
Seat 4: Loholov folded before Flop (didn't bet)
Seat 5: wtu1986 folded before Flop (didn't bet)
Seat 6: hirozo folded before Flop (didn't bet)
Seat 7: Roglus folded before Flop (didn't bet)
Seat 8: Jene4kaBest folded on the Turn
Seat 9: BlOnDhOlIc collected ($2.72)



PokerStars Zoom Hand #84298660949:  Hold'em No Limit ($0.10/$0.25) - 2012/08/05 13:27:35 JST [2012/08/05 0:27:35 ET]
Table 'Whirlpool' 9-max Seat #1 is the button
Seat 1: BlOnDhOlIc ($34.38 in chips) 
Seat 2: Th3Fog ($26.22 in chips) 
Seat 3: Medic8681 ($17.38 in chips) 
Seat 4: goldstone ($26.38 in chips) 
Seat 5: PetitAlejo ($25.17 in chips) 
Seat 6: masterkoolb ($13.37 in chips) 
Seat 7: slapshot2011 ($40.88 in chips) 
Seat 8: chiyuki ($42.06 in chips) 
Seat 9: DooMSDaY1337 ($95.46 in chips) 
Th3Fog: posts small blind $0.10
Medic8681: posts big blind $0.25
*** HOLE CARDS ***
Dealt to chiyuki [6s 9d]
goldstone: folds 
PetitAlejo: folds 
masterkoolb: raises $0.60 to $0.85
slapshot2011: folds 
chiyuki: folds 
DooMSDaY1337: folds 
BlOnDhOlIc: folds 
Th3Fog: folds 
Medic8681: folds 
Uncalled bet ($0.60) returned to masterkoolb
masterkoolb collected $0.60 from pot
masterkoolb: doesn't show hand 
*** SUMMARY ***
Total pot $0.60 | Rake $0 
Seat 1: BlOnDhOlIc (button) folded before Flop (didn't bet)
Seat 2: Th3Fog (small blind) folded before Flop
Seat 3: Medic8681 (big blind) folded before Flop
Seat 4: goldstone folded before Flop (didn't bet)
Seat 5: PetitAlejo folded before Flop (didn't bet)
Seat 6: masterkoolb collected ($0.60)
Seat 7: slapshot2011 folded before Flop (didn't bet)
Seat 8: chiyuki folded before Flop (didn't bet)
Seat 9: DooMSDaY1337 folded before Flop (didn't bet)



PokerStars Zoom Hand #84298663991:  Hold'em No Limit ($0.10/$0.25) - 2012/08/05 13:27:47 JST [2012/08/05 0:27:47 ET]
Table 'Whirlpool' 9-max Seat #1 is the button
Seat 1: Loholov ($37.10 in chips) 
Seat 2: Suhoff76 ($25 in chips) 
Seat 3: a_tasmanian ($87.21 in chips) 
Seat 4: chiyuki ($42.06 in chips) 
Seat 5: TErr18 ($27.85 in chips) 
Seat 6: 4ydo yogurt ($6.95 in chips) 
Seat 7: Lasutchik ($8.34 in chips) 
Seat 8: diez007 ($23.75 in chips) 
Seat 9: PetitAlejo ($28.52 in chips) 
Suhoff76: posts small blind $0.10
a_tasmanian: posts big blind $0.25
*** HOLE CARDS ***
Dealt to chiyuki [6c 6s]
chiyuki: folds 
TErr18: folds 
4ydo yogurt: folds 
Lasutchik: folds 
diez007: folds 
PetitAlejo: folds 
Loholov: folds 
Suhoff76: folds 
Uncalled bet ($0.15) returned to a_tasmanian
a_tasmanian collected $0.20 from pot
a_tasmanian: doesn't show hand 
*** SUMMARY ***
Total pot $0.20 | Rake $0 
Seat 1: Loholov (button) folded before Flop (didn't bet)
Seat 2: Suhoff76 (small blind) folded before Flop
Seat 3: a_tasmanian (big blind) collected ($0.20)
Seat 4: chiyuki folded before Flop (didn't bet)
Seat 5: TErr18 folded before Flop (didn't bet)
Seat 6: 4ydo yogurt folded before Flop (didn't bet)
Seat 7: Lasutchik folded before Flop (didn't bet)
Seat 8: diez007 folded before Flop (didn't bet)
Seat 9: PetitAlejo folded before Flop (didn't bet)



PokerStars Zoom Hand #84298653331:  Hold'em No Limit ($0.10/$0.25) - 2012/08/05 13:27:07 JST [2012/08/05 0:27:07 ET]
Table 'Whirlpool' 9-max Seat #1 is the button
Seat 1: chiyuki ($42.06 in chips) 
Seat 2: fwani ($28.37 in chips) 
Seat 3: TraderYao ($25 in chips) 
Seat 4: PetitAlejo ($25.52 in chips) 
Seat 5: Landybob ($25 in chips) 
Seat 6: Medic8681 ($17.38 in chips) 
Seat 7: ShockLaMuc ($25.08 in chips) 
Seat 8: slickthis ($33.28 in chips) 
Seat 9: Loholov ($15 in chips) 
fwani: posts small blind $0.10
TraderYao: posts big blind $0.25
*** HOLE CARDS ***
Dealt to chiyuki [2s Ac]
PetitAlejo: folds 
Landybob: folds 
Medic8681: folds 
ShockLaMuc: folds 
slickthis: calls $0.25
Loholov: folds 
chiyuki: folds 
fwani: calls $0.15
TraderYao: raises $1.25 to $1.50
slickthis: folds 
fwani: folds 
Uncalled bet ($1.25) returned to TraderYao
TraderYao collected $0.75 from pot
TraderYao: doesn't show hand 
*** SUMMARY ***
Total pot $0.75 | Rake $0 
Seat 1: chiyuki (button) folded before Flop (didn't bet)
Seat 2: fwani (small blind) folded before Flop
Seat 3: TraderYao (big blind) collected ($0.75)
Seat 4: PetitAlejo folded before Flop (didn't bet)
Seat 5: Landybob folded before Flop (didn't bet)
Seat 6: Medic8681 folded before Flop (didn't bet)
Seat 7: ShockLaMuc folded before Flop (didn't bet)
Seat 8: slickthis folded before Flop
Seat 9: Loholov folded before Flop (didn't bet)



PokerStars Zoom Hand #84298662065:  Hold'em No Limit ($0.10/$0.25) - 2012/08/05 13:27:39 JST [2012/08/05 0:27:39 ET]
Table 'Whirlpool' 9-max Seat #1 is the button
Seat 1: PetitAlejo ($25.17 in chips) 
Seat 2: Jippyflip ($17.75 in chips) 
Seat 3: Suhoff76 ($26.32 in chips) 
Seat 4: DooMSDaY1337 ($61.99 in chips) 
Seat 5: Zugrug ($33.87 in chips) 
Seat 6: chiyuki ($42.06 in chips) 
Seat 7: ShockLaMuc ($21.89 in chips) 
Seat 8: Dejacob ($25.70 in chips) 
Seat 9: seula i ($51.38 in chips) 
Jippyflip: posts small blind $0.10
Suhoff76: posts big blind $0.25
*** HOLE CARDS ***
Dealt to chiyuki [Qh Jh]
DooMSDaY1337: folds 
Zugrug: folds 
chiyuki: folds 
ShockLaMuc: folds 
Dejacob: folds 
seula i: folds 
PetitAlejo: folds 
Jippyflip: calls $0.15
Suhoff76: checks 
*** FLOP *** [3h 3s Qs]
Jippyflip: checks 
Suhoff76: bets $0.31
Jippyflip: folds 
Uncalled bet ($0.31) returned to Suhoff76
Suhoff76 collected $0.48 from pot
Suhoff76: doesn't show hand 
*** SUMMARY ***
Total pot $0.50 | Rake $0.02 
Board [3h 3s Qs]
Seat 1: PetitAlejo (button) folded before Flop (didn't bet)
Seat 2: Jippyflip (small blind) folded on the Flop
Seat 3: Suhoff76 (big blind) collected ($0.48)
Seat 4: DooMSDaY1337 folded before Flop (didn't bet)
Seat 5: Zugrug folded before Flop (didn't bet)
Seat 6: chiyuki folded before Flop (didn't bet)
Seat 7: ShockLaMuc folded before Flop (didn't bet)
Seat 8: Dejacob folded before Flop (didn't bet)
Seat 9: seula i folded before Flop (didn't bet)



PokerStars Zoom Hand #84298666516:  Hold'em No Limit ($0.10/$0.25) - 2012/08/05 13:27:56 JST [2012/08/05 0:27:56 ET]
Table 'Whirlpool' 9-max Seat #1 is the button
Seat 1: DooMSDaY1337 ($61.89 in chips) 
Seat 2: chiyuki ($42.06 in chips) 
Seat 3: Ellen1947 ($25 in chips) 
Seat 4: PetitAlejo ($25 in chips) 
Seat 5: RomarioJa ($8.76 in chips) 
Seat 6: Zugrug ($33.96 in chips) 
Seat 7: Dejacob ($25.25 in chips) 
Seat 8: ShockLaMuc ($21.79 in chips) 
Seat 9: BlackZafiro ($27.05 in chips) 
chiyuki: posts small blind $0.10
Ellen1947: posts big blind $0.25
*** HOLE CARDS ***
Dealt to chiyuki [4s 2s]
PetitAlejo: folds 
RomarioJa: folds 
Zugrug: folds 
Dejacob: folds 
ShockLaMuc: raises $0.50 to $0.75
BlackZafiro: folds 
DooMSDaY1337: folds 
chiyuki: folds 
Ellen1947: folds 
Uncalled bet ($0.50) returned to ShockLaMuc
ShockLaMuc collected $0.60 from pot
ShockLaMuc: doesn't show hand 
*** SUMMARY ***
Total pot $0.60 | Rake $0 
Seat 1: DooMSDaY1337 (button) folded before Flop (didn't bet)
Seat 2: chiyuki (small blind) folded before Flop
Seat 3: Ellen1947 (big blind) folded before Flop
Seat 4: PetitAlejo folded before Flop (didn't bet)
Seat 5: RomarioJa folded before Flop (didn't bet)
Seat 6: Zugrug folded before Flop (didn't bet)
Seat 7: Dejacob folded before Flop (didn't bet)
Seat 8: ShockLaMuc collected ($0.60)
Seat 9: BlackZafiro folded before Flop (didn't bet)



PokerStars Zoom Hand #84298663181:  Hold'em No Limit ($0.10/$0.25) - 2012/08/05 13:27:44 JST [2012/08/05 0:27:44 ET]
Table 'Whirlpool' 9-max Seat #1 is the button
Seat 1: fwani ($30.38 in chips) 
Seat 2: goldstone ($34.88 in chips) 
Seat 3: KeLevro0 ($12.15 in chips) 
Seat 4: ll_LaMeR_ll ($27.57 in chips) 
Seat 5: chiyuki ($42.06 in chips) 
Seat 6: NastyMcNast ($56.01 in chips) 
Seat 7: DooMSDaY1337 ($95.46 in chips) 
Seat 8: TraderYao ($31.94 in chips) 
Seat 9: Pkdave ($26.60 in chips) 
goldstone: posts small blind $0.10
KeLevro0: posts big blind $0.25
*** HOLE CARDS ***
Dealt to chiyuki [Th Kd]
ll_LaMeR_ll: folds 
chiyuki: folds 
NastyMcNast: folds 
DooMSDaY1337: folds 
TraderYao: folds 
Pkdave: folds 
fwani: raises $0.35 to $0.60
goldstone: calls $0.50
KeLevro0: folds 
*** FLOP *** [2h 3c 4h]
goldstone: checks 
fwani: checks 
*** TURN *** [2h 3c 4h] [8h]
goldstone: checks 
fwani: bets $0.70
goldstone: folds 
Uncalled bet ($0.70) returned to fwani
fwani collected $1.38 from pot
fwani: doesn't show hand 
*** SUMMARY ***
Total pot $1.45 | Rake $0.07 
Board [2h 3c 4h 8h]
Seat 1: fwani (button) collected ($1.38)
Seat 2: goldstone (small blind) folded on the Turn
Seat 3: KeLevro0 (big blind) folded before Flop
Seat 4: ll_LaMeR_ll folded before Flop (didn't bet)
Seat 5: chiyuki folded before Flop (didn't bet)
Seat 6: NastyMcNast folded before Flop (didn't bet)
Seat 7: DooMSDaY1337 folded before Flop (didn't bet)
Seat 8: TraderYao folded before Flop (didn't bet)
Seat 9: Pkdave folded before Flop (didn't bet)



PokerStars Zoom Hand #84298668081:  Hold'em No Limit ($0.10/$0.25) - 2012/08/05 13:28:02 JST [2012/08/05 0:28:02 ET]
Table 'Whirlpool' 9-max Seat #1 is the button
Seat 1: polk11 ($17 in chips) 
Seat 2: deadmoneykid ($25.02 in chips) 
Seat 3: Medic8681 ($16.68 in chips) 
Seat 4: DooMSDaY1337 ($61.89 in chips) 
Seat 5: chiyuki ($41.96 in chips) 
Seat 6: PetitAlejo ($25 in chips) 
Seat 7: Roglus ($17.76 in chips) 
Seat 8: hirozo ($36.39 in chips) 
Seat 9: wtu1986 ($24.65 in chips) 
deadmoneykid: posts small blind $0.10
Medic8681: posts big blind $0.25
*** HOLE CARDS ***
Dealt to chiyuki [4s 5c]
DooMSDaY1337: raises $0.50 to $0.75
chiyuki: folds 
PetitAlejo: folds 
Roglus: folds 
hirozo: folds 
wtu1986: folds 
polk11: calls $0.75
deadmoneykid: folds 
Medic8681: folds 
*** FLOP *** [8h Js 2d]
DooMSDaY1337: bets $0.88
polk11: folds 
Uncalled bet ($0.88) returned to DooMSDaY1337
DooMSDaY1337 collected $1.77 from pot
DooMSDaY1337: doesn't show hand 
*** SUMMARY ***
Total pot $1.85 | Rake $0.08 
Board [8h Js 2d]
Seat 1: polk11 (button) folded on the Flop
Seat 2: deadmoneykid (small blind) folded before Flop
Seat 3: Medic8681 (big blind) folded before Flop
Seat 4: DooMSDaY1337 collected ($1.77)
Seat 5: chiyuki folded before Flop (didn't bet)
Seat 6: PetitAlejo folded before Flop (didn't bet)
Seat 7: Roglus folded before Flop (didn't bet)
Seat 8: hirozo folded before Flop (didn't bet)
Seat 9: wtu1986 folded before Flop (didn't bet)



PokerStars Zoom Hand #84298669449:  Hold'em No Limit ($0.10/$0.25) - 2012/08/05 13:28:07 JST [2012/08/05 0:28:07 ET]
Table 'Whirlpool' 9-max Seat #1 is the button
Seat 1: KeLevro0 ($9.65 in chips) 
Seat 2: goldstone ($26.38 in chips) 
Seat 3: chiyuki ($41.96 in chips) 
Seat 4: Dejacob ($25.25 in chips) 
Seat 5: nice.franki ($12.37 in chips) 
Seat 6: Roglus ($17.76 in chips) 
Seat 7: Zugrug ($38.15 in chips) 
Seat 8: BlOnDhOlIc ($34.13 in chips) 
Seat 9: BlackZafiro ($25 in chips) 
goldstone: posts small blind $0.10
chiyuki: posts big blind $0.25
*** HOLE CARDS ***
Dealt to chiyuki [Js 9s]
Dejacob: folds 
nice.franki: folds 
Roglus: folds 
Zugrug: folds 
BlOnDhOlIc: folds 
BlackZafiro: folds 
KeLevro0: folds 
goldstone: raises $0.30 to $0.55
chiyuki: calls $0.30
*** FLOP *** [2s 6c Td]
goldstone: bets $0.49
chiyuki: folds 
Uncalled bet ($0.49) returned to goldstone
goldstone collected $1.05 from pot
goldstone: doesn't show hand 
*** SUMMARY ***
Total pot $1.10 | Rake $0.05 
Board [2s 6c Td]
Seat 1: KeLevro0 (button) folded before Flop (didn't bet)
Seat 2: goldstone (small blind) collected ($1.05)
Seat 3: chiyuki (big blind) folded on the Flop
Seat 4: Dejacob folded before Flop (didn't bet)
Seat 5: nice.franki folded before Flop (didn't bet)
Seat 6: Roglus folded before Flop (didn't bet)
Seat 7: Zugrug folded before Flop (didn't bet)
Seat 8: BlOnDhOlIc folded before Flop (didn't bet)
Seat 9: BlackZafiro folded before Flop (didn't bet)



PokerStars Zoom Hand #84298675425:  Hold'em No Limit ($0.10/$0.25) - 2012/08/05 13:28:29 JST [2012/08/05 0:28:29 ET]
Table 'Whirlpool' 9-max Seat #1 is the button
Seat 1: Suhoff76 ($25.89 in chips) 
Seat 2: KINGKILERACE ($22.27 in chips) 
Seat 3: masterkoolb ($13.72 in chips) 
Seat 4: Lasutchik ($8.09 in chips) 
Seat 5: DooMSDaY1337 ($96.38 in chips) 
Seat 6: TraderYao ($31.69 in chips) 
Seat 7: NastyMcNast ($35.48 in chips) 
Seat 8: nice.franki ($3.47 in chips) 
Seat 9: chiyuki ($41.41 in chips) 
KINGKILERACE: posts small blind $0.10
masterkoolb: posts big blind $0.25
*** HOLE CARDS ***
Dealt to chiyuki [Js Ac]
Lasutchik: raises $0.50 to $0.75
DooMSDaY1337: folds 
TraderYao: folds 
NastyMcNast: folds 
nice.franki: folds 
chiyuki: folds 
Suhoff76: folds 
KINGKILERACE: folds 
masterkoolb: folds 
Uncalled bet ($0.50) returned to Lasutchik
Lasutchik collected $0.60 from pot
Lasutchik: doesn't show hand 
*** SUMMARY ***
Total pot $0.60 | Rake $0 
Seat 1: Suhoff76 (button) folded before Flop (didn't bet)
Seat 2: KINGKILERACE (small blind) folded before Flop
Seat 3: masterkoolb (big blind) folded before Flop
Seat 4: Lasutchik collected ($0.60)
Seat 5: DooMSDaY1337 folded before Flop (didn't bet)
Seat 6: TraderYao folded before Flop (didn't bet)
Seat 7: NastyMcNast folded before Flop (didn't bet)
Seat 8: nice.franki folded before Flop (didn't bet)
Seat 9: chiyuki folded before Flop (didn't bet)



PokerStars Zoom Hand #84298687617:  Hold'em No Limit ($0.10/$0.25) - 2012/08/05 13:29:15 JST [2012/08/05 0:29:15 ET]
Table 'Whirlpool' 9-max Seat #1 is the button
Seat 1: chiyuki ($41.41 in chips) 
Seat 2: Lasutchik ($8.44 in chips) 
Seat 3: KeLevro0 ($15.31 in chips) 
Seat 4: kamikkaze ($47.95 in chips) 
Seat 5: 4ydo yogurt ($5.35 in chips) 
Seat 6: wtu1986 ($25.25 in chips) 
Seat 7: RomarioJa ($5.39 in chips) 
Seat 8: jtedecaliss ($144.29 in chips) 
Seat 9: NastyMcNast ($37.87 in chips) 
Lasutchik: posts small blind $0.10
KeLevro0: posts big blind $0.25
*** HOLE CARDS ***
Dealt to chiyuki [5c Ad]
kamikkaze: folds 
4ydo yogurt: folds 
wtu1986: folds 
RomarioJa: folds 
jtedecaliss: folds 
NastyMcNast: folds 
chiyuki: raises $0.50 to $0.75
Lasutchik: folds 
KeLevro0: folds 
Uncalled bet ($0.50) returned to chiyuki
chiyuki collected $0.60 from pot
chiyuki: doesn't show hand 
*** SUMMARY ***
Total pot $0.60 | Rake $0 
Seat 1: chiyuki (button) collected ($0.60)
Seat 2: Lasutchik (small blind) folded before Flop
Seat 3: KeLevro0 (big blind) folded before Flop
Seat 4: kamikkaze folded before Flop (didn't bet)
Seat 5: 4ydo yogurt folded before Flop (didn't bet)
Seat 6: wtu1986 folded before Flop (didn't bet)
Seat 7: RomarioJa folded before Flop (didn't bet)
Seat 8: jtedecaliss folded before Flop (didn't bet)
Seat 9: NastyMcNast folded before Flop (didn't bet)



PokerStars Zoom Hand #84298691606:  Hold'em No Limit ($0.10/$0.25) - 2012/08/05 13:29:30 JST [2012/08/05 0:29:30 ET]
Table 'Whirlpool' 9-max Seat #1 is the button
Seat 1: seula i ($51.03 in chips) 
Seat 2: PetitAlejo ($25 in chips) 
Seat 3: NastyMcNast ($27.92 in chips) 
Seat 4: Nerkit ($12.50 in chips) 
Seat 5: diez007 ($25.80 in chips) 
Seat 6: Landybob ($25.78 in chips) 
Seat 7: TraderYao ($25.75 in chips) 
Seat 8: chiyuki ($41.76 in chips) 
Seat 9: deadmoneykid ($29.12 in chips) 
PetitAlejo: posts small blind $0.10
NastyMcNast: posts big blind $0.25
*** HOLE CARDS ***
Dealt to chiyuki [7s Qd]
Nerkit: folds 
diez007: raises $0.62 to $0.87
Landybob: folds 
TraderYao: raises $1.88 to $2.75
chiyuki: folds 
deadmoneykid: folds 
seula i: folds 
PetitAlejo: folds 
NastyMcNast: folds 
diez007: folds 
Uncalled bet ($1.88) returned to TraderYao
TraderYao collected $2.09 from pot
TraderYao: doesn't show hand 
*** SUMMARY ***
Total pot $2.09 | Rake $0 
Seat 1: seula i (button) folded before Flop (didn't bet)
Seat 2: PetitAlejo (small blind) folded before Flop
Seat 3: NastyMcNast (big blind) folded before Flop
Seat 4: Nerkit folded before Flop (didn't bet)
Seat 5: diez007 folded before Flop
Seat 6: Landybob folded before Flop (didn't bet)
Seat 7: TraderYao collected ($2.09)
Seat 8: chiyuki folded before Flop (didn't bet)
Seat 9: deadmoneykid folded before Flop (didn't bet)



PokerStars Zoom Hand #84298695148:  Hold'em No Limit ($0.10/$0.25) - 2012/08/05 13:29:43 JST [2012/08/05 0:29:43 ET]
Table 'Whirlpool' 9-max Seat #1 is the button
Seat 1: PetitAlejo ($25 in chips) 
Seat 2: fwani ($35.65 in chips) 
Seat 3: BlackZafiro ($25 in chips) 
Seat 4: kamikkaze ($47.70 in chips) 
Seat 5: masterkoolb ($12.50 in chips) 
Seat 6: chiyuki ($41.76 in chips) 
Seat 7: Suhoff76 ($26.10 in chips) 
Seat 8: gunbowler ($95.21 in chips) 
Seat 9: KeLevro0 ($11.55 in chips) 
fwani: posts small blind $0.10
BlackZafiro: posts big blind $0.25
*** HOLE CARDS ***
Dealt to chiyuki [Qs Kd]
kamikkaze: folds 
masterkoolb: folds 
chiyuki: raises $0.50 to $0.75
Suhoff76: folds 
gunbowler: calls $0.75
KeLevro0: folds 
PetitAlejo: folds 
fwani: folds 
BlackZafiro: folds 
*** FLOP *** [8d Ks Tc]
chiyuki: bets $1
gunbowler: calls $1
*** TURN *** [8d Ks Tc] [Ah]
chiyuki: bets $1.84
gunbowler: folds 
Uncalled bet ($1.84) returned to chiyuki
chiyuki collected $3.68 from pot
chiyuki: doesn't show hand 
*** SUMMARY ***
Total pot $3.85 | Rake $0.17 
Board [8d Ks Tc Ah]
Seat 1: PetitAlejo (button) folded before Flop (didn't bet)
Seat 2: fwani (small blind) folded before Flop
Seat 3: BlackZafiro (big blind) folded before Flop
Seat 4: kamikkaze folded before Flop (didn't bet)
Seat 5: masterkoolb folded before Flop (didn't bet)
Seat 6: chiyuki collected ($3.68)
Seat 7: Suhoff76 folded before Flop (didn't bet)
Seat 8: gunbowler folded on the Turn
Seat 9: KeLevro0 folded before Flop (didn't bet)



PokerStars Zoom Hand #84298692438:  Hold'em No Limit ($0.10/$0.25) - 2012/08/05 13:29:33 JST [2012/08/05 0:29:33 ET]
Table 'Whirlpool' 9-max Seat #1 is the button
Seat 1: jtedecaliss ($144.19 in chips) 
Seat 2: DooMSDaY1337 ($63.01 in chips) 
Seat 3: carlosrbr ($12.35 in chips) 
Seat 4: KeLevro0 ($13.74 in chips) 
Seat 5: Loholov ($29.11 in chips) 
Seat 6: Paranoix1990 ($25.13 in chips) 
Seat 7: chiyuki ($41.76 in chips) 
Seat 8: Suhoff76 ($25 in chips) 
Seat 9: Th3Fog ($54.42 in chips) 
DooMSDaY1337: posts small blind $0.10
carlosrbr: posts big blind $0.25
*** HOLE CARDS ***
Dealt to chiyuki [8d 7h]
KeLevro0: folds 
Loholov: folds 
Paranoix1990: calls $0.25
chiyuki: folds 
Suhoff76: folds 
Th3Fog: folds 
jtedecaliss: folds 
DooMSDaY1337: folds 
carlosrbr: checks 
*** FLOP *** [Jh Ac 3s]
carlosrbr: checks 
Paranoix1990: checks 
*** TURN *** [Jh Ac 3s] [6d]
carlosrbr: checks 
Paranoix1990: bets $0.50
carlosrbr: folds 
Uncalled bet ($0.50) returned to Paranoix1990
Paranoix1990 collected $0.57 from pot
Paranoix1990: doesn't show hand 
*** SUMMARY ***
Total pot $0.60 | Rake $0.03 
Board [Jh Ac 3s 6d]
Seat 1: jtedecaliss (button) folded before Flop (didn't bet)
Seat 2: DooMSDaY1337 (small blind) folded before Flop
Seat 3: carlosrbr (big blind) folded on the Turn
Seat 4: KeLevro0 folded before Flop (didn't bet)
Seat 5: Loholov folded before Flop (didn't bet)
Seat 6: Paranoix1990 collected ($0.57)
Seat 7: chiyuki folded before Flop (didn't bet)
Seat 8: Suhoff76 folded before Flop (didn't bet)
Seat 9: Th3Fog folded before Flop (didn't bet)



PokerStars Zoom Hand #84298706712:  Hold'em No Limit ($0.10/$0.25) - 2012/08/05 13:30:26 JST [2012/08/05 0:30:26 ET]
Table 'Whirlpool' 9-max Seat #1 is the button
Seat 1: kamikkaze ($47.60 in chips) 
Seat 2: BlOnDhOlIc ($33.28 in chips) 
Seat 3: Jippyflip ($17.15 in chips) 
Seat 4: chiyuki ($43.69 in chips) 
Seat 5: Landybob ($25.43 in chips) 
Seat 6: KeLevro0 ($10.83 in chips) 
Seat 7: ShockLaMuc ($20.04 in chips) 
Seat 8: BlackZafiro ($25 in chips) 
Seat 9: TraderYao ($31.09 in chips) 
BlOnDhOlIc: posts small blind $0.10
Jippyflip: posts big blind $0.25
*** HOLE CARDS ***
Dealt to chiyuki [7c 9c]
chiyuki: folds 
Landybob: folds 
KeLevro0: folds 
ShockLaMuc: folds 
BlackZafiro: folds 
TraderYao: folds 
kamikkaze: raises $0.38 to $0.63
BlOnDhOlIc: folds 
Jippyflip: folds 
Uncalled bet ($0.38) returned to kamikkaze
kamikkaze collected $0.60 from pot
kamikkaze: doesn't show hand 
*** SUMMARY ***
Total pot $0.60 | Rake $0 
Seat 1: kamikkaze (button) collected ($0.60)
Seat 2: BlOnDhOlIc (small blind) folded before Flop
Seat 3: Jippyflip (big blind) folded before Flop
Seat 4: chiyuki folded before Flop (didn't bet)
Seat 5: Landybob folded before Flop (didn't bet)
Seat 6: KeLevro0 folded before Flop (didn't bet)
Seat 7: ShockLaMuc folded before Flop (didn't bet)
Seat 8: BlackZafiro folded before Flop (didn't bet)
Seat 9: TraderYao folded before Flop (didn't bet)



PokerStars Zoom Hand #84298708677:  Hold'em No Limit ($0.10/$0.25) - 2012/08/05 13:30:33 JST [2012/08/05 0:30:33 ET]
Table 'Whirlpool' 9-max Seat #1 is the button
Seat 1: wtu1986 ($26.60 in chips) 
Seat 2: carlosrbr ($12.10 in chips) 
Seat 3: hirozo ($45.80 in chips) 
Seat 4: PetitAlejo ($28.64 in chips) 
Seat 5: Lasutchik ($8.34 in chips) 
Seat 6: polk11 ($15.70 in chips) 
Seat 7: Loholov ($22.20 in chips) 
Seat 8: taksist889 ($24.46 in chips) 
Seat 9: chiyuki ($43.69 in chips) 
carlosrbr: posts small blind $0.10
hirozo: posts big blind $0.25
*** HOLE CARDS ***
Dealt to chiyuki [9c Ts]
PetitAlejo: folds 
Lasutchik: folds 
polk11: calls $0.25
Loholov: folds 
taksist889: folds 
chiyuki: folds 
wtu1986: folds 
carlosrbr: folds 
hirozo: checks 
*** FLOP *** [3s 8c 9h]
hirozo: checks 
polk11: bets $0.50
hirozo: folds 
Uncalled bet ($0.50) returned to polk11
polk11 collected $0.57 from pot
polk11: doesn't show hand 
*** SUMMARY ***
Total pot $0.60 | Rake $0.03 
Board [3s 8c 9h]
Seat 1: wtu1986 (button) folded before Flop (didn't bet)
Seat 2: carlosrbr (small blind) folded before Flop
Seat 3: hirozo (big blind) folded on the Flop
Seat 4: PetitAlejo folded before Flop (didn't bet)
Seat 5: Lasutchik folded before Flop (didn't bet)
Seat 6: polk11 collected ($0.57)
Seat 7: Loholov folded before Flop (didn't bet)
Seat 8: taksist889 folded before Flop (didn't bet)
Seat 9: chiyuki folded before Flop (didn't bet)



PokerStars Zoom Hand #84298710828:  Hold'em No Limit ($0.10/$0.25) - 2012/08/05 13:30:41 JST [2012/08/05 0:30:41 ET]
Table 'Whirlpool' 9-max Seat #1 is the button
Seat 1: masterkoolb ($12.72 in chips) 
Seat 2: TraderYao ($29.34 in chips) 
Seat 3: Paranoix1990 ($25.35 in chips) 
Seat 4: KeLevro0 ($10.83 in chips) 
Seat 5: chiyuki ($43.69 in chips) 
Seat 6: Dejacob ($26.37 in chips) 
Seat 7: RomarioJa ($7.24 in chips) 
Seat 8: PetitAlejo ($34.73 in chips) 
Seat 9: fwani ($34.95 in chips) 
TraderYao: posts small blind $0.10
Paranoix1990: posts big blind $0.25
*** HOLE CARDS ***
Dealt to chiyuki [Jc Ac]
KeLevro0: folds 
chiyuki: raises $0.50 to $0.75
Dejacob: folds 
RomarioJa: folds 
PetitAlejo: folds 
fwani: folds 
masterkoolb: folds 
TraderYao: folds 
Paranoix1990: calls $0.50
*** FLOP *** [5c 4h 6d]
Paranoix1990: checks 
chiyuki: bets $0.76
Paranoix1990: calls $0.76
*** TURN *** [5c 4h 6d] [6h]
Paranoix1990: checks 
chiyuki: checks 
*** RIVER *** [5c 4h 6d 6h] [9s]
Paranoix1990: bets $1.25
chiyuki: folds 
Uncalled bet ($1.25) returned to Paranoix1990
Paranoix1990 collected $2.98 from pot
Paranoix1990: doesn't show hand 
*** SUMMARY ***
Total pot $3.12 | Rake $0.14 
Board [5c 4h 6d 6h 9s]
Seat 1: masterkoolb (button) folded before Flop (didn't bet)
Seat 2: TraderYao (small blind) folded before Flop
Seat 3: Paranoix1990 (big blind) collected ($2.98)
Seat 4: KeLevro0 folded before Flop (didn't bet)
Seat 5: chiyuki folded on the River
Seat 6: Dejacob folded before Flop (didn't bet)
Seat 7: RomarioJa folded before Flop (didn't bet)
Seat 8: PetitAlejo folded before Flop (didn't bet)
Seat 9: fwani folded before Flop (didn't bet)



PokerStars Zoom Hand #84298722358:  Hold'em No Limit ($0.10/$0.25) - 2012/08/05 13:31:24 JST [2012/08/05 0:31:24 ET]
Table 'Whirlpool' 9-max Seat #1 is the button
Seat 1: BlOnDhOlIc ($67.01 in chips) 
Seat 2: chiyuki ($42.18 in chips) 
Seat 3: ygoegoe ($25 in chips) 
Seat 4: DooMSDaY1337 ($51.99 in chips) 
Seat 5: softdesign ($54.01 in chips) 
Seat 6: BlackZafiro ($25.35 in chips) 
Seat 7: Suhoff76 ($28.17 in chips) 
Seat 8: wtu1986 ($24.75 in chips) 
Seat 9: Ellen1947 ($28.05 in chips) 
chiyuki: posts small blind $0.10
ygoegoe: posts big blind $0.25
*** HOLE CARDS ***
Dealt to chiyuki [Qs Qd]
DooMSDaY1337: folds 
softdesign: folds 
BlackZafiro: raises $0.50 to $0.75
Suhoff76: folds 
wtu1986: folds 
Ellen1947: calls $0.75
BlOnDhOlIc: folds 
chiyuki: raises $2.25 to $3
ygoegoe: folds 
BlackZafiro: raises $3.50 to $6.50
Ellen1947: folds 
chiyuki: calls $3.50
*** FLOP *** [Td 2h 3d]
chiyuki: checks 
BlackZafiro: checks 
*** TURN *** [Td 2h 3d] [3c]
chiyuki: checks 
BlackZafiro: checks 
*** RIVER *** [Td 2h 3d 3c] [7d]
chiyuki: bets $6.50
BlackZafiro: calls $6.50
*** SHOW DOWN ***
chiyuki: shows [Qs Qd] (two pair, Queens and Threes)
BlackZafiro: mucks hand 
chiyuki collected $25.78 from pot
*** SUMMARY ***
Total pot $27 | Rake $1.22 
Board [Td 2h 3d 3c 7d]
Seat 1: BlOnDhOlIc (button) folded before Flop (didn't bet)
Seat 2: chiyuki (small blind) showed [Qs Qd] and won ($25.78) with two pair, Queens and Threes
Seat 3: ygoegoe (big blind) folded before Flop
Seat 4: DooMSDaY1337 folded before Flop (didn't bet)
Seat 5: softdesign folded before Flop (didn't bet)
Seat 6: BlackZafiro mucked [Ts 9s]
Seat 7: Suhoff76 folded before Flop (didn't bet)
Seat 8: wtu1986 folded before Flop (didn't bet)
Seat 9: Ellen1947 folded before Flop



PokerStars Zoom Hand #84298756446:  Hold'em No Limit ($0.10/$0.25) - 2012/08/05 13:33:32 JST [2012/08/05 0:33:32 ET]
Table 'Whirlpool' 9-max Seat #1 is the button
Seat 1: deadmoneykid ($25.61 in chips) 
Seat 2: RomarioJa ($7.44 in chips) 
Seat 3: ShockLaMuc ($16.43 in chips) 
Seat 4: KeLevro0 ($11 in chips) 
Seat 5: Th3Fog ($16.42 in chips) 
Seat 6: chiyuki ($54.71 in chips) 
Seat 7: Anafim ($12.50 in chips) 
Seat 8: TraderYao ($27.44 in chips) 
Seat 9: masterkoolb ($13.61 in chips) 
RomarioJa: posts small blind $0.10
ShockLaMuc: posts big blind $0.25
*** HOLE CARDS ***
Dealt to chiyuki [Ac 3h]
KeLevro0: folds 
Th3Fog: folds 
chiyuki: folds 
Anafim: folds 
TraderYao: folds 
masterkoolb: folds 
deadmoneykid: folds 
RomarioJa: folds 
Uncalled bet ($0.15) returned to ShockLaMuc
ShockLaMuc collected $0.20 from pot
ShockLaMuc: doesn't show hand 
*** SUMMARY ***
Total pot $0.20 | Rake $0 
Seat 1: deadmoneykid (button) folded before Flop (didn't bet)
Seat 2: RomarioJa (small blind) folded before Flop
Seat 3: ShockLaMuc (big blind) collected ($0.20)
Seat 4: KeLevro0 folded before Flop (didn't bet)
Seat 5: Th3Fog folded before Flop (didn't bet)
Seat 6: chiyuki folded before Flop (didn't bet)
Seat 7: Anafim folded before Flop (didn't bet)
Seat 8: TraderYao folded before Flop (didn't bet)
Seat 9: masterkoolb folded before Flop (didn't bet)



PokerStars Zoom Hand #84298748733:  Hold'em No Limit ($0.10/$0.25) - 2012/08/05 13:33:03 JST [2012/08/05 0:33:03 ET]
Table 'Whirlpool' 9-max Seat #1 is the button
Seat 1: munky3 ($34.21 in chips) 
Seat 2: Alvinpe85 ($27.64 in chips) 
Seat 3: chiyuki ($54.96 in chips) 
Seat 4: BlackZafiro ($25 in chips) 
Seat 5: fwani ($34 in chips) 
Seat 6: Jippyflip ($19.60 in chips) 
Seat 7: BlOnDhOlIc ($25.49 in chips) 
Seat 8: Lasutchik ($15.01 in chips) 
Seat 9: TraderYao ($27.44 in chips) 
Alvinpe85: posts small blind $0.10
chiyuki: posts big blind $0.25
*** HOLE CARDS ***
Dealt to chiyuki [Jc 2h]
BlackZafiro: folds 
fwani: folds 
Jippyflip: calls $0.25
BlOnDhOlIc: raises $0.75 to $1
Lasutchik: folds 
TraderYao: folds 
munky3: folds 
Alvinpe85: folds 
chiyuki: folds 
Jippyflip: calls $0.75
*** FLOP *** [8s 7c 4c]
Jippyflip: checks 
BlOnDhOlIc: checks 
*** TURN *** [8s 7c 4c] [6c]
Jippyflip: checks 
BlOnDhOlIc: bets $1.25
Jippyflip: folds 
Uncalled bet ($1.25) returned to BlOnDhOlIc
BlOnDhOlIc collected $2.24 from pot
BlOnDhOlIc: doesn't show hand 
*** SUMMARY ***
Total pot $2.35 | Rake $0.11 
Board [8s 7c 4c 6c]
Seat 1: munky3 (button) folded before Flop (didn't bet)
Seat 2: Alvinpe85 (small blind) folded before Flop
Seat 3: chiyuki (big blind) folded before Flop
Seat 4: BlackZafiro folded before Flop (didn't bet)
Seat 5: fwani folded before Flop (didn't bet)
Seat 6: Jippyflip folded on the Turn
Seat 7: BlOnDhOlIc collected ($2.24)
Seat 8: Lasutchik folded before Flop (didn't bet)
Seat 9: TraderYao folded before Flop (didn't bet)



PokerStars Zoom Hand #84298758092:  Hold'em No Limit ($0.10/$0.25) - 2012/08/05 13:33:38 JST [2012/08/05 0:33:38 ET]
Table 'Whirlpool' 9-max Seat #1 is the button
Seat 1: chiyuki ($54.71 in chips) 
Seat 2: jethaz ($80.47 in chips) 
Seat 3: taiali ($13.59 in chips) 
Seat 4: Nerkit ($11.40 in chips) 
Seat 5: DooMSDaY1337 ($60.01 in chips) 
Seat 6: taksist889 ($24.11 in chips) 
Seat 7: PetitAlejo ($36.23 in chips) 
Seat 8: Rsonal ($22.53 in chips) 
Seat 9: BlackZafiro ($25 in chips) 
jethaz: posts small blind $0.10
taiali: posts big blind $0.25
*** HOLE CARDS ***
Dealt to chiyuki [Js Ac]
Nerkit: folds 
DooMSDaY1337: folds 
taksist889: folds 
PetitAlejo: folds 
Rsonal: raises $0.25 to $0.50
BlackZafiro: folds 
chiyuki: raises $1.25 to $1.75
jethaz: folds 
taiali: folds 
Rsonal: calls $1.25
*** FLOP *** [Kc 2h 2c]
Rsonal: bets $2.50
chiyuki: folds 
Uncalled bet ($2.50) returned to Rsonal
Rsonal collected $3.68 from pot
Rsonal: doesn't show hand 
*** SUMMARY ***
Total pot $3.85 | Rake $0.17 
Board [Kc 2h 2c]
Seat 1: chiyuki (button) folded on the Flop
Seat 2: jethaz (small blind) folded before Flop
Seat 3: taiali (big blind) folded before Flop
Seat 4: Nerkit folded before Flop (didn't bet)
Seat 5: DooMSDaY1337 folded before Flop (didn't bet)
Seat 6: taksist889 folded before Flop (didn't bet)
Seat 7: PetitAlejo folded before Flop (didn't bet)
Seat 8: Rsonal collected ($3.68)
Seat 9: BlackZafiro folded before Flop (didn't bet)



PokerStars Zoom Hand #84298769647:  Hold'em No Limit ($0.10/$0.25) - 2012/08/05 13:34:22 JST [2012/08/05 0:34:22 ET]
Table 'Whirlpool' 9-max Seat #1 is the button
Seat 1: BlackZafiro ($25.10 in chips) 
Seat 2: Suhoff76 ($25.10 in chips) 
Seat 3: taksist889 ($24.11 in chips) 
Seat 4: chiyuki ($52.96 in chips) 
Seat 5: KeLevro0 ($12.15 in chips) 
Seat 6: SlimeyGash ($2.56 in chips) 
Seat 7: masterkoolb ($13.26 in chips) 
Seat 8: NastyMcNast ($31.20 in chips) 
Seat 9: Ellen1947 ($26.95 in chips) 
Suhoff76: posts small blind $0.10
taksist889: posts big blind $0.25
*** HOLE CARDS ***
Dealt to chiyuki [As Ts]
chiyuki: folds 
KeLevro0: folds 
SlimeyGash: raises $2.31 to $2.56 and is all-in
masterkoolb: folds 
NastyMcNast: folds 
Ellen1947: folds 
BlackZafiro: folds 
Suhoff76: folds 
taksist889: folds 
Uncalled bet ($2.31) returned to SlimeyGash
SlimeyGash collected $0.60 from pot
SlimeyGash: doesn't show hand 
*** SUMMARY ***
Total pot $0.60 | Rake $0 
Seat 1: BlackZafiro (button) folded before Flop (didn't bet)
Seat 2: Suhoff76 (small blind) folded before Flop
Seat 3: taksist889 (big blind) folded before Flop
Seat 4: chiyuki folded before Flop (didn't bet)
Seat 5: KeLevro0 folded before Flop (didn't bet)
Seat 6: SlimeyGash collected ($0.60)
Seat 7: masterkoolb folded before Flop (didn't bet)
Seat 8: NastyMcNast folded before Flop (didn't bet)
Seat 9: Ellen1947 folded before Flop (didn't bet)



PokerStars Zoom Hand #84298768646:  Hold'em No Limit ($0.10/$0.25) - 2012/08/05 13:34:18 JST [2012/08/05 0:34:18 ET]
Table 'Whirlpool' 9-max Seat #1 is the button
Seat 1: Loholov ($21.75 in chips) 
Seat 2: eduvazsilva ($14.55 in chips) 
Seat 3: vit 111 ($36.41 in chips) 
Seat 4: PetitAlejo ($29.79 in chips) 
Seat 5: Suhoff76 ($25 in chips) 
Seat 6: TraderYao ($27.54 in chips) 
Seat 7: BlOnDhOlIc ($34.06 in chips) 
Seat 8: chiyuki ($52.96 in chips) 
Seat 9: fwani ($25 in chips) 
eduvazsilva: posts small blind $0.10
vit 111: posts big blind $0.25
*** HOLE CARDS ***
Dealt to chiyuki [9d 3c]
PetitAlejo: folds 
Suhoff76: folds 
TraderYao: folds 
BlOnDhOlIc: raises $0.25 to $0.50
chiyuki: folds 
fwani: folds 
Loholov: folds 
eduvazsilva: folds 
vit 111: calls $0.25
*** FLOP *** [Ts 4d Ah]
vit 111: checks 
BlOnDhOlIc: checks 
*** TURN *** [Ts 4d Ah] [Th]
vit 111: checks 
BlOnDhOlIc: bets $0.52
vit 111: folds 
Uncalled bet ($0.52) returned to BlOnDhOlIc
BlOnDhOlIc collected $1.05 from pot
BlOnDhOlIc: doesn't show hand 
*** SUMMARY ***
Total pot $1.10 | Rake $0.05 
Board [Ts 4d Ah Th]
Seat 1: Loholov (button) folded before Flop (didn't bet)
Seat 2: eduvazsilva (small blind) folded before Flop
Seat 3: vit 111 (big blind) folded on the Turn
Seat 4: PetitAlejo folded before Flop (didn't bet)
Seat 5: Suhoff76 folded before Flop (didn't bet)
Seat 6: TraderYao folded before Flop (didn't bet)
Seat 7: BlOnDhOlIc collected ($1.05)
Seat 8: chiyuki folded before Flop (didn't bet)
Seat 9: fwani folded before Flop (didn't bet)



PokerStars Zoom Hand #84298772274:  Hold'em No Limit ($0.10/$0.25) - 2012/08/05 13:34:32 JST [2012/08/05 0:34:32 ET]
Table 'Whirlpool' 9-max Seat #1 is the button
Seat 1: silvno31 ($26.12 in chips) 
Seat 2: BlackZafiro ($25 in chips) 
Seat 3: Dejacob ($25.79 in chips) 
Seat 4: wtu1986 ($24.90 in chips) 
Seat 5: Roglus ($17.88 in chips) 
Seat 6: ll_LaMeR_ll ($40.27 in chips) 
Seat 7: DooMSDaY1337 ($94.20 in chips) 
Seat 8: TraderYao ($26.49 in chips) 
Seat 9: chiyuki ($52.96 in chips) 
BlackZafiro: posts small blind $0.10
Dejacob: posts big blind $0.25
*** HOLE CARDS ***
Dealt to chiyuki [Js Qc]
wtu1986: folds 
Roglus: folds 
ll_LaMeR_ll: folds 
DooMSDaY1337: folds 
TraderYao: raises $0.50 to $0.75
chiyuki: folds 
silvno31: folds 
BlackZafiro: folds 
Dejacob: folds 
Uncalled bet ($0.50) returned to TraderYao
TraderYao collected $0.60 from pot
TraderYao: doesn't show hand 
*** SUMMARY ***
Total pot $0.60 | Rake $0 
Seat 1: silvno31 (button) folded before Flop (didn't bet)
Seat 2: BlackZafiro (small blind) folded before Flop
Seat 3: Dejacob (big blind) folded before Flop
Seat 4: wtu1986 folded before Flop (didn't bet)
Seat 5: Roglus folded before Flop (didn't bet)
Seat 6: ll_LaMeR_ll folded before Flop (didn't bet)
Seat 7: DooMSDaY1337 folded before Flop (didn't bet)
Seat 8: TraderYao collected ($0.60)
Seat 9: chiyuki folded before Flop (didn't bet)



PokerStars Zoom Hand #84298770944:  Hold'em No Limit ($0.10/$0.25) - 2012/08/05 13:34:27 JST [2012/08/05 0:34:27 ET]
Table 'Whirlpool' 9-max Seat #1 is the button
Seat 1: hirozo ($27.50 in chips) 
Seat 2: Loholov ($21.75 in chips) 
Seat 3: goldstone ($26.88 in chips) 
Seat 4: deadmoneykid ($25.76 in chips) 
Seat 5: ll_LaMeR_ll ($40.27 in chips) 
Seat 6: ShockLaMuc ($16.43 in chips) 
Seat 7: chiyuki ($52.96 in chips) 
Seat 8: masterkoolb ($12.50 in chips) 
Seat 9: eduvazsilva ($14.45 in chips) 
Loholov: posts small blind $0.10
goldstone: posts big blind $0.25
*** HOLE CARDS ***
Dealt to chiyuki [Ks 5d]
deadmoneykid: folds 
ll_LaMeR_ll: folds 
ShockLaMuc: folds 
chiyuki: folds 
masterkoolb: folds 
eduvazsilva: folds 
hirozo: raises $0.25 to $0.50
Loholov: folds 
goldstone: calls $0.25
*** FLOP *** [2c 4d 5c]
goldstone: bets $0.49
hirozo: folds 
Uncalled bet ($0.49) returned to goldstone
goldstone collected $1.05 from pot
goldstone: doesn't show hand 
*** SUMMARY ***
Total pot $1.10 | Rake $0.05 
Board [2c 4d 5c]
Seat 1: hirozo (button) folded on the Flop
Seat 2: Loholov (small blind) folded before Flop
Seat 3: goldstone (big blind) collected ($1.05)
Seat 4: deadmoneykid folded before Flop (didn't bet)
Seat 5: ll_LaMeR_ll folded before Flop (didn't bet)
Seat 6: ShockLaMuc folded before Flop (didn't bet)
Seat 7: chiyuki folded before Flop (didn't bet)
Seat 8: masterkoolb folded before Flop (didn't bet)
Seat 9: eduvazsilva folded before Flop (didn't bet)



PokerStars Zoom Hand #84298779985:  Hold'em No Limit ($0.10/$0.25) - 2012/08/05 13:35:02 JST [2012/08/05 0:35:02 ET]
Table 'Whirlpool' 9-max Seat #1 is the button
Seat 1: Alvinpe85 ($26.94 in chips) 
Seat 2: agurio ($25.10 in chips) 
Seat 3: chiyuki ($52.96 in chips) 
Seat 4: Anafim ($14.09 in chips) 
Seat 5: jeff0923 ($24.65 in chips) 
Seat 6: PetitAlejo ($25 in chips) 
Seat 7: seula i ($47.37 in chips) 
Seat 8: TraderYao ($27.44 in chips) 
Seat 9: Ellen1947 ($24.65 in chips) 
agurio: posts small blind $0.10
chiyuki: posts big blind $0.25
*** HOLE CARDS ***
Dealt to chiyuki [4h 6c]
Anafim: folds 
jeff0923: folds 
PetitAlejo: folds 
seula i: folds 
TraderYao: raises $0.50 to $0.75
Ellen1947: raises $1.55 to $2.30
Alvinpe85: folds 
agurio: folds 
chiyuki: folds 
TraderYao: folds 
Uncalled bet ($1.55) returned to Ellen1947
Ellen1947 collected $1.85 from pot
Ellen1947: doesn't show hand 
*** SUMMARY ***
Total pot $1.85 | Rake $0 
Seat 1: Alvinpe85 (button) folded before Flop (didn't bet)
Seat 2: agurio (small blind) folded before Flop
Seat 3: chiyuki (big blind) folded before Flop
Seat 4: Anafim folded before Flop (didn't bet)
Seat 5: jeff0923 folded before Flop (didn't bet)
Seat 6: PetitAlejo folded before Flop (didn't bet)
Seat 7: seula i folded before Flop (didn't bet)
Seat 8: TraderYao folded before Flop
Seat 9: Ellen1947 collected ($1.85)



PokerStars Zoom Hand #84298777873:  Hold'em No Limit ($0.10/$0.25) - 2012/08/05 13:34:53 JST [2012/08/05 0:34:53 ET]
Table 'Whirlpool' 9-max Seat #1 is the button
Seat 1: jethaz ($71.85 in chips) 
Seat 2: DooMSDaY1337 ($94.20 in chips) 
Seat 3: eduvazsilva ($14.45 in chips) 
Seat 4: vit 111 ($35.91 in chips) 
Seat 5: deadmoneykid ($25.76 in chips) 
Seat 6: chiyuki ($52.96 in chips) 
Seat 7: NastyMcNast ($62.77 in chips) 
Seat 8: TraderYao ($30.09 in chips) 
Seat 9: SlimeyGash ($2.91 in chips) 
DooMSDaY1337: posts small blind $0.10
eduvazsilva: posts big blind $0.25
*** HOLE CARDS ***
Dealt to chiyuki [7c Kc]
vit 111: calls $0.25
deadmoneykid: folds 
chiyuki: folds 
NastyMcNast: folds 
TraderYao: folds 
SlimeyGash: folds 
jethaz: folds 
DooMSDaY1337: raises $1 to $1.25
eduvazsilva: folds 
vit 111: calls $1
*** FLOP *** [5c Qh 4s]
DooMSDaY1337: bets $1.31
vit 111: folds 
Uncalled bet ($1.31) returned to DooMSDaY1337
DooMSDaY1337 collected $2.63 from pot
DooMSDaY1337: doesn't show hand 
*** SUMMARY ***
Total pot $2.75 | Rake $0.12 
Board [5c Qh 4s]
Seat 1: jethaz (button) folded before Flop (didn't bet)
Seat 2: DooMSDaY1337 (small blind) collected ($2.63)
Seat 3: eduvazsilva (big blind) folded before Flop
Seat 4: vit 111 folded on the Flop
Seat 5: deadmoneykid folded before Flop (didn't bet)
Seat 6: chiyuki folded before Flop (didn't bet)
Seat 7: NastyMcNast folded before Flop (didn't bet)
Seat 8: TraderYao folded before Flop (didn't bet)
Seat 9: SlimeyGash folded before Flop (didn't bet)



PokerStars Zoom Hand #84298788056:  Hold'em No Limit ($0.10/$0.25) - 2012/08/05 13:35:33 JST [2012/08/05 0:35:33 ET]
Table 'Whirlpool' 9-max Seat #1 is the button
Seat 1: DooMSDaY1337 ($51.34 in chips) 
Seat 2: chiyuki ($52.71 in chips) 
Seat 3: agurio ($25 in chips) 
Seat 4: gedavaca ($44.78 in chips) 
Seat 5: jtedecaliss ($136.65 in chips) 
Seat 6: Nerkit ($11.75 in chips) 
Seat 7: Th3Fog ($24.69 in chips) 
Seat 8: jethaz ($65.12 in chips) 
Seat 9: wtu1986 ($25.53 in chips) 
chiyuki: posts small blind $0.10
agurio: posts big blind $0.25
*** HOLE CARDS ***
Dealt to chiyuki [Qh Ah]
gedavaca: folds 
jtedecaliss: folds 
Nerkit: folds 
Th3Fog: folds 
jethaz: folds 
wtu1986: folds 
DooMSDaY1337: folds 
chiyuki: raises $0.50 to $0.75
agurio: folds 
Uncalled bet ($0.50) returned to chiyuki
chiyuki collected $0.50 from pot
chiyuki: doesn't show hand 
*** SUMMARY ***
Total pot $0.50 | Rake $0 
Seat 1: DooMSDaY1337 (button) folded before Flop (didn't bet)
Seat 2: chiyuki (small blind) collected ($0.50)
Seat 3: agurio (big blind) folded before Flop
Seat 4: gedavaca folded before Flop (didn't bet)
Seat 5: jtedecaliss folded before Flop (didn't bet)
Seat 6: Nerkit folded before Flop (didn't bet)
Seat 7: Th3Fog folded before Flop (didn't bet)
Seat 8: jethaz folded before Flop (didn't bet)
Seat 9: wtu1986 folded before Flop (didn't bet)



PokerStars Zoom Hand #84298793569:  Hold'em No Limit ($0.10/$0.25) - 2012/08/05 13:35:54 JST [2012/08/05 0:35:54 ET]
Table 'Whirlpool' 9-max Seat #1 is the button
Seat 1: chiyuki ($52.96 in chips) 
Seat 2: 5zzzz33 ($22.25 in chips) 
Seat 3: fwani ($25.35 in chips) 
Seat 4: PetitAlejo ($37.36 in chips) 
Seat 5: Loholov ($15 in chips) 
Seat 6: DooMSDaY1337 ($83.01 in chips) 
Seat 7: KeLevro0 ($9.33 in chips) 
Seat 8: Anafim ($14.81 in chips) 
Seat 9: macr11111111 ($12.15 in chips) 
5zzzz33: posts small blind $0.10
fwani: posts big blind $0.25
*** HOLE CARDS ***
Dealt to chiyuki [5h Kc]
PetitAlejo: folds 
Loholov said, "fucckkk donkey site"
Loholov said, "****KK poker stars"
Loholov: folds 
DooMSDaY1337: folds 
KeLevro0: folds 
Anafim: folds 
macr11111111: folds 
chiyuki: folds 
5zzzz33: folds 
Uncalled bet ($0.15) returned to fwani
fwani collected $0.20 from pot
fwani: doesn't show hand 
*** SUMMARY ***
Total pot $0.20 | Rake $0 
Seat 1: chiyuki (button) folded before Flop (didn't bet)
Seat 2: 5zzzz33 (small blind) folded before Flop
Seat 3: fwani (big blind) collected ($0.20)
Seat 4: PetitAlejo folded before Flop (didn't bet)
Seat 5: Loholov folded before Flop (didn't bet)
Seat 6: DooMSDaY1337 folded before Flop (didn't bet)
Seat 7: KeLevro0 folded before Flop (didn't bet)
Seat 8: Anafim folded before Flop (didn't bet)
Seat 9: macr11111111 folded before Flop (didn't bet)



PokerStars Zoom Hand #84298795882:  Hold'em No Limit ($0.10/$0.25) - 2012/08/05 13:36:03 JST [2012/08/05 0:36:03 ET]
Table 'Whirlpool' 9-max Seat #1 is the button
Seat 1: Roglus ($40.47 in chips) 
Seat 2: Nerkit ($11.75 in chips) 
Seat 3: timburonps ($25 in chips) 
Seat 4: eduvazsilva ($14.10 in chips) 
Seat 5: silvno31 ($27.70 in chips) 
Seat 6: Ellen1947 ($25.75 in chips) 
Seat 7: Rsonal ($25.74 in chips) 
Seat 8: chiyuki ($52.96 in chips) 
Seat 9: PetitAlejo ($26.04 in chips) 
Nerkit: posts small blind $0.10
timburonps: posts big blind $0.25
*** HOLE CARDS ***
Dealt to chiyuki [Tc 3s]
eduvazsilva: folds 
silvno31: folds 
Ellen1947: folds 
Rsonal: calls $0.25
chiyuki: folds 
PetitAlejo: folds 
Roglus: folds 
Nerkit: folds 
timburonps: checks 
*** FLOP *** [Qd 9s Js]
timburonps: checks 
Rsonal: bets $0.75
timburonps: folds 
Uncalled bet ($0.75) returned to Rsonal
Rsonal collected $0.57 from pot
Rsonal: doesn't show hand 
*** SUMMARY ***
Total pot $0.60 | Rake $0.03 
Board [Qd 9s Js]
Seat 1: Roglus (button) folded before Flop (didn't bet)
Seat 2: Nerkit (small blind) folded before Flop
Seat 3: timburonps (big blind) folded on the Flop
Seat 4: eduvazsilva folded before Flop (didn't bet)
Seat 5: silvno31 folded before Flop (didn't bet)
Seat 6: Ellen1947 folded before Flop (didn't bet)
Seat 7: Rsonal collected ($0.57)
Seat 8: chiyuki folded before Flop (didn't bet)
Seat 9: PetitAlejo folded before Flop (didn't bet)



PokerStars Zoom Hand #84298797195:  Hold'em No Limit ($0.10/$0.25) - 2012/08/05 13:36:09 JST [2012/08/05 0:36:09 ET]
Table 'Whirlpool' 9-max Seat #1 is the button
Seat 1: hirozo ($27.54 in chips) 
Seat 2: Suhoff76 ($25 in chips) 
Seat 3: deadmoneykid ($25.76 in chips) 
Seat 4: Ellen1947 ($25.75 in chips) 
Seat 5: chiyuki ($52.96 in chips) 
Seat 6: BlackZafiro ($26.20 in chips) 
Seat 7: PetitAlejo ($26.04 in chips) 
Seat 8: stankfist420 ($9.59 in chips) 
Seat 9: goldstone ($37.77 in chips) 
Suhoff76: posts small blind $0.10
deadmoneykid: posts big blind $0.25
*** HOLE CARDS ***
Dealt to chiyuki [9h Jh]
Ellen1947: folds 
chiyuki: folds 
BlackZafiro: folds 
PetitAlejo: raises $0.50 to $0.75
stankfist420: folds 
goldstone: folds 
hirozo: folds 
Suhoff76: calls $0.65
deadmoneykid: folds 
*** FLOP *** [5c 2c Ad]
Suhoff76: checks 
PetitAlejo: bets $1.25
Suhoff76: folds 
Uncalled bet ($1.25) returned to PetitAlejo
PetitAlejo collected $1.67 from pot
PetitAlejo: doesn't show hand 
*** SUMMARY ***
Total pot $1.75 | Rake $0.08 
Board [5c 2c Ad]
Seat 1: hirozo (button) folded before Flop (didn't bet)
Seat 2: Suhoff76 (small blind) folded on the Flop
Seat 3: deadmoneykid (big blind) folded before Flop
Seat 4: Ellen1947 folded before Flop (didn't bet)
Seat 5: chiyuki folded before Flop (didn't bet)
Seat 6: BlackZafiro folded before Flop (didn't bet)
Seat 7: PetitAlejo collected ($1.67)
Seat 8: stankfist420 folded before Flop (didn't bet)
Seat 9: goldstone folded before Flop (didn't bet)



PokerStars Zoom Hand #84298798238:  Hold'em No Limit ($0.10/$0.25) - 2012/08/05 13:36:13 JST [2012/08/05 0:36:13 ET]
Table 'Whirlpool' 9-max Seat #1 is the button
Seat 1: timburonps ($25.10 in chips) 
Seat 2: ygoegoe ($26.60 in chips) 
Seat 3: seula i ($34.43 in chips) 
Seat 4: NastyMcNast ($31.30 in chips) 
Seat 5: DooMSDaY1337 ($83.01 in chips) 
Seat 6: Landybob ($31.99 in chips) 
Seat 7: chiyuki ($52.96 in chips) 
Seat 8: Dejacob ($25.68 in chips) 
Seat 9: Loholov ($15 in chips) 
ygoegoe: posts small blind $0.10
seula i: posts big blind $0.25
*** HOLE CARDS ***
Dealt to chiyuki [6d 6h]
NastyMcNast: folds 
DooMSDaY1337: raises $0.50 to $0.75
Landybob: folds 
chiyuki: folds 
Dejacob: calls $0.75
Loholov: folds 
timburonps: folds 
ygoegoe: folds 
seula i: folds 
*** FLOP *** [4s 8h 7h]
DooMSDaY1337: checks 
Dejacob: bets $1.25
DooMSDaY1337: folds 
Uncalled bet ($1.25) returned to Dejacob
Dejacob collected $1.77 from pot
Dejacob: doesn't show hand 
*** SUMMARY ***
Total pot $1.85 | Rake $0.08 
Board [4s 8h 7h]
Seat 1: timburonps (button) folded before Flop (didn't bet)
Seat 2: ygoegoe (small blind) folded before Flop
Seat 3: seula i (big blind) folded before Flop
Seat 4: NastyMcNast folded before Flop (didn't bet)
Seat 5: DooMSDaY1337 folded on the Flop
Seat 6: Landybob folded before Flop (didn't bet)
Seat 7: chiyuki folded before Flop (didn't bet)
Seat 8: Dejacob collected ($1.77)
Seat 9: Loholov folded before Flop (didn't bet)



PokerStars Zoom Hand #84298803884:  Hold'em No Limit ($0.10/$0.25) - 2012/08/05 13:36:34 JST [2012/08/05 0:36:34 ET]
Table 'Whirlpool' 9-max Seat #1 is the button
Seat 1: ygoegoe ($27.12 in chips) 
Seat 2: chiyuki ($52.96 in chips) 
Seat 3: hirozo ($35.99 in chips) 
Seat 4: TraderYao ($26.79 in chips) 
Seat 5: 5zzzz33 ($21.40 in chips) 
Seat 6: Th3Fog ($55 in chips) 
Seat 7: BlOnDhOlIc ($35.73 in chips) 
Seat 8: Paranoix1990 ($21.62 in chips) 
Seat 9: jeff0923 ($26.12 in chips) 
chiyuki: posts small blind $0.10
hirozo: posts big blind $0.25
*** HOLE CARDS ***
Dealt to chiyuki [7d 2h]
TraderYao: folds 
5zzzz33: raises $0.45 to $0.70
Th3Fog: folds 
BlOnDhOlIc: folds 
Paranoix1990: folds 
jeff0923: folds 
ygoegoe: folds 
chiyuki: folds 
hirozo: folds 
Uncalled bet ($0.45) returned to 5zzzz33
5zzzz33 collected $0.60 from pot
5zzzz33: doesn't show hand 
*** SUMMARY ***
Total pot $0.60 | Rake $0 
Seat 1: ygoegoe (button) folded before Flop (didn't bet)
Seat 2: chiyuki (small blind) folded before Flop
Seat 3: hirozo (big blind) folded before Flop
Seat 4: TraderYao folded before Flop (didn't bet)
Seat 5: 5zzzz33 collected ($0.60)
Seat 6: Th3Fog folded before Flop (didn't bet)
Seat 7: BlOnDhOlIc folded before Flop (didn't bet)
Seat 8: Paranoix1990 folded before Flop (didn't bet)
Seat 9: jeff0923 folded before Flop (didn't bet)



PokerStars Zoom Hand #84298800880:  Hold'em No Limit ($0.10/$0.25) - 2012/08/05 13:36:23 JST [2012/08/05 0:36:23 ET]
Table 'Whirlpool' 9-max Seat #1 is the button
Seat 1: seula i ($61.59 in chips) 
Seat 2: Th3Fog ($24.44 in chips) 
Seat 3: Alvinpe85 ($53.68 in chips) 
Seat 4: chiyuki ($52.96 in chips) 
Seat 5: jethaz ($64.87 in chips) 
Seat 6: hirozo ($27.54 in chips) 
Seat 7: Lasutchik ($11.30 in chips) 
Seat 8: ll_LaMeR_ll ($33.27 in chips) 
Seat 9: wtu1986 ($24.90 in chips) 
Th3Fog: posts small blind $0.10
Alvinpe85: posts big blind $0.25
*** HOLE CARDS ***
Dealt to chiyuki [2s As]
chiyuki: folds 
jethaz: folds 
hirozo: folds 
Lasutchik: folds 
ll_LaMeR_ll: folds 
wtu1986: folds 
seula i: raises $0.50 to $0.75
Th3Fog: calls $0.65
Alvinpe85: folds 
*** FLOP *** [6s Qh Ah]
Th3Fog: checks 
seula i: checks 
*** TURN *** [6s Qh Ah] [Jd]
Th3Fog: bets $0.98
seula i: folds 
Uncalled bet ($0.98) returned to Th3Fog
Th3Fog collected $1.67 from pot
Th3Fog: doesn't show hand 
*** SUMMARY ***
Total pot $1.75 | Rake $0.08 
Board [6s Qh Ah Jd]
Seat 1: seula i (button) folded on the Turn
Seat 2: Th3Fog (small blind) collected ($1.67)
Seat 3: Alvinpe85 (big blind) folded before Flop
Seat 4: chiyuki folded before Flop (didn't bet)
Seat 5: jethaz folded before Flop (didn't bet)
Seat 6: hirozo folded before Flop (didn't bet)
Seat 7: Lasutchik folded before Flop (didn't bet)
Seat 8: ll_LaMeR_ll folded before Flop (didn't bet)
Seat 9: wtu1986 folded before Flop (didn't bet)



PokerStars Zoom Hand #84298807918:  Hold'em No Limit ($0.10/$0.25) - 2012/08/05 13:36:49 JST [2012/08/05 0:36:49 ET]
Table 'Whirlpool' 9-max Seat #1 is the button
Seat 1: BlOnDhOlIc ($27.17 in chips) 
Seat 2: Roglus ($40.72 in chips) 
Seat 3: BlackValaR ($12.50 in chips) 
Seat 4: leo2095 ($13.72 in chips) 
Seat 5: TErr18 ($32.85 in chips) 
Seat 6: PetitAlejo ($25 in chips) 
Seat 7: jeff0923 ($26.12 in chips) 
Seat 8: Dejacob ($25 in chips) 
Seat 9: chiyuki ($52.86 in chips) 
Roglus: posts small blind $0.10
BlackValaR: posts big blind $0.25
*** HOLE CARDS ***
Dealt to chiyuki [Kh 3d]
leo2095: folds 
TErr18: folds 
PetitAlejo: folds 
jeff0923: folds 
Dejacob: folds 
chiyuki: folds 
BlOnDhOlIc: folds 
Roglus: folds 
Uncalled bet ($0.15) returned to BlackValaR
BlackValaR collected $0.20 from pot
BlackValaR: doesn't show hand 
*** SUMMARY ***
Total pot $0.20 | Rake $0 
Seat 1: BlOnDhOlIc (button) folded before Flop (didn't bet)
Seat 2: Roglus (small blind) folded before Flop
Seat 3: BlackValaR (big blind) collected ($0.20)
Seat 4: leo2095 folded before Flop (didn't bet)
Seat 5: TErr18 folded before Flop (didn't bet)
Seat 6: PetitAlejo folded before Flop (didn't bet)
Seat 7: jeff0923 folded before Flop (didn't bet)
Seat 8: Dejacob folded before Flop (didn't bet)
Seat 9: chiyuki folded before Flop (didn't bet)



PokerStars Zoom Hand #84298802775:  Hold'em No Limit ($0.10/$0.25) - 2012/08/05 13:36:30 JST [2012/08/05 0:36:30 ET]
Table 'Whirlpool' 9-max Seat #1 is the button
Seat 1: eduvazsilva ($13.75 in chips) 
Seat 2: timburonps ($25 in chips) 
Seat 3: Lasutchik ($31.68 in chips) 
Seat 4: wtu1986 ($25 in chips) 
Seat 5: chiyuki ($52.96 in chips) 
Seat 6: agurio ($30.05 in chips) 
Seat 7: jethaz ($67 in chips) 
Seat 8: Suhoff76 ($25 in chips) 
Seat 9: fwani ($25.45 in chips) 
timburonps: posts small blind $0.10
Lasutchik: posts big blind $0.25
*** HOLE CARDS ***
Dealt to chiyuki [8h Qh]
wtu1986: folds 
chiyuki: folds 
agurio: folds 
jethaz: folds 
Suhoff76: folds 
fwani: raises $0.35 to $0.60
eduvazsilva: folds 
timburonps: raises $1.15 to $1.75
Lasutchik: folds 
fwani: folds 
Uncalled bet ($1.15) returned to timburonps
timburonps collected $1.45 from pot
timburonps: doesn't show hand 
*** SUMMARY ***
Total pot $1.45 | Rake $0 
Seat 1: eduvazsilva (button) folded before Flop (didn't bet)
Seat 2: timburonps (small blind) collected ($1.45)
Seat 3: Lasutchik (big blind) folded before Flop
Seat 4: wtu1986 folded before Flop (didn't bet)
Seat 5: chiyuki folded before Flop (didn't bet)
Seat 6: agurio folded before Flop (didn't bet)
Seat 7: jethaz folded before Flop (didn't bet)
Seat 8: Suhoff76 folded before Flop (didn't bet)
Seat 9: fwani folded before Flop



PokerStars Zoom Hand #84298809008:  Hold'em No Limit ($0.10/$0.25) - 2012/08/05 13:36:53 JST [2012/08/05 0:36:53 ET]
Table 'Whirlpool' 9-max Seat #1 is the button
Seat 1: chiyuki ($52.86 in chips) 
Seat 2: macr11111111 ($11.65 in chips) 
Seat 3: isti2 ($19.20 in chips) 
Seat 4: Anafim ($14.46 in chips) 
Seat 5: ShockLaMuc ($14.67 in chips) 
Seat 6: Jippyflip ($16.80 in chips) 
Seat 7: TErr18 ($32.85 in chips) 
Seat 8: kamikkaze ($55.32 in chips) 
Seat 9: wtu1986 ($25.35 in chips) 
macr11111111: posts small blind $0.10
isti2: posts big blind $0.25
*** HOLE CARDS ***
Dealt to chiyuki [5d Ah]
Anafim: folds 
ShockLaMuc: folds 
Jippyflip: folds 
TErr18: raises $0.50 to $0.75
kamikkaze: folds 
wtu1986: folds 
chiyuki: folds 
macr11111111: calls $0.65
isti2: calls $0.50
*** FLOP *** [5c Qs 3c]
macr11111111: checks 
isti2: checks 
TErr18: checks 
*** TURN *** [5c Qs 3c] [9d]
macr11111111: bets $0.50
isti2: calls $0.50
TErr18: calls $0.50
*** RIVER *** [5c Qs 3c 9d] [2d]
macr11111111: bets $0.50
isti2: folds 
TErr18: folds 
Uncalled bet ($0.50) returned to macr11111111
macr11111111 collected $3.58 from pot
macr11111111: doesn't show hand 
*** SUMMARY ***
Total pot $3.75 | Rake $0.17 
Board [5c Qs 3c 9d 2d]
Seat 1: chiyuki (button) folded before Flop (didn't bet)
Seat 2: macr11111111 (small blind) collected ($3.58)
Seat 3: isti2 (big blind) folded on the River
Seat 4: Anafim folded before Flop (didn't bet)
Seat 5: ShockLaMuc folded before Flop (didn't bet)
Seat 6: Jippyflip folded before Flop (didn't bet)
Seat 7: TErr18 folded on the River
Seat 8: kamikkaze folded before Flop (didn't bet)
Seat 9: wtu1986 folded before Flop (didn't bet)



PokerStars Zoom Hand #84298812804:  Hold'em No Limit ($0.10/$0.25) - 2012/08/05 13:37:07 JST [2012/08/05 0:37:07 ET]
Table 'Whirlpool' 9-max Seat #1 is the button
Seat 1: Loholov ($15.10 in chips) 
Seat 2: BlackValaR ($12.60 in chips) 
Seat 3: Tom1999 ($15 in chips) 
Seat 4: Th3Fog ($54.75 in chips) 
Seat 5: TraderYao ($28.47 in chips) 
Seat 6: BlOnDhOlIc ($66.23 in chips) 
Seat 7: chiyuki ($52.86 in chips) 
Seat 8: Suhoff76 ($25 in chips) 
Seat 9: taksist889 ($24.73 in chips) 
BlackValaR: posts small blind $0.10
Tom1999: posts big blind $0.25
*** HOLE CARDS ***
Dealt to chiyuki [Jc Kh]
Th3Fog: folds 
TraderYao: folds 
BlOnDhOlIc: folds 
chiyuki: folds 
Suhoff76: folds 
taksist889: folds 
Loholov: raises $0.50 to $0.75
BlackValaR: folds 
Tom1999: raises $1 to $1.75
Loholov: calls $1
*** FLOP *** [9c 8c 7d]
Tom1999: bets $1.25
Loholov: calls $1.25
*** TURN *** [9c 8c 7d] [7h]
Tom1999: bets $1.75
Loholov: folds 
Uncalled bet ($1.75) returned to Tom1999
Tom1999 collected $5.83 from pot
Tom1999: doesn't show hand 
*** SUMMARY ***
Total pot $6.10 | Rake $0.27 
Board [9c 8c 7d 7h]
Seat 1: Loholov (button) folded on the Turn
Seat 2: BlackValaR (small blind) folded before Flop
Seat 3: Tom1999 (big blind) collected ($5.83)
Seat 4: Th3Fog folded before Flop (didn't bet)
Seat 5: TraderYao folded before Flop (didn't bet)
Seat 6: BlOnDhOlIc folded before Flop (didn't bet)
Seat 7: chiyuki folded before Flop (didn't bet)
Seat 8: Suhoff76 folded before Flop (didn't bet)
Seat 9: taksist889 folded before Flop (didn't bet)



PokerStars Zoom Hand #84298815228:  Hold'em No Limit ($0.10/$0.25) - 2012/08/05 13:37:16 JST [2012/08/05 0:37:16 ET]
Table 'Whirlpool' 9-max Seat #1 is the button
Seat 1: fwani ($30.19 in chips) 
Seat 2: TraderYao ($25 in chips) 
Seat 3: chiyuki ($52.86 in chips) 
Seat 4: petersmiths ($26.26 in chips) 
Seat 5: agurio ($25.43 in chips) 
Seat 6: jethaz ($38.85 in chips) 
Seat 7: Suhoff76 ($25 in chips) 
Seat 8: BlOnDhOlIc ($66.23 in chips) 
Seat 9: KeLevro0 ($7.70 in chips) 
TraderYao: posts small blind $0.10
chiyuki: posts big blind $0.25
*** HOLE CARDS ***
Dealt to chiyuki [Kd 9h]
petersmiths: raises $0.25 to $0.50
agurio: folds 
jethaz: folds 
Suhoff76: folds 
BlOnDhOlIc: calls $0.50
KeLevro0: folds 
fwani: folds 
TraderYao: folds 
chiyuki: calls $0.25
*** FLOP *** [Qc Js 8h]
chiyuki: checks 
petersmiths: bets $0.61
BlOnDhOlIc: raises $1.64 to $2.25
chiyuki: folds 
petersmiths: folds 
Uncalled bet ($1.64) returned to BlOnDhOlIc
BlOnDhOlIc collected $2.69 from pot
BlOnDhOlIc: doesn't show hand 
*** SUMMARY ***
Total pot $2.82 | Rake $0.13 
Board [Qc Js 8h]
Seat 1: fwani (button) folded before Flop (didn't bet)
Seat 2: TraderYao (small blind) folded before Flop
Seat 3: chiyuki (big blind) folded on the Flop
Seat 4: petersmiths folded on the Flop
Seat 5: agurio folded before Flop (didn't bet)
Seat 6: jethaz folded before Flop (didn't bet)
Seat 7: Suhoff76 folded before Flop (didn't bet)
Seat 8: BlOnDhOlIc collected ($2.69)
Seat 9: KeLevro0 folded before Flop (didn't bet)



PokerStars Zoom Hand #84298823778:  Hold'em No Limit ($0.10/$0.25) - 2012/08/05 13:37:49 JST [2012/08/05 0:37:49 ET]
Table 'Whirlpool' 9-max Seat #1 is the button
Seat 1: seula i ($33.33 in chips) 
Seat 2: Tom1999 ($17.83 in chips) 
Seat 3: ShockLaMuc ($44.02 in chips) 
Seat 4: fwani ($25 in chips) 
Seat 5: Pkdave ($41.35 in chips) 
Seat 6: chiyuki ($52.36 in chips) 
Seat 7: BlOnDhOlIc ($35.48 in chips) 
Seat 8: Lasutchik ($31.33 in chips) 
Seat 9: TraderYao ($28.26 in chips) 
Tom1999: posts small blind $0.10
ShockLaMuc: posts big blind $0.25
*** HOLE CARDS ***
Dealt to chiyuki [Th 6c]
fwani: folds 
Pkdave: folds 
chiyuki: folds 
BlOnDhOlIc: raises $0.37 to $0.62
Lasutchik: folds 
TraderYao: folds 
seula i: folds 
Tom1999: folds 
ShockLaMuc: folds 
Uncalled bet ($0.37) returned to BlOnDhOlIc
BlOnDhOlIc collected $0.60 from pot
BlOnDhOlIc: doesn't show hand 
*** SUMMARY ***
Total pot $0.60 | Rake $0 
Seat 1: seula i (button) folded before Flop (didn't bet)
Seat 2: Tom1999 (small blind) folded before Flop
Seat 3: ShockLaMuc (big blind) folded before Flop
Seat 4: fwani folded before Flop (didn't bet)
Seat 5: Pkdave folded before Flop (didn't bet)
Seat 6: chiyuki folded before Flop (didn't bet)
Seat 7: BlOnDhOlIc collected ($0.60)
Seat 8: Lasutchik folded before Flop (didn't bet)
Seat 9: TraderYao folded before Flop (didn't bet)



PokerStars Zoom Hand #84298825506:  Hold'em No Limit ($0.10/$0.25) - 2012/08/05 13:37:56 JST [2012/08/05 0:37:56 ET]
Table 'Whirlpool' 9-max Seat #1 is the button
Seat 1: isti2 ($17.85 in chips) 
Seat 2: Loholov ($15 in chips) 
Seat 3: hirozo ($25 in chips) 
Seat 4: 4ydo yogurt ($8.23 in chips) 
Seat 5: Alvinpe85 ($53.33 in chips) 
Seat 6: timburonps ($25 in chips) 
Seat 7: silvno31 ($28.99 in chips) 
Seat 8: chiyuki ($52.36 in chips) 
Seat 9: PetitAlejo ($37.14 in chips) 
Loholov: posts small blind $0.10
hirozo: posts big blind $0.25
*** HOLE CARDS ***
Dealt to chiyuki [7s 8d]
4ydo yogurt: raises $0.50 to $0.75
Alvinpe85: folds 
timburonps: folds 
silvno31: folds 
chiyuki: folds 
PetitAlejo: folds 
isti2: folds 
Loholov: folds 
hirozo: folds 
Uncalled bet ($0.50) returned to 4ydo yogurt
4ydo yogurt collected $0.60 from pot
4ydo yogurt: doesn't show hand 
*** SUMMARY ***
Total pot $0.60 | Rake $0 
Seat 1: isti2 (button) folded before Flop (didn't bet)
Seat 2: Loholov (small blind) folded before Flop
Seat 3: hirozo (big blind) folded before Flop
Seat 4: 4ydo yogurt collected ($0.60)
Seat 5: Alvinpe85 folded before Flop (didn't bet)
Seat 6: timburonps folded before Flop (didn't bet)
Seat 7: silvno31 folded before Flop (didn't bet)
Seat 8: chiyuki folded before Flop (didn't bet)
Seat 9: PetitAlejo folded before Flop (didn't bet)



PokerStars Zoom Hand #84298826788:  Hold'em No Limit ($0.10/$0.25) - 2012/08/05 13:38:01 JST [2012/08/05 0:38:01 ET]
Table 'Whirlpool' 9-max Seat #1 is the button
Seat 1: silvno31 ($28.99 in chips) 
Seat 2: fwani ($25 in chips) 
Seat 3: seula i ($52.59 in chips) 
Seat 4: Alvinpe85 ($53.33 in chips) 
Seat 5: deadmoneykid ($20.92 in chips) 
Seat 6: gedavaca ($44.36 in chips) 
Seat 7: TraderYao ($25.05 in chips) 
Seat 8: Loholov ($15 in chips) 
Seat 9: chiyuki ($52.36 in chips) 
fwani: posts small blind $0.10
seula i: posts big blind $0.25
*** HOLE CARDS ***
Dealt to chiyuki [4c 9c]
Alvinpe85: folds 
deadmoneykid: folds 
gedavaca: calls $0.25
TraderYao: folds 
Loholov: folds 
chiyuki: folds 
silvno31: raises $1 to $1.25
fwani: folds 
seula i: folds 
gedavaca: folds 
Uncalled bet ($1) returned to silvno31
silvno31 collected $0.85 from pot
silvno31: doesn't show hand 
*** SUMMARY ***
Total pot $0.85 | Rake $0 
Seat 1: silvno31 (button) collected ($0.85)
Seat 2: fwani (small blind) folded before Flop
Seat 3: seula i (big blind) folded before Flop
Seat 4: Alvinpe85 folded before Flop (didn't bet)
Seat 5: deadmoneykid folded before Flop (didn't bet)
Seat 6: gedavaca folded before Flop
Seat 7: TraderYao folded before Flop (didn't bet)
Seat 8: Loholov folded before Flop (didn't bet)
Seat 9: chiyuki folded before Flop (didn't bet)



PokerStars Zoom Hand #84298828819:  Hold'em No Limit ($0.10/$0.25) - 2012/08/05 13:38:09 JST [2012/08/05 0:38:09 ET]
Table 'Whirlpool' 9-max Seat #1 is the button
Seat 1: Anafim ($15 in chips) 
Seat 2: ll_LaMeR_ll ($36.39 in chips) 
Seat 3: jethaz ($62.25 in chips) 
Seat 4: chiyuki ($52.36 in chips) 
Seat 5: TraderYao ($25.05 in chips) 
Seat 6: DooMSDaY1337 ($99.83 in chips) 
Seat 7: timburonps ($25 in chips) 
Seat 8: PetitAlejo ($26.84 in chips) 
Seat 9: fwani ($25 in chips) 
ll_LaMeR_ll: posts small blind $0.10
jethaz: posts big blind $0.25
*** HOLE CARDS ***
Dealt to chiyuki [7d Ad]
chiyuki: folds 
TraderYao: folds 
DooMSDaY1337: folds 
timburonps: folds 
PetitAlejo: folds 
fwani: raises $0.35 to $0.60
Anafim: folds 
ll_LaMeR_ll: folds 
jethaz: raises $1.40 to $2
fwani: folds 
Uncalled bet ($1.40) returned to jethaz
jethaz collected $1.30 from pot
jethaz: doesn't show hand 
*** SUMMARY ***
Total pot $1.30 | Rake $0 
Seat 1: Anafim (button) folded before Flop (didn't bet)
Seat 2: ll_LaMeR_ll (small blind) folded before Flop
Seat 3: jethaz (big blind) collected ($1.30)
Seat 4: chiyuki folded before Flop (didn't bet)
Seat 5: TraderYao folded before Flop (didn't bet)
Seat 6: DooMSDaY1337 folded before Flop (didn't bet)
Seat 7: timburonps folded before Flop (didn't bet)
Seat 8: PetitAlejo folded before Flop (didn't bet)
Seat 9: fwani folded before Flop



PokerStars Zoom Hand #84298829940:  Hold'em No Limit ($0.10/$0.25) - 2012/08/05 13:38:13 JST [2012/08/05 0:38:13 ET]
Table 'Whirlpool' 9-max Seat #1 is the button
Seat 1: seula i ($25 in chips) 
Seat 2: chiyuki ($52.36 in chips) 
Seat 3: BlackZafiro ($28.56 in chips) 
Seat 4: taksist889 ($27.83 in chips) 
Seat 5: cR!Ma*aRm ($32.10 in chips) 
Seat 6: TraderYao ($28.57 in chips) 
Seat 7: leo2095 ($13.72 in chips) 
Seat 8: DooMSDaY1337 ($49.39 in chips) 
Seat 9: Suhoff76 ($25 in chips) 
chiyuki: posts small blind $0.10
BlackZafiro: posts big blind $0.25
*** HOLE CARDS ***
Dealt to chiyuki [4s 4h]
taksist889: folds 
cR!Ma*aRm: folds 
TraderYao: folds 
leo2095: folds 
DooMSDaY1337: folds 
Suhoff76: folds 
seula i: raises $0.50 to $0.75
chiyuki: folds 
BlackZafiro: folds 
Uncalled bet ($0.50) returned to seula i
seula i collected $0.60 from pot
seula i: doesn't show hand 
*** SUMMARY ***
Total pot $0.60 | Rake $0 
Seat 1: seula i (button) collected ($0.60)
Seat 2: chiyuki (small blind) folded before Flop
Seat 3: BlackZafiro (big blind) folded before Flop
Seat 4: taksist889 folded before Flop (didn't bet)
Seat 5: cR!Ma*aRm folded before Flop (didn't bet)
Seat 6: TraderYao folded before Flop (didn't bet)
Seat 7: leo2095 folded before Flop (didn't bet)
Seat 8: DooMSDaY1337 folded before Flop (didn't bet)
Seat 9: Suhoff76 folded before Flop (didn't bet)



PokerStars Zoom Hand #84298834773:  Hold'em No Limit ($0.10/$0.25) - 2012/08/05 13:38:33 JST [2012/08/05 0:38:33 ET]
Table 'Whirlpool' 9-max Seat #1 is the button
Seat 1: NastyMcNast ($33.15 in chips) 
Seat 2: jethaz ($62.95 in chips) 
Seat 3: chiyuki ($52.26 in chips) 
Seat 4: Loholov ($15 in chips) 
Seat 5: Suhoff76 ($25 in chips) 
Seat 6: seula i ($33.33 in chips) 
Seat 7: BlackZafiro ($28.96 in chips) 
Seat 8: agurio ($25.53 in chips) 
Seat 9: fwani ($25 in chips) 
jethaz: posts small blind $0.10
chiyuki: posts big blind $0.25
*** HOLE CARDS ***
Dealt to chiyuki [5d 3d]
Loholov: folds 
Suhoff76: folds 
seula i: folds 
BlackZafiro: folds 
agurio: folds 
fwani: folds 
NastyMcNast: folds 
jethaz: folds 
Uncalled bet ($0.15) returned to chiyuki
chiyuki collected $0.20 from pot
chiyuki: doesn't show hand 
*** SUMMARY ***
Total pot $0.20 | Rake $0 
Seat 1: NastyMcNast (button) folded before Flop (didn't bet)
Seat 2: jethaz (small blind) folded before Flop
Seat 3: chiyuki (big blind) collected ($0.20)
Seat 4: Loholov folded before Flop (didn't bet)
Seat 5: Suhoff76 folded before Flop (didn't bet)
Seat 6: seula i folded before Flop (didn't bet)
Seat 7: BlackZafiro folded before Flop (didn't bet)
Seat 8: agurio folded before Flop (didn't bet)
Seat 9: fwani folded before Flop (didn't bet)



PokerStars Zoom Hand #84298824485:  Hold'em No Limit ($0.10/$0.25) - 2012/08/05 13:37:52 JST [2012/08/05 0:37:52 ET]
Table 'Whirlpool' 9-max Seat #1 is the button
Seat 1: Tom1999 ($17.73 in chips) 
Seat 2: Suhoff76 ($25 in chips) 
Seat 3: NastyMcNast ($36.40 in chips) 
Seat 4: Th3Fog ($65.53 in chips) 
Seat 5: chiyuki ($52.36 in chips) 
Seat 6: 4ydo yogurt ($8.23 in chips) 
Seat 7: DooMSDaY1337 ($49.49 in chips) 
Seat 8: Ellen1947 ($35.31 in chips) 
Seat 9: cR!Ma*aRm ($32.10 in chips) 
Suhoff76: posts small blind $0.10
NastyMcNast: posts big blind $0.25
*** HOLE CARDS ***
Dealt to chiyuki [2s 8h]
Th3Fog: raises $0.47 to $0.72
chiyuki: folds 
4ydo yogurt: folds 
DooMSDaY1337: folds 
Ellen1947: calls $0.72
cR!Ma*aRm: folds 
Tom1999: folds 
Suhoff76: folds 
NastyMcNast: folds 
*** FLOP *** [Ts 9h 3c]
Th3Fog: checks 
Ellen1947: bets $0.80
Th3Fog: calls $0.80
*** TURN *** [Ts 9h 3c] [5s]
Th3Fog: checks 
Ellen1947: checks 
*** RIVER *** [Ts 9h 3c 5s] [Qd]
Th3Fog: bets $1.42
Ellen1947: folds 
Uncalled bet ($1.42) returned to Th3Fog
Th3Fog collected $3.24 from pot
Th3Fog: doesn't show hand 
*** SUMMARY ***
Total pot $3.39 | Rake $0.15 
Board [Ts 9h 3c 5s Qd]
Seat 1: Tom1999 (button) folded before Flop (didn't bet)
Seat 2: Suhoff76 (small blind) folded before Flop
Seat 3: NastyMcNast (big blind) folded before Flop
Seat 4: Th3Fog collected ($3.24)
Seat 5: chiyuki folded before Flop (didn't bet)
Seat 6: 4ydo yogurt folded before Flop (didn't bet)
Seat 7: DooMSDaY1337 folded before Flop (didn't bet)
Seat 8: Ellen1947 folded on the River
Seat 9: cR!Ma*aRm folded before Flop (didn't bet)



PokerStars Zoom Hand #84298838475:  Hold'em No Limit ($0.10/$0.25) - 2012/08/05 13:38:47 JST [2012/08/05 0:38:47 ET]
Table 'Whirlpool' 9-max Seat #1 is the button
Seat 1: chiyuki ($52.36 in chips) 
Seat 2: PetitAlejo ($25 in chips) 
Seat 3: wtu1986 ($27.73 in chips) 
Seat 4: eduvazsilva ($12.90 in chips) 
Seat 5: munky3 ($43.89 in chips) 
Seat 6: Anafim ($16.04 in chips) 
Seat 7: fwani ($25 in chips) 
Seat 8: stankfist420 ($12.66 in chips) 
Seat 9: Dejacob ($27.77 in chips) 
PetitAlejo: posts small blind $0.10
wtu1986: posts big blind $0.25
*** HOLE CARDS ***
Dealt to chiyuki [Th 5h]
eduvazsilva: folds 
munky3: folds 
Anafim: folds 
fwani: folds 
stankfist420: raises $0.50 to $0.75
Dejacob: folds 
chiyuki: folds 
PetitAlejo: folds 
wtu1986: folds 
Uncalled bet ($0.50) returned to stankfist420
stankfist420 collected $0.60 from pot
stankfist420: doesn't show hand 
*** SUMMARY ***
Total pot $0.60 | Rake $0 
Seat 1: chiyuki (button) folded before Flop (didn't bet)
Seat 2: PetitAlejo (small blind) folded before Flop
Seat 3: wtu1986 (big blind) folded before Flop
Seat 4: eduvazsilva folded before Flop (didn't bet)
Seat 5: munky3 folded before Flop (didn't bet)
Seat 6: Anafim folded before Flop (didn't bet)
Seat 7: fwani folded before Flop (didn't bet)
Seat 8: stankfist420 collected ($0.60)
Seat 9: Dejacob folded before Flop (didn't bet)



PokerStars Zoom Hand #84298842091:  Hold'em No Limit ($0.10/$0.25) - 2012/08/05 13:39:01 JST [2012/08/05 0:39:01 ET]
Table 'Whirlpool' 9-max Seat #1 is the button
Seat 1: Loholov ($15 in chips) 
Seat 2: kkbruins0408 ($11.03 in chips) 
Seat 3: jethaz ($49.83 in chips) 
Seat 4: fwani ($25 in chips) 
Seat 5: timburonps ($25 in chips) 
Seat 6: chiyuki ($52.36 in chips) 
Seat 7: goldstone ($23.46 in chips) 
Seat 8: hirozo ($25 in chips) 
Seat 9: BlackZafiro ($25.10 in chips) 
kkbruins0408: posts small blind $0.10
jethaz: posts big blind $0.25
*** HOLE CARDS ***
Dealt to chiyuki [Qc Js]
fwani: folds 
timburonps: folds 
chiyuki: folds 
goldstone: folds 
hirozo: raises $0.50 to $0.75
BlackZafiro: folds 
Loholov: folds 
kkbruins0408: folds 
jethaz: folds 
Uncalled bet ($0.50) returned to hirozo
hirozo collected $0.60 from pot
hirozo: doesn't show hand 
*** SUMMARY ***
Total pot $0.60 | Rake $0 
Seat 1: Loholov (button) folded before Flop (didn't bet)
Seat 2: kkbruins0408 (small blind) folded before Flop
Seat 3: jethaz (big blind) folded before Flop
Seat 4: fwani folded before Flop (didn't bet)
Seat 5: timburonps folded before Flop (didn't bet)
Seat 6: chiyuki folded before Flop (didn't bet)
Seat 7: goldstone folded before Flop (didn't bet)
Seat 8: hirozo collected ($0.60)
Seat 9: BlackZafiro folded before Flop (didn't bet)



PokerStars Zoom Hand #84298844414:  Hold'em No Limit ($0.10/$0.25) - 2012/08/05 13:39:10 JST [2012/08/05 0:39:10 ET]
Table 'Whirlpool' 9-max Seat #1 is the button
Seat 1: hirozo ($25 in chips) 
Seat 2: Ellen1947 ($33.79 in chips) 
Seat 3: solawind ($24.55 in chips) 
Seat 4: ShockLaMuc ($44.77 in chips) 
Seat 5: BlOnDhOlIc ($67.46 in chips) 
Seat 6: ZSIDD ($36.12 in chips) 
Seat 7: Th3Fog ($23.11 in chips) 
Seat 8: leo2095 ($13.82 in chips) 
Seat 9: chiyuki ($52.36 in chips) 
Ellen1947: posts small blind $0.10
solawind: posts big blind $0.25
*** HOLE CARDS ***
Dealt to chiyuki [5d 5h]
ShockLaMuc: folds 
BlOnDhOlIc: folds 
ZSIDD: folds 
Th3Fog: folds 
leo2095: folds 
chiyuki: raises $0.50 to $0.75
hirozo: folds 
Ellen1947: folds 
solawind: folds 
Uncalled bet ($0.50) returned to chiyuki
chiyuki collected $0.60 from pot
chiyuki: doesn't show hand 
*** SUMMARY ***
Total pot $0.60 | Rake $0 
Seat 1: hirozo (button) folded before Flop (didn't bet)
Seat 2: Ellen1947 (small blind) folded before Flop
Seat 3: solawind (big blind) folded before Flop
Seat 4: ShockLaMuc folded before Flop (didn't bet)
Seat 5: BlOnDhOlIc folded before Flop (didn't bet)
Seat 6: ZSIDD folded before Flop (didn't bet)
Seat 7: Th3Fog folded before Flop (didn't bet)
Seat 8: leo2095 folded before Flop (didn't bet)
Seat 9: chiyuki collected ($0.60)



PokerStars Zoom Hand #84298847590:  Hold'em No Limit ($0.10/$0.25) - 2012/08/05 13:39:22 JST [2012/08/05 0:39:22 ET]
Table 'Whirlpool' 9-max Seat #1 is the button
Seat 1: Tom1999 ($18.71 in chips) 
Seat 2: jethaz ($49.58 in chips) 
Seat 3: Landybob ($37.07 in chips) 
Seat 4: chiyuki ($52.71 in chips) 
Seat 5: DooMSDaY1337 ($77.28 in chips) 
Seat 6: hirozo ($26.02 in chips) 
Seat 7: ygoegoe ($26.77 in chips) 
Seat 8: kamikkaze ($54.10 in chips) 
Seat 9: kkbruins0408 ($10.93 in chips) 
jethaz: posts small blind $0.10
Landybob: posts big blind $0.25
*** HOLE CARDS ***
Dealt to chiyuki [4s 7h]
chiyuki: folds 
DooMSDaY1337: folds 
hirozo: folds 
ygoegoe: folds 
kamikkaze: folds 
kkbruins0408: folds 
Tom1999: folds 
jethaz: folds 
Uncalled bet ($0.15) returned to Landybob
Landybob collected $0.20 from pot
Landybob: doesn't show hand 
*** SUMMARY ***
Total pot $0.20 | Rake $0 
Seat 1: Tom1999 (button) folded before Flop (didn't bet)
Seat 2: jethaz (small blind) folded before Flop
Seat 3: Landybob (big blind) collected ($0.20)
Seat 4: chiyuki folded before Flop (didn't bet)
Seat 5: DooMSDaY1337 folded before Flop (didn't bet)
Seat 6: hirozo folded before Flop (didn't bet)
Seat 7: ygoegoe folded before Flop (didn't bet)
Seat 8: kamikkaze folded before Flop (didn't bet)
Seat 9: kkbruins0408 folded before Flop (didn't bet)



PokerStars Zoom Hand #84298848663:  Hold'em No Limit ($0.10/$0.25) - 2012/08/05 13:39:26 JST [2012/08/05 0:39:26 ET]
Table 'Whirlpool' 9-max Seat #1 is the button
Seat 1: ShockLaMuc ($44.77 in chips) 
Seat 2: Pkdave ($37.33 in chips) 
Seat 3: wtu1986 ($27.84 in chips) 
Seat 4: slapshot2011 ($39.06 in chips) 
Seat 5: Loholov ($15 in chips) 
Seat 6: Tom1999 ($15.58 in chips) 
Seat 7: timburonps ($48.35 in chips) 
Seat 8: chiyuki ($52.71 in chips) 
Seat 9: hirozo ($26.02 in chips) 
Pkdave: posts small blind $0.10
wtu1986: posts big blind $0.25
*** HOLE CARDS ***
Dealt to chiyuki [Td 8d]
slapshot2011: folds 
Loholov: folds 
Tom1999: raises $0.50 to $0.75
timburonps: folds 
chiyuki: folds 
hirozo: folds 
ShockLaMuc: folds 
Pkdave: folds 
wtu1986: folds 
Uncalled bet ($0.50) returned to Tom1999
Tom1999 collected $0.60 from pot
Tom1999: doesn't show hand 
*** SUMMARY ***
Total pot $0.60 | Rake $0 
Seat 1: ShockLaMuc (button) folded before Flop (didn't bet)
Seat 2: Pkdave (small blind) folded before Flop
Seat 3: wtu1986 (big blind) folded before Flop
Seat 4: slapshot2011 folded before Flop (didn't bet)
Seat 5: Loholov folded before Flop (didn't bet)
Seat 6: Tom1999 collected ($0.60)
Seat 7: timburonps folded before Flop (didn't bet)
Seat 8: chiyuki folded before Flop (didn't bet)
Seat 9: hirozo folded before Flop (didn't bet)



PokerStars Zoom Hand #84298850997:  Hold'em No Limit ($0.10/$0.25) - 2012/08/05 13:39:35 JST [2012/08/05 0:39:35 ET]
Table 'Whirlpool' 9-max Seat #1 is the button
Seat 1: Pkdave ($37.23 in chips) 
Seat 2: TraderYao ($27.91 in chips) 
Seat 3: KeLevro0 ($12.50 in chips) 
Seat 4: Loholov ($24.36 in chips) 
Seat 5: silvno31 ($28.59 in chips) 
Seat 6: BlOnDhOlIc ($35.73 in chips) 
Seat 7: chiyuki ($52.71 in chips) 
Seat 8: hirozo ($25.35 in chips) 
Seat 9: Nerkit ($13.17 in chips) 
TraderYao: posts small blind $0.10
KeLevro0: posts big blind $0.25
*** HOLE CARDS ***
Dealt to chiyuki [Kh 5h]
Loholov: folds 
silvno31: folds 
BlOnDhOlIc: folds 
chiyuki: folds 
hirozo: raises $0.50 to $0.75
Nerkit: folds 
Pkdave: folds 
TraderYao: folds 
KeLevro0: raises $1.75 to $2.50
hirozo: folds 
Uncalled bet ($1.75) returned to KeLevro0
KeLevro0 collected $1.60 from pot
KeLevro0: doesn't show hand 
*** SUMMARY ***
Total pot $1.60 | Rake $0 
Seat 1: Pkdave (button) folded before Flop (didn't bet)
Seat 2: TraderYao (small blind) folded before Flop
Seat 3: KeLevro0 (big blind) collected ($1.60)
Seat 4: Loholov folded before Flop (didn't bet)
Seat 5: silvno31 folded before Flop (didn't bet)
Seat 6: BlOnDhOlIc folded before Flop (didn't bet)
Seat 7: chiyuki folded before Flop (didn't bet)
Seat 8: hirozo folded before Flop
Seat 9: Nerkit folded before Flop (didn't bet)



PokerStars Zoom Hand #84298855051:  Hold'em No Limit ($0.10/$0.25) - 2012/08/05 13:39:52 JST [2012/08/05 0:39:52 ET]
Table 'Whirlpool' 9-max Seat #1 is the button
Seat 1: BlOnDhOlIc ($67.82 in chips) 
Seat 2: ygoegoe ($26.92 in chips) 
Seat 3: silvno31 ($28.59 in chips) 
Seat 4: jethaz ($36.35 in chips) 
Seat 5: chiyuki ($52.71 in chips) 
Seat 6: Suhoff76 ($36.73 in chips) 
Seat 7: PetitAlejo ($25.10 in chips) 
Seat 8: deadmoneykid ($35.04 in chips) 
Seat 9: Anafim ($15.69 in chips) 
ygoegoe: posts small blind $0.10
silvno31: posts big blind $0.25
*** HOLE CARDS ***
Dealt to chiyuki [Kd 4h]
jethaz: folds 
chiyuki: folds 
Suhoff76: folds 
PetitAlejo: folds 
deadmoneykid: folds 
Anafim: folds 
BlOnDhOlIc: raises $0.25 to $0.50
ygoegoe: folds 
silvno31: calls $0.25
*** FLOP *** [2h Qs Ts]
silvno31: checks 
BlOnDhOlIc: checks 
*** TURN *** [2h Qs Ts] [9s]
silvno31: bets $1.50
BlOnDhOlIc: calls $1.50
*** RIVER *** [2h Qs Ts 9s] [3c]
silvno31: bets $5
BlOnDhOlIc: folds 
Uncalled bet ($5) returned to silvno31
silvno31 collected $3.92 from pot
silvno31: doesn't show hand 
*** SUMMARY ***
Total pot $4.10 | Rake $0.18 
Board [2h Qs Ts 9s 3c]
Seat 1: BlOnDhOlIc (button) folded on the River
Seat 2: ygoegoe (small blind) folded before Flop
Seat 3: silvno31 (big blind) collected ($3.92)
Seat 4: jethaz folded before Flop (didn't bet)
Seat 5: chiyuki folded before Flop (didn't bet)
Seat 6: Suhoff76 folded before Flop (didn't bet)
Seat 7: PetitAlejo folded before Flop (didn't bet)
Seat 8: deadmoneykid folded before Flop (didn't bet)
Seat 9: Anafim folded before Flop (didn't bet)



PokerStars Zoom Hand #84298852226:  Hold'em No Limit ($0.10/$0.25) - 2012/08/05 13:39:40 JST [2012/08/05 0:39:40 ET]
Table 'Whirlpool' 9-max Seat #1 is the button
Seat 1: PetitAlejo ($29.66 in chips) 
Seat 2: Th3Fog ($54.77 in chips) 
Seat 3: hirozo ($25 in chips) 
Seat 4: KeLevro0 ($15.50 in chips) 
Seat 5: chiyuki ($52.71 in chips) 
Seat 6: BlackZafiro ($25 in chips) 
Seat 7: taksist889 ($28.75 in chips) 
Seat 8: Lasutchik ($12.15 in chips) 
Seat 9: Suhoff76 ($25 in chips) 
Th3Fog: posts small blind $0.10
hirozo: posts big blind $0.25
*** HOLE CARDS ***
Dealt to chiyuki [Ah 5c]
KeLevro0: raises $0.42 to $0.67
chiyuki: folds 
BlackZafiro: folds 
taksist889: calls $0.67
Lasutchik: folds 
Suhoff76: raises $1.83 to $2.50
PetitAlejo: folds 
Th3Fog: folds 
hirozo: folds 
KeLevro0: folds 
taksist889: calls $1.83
*** FLOP *** [Ts 3h Qc]
taksist889: checks 
Suhoff76: bets $3.79
taksist889: calls $3.79
*** TURN *** [Ts 3h Qc] [2d]
taksist889: checks 
Suhoff76: bets $5
taksist889: folds 
Uncalled bet ($5) returned to Suhoff76
Suhoff76 collected $12.99 from pot
Suhoff76: doesn't show hand 
*** SUMMARY ***
Total pot $13.60 | Rake $0.61 
Board [Ts 3h Qc 2d]
Seat 1: PetitAlejo (button) folded before Flop (didn't bet)
Seat 2: Th3Fog (small blind) folded before Flop
Seat 3: hirozo (big blind) folded before Flop
Seat 4: KeLevro0 folded before Flop
Seat 5: chiyuki folded before Flop (didn't bet)
Seat 6: BlackZafiro folded before Flop (didn't bet)
Seat 7: taksist889 folded on the Turn
Seat 8: Lasutchik folded before Flop (didn't bet)
Seat 9: Suhoff76 collected ($12.99)



PokerStars Zoom Hand #84298855841:  Hold'em No Limit ($0.10/$0.25) - 2012/08/05 13:39:55 JST [2012/08/05 0:39:55 ET]
Table 'Whirlpool' 9-max Seat #1 is the button
Seat 1: jethaz ($62.45 in chips) 
Seat 2: Th3Fog ($23.11 in chips) 
Seat 3: ladymadon107 ($25.64 in chips) 
Seat 4: chiyuki ($52.71 in chips) 
Seat 5: Tom1999 ($15.93 in chips) 
Seat 6: Landybob ($37.07 in chips) 
Seat 7: timburonps ($25.92 in chips) 
Seat 8: cR!Ma*aRm ($32.77 in chips) 
Seat 9: Dejacob ($36.10 in chips) 
Th3Fog: posts small blind $0.10
ladymadon107: posts big blind $0.25
*** HOLE CARDS ***
Dealt to chiyuki [Ad 4h]
chiyuki: folds 
Tom1999: folds 
Landybob: folds 
timburonps: folds 
cR!Ma*aRm: folds 
Dejacob: folds 
jethaz: raises $0.50 to $0.75
Th3Fog: folds 
ladymadon107: calls $0.50
*** FLOP *** [9c 5c Ac]
ladymadon107: bets $0.50
jethaz: calls $0.50
*** TURN *** [9c 5c Ac] [5h]
ladymadon107: bets $0.75
jethaz: calls $0.75
*** RIVER *** [9c 5c Ac 5h] [2s]
ladymadon107: bets $0.75
jethaz: calls $0.75
*** SHOW DOWN ***
ladymadon107: shows [Ah 6s] (two pair, Aces and Fives)
jethaz: mucks hand 
ladymadon107 collected $5.35 from pot
*** SUMMARY ***
Total pot $5.60 | Rake $0.25 
Board [9c 5c Ac 5h 2s]
Seat 1: jethaz (button) mucked [Qc Qs]
Seat 2: Th3Fog (small blind) folded before Flop
Seat 3: ladymadon107 (big blind) showed [Ah 6s] and won ($5.35) with two pair, Aces and Fives
Seat 4: chiyuki folded before Flop (didn't bet)
Seat 5: Tom1999 folded before Flop (didn't bet)
Seat 6: Landybob folded before Flop (didn't bet)
Seat 7: timburonps folded before Flop (didn't bet)
Seat 8: cR!Ma*aRm folded before Flop (didn't bet)
Seat 9: Dejacob folded before Flop (didn't bet)



PokerStars Zoom Hand #84298857628:  Hold'em No Limit ($0.10/$0.25) - 2012/08/05 13:40:02 JST [2012/08/05 0:40:02 ET]
Table 'Whirlpool' 9-max Seat #1 is the button
Seat 1: agurio ($25.18 in chips) 
Seat 2: jethaz ($73.69 in chips) 
Seat 3: chiyuki ($52.71 in chips) 
Seat 4: hirozo ($27.65 in chips) 
Seat 5: PetitAlejo ($25.10 in chips) 
Seat 6: deadmoneykid ($20.92 in chips) 
Seat 7: timburonps ($25.92 in chips) 
Seat 8: seula i ($33.33 in chips) 
Seat 9: KeLevro0 ($12.50 in chips) 
jethaz: posts small blind $0.10
chiyuki: posts big blind $0.25
*** HOLE CARDS ***
Dealt to chiyuki [6c 7s]
hirozo: folds 
PetitAlejo: raises $0.50 to $0.75
deadmoneykid: folds 
timburonps: folds 
seula i: calls $0.75
KeLevro0: folds 
agurio: folds 
jethaz: calls $0.65
chiyuki: folds 
*** FLOP *** [Th 8c Ah]
jethaz: checks 
PetitAlejo: checks 
seula i: bets $1.75
jethaz: folds 
PetitAlejo: folds 
Uncalled bet ($1.75) returned to seula i
seula i collected $2.39 from pot
seula i: doesn't show hand 
*** SUMMARY ***
Total pot $2.50 | Rake $0.11 
Board [Th 8c Ah]
Seat 1: agurio (button) folded before Flop (didn't bet)
Seat 2: jethaz (small blind) folded on the Flop
Seat 3: chiyuki (big blind) folded before Flop
Seat 4: hirozo folded before Flop (didn't bet)
Seat 5: PetitAlejo folded on the Flop
Seat 6: deadmoneykid folded before Flop (didn't bet)
Seat 7: timburonps folded before Flop (didn't bet)
Seat 8: seula i collected ($2.39)
Seat 9: KeLevro0 folded before Flop (didn't bet)



PokerStars Zoom Hand #84298873020:  Hold'em No Limit ($0.10/$0.25) - 2012/08/05 13:41:03 JST [2012/08/05 0:41:03 ET]
Table 'Whirlpool' 9-max Seat #1 is the button
Seat 1: BlOnDhOlIc ($26.10 in chips) 
Seat 2: Dejacob ($35.75 in chips) 
Seat 3: Ellen1947 ($33.44 in chips) 
Seat 4: Loholov ($20.78 in chips) 
Seat 5: 5zzzz33 ($17.46 in chips) 
Seat 6: slapshot2011 ($39.23 in chips) 
Seat 7: Tom1999 ($5.95 in chips) 
Seat 8: chiyuki ($52.36 in chips) 
Seat 9: hirozo ($25.35 in chips) 
Dejacob: posts small blind $0.10
Ellen1947: posts big blind $0.25
*** HOLE CARDS ***
Dealt to chiyuki [4s 5c]
Loholov: folds 
5zzzz33: folds 
slapshot2011: folds 
Tom1999: folds 
chiyuki: folds 
hirozo: folds 
BlOnDhOlIc: folds 
Dejacob: folds 
Uncalled bet ($0.15) returned to Ellen1947
Ellen1947 collected $0.20 from pot
Ellen1947: doesn't show hand 
*** SUMMARY ***
Total pot $0.20 | Rake $0 
Seat 1: BlOnDhOlIc (button) folded before Flop (didn't bet)
Seat 2: Dejacob (small blind) folded before Flop
Seat 3: Ellen1947 (big blind) collected ($0.20)
Seat 4: Loholov folded before Flop (didn't bet)
Seat 5: 5zzzz33 folded before Flop (didn't bet)
Seat 6: slapshot2011 folded before Flop (didn't bet)
Seat 7: Tom1999 folded before Flop (didn't bet)
Seat 8: chiyuki folded before Flop (didn't bet)
Seat 9: hirozo folded before Flop (didn't bet)



PokerStars Zoom Hand #84298866608:  Hold'em No Limit ($0.10/$0.25) - 2012/08/05 13:40:37 JST [2012/08/05 0:40:37 ET]
Table 'Whirlpool' 9-max Seat #1 is the button
Seat 1: BlOnDhOlIc ($35.38 in chips) 
Seat 2: chiyuki ($52.46 in chips) 
Seat 3: Loholov ($21.03 in chips) 
Seat 4: ShockLaMuc ($29.55 in chips) 
Seat 5: munky3 ($41.79 in chips) 
Seat 6: Suhoff76 ($27.67 in chips) 
Seat 7: fwani ($28.44 in chips) 
Seat 8: Nerkit ($14.89 in chips) 
Seat 9: 4ydo yogurt ($7.05 in chips) 
chiyuki: posts small blind $0.10
Loholov: posts big blind $0.25
*** HOLE CARDS ***
Dealt to chiyuki [9s Ad]
ShockLaMuc: calls $0.25
munky3: folds 
Suhoff76: raises $1.05 to $1.30
fwani: folds 
Nerkit: folds 
4ydo yogurt: folds 
BlOnDhOlIc: folds 
chiyuki: folds 
Loholov: folds 
ShockLaMuc: calls $1.05
*** FLOP *** [5s Kc 3h]
ShockLaMuc: checks 
Suhoff76: checks 
*** TURN *** [5s Kc 3h] [Ts]
ShockLaMuc: checks 
Suhoff76: bets $1.10
ShockLaMuc: folds 
Uncalled bet ($1.10) returned to Suhoff76
Suhoff76 collected $2.82 from pot
Suhoff76: doesn't show hand 
*** SUMMARY ***
Total pot $2.95 | Rake $0.13 
Board [5s Kc 3h Ts]
Seat 1: BlOnDhOlIc (button) folded before Flop (didn't bet)
Seat 2: chiyuki (small blind) folded before Flop
Seat 3: Loholov (big blind) folded before Flop
Seat 4: ShockLaMuc folded on the Turn
Seat 5: munky3 folded before Flop (didn't bet)
Seat 6: Suhoff76 collected ($2.82)
Seat 7: fwani folded before Flop (didn't bet)
Seat 8: Nerkit folded before Flop (didn't bet)
Seat 9: 4ydo yogurt folded before Flop (didn't bet)



PokerStars Zoom Hand #84298874037:  Hold'em No Limit ($0.10/$0.25) - 2012/08/05 13:41:07 JST [2012/08/05 0:41:07 ET]
Table 'Whirlpool' 9-max Seat #1 is the button
Seat 1: eduvazsilva ($11.05 in chips) 
Seat 2: Loholov ($20.78 in chips) 
Seat 3: Tom1999 ($5.95 in chips) 
Seat 4: Roglus ($70.29 in chips) 
Seat 5: goldstone ($23.71 in chips) 
Seat 6: ygoegoe ($27.07 in chips) 
Seat 7: silvno31 ($30.41 in chips) 
Seat 8: carlosrbr ($11.75 in chips) 
Seat 9: chiyuki ($52.36 in chips) 
Loholov: posts small blind $0.10
Tom1999: posts big blind $0.25
*** HOLE CARDS ***
Dealt to chiyuki [6s 7d]
Roglus: folds 
goldstone has timed out
goldstone: folds 
ygoegoe: folds 
silvno31: folds 
carlosrbr: folds 
chiyuki: folds 
eduvazsilva: folds 
Loholov: folds 
Uncalled bet ($0.15) returned to Tom1999
Tom1999 collected $0.20 from pot
Tom1999: doesn't show hand 
*** SUMMARY ***
Total pot $0.20 | Rake $0 
Seat 1: eduvazsilva (button) folded before Flop (didn't bet)
Seat 2: Loholov (small blind) folded before Flop
Seat 3: Tom1999 (big blind) collected ($0.20)
Seat 4: Roglus folded before Flop (didn't bet)
Seat 5: goldstone folded before Flop (didn't bet)
Seat 6: ygoegoe folded before Flop (didn't bet)
Seat 7: silvno31 folded before Flop (didn't bet)
Seat 8: carlosrbr folded before Flop (didn't bet)
Seat 9: chiyuki folded before Flop (didn't bet)



PokerStars Zoom Hand #84298875121:  Hold'em No Limit ($0.10/$0.25) - 2012/08/05 13:41:11 JST [2012/08/05 0:41:11 ET]
Table 'Whirlpool' 9-max Seat #1 is the button
Seat 1: Lasutchik ($9.39 in chips) 
Seat 2: deadmoneykid ($21.27 in chips) 
Seat 3: BlOnDhOlIc ($65.82 in chips) 
Seat 4: wtu1986 ($26.84 in chips) 
Seat 5: Nerkit ($13.17 in chips) 
Seat 6: KeLevro0 ($12.25 in chips) 
Seat 7: chiyuki ($52.36 in chips) 
Seat 8: NastyMcNast ($31.05 in chips) 
Seat 9: BlackZafiro ($32.09 in chips) 
deadmoneykid: posts small blind $0.10
BlOnDhOlIc: posts big blind $0.25
*** HOLE CARDS ***
Dealt to chiyuki [9d Td]
wtu1986: folds 
Nerkit: folds 
KeLevro0: folds 
chiyuki: folds 
NastyMcNast: folds 
BlackZafiro: folds 
Lasutchik: raises $0.50 to $0.75
deadmoneykid: folds 
BlOnDhOlIc: folds 
Uncalled bet ($0.50) returned to Lasutchik
Lasutchik collected $0.60 from pot
Lasutchik: doesn't show hand 
*** SUMMARY ***
Total pot $0.60 | Rake $0 
Seat 1: Lasutchik (button) collected ($0.60)
Seat 2: deadmoneykid (small blind) folded before Flop
Seat 3: BlOnDhOlIc (big blind) folded before Flop
Seat 4: wtu1986 folded before Flop (didn't bet)
Seat 5: Nerkit folded before Flop (didn't bet)
Seat 6: KeLevro0 folded before Flop (didn't bet)
Seat 7: chiyuki folded before Flop (didn't bet)
Seat 8: NastyMcNast folded before Flop (didn't bet)
Seat 9: BlackZafiro folded before Flop (didn't bet)



PokerStars Zoom Hand #84298880933:  Hold'em No Limit ($0.10/$0.25) - 2012/08/05 13:41:34 JST [2012/08/05 0:41:34 ET]
Table 'Whirlpool' 9-max Seat #1 is the button
Seat 1: Dejacob ($43.55 in chips) 
Seat 2: chiyuki ($52.36 in chips) 
Seat 3: seula i ($52.24 in chips) 
Seat 4: Nerkit ($14.79 in chips) 
Seat 5: ygoegoe ($26.57 in chips) 
Seat 6: jethaz ($59.35 in chips) 
Seat 7: hirozo ($25.78 in chips) 
Seat 8: timburonps ($25.53 in chips) 
Seat 9: lovinlife5 ($25 in chips) 
chiyuki: posts small blind $0.10
seula i: posts big blind $0.25
*** HOLE CARDS ***
Dealt to chiyuki [8c 6d]
Nerkit: folds 
ygoegoe: folds 
jethaz: folds 
hirozo: folds 
timburonps: folds 
lovinlife5: folds 
Dejacob: folds 
chiyuki: folds 
Uncalled bet ($0.15) returned to seula i
seula i collected $0.20 from pot
seula i: doesn't show hand 
*** SUMMARY ***
Total pot $0.20 | Rake $0 
Seat 1: Dejacob (button) folded before Flop (didn't bet)
Seat 2: chiyuki (small blind) folded before Flop
Seat 3: seula i (big blind) collected ($0.20)
Seat 4: Nerkit folded before Flop (didn't bet)
Seat 5: ygoegoe folded before Flop (didn't bet)
Seat 6: jethaz folded before Flop (didn't bet)
Seat 7: hirozo folded before Flop (didn't bet)
Seat 8: timburonps folded before Flop (didn't bet)
Seat 9: lovinlife5 folded before Flop (didn't bet)



PokerStars Zoom Hand #84298877337:  Hold'em No Limit ($0.10/$0.25) - 2012/08/05 13:41:20 JST [2012/08/05 0:41:20 ET]
Table 'Whirlpool' 9-max Seat #1 is the button
Seat 1: slapshot2011 ($39.13 in chips) 
Seat 2: Dejacob ($43.65 in chips) 
Seat 3: KeLevro0 ($13.05 in chips) 
Seat 4: hirozo ($25.35 in chips) 
Seat 5: TErr18 ($10.38 in chips) 
Seat 6: chiyuki ($52.36 in chips) 
Seat 7: jethaz ($35.75 in chips) 
Seat 8: 5zzzz33 ($17.21 in chips) 
Seat 9: Nerkit ($13.17 in chips) 
Dejacob: posts small blind $0.10
KeLevro0: posts big blind $0.25
*** HOLE CARDS ***
Dealt to chiyuki [8c 4h]
hirozo: folds 
TErr18: folds 
chiyuki: folds 
jethaz: raises $0.50 to $0.75
5zzzz33: folds 
Nerkit: folds 
slapshot2011: calls $0.75
Dejacob: folds 
KeLevro0: folds 
*** FLOP *** [7d 8d 6c]
jethaz: bets $1.25
slapshot2011: calls $1.25
*** TURN *** [7d 8d 6c] [6h]
jethaz: bets $2.50
slapshot2011: calls $2.50
*** RIVER *** [7d 8d 6c 6h] [6s]
jethaz: checks 
slapshot2011: checks 
*** SHOW DOWN ***
jethaz: shows [Kh Qc] (three of a kind, Sixes)
slapshot2011: shows [8s 9d] (a full house, Sixes full of Eights)
slapshot2011 collected $8.93 from pot
*** SUMMARY ***
Total pot $9.35 | Rake $0.42 
Board [7d 8d 6c 6h 6s]
Seat 1: slapshot2011 (button) showed [8s 9d] and won ($8.93) with a full house, Sixes full of Eights
Seat 2: Dejacob (small blind) folded before Flop
Seat 3: KeLevro0 (big blind) folded before Flop
Seat 4: hirozo folded before Flop (didn't bet)
Seat 5: TErr18 folded before Flop (didn't bet)
Seat 6: chiyuki folded before Flop (didn't bet)
Seat 7: jethaz showed [Kh Qc] and lost with three of a kind, Sixes
Seat 8: 5zzzz33 folded before Flop (didn't bet)
Seat 9: Nerkit folded before Flop (didn't bet)



PokerStars Zoom Hand #84298878595:  Hold'em No Limit ($0.10/$0.25) - 2012/08/05 13:41:25 JST [2012/08/05 0:41:25 ET]
Table 'Whirlpool' 9-max Seat #1 is the button
Seat 1: TErr18 ($10.38 in chips) 
Seat 2: wtu1986 ($26.84 in chips) 
Seat 3: hirozo ($25 in chips) 
Seat 4: seula i ($26.49 in chips) 
Seat 5: ll_LaMeR_ll ($38.85 in chips) 
Seat 6: chiyuki ($52.36 in chips) 
Seat 7: Nerkit ($13.17 in chips) 
Seat 8: carlosrbr ($11.75 in chips) 
Seat 9: Th3Fog ($22.26 in chips) 
wtu1986: posts small blind $0.10
hirozo: posts big blind $0.25
*** HOLE CARDS ***
Dealt to chiyuki [5c 7s]
seula i: folds 
ll_LaMeR_ll: raises $0.50 to $0.75
chiyuki: folds 
Nerkit: folds 
carlosrbr: raises $1.25 to $2
Th3Fog: folds 
TErr18: folds 
wtu1986: folds 
hirozo: folds 
ll_LaMeR_ll: folds 
Uncalled bet ($1.25) returned to carlosrbr
carlosrbr collected $1.85 from pot
carlosrbr: doesn't show hand 
*** SUMMARY ***
Total pot $1.85 | Rake $0 
Seat 1: TErr18 (button) folded before Flop (didn't bet)
Seat 2: wtu1986 (small blind) folded before Flop
Seat 3: hirozo (big blind) folded before Flop
Seat 4: seula i folded before Flop (didn't bet)
Seat 5: ll_LaMeR_ll folded before Flop
Seat 6: chiyuki folded before Flop (didn't bet)
Seat 7: Nerkit folded before Flop (didn't bet)
Seat 8: carlosrbr collected ($1.85)
Seat 9: Th3Fog folded before Flop (didn't bet)



PokerStars Zoom Hand #84298871997:  Hold'em No Limit ($0.10/$0.25) - 2012/08/05 13:40:59 JST [2012/08/05 0:40:59 ET]
Table 'Whirlpool' 9-max Seat #1 is the button
Seat 1: chiyuki ($52.36 in chips) 
Seat 2: timburonps ($25.67 in chips) 
Seat 3: jethaz ($36 in chips) 
Seat 4: Th3Fog ($54.42 in chips) 
Seat 5: fwani ($25.75 in chips) 
Seat 6: silvno31 ($30.41 in chips) 
Seat 7: BlackValaR ($13.18 in chips) 
Seat 8: slapshot2011 ($39.23 in chips) 
Seat 9: wildy29 ($16.84 in chips) 
timburonps: posts small blind $0.10
jethaz: posts big blind $0.25
*** HOLE CARDS ***
Dealt to chiyuki [Jh 8h]
Th3Fog: folds 
fwani: folds 
silvno31: folds 
BlackValaR: calls $0.25
slapshot2011: folds 
wildy29: raises $0.25 to $0.50
chiyuki: folds 
timburonps: raises $2.25 to $2.75
jethaz: folds 
BlackValaR: folds 
wildy29: calls $2.25
*** FLOP *** [2s Kd 8c]
timburonps: bets $3
wildy29: folds 
Uncalled bet ($3) returned to timburonps
timburonps collected $5.73 from pot
timburonps: doesn't show hand 
*** SUMMARY ***
Total pot $6 | Rake $0.27 
Board [2s Kd 8c]
Seat 1: chiyuki (button) folded before Flop (didn't bet)
Seat 2: timburonps (small blind) collected ($5.73)
Seat 3: jethaz (big blind) folded before Flop
Seat 4: Th3Fog folded before Flop (didn't bet)
Seat 5: fwani folded before Flop (didn't bet)
Seat 6: silvno31 folded before Flop (didn't bet)
Seat 7: BlackValaR folded before Flop
Seat 8: slapshot2011 folded before Flop (didn't bet)
Seat 9: wildy29 folded on the Flop



PokerStars Zoom Hand #84298879666:  Hold'em No Limit ($0.10/$0.25) - 2012/08/05 13:41:29 JST [2012/08/05 0:41:29 ET]
Table 'Whirlpool' 9-max Seat #1 is the button
Seat 1: Suhoff76 ($25 in chips) 
Seat 2: cR!Ma*aRm ($33.54 in chips) 
Seat 3: TErr18 ($10.38 in chips) 
Seat 4: chiyuki ($52.36 in chips) 
Seat 5: KAKamiro ($11.18 in chips) 
Seat 6: fwani ($25.10 in chips) 
Seat 7: NastyMcNast ($31.05 in chips) 
Seat 8: ShockLaMuc ($24.65 in chips) 
Seat 9: Anafim ($14.09 in chips) 
cR!Ma*aRm: posts small blind $0.10
TErr18: posts big blind $0.25
*** HOLE CARDS ***
Dealt to chiyuki [Tc 9h]
chiyuki: folds 
KAKamiro: folds 
fwani: folds 
NastyMcNast: folds 
ShockLaMuc: folds 
Anafim: folds 
Suhoff76: folds 
cR!Ma*aRm: raises $0.50 to $0.75
TErr18: raises $0.50 to $1.25
cR!Ma*aRm: calls $0.50
*** FLOP *** [7d Kh 6d]
cR!Ma*aRm: checks 
TErr18: bets $0.25
cR!Ma*aRm: calls $0.25
*** TURN *** [7d Kh 6d] [4s]
cR!Ma*aRm: bets $1
TErr18: calls $1
*** RIVER *** [7d Kh 6d 4s] [5h]
cR!Ma*aRm: bets $1
TErr18: raises $6.88 to $7.88 and is all-in
cR!Ma*aRm: folds 
Uncalled bet ($6.88) returned to TErr18
TErr18 collected $6.68 from pot
TErr18: doesn't show hand 
*** SUMMARY ***
Total pot $7 | Rake $0.32 
Board [7d Kh 6d 4s 5h]
Seat 1: Suhoff76 (button) folded before Flop (didn't bet)
Seat 2: cR!Ma*aRm (small blind) folded on the River
Seat 3: TErr18 (big blind) collected ($6.68)
Seat 4: chiyuki folded before Flop (didn't bet)
Seat 5: KAKamiro folded before Flop (didn't bet)
Seat 6: fwani folded before Flop (didn't bet)
Seat 7: NastyMcNast folded before Flop (didn't bet)
Seat 8: ShockLaMuc folded before Flop (didn't bet)
Seat 9: Anafim folded before Flop (didn't bet)



PokerStars Zoom Hand #84298884927:  Hold'em No Limit ($0.10/$0.25) - 2012/08/05 13:41:49 JST [2012/08/05 0:41:49 ET]
Table 'Whirlpool' 9-max Seat #1 is the button
Seat 1: BlOnDhOlIc ($36.15 in chips) 
Seat 2: Suhoff76 ($25 in chips) 
Seat 3: chiyuki ($52.26 in chips) 
Seat 4: deadmoneykid ($25.06 in chips) 
Seat 5: NastyMcNast ($36.15 in chips) 
Seat 6: lovinlife5 ($25 in chips) 
Seat 7: 5zzzz33 ($17.11 in chips) 
Seat 8: PetitAlejo ($36.69 in chips) 
Seat 9: fwani ($28.19 in chips) 
Suhoff76: posts small blind $0.10
chiyuki: posts big blind $0.25
*** HOLE CARDS ***
Dealt to chiyuki [4s Js]
deadmoneykid: folds 
NastyMcNast: folds 
lovinlife5: folds 
5zzzz33: folds 
PetitAlejo: raises $0.50 to $0.75
fwani: folds 
BlOnDhOlIc: folds 
Suhoff76: folds 
chiyuki: folds 
Uncalled bet ($0.50) returned to PetitAlejo
PetitAlejo collected $0.60 from pot
PetitAlejo: doesn't show hand 
*** SUMMARY ***
Total pot $0.60 | Rake $0 
Seat 1: BlOnDhOlIc (button) folded before Flop (didn't bet)
Seat 2: Suhoff76 (small blind) folded before Flop
Seat 3: chiyuki (big blind) folded before Flop
Seat 4: deadmoneykid folded before Flop (didn't bet)
Seat 5: NastyMcNast folded before Flop (didn't bet)
Seat 6: lovinlife5 folded before Flop (didn't bet)
Seat 7: 5zzzz33 folded before Flop (didn't bet)
Seat 8: PetitAlejo collected ($0.60)
Seat 9: fwani folded before Flop (didn't bet)



PokerStars Zoom Hand #84298883934:  Hold'em No Limit ($0.10/$0.25) - 2012/08/05 13:41:45 JST [2012/08/05 0:41:45 ET]
Table 'Whirlpool' 9-max Seat #1 is the button
Seat 1: goldstone ($40.23 in chips) 
Seat 2: solawind ($25.76 in chips) 
Seat 3: Lasutchik ($9.74 in chips) 
Seat 4: BlOnDhOlIc ($36.15 in chips) 
Seat 5: chiyuki ($52.26 in chips) 
Seat 6: Roglus ($19.48 in chips) 
Seat 7: Anafim ($15.88 in chips) 
Seat 8: wtu1986 ($25 in chips) 
Seat 9: Loholov ($19.18 in chips) 
solawind: posts small blind $0.10
Lasutchik: posts big blind $0.25
*** HOLE CARDS ***
Dealt to chiyuki [2s 2c]
BlOnDhOlIc: folds 
chiyuki: folds 
Roglus: raises $0.50 to $0.75
Anafim: folds 
wtu1986: calls $0.75
Loholov: folds 
goldstone: folds 
solawind: calls $0.65
Lasutchik: calls $0.50
*** FLOP *** [Ah Jd 4s]
solawind: checks 
Lasutchik: checks 
Roglus: bets $1.94
wtu1986: folds 
solawind: folds 
Lasutchik: folds 
Uncalled bet ($1.94) returned to Roglus
Roglus collected $2.86 from pot
Roglus: doesn't show hand 
*** SUMMARY ***
Total pot $3 | Rake $0.14 
Board [Ah Jd 4s]
Seat 1: goldstone (button) folded before Flop (didn't bet)
Seat 2: solawind (small blind) folded on the Flop
Seat 3: Lasutchik (big blind) folded on the Flop
Seat 4: BlOnDhOlIc folded before Flop (didn't bet)
Seat 5: chiyuki folded before Flop (didn't bet)
Seat 6: Roglus collected ($2.86)
Seat 7: Anafim folded before Flop (didn't bet)
Seat 8: wtu1986 folded on the Flop
Seat 9: Loholov folded before Flop (didn't bet)



PokerStars Zoom Hand #84298890568:  Hold'em No Limit ($0.10/$0.25) - 2012/08/05 13:42:11 JST [2012/08/05 0:42:11 ET]
Table 'Whirlpool' 9-max Seat #1 is the button
Seat 1: chiyuki ($52.01 in chips) 
Seat 2: Alvinpe85 ($27.83 in chips) 
Seat 3: ShockLaMuc ($24.65 in chips) 
Seat 4: BlackZafiro ($32.09 in chips) 
Seat 5: timburonps ($33.42 in chips) 
Seat 6: Loholov ($19.18 in chips) 
Seat 7: Dejacob ($29.31 in chips) 
Seat 8: fwani ($28.09 in chips) 
Seat 9: Tom1999 ($14.56 in chips) 
Alvinpe85: posts small blind $0.10
ShockLaMuc: posts big blind $0.25
*** HOLE CARDS ***
Dealt to chiyuki [9s Ks]
BlackZafiro: folds 
timburonps: folds 
Loholov: folds 
Dejacob: folds 
fwani: raises $0.35 to $0.60
Tom1999: folds 
chiyuki: folds 
Alvinpe85: folds 
ShockLaMuc: folds 
Uncalled bet ($0.35) returned to fwani
fwani collected $0.60 from pot
fwani: doesn't show hand 
*** SUMMARY ***
Total pot $0.60 | Rake $0 
Seat 1: chiyuki (button) folded before Flop (didn't bet)
Seat 2: Alvinpe85 (small blind) folded before Flop
Seat 3: ShockLaMuc (big blind) folded before Flop
Seat 4: BlackZafiro folded before Flop (didn't bet)
Seat 5: timburonps folded before Flop (didn't bet)
Seat 6: Loholov folded before Flop (didn't bet)
Seat 7: Dejacob folded before Flop (didn't bet)
Seat 8: fwani collected ($0.60)
Seat 9: Tom1999 folded before Flop (didn't bet)



PokerStars Zoom Hand #84298894473:  Hold'em No Limit ($0.10/$0.25) - 2012/08/05 13:42:26 JST [2012/08/05 0:42:26 ET]
Table 'Whirlpool' 9-max Seat #1 is the button
Seat 1: jethaz ($31.15 in chips) 
Seat 2: Roglus ($21.59 in chips) 
Seat 3: hirozo ($26.13 in chips) 
Seat 4: Dejacob ($29.31 in chips) 
Seat 5: TraderYao ($25 in chips) 
Seat 6: agurio ($33.41 in chips) 
Seat 7: Loholov ($23.14 in chips) 
Seat 8: chiyuki ($52.01 in chips) 
Seat 9: cr0lox ($27.22 in chips) 
Roglus: posts small blind $0.10
hirozo: posts big blind $0.25
*** HOLE CARDS ***
Dealt to chiyuki [6d Ac]
Dejacob: raises $0.50 to $0.75
TraderYao: folds 
agurio: folds 
Loholov: folds 
chiyuki: folds 
cr0lox: calls $0.75
jethaz: calls $0.75
Roglus: folds 
hirozo: folds 
*** FLOP *** [9s Kh 2s]
Dejacob: bets $1.75
cr0lox: folds 
jethaz: folds 
Uncalled bet ($1.75) returned to Dejacob
Dejacob collected $2.48 from pot
Dejacob: doesn't show hand 
*** SUMMARY ***
Total pot $2.60 | Rake $0.12 
Board [9s Kh 2s]
Seat 1: jethaz (button) folded on the Flop
Seat 2: Roglus (small blind) folded before Flop
Seat 3: hirozo (big blind) folded before Flop
Seat 4: Dejacob collected ($2.48)
Seat 5: TraderYao folded before Flop (didn't bet)
Seat 6: agurio folded before Flop (didn't bet)
Seat 7: Loholov folded before Flop (didn't bet)
Seat 8: chiyuki folded before Flop (didn't bet)
Seat 9: cr0lox folded on the Flop



PokerStars Zoom Hand #84298897038:  Hold'em No Limit ($0.10/$0.25) - 2012/08/05 13:42:36 JST [2012/08/05 0:42:36 ET]
Table 'Whirlpool' 9-max Seat #1 is the button
Seat 1: eduvazsilva ($10.70 in chips) 
Seat 2: agurio ($33.41 in chips) 
Seat 3: Loholov ($19.18 in chips) 
Seat 4: BlackZafiro ($25 in chips) 
Seat 5: stankfist420 ($24.94 in chips) 
Seat 6: TraderYao ($25 in chips) 
Seat 7: Nerkit ($12.82 in chips) 
Seat 8: TErr18 ($13.46 in chips) 
Seat 9: chiyuki ($52.01 in chips) 
agurio: posts small blind $0.10
Loholov: posts big blind $0.25
*** HOLE CARDS ***
Dealt to chiyuki [8d 5c]
BlackZafiro: folds 
stankfist420: folds 
TraderYao: folds 
Nerkit: folds 
TErr18: folds 
chiyuki: folds 
eduvazsilva: folds 
agurio: folds 
Uncalled bet ($0.15) returned to Loholov
Loholov collected $0.20 from pot
Loholov: doesn't show hand 
*** SUMMARY ***
Total pot $0.20 | Rake $0 
Seat 1: eduvazsilva (button) folded before Flop (didn't bet)
Seat 2: agurio (small blind) folded before Flop
Seat 3: Loholov (big blind) collected ($0.20)
Seat 4: BlackZafiro folded before Flop (didn't bet)
Seat 5: stankfist420 folded before Flop (didn't bet)
Seat 6: TraderYao folded before Flop (didn't bet)
Seat 7: Nerkit folded before Flop (didn't bet)
Seat 8: TErr18 folded before Flop (didn't bet)
Seat 9: chiyuki folded before Flop (didn't bet)



PokerStars Zoom Hand #84298901252:  Hold'em No Limit ($0.10/$0.25) - 2012/08/05 13:42:52 JST [2012/08/05 0:42:52 ET]
Table 'Whirlpool' 9-max Seat #1 is the button
Seat 1: KeLevro0 ($12.60 in chips) 
Seat 2: NastyMcNast ($30.80 in chips) 
Seat 3: jethaz ($49.70 in chips) 
Seat 4: BlackZafiro ($25 in chips) 
Seat 5: PetitAlejo ($25.99 in chips) 
Seat 6: Suhoff76 ($31.70 in chips) 
Seat 7: chiyuki ($52.01 in chips) 
Seat 8: Loholov ($23.14 in chips) 
Seat 9: jtedecaliss ($158.96 in chips) 
NastyMcNast: posts small blind $0.10
jethaz: posts big blind $0.25
*** HOLE CARDS ***
Dealt to chiyuki [6c Qd]
BlackZafiro: folds 
PetitAlejo: folds 
Suhoff76: folds 
chiyuki: folds 
Loholov: folds 
jtedecaliss: folds 
KeLevro0: folds 
NastyMcNast: folds 
Uncalled bet ($0.15) returned to jethaz
jethaz collected $0.20 from pot
jethaz: doesn't show hand 
*** SUMMARY ***
Total pot $0.20 | Rake $0 
Seat 1: KeLevro0 (button) folded before Flop (didn't bet)
Seat 2: NastyMcNast (small blind) folded before Flop
Seat 3: jethaz (big blind) collected ($0.20)
Seat 4: BlackZafiro folded before Flop (didn't bet)
Seat 5: PetitAlejo folded before Flop (didn't bet)
Seat 6: Suhoff76 folded before Flop (didn't bet)
Seat 7: chiyuki folded before Flop (didn't bet)
Seat 8: Loholov folded before Flop (didn't bet)
Seat 9: jtedecaliss folded before Flop (didn't bet)



PokerStars Zoom Hand #84298898058:  Hold'em No Limit ($0.10/$0.25) - 2012/08/05 13:42:40 JST [2012/08/05 0:42:40 ET]
Table 'Whirlpool' 9-max Seat #1 is the button
Seat 1: KAKamiro ($19.15 in chips) 
Seat 2: fwani ($25.35 in chips) 
Seat 3: eduvazsilva ($10.70 in chips) 
Seat 4: Roglus ($21.24 in chips) 
Seat 5: chiyuki ($52.01 in chips) 
Seat 6: Dejacob ($25 in chips) 
Seat 7: Th3Fog ($57.48 in chips) 
Seat 8: PetitAlejo ($25 in chips) 
Seat 9: ShockLaMuc ($27.90 in chips) 
fwani: posts small blind $0.10
eduvazsilva: posts big blind $0.25
*** HOLE CARDS ***
Dealt to chiyuki [Ac 3c]
Roglus: folds 
chiyuki: folds 
Dejacob: folds 
Th3Fog: folds 
PetitAlejo: raises $0.50 to $0.75
ShockLaMuc: folds 
KAKamiro: calls $0.75
fwani: folds 
eduvazsilva: folds 
*** FLOP *** [9c 8c 6c]
PetitAlejo: bets $1.25
KAKamiro: folds 
Uncalled bet ($1.25) returned to PetitAlejo
PetitAlejo collected $1.77 from pot
PetitAlejo: doesn't show hand 
*** SUMMARY ***
Total pot $1.85 | Rake $0.08 
Board [9c 8c 6c]
Seat 1: KAKamiro (button) folded on the Flop
Seat 2: fwani (small blind) folded before Flop
Seat 3: eduvazsilva (big blind) folded before Flop
Seat 4: Roglus folded before Flop (didn't bet)
Seat 5: chiyuki folded before Flop (didn't bet)
Seat 6: Dejacob folded before Flop (didn't bet)
Seat 7: Th3Fog folded before Flop (didn't bet)
Seat 8: PetitAlejo collected ($1.77)
Seat 9: ShockLaMuc folded before Flop (didn't bet)



PokerStars Zoom Hand #84298900207:  Hold'em No Limit ($0.10/$0.25) - 2012/08/05 13:42:48 JST [2012/08/05 0:42:48 ET]
Table 'Whirlpool' 9-max Seat #1 is the button
Seat 1: hirozo ($28.60 in chips) 
Seat 2: jtedecaliss ($159.06 in chips) 
Seat 3: TraderYao ($25 in chips) 
Seat 4: slapshot2011 ($43.31 in chips) 
Seat 5: wtu1986 ($26.49 in chips) 
Seat 6: chiyuki ($52.01 in chips) 
Seat 7: ShockLaMuc ($27.90 in chips) 
Seat 8: Suhoff76 ($31.70 in chips) 
Seat 9: timburonps ($33.77 in chips) 
jtedecaliss: posts small blind $0.10
TraderYao: posts big blind $0.25
*** HOLE CARDS ***
Dealt to chiyuki [Jd 8c]
slapshot2011: folds 
wtu1986: folds 
chiyuki: folds 
ShockLaMuc: raises $0.50 to $0.75
Suhoff76: folds 
timburonps: folds 
hirozo: folds 
jtedecaliss: folds 
TraderYao: folds 
Uncalled bet ($0.50) returned to ShockLaMuc
ShockLaMuc collected $0.60 from pot
ShockLaMuc: doesn't show hand 
*** SUMMARY ***
Total pot $0.60 | Rake $0 
Seat 1: hirozo (button) folded before Flop (didn't bet)
Seat 2: jtedecaliss (small blind) folded before Flop
Seat 3: TraderYao (big blind) folded before Flop
Seat 4: slapshot2011 folded before Flop (didn't bet)
Seat 5: wtu1986 folded before Flop (didn't bet)
Seat 6: chiyuki folded before Flop (didn't bet)
Seat 7: ShockLaMuc collected ($0.60)
Seat 8: Suhoff76 folded before Flop (didn't bet)
Seat 9: timburonps folded before Flop (didn't bet)



PokerStars Zoom Hand #84298902279:  Hold'em No Limit ($0.10/$0.25) - 2012/08/05 13:42:56 JST [2012/08/05 0:42:56 ET]
Table 'Whirlpool' 9-max Seat #1 is the button
Seat 1: BlackZafiro ($31.74 in chips) 
Seat 2: Suhoff76 ($31.70 in chips) 
Seat 3: Paranoix1990 ($14.88 in chips) 
Seat 4: TraderYao ($25 in chips) 
Seat 5: solawind ($19.68 in chips) 
Seat 6: Dejacob ($43.20 in chips) 
Seat 7: ygoegoe ($28.93 in chips) 
Seat 8: Tom1999 ($28.98 in chips) 
Seat 9: chiyuki ($52.01 in chips) 
Suhoff76: posts small blind $0.10
Paranoix1990: posts big blind $0.25
*** HOLE CARDS ***
Dealt to chiyuki [Jc 8c]
TraderYao: folds 
solawind: folds 
Dejacob: folds 
ygoegoe: folds 
Tom1999: folds 
chiyuki: raises $0.50 to $0.75
BlackZafiro: calls $0.75
Suhoff76: folds 
Paranoix1990: calls $0.50
*** FLOP *** [8h 8d Th]
Paranoix1990: checks 
chiyuki: bets $1.25
BlackZafiro: calls $1.25
Paranoix1990: folds 
*** TURN *** [8h 8d Th] [Ad]
chiyuki: bets $3
BlackZafiro: calls $3
*** RIVER *** [8h 8d Th Ad] [2h]
chiyuki: bets $4
BlackZafiro: raises $9 to $13
chiyuki: folds 
Uncalled bet ($9) returned to BlackZafiro
BlackZafiro collected $18 from pot
BlackZafiro: doesn't show hand 
*** SUMMARY ***
Total pot $18.85 | Rake $0.85 
Board [8h 8d Th Ad 2h]
Seat 1: BlackZafiro (button) collected ($18)
Seat 2: Suhoff76 (small blind) folded before Flop
Seat 3: Paranoix1990 (big blind) folded on the Flop
Seat 4: TraderYao folded before Flop (didn't bet)
Seat 5: solawind folded before Flop (didn't bet)
Seat 6: Dejacob folded before Flop (didn't bet)
Seat 7: ygoegoe folded before Flop (didn't bet)
Seat 8: Tom1999 folded before Flop (didn't bet)
Seat 9: chiyuki folded on the River



PokerStars Zoom Hand #84298920193:  Hold'em No Limit ($0.10/$0.25) - 2012/08/05 13:44:06 JST [2012/08/05 0:44:06 ET]
Table 'Whirlpool' 9-max Seat #1 is the button
Seat 1: Suhoff76 ($28.27 in chips) 
Seat 2: Landybob ($35.42 in chips) 
Seat 3: chiyuki ($43.01 in chips) 
Seat 4: gunbowler ($149.61 in chips) 
Seat 5: TraderYao ($25.35 in chips) 
Seat 6: simonzez ($31.02 in chips) 
Seat 7: Th3Fog ($64.80 in chips) 
Seat 8: wtu1986 ($26.39 in chips) 
Seat 9: Roglus ($69.96 in chips) 
Landybob: posts small blind $0.10
chiyuki: posts big blind $0.25
*** HOLE CARDS ***
Dealt to chiyuki [Qh 2h]
gunbowler: folds 
TraderYao: folds 
simonzez: calls $0.25
Th3Fog: folds 
wtu1986: folds 
Roglus: raises $0.75 to $1
Suhoff76: folds 
Landybob: folds 
chiyuki: folds 
simonzez: calls $0.75
*** FLOP *** [6h 7s 5c]
simonzez: checks 
Roglus: checks 
*** TURN *** [6h 7s 5c] [9h]
simonzez: checks 
Roglus: checks 
*** RIVER *** [6h 7s 5c 9h] [Jc]
simonzez: bets $1.25
Roglus: calls $1.25
*** SHOW DOWN ***
simonzez: shows [Ad 8c] (a straight, Five to Nine)
Roglus: mucks hand 
simonzez collected $4.63 from pot
*** SUMMARY ***
Total pot $4.85 | Rake $0.22 
Board [6h 7s 5c 9h Jc]
Seat 1: Suhoff76 (button) folded before Flop (didn't bet)
Seat 2: Landybob (small blind) folded before Flop
Seat 3: chiyuki (big blind) folded before Flop
Seat 4: gunbowler folded before Flop (didn't bet)
Seat 5: TraderYao folded before Flop (didn't bet)
Seat 6: simonzez showed [Ad 8c] and won ($4.63) with a straight, Five to Nine
Seat 7: Th3Fog folded before Flop (didn't bet)
Seat 8: wtu1986 folded before Flop (didn't bet)
Seat 9: Roglus mucked [Kc Js]



PokerStars Zoom Hand #84298928291:  Hold'em No Limit ($0.10/$0.25) - 2012/08/05 13:44:38 JST [2012/08/05 0:44:38 ET]
Table 'Whirlpool' 9-max Seat #1 is the button
Seat 1: BlOnDhOlIc ($43.80 in chips) 
Seat 2: Alvinpe85 ($50.20 in chips) 
Seat 3: NastyMcNast ($32.30 in chips) 
Seat 4: Tuan0109 ($12.07 in chips) 
Seat 5: cr0lox ($26.72 in chips) 
Seat 6: Loholov ($19.18 in chips) 
Seat 7: Suhoff76 ($28.27 in chips) 
Seat 8: chiyuki ($42.66 in chips) 
Seat 9: Nerkit ($12.94 in chips) 
Alvinpe85: posts small blind $0.10
NastyMcNast: posts big blind $0.25
*** HOLE CARDS ***
Dealt to chiyuki [2h 5d]
Tuan0109: folds 
cr0lox: folds 
Loholov: folds 
Suhoff76: folds 
chiyuki: folds 
Nerkit: folds 
BlOnDhOlIc: folds 
Alvinpe85: folds 
Uncalled bet ($0.15) returned to NastyMcNast
NastyMcNast collected $0.20 from pot
NastyMcNast: doesn't show hand 
*** SUMMARY ***
Total pot $0.20 | Rake $0 
Seat 1: BlOnDhOlIc (button) folded before Flop (didn't bet)
Seat 2: Alvinpe85 (small blind) folded before Flop
Seat 3: NastyMcNast (big blind) collected ($0.20)
Seat 4: Tuan0109 folded before Flop (didn't bet)
Seat 5: cr0lox folded before Flop (didn't bet)
Seat 6: Loholov folded before Flop (didn't bet)
Seat 7: Suhoff76 folded before Flop (didn't bet)
Seat 8: chiyuki folded before Flop (didn't bet)
Seat 9: Nerkit folded before Flop (didn't bet)



PokerStars Zoom Hand #84298929072:  Hold'em No Limit ($0.10/$0.25) - 2012/08/05 13:44:41 JST [2012/08/05 0:44:41 ET]
Table 'Whirlpool' 9-max Seat #1 is the button
Seat 1: Rudolf ($25 in chips) 
Seat 2: jtedecaliss ($159.06 in chips) 
Seat 3: KeLevro0 ($13.41 in chips) 
Seat 4: chiyuki ($42.66 in chips) 
Seat 5: agurio ($25 in chips) 
Seat 6: ChrisCDee ($26.69 in chips) 
Seat 7: BlackValaR ($6.93 in chips) 
Seat 8: wtu1986 ($24.65 in chips) 
Seat 9: roksmokndonk ($38.52 in chips) 
jtedecaliss: posts small blind $0.10
KeLevro0: posts big blind $0.25
*** HOLE CARDS ***
Dealt to chiyuki [6c 4h]
chiyuki: folds 
agurio: folds 
ChrisCDee: folds 
BlackValaR: folds 
wtu1986: folds 
roksmokndonk: folds 
Rudolf: raises $0.25 to $0.50
jtedecaliss: folds 
KeLevro0: folds 
Uncalled bet ($0.25) returned to Rudolf
Rudolf collected $0.60 from pot
Rudolf: doesn't show hand 
*** SUMMARY ***
Total pot $0.60 | Rake $0 
Seat 1: Rudolf (button) collected ($0.60)
Seat 2: jtedecaliss (small blind) folded before Flop
Seat 3: KeLevro0 (big blind) folded before Flop
Seat 4: chiyuki folded before Flop (didn't bet)
Seat 5: agurio folded before Flop (didn't bet)
Seat 6: ChrisCDee folded before Flop (didn't bet)
Seat 7: BlackValaR folded before Flop (didn't bet)
Seat 8: wtu1986 folded before Flop (didn't bet)
Seat 9: roksmokndonk folded before Flop (didn't bet)



PokerStars Zoom Hand #84298925675:  Hold'em No Limit ($0.10/$0.25) - 2012/08/05 13:44:27 JST [2012/08/05 0:44:27 ET]
Table 'Whirlpool' 9-max Seat #1 is the button
Seat 1: chiyuki ($42.66 in chips) 
Seat 2: NastyMcNast ($32.40 in chips) 
Seat 3: Anafim ($15.78 in chips) 
Seat 4: wtu1986 ($26.46 in chips) 
Seat 5: ChrisCDee ($26.65 in chips) 
Seat 6: deadmoneykid ($20.82 in chips) 
Seat 7: PetitAlejo ($36.69 in chips) 
Seat 8: TamiKarpen13 ($19.41 in chips) 
Seat 9: hirozo ($25 in chips) 
NastyMcNast: posts small blind $0.10
Anafim: posts big blind $0.25
*** HOLE CARDS ***
Dealt to chiyuki [3d Jh]
wtu1986: folds 
ChrisCDee: folds 
deadmoneykid: folds 
PetitAlejo: raises $0.50 to $0.75
TamiKarpen13: calls $0.75
hirozo: raises $2.35 to $3.10
chiyuki: folds 
NastyMcNast: folds 
Anafim: folds 
PetitAlejo: folds 
TamiKarpen13: calls $2.35
*** FLOP *** [8d 7h 4s]
TamiKarpen13: checks 
hirozo: bets $3.49
TamiKarpen13: folds 
Uncalled bet ($3.49) returned to hirozo
hirozo collected $6.97 from pot
hirozo: doesn't show hand 
*** SUMMARY ***
Total pot $7.30 | Rake $0.33 
Board [8d 7h 4s]
Seat 1: chiyuki (button) folded before Flop (didn't bet)
Seat 2: NastyMcNast (small blind) folded before Flop
Seat 3: Anafim (big blind) folded before Flop
Seat 4: wtu1986 folded before Flop (didn't bet)
Seat 5: ChrisCDee folded before Flop (didn't bet)
Seat 6: deadmoneykid folded before Flop (didn't bet)
Seat 7: PetitAlejo folded before Flop
Seat 8: TamiKarpen13 folded on the Flop
Seat 9: hirozo collected ($6.97)



PokerStars Zoom Hand #84298932244:  Hold'em No Limit ($0.10/$0.25) - 2012/08/05 13:44:53 JST [2012/08/05 0:44:53 ET]
Table 'Whirlpool' 9-max Seat #1 is the button
Seat 1: jethaz ($67.37 in chips) 
Seat 2: PetitAlejo ($25.67 in chips) 
Seat 3: cr0lox ($26.72 in chips) 
Seat 4: BlackValaR ($6.93 in chips) 
Seat 5: roksmokndonk ($38.52 in chips) 
Seat 6: Roglus ($67.71 in chips) 
Seat 7: chiyuki ($42.66 in chips) 
Seat 8: BlOnDhOlIc ($25 in chips) 
Seat 9: NastyMcNast ($63.54 in chips) 
PetitAlejo: posts small blind $0.10
cr0lox: posts big blind $0.25
*** HOLE CARDS ***
Dealt to chiyuki [Js 9d]
BlackValaR: folds 
roksmokndonk: folds 
Roglus: folds 
chiyuki: folds 
BlOnDhOlIc: folds 
NastyMcNast: folds 
jethaz: folds 
PetitAlejo: raises $0.50 to $0.75
cr0lox: folds 
Uncalled bet ($0.50) returned to PetitAlejo
PetitAlejo collected $0.50 from pot
PetitAlejo: doesn't show hand 
*** SUMMARY ***
Total pot $0.50 | Rake $0 
Seat 1: jethaz (button) folded before Flop (didn't bet)
Seat 2: PetitAlejo (small blind) collected ($0.50)
Seat 3: cr0lox (big blind) folded before Flop
Seat 4: BlackValaR folded before Flop (didn't bet)
Seat 5: roksmokndonk folded before Flop (didn't bet)
Seat 6: Roglus folded before Flop (didn't bet)
Seat 7: chiyuki folded before Flop (didn't bet)
Seat 8: BlOnDhOlIc folded before Flop (didn't bet)
Seat 9: NastyMcNast folded before Flop (didn't bet)



PokerStars Zoom Hand #84298923809:  Hold'em No Limit ($0.10/$0.25) - 2012/08/05 13:44:20 JST [2012/08/05 0:44:20 ET]
Table 'Whirlpool' 9-max Seat #1 is the button
Seat 1: Anafim ($15.78 in chips) 
Seat 2: chiyuki ($42.76 in chips) 
Seat 3: PetitAlejo ($36.94 in chips) 
Seat 4: Alvinpe85 ($28.16 in chips) 
Seat 5: munky3 ($45.93 in chips) 
Seat 6: Nerkit ($12.94 in chips) 
Seat 7: gazandim ($23.40 in chips) 
Seat 8: cr0lox ($26.72 in chips) 
Seat 9: jethaz ($30.75 in chips) 
chiyuki: posts small blind $0.10
PetitAlejo: posts big blind $0.25
*** HOLE CARDS ***
Dealt to chiyuki [8h 4s]
Alvinpe85: raises $0.50 to $0.75
munky3: folds 
Nerkit: folds 
gazandim: calls $0.75
cr0lox: folds 
jethaz: calls $0.75
Anafim: folds 
chiyuki: folds 
PetitAlejo: folds 
*** FLOP *** [Qc 5s 8s]
Alvinpe85: checks 
gazandim: bets $1.24
jethaz: calls $1.24
Alvinpe85: folds 
*** TURN *** [Qc 5s 8s] [Ad]
gazandim: bets $3.63
jethaz: raises $4.87 to $8.50
gazandim: calls $4.87
*** RIVER *** [Qc 5s 8s Ad] [3h]
gazandim: checks 
jethaz: bets $14
gazandim: folds 
Uncalled bet ($14) returned to jethaz
jethaz collected $21.09 from pot
jethaz: doesn't show hand 
*** SUMMARY ***
Total pot $22.08 | Rake $0.99 
Board [Qc 5s 8s Ad 3h]
Seat 1: Anafim (button) folded before Flop (didn't bet)
Seat 2: chiyuki (small blind) folded before Flop
Seat 3: PetitAlejo (big blind) folded before Flop
Seat 4: Alvinpe85 folded on the Flop
Seat 5: munky3 folded before Flop (didn't bet)
Seat 6: Nerkit folded before Flop (didn't bet)
Seat 7: gazandim folded on the River
Seat 8: cr0lox folded before Flop (didn't bet)
Seat 9: jethaz collected ($21.09)



PokerStars Zoom Hand #84298930931:  Hold'em No Limit ($0.10/$0.25) - 2012/08/05 13:44:48 JST [2012/08/05 0:44:48 ET]
Table 'Whirlpool' 9-max Seat #1 is the button
Seat 1: NastyMcNast ($63.54 in chips) 
Seat 2: KeLevro0 ($12.50 in chips) 
Seat 3: KAKamiro ($34.51 in chips) 
Seat 4: chiyuki ($42.66 in chips) 
Seat 5: PetitAlejo ($25 in chips) 
Seat 6: Loholov ($23.57 in chips) 
Seat 7: ChrisCDee ($26.69 in chips) 
Seat 8: Roglus ($67.71 in chips) 
Seat 9: jethaz ($67.37 in chips) 
KeLevro0: posts small blind $0.10
KAKamiro: posts big blind $0.25
*** HOLE CARDS ***
Dealt to chiyuki [Ac Ts]
chiyuki: folds 
PetitAlejo: folds 
Loholov: raises $0.50 to $0.75
ChrisCDee: folds 
Roglus: folds 
jethaz: folds 
NastyMcNast: folds 
KeLevro0: folds 
KAKamiro: calls $0.50
*** FLOP *** [4h 7h 3s]
KAKamiro: checks 
Loholov: bets $1
KAKamiro: folds 
Uncalled bet ($1) returned to Loholov
Loholov collected $1.53 from pot
Loholov: doesn't show hand 
*** SUMMARY ***
Total pot $1.60 | Rake $0.07 
Board [4h 7h 3s]
Seat 1: NastyMcNast (button) folded before Flop (didn't bet)
Seat 2: KeLevro0 (small blind) folded before Flop
Seat 3: KAKamiro (big blind) folded on the Flop
Seat 4: chiyuki folded before Flop (didn't bet)
Seat 5: PetitAlejo folded before Flop (didn't bet)
Seat 6: Loholov collected ($1.53)
Seat 7: ChrisCDee folded before Flop (didn't bet)
Seat 8: Roglus folded before Flop (didn't bet)
Seat 9: jethaz folded before Flop (didn't bet)



PokerStars Zoom Hand #84298933827:  Hold'em No Limit ($0.10/$0.25) - 2012/08/05 13:44:59 JST [2012/08/05 0:44:59 ET]
Table 'Whirlpool' 9-max Seat #1 is the button
Seat 1: Suhoff76 ($34.88 in chips) 
Seat 2: BlOnDhOlIc ($34.68 in chips) 
Seat 3: Roglus ($18.51 in chips) 
Seat 4: chiyuki ($42.66 in chips) 
Seat 5: PetitAlejo ($35.94 in chips) 
Seat 6: Alvinpe85 ($27.31 in chips) 
Seat 7: kamikkaze ($14.39 in chips) 
Seat 8: jeff0923 ($25.17 in chips) 
Seat 9: timburonps ($25 in chips) 
BlOnDhOlIc: posts small blind $0.10
Roglus: posts big blind $0.25
*** HOLE CARDS ***
Dealt to chiyuki [8s 7s]
chiyuki: folds 
PetitAlejo: folds 
Alvinpe85: raises $0.50 to $0.75
kamikkaze: folds 
jeff0923: folds 
timburonps: folds 
Suhoff76: folds 
BlOnDhOlIc: folds 
Roglus: folds 
Uncalled bet ($0.50) returned to Alvinpe85
Alvinpe85 collected $0.60 from pot
Alvinpe85: doesn't show hand 
*** SUMMARY ***
Total pot $0.60 | Rake $0 
Seat 1: Suhoff76 (button) folded before Flop (didn't bet)
Seat 2: BlOnDhOlIc (small blind) folded before Flop
Seat 3: Roglus (big blind) folded before Flop
Seat 4: chiyuki folded before Flop (didn't bet)
Seat 5: PetitAlejo folded before Flop (didn't bet)
Seat 6: Alvinpe85 collected ($0.60)
Seat 7: kamikkaze folded before Flop (didn't bet)
Seat 8: jeff0923 folded before Flop (didn't bet)
Seat 9: timburonps folded before Flop (didn't bet)



PokerStars Zoom Hand #84298939288:  Hold'em No Limit ($0.10/$0.25) - 2012/08/05 13:45:20 JST [2012/08/05 0:45:20 ET]
Table 'Whirlpool' 9-max Seat #1 is the button
Seat 1: timburonps ($29.10 in chips) 
Seat 2: chiyuki ($42.41 in chips) 
Seat 3: jeff0923 ($25.17 in chips) 
Seat 4: TraderYao ($27.12 in chips) 
Seat 5: hirozo ($25 in chips) 
Seat 6: agurio ($25 in chips) 
Seat 7: fwani ($26.96 in chips) 
Seat 8: slapshot2011 ($46.12 in chips) 
Seat 9: Lasutchik ($36.52 in chips) 
chiyuki: posts small blind $0.10
jeff0923: posts big blind $0.25
*** HOLE CARDS ***
Dealt to chiyuki [2c Qh]
TraderYao: raises $0.50 to $0.75
hirozo: folds 
agurio: folds 
fwani: folds 
slapshot2011: folds 
Lasutchik: folds 
timburonps: folds 
chiyuki: folds 
jeff0923: folds 
Uncalled bet ($0.50) returned to TraderYao
TraderYao collected $0.60 from pot
TraderYao: doesn't show hand 
*** SUMMARY ***
Total pot $0.60 | Rake $0 
Seat 1: timburonps (button) folded before Flop (didn't bet)
Seat 2: chiyuki (small blind) folded before Flop
Seat 3: jeff0923 (big blind) folded before Flop
Seat 4: TraderYao collected ($0.60)
Seat 5: hirozo folded before Flop (didn't bet)
Seat 6: agurio folded before Flop (didn't bet)
Seat 7: fwani folded before Flop (didn't bet)
Seat 8: slapshot2011 folded before Flop (didn't bet)
Seat 9: Lasutchik folded before Flop (didn't bet)



PokerStars Zoom Hand #84298934872:  Hold'em No Limit ($0.10/$0.25) - 2012/08/05 13:45:03 JST [2012/08/05 0:45:03 ET]
Table 'Whirlpool' 9-max Seat #1 is the button
Seat 1: wtu1986 ($27.13 in chips) 
Seat 2: ll_LaMeR_ll ($48.36 in chips) 
Seat 3: chiyuki ($42.66 in chips) 
Seat 4: roksmokndonk ($38.52 in chips) 
Seat 5: ChrisCDee ($26.69 in chips) 
Seat 6: PetitAlejo ($35.94 in chips) 
Seat 7: Suhoff76 ($34.88 in chips) 
Seat 8: Landybob ($36.10 in chips) 
Seat 9: KeLevro0 ($10.88 in chips) 
ll_LaMeR_ll: posts small blind $0.10
chiyuki: posts big blind $0.25
*** HOLE CARDS ***
Dealt to chiyuki [5h 2h]
roksmokndonk: folds 
ChrisCDee: folds 
PetitAlejo: folds 
Suhoff76: folds 
Landybob: folds 
KeLevro0: folds 
wtu1986: raises $0.37 to $0.62
ll_LaMeR_ll: raises $0.88 to $1.50
chiyuki: folds 
wtu1986: calls $0.88
*** FLOP *** [9d Ah Ad]
ll_LaMeR_ll: bets $1.75
wtu1986: folds 
Uncalled bet ($1.75) returned to ll_LaMeR_ll
ll_LaMeR_ll collected $3.10 from pot
ll_LaMeR_ll: doesn't show hand 
*** SUMMARY ***
Total pot $3.25 | Rake $0.15 
Board [9d Ah Ad]
Seat 1: wtu1986 (button) folded on the Flop
Seat 2: ll_LaMeR_ll (small blind) collected ($3.10)
Seat 3: chiyuki (big blind) folded before Flop
Seat 4: roksmokndonk folded before Flop (didn't bet)
Seat 5: ChrisCDee folded before Flop (didn't bet)
Seat 6: PetitAlejo folded before Flop (didn't bet)
Seat 7: Suhoff76 folded before Flop (didn't bet)
Seat 8: Landybob folded before Flop (didn't bet)
Seat 9: KeLevro0 folded before Flop (didn't bet)



PokerStars Zoom Hand #84298940322:  Hold'em No Limit ($0.10/$0.25) - 2012/08/05 13:45:24 JST [2012/08/05 0:45:24 ET]
Table 'Whirlpool' 9-max Seat #1 is the button
Seat 1: chiyuki ($42.31 in chips) 
Seat 2: PetitAlejo ($25 in chips) 
Seat 3: Jippyflip ($10.98 in chips) 
Seat 4: agurio ($25 in chips) 
Seat 5: TErr18 ($13.46 in chips) 
Seat 6: hirozo ($25 in chips) 
Seat 7: slapshot2011 ($46.12 in chips) 
Seat 8: Th3Fog ($55.29 in chips) 
Seat 9: Anafim ($18.63 in chips) 
PetitAlejo: posts small blind $0.10
Jippyflip: posts big blind $0.25
*** HOLE CARDS ***
Dealt to chiyuki [As 4c]
agurio: folds 
TErr18: folds 
hirozo: folds 
slapshot2011: folds 
Th3Fog: folds 
Anafim: folds 
chiyuki: folds 
PetitAlejo: raises $0.50 to $0.75
Jippyflip: folds 
Uncalled bet ($0.50) returned to PetitAlejo
PetitAlejo collected $0.50 from pot
PetitAlejo: doesn't show hand 
*** SUMMARY ***
Total pot $0.50 | Rake $0 
Seat 1: chiyuki (button) folded before Flop (didn't bet)
Seat 2: PetitAlejo (small blind) collected ($0.50)
Seat 3: Jippyflip (big blind) folded before Flop
Seat 4: agurio folded before Flop (didn't bet)
Seat 5: TErr18 folded before Flop (didn't bet)
Seat 6: hirozo folded before Flop (didn't bet)
Seat 7: slapshot2011 folded before Flop (didn't bet)
Seat 8: Th3Fog folded before Flop (didn't bet)
Seat 9: Anafim folded before Flop (didn't bet)



PokerStars Zoom Hand #84298941148:  Hold'em No Limit ($0.10/$0.25) - 2012/08/05 13:45:27 JST [2012/08/05 0:45:27 ET]
Table 'Whirlpool' 9-max Seat #1 is the button
Seat 1: TamiKarpen13 ($16.21 in chips) 
Seat 2: ChrisCDee ($26.69 in chips) 
Seat 3: BlackZafiro ($25 in chips) 
Seat 4: TErr18 ($13.46 in chips) 
Seat 5: lovinlife5 ($21.65 in chips) 
Seat 6: NastyMcNast ($31.98 in chips) 
Seat 7: Loholov ($24.35 in chips) 
Seat 8: a_tasmanian ($86.64 in chips) 
Seat 9: chiyuki ($42.31 in chips) 
ChrisCDee: posts small blind $0.10
BlackZafiro: posts big blind $0.25
*** HOLE CARDS ***
Dealt to chiyuki [Ac Kd]
TErr18: folds 
lovinlife5: folds 
NastyMcNast: folds 
Loholov: folds 
a_tasmanian: raises $0.25 to $0.50
chiyuki: raises $1.25 to $1.75
TamiKarpen13: folds 
ChrisCDee: folds 
BlackZafiro: folds 
a_tasmanian: calls $1.25
*** FLOP *** [Jh 6s Kc]
a_tasmanian: checks 
chiyuki: bets $2.25
a_tasmanian: folds 
Uncalled bet ($2.25) returned to chiyuki
chiyuki collected $3.68 from pot
chiyuki: doesn't show hand 
*** SUMMARY ***
Total pot $3.85 | Rake $0.17 
Board [Jh 6s Kc]
Seat 1: TamiKarpen13 (button) folded before Flop (didn't bet)
Seat 2: ChrisCDee (small blind) folded before Flop
Seat 3: BlackZafiro (big blind) folded before Flop
Seat 4: TErr18 folded before Flop (didn't bet)
Seat 5: lovinlife5 folded before Flop (didn't bet)
Seat 6: NastyMcNast folded before Flop (didn't bet)
Seat 7: Loholov folded before Flop (didn't bet)
Seat 8: a_tasmanian folded on the Flop
Seat 9: chiyuki collected ($3.68)



PokerStars Zoom Hand #84298955069:  Hold'em No Limit ($0.10/$0.25) - 2012/08/05 13:46:22 JST [2012/08/05 0:46:22 ET]
Table 'Whirlpool' 9-max Seat #1 is the button
Seat 1: BlOnDhOlIc ($45.84 in chips) 
Seat 2: chiyuki ($44.24 in chips) 
Seat 3: Roglus ($18.94 in chips) 
Seat 4: wtu1986 ($24.90 in chips) 
Seat 5: Alvinpe85 ($27.31 in chips) 
Seat 6: roksmokndonk ($38.37 in chips) 
Seat 7: BlackZafiro ($41.25 in chips) 
Seat 8: Dafleche ($15 in chips) 
Seat 9: jethaz ($51.95 in chips) 
chiyuki: posts small blind $0.10
Roglus: posts big blind $0.25
*** HOLE CARDS ***
Dealt to chiyuki [Tc Qd]
wtu1986: folds 
Alvinpe85: folds 
roksmokndonk: folds 
BlackZafiro: raises $0.50 to $0.75
Dafleche: folds 
jethaz: folds 
BlOnDhOlIc: folds 
chiyuki: folds 
Roglus: folds 
Uncalled bet ($0.50) returned to BlackZafiro
BlackZafiro collected $0.60 from pot
BlackZafiro: doesn't show hand 
*** SUMMARY ***
Total pot $0.60 | Rake $0 
Seat 1: BlOnDhOlIc (button) folded before Flop (didn't bet)
Seat 2: chiyuki (small blind) folded before Flop
Seat 3: Roglus (big blind) folded before Flop
Seat 4: wtu1986 folded before Flop (didn't bet)
Seat 5: Alvinpe85 folded before Flop (didn't bet)
Seat 6: roksmokndonk folded before Flop (didn't bet)
Seat 7: BlackZafiro collected ($0.60)
Seat 8: Dafleche folded before Flop (didn't bet)
Seat 9: jethaz folded before Flop (didn't bet)



PokerStars Zoom Hand #84298952476:  Hold'em No Limit ($0.10/$0.25) - 2012/08/05 13:46:12 JST [2012/08/05 0:46:12 ET]
Table 'Whirlpool' 9-max Seat #1 is the button
Seat 1: softdesign ($77.93 in chips) 
Seat 2: Alvinpe85 ($27.41 in chips) 
Seat 3: lovinlife5 ($21.15 in chips) 
Seat 4: Suhoff76 ($28.05 in chips) 
Seat 5: wildy29 ($12.69 in chips) 
Seat 6: NastyMcNast ($31.73 in chips) 
Seat 7: chiyuki ($44.24 in chips) 
Seat 8: PetitAlejo ($35.69 in chips) 
Seat 9: TamiKarpen13 ($15.96 in chips) 
Alvinpe85: posts small blind $0.10
lovinlife5: posts big blind $0.25
*** HOLE CARDS ***
Dealt to chiyuki [7c Qh]
Suhoff76: folds 
wildy29: calls $0.25
NastyMcNast: folds 
chiyuki: folds 
PetitAlejo: folds 
TamiKarpen13: folds 
softdesign: folds 
Alvinpe85: folds 
lovinlife5: checks 
*** FLOP *** [Ad Ah 9s]
lovinlife5: checks 
wildy29: checks 
*** TURN *** [Ad Ah 9s] [3c]
lovinlife5: checks 
wildy29: bets $0.25
lovinlife5: folds 
Uncalled bet ($0.25) returned to wildy29
wildy29 collected $0.57 from pot
wildy29: doesn't show hand 
*** SUMMARY ***
Total pot $0.60 | Rake $0.03 
Board [Ad Ah 9s 3c]
Seat 1: softdesign (button) folded before Flop (didn't bet)
Seat 2: Alvinpe85 (small blind) folded before Flop
Seat 3: lovinlife5 (big blind) folded on the Turn
Seat 4: Suhoff76 folded before Flop (didn't bet)
Seat 5: wildy29 collected ($0.57)
Seat 6: NastyMcNast folded before Flop (didn't bet)
Seat 7: chiyuki folded before Flop (didn't bet)
Seat 8: PetitAlejo folded before Flop (didn't bet)
Seat 9: TamiKarpen13 folded before Flop (didn't bet)



PokerStars Zoom Hand #84298953790:  Hold'em No Limit ($0.10/$0.25) - 2012/08/05 13:46:17 JST [2012/08/05 0:46:17 ET]
Table 'Whirlpool' 9-max Seat #1 is the button
Seat 1: jethaz ($51.95 in chips) 
Seat 2: NastyMcNast ($31.73 in chips) 
Seat 3: Suhoff76 ($28.05 in chips) 
Seat 4: TraderYao ($27.08 in chips) 
Seat 5: chiyuki ($44.24 in chips) 
Seat 6: Th3Fog ($22.61 in chips) 
Seat 7: Alvinpe85 ($27.31 in chips) 
Seat 8: timburonps ($29 in chips) 
Seat 9: PetitAlejo ($26.10 in chips) 
NastyMcNast: posts small blind $0.10
Suhoff76: posts big blind $0.25
*** HOLE CARDS ***
Dealt to chiyuki [Kc 7s]
TraderYao: folds 
chiyuki: folds 
Th3Fog: raises $0.47 to $0.72
Alvinpe85: folds 
timburonps: folds 
PetitAlejo: folds 
jethaz: folds 
NastyMcNast: folds 
Suhoff76: folds 
Uncalled bet ($0.47) returned to Th3Fog
Th3Fog collected $0.60 from pot
Th3Fog: doesn't show hand 
*** SUMMARY ***
Total pot $0.60 | Rake $0 
Seat 1: jethaz (button) folded before Flop (didn't bet)
Seat 2: NastyMcNast (small blind) folded before Flop
Seat 3: Suhoff76 (big blind) folded before Flop
Seat 4: TraderYao folded before Flop (didn't bet)
Seat 5: chiyuki folded before Flop (didn't bet)
Seat 6: Th3Fog collected ($0.60)
Seat 7: Alvinpe85 folded before Flop (didn't bet)
Seat 8: timburonps folded before Flop (didn't bet)
Seat 9: PetitAlejo folded before Flop (didn't bet)



PokerStars Zoom Hand #84298959127:  Hold'em No Limit ($0.10/$0.25) - 2012/08/05 13:46:38 JST [2012/08/05 0:46:38 ET]
Table 'Whirlpool' 9-max Seat #1 is the button
Seat 1: Suhoff76 ($34.88 in chips) 
Seat 2: Wilcox76607 ($19.60 in chips) 
Seat 3: chiyuki ($44.14 in chips) 
Seat 4: agurio ($31.36 in chips) 
Seat 5: Dejacob ($38.55 in chips) 
Seat 6: Jippyflip ($10.63 in chips) 
Seat 7: KeLevro0 ($13.06 in chips) 
Seat 8: BlOnDhOlIc ($62.92 in chips) 
Seat 9: Th3Fog ($22.96 in chips) 
Wilcox76607: posts small blind $0.10
chiyuki: posts big blind $0.25
*** HOLE CARDS ***
Dealt to chiyuki [6s 9c]
agurio: folds 
Dejacob: folds 
Jippyflip: folds 
KeLevro0: folds 
BlOnDhOlIc: raises $0.37 to $0.62
Th3Fog: folds 
Suhoff76: folds 
Wilcox76607: folds 
chiyuki: folds 
Uncalled bet ($0.37) returned to BlOnDhOlIc
BlOnDhOlIc collected $0.60 from pot
BlOnDhOlIc: doesn't show hand 
*** SUMMARY ***
Total pot $0.60 | Rake $0 
Seat 1: Suhoff76 (button) folded before Flop (didn't bet)
Seat 2: Wilcox76607 (small blind) folded before Flop
Seat 3: chiyuki (big blind) folded before Flop
Seat 4: agurio folded before Flop (didn't bet)
Seat 5: Dejacob folded before Flop (didn't bet)
Seat 6: Jippyflip folded before Flop (didn't bet)
Seat 7: KeLevro0 folded before Flop (didn't bet)
Seat 8: BlOnDhOlIc collected ($0.60)
Seat 9: Th3Fog folded before Flop (didn't bet)



PokerStars Zoom Hand #84298951216:  Hold'em No Limit ($0.10/$0.25) - 2012/08/05 13:46:07 JST [2012/08/05 0:46:07 ET]
Table 'Whirlpool' 9-max Seat #1 is the button
Seat 1: taksist889 ($28.85 in chips) 
Seat 2: hirozo ($28.62 in chips) 
Seat 3: Dejacob ($32.75 in chips) 
Seat 4: TamiKarpen13 ($15.96 in chips) 
Seat 5: lovinlife5 ($21.15 in chips) 
Seat 6: TraderYao ($27.37 in chips) 
Seat 7: KeLevro0 ($16.07 in chips) 
Seat 8: chiyuki ($44.24 in chips) 
Seat 9: NastyMcNast ($31.73 in chips) 
hirozo: posts small blind $0.10
Dejacob: posts big blind $0.25
*** HOLE CARDS ***
Dealt to chiyuki [Jd 8c]
TamiKarpen13: folds 
lovinlife5: folds 
TraderYao: folds 
KeLevro0: folds 
chiyuki: folds 
NastyMcNast: folds 
taksist889: folds 
hirozo: raises $0.25 to $0.50
Dejacob: calls $0.25
*** FLOP *** [Ts 8h 2h]
hirozo: checks 
Dejacob: checks 
*** TURN *** [Ts 8h 2h] [Ad]
hirozo: checks 
Dejacob: bets $0.75
hirozo: folds 
Uncalled bet ($0.75) returned to Dejacob
Dejacob collected $0.96 from pot
Dejacob: doesn't show hand 
*** SUMMARY ***
Total pot $1 | Rake $0.04 
Board [Ts 8h 2h Ad]
Seat 1: taksist889 (button) folded before Flop (didn't bet)
Seat 2: hirozo (small blind) folded on the Turn
Seat 3: Dejacob (big blind) collected ($0.96)
Seat 4: TamiKarpen13 folded before Flop (didn't bet)
Seat 5: lovinlife5 folded before Flop (didn't bet)
Seat 6: TraderYao folded before Flop (didn't bet)
Seat 7: KeLevro0 folded before Flop (didn't bet)
Seat 8: chiyuki folded before Flop (didn't bet)
Seat 9: NastyMcNast folded before Flop (didn't bet)



PokerStars Zoom Hand #84298949893:  Hold'em No Limit ($0.10/$0.25) - 2012/08/05 13:46:02 JST [2012/08/05 0:46:02 ET]
Table 'Whirlpool' 9-max Seat #1 is the button
Seat 1: Alvinpe85 ($27.41 in chips) 
Seat 2: BlackZafiro ($25 in chips) 
Seat 3: Anafim ($15.18 in chips) 
Seat 4: KeLevro0 ($10.53 in chips) 
Seat 5: ShockLaMuc ($28.21 in chips) 
Seat 6: chiyuki ($44.24 in chips) 
Seat 7: TraderYao ($28.43 in chips) 
Seat 8: Ellen1947 ($33.04 in chips) 
Seat 9: silvno31 ($40.12 in chips) 
BlackZafiro: posts small blind $0.10
Anafim: posts big blind $0.25
*** HOLE CARDS ***
Dealt to chiyuki [5s 6s]
KeLevro0: folds 
ShockLaMuc: calls $0.25
chiyuki: folds 
TraderYao: folds 
Ellen1947: calls $0.25
silvno31: folds 
Alvinpe85: folds 
BlackZafiro: folds 
Anafim: checks 
*** FLOP *** [8h Tc 4d]
Anafim: checks 
ShockLaMuc: checks 
Ellen1947: checks 
*** TURN *** [8h Tc 4d] [Kc]
Anafim: checks 
ShockLaMuc: checks 
Ellen1947: bets $0.60
Anafim: calls $0.60
ShockLaMuc: folds 
*** RIVER *** [8h Tc 4d Kc] [Js]
Anafim: checks 
Ellen1947: bets $1.10
Anafim: folds 
Uncalled bet ($1.10) returned to Ellen1947
Ellen1947 collected $1.96 from pot
Ellen1947: doesn't show hand 
*** SUMMARY ***
Total pot $2.05 | Rake $0.09 
Board [8h Tc 4d Kc Js]
Seat 1: Alvinpe85 (button) folded before Flop (didn't bet)
Seat 2: BlackZafiro (small blind) folded before Flop
Seat 3: Anafim (big blind) folded on the River
Seat 4: KeLevro0 folded before Flop (didn't bet)
Seat 5: ShockLaMuc folded on the Turn
Seat 6: chiyuki folded before Flop (didn't bet)
Seat 7: TraderYao folded before Flop (didn't bet)
Seat 8: Ellen1947 collected ($1.96)
Seat 9: silvno31 folded before Flop (didn't bet)



PokerStars Zoom Hand #84298964050:  Hold'em No Limit ($0.10/$0.25) - 2012/08/05 13:46:57 JST [2012/08/05 0:46:57 ET]
Table 'Whirlpool' 9-max Seat #1 is the button
Seat 1: chiyuki ($43.89 in chips) 
Seat 2: wildy29 ($13.11 in chips) 
Seat 3: timburonps ($29 in chips) 
Seat 4: softdesign ($78.03 in chips) 
Seat 5: cR!Ma*aRm ($37.91 in chips) 
Seat 6: Suhoff76 ($29.88 in chips) 
Seat 7: solawind ($12.37 in chips) 
Seat 8: Tuan0109 ($10.51 in chips) 
Seat 9: Th3Fog ($55.52 in chips) 
wildy29: posts small blind $0.10
timburonps: posts big blind $0.25
*** HOLE CARDS ***
Dealt to chiyuki [5h Ks]
softdesign: folds 
cR!Ma*aRm: raises $0.50 to $0.75
Suhoff76: folds 
solawind: folds 
Tuan0109: folds 
Th3Fog: folds 
chiyuki: folds 
wildy29: folds 
timburonps: folds 
Uncalled bet ($0.50) returned to cR!Ma*aRm
cR!Ma*aRm collected $0.60 from pot
cR!Ma*aRm: doesn't show hand 
*** SUMMARY ***
Total pot $0.60 | Rake $0 
Seat 1: chiyuki (button) folded before Flop (didn't bet)
Seat 2: wildy29 (small blind) folded before Flop
Seat 3: timburonps (big blind) folded before Flop
Seat 4: softdesign folded before Flop (didn't bet)
Seat 5: cR!Ma*aRm collected ($0.60)
Seat 6: Suhoff76 folded before Flop (didn't bet)
Seat 7: solawind folded before Flop (didn't bet)
Seat 8: Tuan0109 folded before Flop (didn't bet)
Seat 9: Th3Fog folded before Flop (didn't bet)



PokerStars Zoom Hand #84298965822:  Hold'em No Limit ($0.10/$0.25) - 2012/08/05 13:47:05 JST [2012/08/05 0:47:05 ET]
Table 'Whirlpool' 9-max Seat #1 is the button
Seat 1: seula i ($40.50 in chips) 
Seat 2: KeLevro0 ($12.81 in chips) 
Seat 3: Nerkit ($13.57 in chips) 
Seat 4: a_tasmanian ($82.94 in chips) 
Seat 5: wtu1986 ($25 in chips) 
Seat 6: TraderYao ($26.98 in chips) 
Seat 7: Ellen1947 ($34.15 in chips) 
Seat 8: jethaz ($60.79 in chips) 
Seat 9: chiyuki ($43.89 in chips) 
KeLevro0: posts small blind $0.10
Nerkit: posts big blind $0.25
*** HOLE CARDS ***
Dealt to chiyuki [3s 7s]
a_tasmanian: folds 
wtu1986: folds 
TraderYao: folds 
Ellen1947: folds 
jethaz: folds 
chiyuki: folds 
seula i: folds 
KeLevro0: raises $0.42 to $0.67
Nerkit: folds 
Uncalled bet ($0.42) returned to KeLevro0
KeLevro0 collected $0.50 from pot
KeLevro0: doesn't show hand 
*** SUMMARY ***
Total pot $0.50 | Rake $0 
Seat 1: seula i (button) folded before Flop (didn't bet)
Seat 2: KeLevro0 (small blind) collected ($0.50)
Seat 3: Nerkit (big blind) folded before Flop
Seat 4: a_tasmanian folded before Flop (didn't bet)
Seat 5: wtu1986 folded before Flop (didn't bet)
Seat 6: TraderYao folded before Flop (didn't bet)
Seat 7: Ellen1947 folded before Flop (didn't bet)
Seat 8: jethaz folded before Flop (didn't bet)
Seat 9: chiyuki folded before Flop (didn't bet)



PokerStars Zoom Hand #84298968457:  Hold'em No Limit ($0.10/$0.25) - 2012/08/05 13:47:15 JST [2012/08/05 0:47:15 ET]
Table 'Whirlpool' 9-max Seat #1 is the button
Seat 1: softdesign ($77.93 in chips) 
Seat 2: Th3Fog ($55.52 in chips) 
Seat 3: wtu1986 ($25 in chips) 
Seat 4: jethaz ($60.79 in chips) 
Seat 5: TamiKarpen13 ($6.66 in chips) 
Seat 6: BlOnDhOlIc ($47.20 in chips) 
Seat 7: chiyuki ($43.89 in chips) 
Seat 8: puffy5533 ($23.30 in chips) 
Seat 9: Roglus ($16.04 in chips) 
Th3Fog: posts small blind $0.10
wtu1986: posts big blind $0.25
*** HOLE CARDS ***
Dealt to chiyuki [Jc 5h]
jethaz: folds 
TamiKarpen13: folds 
BlOnDhOlIc: folds 
chiyuki: folds 
puffy5533: folds 
Roglus: folds 
softdesign: raises $0.50 to $0.75
Th3Fog: folds 
wtu1986: folds 
Uncalled bet ($0.50) returned to softdesign
softdesign collected $0.60 from pot
softdesign: doesn't show hand 
*** SUMMARY ***
Total pot $0.60 | Rake $0 
Seat 1: softdesign (button) collected ($0.60)
Seat 2: Th3Fog (small blind) folded before Flop
Seat 3: wtu1986 (big blind) folded before Flop
Seat 4: jethaz folded before Flop (didn't bet)
Seat 5: TamiKarpen13 folded before Flop (didn't bet)
Seat 6: BlOnDhOlIc folded before Flop (didn't bet)
Seat 7: chiyuki folded before Flop (didn't bet)
Seat 8: puffy5533 folded before Flop (didn't bet)
Seat 9: Roglus folded before Flop (didn't bet)



PokerStars Zoom Hand #84298957832:  Hold'em No Limit ($0.10/$0.25) - 2012/08/05 13:46:33 JST [2012/08/05 0:46:33 ET]
Table 'Whirlpool' 9-max Seat #1 is the button
Seat 1: Lasutchik ($36.27 in chips) 
Seat 2: gunbowler ($147.50 in chips) 
Seat 3: hirozo ($25 in chips) 
Seat 4: chiyuki ($44.14 in chips) 
Seat 5: goldstone ($26.12 in chips) 
Seat 6: KeLevro0 ($13.06 in chips) 
Seat 7: jethaz ($41 in chips) 
Seat 8: deadmoneykid ($20.57 in chips) 
Seat 9: BlOnDhOlIc ($62.92 in chips) 
gunbowler: posts small blind $0.10
hirozo: posts big blind $0.25
*** HOLE CARDS ***
Dealt to chiyuki [Kh 3d]
chiyuki: folds 
goldstone: calls $0.25
KeLevro0: folds 
jethaz: folds 
deadmoneykid: folds 
BlOnDhOlIc: folds 
Lasutchik: calls $0.25
gunbowler: folds 
hirozo: checks 
*** FLOP *** [4c 8c 3s]
hirozo: checks 
goldstone: bets $0.55
Lasutchik: calls $0.55
hirozo: folds 
*** TURN *** [4c 8c 3s] [5h]
goldstone: bets $1.28
Lasutchik: calls $1.28
*** RIVER *** [4c 8c 3s 5h] [Td]
goldstone: bets $3.79
Lasutchik: folds 
Uncalled bet ($3.79) returned to goldstone
goldstone collected $4.31 from pot
goldstone: doesn't show hand 
*** SUMMARY ***
Total pot $4.51 | Rake $0.20 
Board [4c 8c 3s 5h Td]
Seat 1: Lasutchik (button) folded on the River
Seat 2: gunbowler (small blind) folded before Flop
Seat 3: hirozo (big blind) folded on the Flop
Seat 4: chiyuki folded before Flop (didn't bet)
Seat 5: goldstone collected ($4.31)
Seat 6: KeLevro0 folded before Flop (didn't bet)
Seat 7: jethaz folded before Flop (didn't bet)
Seat 8: deadmoneykid folded before Flop (didn't bet)
Seat 9: BlOnDhOlIc folded before Flop (didn't bet)



PokerStars Zoom Hand #84298969469:  Hold'em No Limit ($0.10/$0.25) - 2012/08/05 13:47:19 JST [2012/08/05 0:47:19 ET]
Table 'Whirlpool' 9-max Seat #1 is the button
Seat 1: jethaz ($60.79 in chips) 
Seat 2: PetitAlejo ($35.34 in chips) 
Seat 3: Th3Fog ($22.71 in chips) 
Seat 4: Suhoff76 ($34.88 in chips) 
Seat 5: BlOnDhOlIc ($47.20 in chips) 
Seat 6: deadmoneykid ($40.25 in chips) 
Seat 7: TamiKarpen13 ($6.66 in chips) 
Seat 8: chiyuki ($43.89 in chips) 
Seat 9: flyinprits ($46.45 in chips) 
PetitAlejo: posts small blind $0.10
Th3Fog: posts big blind $0.25
*** HOLE CARDS ***
Dealt to chiyuki [5d 8h]
Suhoff76: folds 
BlOnDhOlIc: folds 
deadmoneykid: calls $0.25
TamiKarpen13: folds 
chiyuki: folds 
flyinprits: folds 
jethaz: folds 
PetitAlejo: folds 
Th3Fog: checks 
*** FLOP *** [Tc 2d Qc]
Th3Fog: checks 
deadmoneykid: bets $0.28
Th3Fog: folds 
Uncalled bet ($0.28) returned to deadmoneykid
deadmoneykid collected $0.57 from pot
deadmoneykid: doesn't show hand 
*** SUMMARY ***
Total pot $0.60 | Rake $0.03 
Board [Tc 2d Qc]
Seat 1: jethaz (button) folded before Flop (didn't bet)
Seat 2: PetitAlejo (small blind) folded before Flop
Seat 3: Th3Fog (big blind) folded on the Flop
Seat 4: Suhoff76 folded before Flop (didn't bet)
Seat 5: BlOnDhOlIc folded before Flop (didn't bet)
Seat 6: deadmoneykid collected ($0.57)
Seat 7: TamiKarpen13 folded before Flop (didn't bet)
Seat 8: chiyuki folded before Flop (didn't bet)
Seat 9: flyinprits folded before Flop (didn't bet)



PokerStars Zoom Hand #84298971231:  Hold'em No Limit ($0.10/$0.25) - 2012/08/05 13:47:26 JST [2012/08/05 0:47:26 ET]
Table 'Whirlpool' 9-max Seat #1 is the button
Seat 1: Dejacob ($33.21 in chips) 
Seat 2: wtu1986 ($25 in chips) 
Seat 3: lovinlife5 ($21.78 in chips) 
Seat 4: ChrisCDee ($25 in chips) 
Seat 5: fwani ($39.15 in chips) 
Seat 6: chiyuki ($43.89 in chips) 
Seat 7: Loholov ($18.08 in chips) 
Seat 8: BlOnDhOlIc ($47.20 in chips) 
Seat 9: TamiKarpen13 ($6.66 in chips) 
wtu1986: posts small blind $0.10
lovinlife5: posts big blind $0.25
*** HOLE CARDS ***
Dealt to chiyuki [6h 5h]
ChrisCDee: folds 
fwani: raises $0.35 to $0.60
chiyuki: folds 
Loholov: folds 
BlOnDhOlIc: folds 
TamiKarpen13: folds 
Dejacob: calls $0.60
wtu1986: folds 
lovinlife5: folds 
*** FLOP *** [9d 5d 3h]
fwani: bets $1.10
Dejacob: folds 
Uncalled bet ($1.10) returned to fwani
fwani collected $1.48 from pot
fwani: doesn't show hand 
*** SUMMARY ***
Total pot $1.55 | Rake $0.07 
Board [9d 5d 3h]
Seat 1: Dejacob (button) folded on the Flop
Seat 2: wtu1986 (small blind) folded before Flop
Seat 3: lovinlife5 (big blind) folded before Flop
Seat 4: ChrisCDee folded before Flop (didn't bet)
Seat 5: fwani collected ($1.48)
Seat 6: chiyuki folded before Flop (didn't bet)
Seat 7: Loholov folded before Flop (didn't bet)
Seat 8: BlOnDhOlIc folded before Flop (didn't bet)
Seat 9: TamiKarpen13 folded before Flop (didn't bet)



PokerStars Zoom Hand #84298975542:  Hold'em No Limit ($0.10/$0.25) - 2012/08/05 13:47:43 JST [2012/08/05 0:47:43 ET]
Table 'Whirlpool' 9-max Seat #1 is the button
Seat 1: Anafim ($14.23 in chips) 
Seat 2: timburonps ($28.18 in chips) 
Seat 3: Roglus ($16.04 in chips) 
Seat 4: slapshot2011 ($45.59 in chips) 
Seat 5: chiyuki ($43.64 in chips) 
Seat 6: fwani ($26.59 in chips) 
Seat 7: agurio ($32.28 in chips) 
Seat 8: Suhoff76 ($40.96 in chips) 
Seat 9: roksmokndonk ($37.12 in chips) 
timburonps: posts small blind $0.10
Roglus: posts big blind $0.25
*** HOLE CARDS ***
Dealt to chiyuki [4s Qs]
slapshot2011: folds 
chiyuki: folds 
fwani: folds 
agurio: folds 
Suhoff76: folds 
roksmokndonk: folds 
Anafim: raises $0.25 to $0.50
timburonps: folds 
Roglus: folds 
Uncalled bet ($0.25) returned to Anafim
Anafim collected $0.60 from pot
Anafim: doesn't show hand 
*** SUMMARY ***
Total pot $0.60 | Rake $0 
Seat 1: Anafim (button) collected ($0.60)
Seat 2: timburonps (small blind) folded before Flop
Seat 3: Roglus (big blind) folded before Flop
Seat 4: slapshot2011 folded before Flop (didn't bet)
Seat 5: chiyuki folded before Flop (didn't bet)
Seat 6: fwani folded before Flop (didn't bet)
Seat 7: agurio folded before Flop (didn't bet)
Seat 8: Suhoff76 folded before Flop (didn't bet)
Seat 9: roksmokndonk folded before Flop (didn't bet)



PokerStars Zoom Hand #84298977333:  Hold'em No Limit ($0.10/$0.25) - 2012/08/05 13:47:50 JST [2012/08/05 0:47:50 ET]
Table 'Whirlpool' 9-max Seat #1 is the button
Seat 1: hirozo ($25 in chips) 
Seat 2: Tom1999 ($20.86 in chips) 
Seat 3: PetitAlejo ($25 in chips) 
Seat 4: chiyuki ($43.64 in chips) 
Seat 5: Suhoff76 ($40.96 in chips) 
Seat 6: softdesign ($76.78 in chips) 
Seat 7: Nerkit ($11.59 in chips) 
Seat 8: Jippyflip ($10.28 in chips) 
Seat 9: agurio ($30.55 in chips) 
Tom1999: posts small blind $0.10
PetitAlejo: posts big blind $0.25
*** HOLE CARDS ***
Dealt to chiyuki [8s 7c]
chiyuki: folds 
Suhoff76: folds 
softdesign: folds 
Nerkit: folds 
Jippyflip: folds 
agurio: folds 
hirozo: raises $0.50 to $0.75
Tom1999: folds 
PetitAlejo: folds 
Uncalled bet ($0.50) returned to hirozo
hirozo collected $0.60 from pot
hirozo: doesn't show hand 
*** SUMMARY ***
Total pot $0.60 | Rake $0 
Seat 1: hirozo (button) collected ($0.60)
Seat 2: Tom1999 (small blind) folded before Flop
Seat 3: PetitAlejo (big blind) folded before Flop
Seat 4: chiyuki folded before Flop (didn't bet)
Seat 5: Suhoff76 folded before Flop (didn't bet)
Seat 6: softdesign folded before Flop (didn't bet)
Seat 7: Nerkit folded before Flop (didn't bet)
Seat 8: Jippyflip folded before Flop (didn't bet)
Seat 9: agurio folded before Flop (didn't bet)



PokerStars Zoom Hand #84298979920:  Hold'em No Limit ($0.10/$0.25) - 2012/08/05 13:48:00 JST [2012/08/05 0:48:00 ET]
Table 'Whirlpool' 9-max Seat #1 is the button
Seat 1: BlOnDhOlIc ($46.95 in chips) 
Seat 2: chiyuki ($43.64 in chips) 
Seat 3: Loholov ($15 in chips) 
Seat 4: KeLevro0 ($13.06 in chips) 
Seat 5: jethaz ($45.74 in chips) 
Seat 6: mariuka1 ($6.29 in chips) 
Seat 7: Paranoix1990 ($28.67 in chips) 
Seat 8: timburonps ($33.46 in chips) 
Seat 9: munky3 ($37.57 in chips) 
chiyuki: posts small blind $0.10
Loholov: posts big blind $0.25
*** HOLE CARDS ***
Dealt to chiyuki [8h 9s]
KeLevro0: folds 
jethaz: folds 
mariuka1: folds 
Paranoix1990: folds 
timburonps: folds 
munky3: folds 
BlOnDhOlIc: folds 
chiyuki: folds 
Uncalled bet ($0.15) returned to Loholov
Loholov collected $0.20 from pot
Loholov: doesn't show hand 
*** SUMMARY ***
Total pot $0.20 | Rake $0 
Seat 1: BlOnDhOlIc (button) folded before Flop (didn't bet)
Seat 2: chiyuki (small blind) folded before Flop
Seat 3: Loholov (big blind) collected ($0.20)
Seat 4: KeLevro0 folded before Flop (didn't bet)
Seat 5: jethaz folded before Flop (didn't bet)
Seat 6: mariuka1 folded before Flop (didn't bet)
Seat 7: Paranoix1990 folded before Flop (didn't bet)
Seat 8: timburonps folded before Flop (didn't bet)
Seat 9: munky3 folded before Flop (didn't bet)



PokerStars Zoom Hand #84298978374:  Hold'em No Limit ($0.10/$0.25) - 2012/08/05 13:47:54 JST [2012/08/05 0:47:54 ET]
Table 'Whirlpool' 9-max Seat #1 is the button
Seat 1: Tom1999 ($20.76 in chips) 
Seat 2: Ellen1947 ($32.86 in chips) 
Seat 3: softdesign ($76.78 in chips) 
Seat 4: agurio ($30.55 in chips) 
Seat 5: wtu1986 ($25.74 in chips) 
Seat 6: chiyuki ($43.64 in chips) 
Seat 7: Wilcox76607 ($15.75 in chips) 
Seat 8: Th3Fog ($55.42 in chips) 
Seat 9: BlackZafiro ($43.75 in chips) 
Ellen1947: posts small blind $0.10
softdesign: posts big blind $0.25
*** HOLE CARDS ***
Dealt to chiyuki [Jd 6s]
agurio: folds 
wtu1986: folds 
chiyuki: folds 
Wilcox76607: folds 
Th3Fog: folds 
BlackZafiro: folds 
Tom1999: folds 
Ellen1947: folds 
Uncalled bet ($0.15) returned to softdesign
softdesign collected $0.20 from pot
softdesign: doesn't show hand 
*** SUMMARY ***
Total pot $0.20 | Rake $0 
Seat 1: Tom1999 (button) folded before Flop (didn't bet)
Seat 2: Ellen1947 (small blind) folded before Flop
Seat 3: softdesign (big blind) collected ($0.20)
Seat 4: agurio folded before Flop (didn't bet)
Seat 5: wtu1986 folded before Flop (didn't bet)
Seat 6: chiyuki folded before Flop (didn't bet)
Seat 7: Wilcox76607 folded before Flop (didn't bet)
Seat 8: Th3Fog folded before Flop (didn't bet)
Seat 9: BlackZafiro folded before Flop (didn't bet)



PokerStars Zoom Hand #84298981168:  Hold'em No Limit ($0.10/$0.25) - 2012/08/05 13:48:05 JST [2012/08/05 0:48:05 ET]
Table 'Whirlpool' 9-max Seat #1 is the button
Seat 1: chiyuki ($43.54 in chips) 
Seat 2: Nerkit ($11.59 in chips) 
Seat 3: RikkStroken ($15 in chips) 
Seat 4: wtu1986 ($25 in chips) 
Seat 5: gunbowler ($146.80 in chips) 
Seat 6: fwani ($26.79 in chips) 
Seat 7: jethaz ($45.74 in chips) 
Seat 8: BlackZafiro ($43.75 in chips) 
Seat 9: Suhoff76 ($40.96 in chips) 
Nerkit: posts small blind $0.10
RikkStroken: posts big blind $0.25
*** HOLE CARDS ***
Dealt to chiyuki [8d 7c]
wtu1986: folds 
gunbowler: folds 
fwani: folds 
jethaz: folds 
BlackZafiro: folds 
Suhoff76: folds 
chiyuki: folds 
Nerkit: folds 
Uncalled bet ($0.15) returned to RikkStroken
RikkStroken collected $0.20 from pot
RikkStroken: doesn't show hand 
*** SUMMARY ***
Total pot $0.20 | Rake $0 
Seat 1: chiyuki (button) folded before Flop (didn't bet)
Seat 2: Nerkit (small blind) folded before Flop
Seat 3: RikkStroken (big blind) collected ($0.20)
Seat 4: wtu1986 folded before Flop (didn't bet)
Seat 5: gunbowler folded before Flop (didn't bet)
Seat 6: fwani folded before Flop (didn't bet)
Seat 7: jethaz folded before Flop (didn't bet)
Seat 8: BlackZafiro folded before Flop (didn't bet)
Seat 9: Suhoff76 folded before Flop (didn't bet)



PokerStars Zoom Hand #84298985021:  Hold'em No Limit ($0.10/$0.25) - 2012/08/05 13:48:21 JST [2012/08/05 0:48:21 ET]
Table 'Whirlpool' 9-max Seat #1 is the button
Seat 1: BlOnDhOlIc ($62.82 in chips) 
Seat 2: Jippyflip ($10.03 in chips) 
Seat 3: kamikkaze ($14.04 in chips) 
Seat 4: RikkStroken ($14.75 in chips) 
Seat 5: cr0lox ($24.50 in chips) 
Seat 6: TraderYao ($26.73 in chips) 
Seat 7: Suhoff76 ($26.70 in chips) 
Seat 8: chiyuki ($43.54 in chips) 
Seat 9: RomarioJa ($5.33 in chips) 
Jippyflip: posts small blind $0.10
kamikkaze: posts big blind $0.25
*** HOLE CARDS ***
Dealt to chiyuki [3h Js]
RikkStroken: folds 
cr0lox: folds 
TraderYao: folds 
Suhoff76: folds 
chiyuki: folds 
RomarioJa: folds 
BlOnDhOlIc: folds 
Jippyflip: folds 
Uncalled bet ($0.15) returned to kamikkaze
kamikkaze collected $0.20 from pot
kamikkaze: doesn't show hand 
*** SUMMARY ***
Total pot $0.20 | Rake $0 
Seat 1: BlOnDhOlIc (button) folded before Flop (didn't bet)
Seat 2: Jippyflip (small blind) folded before Flop
Seat 3: kamikkaze (big blind) collected ($0.20)
Seat 4: RikkStroken folded before Flop (didn't bet)
Seat 5: cr0lox folded before Flop (didn't bet)
Seat 6: TraderYao folded before Flop (didn't bet)
Seat 7: Suhoff76 folded before Flop (didn't bet)
Seat 8: chiyuki folded before Flop (didn't bet)
Seat 9: RomarioJa folded before Flop (didn't bet)



PokerStars Zoom Hand #84298982435:  Hold'em No Limit ($0.10/$0.25) - 2012/08/05 13:48:11 JST [2012/08/05 0:48:11 ET]
Table 'Whirlpool' 9-max Seat #1 is the button
Seat 1: cr0lox ($24.50 in chips) 
Seat 2: leo2095 ($13.93 in chips) 
Seat 3: Th3Fog ($55.42 in chips) 
Seat 4: BlackZafiro ($43.75 in chips) 
Seat 5: jethaz ($60.44 in chips) 
Seat 6: timburonps ($28.08 in chips) 
Seat 7: KeLevro0 ($13.06 in chips) 
Seat 8: 123progress ($26.85 in chips) 
Seat 9: chiyuki ($43.54 in chips) 
leo2095: posts small blind $0.10
Th3Fog: posts big blind $0.25
*** HOLE CARDS ***
Dealt to chiyuki [2s 6s]
BlackZafiro: folds 
jethaz: folds 
timburonps: folds 
KeLevro0: folds 
123progress: raises $0.50 to $0.75
chiyuki: folds 
cr0lox: folds 
leo2095: calls $0.65
Th3Fog: folds 
*** FLOP *** [As Ks Tc]
leo2095: checks 
123progress: checks 
*** TURN *** [As Ks Tc] [Ah]
leo2095: bets $0.50
123progress: folds 
Uncalled bet ($0.50) returned to leo2095
leo2095 collected $1.67 from pot
leo2095: doesn't show hand 
*** SUMMARY ***
Total pot $1.75 | Rake $0.08 
Board [As Ks Tc Ah]
Seat 1: cr0lox (button) folded before Flop (didn't bet)
Seat 2: leo2095 (small blind) collected ($1.67)
Seat 3: Th3Fog (big blind) folded before Flop
Seat 4: BlackZafiro folded before Flop (didn't bet)
Seat 5: jethaz folded before Flop (didn't bet)
Seat 6: timburonps folded before Flop (didn't bet)
Seat 7: KeLevro0 folded before Flop (didn't bet)
Seat 8: 123progress folded on the Turn
Seat 9: chiyuki folded before Flop (didn't bet)



PokerStars Zoom Hand #84298986327:  Hold'em No Limit ($0.10/$0.25) - 2012/08/05 13:48:26 JST [2012/08/05 0:48:26 ET]
Table 'Whirlpool' 9-max Seat #1 is the button
Seat 1: NastyMcNast ($30.88 in chips) 
Seat 2: wtu1986 ($25.74 in chips) 
Seat 3: TraderYao ($26.73 in chips) 
Seat 4: Th3Fog ($22.46 in chips) 
Seat 5: Anafim ($15.46 in chips) 
Seat 6: PetitAlejo ($25 in chips) 
Seat 7: chiyuki ($43.54 in chips) 
Seat 8: RomarioJa ($5.33 in chips) 
Seat 9: goldstone ($27.60 in chips) 
wtu1986: posts small blind $0.10
TraderYao: posts big blind $0.25
*** HOLE CARDS ***
Dealt to chiyuki [Js 3s]
Th3Fog: folds 
Anafim: folds 
PetitAlejo: folds 
chiyuki: folds 
RomarioJa: folds 
goldstone: folds 
NastyMcNast: raises $0.50 to $0.75
wtu1986: folds 
TraderYao: folds 
Uncalled bet ($0.50) returned to NastyMcNast
NastyMcNast collected $0.60 from pot
NastyMcNast: doesn't show hand 
*** SUMMARY ***
Total pot $0.60 | Rake $0 
Seat 1: NastyMcNast (button) collected ($0.60)
Seat 2: wtu1986 (small blind) folded before Flop
Seat 3: TraderYao (big blind) folded before Flop
Seat 4: Th3Fog folded before Flop (didn't bet)
Seat 5: Anafim folded before Flop (didn't bet)
Seat 6: PetitAlejo folded before Flop (didn't bet)
Seat 7: chiyuki folded before Flop (didn't bet)
Seat 8: RomarioJa folded before Flop (didn't bet)
Seat 9: goldstone folded before Flop (didn't bet)



PokerStars Zoom Hand #84298987843:  Hold'em No Limit ($0.10/$0.25) - 2012/08/05 13:48:32 JST [2012/08/05 0:48:32 ET]
Table 'Whirlpool' 9-max Seat #1 is the button
Seat 1: jethaz ($45.49 in chips) 
Seat 2: goldstone ($27.60 in chips) 
Seat 3: ChrisCDee ($25.35 in chips) 
Seat 4: RomarioJa ($12.16 in chips) 
Seat 5: KeLevro0 ($12.25 in chips) 
Seat 6: chiyuki ($43.54 in chips) 
Seat 7: Suhoff76 ($34.88 in chips) 
Seat 8: slapshot2011 ($43.74 in chips) 
Seat 9: Dejacob ($25.59 in chips) 
goldstone: posts small blind $0.10
ChrisCDee: posts big blind $0.25
*** HOLE CARDS ***
Dealt to chiyuki [9d 9h]
RomarioJa: folds 
KeLevro0: folds 
chiyuki: raises $0.50 to $0.75
Suhoff76: folds 
slapshot2011: folds 
Dejacob: folds 
jethaz: folds 
goldstone: folds 
ChrisCDee: folds 
Uncalled bet ($0.50) returned to chiyuki
chiyuki collected $0.60 from pot
chiyuki: doesn't show hand 
*** SUMMARY ***
Total pot $0.60 | Rake $0 
Seat 1: jethaz (button) folded before Flop (didn't bet)
Seat 2: goldstone (small blind) folded before Flop
Seat 3: ChrisCDee (big blind) folded before Flop
Seat 4: RomarioJa folded before Flop (didn't bet)
Seat 5: KeLevro0 folded before Flop (didn't bet)
Seat 6: chiyuki collected ($0.60)
Seat 7: Suhoff76 folded before Flop (didn't bet)
Seat 8: slapshot2011 folded before Flop (didn't bet)
Seat 9: Dejacob folded before Flop (didn't bet)



PokerStars Zoom Hand #84298972931:  Hold'em No Limit ($0.10/$0.25) - 2012/08/05 13:47:33 JST [2012/08/05 0:47:33 ET]
Table 'Whirlpool' 9-max Seat #1 is the button
Seat 1: BlOnDhOlIc ($33.08 in chips) 
Seat 2: Suhoff76 ($41.06 in chips) 
Seat 3: chiyuki ($43.89 in chips) 
Seat 4: taiali ($18.10 in chips) 
Seat 5: hirozo ($27.50 in chips) 
Seat 6: deadmoneykid ($42.94 in chips) 
Seat 7: TraderYao ($26.73 in chips) 
Seat 8: vit 111 ($8.96 in chips) 
Seat 9: NastyMcNast ($63.97 in chips) 
Suhoff76: posts small blind $0.10
chiyuki: posts big blind $0.25
*** HOLE CARDS ***
Dealt to chiyuki [5s 2h]
taiali: raises $0.37 to $0.62
hirozo: folds 
deadmoneykid: calls $0.62
TraderYao: folds 
vit 111: folds 
NastyMcNast: calls $0.62
BlOnDhOlIc: folds 
Suhoff76: folds 
chiyuki: folds 
*** FLOP *** [Ah 6h 4c]
taiali: checks 
deadmoneykid: checks 
NastyMcNast: checks 
*** TURN *** [Ah 6h 4c] [9d]
taiali: bets $1.05
deadmoneykid: calls $1.05
NastyMcNast: folds 
*** RIVER *** [Ah 6h 4c 9d] [4d]
taiali: bets $2.06
deadmoneykid: folds 
Uncalled bet ($2.06) returned to taiali
taiali collected $4.12 from pot
taiali: doesn't show hand 
*** SUMMARY ***
Total pot $4.31 | Rake $0.19 
Board [Ah 6h 4c 9d 4d]
Seat 1: BlOnDhOlIc (button) folded before Flop (didn't bet)
Seat 2: Suhoff76 (small blind) folded before Flop
Seat 3: chiyuki (big blind) folded before Flop
Seat 4: taiali collected ($4.12)
Seat 5: hirozo folded before Flop (didn't bet)
Seat 6: deadmoneykid folded on the River
Seat 7: TraderYao folded before Flop (didn't bet)
Seat 8: vit 111 folded before Flop (didn't bet)
Seat 9: NastyMcNast folded on the Turn



PokerStars Zoom Hand #84298994800:  Hold'em No Limit ($0.10/$0.25) - 2012/08/05 13:48:59 JST [2012/08/05 0:48:59 ET]
Table 'Whirlpool' 9-max Seat #1 is the button
Seat 1: Vahe50 ($14.75 in chips) 
Seat 2: agurio ($35.81 in chips) 
Seat 3: Anafim ($13.83 in chips) 
Seat 4: wtu1986 ($25.13 in chips) 
Seat 5: chiyuki ($43.89 in chips) 
Seat 6: BlackZafiro ($46.13 in chips) 
Seat 7: RikkStroken ($14.65 in chips) 
Seat 8: TErr18 ($13.39 in chips) 
Seat 9: Wilcox76607 ($15.75 in chips) 
agurio: posts small blind $0.10
Anafim: posts big blind $0.25
*** HOLE CARDS ***
Dealt to chiyuki [5d Jh]
wtu1986: folds 
chiyuki: folds 
BlackZafiro: folds 
RikkStroken: folds 
TErr18: folds 
Wilcox76607: raises $0.50 to $0.75
Vahe50: folds 
agurio: folds 
Anafim: folds 
Uncalled bet ($0.50) returned to Wilcox76607
Wilcox76607 collected $0.60 from pot
Wilcox76607: doesn't show hand 
*** SUMMARY ***
Total pot $0.60 | Rake $0 
Seat 1: Vahe50 (button) folded before Flop (didn't bet)
Seat 2: agurio (small blind) folded before Flop
Seat 3: Anafim (big blind) folded before Flop
Seat 4: wtu1986 folded before Flop (didn't bet)
Seat 5: chiyuki folded before Flop (didn't bet)
Seat 6: BlackZafiro folded before Flop (didn't bet)
Seat 7: RikkStroken folded before Flop (didn't bet)
Seat 8: TErr18 folded before Flop (didn't bet)
Seat 9: Wilcox76607 collected ($0.60)



PokerStars Zoom Hand #84298995835:  Hold'em No Limit ($0.10/$0.25) - 2012/08/05 13:49:03 JST [2012/08/05 0:49:03 ET]
Table 'Whirlpool' 9-max Seat #1 is the button
Seat 1: RomarioJa ($6.99 in chips) 
Seat 2: KAKamiro ($38.82 in chips) 
Seat 3: chiyuki ($43.89 in chips) 
Seat 4: agurio ($35.71 in chips) 
Seat 5: lovinlife5 ($20.28 in chips) 
Seat 6: timburonps ($29 in chips) 
Seat 7: peng2astic ($11.11 in chips) 
Seat 8: jethaz ($43.45 in chips) 
Seat 9: Dejacob ($38.55 in chips) 
KAKamiro: posts small blind $0.10
chiyuki: posts big blind $0.25
*** HOLE CARDS ***
Dealt to chiyuki [4d Js]
agurio: raises $0.75 to $1
lovinlife5: folds 
timburonps has timed out
timburonps: folds 
peng2astic: folds 
jethaz: folds 
Dejacob: folds 
RomarioJa: folds 
KAKamiro: calls $0.90
chiyuki: folds 
*** FLOP *** [Jh Kd 7d]
KAKamiro: checks 
agurio: bets $1.50
KAKamiro: folds 
Uncalled bet ($1.50) returned to agurio
agurio collected $2.15 from pot
agurio: doesn't show hand 
*** SUMMARY ***
Total pot $2.25 | Rake $0.10 
Board [Jh Kd 7d]
Seat 1: RomarioJa (button) folded before Flop (didn't bet)
Seat 2: KAKamiro (small blind) folded on the Flop
Seat 3: chiyuki (big blind) folded before Flop
Seat 4: agurio collected ($2.15)
Seat 5: lovinlife5 folded before Flop (didn't bet)
Seat 6: timburonps folded before Flop (didn't bet)
Seat 7: peng2astic folded before Flop (didn't bet)
Seat 8: jethaz folded before Flop (didn't bet)
Seat 9: Dejacob folded before Flop (didn't bet)



PokerStars Zoom Hand #84299003166:  Hold'em No Limit ($0.10/$0.25) - 2012/08/05 13:49:33 JST [2012/08/05 0:49:33 ET]
Table 'Whirlpool' 9-max Seat #1 is the button
Seat 1: jethaz ($43.20 in chips) 
Seat 2: chiyuki ($43.64 in chips) 
Seat 3: goldstone ($13.40 in chips) 
Seat 4: 123progress ($25 in chips) 
Seat 5: hirozo ($26.10 in chips) 
Seat 6: seula i ($60.60 in chips) 
Seat 7: kamikkaze ($14.39 in chips) 
Seat 8: Jippyflip ($9.58 in chips) 
Seat 9: flyinprits ($49.24 in chips) 
chiyuki: posts small blind $0.10
goldstone: posts big blind $0.25
*** HOLE CARDS ***
Dealt to chiyuki [8h Jd]
123progress: folds 
hirozo: folds 
seula i: folds 
kamikkaze: folds 
Jippyflip: folds 
flyinprits: folds 
jethaz: folds 
chiyuki: folds 
Uncalled bet ($0.15) returned to goldstone
goldstone collected $0.20 from pot
goldstone: doesn't show hand 
*** SUMMARY ***
Total pot $0.20 | Rake $0 
Seat 1: jethaz (button) folded before Flop (didn't bet)
Seat 2: chiyuki (small blind) folded before Flop
Seat 3: goldstone (big blind) collected ($0.20)
Seat 4: 123progress folded before Flop (didn't bet)
Seat 5: hirozo folded before Flop (didn't bet)
Seat 6: seula i folded before Flop (didn't bet)
Seat 7: kamikkaze folded before Flop (didn't bet)
Seat 8: Jippyflip folded before Flop (didn't bet)
Seat 9: flyinprits folded before Flop (didn't bet)



PokerStars Zoom Hand #84299002448:  Hold'em No Limit ($0.10/$0.25) - 2012/08/05 13:49:30 JST [2012/08/05 0:49:30 ET]
Table 'Whirlpool' 9-max Seat #1 is the button
Seat 1: Loholov ($20.13 in chips) 
Seat 2: KeLevro0 ($12.60 in chips) 
Seat 3: ChrisCDee ($25.38 in chips) 
Seat 4: jethaz ($43.20 in chips) 
Seat 5: DjJooni ($27.25 in chips) 
Seat 6: ygoegoe ($29.47 in chips) 
Seat 7: chiyuki ($43.64 in chips) 
Seat 8: solawind ($14.82 in chips) 
Seat 9: softdesign ($78.02 in chips) 
KeLevro0: posts small blind $0.10
ChrisCDee: posts big blind $0.25
*** HOLE CARDS ***
Dealt to chiyuki [2d 8s]
jethaz: folds 
DjJooni: calls $0.25
ygoegoe: folds 
chiyuki: folds 
solawind: folds 
softdesign: folds 
Loholov: raises $1 to $1.25
KeLevro0: folds 
ChrisCDee: folds 
DjJooni: raises $1 to $2.25
Loholov: calls $1
*** FLOP *** [3s 8d 2h]
DjJooni: bets $1.25
Loholov: folds 
Uncalled bet ($1.25) returned to DjJooni
DjJooni collected $4.63 from pot
DjJooni: doesn't show hand 
*** SUMMARY ***
Total pot $4.85 | Rake $0.22 
Board [3s 8d 2h]
Seat 1: Loholov (button) folded on the Flop
Seat 2: KeLevro0 (small blind) folded before Flop
Seat 3: ChrisCDee (big blind) folded before Flop
Seat 4: jethaz folded before Flop (didn't bet)
Seat 5: DjJooni collected ($4.63)
Seat 6: ygoegoe folded before Flop (didn't bet)
Seat 7: chiyuki folded before Flop (didn't bet)
Seat 8: solawind folded before Flop (didn't bet)
Seat 9: softdesign folded before Flop (didn't bet)



PokerStars Zoom Hand #84299011726:  Hold'em No Limit ($0.10/$0.25) - 2012/08/05 13:50:07 JST [2012/08/05 0:50:07 ET]
Table 'Whirlpool' 9-max Seat #1 is the button
Seat 1: timburonps ($28.75 in chips) 
Seat 2: PetitAlejo ($29.74 in chips) 
Seat 3: seula i ($40.45 in chips) 
Seat 4: Nerkit ($13.22 in chips) 
Seat 5: Anafim ($15.46 in chips) 
Seat 6: chiyuki ($43.54 in chips) 
Seat 7: Suhoff76 ($39.11 in chips) 
Seat 8: NastyMcNast ($25.49 in chips) 
Seat 9: solawind ($13.97 in chips) 
PetitAlejo: posts small blind $0.10
seula i: posts big blind $0.25
*** HOLE CARDS ***
Dealt to chiyuki [3s Qh]
Nerkit: raises $0.50 to $0.75
Anafim: folds 
chiyuki: folds 
Suhoff76: folds 
NastyMcNast: folds 
solawind: folds 
timburonps: folds 
PetitAlejo: folds 
seula i: folds 
Uncalled bet ($0.50) returned to Nerkit
Nerkit collected $0.60 from pot
Nerkit: doesn't show hand 
*** SUMMARY ***
Total pot $0.60 | Rake $0 
Seat 1: timburonps (button) folded before Flop (didn't bet)
Seat 2: PetitAlejo (small blind) folded before Flop
Seat 3: seula i (big blind) folded before Flop
Seat 4: Nerkit collected ($0.60)
Seat 5: Anafim folded before Flop (didn't bet)
Seat 6: chiyuki folded before Flop (didn't bet)
Seat 7: Suhoff76 folded before Flop (didn't bet)
Seat 8: NastyMcNast folded before Flop (didn't bet)
Seat 9: solawind folded before Flop (didn't bet)



PokerStars Zoom Hand #84299013905:  Hold'em No Limit ($0.10/$0.25) - 2012/08/05 13:50:16 JST [2012/08/05 0:50:16 ET]
Table 'Whirlpool' 9-max Seat #1 is the button
Seat 1: softdesign ($78.34 in chips) 
Seat 2: gandalfs9 ($24.75 in chips) 
Seat 3: timburonps ($41.99 in chips) 
Seat 4: chiyuki ($43.54 in chips) 
Seat 5: munky3 ($28.62 in chips) 
Seat 6: Suhoff76 ($39.11 in chips) 
Seat 7: jethaz ($45.04 in chips) 
Seat 8: hirozo ($25.85 in chips) 
Seat 9: NastyMcNast ($25.49 in chips) 
gandalfs9: posts small blind $0.10
timburonps: posts big blind $0.25
*** HOLE CARDS ***
Dealt to chiyuki [8h Ah]
chiyuki: folds 
munky3: folds 
Suhoff76: folds 
jethaz: folds 
hirozo: raises $0.50 to $0.75
NastyMcNast: folds 
softdesign: folds 
gandalfs9: folds 
timburonps: raises $1.69 to $2.44
hirozo: folds 
Uncalled bet ($1.69) returned to timburonps
timburonps collected $1.60 from pot
timburonps: doesn't show hand 
*** SUMMARY ***
Total pot $1.60 | Rake $0 
Seat 1: softdesign (button) folded before Flop (didn't bet)
Seat 2: gandalfs9 (small blind) folded before Flop
Seat 3: timburonps (big blind) collected ($1.60)
Seat 4: chiyuki folded before Flop (didn't bet)
Seat 5: munky3 folded before Flop (didn't bet)
Seat 6: Suhoff76 folded before Flop (didn't bet)
Seat 7: jethaz folded before Flop (didn't bet)
Seat 8: hirozo folded before Flop
Seat 9: NastyMcNast folded before Flop (didn't bet)



PokerStars Zoom Hand #84299006930:  Hold'em No Limit ($0.10/$0.25) - 2012/08/05 13:49:48 JST [2012/08/05 0:49:48 ET]
Table 'Whirlpool' 9-max Seat #1 is the button
Seat 1: chiyuki ($43.54 in chips) 
Seat 2: carlosrbr ($19.81 in chips) 
Seat 3: 123progress ($22.98 in chips) 
Seat 4: agurio ($30.30 in chips) 
Seat 5: Anafim ($13.48 in chips) 
Seat 6: ShockLaMuc ($27.86 in chips) 
Seat 7: TraderYao ($25 in chips) 
Seat 8: KeLevro0 ($12.50 in chips) 
Seat 9: NastyMcNast ($63 in chips) 
carlosrbr: posts small blind $0.10
123progress: posts big blind $0.25
*** HOLE CARDS ***
Dealt to chiyuki [3s 4c]
agurio: folds 
Anafim: folds 
ShockLaMuc: folds 
TraderYao: folds 
KeLevro0: folds 
NastyMcNast: raises $0.50 to $0.75
chiyuki: folds 
carlosrbr: folds 
123progress: raises $1.50 to $2.25
NastyMcNast: calls $1.50
*** FLOP *** [9d Ts 9c]
123progress: bets $3.29
NastyMcNast: calls $3.29
*** TURN *** [9d Ts 9c] [3c]
123progress: bets $8.01
NastyMcNast: raises $18.69 to $26.70
123progress: calls $9.43 and is all-in
Uncalled bet ($9.26) returned to NastyMcNast
*** RIVER *** [9d Ts 9c 3c] [Ad]
*** SHOW DOWN ***
123progress: shows [9s Ac] (a full house, Nines full of Aces)
NastyMcNast: mucks hand 
123progress collected $44.06 from pot
*** SUMMARY ***
Total pot $46.06 | Rake $2 
Board [9d Ts 9c 3c Ad]
Seat 1: chiyuki (button) folded before Flop (didn't bet)
Seat 2: carlosrbr (small blind) folded before Flop
Seat 3: 123progress (big blind) showed [9s Ac] and won ($44.06) with a full house, Nines full of Aces
Seat 4: agurio folded before Flop (didn't bet)
Seat 5: Anafim folded before Flop (didn't bet)
Seat 6: ShockLaMuc folded before Flop (didn't bet)
Seat 7: TraderYao folded before Flop (didn't bet)
Seat 8: KeLevro0 folded before Flop (didn't bet)
Seat 9: NastyMcNast mucked [Kc Kd]



PokerStars Zoom Hand #84299014882:  Hold'em No Limit ($0.10/$0.25) - 2012/08/05 13:50:20 JST [2012/08/05 0:50:20 ET]
Table 'Whirlpool' 9-max Seat #1 is the button
Seat 1: munky3 ($28.62 in chips) 
Seat 2: Dejacob ($43.40 in chips) 
Seat 3: chiyuki ($43.54 in chips) 
Seat 4: Suhoff76 ($29.18 in chips) 
Seat 5: RomarioJa ($5.33 in chips) 
Seat 6: fwani ($38.62 in chips) 
Seat 7: KeLevro0 ($13.41 in chips) 
Seat 8: Jippyflip ($9.58 in chips) 
Seat 9: agurio ($36.61 in chips) 
Dejacob: posts small blind $0.10
chiyuki: posts big blind $0.25
*** HOLE CARDS ***
Dealt to chiyuki [Th 2d]
Suhoff76: folds 
RomarioJa: folds 
fwani: raises $0.35 to $0.60
KeLevro0: folds 
Jippyflip: folds 
agurio: folds 
munky3: calls $0.60
Dejacob: folds 
chiyuki: folds 
*** FLOP *** [8h Qs 2h]
fwani: bets $1.20
munky3: calls $1.20
*** TURN *** [8h Qs 2h] [Qc]
fwani: bets $1.90
munky3: folds 
Uncalled bet ($1.90) returned to fwani
fwani collected $3.77 from pot
fwani: doesn't show hand 
*** SUMMARY ***
Total pot $3.95 | Rake $0.18 
Board [8h Qs 2h Qc]
Seat 1: munky3 (button) folded on the Turn
Seat 2: Dejacob (small blind) folded before Flop
Seat 3: chiyuki (big blind) folded before Flop
Seat 4: Suhoff76 folded before Flop (didn't bet)
Seat 5: RomarioJa folded before Flop (didn't bet)
Seat 6: fwani collected ($3.77)
Seat 7: KeLevro0 folded before Flop (didn't bet)
Seat 8: Jippyflip folded before Flop (didn't bet)
Seat 9: agurio folded before Flop (didn't bet)



PokerStars Zoom Hand #84299018243:  Hold'em No Limit ($0.10/$0.25) - 2012/08/05 13:50:33 JST [2012/08/05 0:50:33 ET]
Table 'Whirlpool' 9-max Seat #1 is the button
Seat 1: leo2095 ($12.45 in chips) 
Seat 2: NastyMcNast ($25.49 in chips) 
Seat 3: Loholov ($17.88 in chips) 
Seat 4: jethaz ($45.04 in chips) 
Seat 5: chiyuki ($43.29 in chips) 
Seat 6: flyinprits ($56.31 in chips) 
Seat 7: KeLevro0 ($12.15 in chips) 
Seat 8: agurio ($36.61 in chips) 
Seat 9: Roglus ($68.04 in chips) 
NastyMcNast: posts small blind $0.10
Loholov: posts big blind $0.25
*** HOLE CARDS ***
Dealt to chiyuki [7d Ks]
jethaz: folds 
chiyuki: folds 
flyinprits: folds 
KeLevro0: folds 
agurio: folds 
Roglus: folds 
leo2095: folds 
NastyMcNast: folds 
Uncalled bet ($0.15) returned to Loholov
Loholov collected $0.20 from pot
Loholov: doesn't show hand 
*** SUMMARY ***
Total pot $0.20 | Rake $0 
Seat 1: leo2095 (button) folded before Flop (didn't bet)
Seat 2: NastyMcNast (small blind) folded before Flop
Seat 3: Loholov (big blind) collected ($0.20)
Seat 4: jethaz folded before Flop (didn't bet)
Seat 5: chiyuki folded before Flop (didn't bet)
Seat 6: flyinprits folded before Flop (didn't bet)
Seat 7: KeLevro0 folded before Flop (didn't bet)
Seat 8: agurio folded before Flop (didn't bet)
Seat 9: Roglus folded before Flop (didn't bet)



PokerStars Zoom Hand #84299021155:  Hold'em No Limit ($0.10/$0.25) - 2012/08/05 13:50:46 JST [2012/08/05 0:50:46 ET]
Table 'Whirlpool' 9-max Seat #1 is the button
Seat 1: Wilcox76607 ($17.20 in chips) 
Seat 2: Déculotter69 ($14.75 in chips) 
Seat 3: deadmoneykid ($30.03 in chips) 
Seat 4: chiyuki ($43.29 in chips) 
Seat 5: 2997qwer ($12.25 in chips) 
Seat 6: puffy5533 ($22.20 in chips) 
Seat 7: ygoegoe ($31.29 in chips) 
Seat 8: cR!Ma*aRm ($39.23 in chips) 
Seat 9: Jippyflip ($9.33 in chips) 
Déculotter69: posts small blind $0.10
deadmoneykid: posts big blind $0.25
*** HOLE CARDS ***
Dealt to chiyuki [Kd Ts]
chiyuki: folds 
2997qwer: folds 
puffy5533: folds 
ygoegoe: folds 
cR!Ma*aRm: folds 
Jippyflip: folds 
Wilcox76607: folds 
Déculotter69: raises $0.50 to $0.75
deadmoneykid: folds 
Uncalled bet ($0.50) returned to Déculotter69
Déculotter69 collected $0.50 from pot
Déculotter69: doesn't show hand 
*** SUMMARY ***
Total pot $0.50 | Rake $0 
Seat 1: Wilcox76607 (button) folded before Flop (didn't bet)
Seat 2: Déculotter69 (small blind) collected ($0.50)
Seat 3: deadmoneykid (big blind) folded before Flop
Seat 4: chiyuki folded before Flop (didn't bet)
Seat 5: 2997qwer folded before Flop (didn't bet)
Seat 6: puffy5533 folded before Flop (didn't bet)
Seat 7: ygoegoe folded before Flop (didn't bet)
Seat 8: cR!Ma*aRm folded before Flop (didn't bet)
Seat 9: Jippyflip folded before Flop (didn't bet)



PokerStars Zoom Hand #84299008186:  Hold'em No Limit ($0.10/$0.25) - 2012/08/05 13:49:53 JST [2012/08/05 0:49:53 ET]
Table 'Whirlpool' 9-max Seat #1 is the button
Seat 1: Dejacob ($25 in chips) 
Seat 2: ladymadon107 ($19.07 in chips) 
Seat 3: Alvinpe85 ($42.91 in chips) 
Seat 4: agurio ($36.86 in chips) 
Seat 5: TraderYao ($25 in chips) 
Seat 6: timburonps ($41.99 in chips) 
Seat 7: RikkStroken ($15.35 in chips) 
Seat 8: Th3Fog ($22.11 in chips) 
Seat 9: chiyuki ($43.54 in chips) 
ladymadon107: posts small blind $0.10
Alvinpe85: posts big blind $0.25
*** HOLE CARDS ***
Dealt to chiyuki [9d Qh]
agurio: folds 
TraderYao: folds 
timburonps: folds 
RikkStroken: raises $0.50 to $0.75
Th3Fog: folds 
chiyuki: folds 
Dejacob: calls $0.75
ladymadon107: calls $0.65
Alvinpe85: calls $0.50
*** FLOP *** [4s 2d Qs]
ladymadon107: checks 
Alvinpe85: checks 
RikkStroken: bets $2
Dejacob: folds 
ladymadon107: folds 
Alvinpe85: calls $2
*** TURN *** [4s 2d Qs] [As]
Alvinpe85: checks 
RikkStroken: checks 
*** RIVER *** [4s 2d Qs As] [Ah]
Alvinpe85: checks 
RikkStroken: bets $2.60
Alvinpe85: calls $2.60
*** SHOW DOWN ***
RikkStroken: shows [Kh Qd] (two pair, Aces and Queens)
Alvinpe85: shows [7s 8s] (a flush, Ace high)
Alvinpe85 collected $11.65 from pot
*** SUMMARY ***
Total pot $12.20 | Rake $0.55 
Board [4s 2d Qs As Ah]
Seat 1: Dejacob (button) folded on the Flop
Seat 2: ladymadon107 (small blind) folded on the Flop
Seat 3: Alvinpe85 (big blind) showed [7s 8s] and won ($11.65) with a flush, Ace high
Seat 4: agurio folded before Flop (didn't bet)
Seat 5: TraderYao folded before Flop (didn't bet)
Seat 6: timburonps folded before Flop (didn't bet)
Seat 7: RikkStroken showed [Kh Qd] and lost with two pair, Aces and Queens
Seat 8: Th3Fog folded before Flop (didn't bet)
Seat 9: chiyuki folded before Flop (didn't bet)



PokerStars Zoom Hand #84299008938:  Hold'em No Limit ($0.10/$0.25) - 2012/08/05 13:49:56 JST [2012/08/05 0:49:56 ET]
Table 'Whirlpool' 9-max Seat #1 is the button
Seat 1: wtu1986 ($24.78 in chips) 
Seat 2: Rudolf ($50.46 in chips) 
Seat 3: Suhoff76 ($39.36 in chips) 
Seat 4: chiyuki ($43.54 in chips) 
Seat 5: RomarioJa ($8.82 in chips) 
Seat 6: fwani ($27.14 in chips) 
Seat 7: BlOnDhOlIc ($48.39 in chips) 
Seat 8: Anafim ($15.46 in chips) 
Seat 9: gunbowler ($144.85 in chips) 
Rudolf: posts small blind $0.10
Suhoff76: posts big blind $0.25
*** HOLE CARDS ***
Dealt to chiyuki [6s 3d]
chiyuki: folds 
RomarioJa: folds 
fwani: raises $0.35 to $0.60
BlOnDhOlIc: folds 
Anafim: folds 
gunbowler: raises $1.60 to $2.20
wtu1986: folds 
Rudolf: folds 
Suhoff76: folds 
fwani: calls $1.60
*** FLOP *** [7h Ts 4h]
fwani: checks 
gunbowler: bets $3.50
fwani: raises $4.40 to $7.90
gunbowler: calls $4.40
*** TURN *** [7h Ts 4h] [Ac]
fwani: checks 
gunbowler: checks 
*** RIVER *** [7h Ts 4h Ac] [2c]
fwani: checks 
gunbowler: checks 
*** SHOW DOWN ***
fwani: shows [Jh Jd] (a pair of Jacks)
gunbowler: shows [Qc Qh] (a pair of Queens)
gunbowler collected $19.63 from pot
*** SUMMARY ***
Total pot $20.55 | Rake $0.92 
Board [7h Ts 4h Ac 2c]
Seat 1: wtu1986 (button) folded before Flop (didn't bet)
Seat 2: Rudolf (small blind) folded before Flop
Seat 3: Suhoff76 (big blind) folded before Flop
Seat 4: chiyuki folded before Flop (didn't bet)
Seat 5: RomarioJa folded before Flop (didn't bet)
Seat 6: fwani showed [Jh Jd] and lost with a pair of Jacks
Seat 7: BlOnDhOlIc folded before Flop (didn't bet)
Seat 8: Anafim folded before Flop (didn't bet)
Seat 9: gunbowler showed [Qc Qh] and won ($19.63) with a pair of Queens



PokerStars Zoom Hand #84299010725:  Hold'em No Limit ($0.10/$0.25) - 2012/08/05 13:50:03 JST [2012/08/05 0:50:03 ET]
Table 'Whirlpool' 9-max Seat #1 is the button
Seat 1: Rudolf ($50.36 in chips) 
Seat 2: cr0lox ($23.50 in chips) 
Seat 3: KeLevro0 ($12.50 in chips) 
Seat 4: NastyMcNast ($25.49 in chips) 
Seat 5: goldstone ($27.85 in chips) 
Seat 6: BlOnDhOlIc ($48.39 in chips) 
Seat 7: Anafim ($15.46 in chips) 
Seat 8: chiyuki ($43.54 in chips) 
Seat 9: taksist889 ($18.42 in chips) 
cr0lox: posts small blind $0.10
KeLevro0: posts big blind $0.25
*** HOLE CARDS ***
Dealt to chiyuki [Ac 8d]
NastyMcNast: folds 
goldstone: raises $0.57 to $0.82
BlOnDhOlIc: calls $0.82
Anafim: folds 
chiyuki: folds 
taksist889: folds 
Rudolf: calls $0.82
cr0lox: folds 
KeLevro0: folds 
*** FLOP *** [2d 7d 7h]
goldstone: bets $1.84
BlOnDhOlIc: calls $1.84
Rudolf: folds 
*** TURN *** [2d 7d 7h] [Qc]
goldstone: checks 
BlOnDhOlIc: bets $3.50
goldstone: calls $3.50
*** RIVER *** [2d 7d 7h Qc] [4h]
goldstone: bets $11.33
BlOnDhOlIc: folds 
Uncalled bet ($11.33) returned to goldstone
goldstone collected $12.88 from pot
goldstone: doesn't show hand 
*** SUMMARY ***
Total pot $13.49 | Rake $0.61 
Board [2d 7d 7h Qc 4h]
Seat 1: Rudolf (button) folded on the Flop
Seat 2: cr0lox (small blind) folded before Flop
Seat 3: KeLevro0 (big blind) folded before Flop
Seat 4: NastyMcNast folded before Flop (didn't bet)
Seat 5: goldstone collected ($12.88)
Seat 6: BlOnDhOlIc folded on the River
Seat 7: Anafim folded before Flop (didn't bet)
Seat 8: chiyuki folded before Flop (didn't bet)
Seat 9: taksist889 folded before Flop (didn't bet)



PokerStars Zoom Hand #84299027965:  Hold'em No Limit ($0.10/$0.25) - 2012/08/05 13:51:13 JST [2012/08/05 0:51:13 ET]
Table 'Whirlpool' 9-max Seat #1 is the button
Seat 1: chiyuki ($43.19 in chips) 
Seat 2: Nerkit ($12.60 in chips) 
Seat 3: deadmoneykid ($44.69 in chips) 
Seat 4: goldstone ($13.75 in chips) 
Seat 5: Roglus ($70.02 in chips) 
Seat 6: Vahe50 ($28.17 in chips) 
Seat 7: timburonps ($42.74 in chips) 
Seat 8: KeLevro0 ($13.06 in chips) 
Seat 9: Loholov ($17.88 in chips) 
Nerkit: posts small blind $0.10
deadmoneykid: posts big blind $0.25
*** HOLE CARDS ***
Dealt to chiyuki [8s 6s]
goldstone: folds 
Roglus: raises $0.37 to $0.62
Vahe50: folds 
timburonps: folds 
KeLevro0: folds 
Loholov: folds 
chiyuki: folds 
Nerkit: folds 
deadmoneykid: folds 
Uncalled bet ($0.37) returned to Roglus
Roglus collected $0.60 from pot
Roglus: doesn't show hand 
*** SUMMARY ***
Total pot $0.60 | Rake $0 
Seat 1: chiyuki (button) folded before Flop (didn't bet)
Seat 2: Nerkit (small blind) folded before Flop
Seat 3: deadmoneykid (big blind) folded before Flop
Seat 4: goldstone folded before Flop (didn't bet)
Seat 5: Roglus collected ($0.60)
Seat 6: Vahe50 folded before Flop (didn't bet)
Seat 7: timburonps folded before Flop (didn't bet)
Seat 8: KeLevro0 folded before Flop (didn't bet)
Seat 9: Loholov folded before Flop (didn't bet)



PokerStars Zoom Hand #84299022450:  Hold'em No Limit ($0.10/$0.25) - 2012/08/05 13:50:51 JST [2012/08/05 0:50:51 ET]
Table 'Whirlpool' 9-max Seat #1 is the button
Seat 1: 2997qwer ($12.25 in chips) 
Seat 2: chiyuki ($43.29 in chips) 
Seat 3: RomarioJa ($5.23 in chips) 
Seat 4: Suhoff76 ($29.18 in chips) 
Seat 5: timburonps ($27.63 in chips) 
Seat 6: hirozo ($26.50 in chips) 
Seat 7: NastyMcNast ($25 in chips) 
Seat 8: munky3 ($26.82 in chips) 
Seat 9: fwani ($40.59 in chips) 
chiyuki: posts small blind $0.10
RomarioJa: posts big blind $0.25
*** HOLE CARDS ***
Dealt to chiyuki [8s Jc]
Suhoff76: folds 
timburonps: folds 
hirozo: folds 
NastyMcNast: folds 
munky3: calls $0.25
fwani: folds 
2997qwer: folds 
chiyuki: folds 
RomarioJa: checks 
*** FLOP *** [Qs 6s 6d]
RomarioJa: checks 
munky3: checks 
*** TURN *** [Qs 6s 6d] [Qc]
RomarioJa: checks 
munky3: checks 
*** RIVER *** [Qs 6s 6d Qc] [Jh]
RomarioJa: checks 
munky3: bets $0.50
RomarioJa: folds 
Uncalled bet ($0.50) returned to munky3
munky3 collected $0.57 from pot
munky3: doesn't show hand 
*** SUMMARY ***
Total pot $0.60 | Rake $0.03 
Board [Qs 6s 6d Qc Jh]
Seat 1: 2997qwer (button) folded before Flop (didn't bet)
Seat 2: chiyuki (small blind) folded before Flop
Seat 3: RomarioJa (big blind) folded on the River
Seat 4: Suhoff76 folded before Flop (didn't bet)
Seat 5: timburonps folded before Flop (didn't bet)
Seat 6: hirozo folded before Flop (didn't bet)
Seat 7: NastyMcNast folded before Flop (didn't bet)
Seat 8: munky3 collected ($0.57)
Seat 9: fwani folded before Flop (didn't bet)



PokerStars Zoom Hand #84299029728:  Hold'em No Limit ($0.10/$0.25) - 2012/08/05 13:51:20 JST [2012/08/05 0:51:20 ET]
Table 'Whirlpool' 9-max Seat #1 is the button
Seat 1: NastyMcNast ($25.01 in chips) 
Seat 2: Rudolf ($48.54 in chips) 
Seat 3: Lasutchik ($32.78 in chips) 
Seat 4: KeLevro0 ($12.90 in chips) 
Seat 5: Nerkit ($13.57 in chips) 
Seat 6: Th3Fog ($80.41 in chips) 
Seat 7: wtu1986 ($24.53 in chips) 
Seat 8: 2997qwer ($12.15 in chips) 
Seat 9: chiyuki ($43.19 in chips) 
Rudolf: posts small blind $0.10
Lasutchik: posts big blind $0.25
*** HOLE CARDS ***
Dealt to chiyuki [6h As]
KeLevro0: raises $0.50 to $0.75
Nerkit: folds 
Th3Fog: folds 
wtu1986: folds 
2997qwer: folds 
chiyuki: folds 
NastyMcNast: folds 
Rudolf: folds 
Lasutchik: folds 
Uncalled bet ($0.50) returned to KeLevro0
KeLevro0 collected $0.60 from pot
KeLevro0: doesn't show hand 
*** SUMMARY ***
Total pot $0.60 | Rake $0 
Seat 1: NastyMcNast (button) folded before Flop (didn't bet)
Seat 2: Rudolf (small blind) folded before Flop
Seat 3: Lasutchik (big blind) folded before Flop
Seat 4: KeLevro0 collected ($0.60)
Seat 5: Nerkit folded before Flop (didn't bet)
Seat 6: Th3Fog folded before Flop (didn't bet)
Seat 7: wtu1986 folded before Flop (didn't bet)
Seat 8: 2997qwer folded before Flop (didn't bet)
Seat 9: chiyuki folded before Flop (didn't bet)



PokerStars Zoom Hand #84299036414:  Hold'em No Limit ($0.10/$0.25) - 2012/08/05 13:51:47 JST [2012/08/05 0:51:47 ET]
Table 'Whirlpool' 9-max Seat #1 is the button
Seat 1: hirozo ($26.50 in chips) 
Seat 2: timburonps ($40.63 in chips) 
Seat 3: kamikkaze ($15.90 in chips) 
Seat 4: PetitAlejo ($25 in chips) 
Seat 5: NastyMcNast ($25.01 in chips) 
Seat 6: Dejacob ($44.61 in chips) 
Seat 7: chiyuki ($43.19 in chips) 
Seat 8: solawind ($14.32 in chips) 
Seat 9: Nerkit ($12.25 in chips) 
timburonps: posts small blind $0.10
kamikkaze: posts big blind $0.25
*** HOLE CARDS ***
Dealt to chiyuki [9d 6d]
PetitAlejo: folds 
NastyMcNast: folds 
Dejacob: raises $0.50 to $0.75
chiyuki: folds 
solawind: folds 
Nerkit: folds 
hirozo: folds 
timburonps: folds 
kamikkaze: calls $0.50
*** FLOP *** [As Ts Jh]
kamikkaze: checks 
Dejacob: bets $1
kamikkaze: calls $1
*** TURN *** [As Ts Jh] [Js]
kamikkaze: checks 
Dejacob: bets $2.25
kamikkaze: calls $2.25
*** RIVER *** [As Ts Jh Js] [3d]
kamikkaze: checks 
Dejacob: bets $5.75
kamikkaze: calls $5.75
*** SHOW DOWN ***
Dejacob: shows [9s 6s] (a flush, Ace high)
kamikkaze: mucks hand 
Dejacob collected $18.72 from pot
*** SUMMARY ***
Total pot $19.60 | Rake $0.88 
Board [As Ts Jh Js 3d]
Seat 1: hirozo (button) folded before Flop (didn't bet)
Seat 2: timburonps (small blind) folded before Flop
Seat 3: kamikkaze (big blind) mucked [Ah Qd]
Seat 4: PetitAlejo folded before Flop (didn't bet)
Seat 5: NastyMcNast folded before Flop (didn't bet)
Seat 6: Dejacob showed [9s 6s] and won ($18.72) with a flush, Ace high
Seat 7: chiyuki folded before Flop (didn't bet)
Seat 8: solawind folded before Flop (didn't bet)
Seat 9: Nerkit folded before Flop (didn't bet)



PokerStars Zoom Hand #84299041228:  Hold'em No Limit ($0.10/$0.25) - 2012/08/05 13:52:06 JST [2012/08/05 0:52:06 ET]
Table 'Whirlpool' 9-max Seat #1 is the button
Seat 1: RikkStroken ($9.65 in chips) 
Seat 2: Nerkit ($12.25 in chips) 
Seat 3: chiyuki ($43.19 in chips) 
Seat 4: KeLevro0 ($13.25 in chips) 
Seat 5: fwani ($29.59 in chips) 
Seat 6: NastyMcNast ($36.92 in chips) 
Seat 7: deadmoneykid ($44.44 in chips) 
Seat 8: Anafim ($15.11 in chips) 
Seat 9: timburonps ($28.30 in chips) 
Nerkit: posts small blind $0.10
chiyuki: posts big blind $0.25
*** HOLE CARDS ***
Dealt to chiyuki [5d Jd]
KeLevro0: folds 
fwani: folds 
NastyMcNast: folds 
deadmoneykid: folds 
Anafim: folds 
timburonps: folds 
RikkStroken: raises $0.50 to $0.75
Nerkit: raises $1.25 to $2
chiyuki: folds 
RikkStroken: folds 
Uncalled bet ($1.25) returned to Nerkit
Nerkit collected $1.75 from pot
Nerkit: doesn't show hand 
*** SUMMARY ***
Total pot $1.75 | Rake $0 
Seat 1: RikkStroken (button) folded before Flop
Seat 2: Nerkit (small blind) collected ($1.75)
Seat 3: chiyuki (big blind) folded before Flop
Seat 4: KeLevro0 folded before Flop (didn't bet)
Seat 5: fwani folded before Flop (didn't bet)
Seat 6: NastyMcNast folded before Flop (didn't bet)
Seat 7: deadmoneykid folded before Flop (didn't bet)
Seat 8: Anafim folded before Flop (didn't bet)
Seat 9: timburonps folded before Flop (didn't bet)



PokerStars Zoom Hand #84299038415:  Hold'em No Limit ($0.10/$0.25) - 2012/08/05 13:51:55 JST [2012/08/05 0:51:55 ET]
Table 'Whirlpool' 9-max Seat #1 is the button
Seat 1: Roglus ($70.72 in chips) 
Seat 2: Anafim ($15.21 in chips) 
Seat 3: NastyMcNast ($25.01 in chips) 
Seat 4: hirozo ($26.50 in chips) 
Seat 5: RikkStroken ($9.75 in chips) 
Seat 6: 2997qwer ($10 in chips) 
Seat 7: wildy29 ($18.36 in chips) 
Seat 8: chiyuki ($43.19 in chips) 
Seat 9: Suhoff76 ($28.83 in chips) 
Anafim: posts small blind $0.10
NastyMcNast: posts big blind $0.25
*** HOLE CARDS ***
Dealt to chiyuki [9s 8d]
hirozo: folds 
RikkStroken: folds 
2997qwer: folds 
wildy29: raises $0.50 to $0.75
chiyuki: folds 
Suhoff76: folds 
Roglus: folds 
Anafim: folds 
NastyMcNast: calls $0.50
*** FLOP *** [7d Ad Qh]
NastyMcNast: checks 
wildy29: bets $0.50
NastyMcNast: calls $0.50
*** TURN *** [7d Ad Qh] [As]
NastyMcNast: checks 
wildy29: bets $0.25
NastyMcNast: calls $0.25
*** RIVER *** [7d Ad Qh As] [6h]
NastyMcNast: checks 
wildy29: bets $0.50
NastyMcNast: calls $0.50
*** SHOW DOWN ***
wildy29: shows [Td Ac] (three of a kind, Aces)
NastyMcNast: mucks hand 
wildy29 collected $3.92 from pot
*** SUMMARY ***
Total pot $4.10 | Rake $0.18 
Board [7d Ad Qh As 6h]
Seat 1: Roglus (button) folded before Flop (didn't bet)
Seat 2: Anafim (small blind) folded before Flop
Seat 3: NastyMcNast (big blind) mucked [5d 6d]
Seat 4: hirozo folded before Flop (didn't bet)
Seat 5: RikkStroken folded before Flop (didn't bet)
Seat 6: 2997qwer folded before Flop (didn't bet)
Seat 7: wildy29 showed [Td Ac] and won ($3.92) with three of a kind, Aces
Seat 8: chiyuki folded before Flop (didn't bet)
Seat 9: Suhoff76 folded before Flop (didn't bet)



PokerStars Zoom Hand #84299047587:  Hold'em No Limit ($0.10/$0.25) - 2012/08/05 13:52:31 JST [2012/08/05 0:52:31 ET]
Table 'Whirlpool' 9-max Seat #1 is the button
Seat 1: Loholov ($17.84 in chips) 
Seat 2: solawind ($14.07 in chips) 
Seat 3: Alvinpe85 ($48.81 in chips) 
Seat 4: chiyuki ($42.94 in chips) 
Seat 5: Th3Fog ($80.06 in chips) 
Seat 6: Anafim ($15.11 in chips) 
Seat 7: BlOnDhOlIc ($26.50 in chips) 
Seat 8: Lasutchik ($32.43 in chips) 
Seat 9: timburonps ($40.28 in chips) 
solawind: posts small blind $0.10
Alvinpe85: posts big blind $0.25
*** HOLE CARDS ***
Dealt to chiyuki [Ad 7d]
chiyuki: folds 
Th3Fog: folds 
Anafim: raises $0.25 to $0.50
BlOnDhOlIc: folds 
Lasutchik: calls $0.50
timburonps: folds 
Loholov: folds 
solawind: folds 
Alvinpe85: folds 
*** FLOP *** [8c 4d 4s]
Anafim: checks 
Lasutchik: checks 
*** TURN *** [8c 4d 4s] [Tc]
Anafim: bets $0.50
Lasutchik: folds 
Uncalled bet ($0.50) returned to Anafim
Anafim collected $1.29 from pot
Anafim: doesn't show hand 
*** SUMMARY ***
Total pot $1.35 | Rake $0.06 
Board [8c 4d 4s Tc]
Seat 1: Loholov (button) folded before Flop (didn't bet)
Seat 2: solawind (small blind) folded before Flop
Seat 3: Alvinpe85 (big blind) folded before Flop
Seat 4: chiyuki folded before Flop (didn't bet)
Seat 5: Th3Fog folded before Flop (didn't bet)
Seat 6: Anafim collected ($1.29)
Seat 7: BlOnDhOlIc folded before Flop (didn't bet)
Seat 8: Lasutchik folded on the Turn
Seat 9: timburonps folded before Flop (didn't bet)



PokerStars Zoom Hand #84299039955:  Hold'em No Limit ($0.10/$0.25) - 2012/08/05 13:52:01 JST [2012/08/05 0:52:01 ET]
Table 'Whirlpool' 9-max Seat #1 is the button
Seat 1: timburonps ($27.38 in chips) 
Seat 2: Roglus ($70.72 in chips) 
Seat 3: Th3Fog ($52.97 in chips) 
Seat 4: roksmokndonk ($39.01 in chips) 
Seat 5: Nerkit ($12.25 in chips) 
Seat 6: chiyuki ($43.19 in chips) 
Seat 7: PetitAlejo ($29.64 in chips) 
Seat 8: ChrisCDee ($25 in chips) 
Seat 9: RomarioJa ($8.45 in chips) 
Roglus: posts small blind $0.10
Th3Fog: posts big blind $0.25
*** HOLE CARDS ***
Dealt to chiyuki [9h 4d]
roksmokndonk: calls $0.25
Nerkit: folds 
chiyuki: folds 
PetitAlejo: folds 
ChrisCDee: folds 
RomarioJa: folds 
timburonps: folds 
Roglus: calls $0.15
Th3Fog: checks 
*** FLOP *** [3c 9s 2c]
Roglus: checks 
Th3Fog: bets $0.25
roksmokndonk: calls $0.25
Roglus: folds 
*** TURN *** [3c 9s 2c] [3s]
Th3Fog: bets $0.70
roksmokndonk: calls $0.70
*** RIVER *** [3c 9s 2c 3s] [Qd]
Th3Fog: bets $1.49
roksmokndonk: folds 
Uncalled bet ($1.49) returned to Th3Fog
Th3Fog collected $2.53 from pot
Th3Fog: doesn't show hand 
*** SUMMARY ***
Total pot $2.65 | Rake $0.12 
Board [3c 9s 2c 3s Qd]
Seat 1: timburonps (button) folded before Flop (didn't bet)
Seat 2: Roglus (small blind) folded on the Flop
Seat 3: Th3Fog (big blind) collected ($2.53)
Seat 4: roksmokndonk folded on the River
Seat 5: Nerkit folded before Flop (didn't bet)
Seat 6: chiyuki folded before Flop (didn't bet)
Seat 7: PetitAlejo folded before Flop (didn't bet)
Seat 8: ChrisCDee folded before Flop (didn't bet)
Seat 9: RomarioJa folded before Flop (didn't bet)



PokerStars Zoom Hand #84299050328:  Hold'em No Limit ($0.10/$0.25) - 2012/08/05 13:52:42 JST [2012/08/05 0:52:42 ET]
Table 'Whirlpool' 9-max Seat #1 is the button
Seat 1: flyinprits ($44.87 in chips) 
Seat 2: chiyuki ($42.94 in chips) 
Seat 3: timburonps ($28.30 in chips) 
Seat 4: PetitAlejo ($25.75 in chips) 
Seat 5: BlackZafiro ($42.06 in chips) 
Seat 6: mariuka1 ($10.96 in chips) 
Seat 7: Dejacob ($53.58 in chips) 
Seat 8: goldstone ($33.82 in chips) 
Seat 9: munky3 ($26.79 in chips) 
chiyuki: posts small blind $0.10
timburonps: posts big blind $0.25
*** HOLE CARDS ***
Dealt to chiyuki [Ks 4h]
PetitAlejo: folds 
BlackZafiro: folds 
mariuka1: folds 
Dejacob: folds 
goldstone: folds 
munky3: folds 
flyinprits: folds 
chiyuki: folds 
Uncalled bet ($0.15) returned to timburonps
timburonps collected $0.20 from pot
timburonps: doesn't show hand 
*** SUMMARY ***
Total pot $0.20 | Rake $0 
Seat 1: flyinprits (button) folded before Flop (didn't bet)
Seat 2: chiyuki (small blind) folded before Flop
Seat 3: timburonps (big blind) collected ($0.20)
Seat 4: PetitAlejo folded before Flop (didn't bet)
Seat 5: BlackZafiro folded before Flop (didn't bet)
Seat 6: mariuka1 folded before Flop (didn't bet)
Seat 7: Dejacob folded before Flop (didn't bet)
Seat 8: goldstone folded before Flop (didn't bet)
Seat 9: munky3 folded before Flop (didn't bet)



PokerStars Zoom Hand #84299045812:  Hold'em No Limit ($0.10/$0.25) - 2012/08/05 13:52:24 JST [2012/08/05 0:52:24 ET]
Table 'Whirlpool' 9-max Seat #1 is the button
Seat 1: 2997qwer ($11.05 in chips) 
Seat 2: hirozo ($26.64 in chips) 
Seat 3: 123progress ($25 in chips) 
Seat 4: gandalfs9 ($21 in chips) 
Seat 5: chiyuki ($42.94 in chips) 
Seat 6: NastyMcNast ($26.93 in chips) 
Seat 7: agurio ($33.55 in chips) 
Seat 8: BlOnDhOlIc ($26.50 in chips) 
Seat 9: Dejacob ($53.58 in chips) 
hirozo: posts small blind $0.10
123progress: posts big blind $0.25
*** HOLE CARDS ***
Dealt to chiyuki [8d 5c]
gandalfs9: folds 
chiyuki: folds 
NastyMcNast: folds 
agurio: folds 
BlOnDhOlIc: folds 
Dejacob: folds 
2997qwer: raises $0.50 to $0.75
hirozo: calls $0.65
123progress: folds 
*** FLOP *** [2s Kc 7c]
hirozo: bets $1.11
2997qwer: folds 
Uncalled bet ($1.11) returned to hirozo
hirozo collected $1.67 from pot
hirozo: doesn't show hand 
*** SUMMARY ***
Total pot $1.75 | Rake $0.08 
Board [2s Kc 7c]
Seat 1: 2997qwer (button) folded on the Flop
Seat 2: hirozo (small blind) collected ($1.67)
Seat 3: 123progress (big blind) folded before Flop
Seat 4: gandalfs9 folded before Flop (didn't bet)
Seat 5: chiyuki folded before Flop (didn't bet)
Seat 6: NastyMcNast folded before Flop (didn't bet)
Seat 7: agurio folded before Flop (didn't bet)
Seat 8: BlOnDhOlIc folded before Flop (didn't bet)
Seat 9: Dejacob folded before Flop (didn't bet)



PokerStars Zoom Hand #84299052302:  Hold'em No Limit ($0.10/$0.25) - 2012/08/05 13:52:50 JST [2012/08/05 0:52:50 ET]
Table 'Whirlpool' 9-max Seat #1 is the button
Seat 1: chiyuki ($42.84 in chips) 
Seat 2: BlOnDhOlIc ($59.43 in chips) 
Seat 3: Nerkit ($11.81 in chips) 
Seat 4: agurio ($33.55 in chips) 
Seat 5: ChrisCDee ($26.49 in chips) 
Seat 6: RikkStroken ($13.15 in chips) 
Seat 7: fwani ($38.91 in chips) 
Seat 8: petersmiths ($48.92 in chips) 
Seat 9: kamikkaze ($12.50 in chips) 
BlOnDhOlIc: posts small blind $0.10
Nerkit: posts big blind $0.25
*** HOLE CARDS ***
Dealt to chiyuki [9h 3s]
agurio: folds 
ChrisCDee: folds 
RikkStroken: folds 
fwani: folds 
petersmiths: folds 
kamikkaze: raises $0.38 to $0.63
chiyuki: folds 
BlOnDhOlIc: folds 
Nerkit: folds 
Uncalled bet ($0.38) returned to kamikkaze
kamikkaze collected $0.60 from pot
kamikkaze: doesn't show hand 
*** SUMMARY ***
Total pot $0.60 | Rake $0 
Seat 1: chiyuki (button) folded before Flop (didn't bet)
Seat 2: BlOnDhOlIc (small blind) folded before Flop
Seat 3: Nerkit (big blind) folded before Flop
Seat 4: agurio folded before Flop (didn't bet)
Seat 5: ChrisCDee folded before Flop (didn't bet)
Seat 6: RikkStroken folded before Flop (didn't bet)
Seat 7: fwani folded before Flop (didn't bet)
Seat 8: petersmiths folded before Flop (didn't bet)
Seat 9: kamikkaze collected ($0.60)



PokerStars Zoom Hand #84299054135:  Hold'em No Limit ($0.10/$0.25) - 2012/08/05 13:52:57 JST [2012/08/05 0:52:57 ET]
Table 'Whirlpool' 9-max Seat #1 is the button
Seat 1: wtu1986 ($25.73 in chips) 
Seat 2: ChrisCDee ($26.49 in chips) 
Seat 3: cR!Ma*aRm ($36.63 in chips) 
Seat 4: BlackZafiro ($26.62 in chips) 
Seat 5: Dejacob ($30.58 in chips) 
Seat 6: Suhoff76 ($27.53 in chips) 
Seat 7: chiyuki ($42.84 in chips) 
Seat 8: Th3Fog ($80.06 in chips) 
Seat 9: KAKamiro ($38.77 in chips) 
ChrisCDee: posts small blind $0.10
cR!Ma*aRm: posts big blind $0.25
*** HOLE CARDS ***
Dealt to chiyuki [Js Qh]
BlackZafiro: folds 
Dejacob: raises $0.50 to $0.75
Suhoff76: folds 
chiyuki: folds 
Th3Fog: folds 
KAKamiro: folds 
wtu1986: folds 
ChrisCDee: folds 
cR!Ma*aRm: folds 
Uncalled bet ($0.50) returned to Dejacob
Dejacob collected $0.60 from pot
Dejacob: doesn't show hand 
*** SUMMARY ***
Total pot $0.60 | Rake $0 
Seat 1: wtu1986 (button) folded before Flop (didn't bet)
Seat 2: ChrisCDee (small blind) folded before Flop
Seat 3: cR!Ma*aRm (big blind) folded before Flop
Seat 4: BlackZafiro folded before Flop (didn't bet)
Seat 5: Dejacob collected ($0.60)
Seat 6: Suhoff76 folded before Flop (didn't bet)
Seat 7: chiyuki folded before Flop (didn't bet)
Seat 8: Th3Fog folded before Flop (didn't bet)
Seat 9: KAKamiro folded before Flop (didn't bet)



PokerStars Zoom Hand #84299058642:  Hold'em No Limit ($0.10/$0.25) - 2012/08/05 13:53:16 JST [2012/08/05 0:53:16 ET]
Table 'Whirlpool' 9-max Seat #1 is the button
Seat 1: timburonps ($28.40 in chips) 
Seat 2: silvno31 ($46.20 in chips) 
Seat 3: Alvinpe85 ($36.63 in chips) 
Seat 4: KeLevro0 ($8.93 in chips) 
Seat 5: Nerkit ($11.56 in chips) 
Seat 6: hirozo ($25 in chips) 
Seat 7: Th3Fog ($54.30 in chips) 
Seat 8: Vahe50 ($29.75 in chips) 
Seat 9: chiyuki ($42.84 in chips) 
silvno31: posts small blind $0.10
Alvinpe85: posts big blind $0.25
*** HOLE CARDS ***
Dealt to chiyuki [9d 2h]
KeLevro0: folds 
Nerkit: folds 
hirozo: folds 
Th3Fog: folds 
Vahe50: raises $0.50 to $0.75
chiyuki: folds 
timburonps: folds 
silvno31: folds 
Alvinpe85: folds 
Uncalled bet ($0.50) returned to Vahe50
Vahe50 collected $0.60 from pot
Vahe50: doesn't show hand 
*** SUMMARY ***
Total pot $0.60 | Rake $0 
Seat 1: timburonps (button) folded before Flop (didn't bet)
Seat 2: silvno31 (small blind) folded before Flop
Seat 3: Alvinpe85 (big blind) folded before Flop
Seat 4: KeLevro0 folded before Flop (didn't bet)
Seat 5: Nerkit folded before Flop (didn't bet)
Seat 6: hirozo folded before Flop (didn't bet)
Seat 7: Th3Fog folded before Flop (didn't bet)
Seat 8: Vahe50 collected ($0.60)
Seat 9: chiyuki folded before Flop (didn't bet)



PokerStars Zoom Hand #84299062152:  Hold'em No Limit ($0.10/$0.25) - 2012/08/05 13:53:30 JST [2012/08/05 0:53:30 ET]
Table 'Whirlpool' 9-max Seat #1 is the button
Seat 1: Anafim ($15.55 in chips) 
Seat 2: Suhoff76 ($27.28 in chips) 
Seat 3: PetitAlejo ($28.66 in chips) 
Seat 4: RikkStroken ($13.15 in chips) 
Seat 5: KeLevro0 ($12.90 in chips) 
Seat 6: ygoegoe ($30.34 in chips) 
Seat 7: goldstone ($14.88 in chips) 
Seat 8: chiyuki ($42.84 in chips) 
Seat 9: Lasutchik ($7.63 in chips) 
Suhoff76: posts small blind $0.10
PetitAlejo: posts big blind $0.25
*** HOLE CARDS ***
Dealt to chiyuki [Tc 5h]
RikkStroken: folds 
KeLevro0: folds 
ygoegoe: folds 
goldstone: folds 
chiyuki: folds 
Lasutchik: folds 
Anafim: folds 
Suhoff76: raises $0.32 to $0.57
PetitAlejo: folds 
Uncalled bet ($0.32) returned to Suhoff76
Suhoff76 collected $0.50 from pot
Suhoff76: doesn't show hand 
*** SUMMARY ***
Total pot $0.50 | Rake $0 
Seat 1: Anafim (button) folded before Flop (didn't bet)
Seat 2: Suhoff76 (small blind) collected ($0.50)
Seat 3: PetitAlejo (big blind) folded before Flop
Seat 4: RikkStroken folded before Flop (didn't bet)
Seat 5: KeLevro0 folded before Flop (didn't bet)
Seat 6: ygoegoe folded before Flop (didn't bet)
Seat 7: goldstone folded before Flop (didn't bet)
Seat 8: chiyuki folded before Flop (didn't bet)
Seat 9: Lasutchik folded before Flop (didn't bet)



PokerStars Zoom Hand #84299059657:  Hold'em No Limit ($0.10/$0.25) - 2012/08/05 13:53:20 JST [2012/08/05 0:53:20 ET]
Table 'Whirlpool' 9-max Seat #1 is the button
Seat 1: Suhoff76 ($27.28 in chips) 
Seat 2: timburonps ($28.40 in chips) 
Seat 3: BlOnDhOlIc ($43.99 in chips) 
Seat 4: Dejacob ($33.38 in chips) 
Seat 5: Dafleche ($15.88 in chips) 
Seat 6: chiyuki ($42.84 in chips) 
Seat 7: hirozo ($25 in chips) 
Seat 8: fwani ($29.84 in chips) 
Seat 9: PetitAlejo ($28.66 in chips) 
timburonps: posts small blind $0.10
BlOnDhOlIc: posts big blind $0.25
*** HOLE CARDS ***
Dealt to chiyuki [5s 7d]
Dejacob: raises $0.50 to $0.75
Dafleche: folds 
chiyuki: folds 
hirozo: folds 
fwani: folds 
PetitAlejo: folds 
Suhoff76: folds 
timburonps: calls $0.65
BlOnDhOlIc: folds 
*** FLOP *** [9s Ah 2c]
timburonps: checks 
Dejacob: bets $1
timburonps: folds 
Uncalled bet ($1) returned to Dejacob
Dejacob collected $1.67 from pot
Dejacob: doesn't show hand 
*** SUMMARY ***
Total pot $1.75 | Rake $0.08 
Board [9s Ah 2c]
Seat 1: Suhoff76 (button) folded before Flop (didn't bet)
Seat 2: timburonps (small blind) folded on the Flop
Seat 3: BlOnDhOlIc (big blind) folded before Flop
Seat 4: Dejacob collected ($1.67)
Seat 5: Dafleche folded before Flop (didn't bet)
Seat 6: chiyuki folded before Flop (didn't bet)
Seat 7: hirozo folded before Flop (didn't bet)
Seat 8: fwani folded before Flop (didn't bet)
Seat 9: PetitAlejo folded before Flop (didn't bet)



PokerStars Zoom Hand #84299064208:  Hold'em No Limit ($0.10/$0.25) - 2012/08/05 13:53:38 JST [2012/08/05 0:53:38 ET]
Table 'Whirlpool' 9-max Seat #1 is the button
Seat 1: RomarioJa ($14.08 in chips) 
Seat 2: Nerkit ($13 in chips) 
Seat 3: chiyuki ($42.84 in chips) 
Seat 4: Roglus ($15.61 in chips) 
Seat 5: Suhoff76 ($40.88 in chips) 
Seat 6: deadmoneykid ($40.12 in chips) 
Seat 7: KeLevro0 ($13.01 in chips) 
Seat 8: wtu1986 ($25.73 in chips) 
Seat 9: GoldNutter ($16.59 in chips) 
Nerkit: posts small blind $0.10
chiyuki: posts big blind $0.25
*** HOLE CARDS ***
Dealt to chiyuki [Td 4c]
Roglus: raises $0.50 to $0.75
Suhoff76: folds 
deadmoneykid: folds 
KeLevro0: folds 
wtu1986: folds 
GoldNutter: calls $0.75
RomarioJa: folds 
Nerkit: folds 
chiyuki: folds 
*** FLOP *** [Kc 8c 9h]
Roglus: bets $1
GoldNutter: folds 
Uncalled bet ($1) returned to Roglus
Roglus collected $1.77 from pot
Roglus: doesn't show hand 
*** SUMMARY ***
Total pot $1.85 | Rake $0.08 
Board [Kc 8c 9h]
Seat 1: RomarioJa (button) folded before Flop (didn't bet)
Seat 2: Nerkit (small blind) folded before Flop
Seat 3: chiyuki (big blind) folded before Flop
Seat 4: Roglus collected ($1.77)
Seat 5: Suhoff76 folded before Flop (didn't bet)
Seat 6: deadmoneykid folded before Flop (didn't bet)
Seat 7: KeLevro0 folded before Flop (didn't bet)
Seat 8: wtu1986 folded before Flop (didn't bet)
Seat 9: GoldNutter folded on the Flop



PokerStars Zoom Hand #84299072974:  Hold'em No Limit ($0.10/$0.25) - 2012/08/05 13:54:14 JST [2012/08/05 0:54:14 ET]
Table 'Whirlpool' 9-max Seat #1 is the button
Seat 1: chiyuki ($42.49 in chips) 
Seat 2: RikkStroken ($16.94 in chips) 
Seat 3: leo2095 ($16.96 in chips) 
Seat 4: Vahe50 ($30.10 in chips) 
Seat 5: Lasutchik ($7.63 in chips) 
Seat 6: Ellen1947 ($30.32 in chips) 
Seat 7: TErr18 ($17 in chips) 
Seat 8: BlOnDhOlIc ($25 in chips) 
Seat 9: taksist889 ($8.37 in chips) 
RikkStroken: posts small blind $0.10
leo2095: posts big blind $0.25
*** HOLE CARDS ***
Dealt to chiyuki [3c 4s]
Vahe50: folds 
Lasutchik: folds 
Ellen1947: folds 
TErr18: folds 
BlOnDhOlIc: folds 
taksist889: folds 
chiyuki: folds 
RikkStroken: folds 
Uncalled bet ($0.15) returned to leo2095
leo2095 collected $0.20 from pot
leo2095: doesn't show hand 
*** SUMMARY ***
Total pot $0.20 | Rake $0 
Seat 1: chiyuki (button) folded before Flop (didn't bet)
Seat 2: RikkStroken (small blind) folded before Flop
Seat 3: leo2095 (big blind) collected ($0.20)
Seat 4: Vahe50 folded before Flop (didn't bet)
Seat 5: Lasutchik folded before Flop (didn't bet)
Seat 6: Ellen1947 folded before Flop (didn't bet)
Seat 7: TErr18 folded before Flop (didn't bet)
Seat 8: BlOnDhOlIc folded before Flop (didn't bet)
Seat 9: taksist889 folded before Flop (didn't bet)



PokerStars Zoom Hand #84299071952:  Hold'em No Limit ($0.10/$0.25) - 2012/08/05 13:54:09 JST [2012/08/05 0:54:09 ET]
Table 'Whirlpool' 9-max Seat #1 is the button
Seat 1: BlOnDhOlIc ($57.80 in chips) 
Seat 2: Th3Fog ($54.30 in chips) 
Seat 3: Vahe50 ($16.05 in chips) 
Seat 4: TErr18 ($17 in chips) 
Seat 5: chiyuki ($42.49 in chips) 
Seat 6: goldstone ($14.88 in chips) 
Seat 7: PetitAlejo ($26.83 in chips) 
Seat 8: fwani ($36.50 in chips) 
Seat 9: Jippyflip ($7.70 in chips) 
Th3Fog: posts small blind $0.10
Vahe50: posts big blind $0.25
*** HOLE CARDS ***
Dealt to chiyuki [As 6s]
TErr18: folds 
chiyuki: folds 
goldstone: folds 
PetitAlejo: folds 
fwani: raises $0.35 to $0.60
Jippyflip: folds 
BlOnDhOlIc: folds 
Th3Fog: folds 
Vahe50: folds 
Uncalled bet ($0.35) returned to fwani
fwani collected $0.60 from pot
fwani: doesn't show hand 
*** SUMMARY ***
Total pot $0.60 | Rake $0 
Seat 1: BlOnDhOlIc (button) folded before Flop (didn't bet)
Seat 2: Th3Fog (small blind) folded before Flop
Seat 3: Vahe50 (big blind) folded before Flop
Seat 4: TErr18 folded before Flop (didn't bet)
Seat 5: chiyuki folded before Flop (didn't bet)
Seat 6: goldstone folded before Flop (didn't bet)
Seat 7: PetitAlejo folded before Flop (didn't bet)
Seat 8: fwani collected ($0.60)
Seat 9: Jippyflip folded before Flop (didn't bet)



PokerStars Zoom Hand #84299070739:  Hold'em No Limit ($0.10/$0.25) - 2012/08/05 13:54:04 JST [2012/08/05 0:54:04 ET]
Table 'Whirlpool' 9-max Seat #1 is the button
Seat 1: NastyMcNast ($35.65 in chips) 
Seat 2: chiyuki ($42.59 in chips) 
Seat 3: seula i ($59.85 in chips) 
Seat 4: ygoegoe ($30.34 in chips) 
Seat 5: PetitAlejo ($26.83 in chips) 
Seat 6: hirozo ($27.56 in chips) 
Seat 7: roksmokndonk ($37.46 in chips) 
Seat 8: Alvinpe85 ($36.28 in chips) 
Seat 9: giorgos_k ($14.65 in chips) 
chiyuki: posts small blind $0.10
seula i: posts big blind $0.25
*** HOLE CARDS ***
Dealt to chiyuki [7d Kh]
ygoegoe: folds 
PetitAlejo: folds 
hirozo: folds 
roksmokndonk: folds 
Alvinpe85: folds 
giorgos_k: calls $0.25
NastyMcNast: folds 
chiyuki: folds 
seula i: checks 
*** FLOP *** [Ac Kd Js]
seula i: checks 
giorgos_k: checks 
*** TURN *** [Ac Kd Js] [6d]
seula i: checks 
giorgos_k: checks 
*** RIVER *** [Ac Kd Js 6d] [9s]
seula i: checks 
giorgos_k: checks 
*** SHOW DOWN ***
seula i: shows [7c 8d] (high card Ace)
giorgos_k: shows [9c 8c] (a pair of Nines)
giorgos_k collected $0.57 from pot
*** SUMMARY ***
Total pot $0.60 | Rake $0.03 
Board [Ac Kd Js 6d 9s]
Seat 1: NastyMcNast (button) folded before Flop (didn't bet)
Seat 2: chiyuki (small blind) folded before Flop
Seat 3: seula i (big blind) showed [7c 8d] and lost with high card Ace
Seat 4: ygoegoe folded before Flop (didn't bet)
Seat 5: PetitAlejo folded before Flop (didn't bet)
Seat 6: hirozo folded before Flop (didn't bet)
Seat 7: roksmokndonk folded before Flop (didn't bet)
Seat 8: Alvinpe85 folded before Flop (didn't bet)
Seat 9: giorgos_k showed [9c 8c] and won ($0.57) with a pair of Nines



PokerStars Zoom Hand #84299074768:  Hold'em No Limit ($0.10/$0.25) - 2012/08/05 13:54:21 JST [2012/08/05 0:54:21 ET]
Table 'Whirlpool' 9-max Seat #1 is the button
Seat 1: Alvinpe85 ($36.28 in chips) 
Seat 2: hirozo ($29.12 in chips) 
Seat 3: PetitAlejo ($26.83 in chips) 
Seat 4: solawind ($13.22 in chips) 
Seat 5: Loholov ($15 in chips) 
Seat 6: BlOnDhOlIc ($25 in chips) 
Seat 7: chiyuki ($42.49 in chips) 
Seat 8: KeLevro0 ($8.93 in chips) 
Seat 9: Nerkit ($15.75 in chips) 
hirozo: posts small blind $0.10
PetitAlejo: posts big blind $0.25
*** HOLE CARDS ***
Dealt to chiyuki [Jd 2c]
solawind: folds 
Loholov: folds 
BlOnDhOlIc: folds 
chiyuki: folds 
KeLevro0: folds 
Nerkit: folds 
Alvinpe85: folds 
hirozo: raises $0.25 to $0.50
PetitAlejo: folds 
Uncalled bet ($0.25) returned to hirozo
hirozo collected $0.50 from pot
hirozo: doesn't show hand 
*** SUMMARY ***
Total pot $0.50 | Rake $0 
Seat 1: Alvinpe85 (button) folded before Flop (didn't bet)
Seat 2: hirozo (small blind) collected ($0.50)
Seat 3: PetitAlejo (big blind) folded before Flop
Seat 4: solawind folded before Flop (didn't bet)
Seat 5: Loholov folded before Flop (didn't bet)
Seat 6: BlOnDhOlIc folded before Flop (didn't bet)
Seat 7: chiyuki folded before Flop (didn't bet)
Seat 8: KeLevro0 folded before Flop (didn't bet)
Seat 9: Nerkit folded before Flop (didn't bet)



PokerStars Zoom Hand #84299078062:  Hold'em No Limit ($0.10/$0.25) - 2012/08/05 13:54:34 JST [2012/08/05 0:54:34 ET]
Table 'Whirlpool' 9-max Seat #1 is the button
Seat 1: Rudolf ($52.62 in chips) 
Seat 2: RikkStroken ($12.90 in chips) 
Seat 3: BlOnDhOlIc ($57.80 in chips) 
Seat 4: silvno31 ($47.34 in chips) 
Seat 5: 123progress ($25 in chips) 
Seat 6: NastyMcNast ($27.43 in chips) 
Seat 7: RomarioJa ($14.08 in chips) 
Seat 8: chiyuki ($42.49 in chips) 
Seat 9: Suhoff76 ($55.31 in chips) 
RikkStroken: posts small blind $0.10
BlOnDhOlIc: posts big blind $0.25
*** HOLE CARDS ***
Dealt to chiyuki [Ks Th]
silvno31: folds 
123progress: folds 
NastyMcNast: folds 
RomarioJa: folds 
chiyuki: folds 
Suhoff76: folds 
Rudolf: folds 
RikkStroken: folds 
Uncalled bet ($0.15) returned to BlOnDhOlIc
BlOnDhOlIc collected $0.20 from pot
BlOnDhOlIc: doesn't show hand 
*** SUMMARY ***
Total pot $0.20 | Rake $0 
Seat 1: Rudolf (button) folded before Flop (didn't bet)
Seat 2: RikkStroken (small blind) folded before Flop
Seat 3: BlOnDhOlIc (big blind) collected ($0.20)
Seat 4: silvno31 folded before Flop (didn't bet)
Seat 5: 123progress folded before Flop (didn't bet)
Seat 6: NastyMcNast folded before Flop (didn't bet)
Seat 7: RomarioJa folded before Flop (didn't bet)
Seat 8: chiyuki folded before Flop (didn't bet)
Seat 9: Suhoff76 folded before Flop (didn't bet)



PokerStars Zoom Hand #84299069768:  Hold'em No Limit ($0.10/$0.25) - 2012/08/05 13:54:00 JST [2012/08/05 0:54:00 ET]
Table 'Whirlpool' 9-max Seat #1 is the button
Seat 1: RomarioJa ($8.10 in chips) 
Seat 2: BlackZafiro ($25 in chips) 
Seat 3: wtu1986 ($25.73 in chips) 
Seat 4: BlOnDhOlIc ($43.74 in chips) 
Seat 5: chiyuki ($42.59 in chips) 
Seat 6: Vahe50 ($16.05 in chips) 
Seat 7: Anafim ($15.55 in chips) 
Seat 8: Nerkit ($15.75 in chips) 
Seat 9: Alvinpe85 ($36.28 in chips) 
BlackZafiro: posts small blind $0.10
wtu1986: posts big blind $0.25
*** HOLE CARDS ***
Dealt to chiyuki [Js 5d]
BlOnDhOlIc: folds 
chiyuki: folds 
Vahe50: folds 
Anafim: folds 
Nerkit: folds 
Alvinpe85: folds 
RomarioJa: folds 
BlackZafiro: raises $0.50 to $0.75
wtu1986: folds 
Uncalled bet ($0.50) returned to BlackZafiro
BlackZafiro collected $0.50 from pot
BlackZafiro: doesn't show hand 
*** SUMMARY ***
Total pot $0.50 | Rake $0 
Seat 1: RomarioJa (button) folded before Flop (didn't bet)
Seat 2: BlackZafiro (small blind) collected ($0.50)
Seat 3: wtu1986 (big blind) folded before Flop
Seat 4: BlOnDhOlIc folded before Flop (didn't bet)
Seat 5: chiyuki folded before Flop (didn't bet)
Seat 6: Vahe50 folded before Flop (didn't bet)
Seat 7: Anafim folded before Flop (didn't bet)
Seat 8: Nerkit folded before Flop (didn't bet)
Seat 9: Alvinpe85 folded before Flop (didn't bet)



PokerStars Zoom Hand #84299080848:  Hold'em No Limit ($0.10/$0.25) - 2012/08/05 13:54:45 JST [2012/08/05 0:54:45 ET]
Table 'Whirlpool' 9-max Seat #1 is the button
Seat 1: solawind ($12.97 in chips) 
Seat 2: Anafim ($12.50 in chips) 
Seat 3: 2997qwer ($10 in chips) 
Seat 4: PetitAlejo ($25.40 in chips) 
Seat 5: ll_LaMeR_ll ($83.82 in chips) 
Seat 6: Suhoff76 ($39.63 in chips) 
Seat 7: chiyuki ($42.49 in chips) 
Seat 8: Alvinpe85 ($49.74 in chips) 
Seat 9: Dejacob ($49.58 in chips) 
Anafim: posts small blind $0.10
2997qwer: posts big blind $0.25
*** HOLE CARDS ***
Dealt to chiyuki [Qh Js]
PetitAlejo: folds 
ll_LaMeR_ll: folds 
Suhoff76: folds 
chiyuki: folds 
Alvinpe85: raises $0.50 to $0.75
Dejacob: folds 
solawind: folds 
Anafim: folds 
2997qwer: folds 
Uncalled bet ($0.50) returned to Alvinpe85
Alvinpe85 collected $0.60 from pot
Alvinpe85: doesn't show hand 
*** SUMMARY ***
Total pot $0.60 | Rake $0 
Seat 1: solawind (button) folded before Flop (didn't bet)
Seat 2: Anafim (small blind) folded before Flop
Seat 3: 2997qwer (big blind) folded before Flop
Seat 4: PetitAlejo folded before Flop (didn't bet)
Seat 5: ll_LaMeR_ll folded before Flop (didn't bet)
Seat 6: Suhoff76 folded before Flop (didn't bet)
Seat 7: chiyuki folded before Flop (didn't bet)
Seat 8: Alvinpe85 collected ($0.60)
Seat 9: Dejacob folded before Flop (didn't bet)



PokerStars Zoom Hand #84299076515:  Hold'em No Limit ($0.10/$0.25) - 2012/08/05 13:54:28 JST [2012/08/05 0:54:28 ET]
Table 'Whirlpool' 9-max Seat #1 is the button
Seat 1: Jippyflip ($7.60 in chips) 
Seat 2: Rudolf ($52.72 in chips) 
Seat 3: agurio ($25 in chips) 
Seat 4: flyinprits ($44.87 in chips) 
Seat 5: Loholov ($15 in chips) 
Seat 6: Anafim ($15.55 in chips) 
Seat 7: BlackZafiro ($27.42 in chips) 
Seat 8: peng2astic ($9.91 in chips) 
Seat 9: chiyuki ($42.49 in chips) 
Rudolf: posts small blind $0.10
agurio: posts big blind $0.25
*** HOLE CARDS ***
Dealt to chiyuki [Th 7s]
flyinprits: folds 
Loholov: folds 
Anafim: folds 
BlackZafiro: folds 
peng2astic has timed out
peng2astic: folds 
chiyuki: folds 
Jippyflip: folds 
Rudolf: folds 
Uncalled bet ($0.15) returned to agurio
agurio collected $0.20 from pot
agurio: doesn't show hand 
*** SUMMARY ***
Total pot $0.20 | Rake $0 
Seat 1: Jippyflip (button) folded before Flop (didn't bet)
Seat 2: Rudolf (small blind) folded before Flop
Seat 3: agurio (big blind) collected ($0.20)
Seat 4: flyinprits folded before Flop (didn't bet)
Seat 5: Loholov folded before Flop (didn't bet)
Seat 6: Anafim folded before Flop (didn't bet)
Seat 7: BlackZafiro folded before Flop (didn't bet)
Seat 8: peng2astic folded before Flop (didn't bet)
Seat 9: chiyuki folded before Flop (didn't bet)



PokerStars Zoom Hand #84299079616:  Hold'em No Limit ($0.10/$0.25) - 2012/08/05 13:54:40 JST [2012/08/05 0:54:40 ET]
Table 'Whirlpool' 9-max Seat #1 is the button
Seat 1: 2997qwer ($10 in chips) 
Seat 2: Lasutchik ($33.52 in chips) 
Seat 3: timburonps ($42.64 in chips) 
Seat 4: PetitAlejo ($25.40 in chips) 
Seat 5: chiyuki ($42.49 in chips) 
Seat 6: Th3Fog ($21.74 in chips) 
Seat 7: Loholov ($15 in chips) 
Seat 8: KeLevro0 ($13.01 in chips) 
Seat 9: slapshot2011 ($22.97 in chips) 
Lasutchik: posts small blind $0.10
timburonps: posts big blind $0.25
*** HOLE CARDS ***
Dealt to chiyuki [Kh 2s]
PetitAlejo: folds 
chiyuki: folds 
Th3Fog: folds 
Loholov: folds 
KeLevro0: folds 
slapshot2011: folds 
2997qwer: folds 
Lasutchik: calls $0.15
timburonps: checks 
*** FLOP *** [Qs 2d 9d]
Lasutchik: bets $0.25
timburonps: folds 
Uncalled bet ($0.25) returned to Lasutchik
Lasutchik collected $0.48 from pot
Lasutchik: doesn't show hand 
*** SUMMARY ***
Total pot $0.50 | Rake $0.02 
Board [Qs 2d 9d]
Seat 1: 2997qwer (button) folded before Flop (didn't bet)
Seat 2: Lasutchik (small blind) collected ($0.48)
Seat 3: timburonps (big blind) folded on the Flop
Seat 4: PetitAlejo folded before Flop (didn't bet)
Seat 5: chiyuki folded before Flop (didn't bet)
Seat 6: Th3Fog folded before Flop (didn't bet)
Seat 7: Loholov folded before Flop (didn't bet)
Seat 8: KeLevro0 folded before Flop (didn't bet)
Seat 9: slapshot2011 folded before Flop (didn't bet)



PokerStars Zoom Hand #84299082067:  Hold'em No Limit ($0.10/$0.25) - 2012/08/05 13:54:50 JST [2012/08/05 0:54:50 ET]
Table 'Whirlpool' 9-max Seat #1 is the button
Seat 1: PetitAlejo ($25.40 in chips) 
Seat 2: solawind ($12.97 in chips) 
Seat 3: chiyuki ($42.49 in chips) 
Seat 4: Suhoff76 ($39.63 in chips) 
Seat 5: BlOnDhOlIc ($45.68 in chips) 
Seat 6: taksist889 ($21.11 in chips) 
Seat 7: RomarioJa ($5.33 in chips) 
Seat 8: Vahe50 ($15.70 in chips) 
Seat 9: Loholov ($17.90 in chips) 
solawind: posts small blind $0.10
chiyuki: posts big blind $0.25
*** HOLE CARDS ***
Dealt to chiyuki [7s 9h]
Suhoff76: folds 
BlOnDhOlIc: folds 
taksist889: folds 
RomarioJa: folds 
Vahe50: folds 
Loholov: folds 
PetitAlejo: raises $0.50 to $0.75
solawind: folds 
chiyuki: folds 
Uncalled bet ($0.50) returned to PetitAlejo
PetitAlejo collected $0.60 from pot
PetitAlejo: doesn't show hand 
*** SUMMARY ***
Total pot $0.60 | Rake $0 
Seat 1: PetitAlejo (button) collected ($0.60)
Seat 2: solawind (small blind) folded before Flop
Seat 3: chiyuki (big blind) folded before Flop
Seat 4: Suhoff76 folded before Flop (didn't bet)
Seat 5: BlOnDhOlIc folded before Flop (didn't bet)
Seat 6: taksist889 folded before Flop (didn't bet)
Seat 7: RomarioJa folded before Flop (didn't bet)
Seat 8: Vahe50 folded before Flop (didn't bet)
Seat 9: Loholov folded before Flop (didn't bet)



PokerStars Zoom Hand #84299087616:  Hold'em No Limit ($0.10/$0.25) - 2012/08/05 13:55:12 JST [2012/08/05 0:55:12 ET]
Table 'Whirlpool' 9-max Seat #1 is the button
Seat 1: ladymadon107 ($15.70 in chips) 
Seat 2: chiyuki ($42.24 in chips) 
Seat 3: BlOnDhOlIc ($45.58 in chips) 
Seat 4: timburonps ($42.39 in chips) 
Seat 5: taksist889 ($21.11 in chips) 
Seat 6: 2997qwer ($9.95 in chips) 
Seat 7: Dejacob ($41.39 in chips) 
Seat 8: Lasutchik ($33.75 in chips) 
Seat 9: Vahe50 ($29.75 in chips) 
chiyuki: posts small blind $0.10
BlOnDhOlIc: posts big blind $0.25
*** HOLE CARDS ***
Dealt to chiyuki [Tc 3h]
timburonps: folds 
taksist889: folds 
2997qwer: folds 
Dejacob: folds 
Lasutchik: folds 
Vahe50: raises $0.50 to $0.75
ladymadon107: folds 
chiyuki: folds 
BlOnDhOlIc: folds 
Uncalled bet ($0.50) returned to Vahe50
Vahe50 collected $0.60 from pot
Vahe50: doesn't show hand 
*** SUMMARY ***
Total pot $0.60 | Rake $0 
Seat 1: ladymadon107 (button) folded before Flop (didn't bet)
Seat 2: chiyuki (small blind) folded before Flop
Seat 3: BlOnDhOlIc (big blind) folded before Flop
Seat 4: timburonps folded before Flop (didn't bet)
Seat 5: taksist889 folded before Flop (didn't bet)
Seat 6: 2997qwer folded before Flop (didn't bet)
Seat 7: Dejacob folded before Flop (didn't bet)
Seat 8: Lasutchik folded before Flop (didn't bet)
Seat 9: Vahe50 collected ($0.60)



PokerStars Zoom Hand #84299091865:  Hold'em No Limit ($0.10/$0.25) - 2012/08/05 13:55:33 JST [2012/08/05 0:55:33 ET]
Table 'Whirlpool' 9-max Seat #1 is the button
Seat 1: NastyMcNast ($25 in chips) 
Seat 2: Loholov ($19.25 in chips) 
Seat 3: Déculotter69 ($18.11 in chips) 
Seat 4: Th3Fog ($66.56 in chips) 
Seat 5: RomarioJa ($7.85 in chips) 
Seat 6: solawind ($12.87 in chips) 
Seat 7: wtu1986 ($25 in chips) 
Seat 8: Dejacob ($49.33 in chips) 
Seat 9: chiyuki ($42.14 in chips) 
Loholov: posts small blind $0.10
Déculotter69: posts big blind $0.25
*** HOLE CARDS ***
Dealt to chiyuki [Kc Qc]
Th3Fog: folds 
RomarioJa: folds 
solawind: folds 
wtu1986: folds 
Dejacob: folds 
chiyuki: raises $0.50 to $0.75
NastyMcNast: folds 
Loholov: folds 
Déculotter69: raises $1.50 to $2.25
chiyuki: calls $1.50
*** FLOP *** [Ad Jh Qd]
Déculotter69: bets $2.50
chiyuki: folds 
Uncalled bet ($2.50) returned to Déculotter69
Déculotter69 collected $4.39 from pot
Déculotter69: doesn't show hand 
*** SUMMARY ***
Total pot $4.60 | Rake $0.21 
Board [Ad Jh Qd]
Seat 1: NastyMcNast (button) folded before Flop (didn't bet)
Seat 2: Loholov (small blind) folded before Flop
Seat 3: Déculotter69 (big blind) collected ($4.39)
Seat 4: Th3Fog folded before Flop (didn't bet)
Seat 5: RomarioJa folded before Flop (didn't bet)
Seat 6: solawind folded before Flop (didn't bet)
Seat 7: wtu1986 folded before Flop (didn't bet)
Seat 8: Dejacob folded before Flop (didn't bet)
Seat 9: chiyuki folded on the Flop



PokerStars Zoom Hand #84299103285:  Hold'em No Limit ($0.10/$0.25) - 2012/08/05 13:56:29 JST [2012/08/05 0:56:29 ET]
Table 'Whirlpool' 9-max Seat #1 is the button
Seat 1: chiyuki ($39.89 in chips) 
Seat 2: Dejacob ($32.15 in chips) 
Seat 3: roksmokndonk ($36.71 in chips) 
Seat 4: Loholov ($19.70 in chips) 
Seat 5: Ellen1947 ($38.33 in chips) 
Seat 6: Roglus ($18.45 in chips) 
Seat 7: Nerkit ($12.30 in chips) 
Seat 8: NastyMcNast ($25 in chips) 
Seat 9: wtu1986 ($25.90 in chips) 
Dejacob: posts small blind $0.10
roksmokndonk: posts big blind $0.25
*** HOLE CARDS ***
Dealt to chiyuki [6d 3s]
Loholov: folds 
Ellen1947: folds 
Roglus: folds 
Nerkit: folds 
NastyMcNast: folds 
wtu1986: folds 
chiyuki: folds 
Dejacob: folds 
Uncalled bet ($0.15) returned to roksmokndonk
roksmokndonk collected $0.20 from pot
roksmokndonk: doesn't show hand 
*** SUMMARY ***
Total pot $0.20 | Rake $0 
Seat 1: chiyuki (button) folded before Flop (didn't bet)
Seat 2: Dejacob (small blind) folded before Flop
Seat 3: roksmokndonk (big blind) collected ($0.20)
Seat 4: Loholov folded before Flop (didn't bet)
Seat 5: Ellen1947 folded before Flop (didn't bet)
Seat 6: Roglus folded before Flop (didn't bet)
Seat 7: Nerkit folded before Flop (didn't bet)
Seat 8: NastyMcNast folded before Flop (didn't bet)
Seat 9: wtu1986 folded before Flop (didn't bet)



PokerStars Zoom Hand #84299104314:  Hold'em No Limit ($0.10/$0.25) - 2012/08/05 13:56:35 JST [2012/08/05 0:56:35 ET]
Table 'Whirlpool' 9-max Seat #1 is the button
Seat 1: Ellen1947 ($38.33 in chips) 
Seat 2: 2997qwer ($12.15 in chips) 
Seat 3: Dejacob ($32.05 in chips) 
Seat 4: Loholov ($19.70 in chips) 
Seat 5: hirozo ($29.37 in chips) 
Seat 6: chiyuki ($39.89 in chips) 
Seat 7: kamikkaze ($11.80 in chips) 
Seat 8: wtu1986 ($25.90 in chips) 
Seat 9: giorgos_k ($16.26 in chips) 
2997qwer: posts small blind $0.10
Dejacob: posts big blind $0.25
*** HOLE CARDS ***
Dealt to chiyuki [5d 3s]
Loholov: folds 
hirozo: folds 
chiyuki: folds 
kamikkaze: folds 
wtu1986: folds 
giorgos_k: folds 
Ellen1947: folds 
2997qwer: folds 
Uncalled bet ($0.15) returned to Dejacob
Dejacob collected $0.20 from pot
Dejacob: doesn't show hand 
*** SUMMARY ***
Total pot $0.20 | Rake $0 
Seat 1: Ellen1947 (button) folded before Flop (didn't bet)
Seat 2: 2997qwer (small blind) folded before Flop
Seat 3: Dejacob (big blind) collected ($0.20)
Seat 4: Loholov folded before Flop (didn't bet)
Seat 5: hirozo folded before Flop (didn't bet)
Seat 6: chiyuki folded before Flop (didn't bet)
Seat 7: kamikkaze folded before Flop (didn't bet)
Seat 8: wtu1986 folded before Flop (didn't bet)
Seat 9: giorgos_k folded before Flop (didn't bet)



PokerStars Zoom Hand #84299105378:  Hold'em No Limit ($0.10/$0.25) - 2012/08/05 13:56:40 JST [2012/08/05 0:56:40 ET]
Table 'Whirlpool' 9-max Seat #1 is the button
Seat 1: NastyMcNast ($25 in chips) 
Seat 2: ygoegoe ($34.29 in chips) 
Seat 3: Tom1999 ($15 in chips) 
Seat 4: GoldNutter ($15.20 in chips) 
Seat 5: chiyuki ($39.89 in chips) 
Seat 6: DjJooni ($41.73 in chips) 
Seat 7: Csabee21 ($26.03 in chips) 
Seat 8: agurio ($25 in chips) 
Seat 9: PetitAlejo ($27.17 in chips) 
ygoegoe: posts small blind $0.10
Tom1999: posts big blind $0.25
*** HOLE CARDS ***
Dealt to chiyuki [4h Qh]
GoldNutter: folds 
chiyuki: folds 
DjJooni: folds 
Csabee21: folds 
agurio: folds 
PetitAlejo: folds 
NastyMcNast: folds 
ygoegoe: folds 
Uncalled bet ($0.15) returned to Tom1999
Tom1999 collected $0.20 from pot
Tom1999: doesn't show hand 
*** SUMMARY ***
Total pot $0.20 | Rake $0 
Seat 1: NastyMcNast (button) folded before Flop (didn't bet)
Seat 2: ygoegoe (small blind) folded before Flop
Seat 3: Tom1999 (big blind) collected ($0.20)
Seat 4: GoldNutter folded before Flop (didn't bet)
Seat 5: chiyuki folded before Flop (didn't bet)
Seat 6: DjJooni folded before Flop (didn't bet)
Seat 7: Csabee21 folded before Flop (didn't bet)
Seat 8: agurio folded before Flop (didn't bet)
Seat 9: PetitAlejo folded before Flop (didn't bet)



PokerStars Zoom Hand #84299106489:  Hold'em No Limit ($0.10/$0.25) - 2012/08/05 13:56:45 JST [2012/08/05 0:56:45 ET]
Table 'Whirlpool' 9-max Seat #1 is the button
Seat 1: ygoegoe ($34.19 in chips) 
Seat 2: kamikkaze ($14.75 in chips) 
Seat 3: TErr18 ($16.50 in chips) 
Seat 4: RikkStroken ($13.61 in chips) 
Seat 5: flyinprits ($44.82 in chips) 
Seat 6: leo2095 ($14.61 in chips) 
Seat 7: hirozo ($29.37 in chips) 
Seat 8: chiyuki ($39.89 in chips) 
Seat 9: JAMESOZZY ($12.54 in chips) 
kamikkaze: posts small blind $0.10
TErr18: posts big blind $0.25
*** HOLE CARDS ***
Dealt to chiyuki [9h 3s]
RikkStroken: folds 
flyinprits: folds 
leo2095: folds 
hirozo: folds 
chiyuki: folds 
JAMESOZZY: raises $1 to $1.25
ygoegoe: folds 
kamikkaze: folds 
TErr18: folds 
Uncalled bet ($1) returned to JAMESOZZY
JAMESOZZY collected $0.60 from pot
JAMESOZZY: doesn't show hand 
*** SUMMARY ***
Total pot $0.60 | Rake $0 
Seat 1: ygoegoe (button) folded before Flop (didn't bet)
Seat 2: kamikkaze (small blind) folded before Flop
Seat 3: TErr18 (big blind) folded before Flop
Seat 4: RikkStroken folded before Flop (didn't bet)
Seat 5: flyinprits folded before Flop (didn't bet)
Seat 6: leo2095 folded before Flop (didn't bet)
Seat 7: hirozo folded before Flop (didn't bet)
Seat 8: chiyuki folded before Flop (didn't bet)
Seat 9: JAMESOZZY collected ($0.60)



PokerStars Zoom Hand #84299107712:  Hold'em No Limit ($0.10/$0.25) - 2012/08/05 13:56:51 JST [2012/08/05 0:56:51 ET]
Table 'Whirlpool' 9-max Seat #1 is the button
Seat 1: giorgos_k ($16.26 in chips) 
Seat 2: Tom1999 ($15.10 in chips) 
Seat 3: timburonps ($28.72 in chips) 
Seat 4: Nerkit ($12.30 in chips) 
Seat 5: NastyMcNast ($36 in chips) 
Seat 6: deadmoneykid ($24.65 in chips) 
Seat 7: chiyuki ($39.89 in chips) 
Seat 8: BlOnDhOlIc ($62.27 in chips) 
Seat 9: solawind ($13.82 in chips) 
Tom1999: posts small blind $0.10
timburonps: posts big blind $0.25
*** HOLE CARDS ***
Dealt to chiyuki [Tc Kc]
Nerkit: folds 
NastyMcNast: folds 
deadmoneykid: folds 
chiyuki: folds 
BlOnDhOlIc: folds 
solawind: folds 
giorgos_k: folds 
Tom1999: raises $0.50 to $0.75
timburonps: folds 
Uncalled bet ($0.50) returned to Tom1999
Tom1999 collected $0.50 from pot
Tom1999: doesn't show hand 
*** SUMMARY ***
Total pot $0.50 | Rake $0 
Seat 1: giorgos_k (button) folded before Flop (didn't bet)
Seat 2: Tom1999 (small blind) collected ($0.50)
Seat 3: timburonps (big blind) folded before Flop
Seat 4: Nerkit folded before Flop (didn't bet)
Seat 5: NastyMcNast folded before Flop (didn't bet)
Seat 6: deadmoneykid folded before Flop (didn't bet)
Seat 7: chiyuki folded before Flop (didn't bet)
Seat 8: BlOnDhOlIc folded before Flop (didn't bet)
Seat 9: solawind folded before Flop (didn't bet)



PokerStars Zoom Hand #84299108530:  Hold'em No Limit ($0.10/$0.25) - 2012/08/05 13:56:55 JST [2012/08/05 0:56:55 ET]
Table 'Whirlpool' 9-max Seat #1 is the button
Seat 1: ChrisCDee ($25 in chips) 
Seat 2: seula i ($40.85 in chips) 
Seat 3: chiyuki ($39.89 in chips) 
Seat 4: PetitAlejo ($30.44 in chips) 
Seat 5: deadmoneykid ($24.65 in chips) 
Seat 6: wtu1986 ($24.63 in chips) 
Seat 7: leo2095 ($14.61 in chips) 
Seat 8: hirozo ($30.90 in chips) 
Seat 9: 2997qwer ($11.80 in chips) 
seula i: posts small blind $0.10
chiyuki: posts big blind $0.25
*** HOLE CARDS ***
Dealt to chiyuki [7c 5d]
PetitAlejo: folds 
deadmoneykid: raises $0.35 to $0.60
wtu1986: folds 
leo2095: folds 
hirozo: folds 
2997qwer: folds 
ChrisCDee: folds 
seula i: raises $2.15 to $2.75
chiyuki: folds 
deadmoneykid: folds 
Uncalled bet ($2.15) returned to seula i
seula i collected $1.45 from pot
seula i: doesn't show hand 
*** SUMMARY ***
Total pot $1.45 | Rake $0 
Seat 1: ChrisCDee (button) folded before Flop (didn't bet)
Seat 2: seula i (small blind) collected ($1.45)
Seat 3: chiyuki (big blind) folded before Flop
Seat 4: PetitAlejo folded before Flop (didn't bet)
Seat 5: deadmoneykid folded before Flop
Seat 6: wtu1986 folded before Flop (didn't bet)
Seat 7: leo2095 folded before Flop (didn't bet)
Seat 8: hirozo folded before Flop (didn't bet)
Seat 9: 2997qwer folded before Flop (didn't bet)



PokerStars Zoom Hand #84299115559:  Hold'em No Limit ($0.10/$0.25) - 2012/08/05 13:57:29 JST [2012/08/05 0:57:29 ET]
Table 'Whirlpool' 9-max Seat #1 is the button
Seat 1: Nerkit ($15.15 in chips) 
Seat 2: fwani ($42.54 in chips) 
Seat 3: Loholov ($19.45 in chips) 
Seat 4: chiyuki ($39.64 in chips) 
Seat 5: PetitAlejo ($26.92 in chips) 
Seat 6: Dejacob ($48.23 in chips) 
Seat 7: Dafleche ($15.29 in chips) 
Seat 8: kamikkaze ($11.90 in chips) 
Seat 9: hirozo ($26.42 in chips) 
fwani: posts small blind $0.10
Loholov: posts big blind $0.25
*** HOLE CARDS ***
Dealt to chiyuki [3d 6s]
chiyuki: folds 
PetitAlejo: folds 
Dejacob: folds 
Dafleche: folds 
kamikkaze: folds 
hirozo: folds 
Nerkit: raises $0.50 to $0.75
fwani: folds 
Loholov: folds 
Uncalled bet ($0.50) returned to Nerkit
Nerkit collected $0.60 from pot
Nerkit: doesn't show hand 
*** SUMMARY ***
Total pot $0.60 | Rake $0 
Seat 1: Nerkit (button) collected ($0.60)
Seat 2: fwani (small blind) folded before Flop
Seat 3: Loholov (big blind) folded before Flop
Seat 4: chiyuki folded before Flop (didn't bet)
Seat 5: PetitAlejo folded before Flop (didn't bet)
Seat 6: Dejacob folded before Flop (didn't bet)
Seat 7: Dafleche folded before Flop (didn't bet)
Seat 8: kamikkaze folded before Flop (didn't bet)
Seat 9: hirozo folded before Flop (didn't bet)



PokerStars Zoom Hand #84299117873:  Hold'em No Limit ($0.10/$0.25) - 2012/08/05 13:57:40 JST [2012/08/05 0:57:40 ET]
Table 'Whirlpool' 9-max Seat #1 is the button
Seat 1: timburonps ($28.37 in chips) 
Seat 2: cr0lox ($15.12 in chips) 
Seat 3: Dejacob ($32.15 in chips) 
Seat 4: chiyuki ($39.64 in chips) 
Seat 5: Loholov ($18.80 in chips) 
Seat 6: wtu1986 ($24.90 in chips) 
Seat 7: 2997qwer ($11.80 in chips) 
Seat 8: PetitAlejo ($30.37 in chips) 
Seat 9: BlackZafiro ($25 in chips) 
cr0lox: posts small blind $0.10
Dejacob: posts big blind $0.25
*** HOLE CARDS ***
Dealt to chiyuki [7d Qh]
chiyuki: folds 
Loholov: folds 
wtu1986: folds 
2997qwer: folds 
PetitAlejo: folds 
BlackZafiro: folds 
timburonps: folds 
cr0lox: folds 
Uncalled bet ($0.15) returned to Dejacob
Dejacob collected $0.20 from pot
Dejacob: doesn't show hand 
*** SUMMARY ***
Total pot $0.20 | Rake $0 
Seat 1: timburonps (button) folded before Flop (didn't bet)
Seat 2: cr0lox (small blind) folded before Flop
Seat 3: Dejacob (big blind) collected ($0.20)
Seat 4: chiyuki folded before Flop (didn't bet)
Seat 5: Loholov folded before Flop (didn't bet)
Seat 6: wtu1986 folded before Flop (didn't bet)
Seat 7: 2997qwer folded before Flop (didn't bet)
Seat 8: PetitAlejo folded before Flop (didn't bet)
Seat 9: BlackZafiro folded before Flop (didn't bet)



PokerStars Zoom Hand #84299116832:  Hold'em No Limit ($0.10/$0.25) - 2012/08/05 13:57:35 JST [2012/08/05 0:57:35 ET]
Table 'Whirlpool' 9-max Seat #1 is the button
Seat 1: 2997qwer ($12.50 in chips) 
Seat 2: seula i ($65.62 in chips) 
Seat 3: Curtis1436 ($25.84 in chips) 
Seat 4: chiyuki ($39.64 in chips) 
Seat 5: Dejacob ($48.23 in chips) 
Seat 6: NastyMcNast ($25 in chips) 
Seat 7: Lasutchik ($34.76 in chips) 
Seat 8: Anafim ($12.50 in chips) 
Seat 9: Nerkit ($12.25 in chips) 
seula i: posts small blind $0.10
Curtis1436: posts big blind $0.25
*** HOLE CARDS ***
Dealt to chiyuki [7h 5d]
chiyuki: folds 
Dejacob: folds 
NastyMcNast: raises $0.50 to $0.75
Lasutchik: calls $0.75
Anafim: folds 
Nerkit: folds 
2997qwer: folds 
seula i: folds 
Curtis1436: calls $0.50
*** FLOP *** [7d Kc Jh]
Curtis1436: checks 
NastyMcNast: bets $1.56
Lasutchik: folds 
Curtis1436: folds 
Uncalled bet ($1.56) returned to NastyMcNast
NastyMcNast collected $2.24 from pot
NastyMcNast: doesn't show hand 
*** SUMMARY ***
Total pot $2.35 | Rake $0.11 
Board [7d Kc Jh]
Seat 1: 2997qwer (button) folded before Flop (didn't bet)
Seat 2: seula i (small blind) folded before Flop
Seat 3: Curtis1436 (big blind) folded on the Flop
Seat 4: chiyuki folded before Flop (didn't bet)
Seat 5: Dejacob folded before Flop (didn't bet)
Seat 6: NastyMcNast collected ($2.24)
Seat 7: Lasutchik folded on the Flop
Seat 8: Anafim folded before Flop (didn't bet)
Seat 9: Nerkit folded before Flop (didn't bet)



PokerStars Zoom Hand #84299114937:  Hold'em No Limit ($0.10/$0.25) - 2012/08/05 13:57:26 JST [2012/08/05 0:57:26 ET]
Table 'Whirlpool' 9-max Seat #1 is the button
Seat 1: seula i ($65.62 in chips) 
Seat 2: 2997qwer ($12.60 in chips) 
Seat 3: KeLevro0 ($12.50 in chips) 
Seat 4: munky3 ($37.39 in chips) 
Seat 5: ChrisCDee ($25.79 in chips) 
Seat 6: chiyuki ($39.64 in chips) 
Seat 7: Ellen1947 ($37.98 in chips) 
Seat 8: TErr18 ($16.15 in chips) 
Seat 9: Roglus ($18.20 in chips) 
2997qwer: posts small blind $0.10
KeLevro0: posts big blind $0.25
*** HOLE CARDS ***
Dealt to chiyuki [Kc Jd]
munky3: calls $0.25
ChrisCDee: folds 
chiyuki: folds 
Ellen1947: calls $0.25
TErr18: folds 
Roglus: calls $0.25
seula i: folds 
2997qwer: folds 
KeLevro0: checks 
*** FLOP *** [6h 8d 5s]
KeLevro0: checks 
munky3: checks 
Ellen1947: checks 
Roglus: checks 
*** TURN *** [6h 8d 5s] [Qh]
KeLevro0: checks 
munky3: checks 
Ellen1947: checks 
Roglus: bets $0.71
KeLevro0: folds 
munky3: folds 
Ellen1947: folds 
Uncalled bet ($0.71) returned to Roglus
Roglus collected $1.05 from pot
Roglus: doesn't show hand 
*** SUMMARY ***
Total pot $1.10 | Rake $0.05 
Board [6h 8d 5s Qh]
Seat 1: seula i (button) folded before Flop (didn't bet)
Seat 2: 2997qwer (small blind) folded before Flop
Seat 3: KeLevro0 (big blind) folded on the Turn
Seat 4: munky3 folded on the Turn
Seat 5: ChrisCDee folded before Flop (didn't bet)
Seat 6: chiyuki folded before Flop (didn't bet)
Seat 7: Ellen1947 folded on the Turn
Seat 8: TErr18 folded before Flop (didn't bet)
Seat 9: Roglus collected ($1.05)



PokerStars Zoom Hand #84299122959:  Hold'em No Limit ($0.10/$0.25) - 2012/08/05 13:58:06 JST [2012/08/05 0:58:06 ET]
Table 'Whirlpool' 9-max Seat #1 is the button
Seat 1: RomarioJa ($8.74 in chips) 
Seat 2: hirozo ($28.37 in chips) 
Seat 3: PetitAlejo ($27.27 in chips) 
Seat 4: Dejacob ($48.13 in chips) 
Seat 5: Nerkit ($15.40 in chips) 
Seat 6: Tom1999 ($15.35 in chips) 
Seat 7: 123progress ($30.25 in chips) 
Seat 8: timburonps ($39.78 in chips) 
Seat 9: chiyuki ($39.54 in chips) 
hirozo: posts small blind $0.10
PetitAlejo: posts big blind $0.25
*** HOLE CARDS ***
Dealt to chiyuki [8c Ks]
Dejacob: folds 
Nerkit: folds 
Tom1999: folds 
123progress: raises $0.37 to $0.62
timburonps: folds 
chiyuki: folds 
RomarioJa: folds 
hirozo: folds 
PetitAlejo: folds 
Uncalled bet ($0.37) returned to 123progress
123progress collected $0.60 from pot
123progress: doesn't show hand 
*** SUMMARY ***
Total pot $0.60 | Rake $0 
Seat 1: RomarioJa (button) folded before Flop (didn't bet)
Seat 2: hirozo (small blind) folded before Flop
Seat 3: PetitAlejo (big blind) folded before Flop
Seat 4: Dejacob folded before Flop (didn't bet)
Seat 5: Nerkit folded before Flop (didn't bet)
Seat 6: Tom1999 folded before Flop (didn't bet)
Seat 7: 123progress collected ($0.60)
Seat 8: timburonps folded before Flop (didn't bet)
Seat 9: chiyuki folded before Flop (didn't bet)



PokerStars Zoom Hand #84299123602:  Hold'em No Limit ($0.10/$0.25) - 2012/08/05 13:58:09 JST [2012/08/05 0:58:09 ET]
Table 'Whirlpool' 9-max Seat #1 is the button
Seat 1: Noviekid ($23.23 in chips) 
Seat 2: Anafim ($12.50 in chips) 
Seat 3: kamikkaze ($13.90 in chips) 
Seat 4: Ellen1947 ($32.25 in chips) 
Seat 5: 2997qwer ($10.30 in chips) 
Seat 6: Roglus ($72.95 in chips) 
Seat 7: Nerkit ($11.95 in chips) 
Seat 8: chiyuki ($39.54 in chips) 
Seat 9: taksist889 ($25.31 in chips) 
Anafim: posts small blind $0.10
kamikkaze: posts big blind $0.25
*** HOLE CARDS ***
Dealt to chiyuki [3d As]
Ellen1947: raises $0.25 to $0.50
2997qwer: folds 
Roglus: folds 
Nerkit: folds 
chiyuki: folds 
taksist889: folds 
Noviekid: folds 
Anafim: folds 
kamikkaze: folds 
Uncalled bet ($0.25) returned to Ellen1947
Ellen1947 collected $0.60 from pot
Ellen1947: doesn't show hand 
*** SUMMARY ***
Total pot $0.60 | Rake $0 
Seat 1: Noviekid (button) folded before Flop (didn't bet)
Seat 2: Anafim (small blind) folded before Flop
Seat 3: kamikkaze (big blind) folded before Flop
Seat 4: Ellen1947 collected ($0.60)
Seat 5: 2997qwer folded before Flop (didn't bet)
Seat 6: Roglus folded before Flop (didn't bet)
Seat 7: Nerkit folded before Flop (didn't bet)
Seat 8: chiyuki folded before Flop (didn't bet)
Seat 9: taksist889 folded before Flop (didn't bet)



PokerStars Zoom Hand #84299121121:  Hold'em No Limit ($0.10/$0.25) - 2012/08/05 13:57:57 JST [2012/08/05 0:57:57 ET]
Table 'Whirlpool' 9-max Seat #1 is the button
Seat 1: chiyuki ($39.54 in chips) 
Seat 2: Csabee21 ($26.48 in chips) 
Seat 3: simonzez ($34.78 in chips) 
Seat 4: wtu1986 ($25.63 in chips) 
Seat 5: 2997qwer ($11.80 in chips) 
Seat 6: BlackZafiro ($25.84 in chips) 
Seat 7: Loholov ($18.80 in chips) 
Seat 8: RomarioJa ($5.73 in chips) 
Seat 9: kamikkaze ($11.80 in chips) 
Csabee21: posts small blind $0.10
simonzez: posts big blind $0.25
*** HOLE CARDS ***
Dealt to chiyuki [Th 6s]
wtu1986: folds 
2997qwer: folds 
BlackZafiro: raises $0.50 to $0.75
Loholov: calls $0.75
RomarioJa: folds 
kamikkaze: folds 
chiyuki: folds 
Csabee21: calls $0.65
simonzez: calls $0.50
*** FLOP *** [5h Qh 3h]
Csabee21: bets $1
simonzez: folds 
BlackZafiro: folds 
Loholov: folds 
Uncalled bet ($1) returned to Csabee21
Csabee21 collected $2.86 from pot
Csabee21: doesn't show hand 
*** SUMMARY ***
Total pot $3 | Rake $0.14 
Board [5h Qh 3h]
Seat 1: chiyuki (button) folded before Flop (didn't bet)
Seat 2: Csabee21 (small blind) collected ($2.86)
Seat 3: simonzez (big blind) folded on the Flop
Seat 4: wtu1986 folded before Flop (didn't bet)
Seat 5: 2997qwer folded before Flop (didn't bet)
Seat 6: BlackZafiro folded on the Flop
Seat 7: Loholov folded on the Flop
Seat 8: RomarioJa folded before Flop (didn't bet)
Seat 9: kamikkaze folded before Flop (didn't bet)



PokerStars Zoom Hand #84299118864:  Hold'em No Limit ($0.10/$0.25) - 2012/08/05 13:57:45 JST [2012/08/05 0:57:45 ET]
Table 'Whirlpool' 9-max Seat #1 is the button
Seat 1: cr0lox ($15.02 in chips) 
Seat 2: chiyuki ($39.64 in chips) 
Seat 3: Anafim ($12.50 in chips) 
Seat 4: peng2astic ($13.54 in chips) 
Seat 5: simonzez ($34.78 in chips) 
Seat 6: TErr18 ($16.15 in chips) 
Seat 7: KeLevro0 ($9.53 in chips) 
Seat 8: ygoegoe ($29.14 in chips) 
Seat 9: Faraz ($28.75 in chips) 
chiyuki: posts small blind $0.10
Anafim: posts big blind $0.25
*** HOLE CARDS ***
Dealt to chiyuki [7s 2h]
peng2astic has timed out
peng2astic: folds 
simonzez: folds 
TErr18: folds 
KeLevro0: folds 
ygoegoe: folds 
Faraz: raises $0.25 to $0.50
cr0lox: calls $0.50
chiyuki: folds 
Anafim: folds 
*** FLOP *** [4c 9c Td]
Faraz: checks 
cr0lox: checks 
*** TURN *** [4c 9c Td] [6d]
Faraz: bets $0.50
cr0lox: folds 
Uncalled bet ($0.50) returned to Faraz
Faraz collected $1.29 from pot
Faraz: doesn't show hand 
*** SUMMARY ***
Total pot $1.35 | Rake $0.06 
Board [4c 9c Td 6d]
Seat 1: cr0lox (button) folded on the Turn
Seat 2: chiyuki (small blind) folded before Flop
Seat 3: Anafim (big blind) folded before Flop
Seat 4: peng2astic folded before Flop (didn't bet)
Seat 5: simonzez folded before Flop (didn't bet)
Seat 6: TErr18 folded before Flop (didn't bet)
Seat 7: KeLevro0 folded before Flop (didn't bet)
Seat 8: ygoegoe folded before Flop (didn't bet)
Seat 9: Faraz collected ($1.29)



PokerStars Zoom Hand #84299125824:  Hold'em No Limit ($0.10/$0.25) - 2012/08/05 13:58:20 JST [2012/08/05 0:58:20 ET]
Table 'Whirlpool' 9-max Seat #1 is the button
Seat 1: fwani ($35.83 in chips) 
Seat 2: agurio ($27.20 in chips) 
Seat 3: Loholov ($15 in chips) 
Seat 4: Ellen1947 ($37.73 in chips) 
Seat 5: Lasutchik ($34.01 in chips) 
Seat 6: RikkStroken ($16.15 in chips) 
Seat 7: chiyuki ($39.54 in chips) 
Seat 8: puffy5533 ($22.60 in chips) 
Seat 9: kamikkaze ($14.30 in chips) 
agurio: posts small blind $0.10
Loholov: posts big blind $0.25
*** HOLE CARDS ***
Dealt to chiyuki [8s Ts]
Ellen1947: folds 
Lasutchik: folds 
RikkStroken: raises $0.25 to $0.50
chiyuki: folds 
puffy5533: folds 
kamikkaze: folds 
fwani: folds 
agurio: folds 
Loholov: folds 
Uncalled bet ($0.25) returned to RikkStroken
RikkStroken collected $0.60 from pot
RikkStroken: doesn't show hand 
*** SUMMARY ***
Total pot $0.60 | Rake $0 
Seat 1: fwani (button) folded before Flop (didn't bet)
Seat 2: agurio (small blind) folded before Flop
Seat 3: Loholov (big blind) folded before Flop
Seat 4: Ellen1947 folded before Flop (didn't bet)
Seat 5: Lasutchik folded before Flop (didn't bet)
Seat 6: RikkStroken collected ($0.60)
Seat 7: chiyuki folded before Flop (didn't bet)
Seat 8: puffy5533 folded before Flop (didn't bet)
Seat 9: kamikkaze folded before Flop (didn't bet)



PokerStars Zoom Hand #84299126632:  Hold'em No Limit ($0.10/$0.25) - 2012/08/05 13:58:24 JST [2012/08/05 0:58:24 ET]
Table 'Whirlpool' 9-max Seat #1 is the button
Seat 1: Tom1999 ($14.65 in chips) 
Seat 2: timburonps ($44.71 in chips) 
Seat 3: chiyuki ($39.54 in chips) 
Seat 4: deadmoneykid ($34.50 in chips) 
Seat 5: kamikkaze ($17.71 in chips) 
Seat 6: Landybob ($34.65 in chips) 
Seat 7: ygoegoe ($38.88 in chips) 
Seat 8: Dafleche ($14.94 in chips) 
Seat 9: Dejacob ($32.15 in chips) 
timburonps: posts small blind $0.10
chiyuki: posts big blind $0.25
*** HOLE CARDS ***
Dealt to chiyuki [Ac 9d]
deadmoneykid: folds 
kamikkaze: folds 
Landybob: folds 
ygoegoe: folds 
Dafleche: folds 
Dejacob: folds 
Tom1999: folds 
timburonps: folds 
Uncalled bet ($0.15) returned to chiyuki
chiyuki collected $0.20 from pot
chiyuki: doesn't show hand 
*** SUMMARY ***
Total pot $0.20 | Rake $0 
Seat 1: Tom1999 (button) folded before Flop (didn't bet)
Seat 2: timburonps (small blind) folded before Flop
Seat 3: chiyuki (big blind) collected ($0.20)
Seat 4: deadmoneykid folded before Flop (didn't bet)
Seat 5: kamikkaze folded before Flop (didn't bet)
Seat 6: Landybob folded before Flop (didn't bet)
Seat 7: ygoegoe folded before Flop (didn't bet)
Seat 8: Dafleche folded before Flop (didn't bet)
Seat 9: Dejacob folded before Flop (didn't bet)



PokerStars Zoom Hand #84299131636:  Hold'em No Limit ($0.10/$0.25) - 2012/08/05 13:58:48 JST [2012/08/05 0:58:48 ET]
Table 'Whirlpool' 9-max Seat #1 is the button
Seat 1: 2997qwer ($12.25 in chips) 
Seat 2: chiyuki ($39.64 in chips) 
Seat 3: cr0lox ($14.52 in chips) 
Seat 4: wtu1986 ($25 in chips) 
Seat 5: Dafleche ($14.94 in chips) 
Seat 6: timburonps ($39.88 in chips) 
Seat 7: ladymadon107 ($9.41 in chips) 
Seat 8: Anafim ($12.50 in chips) 
Seat 9: Loholov ($15 in chips) 
chiyuki: posts small blind $0.10
cr0lox: posts big blind $0.25
*** HOLE CARDS ***
Dealt to chiyuki [7c Qd]
wtu1986: folds 
Dafleche: folds 
timburonps: folds 
ladymadon107: folds 
Anafim: folds 
Loholov: folds 
2997qwer: folds 
chiyuki: folds 
Uncalled bet ($0.15) returned to cr0lox
cr0lox collected $0.20 from pot
cr0lox: doesn't show hand 
*** SUMMARY ***
Total pot $0.20 | Rake $0 
Seat 1: 2997qwer (button) folded before Flop (didn't bet)
Seat 2: chiyuki (small blind) folded before Flop
Seat 3: cr0lox (big blind) collected ($0.20)
Seat 4: wtu1986 folded before Flop (didn't bet)
Seat 5: Dafleche folded before Flop (didn't bet)
Seat 6: timburonps folded before Flop (didn't bet)
Seat 7: ladymadon107 folded before Flop (didn't bet)
Seat 8: Anafim folded before Flop (didn't bet)
Seat 9: Loholov folded before Flop (didn't bet)



PokerStars Zoom Hand #84299125020:  Hold'em No Limit ($0.10/$0.25) - 2012/08/05 13:58:16 JST [2012/08/05 0:58:16 ET]
Table 'Whirlpool' 9-max Seat #1 is the button
Seat 1: ladymadon107 ($10.16 in chips) 
Seat 2: 2997qwer ($10.75 in chips) 
Seat 3: ChrisCDee ($38.19 in chips) 
Seat 4: PetitAlejo ($25 in chips) 
Seat 5: timburonps ($28.37 in chips) 
Seat 6: chiyuki ($39.54 in chips) 
Seat 7: taksist889 ($25.31 in chips) 
Seat 8: NastyMcNast ($26.10 in chips) 
Seat 9: Noviekid ($23.23 in chips) 
2997qwer: posts small blind $0.10
ChrisCDee: posts big blind $0.25
*** HOLE CARDS ***
Dealt to chiyuki [Qc Tc]
PetitAlejo: raises $0.50 to $0.75
timburonps: folds 
chiyuki: folds 
taksist889: calls $0.75
NastyMcNast: folds 
Noviekid: folds 
ladymadon107: calls $0.75
2997qwer: folds 
ChrisCDee: folds 
*** FLOP *** [6h 2s 5h]
PetitAlejo: bets $1.75
taksist889: calls $1.75
ladymadon107: folds 
*** TURN *** [6h 2s 5h] [5c]
PetitAlejo: checks 
taksist889: bets $3.25
PetitAlejo: calls $3.25
*** RIVER *** [6h 2s 5h 5c] [5s]
PetitAlejo: bets $5.31
taksist889: calls $5.31
*** SHOW DOWN ***
PetitAlejo: shows [6s 6c] (a full house, Sixes full of Fives)
taksist889: mucks hand 
PetitAlejo collected $22.18 from pot
*** SUMMARY ***
Total pot $23.22 | Rake $1.04 
Board [6h 2s 5h 5c 5s]
Seat 1: ladymadon107 (button) folded on the Flop
Seat 2: 2997qwer (small blind) folded before Flop
Seat 3: ChrisCDee (big blind) folded before Flop
Seat 4: PetitAlejo showed [6s 6c] and won ($22.18) with a full house, Sixes full of Fives
Seat 5: timburonps folded before Flop (didn't bet)
Seat 6: chiyuki folded before Flop (didn't bet)
Seat 7: taksist889 mucked [8c 8h]
Seat 8: NastyMcNast folded before Flop (didn't bet)
Seat 9: Noviekid folded before Flop (didn't bet)



PokerStars Zoom Hand #84299130848:  Hold'em No Limit ($0.10/$0.25) - 2012/08/05 13:58:44 JST [2012/08/05 0:58:44 ET]
Table 'Whirlpool' 9-max Seat #1 is the button
Seat 1: puffy5533 ($22.60 in chips) 
Seat 2: MrJarte ($25.10 in chips) 
Seat 3: seula i ($65.52 in chips) 
Seat 4: Roglus ($73.30 in chips) 
Seat 5: chiyuki ($39.64 in chips) 
Seat 6: BlOnDhOlIc ($62.27 in chips) 
Seat 7: cr0lox ($14.52 in chips) 
Seat 8: ladymadon107 ($9.41 in chips) 
Seat 9: Anafim ($12.50 in chips) 
MrJarte: posts small blind $0.10
seula i: posts big blind $0.25
*** HOLE CARDS ***
Dealt to chiyuki [8h 4s]
Roglus: folds 
chiyuki: folds 
BlOnDhOlIc: folds 
cr0lox: folds 
ladymadon107: folds 
Anafim: folds 
puffy5533: folds 
MrJarte has timed out while disconnected
MrJarte: folds 
Uncalled bet ($0.15) returned to seula i
seula i collected $0.20 from pot
seula i: doesn't show hand 
*** SUMMARY ***
Total pot $0.20 | Rake $0 
Seat 1: puffy5533 (button) folded before Flop (didn't bet)
Seat 2: MrJarte (small blind) folded before Flop
Seat 3: seula i (big blind) collected ($0.20)
Seat 4: Roglus folded before Flop (didn't bet)
Seat 5: chiyuki folded before Flop (didn't bet)
Seat 6: BlOnDhOlIc folded before Flop (didn't bet)
Seat 7: cr0lox folded before Flop (didn't bet)
Seat 8: ladymadon107 folded before Flop (didn't bet)
Seat 9: Anafim folded before Flop (didn't bet)



PokerStars Zoom Hand #84299132673:  Hold'em No Limit ($0.10/$0.25) - 2012/08/05 13:58:53 JST [2012/08/05 0:58:53 ET]
Table 'Whirlpool' 9-max Seat #1 is the button
Seat 1: KeLevro0 ($9.53 in chips) 
Seat 2: Ellen1947 ($32.60 in chips) 
Seat 3: Wilcox76607 ($26.82 in chips) 
Seat 4: chiyuki ($39.54 in chips) 
Seat 5: Tom1999 ($14.65 in chips) 
Seat 6: RikkStroken ($15 in chips) 
Seat 7: Suhoff76 ($40.30 in chips) 
Seat 8: americoluz ($25.35 in chips) 
Seat 9: solawind ($13.47 in chips) 
Ellen1947: posts small blind $0.10
Wilcox76607: posts big blind $0.25
*** HOLE CARDS ***
Dealt to chiyuki [4s 4d]
chiyuki: folds 
Tom1999: raises $0.50 to $0.75
RikkStroken: folds 
Suhoff76: folds 
americoluz: folds 
solawind: folds 
KeLevro0: folds 
Ellen1947: folds 
Wilcox76607: calls $0.50
*** FLOP *** [7h Jc Tc]
Wilcox76607: checks 
Tom1999: bets $0.50
Wilcox76607: calls $0.50
*** TURN *** [7h Jc Tc] [8h]
Wilcox76607: bets $1
Tom1999: calls $1
*** RIVER *** [7h Jc Tc 8h] [Kd]
Wilcox76607: bets $2
Tom1999: calls $2
*** SHOW DOWN ***
Wilcox76607: shows [Kc Js] (two pair, Kings and Jacks)
Tom1999: shows [9d 9s] (a straight, Seven to Jack)
Tom1999 collected $8.21 from pot
*** SUMMARY ***
Total pot $8.60 | Rake $0.39 
Board [7h Jc Tc 8h Kd]
Seat 1: KeLevro0 (button) folded before Flop (didn't bet)
Seat 2: Ellen1947 (small blind) folded before Flop
Seat 3: Wilcox76607 (big blind) showed [Kc Js] and lost with two pair, Kings and Jacks
Seat 4: chiyuki folded before Flop (didn't bet)
Seat 5: Tom1999 showed [9d 9s] and won ($8.21) with a straight, Seven to Jack
Seat 6: RikkStroken folded before Flop (didn't bet)
Seat 7: Suhoff76 folded before Flop (didn't bet)
Seat 8: americoluz folded before Flop (didn't bet)
Seat 9: solawind folded before Flop (didn't bet)



PokerStars Zoom Hand #84299133453:  Hold'em No Limit ($0.10/$0.25) - 2012/08/05 13:58:57 JST [2012/08/05 0:58:57 ET]
Table 'Whirlpool' 9-max Seat #1 is the button
Seat 1: chiyuki ($39.54 in chips) 
Seat 2: ChrisCDee ($32.83 in chips) 
Seat 3: RikkStroken ($15 in chips) 
Seat 4: kamikkaze ($11.55 in chips) 
Seat 5: KeLevro0 ($9.53 in chips) 
Seat 6: Suhoff76 ($40.30 in chips) 
Seat 7: NastyMcNast ($26.14 in chips) 
Seat 8: BlackZafiro ($25 in chips) 
Seat 9: TErr18 ($15.65 in chips) 
ChrisCDee: posts small blind $0.10
RikkStroken: posts big blind $0.25
*** HOLE CARDS ***
Dealt to chiyuki [Kd Kh]
kamikkaze: raises $0.38 to $0.63
KeLevro0: folds 
Suhoff76: folds 
NastyMcNast: folds 
BlackZafiro: folds 
TErr18: calls $0.63
chiyuki: raises $1.88 to $2.51
ChrisCDee: folds 
RikkStroken: folds 
kamikkaze: folds 
TErr18: calls $1.88
*** FLOP *** [6h 7d 6d]
TErr18: checks 
chiyuki: bets $4
TErr18: calls $4
*** TURN *** [6h 7d 6d] [Qs]
TErr18: bets $9.14 and is all-in
chiyuki: calls $9.14
*** RIVER *** [6h 7d 6d Qs] [Kc]
*** SHOW DOWN ***
TErr18: shows [4h 4d] (two pair, Sixes and Fours)
chiyuki: shows [Kd Kh] (a full house, Kings full of Sixes)
chiyuki collected $30.83 from pot
*** SUMMARY ***
Total pot $32.28 | Rake $1.45 
Board [6h 7d 6d Qs Kc]
Seat 1: chiyuki (button) showed [Kd Kh] and won ($30.83) with a full house, Kings full of Sixes
Seat 2: ChrisCDee (small blind) folded before Flop
Seat 3: RikkStroken (big blind) folded before Flop
Seat 4: kamikkaze folded before Flop
Seat 5: KeLevro0 folded before Flop (didn't bet)
Seat 6: Suhoff76 folded before Flop (didn't bet)
Seat 7: NastyMcNast folded before Flop (didn't bet)
Seat 8: BlackZafiro folded before Flop (didn't bet)
Seat 9: TErr18 showed [4h 4d] and lost with two pair, Sixes and Fours



PokerStars Zoom Hand #84299142172:  Hold'em No Limit ($0.10/$0.25) - 2012/08/05 13:59:41 JST [2012/08/05 0:59:41 ET]
Table 'Whirlpool' 9-max Seat #1 is the button
Seat 1: PetitAlejo ($35.58 in chips) 
Seat 2: RomarioJa ($5.48 in chips) 
Seat 3: Th3Fog ($21.29 in chips) 
Seat 4: Dafleche ($14.59 in chips) 
Seat 5: Alvinpe85 ($37.13 in chips) 
Seat 6: hirozo ($28.92 in chips) 
Seat 7: fezman ($18.53 in chips) 
Seat 8: Tom1999 ($10.25 in chips) 
Seat 9: chiyuki ($54.72 in chips) 
RomarioJa: posts small blind $0.10
Th3Fog: posts big blind $0.25
*** HOLE CARDS ***
Dealt to chiyuki [Kc 8h]
Dafleche: folds 
Alvinpe85: folds 
hirozo: folds 
fezman: folds 
Tom1999: raises $0.50 to $0.75
chiyuki: folds 
PetitAlejo: folds 
RomarioJa: folds 
Th3Fog: folds 
Uncalled bet ($0.50) returned to Tom1999
Tom1999 collected $0.60 from pot
Tom1999: doesn't show hand 
*** SUMMARY ***
Total pot $0.60 | Rake $0 
Seat 1: PetitAlejo (button) folded before Flop (didn't bet)
Seat 2: RomarioJa (small blind) folded before Flop
Seat 3: Th3Fog (big blind) folded before Flop
Seat 4: Dafleche folded before Flop (didn't bet)
Seat 5: Alvinpe85 folded before Flop (didn't bet)
Seat 6: hirozo folded before Flop (didn't bet)
Seat 7: fezman folded before Flop (didn't bet)
Seat 8: Tom1999 collected ($0.60)
Seat 9: chiyuki folded before Flop (didn't bet)



PokerStars Zoom Hand #84299144585:  Hold'em No Limit ($0.10/$0.25) - 2012/08/05 13:59:49 JST [2012/08/05 0:59:49 ET]
Table 'Whirlpool' 9-max Seat #1 is the button
Seat 1: BlackZafiro ($25.10 in chips) 
Seat 2: seula i ($25 in chips) 
Seat 3: D@vidMed ($52.44 in chips) 
Seat 4: hirozo ($28.02 in chips) 
Seat 5: Dejacob ($28.65 in chips) 
Seat 6: giorgos_k ($9.68 in chips) 
Seat 7: carlosrbr ($11.26 in chips) 
Seat 8: chiyuki ($54.72 in chips) 
Seat 9: Wilcox76607 ($22.47 in chips) 
seula i: posts small blind $0.10
D@vidMed: posts big blind $0.25
*** HOLE CARDS ***
Dealt to chiyuki [4d 7h]
hirozo: folds 
Dejacob: folds 
giorgos_k: folds 
carlosrbr: folds 
chiyuki: folds 
Wilcox76607: folds 
BlackZafiro: folds 
seula i: folds 
Uncalled bet ($0.15) returned to D@vidMed
D@vidMed collected $0.20 from pot
D@vidMed: doesn't show hand 
*** SUMMARY ***
Total pot $0.20 | Rake $0 
Seat 1: BlackZafiro (button) folded before Flop (didn't bet)
Seat 2: seula i (small blind) folded before Flop
Seat 3: D@vidMed (big blind) collected ($0.20)
Seat 4: hirozo folded before Flop (didn't bet)
Seat 5: Dejacob folded before Flop (didn't bet)
Seat 6: giorgos_k folded before Flop (didn't bet)
Seat 7: carlosrbr folded before Flop (didn't bet)
Seat 8: chiyuki folded before Flop (didn't bet)
Seat 9: Wilcox76607 folded before Flop (didn't bet)



PokerStars Zoom Hand #84299146145:  Hold'em No Limit ($0.10/$0.25) - 2012/08/05 13:59:56 JST [2012/08/05 0:59:56 ET]
Table 'Whirlpool' 9-max Seat #1 is the button
Seat 1: deadmoneykid ($20.60 in chips) 
Seat 2: Suhoff76 ($25.10 in chips) 
Seat 3: Ellen1947 ($39.13 in chips) 
Seat 4: Nerkit ($16.32 in chips) 
Seat 5: ll_LaMeR_ll ($73.06 in chips) 
Seat 6: Lasutchik ($7.63 in chips) 
Seat 7: chiyuki ($54.72 in chips) 
Seat 8: solawind ($12.72 in chips) 
Seat 9: DjJooni ($32.83 in chips) 
Suhoff76: posts small blind $0.10
Ellen1947: posts big blind $0.25
*** HOLE CARDS ***
Dealt to chiyuki [Ad Qd]
Nerkit: folds 
ll_LaMeR_ll: folds 
Lasutchik: folds 
chiyuki: raises $0.50 to $0.75
solawind: folds 
DjJooni has timed out
DjJooni: folds 
deadmoneykid: folds 
Suhoff76: calls $0.65
Ellen1947: folds 
*** FLOP *** [Ac Kd Jh]
Suhoff76: checks 
chiyuki: bets $1
Suhoff76: folds 
Uncalled bet ($1) returned to chiyuki
chiyuki collected $1.67 from pot
chiyuki: doesn't show hand 
*** SUMMARY ***
Total pot $1.75 | Rake $0.08 
Board [Ac Kd Jh]
Seat 1: deadmoneykid (button) folded before Flop (didn't bet)
Seat 2: Suhoff76 (small blind) folded on the Flop
Seat 3: Ellen1947 (big blind) folded before Flop
Seat 4: Nerkit folded before Flop (didn't bet)
Seat 5: ll_LaMeR_ll folded before Flop (didn't bet)
Seat 6: Lasutchik folded before Flop (didn't bet)
Seat 7: chiyuki collected ($1.67)
Seat 8: solawind folded before Flop (didn't bet)
Seat 9: DjJooni folded before Flop (didn't bet)



PokerStars Zoom Hand #84299156300:  Hold'em No Limit ($0.10/$0.25) - 2012/08/05 14:00:43 JST [2012/08/05 1:00:43 ET]
Table 'Whirlpool' 9-max Seat #1 is the button
Seat 1: hirozo ($30.97 in chips) 
Seat 2: wtu1986 ($30.88 in chips) 
Seat 3: Perstenev ($13 in chips) 
Seat 4: fwani ($25 in chips) 
Seat 5: carlosrbr ($12.18 in chips) 
Seat 6: chiyuki ($55.64 in chips) 
Seat 7: mariuka1 ($5.84 in chips) 
Seat 8: Dejacob ($51.10 in chips) 
Seat 9: KeLevro0 ($12.83 in chips) 
wtu1986: posts small blind $0.10
Perstenev: posts big blind $0.25
*** HOLE CARDS ***
Dealt to chiyuki [7d Kd]
fwani: folds 
carlosrbr: folds 
chiyuki: folds 
mariuka1: folds 
Dejacob: folds 
KeLevro0: folds 
hirozo: raises $0.25 to $0.50
wtu1986: folds 
Perstenev: folds 
Uncalled bet ($0.25) returned to hirozo
hirozo collected $0.60 from pot
hirozo: doesn't show hand 
*** SUMMARY ***
Total pot $0.60 | Rake $0 
Seat 1: hirozo (button) collected ($0.60)
Seat 2: wtu1986 (small blind) folded before Flop
Seat 3: Perstenev (big blind) folded before Flop
Seat 4: fwani folded before Flop (didn't bet)
Seat 5: carlosrbr folded before Flop (didn't bet)
Seat 6: chiyuki folded before Flop (didn't bet)
Seat 7: mariuka1 folded before Flop (didn't bet)
Seat 8: Dejacob folded before Flop (didn't bet)
Seat 9: KeLevro0 folded before Flop (didn't bet)



PokerStars Zoom Hand #84299158667:  Hold'em No Limit ($0.10/$0.25) - 2012/08/05 14:00:53 JST [2012/08/05 1:00:53 ET]
Table 'Whirlpool' 9-max Seat #1 is the button
Seat 1: Nec Arg ($25.10 in chips) 
Seat 2: peng2astic ($9.52 in chips) 
Seat 3: chiyuki ($55.64 in chips) 
Seat 4: flyinprits ($46.70 in chips) 
Seat 5: Loholov ($20.20 in chips) 
Seat 6: Lasutchik ($33.14 in chips) 
Seat 7: RikkStroken ($17.09 in chips) 
Seat 8: agurio ($25 in chips) 
Seat 9: PetitAlejo ($27.47 in chips) 
peng2astic: posts small blind $0.10
chiyuki: posts big blind $0.25
*** HOLE CARDS ***
Dealt to chiyuki [9h Kc]
flyinprits: folds 
Loholov: folds 
Lasutchik: folds 
RikkStroken: folds 
agurio: folds 
PetitAlejo: raises $0.50 to $0.75
Nec Arg: folds 
peng2astic: folds 
chiyuki: folds 
Uncalled bet ($0.50) returned to PetitAlejo
PetitAlejo collected $0.60 from pot
PetitAlejo: doesn't show hand 
*** SUMMARY ***
Total pot $0.60 | Rake $0 
Seat 1: Nec Arg (button) folded before Flop (didn't bet)
Seat 2: peng2astic (small blind) folded before Flop
Seat 3: chiyuki (big blind) folded before Flop
Seat 4: flyinprits folded before Flop (didn't bet)
Seat 5: Loholov folded before Flop (didn't bet)
Seat 6: Lasutchik folded before Flop (didn't bet)
Seat 7: RikkStroken folded before Flop (didn't bet)
Seat 8: agurio folded before Flop (didn't bet)
Seat 9: PetitAlejo collected ($0.60)



PokerStars Zoom Hand #84299166198:  Hold'em No Limit ($0.10/$0.25) - 2012/08/05 14:01:25 JST [2012/08/05 1:01:25 ET]
Table 'Whirlpool' 9-max Seat #1 is the button
Seat 1: BlOnDhOlIc ($25.21 in chips) 
Seat 2: chiyuki ($55.39 in chips) 
Seat 3: DjJooni ($32.33 in chips) 
Seat 4: PetitAlejo ($34.73 in chips) 
Seat 5: slapshot2011 ($19.19 in chips) 
Seat 6: 2997qwer ($9.55 in chips) 
Seat 7: Déculotter69 ($13.32 in chips) 
Seat 8: Perstenev ($12.65 in chips) 
Seat 9: 123progress ($28.23 in chips) 
chiyuki: posts small blind $0.10
DjJooni: posts big blind $0.25
*** HOLE CARDS ***
Dealt to chiyuki [6c 6h]
PetitAlejo: folds 
slapshot2011: raises $0.50 to $0.75
2997qwer: folds 
Déculotter69: raises $1.25 to $2
Perstenev: folds 
123progress: folds 
BlOnDhOlIc: folds 
chiyuki: folds 
DjJooni: folds 
slapshot2011: calls $1.25
*** FLOP *** [Ts 8s 5c]
slapshot2011: folds 
Déculotter69 collected $4.15 from pot
Déculotter69: doesn't show hand 
*** SUMMARY ***
Total pot $4.35 | Rake $0.20 
Board [Ts 8s 5c]
Seat 1: BlOnDhOlIc (button) folded before Flop (didn't bet)
Seat 2: chiyuki (small blind) folded before Flop
Seat 3: DjJooni (big blind) folded before Flop
Seat 4: PetitAlejo folded before Flop (didn't bet)
Seat 5: slapshot2011 folded on the Flop
Seat 6: 2997qwer folded before Flop (didn't bet)
Seat 7: Déculotter69 collected ($4.15)
Seat 8: Perstenev folded before Flop (didn't bet)
Seat 9: 123progress folded before Flop (didn't bet)



PokerStars Zoom Hand #84299163489:  Hold'em No Limit ($0.10/$0.25) - 2012/08/05 14:01:13 JST [2012/08/05 1:01:13 ET]
Table 'Whirlpool' 9-max Seat #1 is the button
Seat 1: Lasutchik ($33.14 in chips) 
Seat 2: KeLevro0 ($10.06 in chips) 
Seat 3: ChrisCDee ($31.73 in chips) 
Seat 4: slapshot2011 ($19.19 in chips) 
Seat 5: agurio ($27.20 in chips) 
Seat 6: fwani ($35.11 in chips) 
Seat 7: Perstenev ($12.65 in chips) 
Seat 8: chiyuki ($55.39 in chips) 
Seat 9: Th3Fog ($66.01 in chips) 
KeLevro0: posts small blind $0.10
ChrisCDee: posts big blind $0.25
*** HOLE CARDS ***
Dealt to chiyuki [9s Js]
slapshot2011: folds 
agurio: folds 
fwani: folds 
Perstenev: folds 
chiyuki: folds 
Th3Fog: raises $0.47 to $0.72
Lasutchik: raises $1.28 to $2
KeLevro0: folds 
ChrisCDee: folds 
Th3Fog: folds 
Uncalled bet ($1.28) returned to Lasutchik
Lasutchik collected $1.79 from pot
Lasutchik: doesn't show hand 
*** SUMMARY ***
Total pot $1.79 | Rake $0 
Seat 1: Lasutchik (button) collected ($1.79)
Seat 2: KeLevro0 (small blind) folded before Flop
Seat 3: ChrisCDee (big blind) folded before Flop
Seat 4: slapshot2011 folded before Flop (didn't bet)
Seat 5: agurio folded before Flop (didn't bet)
Seat 6: fwani folded before Flop (didn't bet)
Seat 7: Perstenev folded before Flop (didn't bet)
Seat 8: chiyuki folded before Flop (didn't bet)
Seat 9: Th3Fog folded before Flop



PokerStars Zoom Hand #84299169719:  Hold'em No Limit ($0.10/$0.25) - 2012/08/05 14:01:39 JST [2012/08/05 1:01:39 ET]
Table 'Whirlpool' 9-max Seat #1 is the button
Seat 1: Lasutchik ($6.88 in chips) 
Seat 2: Nerkit ($12.15 in chips) 
Seat 3: flyinprits ($46.64 in chips) 
Seat 4: Suhoff76 ($40.39 in chips) 
Seat 5: chiyuki ($55.29 in chips) 
Seat 6: Perstenev ($12.65 in chips) 
Seat 7: Ellen1947 ($31.90 in chips) 
Seat 8: Wilcox76607 ($22.64 in chips) 
Seat 9: 2997qwer ($9.95 in chips) 
Nerkit: posts small blind $0.10
flyinprits: posts big blind $0.25
*** HOLE CARDS ***
Dealt to chiyuki [Kc 9c]
Suhoff76: raises $0.32 to $0.57
chiyuki: folds 
Perstenev: folds 
Ellen1947: folds 
Wilcox76607: folds 
2997qwer: folds 
Lasutchik: folds 
Nerkit: raises $0.93 to $1.50
flyinprits: folds 
Suhoff76: folds 
Uncalled bet ($0.93) returned to Nerkit
Nerkit collected $1.39 from pot
Nerkit: doesn't show hand 
*** SUMMARY ***
Total pot $1.39 | Rake $0 
Seat 1: Lasutchik (button) folded before Flop (didn't bet)
Seat 2: Nerkit (small blind) collected ($1.39)
Seat 3: flyinprits (big blind) folded before Flop
Seat 4: Suhoff76 folded before Flop
Seat 5: chiyuki folded before Flop (didn't bet)
Seat 6: Perstenev folded before Flop (didn't bet)
Seat 7: Ellen1947 folded before Flop (didn't bet)
Seat 8: Wilcox76607 folded before Flop (didn't bet)
Seat 9: 2997qwer folded before Flop (didn't bet)



PokerStars Zoom Hand #84299170841:  Hold'em No Limit ($0.10/$0.25) - 2012/08/05 14:01:43 JST [2012/08/05 1:01:43 ET]
Table 'Whirlpool' 9-max Seat #1 is the button
Seat 1: chiyuki ($55.29 in chips) 
Seat 2: agurio ($26.95 in chips) 
Seat 3: KeLevro0 ($9.53 in chips) 
Seat 4: 123progress ($39.63 in chips) 
Seat 5: Loholov ($23.51 in chips) 
Seat 6: wildy29 ($29.06 in chips) 
Seat 7: hirozo ($27.20 in chips) 
Seat 8: kamikkaze ($13.25 in chips) 
Seat 9: leo2095 ($14.50 in chips) 
agurio: posts small blind $0.10
KeLevro0: posts big blind $0.25
*** HOLE CARDS ***
Dealt to chiyuki [Ad Qc]
123progress: folds 
Loholov: folds 
wildy29: calls $0.25
hirozo: folds 
kamikkaze: folds 
leo2095: folds 
chiyuki: raises $0.75 to $1
agurio: folds 
KeLevro0: folds 
wildy29: calls $0.75
*** FLOP *** [Ks 5s 8h]
wildy29: bets $1
chiyuki: raises $1.50 to $2.50
wildy29: calls $1.50
*** TURN *** [Ks 5s 8h] [4s]
wildy29: bets $2.50
chiyuki: folds 
Uncalled bet ($2.50) returned to wildy29
wildy29 collected $7.02 from pot
wildy29: doesn't show hand 
*** SUMMARY ***
Total pot $7.35 | Rake $0.33 
Board [Ks 5s 8h 4s]
Seat 1: chiyuki (button) folded on the Turn
Seat 2: agurio (small blind) folded before Flop
Seat 3: KeLevro0 (big blind) folded before Flop
Seat 4: 123progress folded before Flop (didn't bet)
Seat 5: Loholov folded before Flop (didn't bet)
Seat 6: wildy29 collected ($7.02)
Seat 7: hirozo folded before Flop (didn't bet)
Seat 8: kamikkaze folded before Flop (didn't bet)
Seat 9: leo2095 folded before Flop (didn't bet)



PokerStars Zoom Hand #84299186554:  Hold'em No Limit ($0.10/$0.25) - 2012/08/05 14:02:45 JST [2012/08/05 1:02:45 ET]
Table 'Whirlpool' 9-max Seat #1 is the button
Seat 1: Dejacob ($25.25 in chips) 
Seat 2: kamikkaze ($14.75 in chips) 
Seat 3: Loholov ($15 in chips) 
Seat 4: slapshot2011 ($26.97 in chips) 
Seat 5: Roglus ($19.24 in chips) 
Seat 6: chiyuki ($51.79 in chips) 
Seat 7: giorgos_k ($39.41 in chips) 
Seat 8: 123progress ($39.63 in chips) 
Seat 9: BlOnDhOlIc ($47.78 in chips) 
kamikkaze: posts small blind $0.10
Loholov: posts big blind $0.25
*** HOLE CARDS ***
Dealt to chiyuki [9c 8c]
slapshot2011: folds 
Roglus: raises $0.37 to $0.62
chiyuki: folds 
giorgos_k: folds 
123progress: folds 
BlOnDhOlIc: folds 
Dejacob: folds 
kamikkaze: folds 
Loholov: calls $0.37
*** FLOP *** [2h Qh 6d]
Loholov: checks 
Roglus: bets $0.87
Loholov: folds 
Uncalled bet ($0.87) returned to Roglus
Roglus collected $1.28 from pot
Roglus: doesn't show hand 
*** SUMMARY ***
Total pot $1.34 | Rake $0.06 
Board [2h Qh 6d]
Seat 1: Dejacob (button) folded before Flop (didn't bet)
Seat 2: kamikkaze (small blind) folded before Flop
Seat 3: Loholov (big blind) folded on the Flop
Seat 4: slapshot2011 folded before Flop (didn't bet)
Seat 5: Roglus collected ($1.28)
Seat 6: chiyuki folded before Flop (didn't bet)
Seat 7: giorgos_k folded before Flop (didn't bet)
Seat 8: 123progress folded before Flop (didn't bet)
Seat 9: BlOnDhOlIc folded before Flop (didn't bet)



PokerStars Zoom Hand #84299187888:  Hold'em No Limit ($0.10/$0.25) - 2012/08/05 14:02:50 JST [2012/08/05 1:02:50 ET]
Table 'Whirlpool' 9-max Seat #1 is the button
Seat 1: 123progress ($39.63 in chips) 
Seat 2: RikkStroken ($23.90 in chips) 
Seat 3: deadmoneykid ($25 in chips) 
Seat 4: Perstenev ($12.30 in chips) 
Seat 5: Suhoff76 ($26.03 in chips) 
Seat 6: Noviekid ($29.19 in chips) 
Seat 7: Dejacob ($25.25 in chips) 
Seat 8: seula i ($36.75 in chips) 
Seat 9: chiyuki ($51.79 in chips) 
RikkStroken: posts small blind $0.10
deadmoneykid: posts big blind $0.25
*** HOLE CARDS ***
Dealt to chiyuki [Jc Jh]
Perstenev has timed out
Perstenev: folds 
Suhoff76: folds 
Noviekid: folds 
Dejacob: folds 
seula i: folds 
chiyuki: raises $0.50 to $0.75
123progress: folds 
RikkStroken: folds 
deadmoneykid: folds 
Uncalled bet ($0.50) returned to chiyuki
chiyuki collected $0.60 from pot
chiyuki: doesn't show hand 
*** SUMMARY ***
Total pot $0.60 | Rake $0 
Seat 1: 123progress (button) folded before Flop (didn't bet)
Seat 2: RikkStroken (small blind) folded before Flop
Seat 3: deadmoneykid (big blind) folded before Flop
Seat 4: Perstenev folded before Flop (didn't bet)
Seat 5: Suhoff76 folded before Flop (didn't bet)
Seat 6: Noviekid folded before Flop (didn't bet)
Seat 7: Dejacob folded before Flop (didn't bet)
Seat 8: seula i folded before Flop (didn't bet)
Seat 9: chiyuki collected ($0.60)



PokerStars Zoom Hand #84299201799:  Hold'em No Limit ($0.10/$0.25) - 2012/08/05 14:03:43 JST [2012/08/05 1:03:43 ET]
Table 'Whirlpool' 9-max Seat #1 is the button
Seat 1: kkbruins0408 ($14.65 in chips) 
Seat 2: KeLevro0 ($12.41 in chips) 
Seat 3: chiyuki ($52.14 in chips) 
Seat 4: Tom1999 ($14.42 in chips) 
Seat 5: PetitAlejo ($35.81 in chips) 
Seat 6: Dejacob ($49.90 in chips) 
Seat 7: Wilcox76607 ($17.95 in chips) 
Seat 8: hirozo ($26.17 in chips) 
Seat 9: deadmoneykid ($24.65 in chips) 
KeLevro0: posts small blind $0.10
chiyuki: posts big blind $0.25
*** HOLE CARDS ***
Dealt to chiyuki [Ts 6s]
Tom1999: folds 
PetitAlejo: folds 
Dejacob: folds 
Wilcox76607: raises $0.50 to $0.75
hirozo: folds 
deadmoneykid: folds 
kkbruins0408: folds 
KeLevro0: folds 
chiyuki: folds 
Uncalled bet ($0.50) returned to Wilcox76607
Wilcox76607 collected $0.60 from pot
Wilcox76607: doesn't show hand 
*** SUMMARY ***
Total pot $0.60 | Rake $0 
Seat 1: kkbruins0408 (button) folded before Flop (didn't bet)
Seat 2: KeLevro0 (small blind) folded before Flop
Seat 3: chiyuki (big blind) folded before Flop
Seat 4: Tom1999 folded before Flop (didn't bet)
Seat 5: PetitAlejo folded before Flop (didn't bet)
Seat 6: Dejacob folded before Flop (didn't bet)
Seat 7: Wilcox76607 collected ($0.60)
Seat 8: hirozo folded before Flop (didn't bet)
Seat 9: deadmoneykid folded before Flop (didn't bet)



PokerStars Zoom Hand #84299199384:  Hold'em No Limit ($0.10/$0.25) - 2012/08/05 14:03:34 JST [2012/08/05 1:03:34 ET]
Table 'Whirlpool' 9-max Seat #1 is the button
Seat 1: BlOnDhOlIc ($61.72 in chips) 
Seat 2: BlackZafiro ($46.46 in chips) 
Seat 3: seula i ($27.96 in chips) 
Seat 4: kamikkaze ($18.58 in chips) 
Seat 5: Suhoff76 ($39.47 in chips) 
Seat 6: PetitAlejo ($26.77 in chips) 
Seat 7: chiyuki ($52.14 in chips) 
Seat 8: KeLevro0 ($12.41 in chips) 
Seat 9: RomarioJa ($11.96 in chips) 
BlackZafiro: posts small blind $0.10
seula i: posts big blind $0.25
*** HOLE CARDS ***
Dealt to chiyuki [7s 3c]
kamikkaze: raises $0.76 to $1.01
Suhoff76: calls $1.01
PetitAlejo: folds 
chiyuki: folds 
KeLevro0: folds 
RomarioJa: folds 
BlOnDhOlIc: folds 
BlackZafiro: folds 
seula i: raises $1.99 to $3
kamikkaze: calls $1.99
Suhoff76: folds 
*** FLOP *** [Ad 7d 5d]
seula i: bets $4.75
kamikkaze: calls $4.75
*** TURN *** [Ad 7d 5d] [Qc]
seula i: bets $20.21 and is all-in
kamikkaze: calls $10.83 and is all-in
Uncalled bet ($9.38) returned to seula i
*** RIVER *** [Ad 7d 5d Qc] [3d]
*** SHOW DOWN ***
seula i: shows [Kc As] (a pair of Aces)
kamikkaze: shows [Jd Jc] (a flush, Ace high)
kamikkaze collected $36.55 from pot
*** SUMMARY ***
Total pot $38.27 | Rake $1.72 
Board [Ad 7d 5d Qc 3d]
Seat 1: BlOnDhOlIc (button) folded before Flop (didn't bet)
Seat 2: BlackZafiro (small blind) folded before Flop
Seat 3: seula i (big blind) showed [Kc As] and lost with a pair of Aces
Seat 4: kamikkaze showed [Jd Jc] and won ($36.55) with a flush, Ace high
Seat 5: Suhoff76 folded before Flop
Seat 6: PetitAlejo folded before Flop (didn't bet)
Seat 7: chiyuki folded before Flop (didn't bet)
Seat 8: KeLevro0 folded before Flop (didn't bet)
Seat 9: RomarioJa folded before Flop (didn't bet)



PokerStars Zoom Hand #84299205205:  Hold'em No Limit ($0.10/$0.25) - 2012/08/05 14:03:57 JST [2012/08/05 1:03:57 ET]
Table 'Whirlpool' 9-max Seat #1 is the button
Seat 1: BlOnDhOlIc ($58.70 in chips) 
Seat 2: PetitAlejo ($26.77 in chips) 
Seat 3: hirozo ($31.27 in chips) 
Seat 4: 2997qwer ($9.20 in chips) 
Seat 5: wtu1986 ($26.94 in chips) 
Seat 6: chiyuki ($51.89 in chips) 
Seat 7: Loholov ($15 in chips) 
Seat 8: ygoegoe ($34.16 in chips) 
Seat 9: KeLevro0 ($12.31 in chips) 
PetitAlejo: posts small blind $0.10
hirozo: posts big blind $0.25
*** HOLE CARDS ***
Dealt to chiyuki [Ad Kc]
2997qwer: folds 
wtu1986: folds 
chiyuki: raises $0.50 to $0.75
Loholov: folds 
ygoegoe: folds 
KeLevro0: folds 
BlOnDhOlIc: folds 
PetitAlejo: folds 
hirozo: folds 
Uncalled bet ($0.50) returned to chiyuki
chiyuki collected $0.60 from pot
chiyuki: doesn't show hand 
*** SUMMARY ***
Total pot $0.60 | Rake $0 
Seat 1: BlOnDhOlIc (button) folded before Flop (didn't bet)
Seat 2: PetitAlejo (small blind) folded before Flop
Seat 3: hirozo (big blind) folded before Flop
Seat 4: 2997qwer folded before Flop (didn't bet)
Seat 5: wtu1986 folded before Flop (didn't bet)
Seat 6: chiyuki collected ($0.60)
Seat 7: Loholov folded before Flop (didn't bet)
Seat 8: ygoegoe folded before Flop (didn't bet)
Seat 9: KeLevro0 folded before Flop (didn't bet)



PokerStars Zoom Hand #84299200517:  Hold'em No Limit ($0.10/$0.25) - 2012/08/05 14:03:38 JST [2012/08/05 1:03:38 ET]
Table 'Whirlpool' 9-max Seat #1 is the button
Seat 1: Wilcox76607 ($17.95 in chips) 
Seat 2: 123progress ($39.38 in chips) 
Seat 3: 2997qwer ($12.90 in chips) 
Seat 4: chiyuki ($52.14 in chips) 
Seat 5: RikkStroken ($25 in chips) 
Seat 6: mariuka1 ($8.84 in chips) 
Seat 7: leo2095 ($14.15 in chips) 
Seat 8: BlOnDhOlIc ($61.72 in chips) 
Seat 9: KeLevro0 ($12.23 in chips) 
123progress: posts small blind $0.10
2997qwer: posts big blind $0.25
*** HOLE CARDS ***
Dealt to chiyuki [Ks 9h]
chiyuki: folds 
RikkStroken: raises $0.50 to $0.75
mariuka1: folds 
leo2095: folds 
BlOnDhOlIc: folds 
KeLevro0: folds 
Wilcox76607: folds 
123progress: calls $0.65
2997qwer: folds 
*** FLOP *** [2h 7c 6h]
123progress: checks 
RikkStroken: checks 
*** TURN *** [2h 7c 6h] [Qd]
123progress: checks 
RikkStroken: bets $1.10
123progress: calls $1.10
*** RIVER *** [2h 7c 6h Qd] [Th]
123progress: checks 
RikkStroken: checks 
*** SHOW DOWN ***
123progress: shows [8h 8s] (a pair of Eights)
RikkStroken: mucks hand 
123progress collected $3.77 from pot
*** SUMMARY ***
Total pot $3.95 | Rake $0.18 
Board [2h 7c 6h Qd Th]
Seat 1: Wilcox76607 (button) folded before Flop (didn't bet)
Seat 2: 123progress (small blind) showed [8h 8s] and won ($3.77) with a pair of Eights
Seat 3: 2997qwer (big blind) folded before Flop
Seat 4: chiyuki folded before Flop (didn't bet)
Seat 5: RikkStroken mucked [Ac Kd]
Seat 6: mariuka1 folded before Flop (didn't bet)
Seat 7: leo2095 folded before Flop (didn't bet)
Seat 8: BlOnDhOlIc folded before Flop (didn't bet)
Seat 9: KeLevro0 folded before Flop (didn't bet)



PokerStars Zoom Hand #84299213646:  Hold'em No Limit ($0.10/$0.25) - 2012/08/05 14:04:29 JST [2012/08/05 1:04:29 ET]
Table 'Whirlpool' 9-max Seat #1 is the button
Seat 1: BlOnDhOlIc ($25.45 in chips) 
Seat 2: chiyuki ($52.24 in chips) 
Seat 3: ChrisCDee ($33.43 in chips) 
Seat 4: 2997qwer ($9.20 in chips) 
Seat 5: D@vidMed ($57.60 in chips) 
Seat 6: ladymadon107 ($5.41 in chips) 
Seat 7: RikkStroken ($33.05 in chips) 
Seat 8: RomarioJa ($6.05 in chips) 
Seat 9: mariuka1 ($8.49 in chips) 
chiyuki: posts small blind $0.10
ChrisCDee: posts big blind $0.25
*** HOLE CARDS ***
Dealt to chiyuki [7d Ad]
2997qwer: folds 
D@vidMed: folds 
ladymadon107: folds 
RikkStroken: folds 
RomarioJa: folds 
mariuka1: folds 
BlOnDhOlIc: folds 
chiyuki: raises $0.50 to $0.75
ChrisCDee: folds 
Uncalled bet ($0.50) returned to chiyuki
chiyuki collected $0.50 from pot
chiyuki: doesn't show hand 
*** SUMMARY ***
Total pot $0.50 | Rake $0 
Seat 1: BlOnDhOlIc (button) folded before Flop (didn't bet)
Seat 2: chiyuki (small blind) collected ($0.50)
Seat 3: ChrisCDee (big blind) folded before Flop
Seat 4: 2997qwer folded before Flop (didn't bet)
Seat 5: D@vidMed folded before Flop (didn't bet)
Seat 6: ladymadon107 folded before Flop (didn't bet)
Seat 7: RikkStroken folded before Flop (didn't bet)
Seat 8: RomarioJa folded before Flop (didn't bet)
Seat 9: mariuka1 folded before Flop (didn't bet)



PokerStars Zoom Hand #84299212301:  Hold'em No Limit ($0.10/$0.25) - 2012/08/05 14:04:24 JST [2012/08/05 1:04:24 ET]
Table 'Whirlpool' 9-max Seat #1 is the button
Seat 1: chiyuki ($52.24 in chips) 
Seat 2: Suhoff76 ($42.52 in chips) 
Seat 3: Loholov ($15 in chips) 
Seat 4: ladymadon107 ($5.41 in chips) 
Seat 5: Wilcox76607 ($18.30 in chips) 
Seat 6: Anafim ($13.53 in chips) 
Seat 7: americoluz ($36.59 in chips) 
Seat 8: mariuka1 ($8.49 in chips) 
Seat 9: Dan Royal ($23.20 in chips) 
Suhoff76: posts small blind $0.10
Loholov: posts big blind $0.25
*** HOLE CARDS ***
Dealt to chiyuki [8h 5d]
ladymadon107: folds 
Wilcox76607: folds 
Anafim: calls $0.25
americoluz: calls $0.25
mariuka1: folds 
Dan Royal: folds 
chiyuki: folds 
Suhoff76: calls $0.15
Loholov: checks 
*** FLOP *** [9c Jd Js]
Suhoff76: checks 
Loholov: checks 
Anafim: checks 
americoluz: checks 
*** TURN *** [9c Jd Js] [Ts]
Suhoff76: checks 
Loholov: checks 
Anafim: checks 
americoluz: checks 
*** RIVER *** [9c Jd Js Ts] [4c]
Suhoff76: checks 
Loholov: checks 
Anafim: checks 
americoluz: checks 
*** SHOW DOWN ***
Suhoff76: shows [9s Th] (two pair, Jacks and Tens)
Loholov: mucks hand 
Anafim: mucks hand 
americoluz: mucks hand 
Suhoff76 collected $0.96 from pot
*** SUMMARY ***
Total pot $1 | Rake $0.04 
Board [9c Jd Js Ts 4c]
Seat 1: chiyuki (button) folded before Flop (didn't bet)
Seat 2: Suhoff76 (small blind) showed [9s Th] and won ($0.96) with two pair, Jacks and Tens
Seat 3: Loholov (big blind) mucked [7s 6s]
Seat 4: ladymadon107 folded before Flop (didn't bet)
Seat 5: Wilcox76607 folded before Flop (didn't bet)
Seat 6: Anafim mucked [8c 8d]
Seat 7: americoluz mucked [Ah Qc]
Seat 8: mariuka1 folded before Flop (didn't bet)
Seat 9: Dan Royal folded before Flop (didn't bet)



PokerStars Zoom Hand #84299220866:  Hold'em No Limit ($0.10/$0.25) - 2012/08/05 14:04:57 JST [2012/08/05 1:04:57 ET]
Table 'Whirlpool' 9-max Seat #1 is the button
Seat 1: Dejacob ($37.54 in chips) 
Seat 2: silvno31 ($41.99 in chips) 
Seat 3: Perstenev ($12.52 in chips) 
Seat 4: RomarioJa ($12.50 in chips) 
Seat 5: RikkStroken ($25.63 in chips) 
Seat 6: DanielWhyte ($26.26 in chips) 
Seat 7: KAKamiro ($61.71 in chips) 
Seat 8: chiyuki ($52.49 in chips) 
Seat 9: munky3 ($35.12 in chips) 
silvno31: posts small blind $0.10
Perstenev: posts big blind $0.25
*** HOLE CARDS ***
Dealt to chiyuki [Ac Qh]
RomarioJa: folds 
RikkStroken: raises $0.25 to $0.50
DanielWhyte: calls $0.50
KAKamiro: folds 
chiyuki: raises $1.50 to $2
munky3: folds 
Dejacob: folds 
silvno31: folds 
Perstenev: folds 
RikkStroken: folds 
DanielWhyte: calls $1.50
*** FLOP *** [3s 8d Js]
DanielWhyte: checks 
chiyuki: bets $3
DanielWhyte: folds 
Uncalled bet ($3) returned to chiyuki
chiyuki collected $4.63 from pot
chiyuki: doesn't show hand 
*** SUMMARY ***
Total pot $4.85 | Rake $0.22 
Board [3s 8d Js]
Seat 1: Dejacob (button) folded before Flop (didn't bet)
Seat 2: silvno31 (small blind) folded before Flop
Seat 3: Perstenev (big blind) folded before Flop
Seat 4: RomarioJa folded before Flop (didn't bet)
Seat 5: RikkStroken folded before Flop
Seat 6: DanielWhyte folded on the Flop
Seat 7: KAKamiro folded before Flop (didn't bet)
Seat 8: chiyuki collected ($4.63)
Seat 9: munky3 folded before Flop (didn't bet)



PokerStars Zoom Hand #84299234583:  Hold'em No Limit ($0.10/$0.25) - 2012/08/05 14:05:50 JST [2012/08/05 1:05:50 ET]
Table 'Whirlpool' 9-max Seat #1 is the button
Seat 1: ygoegoe ($35.49 in chips) 
Seat 2: carlosrbr ($19.99 in chips) 
Seat 3: chiyuki ($55.12 in chips) 
Seat 4: RomarioJa ($11.36 in chips) 
Seat 5: kamikkaze ($37 in chips) 
Seat 6: ll_LaMeR_ll ($61.89 in chips) 
Seat 7: seula i ($36.50 in chips) 
Seat 8: Anafim ($12.50 in chips) 
Seat 9: Perstenev ($12.17 in chips) 
carlosrbr: posts small blind $0.10
chiyuki: posts big blind $0.25
*** HOLE CARDS ***
Dealt to chiyuki [4d Kh]
RomarioJa: folds 
kamikkaze: folds 
ll_LaMeR_ll: folds 
seula i: raises $0.50 to $0.75
Anafim: folds 
Perstenev: folds 
ygoegoe: folds 
carlosrbr: folds 
chiyuki: folds 
Uncalled bet ($0.50) returned to seula i
seula i collected $0.60 from pot
seula i: doesn't show hand 
*** SUMMARY ***
Total pot $0.60 | Rake $0 
Seat 1: ygoegoe (button) folded before Flop (didn't bet)
Seat 2: carlosrbr (small blind) folded before Flop
Seat 3: chiyuki (big blind) folded before Flop
Seat 4: RomarioJa folded before Flop (didn't bet)
Seat 5: kamikkaze folded before Flop (didn't bet)
Seat 6: ll_LaMeR_ll folded before Flop (didn't bet)
Seat 7: seula i collected ($0.60)
Seat 8: Anafim folded before Flop (didn't bet)
Seat 9: Perstenev folded before Flop (didn't bet)



PokerStars Zoom Hand #84299230150:  Hold'em No Limit ($0.10/$0.25) - 2012/08/05 14:05:33 JST [2012/08/05 1:05:33 ET]
Table 'Whirlpool' 9-max Seat #1 is the button
Seat 1: RomarioJa ($10.30 in chips) 
Seat 2: hirozo ($29.67 in chips) 
Seat 3: BlOnDhOlIc ($46.42 in chips) 
Seat 4: kamikkaze ($37 in chips) 
Seat 5: chiyuki ($55.12 in chips) 
Seat 6: jeff0923 ($23.56 in chips) 
Seat 7: Nec Arg ($39.77 in chips) 
Seat 8: slapshot2011 ($31.02 in chips) 
Seat 9: Loholov ($15.25 in chips) 
hirozo: posts small blind $0.10
BlOnDhOlIc: posts big blind $0.25
*** HOLE CARDS ***
Dealt to chiyuki [4c Th]
kamikkaze: folds 
chiyuki: folds 
jeff0923: calls $0.25
Nec Arg: calls $0.25
slapshot2011: folds 
Loholov: folds 
RomarioJa: folds 
hirozo: folds 
BlOnDhOlIc: checks 
*** FLOP *** [9c 5c Kc]
BlOnDhOlIc: bets $0.60
jeff0923: folds 
Nec Arg: calls $0.60
*** TURN *** [9c 5c Kc] [Tc]
BlOnDhOlIc: checks 
Nec Arg: checks 
*** RIVER *** [9c 5c Kc Tc] [3d]
BlOnDhOlIc: checks 
Nec Arg: bets $1.25
BlOnDhOlIc: folds 
Uncalled bet ($1.25) returned to Nec Arg
Nec Arg collected $1.96 from pot
Nec Arg: doesn't show hand 
*** SUMMARY ***
Total pot $2.05 | Rake $0.09 
Board [9c 5c Kc Tc 3d]
Seat 1: RomarioJa (button) folded before Flop (didn't bet)
Seat 2: hirozo (small blind) folded before Flop
Seat 3: BlOnDhOlIc (big blind) folded on the River
Seat 4: kamikkaze folded before Flop (didn't bet)
Seat 5: chiyuki folded before Flop (didn't bet)
Seat 6: jeff0923 folded on the Flop
Seat 7: Nec Arg collected ($1.96)
Seat 8: slapshot2011 folded before Flop (didn't bet)
Seat 9: Loholov folded before Flop (didn't bet)



PokerStars Zoom Hand #84299231455:  Hold'em No Limit ($0.10/$0.25) - 2012/08/05 14:05:38 JST [2012/08/05 1:05:38 ET]
Table 'Whirlpool' 9-max Seat #1 is the button
Seat 1: Perstenev ($14.44 in chips) 
Seat 2: hirozo ($26.27 in chips) 
Seat 3: BlOnDhOlIc ($61.27 in chips) 
Seat 4: chiyuki ($55.12 in chips) 
Seat 5: kamikkaze ($37 in chips) 
Seat 6: RikkStroken ($25.13 in chips) 
Seat 7: Suhoff76 ($34.86 in chips) 
Seat 8: RomarioJa ($5.80 in chips) 
Seat 9: Loholov ($15 in chips) 
hirozo: posts small blind $0.10
BlOnDhOlIc: posts big blind $0.25
*** HOLE CARDS ***
Dealt to chiyuki [2c 3h]
chiyuki: folds 
kamikkaze: folds 
RikkStroken: folds 
Suhoff76: folds 
RomarioJa: folds 
Loholov: folds 
Perstenev: folds 
hirozo: raises $0.25 to $0.50
BlOnDhOlIc: calls $0.25
*** FLOP *** [6c 9h Jh]
hirozo: checks 
BlOnDhOlIc: bets $0.72
hirozo: folds 
Uncalled bet ($0.72) returned to BlOnDhOlIc
BlOnDhOlIc collected $0.96 from pot
BlOnDhOlIc: doesn't show hand 
*** SUMMARY ***
Total pot $1 | Rake $0.04 
Board [6c 9h Jh]
Seat 1: Perstenev (button) folded before Flop (didn't bet)
Seat 2: hirozo (small blind) folded on the Flop
Seat 3: BlOnDhOlIc (big blind) collected ($0.96)
Seat 4: chiyuki folded before Flop (didn't bet)
Seat 5: kamikkaze folded before Flop (didn't bet)
Seat 6: RikkStroken folded before Flop (didn't bet)
Seat 7: Suhoff76 folded before Flop (didn't bet)
Seat 8: RomarioJa folded before Flop (didn't bet)
Seat 9: Loholov folded before Flop (didn't bet)



PokerStars Zoom Hand #84299229393:  Hold'em No Limit ($0.10/$0.25) - 2012/08/05 14:05:30 JST [2012/08/05 1:05:30 ET]
Table 'Whirlpool' 9-max Seat #1 is the button
Seat 1: wtu1986 ($26.59 in chips) 
Seat 2: Tom1999 ($14.12 in chips) 
Seat 3: agurio ($27.52 in chips) 
Seat 4: cr0lox ($22 in chips) 
Seat 5: carlosrbr ($19.99 in chips) 
Seat 6: giorgos_k ($14.58 in chips) 
Seat 7: Dejacob ($25.08 in chips) 
Seat 8: KeLevro0 ($12.15 in chips) 
Seat 9: chiyuki ($55.12 in chips) 
Tom1999: posts small blind $0.10
agurio: posts big blind $0.25
*** HOLE CARDS ***
Dealt to chiyuki [5h Kc]
cr0lox: folds 
carlosrbr: folds 
giorgos_k: calls $0.25
Dejacob: raises $1 to $1.25
KeLevro0: folds 
chiyuki: folds 
wtu1986: calls $1.25
Tom1999: folds 
agurio: folds 
giorgos_k: calls $1
*** FLOP *** [Ah 4c 5d]
giorgos_k: checks 
Dejacob: bets $3
wtu1986: calls $3
giorgos_k: raises $10.33 to $13.33 and is all-in
Dejacob: folds 
wtu1986: calls $10.33
*** TURN *** [Ah 4c 5d] [2s]
*** RIVER *** [Ah 4c 5d 2s] [3h]
*** SHOW DOWN ***
giorgos_k: shows [Ks As] (a straight, Ace to Five)
wtu1986: shows [Kd Ad] (a straight, Ace to Five)
giorgos_k collected $16.12 from pot
wtu1986 collected $16.12 from pot
*** SUMMARY ***
Total pot $33.76 | Rake $1.52 
Board [Ah 4c 5d 2s 3h]
Seat 1: wtu1986 (button) showed [Kd Ad] and won ($16.12) with a straight, Ace to Five
Seat 2: Tom1999 (small blind) folded before Flop
Seat 3: agurio (big blind) folded before Flop
Seat 4: cr0lox folded before Flop (didn't bet)
Seat 5: carlosrbr folded before Flop (didn't bet)
Seat 6: giorgos_k showed [Ks As] and won ($16.12) with a straight, Ace to Five
Seat 7: Dejacob folded on the Flop
Seat 8: KeLevro0 folded before Flop (didn't bet)
Seat 9: chiyuki folded before Flop (didn't bet)



PokerStars Zoom Hand #84299239031:  Hold'em No Limit ($0.10/$0.25) - 2012/08/05 14:06:07 JST [2012/08/05 1:06:07 ET]
Table 'Whirlpool' 9-max Seat #1 is the button
Seat 1: 123progress ($26.51 in chips) 
Seat 2: Perstenev ($12.40 in chips) 
Seat 3: Landybob ($36.13 in chips) 
Seat 4: PetitAlejo ($35.36 in chips) 
Seat 5: 2997qwer ($12.25 in chips) 
Seat 6: KeLevro0 ($12.15 in chips) 
Seat 7: chiyuki ($54.87 in chips) 
Seat 8: agurio ($27.27 in chips) 
Seat 9: jeff0923 ($23.31 in chips) 
Perstenev: posts small blind $0.10
Landybob: posts big blind $0.25
*** HOLE CARDS ***
Dealt to chiyuki [9c 5h]
PetitAlejo: folds 
2997qwer: folds 
KeLevro0: folds 
chiyuki: folds 
agurio: folds 
jeff0923: calls $0.25
123progress: raises $1 to $1.25
Perstenev: folds 
Landybob: folds 
jeff0923: calls $1
*** FLOP *** [Ts Jc Kh]
jeff0923: checks 
123progress: checks 
*** TURN *** [Ts Jc Kh] [9d]
jeff0923: checks 
123progress: checks 
*** RIVER *** [Ts Jc Kh 9d] [8c]
jeff0923: checks 
123progress: checks 
*** SHOW DOWN ***
jeff0923: shows [Th Kc] (two pair, Kings and Tens)
123progress: mucks hand 
jeff0923 collected $2.72 from pot
*** SUMMARY ***
Total pot $2.85 | Rake $0.13 
Board [Ts Jc Kh 9d 8c]
Seat 1: 123progress (button) mucked [Ah As]
Seat 2: Perstenev (small blind) folded before Flop
Seat 3: Landybob (big blind) folded before Flop
Seat 4: PetitAlejo folded before Flop (didn't bet)
Seat 5: 2997qwer folded before Flop (didn't bet)
Seat 6: KeLevro0 folded before Flop (didn't bet)
Seat 7: chiyuki folded before Flop (didn't bet)
Seat 8: agurio folded before Flop (didn't bet)
Seat 9: jeff0923 showed [Th Kc] and won ($2.72) with two pair, Kings and Tens



PokerStars Zoom Hand #84299232244:  Hold'em No Limit ($0.10/$0.25) - 2012/08/05 14:05:41 JST [2012/08/05 1:05:41 ET]
Table 'Whirlpool' 9-max Seat #1 is the button
Seat 1: agurio ($27.27 in chips) 
Seat 2: hirozo ($30.75 in chips) 
Seat 3: cr0lox ($22 in chips) 
Seat 4: Anafim ($12.50 in chips) 
Seat 5: chiyuki ($55.12 in chips) 
Seat 6: Vahe50 ($10.87 in chips) 
Seat 7: Paranoix1990 ($12.68 in chips) 
Seat 8: ChrisCDee ($27.24 in chips) 
Seat 9: deadmoneykid ($24.25 in chips) 
hirozo: posts small blind $0.10
cr0lox: posts big blind $0.25
*** HOLE CARDS ***
Dealt to chiyuki [7d 5h]
Anafim: folds 
chiyuki: folds 
Vahe50: folds 
Paranoix1990: raises $0.25 to $0.50
ChrisCDee: calls $0.50
deadmoneykid: folds 
agurio: folds 
hirozo: folds 
cr0lox: folds 
*** FLOP *** [4c 2s 9d]
Paranoix1990: bets $0.50
ChrisCDee: calls $0.50
*** TURN *** [4c 2s 9d] [6s]
Paranoix1990: checks 
ChrisCDee: bets $1.34
Paranoix1990: folds 
Uncalled bet ($1.34) returned to ChrisCDee
ChrisCDee collected $2.24 from pot
ChrisCDee: doesn't show hand 
*** SUMMARY ***
Total pot $2.35 | Rake $0.11 
Board [4c 2s 9d 6s]
Seat 1: agurio (button) folded before Flop (didn't bet)
Seat 2: hirozo (small blind) folded before Flop
Seat 3: cr0lox (big blind) folded before Flop
Seat 4: Anafim folded before Flop (didn't bet)
Seat 5: chiyuki folded before Flop (didn't bet)
Seat 6: Vahe50 folded before Flop (didn't bet)
Seat 7: Paranoix1990 folded on the Turn
Seat 8: ChrisCDee collected ($2.24)
Seat 9: deadmoneykid folded before Flop (didn't bet)



PokerStars Zoom Hand #84299241078:  Hold'em No Limit ($0.10/$0.25) - 2012/08/05 14:06:16 JST [2012/08/05 1:06:16 ET]
Table 'Whirlpool' 9-max Seat #1 is the button
Seat 1: hirozo ($25.77 in chips) 
Seat 2: chiyuki ($54.87 in chips) 
Seat 3: Perstenev ($14.44 in chips) 
Seat 4: Wilcox76607 ($19.44 in chips) 
Seat 5: Dafleche ($17.01 in chips) 
Seat 6: Nec Arg ($40.88 in chips) 
Seat 7: RomarioJa ($5.70 in chips) 
Seat 8: Dejacob ($31.44 in chips) 
Seat 9: BlOnDhOlIc ($45.57 in chips) 
chiyuki: posts small blind $0.10
Perstenev: posts big blind $0.25
*** HOLE CARDS ***
Dealt to chiyuki [Ad 3d]
Wilcox76607: folds 
Dafleche: folds 
Nec Arg: raises $0.25 to $0.50
RomarioJa: folds 
Dejacob: folds 
BlOnDhOlIc: folds 
hirozo: calls $0.50
chiyuki: calls $0.40
Perstenev: folds 
*** FLOP *** [Jc 7d Kh]
chiyuki: checks 
Nec Arg: bets $0.50
hirozo: calls $0.50
chiyuki: folds 
*** TURN *** [Jc 7d Kh] [Ts]
Nec Arg: bets $1.50
hirozo: calls $1.50
*** RIVER *** [Jc 7d Kh Ts] [5s]
Nec Arg: bets $6
hirozo: calls $6
*** SHOW DOWN ***
Nec Arg: shows [Th Kd] (two pair, Kings and Tens)
hirozo: shows [Ks Tc] (two pair, Kings and Tens)
Nec Arg collected $8.48 from pot
hirozo collected $8.47 from pot
*** SUMMARY ***
Total pot $17.75 | Rake $0.80 
Board [Jc 7d Kh Ts 5s]
Seat 1: hirozo (button) showed [Ks Tc] and won ($8.47) with two pair, Kings and Tens
Seat 2: chiyuki (small blind) folded on the Flop
Seat 3: Perstenev (big blind) folded before Flop
Seat 4: Wilcox76607 folded before Flop (didn't bet)
Seat 5: Dafleche folded before Flop (didn't bet)
Seat 6: Nec Arg showed [Th Kd] and won ($8.48) with two pair, Kings and Tens
Seat 7: RomarioJa folded before Flop (didn't bet)
Seat 8: Dejacob folded before Flop (didn't bet)
Seat 9: BlOnDhOlIc folded before Flop (didn't bet)



PokerStars Zoom Hand #84299256157:  Hold'em No Limit ($0.10/$0.25) - 2012/08/05 14:07:13 JST [2012/08/05 1:07:13 ET]
Table 'Whirlpool' 9-max Seat #1 is the button
Seat 1: troms20 ($25 in chips) 
Seat 2: kamikkaze ($36.15 in chips) 
Seat 3: 2997qwer ($12.15 in chips) 
Seat 4: Perstenev ($13.44 in chips) 
Seat 5: seula i ($36.50 in chips) 
Seat 6: BlackZafiro ($25.35 in chips) 
Seat 7: Tom1999 ($22.16 in chips) 
Seat 8: cr0lox ($20.90 in chips) 
Seat 9: chiyuki ($54.37 in chips) 
kamikkaze: posts small blind $0.10
2997qwer: posts big blind $0.25
*** HOLE CARDS ***
Dealt to chiyuki [2d 7c]
Perstenev: folds 
seula i: folds 
BlackZafiro: folds 
Tom1999: folds 
cr0lox: folds 
chiyuki: folds 
troms20: folds 
kamikkaze: folds 
Uncalled bet ($0.15) returned to 2997qwer
2997qwer collected $0.20 from pot
2997qwer: doesn't show hand 
*** SUMMARY ***
Total pot $0.20 | Rake $0 
Seat 1: troms20 (button) folded before Flop (didn't bet)
Seat 2: kamikkaze (small blind) folded before Flop
Seat 3: 2997qwer (big blind) collected ($0.20)
Seat 4: Perstenev folded before Flop (didn't bet)
Seat 5: seula i folded before Flop (didn't bet)
Seat 6: BlackZafiro folded before Flop (didn't bet)
Seat 7: Tom1999 folded before Flop (didn't bet)
Seat 8: cr0lox folded before Flop (didn't bet)
Seat 9: chiyuki folded before Flop (didn't bet)



PokerStars Zoom Hand #84299240305:  Hold'em No Limit ($0.10/$0.25) - 2012/08/05 14:06:12 JST [2012/08/05 1:06:12 ET]
Table 'Whirlpool' 9-max Seat #1 is the button
Seat 1: Perstenev ($12.30 in chips) 
Seat 2: deadmoneykid ($24.25 in chips) 
Seat 3: KAKamiro ($59.08 in chips) 
Seat 4: chiyuki ($54.87 in chips) 
Seat 5: americoluz ($39.91 in chips) 
Seat 6: Suhoff76 ($25.68 in chips) 
Seat 7: agurio ($27.27 in chips) 
Seat 8: Nerkit ($21.22 in chips) 
Seat 9: cR!Ma*aRm ($20.30 in chips) 
deadmoneykid: posts small blind $0.10
KAKamiro: posts big blind $0.25
*** HOLE CARDS ***
Dealt to chiyuki [2h As]
chiyuki: folds 
americoluz: raises $0.25 to $0.50
Suhoff76: folds 
agurio: folds 
Nerkit: folds 
cR!Ma*aRm: folds 
Perstenev: calls $0.50
deadmoneykid: folds 
KAKamiro: raises $0.75 to $1.25
americoluz: calls $0.75
Perstenev: calls $0.75
*** FLOP *** [9d Tc Qc]
KAKamiro: checks 
americoluz: bets $1.25
Perstenev: calls $1.25
KAKamiro: calls $1.25
*** TURN *** [9d Tc Qc] [6h]
KAKamiro: checks 
americoluz: checks 
Perstenev: bets $1.50
KAKamiro: calls $1.50
americoluz: calls $1.50
*** RIVER *** [9d Tc Qc 6h] [4d]
KAKamiro: bets $4.25
americoluz: calls $4.25
Perstenev: raises $4.05 to $8.30 and is all-in
KAKamiro: calls $4.05
americoluz: calls $4.05
*** SHOW DOWN ***
Perstenev: shows [9s 9h] (three of a kind, Nines)
KAKamiro: shows [Td Ts] (three of a kind, Tens)
americoluz: mucks hand 
KAKamiro collected $35.34 from pot
*** SUMMARY ***
Total pot $37 | Rake $1.66 
Board [9d Tc Qc 6h 4d]
Seat 1: Perstenev (button) showed [9s 9h] and lost with three of a kind, Nines
Seat 2: deadmoneykid (small blind) folded before Flop
Seat 3: KAKamiro (big blind) showed [Td Ts] and won ($35.34) with three of a kind, Tens
Seat 4: chiyuki folded before Flop (didn't bet)
Seat 5: americoluz mucked [Ah Qh]
Seat 6: Suhoff76 folded before Flop (didn't bet)
Seat 7: agurio folded before Flop (didn't bet)
Seat 8: Nerkit folded before Flop (didn't bet)
Seat 9: cR!Ma*aRm folded before Flop (didn't bet)



PokerStars Zoom Hand #84299257164:  Hold'em No Limit ($0.10/$0.25) - 2012/08/05 14:07:17 JST [2012/08/05 1:07:17 ET]
Table 'Whirlpool' 9-max Seat #1 is the button
Seat 1: GoldNutter ($24.77 in chips) 
Seat 2: Tom1999 ($9.38 in chips) 
Seat 3: Nerkit ($15.80 in chips) 
Seat 4: Lasutchik ($34.60 in chips) 
Seat 5: deadmoneykid ($21.73 in chips) 
Seat 6: DanielWhyte ($23.41 in chips) 
Seat 7: chiyuki ($54.37 in chips) 
Seat 8: seula i ($66.02 in chips) 
Seat 9: troms20 ($25 in chips) 
Tom1999: posts small blind $0.10
Nerkit: posts big blind $0.25
*** HOLE CARDS ***
Dealt to chiyuki [Td 7s]
Lasutchik: folds 
deadmoneykid: folds 
DanielWhyte: folds 
chiyuki: folds 
seula i: folds 
troms20: folds 
GoldNutter: folds 
Tom1999: folds 
Uncalled bet ($0.15) returned to Nerkit
Nerkit collected $0.20 from pot
Nerkit: doesn't show hand 
*** SUMMARY ***
Total pot $0.20 | Rake $0 
Seat 1: GoldNutter (button) folded before Flop (didn't bet)
Seat 2: Tom1999 (small blind) folded before Flop
Seat 3: Nerkit (big blind) collected ($0.20)
Seat 4: Lasutchik folded before Flop (didn't bet)
Seat 5: deadmoneykid folded before Flop (didn't bet)
Seat 6: DanielWhyte folded before Flop (didn't bet)
Seat 7: chiyuki folded before Flop (didn't bet)
Seat 8: seula i folded before Flop (didn't bet)
Seat 9: troms20 folded before Flop (didn't bet)



PokerStars Zoom Hand #84299258529:  Hold'em No Limit ($0.10/$0.25) - 2012/08/05 14:07:22 JST [2012/08/05 1:07:22 ET]
Table 'Whirlpool' 9-max Seat #1 is the button
Seat 1: Dejacob ($53.76 in chips) 
Seat 2: Lasutchik ($34.60 in chips) 
Seat 3: KeLevro0 ($12.50 in chips) 
Seat 4: hirozo ($25.74 in chips) 
Seat 5: PetitAlejo ($25.29 in chips) 
Seat 6: chiyuki ($54.37 in chips) 
Seat 7: Perstenev ($11.82 in chips) 
Seat 8: Faraz ($23.17 in chips) 
Seat 9: kamikkaze ($18.38 in chips) 
Lasutchik: posts small blind $0.10
KeLevro0: posts big blind $0.25
*** HOLE CARDS ***
Dealt to chiyuki [Tc 9h]
hirozo: folds 
PetitAlejo: folds 
chiyuki: folds 
Perstenev: raises $0.50 to $0.75
Faraz: folds 
kamikkaze: folds 
Dejacob: folds 
Lasutchik: folds 
KeLevro0: folds 
Uncalled bet ($0.50) returned to Perstenev
Perstenev collected $0.60 from pot
Perstenev: doesn't show hand 
*** SUMMARY ***
Total pot $0.60 | Rake $0 
Seat 1: Dejacob (button) folded before Flop (didn't bet)
Seat 2: Lasutchik (small blind) folded before Flop
Seat 3: KeLevro0 (big blind) folded before Flop
Seat 4: hirozo folded before Flop (didn't bet)
Seat 5: PetitAlejo folded before Flop (didn't bet)
Seat 6: chiyuki folded before Flop (didn't bet)
Seat 7: Perstenev collected ($0.60)
Seat 8: Faraz folded before Flop (didn't bet)
Seat 9: kamikkaze folded before Flop (didn't bet)



PokerStars Zoom Hand #84299253895:  Hold'em No Limit ($0.10/$0.25) - 2012/08/05 14:07:04 JST [2012/08/05 1:07:04 ET]
Table 'Whirlpool' 9-max Seat #1 is the button
Seat 1: ladymadon107 ($4.11 in chips) 
Seat 2: flyinprits ($35.24 in chips) 
Seat 3: BlOnDhOlIc ($25.18 in chips) 
Seat 4: ChrisCDee ($28.48 in chips) 
Seat 5: Nerkit ($11.65 in chips) 
Seat 6: PetitAlejo ($31.58 in chips) 
Seat 7: zaffaroots ($20.57 in chips) 
Seat 8: chiyuki ($54.37 in chips) 
Seat 9: 2997qwer ($12.40 in chips) 
flyinprits: posts small blind $0.10
BlOnDhOlIc: posts big blind $0.25
*** HOLE CARDS ***
Dealt to chiyuki [8h 5c]
ChrisCDee: folds 
Nerkit: folds 
PetitAlejo: folds 
zaffaroots: calls $0.25
chiyuki: folds 
2997qwer: folds 
ladymadon107: calls $0.25
flyinprits: folds 
BlOnDhOlIc: checks 
*** FLOP *** [5s 2s 3h]
BlOnDhOlIc: checks 
zaffaroots: bets $0.75
ladymadon107: calls $0.75
BlOnDhOlIc: folds 
*** TURN *** [5s 2s 3h] [Jd]
zaffaroots: checks 
ladymadon107: bets $3.11 and is all-in
zaffaroots: calls $3.11
*** RIVER *** [5s 2s 3h Jd] [9c]
*** SHOW DOWN ***
zaffaroots: shows [7d 3d] (a pair of Threes)
ladymadon107: shows [Jh Ac] (a pair of Jacks)
ladymadon107 collected $8.18 from pot
*** SUMMARY ***
Total pot $8.57 | Rake $0.39 
Board [5s 2s 3h Jd 9c]
Seat 1: ladymadon107 (button) showed [Jh Ac] and won ($8.18) with a pair of Jacks
Seat 2: flyinprits (small blind) folded before Flop
Seat 3: BlOnDhOlIc (big blind) folded on the Flop
Seat 4: ChrisCDee folded before Flop (didn't bet)
Seat 5: Nerkit folded before Flop (didn't bet)
Seat 6: PetitAlejo folded before Flop (didn't bet)
Seat 7: zaffaroots showed [7d 3d] and lost with a pair of Threes
Seat 8: chiyuki folded before Flop (didn't bet)
Seat 9: 2997qwer folded before Flop (didn't bet)



PokerStars Zoom Hand #84299252798:  Hold'em No Limit ($0.10/$0.25) - 2012/08/05 14:07:00 JST [2012/08/05 1:07:00 ET]
Table 'Whirlpool' 9-max Seat #1 is the button
Seat 1: chiyuki ($54.37 in chips) 
Seat 2: 123progress ($39.30 in chips) 
Seat 3: wtu1986 ($29.58 in chips) 
Seat 4: agurio ($26.03 in chips) 
Seat 5: Tom1999 ($9.63 in chips) 
Seat 6: jallu435 ($24.25 in chips) 
Seat 7: Ellen1947 ($29.90 in chips) 
Seat 8: simonzez ($44.26 in chips) 
Seat 9: Rudolf ($45.42 in chips) 
123progress: posts small blind $0.10
wtu1986: posts big blind $0.25
*** HOLE CARDS ***
Dealt to chiyuki [3h 6d]
agurio: folds 
Tom1999: folds 
jallu435: folds 
Ellen1947: folds 
simonzez: folds 
Rudolf: folds 
chiyuki: folds 
123progress: raises $0.50 to $0.75
wtu1986: folds 
Uncalled bet ($0.50) returned to 123progress
123progress collected $0.50 from pot
123progress: doesn't show hand 
*** SUMMARY ***
Total pot $0.50 | Rake $0 
Seat 1: chiyuki (button) folded before Flop (didn't bet)
Seat 2: 123progress (small blind) collected ($0.50)
Seat 3: wtu1986 (big blind) folded before Flop
Seat 4: agurio folded before Flop (didn't bet)
Seat 5: Tom1999 folded before Flop (didn't bet)
Seat 6: jallu435 folded before Flop (didn't bet)
Seat 7: Ellen1947 folded before Flop (didn't bet)
Seat 8: simonzez folded before Flop (didn't bet)
Seat 9: Rudolf folded before Flop (didn't bet)



PokerStars Zoom Hand #84299260628:  Hold'em No Limit ($0.10/$0.25) - 2012/08/05 14:07:31 JST [2012/08/05 1:07:31 ET]
Table 'Whirlpool' 9-max Seat #1 is the button
Seat 1: Csabee21 ($24.19 in chips) 
Seat 2: seula i ($36.50 in chips) 
Seat 3: chiyuki ($54.37 in chips) 
Seat 4: Roglus ($81.56 in chips) 
Seat 5: BlOnDhOlIc ($58.20 in chips) 
Seat 6: Anafim ($12.50 in chips) 
Seat 7: agurio ($25.68 in chips) 
Seat 8: flyinprits ($43.69 in chips) 
Seat 9: Perstenev ($13 in chips) 
seula i: posts small blind $0.10
chiyuki: posts big blind $0.25
*** HOLE CARDS ***
Dealt to chiyuki [7d Jh]
Roglus: folds 
BlOnDhOlIc: folds 
Anafim: folds 
agurio: folds 
flyinprits: folds 
Perstenev: calls $0.25
Csabee21: folds 
seula i: folds 
chiyuki: checks 
*** FLOP *** [7h Ac 8d]
chiyuki: checks 
Perstenev: bets $0.25
chiyuki: calls $0.25
*** TURN *** [7h Ac 8d] [2d]
chiyuki: checks 
Perstenev: checks 
*** RIVER *** [7h Ac 8d 2d] [7c]
chiyuki: bets $1
Perstenev: calls $1
*** SHOW DOWN ***
chiyuki: shows [7d Jh] (three of a kind, Sevens)
Perstenev: mucks hand 
chiyuki collected $2.96 from pot
*** SUMMARY ***
Total pot $3.10 | Rake $0.14 
Board [7h Ac 8d 2d 7c]
Seat 1: Csabee21 (button) folded before Flop (didn't bet)
Seat 2: seula i (small blind) folded before Flop
Seat 3: chiyuki (big blind) showed [7d Jh] and won ($2.96) with three of a kind, Sevens
Seat 4: Roglus folded before Flop (didn't bet)
Seat 5: BlOnDhOlIc folded before Flop (didn't bet)
Seat 6: Anafim folded before Flop (didn't bet)
Seat 7: agurio folded before Flop (didn't bet)
Seat 8: flyinprits folded before Flop (didn't bet)
Seat 9: Perstenev mucked [8c Tc]



PokerStars Zoom Hand #84299254907:  Hold'em No Limit ($0.10/$0.25) - 2012/08/05 14:07:08 JST [2012/08/05 1:07:08 ET]
Table 'Whirlpool' 9-max Seat #1 is the button
Seat 1: flyinprits ($35.14 in chips) 
Seat 2: Anafim ($12.50 in chips) 
Seat 3: Perstenev ($13.37 in chips) 
Seat 4: PetitAlejo ($31.58 in chips) 
Seat 5: chiyuki ($54.37 in chips) 
Seat 6: 2997qwer ($12.40 in chips) 
Seat 7: kamikkaze ($36.15 in chips) 
Seat 8: jeff0923 ($24.68 in chips) 
Seat 9: sparky5224 ($23.25 in chips) 
Anafim: posts small blind $0.10
Perstenev: posts big blind $0.25
*** HOLE CARDS ***
Dealt to chiyuki [Kh 2d]
PetitAlejo: folds 
chiyuki: folds 
2997qwer: folds 
kamikkaze: folds 
jeff0923: folds 
sparky5224: calls $0.25
flyinprits: calls $0.25
Anafim: folds 
Perstenev: checks 
*** FLOP *** [3c 7d Ts]
Perstenev: checks 
sparky5224: checks 
flyinprits: bets $0.50
Perstenev: calls $0.50
sparky5224: folds 
*** TURN *** [3c 7d Ts] [5h]
Perstenev: checks 
flyinprits: bets $0.75
Perstenev: calls $0.75
*** RIVER *** [3c 7d Ts 5h] [Td]
Perstenev: checks 
flyinprits: bets $1.50
Perstenev: folds 
Uncalled bet ($1.50) returned to flyinprits
flyinprits collected $3.20 from pot
flyinprits: doesn't show hand 
*** SUMMARY ***
Total pot $3.35 | Rake $0.15 
Board [3c 7d Ts 5h Td]
Seat 1: flyinprits (button) collected ($3.20)
Seat 2: Anafim (small blind) folded before Flop
Seat 3: Perstenev (big blind) folded on the River
Seat 4: PetitAlejo folded before Flop (didn't bet)
Seat 5: chiyuki folded before Flop (didn't bet)
Seat 6: 2997qwer folded before Flop (didn't bet)
Seat 7: kamikkaze folded before Flop (didn't bet)
Seat 8: jeff0923 folded before Flop (didn't bet)
Seat 9: sparky5224 folded on the Flop



PokerStars Zoom Hand #84299270392:  Hold'em No Limit ($0.10/$0.25) - 2012/08/05 14:08:09 JST [2012/08/05 1:08:09 ET]
Table 'Whirlpool' 9-max Seat #1 is the button
Seat 1: troms20 ($25.10 in chips) 
Seat 2: Anafim ($12.50 in chips) 
Seat 3: eyesJeJa ($25 in chips) 
Seat 4: 2997qwer ($12.15 in chips) 
Seat 5: Landybob ($37.41 in chips) 
Seat 6: puffy5533 ($21.77 in chips) 
Seat 7: Perstenev ($13.19 in chips) 
Seat 8: chiyuki ($55.83 in chips) 
Seat 9: ladymadon107 ($8.18 in chips) 
Anafim: posts small blind $0.10
eyesJeJa: posts big blind $0.25
*** HOLE CARDS ***
Dealt to chiyuki [Jc 5h]
2997qwer: folds 
Landybob: folds 
puffy5533: folds 
Perstenev: folds 
chiyuki: folds 
ladymadon107: calls $0.25
troms20: folds 
Anafim: folds 
eyesJeJa: checks 
*** FLOP *** [4d 8s Ks]
eyesJeJa: bets $0.50
ladymadon107: folds 
Uncalled bet ($0.50) returned to eyesJeJa
eyesJeJa collected $0.57 from pot
eyesJeJa: doesn't show hand 
*** SUMMARY ***
Total pot $0.60 | Rake $0.03 
Board [4d 8s Ks]
Seat 1: troms20 (button) folded before Flop (didn't bet)
Seat 2: Anafim (small blind) folded before Flop
Seat 3: eyesJeJa (big blind) collected ($0.57)
Seat 4: 2997qwer folded before Flop (didn't bet)
Seat 5: Landybob folded before Flop (didn't bet)
Seat 6: puffy5533 folded before Flop (didn't bet)
Seat 7: Perstenev folded before Flop (didn't bet)
Seat 8: chiyuki folded before Flop (didn't bet)
Seat 9: ladymadon107 folded on the Flop



PokerStars Zoom Hand #84299271394:  Hold'em No Limit ($0.10/$0.25) - 2012/08/05 14:08:13 JST [2012/08/05 1:08:13 ET]
Table 'Whirlpool' 9-max Seat #1 is the button
Seat 1: chiyuki ($55.83 in chips) 
Seat 2: troms20 ($25.10 in chips) 
Seat 3: RikkStroken ($31.53 in chips) 
Seat 4: Landybob ($37.41 in chips) 
Seat 5: Loholov ($15.10 in chips) 
Seat 6: hirozo ($29.57 in chips) 
Seat 7: fezman ($16.66 in chips) 
Seat 8: seula i ($27.26 in chips) 
Seat 9: Spartacus675 ($24.65 in chips) 
troms20: posts small blind $0.10
RikkStroken: posts big blind $0.25
*** HOLE CARDS ***
Dealt to chiyuki [3d Qc]
Landybob: folds 
Loholov: folds 
hirozo: folds 
fezman: folds 
seula i: folds 
Spartacus675: folds 
chiyuki: folds 
troms20: folds 
Uncalled bet ($0.15) returned to RikkStroken
RikkStroken collected $0.20 from pot
RikkStroken: doesn't show hand 
*** SUMMARY ***
Total pot $0.20 | Rake $0 
Seat 1: chiyuki (button) folded before Flop (didn't bet)
Seat 2: troms20 (small blind) folded before Flop
Seat 3: RikkStroken (big blind) collected ($0.20)
Seat 4: Landybob folded before Flop (didn't bet)
Seat 5: Loholov folded before Flop (didn't bet)
Seat 6: hirozo folded before Flop (didn't bet)
Seat 7: fezman folded before Flop (didn't bet)
Seat 8: seula i folded before Flop (didn't bet)
Seat 9: Spartacus675 folded before Flop (didn't bet)



PokerStars Zoom Hand #84299274722:  Hold'em No Limit ($0.10/$0.25) - 2012/08/05 14:08:26 JST [2012/08/05 1:08:26 ET]
Table 'Whirlpool' 9-max Seat #1 is the button
Seat 1: munky3 ($38.44 in chips) 
Seat 2: chiyuki ($55.83 in chips) 
Seat 3: PetitAlejo ($25.54 in chips) 
Seat 4: troms20 ($25 in chips) 
Seat 5: seula i ($65.67 in chips) 
Seat 6: flyinprits ($36.84 in chips) 
Seat 7: 2997qwer ($12.97 in chips) 
Seat 8: RomarioJa ($10.87 in chips) 
Seat 9: kamikkaze ($18.03 in chips) 
chiyuki: posts small blind $0.10
PetitAlejo: posts big blind $0.25
*** HOLE CARDS ***
Dealt to chiyuki [2c 5c]
troms20: folds 
seula i has timed out
seula i: folds 
flyinprits: folds 
2997qwer: folds 
RomarioJa: folds 
kamikkaze: folds 
munky3: calls $0.25
chiyuki: folds 
PetitAlejo: raises $0.88 to $1.13
munky3: calls $0.88
*** FLOP *** [4c 5h Ad]
PetitAlejo: bets $1.50
munky3: folds 
Uncalled bet ($1.50) returned to PetitAlejo
PetitAlejo collected $2.25 from pot
PetitAlejo: doesn't show hand 
*** SUMMARY ***
Total pot $2.36 | Rake $0.11 
Board [4c 5h Ad]
Seat 1: munky3 (button) folded on the Flop
Seat 2: chiyuki (small blind) folded before Flop
Seat 3: PetitAlejo (big blind) collected ($2.25)
Seat 4: troms20 folded before Flop (didn't bet)
Seat 5: seula i folded before Flop (didn't bet)
Seat 6: flyinprits folded before Flop (didn't bet)
Seat 7: 2997qwer folded before Flop (didn't bet)
Seat 8: RomarioJa folded before Flop (didn't bet)
Seat 9: kamikkaze folded before Flop (didn't bet)



PokerStars Zoom Hand #84299276329:  Hold'em No Limit ($0.10/$0.25) - 2012/08/05 14:08:32 JST [2012/08/05 1:08:32 ET]
Table 'Whirlpool' 9-max Seat #1 is the button
Seat 1: eyesJeJa ($25 in chips) 
Seat 2: troms20 ($24.75 in chips) 
Seat 3: Paranoix1990 ($25.08 in chips) 
Seat 4: Th3Fog ($72.21 in chips) 
Seat 5: Lasutchik ($33.88 in chips) 
Seat 6: 2997qwer ($12.97 in chips) 
Seat 7: fezman ($16.66 in chips) 
Seat 8: KeLevro0 ($12.15 in chips) 
Seat 9: chiyuki ($55.73 in chips) 
troms20: posts small blind $0.10
Paranoix1990: posts big blind $0.25
*** HOLE CARDS ***
Dealt to chiyuki [5h Kh]
Th3Fog: raises $0.47 to $0.72
Lasutchik: folds 
2997qwer: folds 
fezman: folds 
KeLevro0: folds 
chiyuki: folds 
eyesJeJa: folds 
troms20: folds 
Paranoix1990: calls $0.47
*** FLOP *** [8h 4c Jc]
Paranoix1990: bets $0.25
Th3Fog: raises $0.25 to $0.50
Paranoix1990: folds 
Uncalled bet ($0.25) returned to Th3Fog
Th3Fog collected $1.95 from pot
Th3Fog: doesn't show hand 
*** SUMMARY ***
Total pot $2.04 | Rake $0.09 
Board [8h 4c Jc]
Seat 1: eyesJeJa (button) folded before Flop (didn't bet)
Seat 2: troms20 (small blind) folded before Flop
Seat 3: Paranoix1990 (big blind) folded on the Flop
Seat 4: Th3Fog collected ($1.95)
Seat 5: Lasutchik folded before Flop (didn't bet)
Seat 6: 2997qwer folded before Flop (didn't bet)
Seat 7: fezman folded before Flop (didn't bet)
Seat 8: KeLevro0 folded before Flop (didn't bet)
Seat 9: chiyuki folded before Flop (didn't bet)



PokerStars Zoom Hand #84299279180:  Hold'em No Limit ($0.10/$0.25) - 2012/08/05 14:08:44 JST [2012/08/05 1:08:44 ET]
Table 'Whirlpool' 9-max Seat #1 is the button
Seat 1: Nerkit ($12.50 in chips) 
Seat 2: Dejacob ($25 in chips) 
Seat 3: taksist889 ($34.64 in chips) 
Seat 4: giorgos_k ($27.85 in chips) 
Seat 5: KeLevro0 ($10.65 in chips) 
Seat 6: chiyuki ($55.73 in chips) 
Seat 7: RomarioJa ($10.87 in chips) 
Seat 8: Loholov ($19.59 in chips) 
Seat 9: eyesJeJa ($25 in chips) 
Dejacob: posts small blind $0.10
taksist889: posts big blind $0.25
*** HOLE CARDS ***
Dealt to chiyuki [2s Qh]
giorgos_k: calls $0.25
KeLevro0: folds 
chiyuki: folds 
RomarioJa: folds 
Loholov: calls $0.25
eyesJeJa: folds 
Nerkit: folds 
Dejacob: folds 
taksist889: checks 
*** FLOP *** [5d Js Kd]
taksist889: checks 
giorgos_k: bets $0.75
Loholov: folds 
taksist889: folds 
Uncalled bet ($0.75) returned to giorgos_k
giorgos_k collected $0.81 from pot
giorgos_k: doesn't show hand 
*** SUMMARY ***
Total pot $0.85 | Rake $0.04 
Board [5d Js Kd]
Seat 1: Nerkit (button) folded before Flop (didn't bet)
Seat 2: Dejacob (small blind) folded before Flop
Seat 3: taksist889 (big blind) folded on the Flop
Seat 4: giorgos_k collected ($0.81)
Seat 5: KeLevro0 folded before Flop (didn't bet)
Seat 6: chiyuki folded before Flop (didn't bet)
Seat 7: RomarioJa folded before Flop (didn't bet)
Seat 8: Loholov folded on the Flop
Seat 9: eyesJeJa folded before Flop (didn't bet)



PokerStars Zoom Hand #84299289141:  Hold'em No Limit ($0.10/$0.25) - 2012/08/05 14:09:22 JST [2012/08/05 1:09:22 ET]
Table 'Whirlpool' 9-max Seat #1 is the button
Seat 1: Anafim ($12.50 in chips) 
Seat 2: troms20 ($24.75 in chips) 
Seat 3: chiyuki ($55.73 in chips) 
Seat 4: Perstenev ($11.50 in chips) 
Seat 5: GoldNutter ($26.44 in chips) 
Seat 6: Rudolf ($43.77 in chips) 
Seat 7: slapshot2011 ($31.77 in chips) 
Seat 8: hirozo ($29.42 in chips) 
Seat 9: Nerkit ($27.09 in chips) 
troms20: posts small blind $0.10
chiyuki: posts big blind $0.25
*** HOLE CARDS ***
Dealt to chiyuki [Jc 2h]
Perstenev: folds 
GoldNutter: folds 
Rudolf: folds 
slapshot2011: folds 
hirozo: folds 
Nerkit: folds 
Anafim: folds 
troms20: folds 
Uncalled bet ($0.15) returned to chiyuki
chiyuki collected $0.20 from pot
chiyuki: doesn't show hand 
*** SUMMARY ***
Total pot $0.20 | Rake $0 
Seat 1: Anafim (button) folded before Flop (didn't bet)
Seat 2: troms20 (small blind) folded before Flop
Seat 3: chiyuki (big blind) collected ($0.20)
Seat 4: Perstenev folded before Flop (didn't bet)
Seat 5: GoldNutter folded before Flop (didn't bet)
Seat 6: Rudolf folded before Flop (didn't bet)
Seat 7: slapshot2011 folded before Flop (didn't bet)
Seat 8: hirozo folded before Flop (didn't bet)
Seat 9: Nerkit folded before Flop (didn't bet)



PokerStars Zoom Hand #84299283346:  Hold'em No Limit ($0.10/$0.25) - 2012/08/05 14:09:00 JST [2012/08/05 1:09:00 ET]
Table 'Whirlpool' 9-max Seat #1 is the button
Seat 1: Perstenev ($11.50 in chips) 
Seat 2: RomarioJa ($9.47 in chips) 
Seat 3: BlOnDhOlIc ($58.20 in chips) 
Seat 4: BlackZafiro ($25 in chips) 
Seat 5: deadmoneykid ($23.50 in chips) 
Seat 6: flyinprits ($36.84 in chips) 
Seat 7: chiyuki ($55.73 in chips) 
Seat 8: wildy29 ($38.57 in chips) 
Seat 9: PetitAlejo ($26.66 in chips) 
RomarioJa: posts small blind $0.10
BlOnDhOlIc: posts big blind $0.25
*** HOLE CARDS ***
Dealt to chiyuki [4h Jh]
BlackZafiro: folds 
deadmoneykid: folds 
flyinprits: folds 
chiyuki: folds 
wildy29: calls $0.25
PetitAlejo: folds 
Perstenev: folds 
RomarioJa: folds 
BlOnDhOlIc: checks 
*** FLOP *** [Qc 9d 9c]
BlOnDhOlIc: checks 
wildy29: checks 
*** TURN *** [Qc 9d 9c] [Kh]
BlOnDhOlIc: bets $0.50
wildy29: folds 
Uncalled bet ($0.50) returned to BlOnDhOlIc
BlOnDhOlIc collected $0.57 from pot
BlOnDhOlIc: doesn't show hand 
*** SUMMARY ***
Total pot $0.60 | Rake $0.03 
Board [Qc 9d 9c Kh]
Seat 1: Perstenev (button) folded before Flop (didn't bet)
Seat 2: RomarioJa (small blind) folded before Flop
Seat 3: BlOnDhOlIc (big blind) collected ($0.57)
Seat 4: BlackZafiro folded before Flop (didn't bet)
Seat 5: deadmoneykid folded before Flop (didn't bet)
Seat 6: flyinprits folded before Flop (didn't bet)
Seat 7: chiyuki folded before Flop (didn't bet)
Seat 8: wildy29 folded on the Turn
Seat 9: PetitAlejo folded before Flop (didn't bet)



PokerStars Zoom Hand #84299287309:  Hold'em No Limit ($0.10/$0.25) - 2012/08/05 14:09:15 JST [2012/08/05 1:09:15 ET]
Table 'Whirlpool' 9-max Seat #1 is the button
Seat 1: Lasutchik ($13.83 in chips) 
Seat 2: Nerkit ($27.19 in chips) 
Seat 3: kamikkaze ($17.40 in chips) 
Seat 4: chiyuki ($55.73 in chips) 
Seat 5: ll_LaMeR_ll ($65.16 in chips) 
Seat 6: munky3 ($37.31 in chips) 
Seat 7: Landybob ($37.06 in chips) 
Seat 8: cR!Ma*aRm ($19.83 in chips) 
Seat 9: simonzez ($51.35 in chips) 
Nerkit: posts small blind $0.10
kamikkaze: posts big blind $0.25
*** HOLE CARDS ***
Dealt to chiyuki [6s 5c]
chiyuki: folds 
ll_LaMeR_ll: raises $0.50 to $0.75
munky3: folds 
Landybob: folds 
cR!Ma*aRm: calls $0.75
simonzez: calls $0.75
Lasutchik: folds 
Nerkit: folds 
kamikkaze: folds 
*** FLOP *** [2s 3h Qc]
ll_LaMeR_ll: checks 
cR!Ma*aRm: checks 
simonzez: checks 
*** TURN *** [2s 3h Qc] [Td]
ll_LaMeR_ll: bets $1.25
cR!Ma*aRm: folds 
simonzez: folds 
Uncalled bet ($1.25) returned to ll_LaMeR_ll
ll_LaMeR_ll collected $2.48 from pot
ll_LaMeR_ll: doesn't show hand 
*** SUMMARY ***
Total pot $2.60 | Rake $0.12 
Board [2s 3h Qc Td]
Seat 1: Lasutchik (button) folded before Flop (didn't bet)
Seat 2: Nerkit (small blind) folded before Flop
Seat 3: kamikkaze (big blind) folded before Flop
Seat 4: chiyuki folded before Flop (didn't bet)
Seat 5: ll_LaMeR_ll collected ($2.48)
Seat 6: munky3 folded before Flop (didn't bet)
Seat 7: Landybob folded before Flop (didn't bet)
Seat 8: cR!Ma*aRm folded on the Turn
Seat 9: simonzez folded on the Turn



PokerStars Zoom Hand #84299288104:  Hold'em No Limit ($0.10/$0.25) - 2012/08/05 14:09:18 JST [2012/08/05 1:09:18 ET]
Table 'Whirlpool' 9-max Seat #1 is the button
Seat 1: agurio ($25 in chips) 
Seat 2: Loholov ($15 in chips) 
Seat 3: ChrisCDee ($55.12 in chips) 
Seat 4: Perstenev ($11.50 in chips) 
Seat 5: chiyuki ($55.73 in chips) 
Seat 6: RomarioJa ($10.87 in chips) 
Seat 7: PetitAlejo ($35.46 in chips) 
Seat 8: slapshot2011 ($31.77 in chips) 
Seat 9: Déculotter69 ($16.05 in chips) 
Loholov: posts small blind $0.10
ChrisCDee: posts big blind $0.25
*** HOLE CARDS ***
Dealt to chiyuki [3c Tc]
Perstenev: folds 
chiyuki: folds 
RomarioJa: folds 
PetitAlejo: folds 
slapshot2011: folds 
Déculotter69: folds 
agurio: raises $0.50 to $0.75
Loholov: folds 
ChrisCDee: raises $1.75 to $2.50
agurio: folds 
Uncalled bet ($1.75) returned to ChrisCDee
ChrisCDee collected $1.60 from pot
ChrisCDee: doesn't show hand 
*** SUMMARY ***
Total pot $1.60 | Rake $0 
Seat 1: agurio (button) folded before Flop
Seat 2: Loholov (small blind) folded before Flop
Seat 3: ChrisCDee (big blind) collected ($1.60)
Seat 4: Perstenev folded before Flop (didn't bet)
Seat 5: chiyuki folded before Flop (didn't bet)
Seat 6: RomarioJa folded before Flop (didn't bet)
Seat 7: PetitAlejo folded before Flop (didn't bet)
Seat 8: slapshot2011 folded before Flop (didn't bet)
Seat 9: Déculotter69 folded before Flop (didn't bet)



PokerStars Zoom Hand #84299292243:  Hold'em No Limit ($0.10/$0.25) - 2012/08/05 14:09:34 JST [2012/08/05 1:09:34 ET]
Table 'Whirlpool' 9-max Seat #1 is the button
Seat 1: kamikkaze ($17.15 in chips) 
Seat 2: Spartacus675 ($25.32 in chips) 
Seat 3: 4ydo yogurt ($21.08 in chips) 
Seat 4: Ellen1947 ($36.36 in chips) 
Seat 5: troms20 ($22.30 in chips) 
Seat 6: eyesJeJa ($25 in chips) 
Seat 7: ygoegoe ($28.21 in chips) 
Seat 8: KAKamiro ($76.72 in chips) 
Seat 9: chiyuki ($55.83 in chips) 
Spartacus675: posts small blind $0.10
4ydo yogurt: posts big blind $0.25
*** HOLE CARDS ***
Dealt to chiyuki [Qh 9s]
Ellen1947: folds 
troms20: folds 
eyesJeJa: folds 
ygoegoe: folds 
KAKamiro: folds 
chiyuki: folds 
kamikkaze: folds 
Spartacus675: calls $0.15
4ydo yogurt: checks 
*** FLOP *** [Qd 4d Tc]
Spartacus675: checks 
4ydo yogurt: bets $0.36
Spartacus675: folds 
Uncalled bet ($0.36) returned to 4ydo yogurt
4ydo yogurt collected $0.48 from pot
4ydo yogurt: doesn't show hand 
*** SUMMARY ***
Total pot $0.50 | Rake $0.02 
Board [Qd 4d Tc]
Seat 1: kamikkaze (button) folded before Flop (didn't bet)
Seat 2: Spartacus675 (small blind) folded on the Flop
Seat 3: 4ydo yogurt (big blind) collected ($0.48)
Seat 4: Ellen1947 folded before Flop (didn't bet)
Seat 5: troms20 folded before Flop (didn't bet)
Seat 6: eyesJeJa folded before Flop (didn't bet)
Seat 7: ygoegoe folded before Flop (didn't bet)
Seat 8: KAKamiro folded before Flop (didn't bet)
Seat 9: chiyuki folded before Flop (didn't bet)



PokerStars Zoom Hand #84299294306:  Hold'em No Limit ($0.10/$0.25) - 2012/08/05 14:09:42 JST [2012/08/05 1:09:42 ET]
Table 'Whirlpool' 9-max Seat #1 is the button
Seat 1: Perstenev ($11.25 in chips) 
Seat 2: chiyuki ($55.83 in chips) 
Seat 3: Noviekid ($40.86 in chips) 
Seat 4: BlackZafiro ($25 in chips) 
Seat 5: 123progress ($25.36 in chips) 
Seat 6: DanielWhyte ($20.31 in chips) 
Seat 7: Loholov ($19.34 in chips) 
Seat 8: agurio ($25 in chips) 
Seat 9: silvno31 ($36.29 in chips) 
chiyuki: posts small blind $0.10
Noviekid: posts big blind $0.25
*** HOLE CARDS ***
Dealt to chiyuki [9d Ad]
BlackZafiro: folds 
123progress: calls $0.25
DanielWhyte: folds 
Loholov: folds 
agurio: folds 
silvno31: folds 
Perstenev: folds 
chiyuki: calls $0.15
Noviekid: checks 
*** FLOP *** [3s 9c Ac]
chiyuki: bets $0.50
Noviekid: folds 
123progress: folds 
Uncalled bet ($0.50) returned to chiyuki
chiyuki collected $0.72 from pot
chiyuki: doesn't show hand 
*** SUMMARY ***
Total pot $0.75 | Rake $0.03 
Board [3s 9c Ac]
Seat 1: Perstenev (button) folded before Flop (didn't bet)
Seat 2: chiyuki (small blind) collected ($0.72)
Seat 3: Noviekid (big blind) folded on the Flop
Seat 4: BlackZafiro folded before Flop (didn't bet)
Seat 5: 123progress folded on the Flop
Seat 6: DanielWhyte folded before Flop (didn't bet)
Seat 7: Loholov folded before Flop (didn't bet)
Seat 8: agurio folded before Flop (didn't bet)
Seat 9: silvno31 folded before Flop (didn't bet)



PokerStars Zoom Hand #84299302885:  Hold'em No Limit ($0.10/$0.25) - 2012/08/05 14:10:16 JST [2012/08/05 1:10:16 ET]
Table 'Whirlpool' 9-max Seat #1 is the button
Seat 1: Lasutchik ($12.15 in chips) 
Seat 2: KeLevro0 ($12.15 in chips) 
Seat 3: smartrisk15 ($5.51 in chips) 
Seat 4: 2997qwer ($12.90 in chips) 
Seat 5: Faraz ($22.42 in chips) 
Seat 6: seula i ($63.67 in chips) 
Seat 7: Loholov ($17.84 in chips) 
Seat 8: chiyuki ($56.30 in chips) 
Seat 9: RomarioJa ($10.52 in chips) 
KeLevro0: posts small blind $0.10
smartrisk15: posts big blind $0.25
*** HOLE CARDS ***
Dealt to chiyuki [Td Qh]
2997qwer: folds 
Faraz: folds 
seula i: folds 
Loholov: folds 
chiyuki: folds 
RomarioJa: folds 
Lasutchik: folds 
KeLevro0: folds 
Uncalled bet ($0.15) returned to smartrisk15
smartrisk15 collected $0.20 from pot
smartrisk15: doesn't show hand 
*** SUMMARY ***
Total pot $0.20 | Rake $0 
Seat 1: Lasutchik (button) folded before Flop (didn't bet)
Seat 2: KeLevro0 (small blind) folded before Flop
Seat 3: smartrisk15 (big blind) collected ($0.20)
Seat 4: 2997qwer folded before Flop (didn't bet)
Seat 5: Faraz folded before Flop (didn't bet)
Seat 6: seula i folded before Flop (didn't bet)
Seat 7: Loholov folded before Flop (didn't bet)
Seat 8: chiyuki folded before Flop (didn't bet)
Seat 9: RomarioJa folded before Flop (didn't bet)



PokerStars Zoom Hand #84299304909:  Hold'em No Limit ($0.10/$0.25) - 2012/08/05 14:10:24 JST [2012/08/05 1:10:24 ET]
Table 'Whirlpool' 9-max Seat #1 is the button
Seat 1: eyesJeJa ($27.15 in chips) 
Seat 2: fima00000007 ($4.95 in chips) 
Seat 3: Perstenev ($11.15 in chips) 
Seat 4: kamikkaze ($16.30 in chips) 
Seat 5: BlOnDhOlIc ($58.77 in chips) 
Seat 6: KeLevro0 ($12.15 in chips) 
Seat 7: chiyuki ($56.30 in chips) 
Seat 8: 2997qwer ($9 in chips) 
Seat 9: RomarioJa ($12.50 in chips) 
fima00000007: posts small blind $0.10
Perstenev: posts big blind $0.25
*** HOLE CARDS ***
Dealt to chiyuki [3h Ac]
kamikkaze: folds 
BlOnDhOlIc: folds 
KeLevro0: folds 
chiyuki: folds 
2997qwer: folds 
RomarioJa: raises $0.50 to $0.75
eyesJeJa: folds 
fima00000007: folds 
Perstenev: folds 
Uncalled bet ($0.50) returned to RomarioJa
RomarioJa collected $0.60 from pot
RomarioJa: doesn't show hand 
*** SUMMARY ***
Total pot $0.60 | Rake $0 
Seat 1: eyesJeJa (button) folded before Flop (didn't bet)
Seat 2: fima00000007 (small blind) folded before Flop
Seat 3: Perstenev (big blind) folded before Flop
Seat 4: kamikkaze folded before Flop (didn't bet)
Seat 5: BlOnDhOlIc folded before Flop (didn't bet)
Seat 6: KeLevro0 folded before Flop (didn't bet)
Seat 7: chiyuki folded before Flop (didn't bet)
Seat 8: 2997qwer folded before Flop (didn't bet)
Seat 9: RomarioJa collected ($0.60)



PokerStars Zoom Hand #84299307406:  Hold'em No Limit ($0.10/$0.25) - 2012/08/05 14:10:34 JST [2012/08/05 1:10:34 ET]
Table 'Whirlpool' 9-max Seat #1 is the button
Seat 1: 2997qwer ($9 in chips) 
Seat 2: Dejacob ($25.35 in chips) 
Seat 3: Roglus ($29.28 in chips) 
Seat 4: slapshot2011 ($32.92 in chips) 
Seat 5: Spartacus675 ($25.42 in chips) 
Seat 6: chiyuki ($56.30 in chips) 
Seat 7: wtu1986 ($27.25 in chips) 
Seat 8: eyesJeJa ($27.15 in chips) 
Seat 9: carlosrbr ($50.60 in chips) 
Dejacob: posts small blind $0.10
Roglus: posts big blind $0.25
*** HOLE CARDS ***
Dealt to chiyuki [4c Th]
slapshot2011: folds 
Spartacus675: folds 
chiyuki: folds 
wtu1986: folds 
eyesJeJa: folds 
carlosrbr: folds 
2997qwer: folds 
Dejacob: folds 
Uncalled bet ($0.15) returned to Roglus
Roglus collected $0.20 from pot
Roglus: doesn't show hand 
*** SUMMARY ***
Total pot $0.20 | Rake $0 
Seat 1: 2997qwer (button) folded before Flop (didn't bet)
Seat 2: Dejacob (small blind) folded before Flop
Seat 3: Roglus (big blind) collected ($0.20)
Seat 4: slapshot2011 folded before Flop (didn't bet)
Seat 5: Spartacus675 folded before Flop (didn't bet)
Seat 6: chiyuki folded before Flop (didn't bet)
Seat 7: wtu1986 folded before Flop (didn't bet)
Seat 8: eyesJeJa folded before Flop (didn't bet)
Seat 9: carlosrbr folded before Flop (didn't bet)



PokerStars Zoom Hand #84299286456:  Hold'em No Limit ($0.10/$0.25) - 2012/08/05 14:09:12 JST [2012/08/05 1:09:12 ET]
Table 'Whirlpool' 9-max Seat #1 is the button
Seat 1: flyinprits ($40.84 in chips) 
Seat 2: 2997qwer ($12.72 in chips) 
Seat 3: deadmoneykid ($24.22 in chips) 
Seat 4: RomarioJa ($10.87 in chips) 
Seat 5: chiyuki ($55.73 in chips) 
Seat 6: mariuka1 ($14.29 in chips) 
Seat 7: jeff0923 ($25.02 in chips) 
Seat 8: Ellen1947 ($31.15 in chips) 
Seat 9: BlackZafiro ($25 in chips) 
2997qwer: posts small blind $0.10
deadmoneykid: posts big blind $0.25
*** HOLE CARDS ***
Dealt to chiyuki [7c Kc]
RomarioJa: folds 
chiyuki: folds 
mariuka1 has timed out
mariuka1: folds 
jeff0923: calls $0.25
Ellen1947: calls $0.25
BlackZafiro: folds 
flyinprits: folds 
2997qwer: folds 
deadmoneykid: checks 
*** FLOP *** [2s 4d 9s]
deadmoneykid: checks 
jeff0923: checks 
Ellen1947: bets $0.40
deadmoneykid: calls $0.40
jeff0923: folds 
*** TURN *** [2s 4d 9s] [2d]
deadmoneykid: checks 
Ellen1947: checks 
*** RIVER *** [2s 4d 9s 2d] [3d]
deadmoneykid: checks 
Ellen1947: checks 
*** SHOW DOWN ***
deadmoneykid: shows [7d 4h] (two pair, Fours and Deuces)
Ellen1947: mucks hand 
deadmoneykid collected $1.58 from pot
*** SUMMARY ***
Total pot $1.65 | Rake $0.07 
Board [2s 4d 9s 2d 3d]
Seat 1: flyinprits (button) folded before Flop (didn't bet)
Seat 2: 2997qwer (small blind) folded before Flop
Seat 3: deadmoneykid (big blind) showed [7d 4h] and won ($1.58) with two pair, Fours and Deuces
Seat 4: RomarioJa folded before Flop (didn't bet)
Seat 5: chiyuki folded before Flop (didn't bet)
Seat 6: mariuka1 folded before Flop (didn't bet)
Seat 7: jeff0923 folded on the Flop
Seat 8: Ellen1947 mucked [Td Kh]
Seat 9: BlackZafiro folded before Flop (didn't bet)



PokerStars Zoom Hand #84299314019:  Hold'em No Limit ($0.10/$0.25) - 2012/08/05 14:11:00 JST [2012/08/05 1:11:00 ET]
Table 'Whirlpool' 9-max Seat #1 is the button
Seat 1: 4thepeople ($23.80 in chips) 
Seat 2: KeLevro0 ($12.25 in chips) 
Seat 3: chiyuki ($56.30 in chips) 
Seat 4: deadmoneykid ($23.15 in chips) 
Seat 5: Roglus ($80.21 in chips) 
Seat 6: troms20 ($21.95 in chips) 
Seat 7: ll_LaMeR_ll ($47.19 in chips) 
Seat 8: Anafim ($12.50 in chips) 
Seat 9: Dejacob ($25 in chips) 
KeLevro0: posts small blind $0.10
chiyuki: posts big blind $0.25
*** HOLE CARDS ***
Dealt to chiyuki [Ad As]
deadmoneykid: folds 
Roglus: folds 
troms20: folds 
ll_LaMeR_ll: folds 
Anafim: folds 
Dejacob: folds 
4thepeople: folds 
KeLevro0: folds 
Uncalled bet ($0.15) returned to chiyuki
chiyuki collected $0.20 from pot
chiyuki: doesn't show hand 
*** SUMMARY ***
Total pot $0.20 | Rake $0 
Seat 1: 4thepeople (button) folded before Flop (didn't bet)
Seat 2: KeLevro0 (small blind) folded before Flop
Seat 3: chiyuki (big blind) collected ($0.20)
Seat 4: deadmoneykid folded before Flop (didn't bet)
Seat 5: Roglus folded before Flop (didn't bet)
Seat 6: troms20 folded before Flop (didn't bet)
Seat 7: ll_LaMeR_ll folded before Flop (didn't bet)
Seat 8: Anafim folded before Flop (didn't bet)
Seat 9: Dejacob folded before Flop (didn't bet)



PokerStars Zoom Hand #84299309191:  Hold'em No Limit ($0.10/$0.25) - 2012/08/05 14:10:41 JST [2012/08/05 1:10:41 ET]
Table 'Whirlpool' 9-max Seat #1 is the button
Seat 1: Perstenev ($10.90 in chips) 
Seat 2: ChrisCDee ($28.08 in chips) 
Seat 3: rellik1981 ($25 in chips) 
Seat 4: RomarioJa ($9.02 in chips) 
Seat 5: 4thepeople ($23.80 in chips) 
Seat 6: KeLevro0 ($12.05 in chips) 
Seat 7: agurio ($25 in chips) 
Seat 8: eyesJeJa ($25.35 in chips) 
Seat 9: chiyuki ($56.30 in chips) 
ChrisCDee: posts small blind $0.10
rellik1981: posts big blind $0.25
*** HOLE CARDS ***
Dealt to chiyuki [4s 8s]
RomarioJa: folds 
4thepeople: folds 
KeLevro0: raises $0.42 to $0.67
agurio: folds 
eyesJeJa: folds 
chiyuki: folds 
Perstenev: folds 
ChrisCDee: folds 
rellik1981: calls $0.42
*** FLOP *** [Qs 7d 3c]
rellik1981: checks 
KeLevro0: bets $1.06
rellik1981: calls $1.06
*** TURN *** [Qs 7d 3c] [Ad]
rellik1981: checks 
KeLevro0: bets $1.90
rellik1981: folds 
Uncalled bet ($1.90) returned to KeLevro0
KeLevro0 collected $3.40 from pot
KeLevro0: doesn't show hand 
*** SUMMARY ***
Total pot $3.56 | Rake $0.16 
Board [Qs 7d 3c Ad]
Seat 1: Perstenev (button) folded before Flop (didn't bet)
Seat 2: ChrisCDee (small blind) folded before Flop
Seat 3: rellik1981 (big blind) folded on the Turn
Seat 4: RomarioJa folded before Flop (didn't bet)
Seat 5: 4thepeople folded before Flop (didn't bet)
Seat 6: KeLevro0 collected ($3.40)
Seat 7: agurio folded before Flop (didn't bet)
Seat 8: eyesJeJa folded before Flop (didn't bet)
Seat 9: chiyuki folded before Flop (didn't bet)



PokerStars Zoom Hand #84299317072:  Hold'em No Limit ($0.10/$0.25) - 2012/08/05 14:11:13 JST [2012/08/05 1:11:13 ET]
Table 'Whirlpool' 9-max Seat #1 is the button
Seat 1: Wilcox76607 ($24 in chips) 
Seat 2: chiyuki ($56.40 in chips) 
Seat 3: BlOnDhOlIc ($51.15 in chips) 
Seat 4: GoldNutter ($24.09 in chips) 
Seat 5: KeLevro0 ($13.72 in chips) 
Seat 6: eyesJeJa ($26.80 in chips) 
Seat 7: seula i ($31.55 in chips) 
Seat 8: craden500 ($15.03 in chips) 
Seat 9: deadmoneykid ($23.15 in chips) 
chiyuki: posts small blind $0.10
BlOnDhOlIc: posts big blind $0.25
*** HOLE CARDS ***
Dealt to chiyuki [Tc 8h]
GoldNutter: folds 
KeLevro0: folds 
eyesJeJa: folds 
seula i: folds 
craden500: folds 
deadmoneykid: folds 
Wilcox76607: folds 
chiyuki: folds 
Uncalled bet ($0.15) returned to BlOnDhOlIc
BlOnDhOlIc collected $0.20 from pot
BlOnDhOlIc: doesn't show hand 
*** SUMMARY ***
Total pot $0.20 | Rake $0 
Seat 1: Wilcox76607 (button) folded before Flop (didn't bet)
Seat 2: chiyuki (small blind) folded before Flop
Seat 3: BlOnDhOlIc (big blind) collected ($0.20)
Seat 4: GoldNutter folded before Flop (didn't bet)
Seat 5: KeLevro0 folded before Flop (didn't bet)
Seat 6: eyesJeJa folded before Flop (didn't bet)
Seat 7: seula i folded before Flop (didn't bet)
Seat 8: craden500 folded before Flop (didn't bet)
Seat 9: deadmoneykid folded before Flop (didn't bet)



PokerStars Zoom Hand #84299310216:  Hold'em No Limit ($0.10/$0.25) - 2012/08/05 14:10:45 JST [2012/08/05 1:10:45 ET]
Table 'Whirlpool' 9-max Seat #1 is the button
Seat 1: Dejacob ($25.25 in chips) 
Seat 2: PakisR ($15.79 in chips) 
Seat 3: agurio ($25 in chips) 
Seat 4: Spartacus675 ($25.42 in chips) 
Seat 5: simonzez ($51.24 in chips) 
Seat 6: chiyuki ($56.30 in chips) 
Seat 7: munky3 ($35.81 in chips) 
Seat 8: Th3Fog ($22.68 in chips) 
Seat 9: deadmoneykid ($25 in chips) 
PakisR: posts small blind $0.10
agurio: posts big blind $0.25
*** HOLE CARDS ***
Dealt to chiyuki [3c Ah]
Spartacus675: folds 
simonzez: calls $0.25
chiyuki: folds 
munky3: calls $0.25
Th3Fog: folds 
deadmoneykid: folds 
Dejacob: raises $1.25 to $1.50
PakisR: folds 
agurio: folds 
simonzez: folds 
munky3: calls $1.25
*** FLOP *** [4c Qc 5s]
munky3: checks 
Dejacob: bets $2.50
munky3: calls $2.50
*** TURN *** [4c Qc 5s] [2s]
munky3: checks 
Dejacob: checks 
*** RIVER *** [4c Qc 5s 2s] [2h]
munky3: checks 
Dejacob: checks 
*** SHOW DOWN ***
munky3: shows [7s 7d] (two pair, Sevens and Deuces)
Dejacob: mucks hand 
munky3 collected $8.21 from pot
*** SUMMARY ***
Total pot $8.60 | Rake $0.39 
Board [4c Qc 5s 2s 2h]
Seat 1: Dejacob (button) mucked [Js Ad]
Seat 2: PakisR (small blind) folded before Flop
Seat 3: agurio (big blind) folded before Flop
Seat 4: Spartacus675 folded before Flop (didn't bet)
Seat 5: simonzez folded before Flop
Seat 6: chiyuki folded before Flop (didn't bet)
Seat 7: munky3 showed [7s 7d] and won ($8.21) with two pair, Sevens and Deuces
Seat 8: Th3Fog folded before Flop (didn't bet)
Seat 9: deadmoneykid folded before Flop (didn't bet)



PokerStars Zoom Hand #84299318841:  Hold'em No Limit ($0.10/$0.25) - 2012/08/05 14:11:20 JST [2012/08/05 1:11:20 ET]
Table 'Whirlpool' 9-max Seat #1 is the button
Seat 1: 2997qwer ($11.40 in chips) 
Seat 2: Roglus ($29.73 in chips) 
Seat 3: slapshot2011 ($31.42 in chips) 
Seat 4: KAKamiro ($83.72 in chips) 
Seat 5: chiyuki ($56.30 in chips) 
Seat 6: Loholov ($15 in chips) 
Seat 7: WARIBANA7777 ($15 in chips) 
Seat 8: KeLevro0 ($12.15 in chips) 
Seat 9: Wilcox76607 ($24 in chips) 
Roglus: posts small blind $0.10
slapshot2011: posts big blind $0.25
*** HOLE CARDS ***
Dealt to chiyuki [7c 6h]
KAKamiro: folds 
chiyuki: folds 
Loholov: folds 
WARIBANA7777: folds 
KeLevro0: folds 
Wilcox76607: folds 
2997qwer: folds 
Roglus: folds 
Uncalled bet ($0.15) returned to slapshot2011
slapshot2011 collected $0.20 from pot
slapshot2011: doesn't show hand 
*** SUMMARY ***
Total pot $0.20 | Rake $0 
Seat 1: 2997qwer (button) folded before Flop (didn't bet)
Seat 2: Roglus (small blind) folded before Flop
Seat 3: slapshot2011 (big blind) collected ($0.20)
Seat 4: KAKamiro folded before Flop (didn't bet)
Seat 5: chiyuki folded before Flop (didn't bet)
Seat 6: Loholov folded before Flop (didn't bet)
Seat 7: WARIBANA7777 folded before Flop (didn't bet)
Seat 8: KeLevro0 folded before Flop (didn't bet)
Seat 9: Wilcox76607 folded before Flop (didn't bet)



PokerStars Zoom Hand #84299321428:  Hold'em No Limit ($0.10/$0.25) - 2012/08/05 14:11:30 JST [2012/08/05 1:11:30 ET]
Table 'Whirlpool' 9-max Seat #1 is the button
Seat 1: kkbruins0408 ($19.12 in chips) 
Seat 2: PetitAlejo ($32.02 in chips) 
Seat 3: ChrisCDee ($30.68 in chips) 
Seat 4: KeLevro0 ($13.62 in chips) 
Seat 5: eyesJeJa ($25 in chips) 
Seat 6: americoluz ($30.28 in chips) 
Seat 7: chiyuki ($56.30 in chips) 
Seat 8: hirozo ($25 in chips) 
Seat 9: acamrash ($14.54 in chips) 
PetitAlejo: posts small blind $0.10
ChrisCDee: posts big blind $0.25
*** HOLE CARDS ***
Dealt to chiyuki [Qc Kd]
KeLevro0: raises $0.42 to $0.67
eyesJeJa: folds 
americoluz: folds 
chiyuki: folds 
hirozo: folds 
acamrash: folds 
kkbruins0408: folds 
PetitAlejo: folds 
ChrisCDee: folds 
Uncalled bet ($0.42) returned to KeLevro0
KeLevro0 collected $0.60 from pot
KeLevro0: doesn't show hand 
*** SUMMARY ***
Total pot $0.60 | Rake $0 
Seat 1: kkbruins0408 (button) folded before Flop (didn't bet)
Seat 2: PetitAlejo (small blind) folded before Flop
Seat 3: ChrisCDee (big blind) folded before Flop
Seat 4: KeLevro0 collected ($0.60)
Seat 5: eyesJeJa folded before Flop (didn't bet)
Seat 6: americoluz folded before Flop (didn't bet)
Seat 7: chiyuki folded before Flop (didn't bet)
Seat 8: hirozo folded before Flop (didn't bet)
Seat 9: acamrash folded before Flop (didn't bet)



PokerStars Zoom Hand #84299303894:  Hold'em No Limit ($0.10/$0.25) - 2012/08/05 14:10:20 JST [2012/08/05 1:10:20 ET]
Table 'Whirlpool' 9-max Seat #1 is the button
Seat 1: chiyuki ($56.30 in chips) 
Seat 2: ygoegoe ($28.31 in chips) 
Seat 3: Nerkit ($12.50 in chips) 
Seat 4: seula i ($63.67 in chips) 
Seat 5: RikkStroken ($16.47 in chips) 
Seat 6: eyesJeJa ($27.15 in chips) 
Seat 7: wtu1986 ($29.17 in chips) 
Seat 8: RomarioJa ($10.52 in chips) 
Seat 9: johnbaco1209 ($25 in chips) 
ygoegoe: posts small blind $0.10
Nerkit: posts big blind $0.25
*** HOLE CARDS ***
Dealt to chiyuki [Js 6d]
seula i: folds 
RikkStroken: folds 
eyesJeJa: folds 
wtu1986: folds 
RomarioJa: folds 
johnbaco1209: raises $0.25 to $0.50
chiyuki: folds 
ygoegoe: folds 
Nerkit: calls $0.25
*** FLOP *** [Qh Td Qd]
Nerkit: checks 
johnbaco1209: bets $1.25
Nerkit: calls $1.25
*** TURN *** [Qh Td Qd] [9h]
Nerkit: checks 
johnbaco1209: bets $1.25
Nerkit: raises $3 to $4.25
johnbaco1209: folds 
Uncalled bet ($3) returned to Nerkit
Nerkit collected $5.83 from pot
Nerkit: doesn't show hand 
*** SUMMARY ***
Total pot $6.10 | Rake $0.27 
Board [Qh Td Qd 9h]
Seat 1: chiyuki (button) folded before Flop (didn't bet)
Seat 2: ygoegoe (small blind) folded before Flop
Seat 3: Nerkit (big blind) collected ($5.83)
Seat 4: seula i folded before Flop (didn't bet)
Seat 5: RikkStroken folded before Flop (didn't bet)
Seat 6: eyesJeJa folded before Flop (didn't bet)
Seat 7: wtu1986 folded before Flop (didn't bet)
Seat 8: RomarioJa folded before Flop (didn't bet)
Seat 9: johnbaco1209 folded on the Turn



PokerStars Zoom Hand #84299324719:  Hold'em No Limit ($0.10/$0.25) - 2012/08/05 14:11:43 JST [2012/08/05 1:11:43 ET]
Table 'Whirlpool' 9-max Seat #1 is the button
Seat 1: PetitAlejo ($31.92 in chips) 
Seat 2: mariuka1 ($13.94 in chips) 
Seat 3: eyesJeJa ($25 in chips) 
Seat 4: 2997qwer ($12.27 in chips) 
Seat 5: chiyuki ($56.30 in chips) 
Seat 6: roksmokndonk ($34.36 in chips) 
Seat 7: acamrash ($14.54 in chips) 
Seat 8: RikkStroken ($14.83 in chips) 
Seat 9: rellik1981 ($26.10 in chips) 
mariuka1: posts small blind $0.10
eyesJeJa: posts big blind $0.25
*** HOLE CARDS ***
Dealt to chiyuki [Td 3d]
2997qwer: folds 
chiyuki: folds 
roksmokndonk: folds 
acamrash: raises $0.50 to $0.75
RikkStroken: folds 
rellik1981: folds 
PetitAlejo: folds 
mariuka1: folds 
eyesJeJa: folds 
Uncalled bet ($0.50) returned to acamrash
acamrash collected $0.60 from pot
acamrash: doesn't show hand 
*** SUMMARY ***
Total pot $0.60 | Rake $0 
Seat 1: PetitAlejo (button) folded before Flop (didn't bet)
Seat 2: mariuka1 (small blind) folded before Flop
Seat 3: eyesJeJa (big blind) folded before Flop
Seat 4: 2997qwer folded before Flop (didn't bet)
Seat 5: chiyuki folded before Flop (didn't bet)
Seat 6: roksmokndonk folded before Flop (didn't bet)
Seat 7: acamrash collected ($0.60)
Seat 8: RikkStroken folded before Flop (didn't bet)
Seat 9: rellik1981 folded before Flop (didn't bet)



PokerStars Zoom Hand #84299311253:  Hold'em No Limit ($0.10/$0.25) - 2012/08/05 14:10:49 JST [2012/08/05 1:10:49 ET]
Table 'Whirlpool' 9-max Seat #1 is the button
Seat 1: hirozo ($35.24 in chips) 
Seat 2: Perstenev ($10.90 in chips) 
Seat 3: Déculotter69 ($15.67 in chips) 
Seat 4: kamikkaze ($31.39 in chips) 
Seat 5: eyesJeJa ($25.35 in chips) 
Seat 6: Th3Fog ($22.68 in chips) 
Seat 7: giorgos_k ($41.63 in chips) 
Seat 8: chiyuki ($56.30 in chips) 
Seat 9: luriks27 ($24.65 in chips) 
Perstenev: posts small blind $0.10
Déculotter69: posts big blind $0.25
*** HOLE CARDS ***
Dealt to chiyuki [Kd Qh]
kamikkaze: folds 
eyesJeJa: folds 
Th3Fog: raises $0.35 to $0.60
giorgos_k: folds 
chiyuki: folds 
luriks27: folds 
hirozo: calls $0.60
Perstenev: calls $0.50
Déculotter69: folds 
*** FLOP *** [7d 8s 9c]
Perstenev: checks 
Th3Fog: checks 
hirozo: bets $1.31
Perstenev: calls $1.31
Th3Fog: calls $1.31
*** TURN *** [7d 8s 9c] [Ad]
Perstenev: bets $1.25
Th3Fog: calls $1.25
hirozo: folds 
*** RIVER *** [7d 8s 9c Ad] [4h]
Perstenev: bets $2.50
Th3Fog: calls $2.50
*** SHOW DOWN ***
Perstenev: shows [6c 5c] (a straight, Five to Nine)
Th3Fog: mucks hand 
Perstenev collected $12.87 from pot
*** SUMMARY ***
Total pot $13.48 | Rake $0.61 
Board [7d 8s 9c Ad 4h]
Seat 1: hirozo (button) folded on the Turn
Seat 2: Perstenev (small blind) showed [6c 5c] and won ($12.87) with a straight, Five to Nine
Seat 3: Déculotter69 (big blind) folded before Flop
Seat 4: kamikkaze folded before Flop (didn't bet)
Seat 5: eyesJeJa folded before Flop (didn't bet)
Seat 6: Th3Fog mucked [Ah Td]
Seat 7: giorgos_k folded before Flop (didn't bet)
Seat 8: chiyuki folded before Flop (didn't bet)
Seat 9: luriks27 folded before Flop (didn't bet)



PokerStars Zoom Hand #84299320371:  Hold'em No Limit ($0.10/$0.25) - 2012/08/05 14:11:26 JST [2012/08/05 1:11:26 ET]
Table 'Whirlpool' 9-max Seat #1 is the button
Seat 1: chiyuki ($56.30 in chips) 
Seat 2: phate-1up ($25 in chips) 
Seat 3: Roglus ($80.11 in chips) 
Seat 4: seula i ($25 in chips) 
Seat 5: kkbruins0408 ($19.12 in chips) 
Seat 6: WARIBANA7777 ($15 in chips) 
Seat 7: jeff0923 ($26.12 in chips) 
Seat 8: Wilcox76607 ($24 in chips) 
Seat 9: agurio ($27.27 in chips) 
phate-1up: posts small blind $0.10
Roglus: posts big blind $0.25
*** HOLE CARDS ***
Dealt to chiyuki [5c 3h]
seula i: folds 
kkbruins0408: folds 
WARIBANA7777: folds 
jeff0923: calls $0.25
Wilcox76607: folds 
agurio: folds 
chiyuki: folds 
phate-1up: folds 
Roglus: raises $0.62 to $0.87
jeff0923: calls $0.62
*** FLOP *** [Jd 8c Ac]
Roglus: bets $1.19
jeff0923: folds 
Uncalled bet ($1.19) returned to Roglus
Roglus collected $1.76 from pot
Roglus: doesn't show hand 
*** SUMMARY ***
Total pot $1.84 | Rake $0.08 
Board [Jd 8c Ac]
Seat 1: chiyuki (button) folded before Flop (didn't bet)
Seat 2: phate-1up (small blind) folded before Flop
Seat 3: Roglus (big blind) collected ($1.76)
Seat 4: seula i folded before Flop (didn't bet)
Seat 5: kkbruins0408 folded before Flop (didn't bet)
Seat 6: WARIBANA7777 folded before Flop (didn't bet)
Seat 7: jeff0923 folded on the Flop
Seat 8: Wilcox76607 folded before Flop (didn't bet)
Seat 9: agurio folded before Flop (didn't bet)



PokerStars Zoom Hand #84299326746:  Hold'em No Limit ($0.10/$0.25) - 2012/08/05 14:11:51 JST [2012/08/05 1:11:51 ET]
Table 'Whirlpool' 9-max Seat #1 is the button
Seat 1: Dan Royal ($31.39 in chips) 
Seat 2: Anafim ($12.50 in chips) 
Seat 3: leo2095 ($13.97 in chips) 
Seat 4: chiyuki ($56.30 in chips) 
Seat 5: ChrisCDee ($28.33 in chips) 
Seat 6: kamikkaze ($15.10 in chips) 
Seat 7: mariuka1 ($13.84 in chips) 
Seat 8: troms20 ($26.75 in chips) 
Seat 9: wtu1986 ($31.62 in chips) 
Anafim: posts small blind $0.10
leo2095: posts big blind $0.25
*** HOLE CARDS ***
Dealt to chiyuki [3s Ah]
chiyuki: folds 
ChrisCDee: raises $0.50 to $0.75
kamikkaze: folds 
mariuka1: folds 
troms20: folds 
wtu1986: folds 
Dan Royal: folds 
Anafim: folds 
leo2095: folds 
Uncalled bet ($0.50) returned to ChrisCDee
ChrisCDee collected $0.60 from pot
ChrisCDee: doesn't show hand 
*** SUMMARY ***
Total pot $0.60 | Rake $0 
Seat 1: Dan Royal (button) folded before Flop (didn't bet)
Seat 2: Anafim (small blind) folded before Flop
Seat 3: leo2095 (big blind) folded before Flop
Seat 4: chiyuki folded before Flop (didn't bet)
Seat 5: ChrisCDee collected ($0.60)
Seat 6: kamikkaze folded before Flop (didn't bet)
Seat 7: mariuka1 folded before Flop (didn't bet)
Seat 8: troms20 folded before Flop (didn't bet)
Seat 9: wtu1986 folded before Flop (didn't bet)



PokerStars Zoom Hand #84299328122:  Hold'em No Limit ($0.10/$0.25) - 2012/08/05 14:11:56 JST [2012/08/05 1:11:56 ET]
Table 'Whirlpool' 9-max Seat #1 is the button
Seat 1: wtu1986 ($31.62 in chips) 
Seat 2: Perstenev ($14.21 in chips) 
Seat 3: Scruf13 ($12.59 in chips) 
Seat 4: troms20 ($24.65 in chips) 
Seat 5: acamrash ($14.89 in chips) 
Seat 6: RikkStroken ($16.47 in chips) 
Seat 7: rellik1981 ($26.10 in chips) 
Seat 8: mariuka1 ($13.84 in chips) 
Seat 9: chiyuki ($56.30 in chips) 
Perstenev: posts small blind $0.10
Scruf13: posts big blind $0.25
*** HOLE CARDS ***
Dealt to chiyuki [9c Th]
troms20: raises $0.50 to $0.75
acamrash: folds 
RikkStroken: folds 
rellik1981: folds 
mariuka1: folds 
chiyuki: folds 
wtu1986: folds 
Perstenev: folds 
Scruf13: folds 
Uncalled bet ($0.50) returned to troms20
troms20 collected $0.60 from pot
troms20: doesn't show hand 
*** SUMMARY ***
Total pot $0.60 | Rake $0 
Seat 1: wtu1986 (button) folded before Flop (didn't bet)
Seat 2: Perstenev (small blind) folded before Flop
Seat 3: Scruf13 (big blind) folded before Flop
Seat 4: troms20 collected ($0.60)
Seat 5: acamrash folded before Flop (didn't bet)
Seat 6: RikkStroken folded before Flop (didn't bet)
Seat 7: rellik1981 folded before Flop (didn't bet)
Seat 8: mariuka1 folded before Flop (didn't bet)
Seat 9: chiyuki folded before Flop (didn't bet)



PokerStars Zoom Hand #84299329606:  Hold'em No Limit ($0.10/$0.25) - 2012/08/05 14:12:02 JST [2012/08/05 1:12:02 ET]
Table 'Whirlpool' 9-max Seat #1 is the button
Seat 1: Perstenev ($21.32 in chips) 
Seat 2: WARIBANA7777 ($14.75 in chips) 
Seat 3: chiyuki ($56.30 in chips) 
Seat 4: Spartacus675 ($25.42 in chips) 
Seat 5: agurio ($27.52 in chips) 
Seat 6: Loholov ($18.91 in chips) 
Seat 7: RikkStroken ($25.18 in chips) 
Seat 8: jeff0923 ($25.25 in chips) 
Seat 9: D@vidMed ($69.69 in chips) 
WARIBANA7777: posts small blind $0.10
chiyuki: posts big blind $0.25
*** HOLE CARDS ***
Dealt to chiyuki [As Ac]
Spartacus675: folds 
agurio: folds 
Loholov: folds 
RikkStroken: folds 
jeff0923: folds 
D@vidMed: folds 
Perstenev: calls $0.25
WARIBANA7777: folds 
chiyuki: raises $1 to $1.25
Perstenev: folds 
Uncalled bet ($1) returned to chiyuki
chiyuki collected $0.60 from pot
chiyuki: doesn't show hand 
*** SUMMARY ***
Total pot $0.60 | Rake $0 
Seat 1: Perstenev (button) folded before Flop
Seat 2: WARIBANA7777 (small blind) folded before Flop
Seat 3: chiyuki (big blind) collected ($0.60)
Seat 4: Spartacus675 folded before Flop (didn't bet)
Seat 5: agurio folded before Flop (didn't bet)
Seat 6: Loholov folded before Flop (didn't bet)
Seat 7: RikkStroken folded before Flop (didn't bet)
Seat 8: jeff0923 folded before Flop (didn't bet)
Seat 9: D@vidMed folded before Flop (didn't bet)



PokerStars Zoom Hand #84299334718:  Hold'em No Limit ($0.10/$0.25) - 2012/08/05 14:12:23 JST [2012/08/05 1:12:23 ET]
Table 'Whirlpool' 9-max Seat #1 is the button
Seat 1: KeLevro0 ($12.25 in chips) 
Seat 2: Perstenev ($13.87 in chips) 
Seat 3: Noviekid ($39.16 in chips) 
Seat 4: rellik1981 ($25.85 in chips) 
Seat 5: 2997qwer ($10.80 in chips) 
Seat 6: wtu1986 ($28.98 in chips) 
Seat 7: troms20 ($20.95 in chips) 
Seat 8: chiyuki ($56.65 in chips) 
Seat 9: Loholov ($15.25 in chips) 
Perstenev: posts small blind $0.10
Noviekid: posts big blind $0.25
*** HOLE CARDS ***
Dealt to chiyuki [9s 7c]
rellik1981: folds 
2997qwer: folds 
wtu1986: folds 
troms20: folds 
chiyuki: folds 
Loholov: folds 
KeLevro0: folds 
Perstenev: folds 
Uncalled bet ($0.15) returned to Noviekid
Noviekid collected $0.20 from pot
Noviekid: doesn't show hand 
*** SUMMARY ***
Total pot $0.20 | Rake $0 
Seat 1: KeLevro0 (button) folded before Flop (didn't bet)
Seat 2: Perstenev (small blind) folded before Flop
Seat 3: Noviekid (big blind) collected ($0.20)
Seat 4: rellik1981 folded before Flop (didn't bet)
Seat 5: 2997qwer folded before Flop (didn't bet)
Seat 6: wtu1986 folded before Flop (didn't bet)
Seat 7: troms20 folded before Flop (didn't bet)
Seat 8: chiyuki folded before Flop (didn't bet)
Seat 9: Loholov folded before Flop (didn't bet)



PokerStars Zoom Hand #84299335727:  Hold'em No Limit ($0.10/$0.25) - 2012/08/05 14:12:27 JST [2012/08/05 1:12:27 ET]
Table 'Whirlpool' 9-max Seat #1 is the button
Seat 1: ChrisCDee ($28.43 in chips) 
Seat 2: chiyuki ($56.65 in chips) 
Seat 3: eyesJeJa ($26.45 in chips) 
Seat 4: seula i ($25 in chips) 
Seat 5: phate-1up ($25 in chips) 
Seat 6: Vahe50 ($7.45 in chips) 
Seat 7: PetitAlejo ($33.66 in chips) 
Seat 8: Robchie ($12.50 in chips) 
Seat 9: roksmokndonk ($33.96 in chips) 
chiyuki: posts small blind $0.10
eyesJeJa: posts big blind $0.25
*** HOLE CARDS ***
Dealt to chiyuki [Qh 5c]
seula i: folds 
phate-1up: folds 
Vahe50: folds 
PetitAlejo: folds 
Robchie: folds 
roksmokndonk: folds 
ChrisCDee: folds 
chiyuki: folds 
Uncalled bet ($0.15) returned to eyesJeJa
eyesJeJa collected $0.20 from pot
eyesJeJa: doesn't show hand 
*** SUMMARY ***
Total pot $0.20 | Rake $0 
Seat 1: ChrisCDee (button) folded before Flop (didn't bet)
Seat 2: chiyuki (small blind) folded before Flop
Seat 3: eyesJeJa (big blind) collected ($0.20)
Seat 4: seula i folded before Flop (didn't bet)
Seat 5: phate-1up folded before Flop (didn't bet)
Seat 6: Vahe50 folded before Flop (didn't bet)
Seat 7: PetitAlejo folded before Flop (didn't bet)
Seat 8: Robchie folded before Flop (didn't bet)
Seat 9: roksmokndonk folded before Flop (didn't bet)



PokerStars Zoom Hand #84299336943:  Hold'em No Limit ($0.10/$0.25) - 2012/08/05 14:12:32 JST [2012/08/05 1:12:32 ET]
Table 'Whirlpool' 9-max Seat #1 is the button
Seat 1: chiyuki ($56.55 in chips) 
Seat 2: BlOnDhOlIc ($25 in chips) 
Seat 3: Landybob ($38.86 in chips) 
Seat 4: 2997qwer ($10.80 in chips) 
Seat 5: phate-1up ($25 in chips) 
Seat 6: johnbaco1209 ($23.65 in chips) 
Seat 7: taksist889 ($38.91 in chips) 
Seat 8: Loholov ($15.25 in chips) 
Seat 9: acamrash ($14.54 in chips) 
BlOnDhOlIc: posts small blind $0.10
Landybob: posts big blind $0.25
*** HOLE CARDS ***
Dealt to chiyuki [5h 2c]
2997qwer: folds 
phate-1up: raises $0.50 to $0.75
johnbaco1209: folds 
taksist889: folds 
Loholov: folds 
acamrash: folds 
chiyuki: folds 
BlOnDhOlIc: raises $1.50 to $2.25
Landybob: folds 
phate-1up: raises $3 to $5.25
BlOnDhOlIc: folds 
Uncalled bet ($3) returned to phate-1up
phate-1up collected $4.75 from pot
phate-1up: doesn't show hand 
*** SUMMARY ***
Total pot $4.75 | Rake $0 
Seat 1: chiyuki (button) folded before Flop (didn't bet)
Seat 2: BlOnDhOlIc (small blind) folded before Flop
Seat 3: Landybob (big blind) folded before Flop
Seat 4: 2997qwer folded before Flop (didn't bet)
Seat 5: phate-1up collected ($4.75)
Seat 6: johnbaco1209 folded before Flop (didn't bet)
Seat 7: taksist889 folded before Flop (didn't bet)
Seat 8: Loholov folded before Flop (didn't bet)
Seat 9: acamrash folded before Flop (didn't bet)



PokerStars Zoom Hand #84299325739:  Hold'em No Limit ($0.10/$0.25) - 2012/08/05 14:11:47 JST [2012/08/05 1:11:47 ET]
Table 'Whirlpool' 9-max Seat #1 is the button
Seat 1: KeLevro0 ($13.97 in chips) 
Seat 2: Dan Royal ($31.49 in chips) 
Seat 3: hirozo ($33.33 in chips) 
Seat 4: chiyuki ($56.30 in chips) 
Seat 5: mariuka1 ($13.84 in chips) 
Seat 6: rellik1981 ($26.10 in chips) 
Seat 7: Loholov ($20.36 in chips) 
Seat 8: 2997qwer ($12.27 in chips) 
Seat 9: Faraz ($22.07 in chips) 
Dan Royal: posts small blind $0.10
hirozo: posts big blind $0.25
*** HOLE CARDS ***
Dealt to chiyuki [Ts 5s]
chiyuki: folds 
mariuka1: folds 
rellik1981: folds 
Loholov: raises $0.50 to $0.75
2997qwer: raises $1.50 to $2.25
Faraz: calls $2.25
KeLevro0: folds 
Dan Royal: folds 
hirozo: folds 
Loholov: calls $1.50
*** FLOP *** [9s Qd 8c]
Loholov: checks 
2997qwer: checks 
Faraz: bets $1
Loholov: calls $1
2997qwer: calls $1
*** TURN *** [9s Qd 8c] [7h]
Loholov: checks 
2997qwer: checks 
Faraz: checks 
*** RIVER *** [9s Qd 8c 7h] [Qh]
Loholov: checks 
2997qwer: bets $4
Faraz: folds 
Loholov: folds 
Uncalled bet ($4) returned to 2997qwer
2997qwer collected $9.65 from pot
2997qwer: doesn't show hand 
*** SUMMARY ***
Total pot $10.10 | Rake $0.45 
Board [9s Qd 8c 7h Qh]
Seat 1: KeLevro0 (button) folded before Flop (didn't bet)
Seat 2: Dan Royal (small blind) folded before Flop
Seat 3: hirozo (big blind) folded before Flop
Seat 4: chiyuki folded before Flop (didn't bet)
Seat 5: mariuka1 folded before Flop (didn't bet)
Seat 6: rellik1981 folded before Flop (didn't bet)
Seat 7: Loholov folded on the River
Seat 8: 2997qwer collected ($9.65)
Seat 9: Faraz folded on the River



PokerStars Zoom Hand #84299338640:  Hold'em No Limit ($0.10/$0.25) - 2012/08/05 14:12:39 JST [2012/08/05 1:12:39 ET]
Table 'Whirlpool' 9-max Seat #1 is the button
Seat 1: taksist889 ($38.91 in chips) 
Seat 2: silvno31 ($44.67 in chips) 
Seat 3: acamrash ($14 in chips) 
Seat 4: Dan Royal ($32.24 in chips) 
Seat 5: Tom1999 ($7.67 in chips) 
Seat 6: chiyuki ($56.55 in chips) 
Seat 7: KeLevro0 ($14.07 in chips) 
Seat 8: Csabee21 ($26.44 in chips) 
Seat 9: deadmoneykid ($24.65 in chips) 
silvno31: posts small blind $0.10
acamrash: posts big blind $0.25
*** HOLE CARDS ***
Dealt to chiyuki [Jc Jd]
Dan Royal: folds 
Tom1999: folds 
chiyuki: raises $0.50 to $0.75
KeLevro0: calls $0.75
Csabee21: folds 
deadmoneykid: folds 
taksist889: folds 
silvno31: folds 
acamrash: folds 
*** FLOP *** [Qd 4d 3h]
chiyuki: bets $1
KeLevro0: calls $1
*** TURN *** [Qd 4d 3h] [3d]
chiyuki: checks 
KeLevro0: bets $2.06
chiyuki: folds 
Uncalled bet ($2.06) returned to KeLevro0
KeLevro0 collected $3.68 from pot
KeLevro0: doesn't show hand 
*** SUMMARY ***
Total pot $3.85 | Rake $0.17 
Board [Qd 4d 3h 3d]
Seat 1: taksist889 (button) folded before Flop (didn't bet)
Seat 2: silvno31 (small blind) folded before Flop
Seat 3: acamrash (big blind) folded before Flop
Seat 4: Dan Royal folded before Flop (didn't bet)
Seat 5: Tom1999 folded before Flop (didn't bet)
Seat 6: chiyuki folded on the Turn
Seat 7: KeLevro0 collected ($3.68)
Seat 8: Csabee21 folded before Flop (didn't bet)
Seat 9: deadmoneykid folded before Flop (didn't bet)



PokerStars Zoom Hand #84299350721:  Hold'em No Limit ($0.10/$0.25) - 2012/08/05 14:13:28 JST [2012/08/05 1:13:28 ET]
Table 'Whirlpool' 9-max Seat #1 is the button
Seat 1: hirozo ($34.40 in chips) 
Seat 2: Dan Royal ($31.99 in chips) 
Seat 3: PetitAlejo ($34.01 in chips) 
Seat 4: acamrash ($13.65 in chips) 
Seat 5: Dejacob ($36.88 in chips) 
Seat 6: chiyuki ($54.80 in chips) 
Seat 7: Suhoff76 ($25 in chips) 
Seat 8: flyinprits ($31.64 in chips) 
Seat 9: Th3Fog ($74.88 in chips) 
Dan Royal: posts small blind $0.10
PetitAlejo: posts big blind $0.25
*** HOLE CARDS ***
Dealt to chiyuki [Ks Qd]
acamrash: folds 
Dejacob: folds 
chiyuki: raises $0.50 to $0.75
Suhoff76: calls $0.75
flyinprits: folds 
Th3Fog: folds 
hirozo: folds 
Dan Royal: folds 
PetitAlejo: raises $2.25 to $3
chiyuki: folds 
Suhoff76: folds 
Uncalled bet ($2.25) returned to PetitAlejo
PetitAlejo collected $2.35 from pot
PetitAlejo: doesn't show hand 
*** SUMMARY ***
Total pot $2.35 | Rake $0 
Seat 1: hirozo (button) folded before Flop (didn't bet)
Seat 2: Dan Royal (small blind) folded before Flop
Seat 3: PetitAlejo (big blind) collected ($2.35)
Seat 4: acamrash folded before Flop (didn't bet)
Seat 5: Dejacob folded before Flop (didn't bet)
Seat 6: chiyuki folded before Flop
Seat 7: Suhoff76 folded before Flop
Seat 8: flyinprits folded before Flop (didn't bet)
Seat 9: Th3Fog folded before Flop (didn't bet)



PokerStars Zoom Hand #84299349169:  Hold'em No Limit ($0.10/$0.25) - 2012/08/05 14:13:21 JST [2012/08/05 1:13:21 ET]
Table 'Whirlpool' 9-max Seat #1 is the button
Seat 1: PetitAlejo ($31.57 in chips) 
Seat 2: acamrash ($12.50 in chips) 
Seat 3: giorgos_k ($15.73 in chips) 
Seat 4: flyinprits ($31.64 in chips) 
Seat 5: WARIBANA7777 ($13.80 in chips) 
Seat 6: phate-1up ($27.40 in chips) 
Seat 7: chiyuki ($54.80 in chips) 
Seat 8: 2997qwer ($10.80 in chips) 
Seat 9: Scruf13 ($11.94 in chips) 
acamrash: posts small blind $0.10
giorgos_k: posts big blind $0.25
*** HOLE CARDS ***
Dealt to chiyuki [Kc Jh]
flyinprits: folds 
WARIBANA7777: folds 
phate-1up: folds 
chiyuki: folds 
2997qwer: raises $0.50 to $0.75
Scruf13: folds 
PetitAlejo: folds 
acamrash: folds 
giorgos_k: calls $0.50
*** FLOP *** [3h 9h 6d]
giorgos_k: checks 
2997qwer: bets $1
giorgos_k: calls $1
*** TURN *** [3h 9h 6d] [6c]
giorgos_k: checks 
2997qwer: bets $2
giorgos_k: calls $2
*** RIVER *** [3h 9h 6d 6c] [Ah]
giorgos_k: bets $3
2997qwer: calls $3
*** SHOW DOWN ***
giorgos_k: shows [5h 8h] (a flush, Ace high)
2997qwer: mucks hand 
giorgos_k collected $12.99 from pot
*** SUMMARY ***
Total pot $13.60 | Rake $0.61 
Board [3h 9h 6d 6c Ah]
Seat 1: PetitAlejo (button) folded before Flop (didn't bet)
Seat 2: acamrash (small blind) folded before Flop
Seat 3: giorgos_k (big blind) showed [5h 8h] and won ($12.99) with a flush, Ace high
Seat 4: flyinprits folded before Flop (didn't bet)
Seat 5: WARIBANA7777 folded before Flop (didn't bet)
Seat 6: phate-1up folded before Flop (didn't bet)
Seat 7: chiyuki folded before Flop (didn't bet)
Seat 8: 2997qwer mucked [As Qh]
Seat 9: Scruf13 folded before Flop (didn't bet)



PokerStars Zoom Hand #84299348389:  Hold'em No Limit ($0.10/$0.25) - 2012/08/05 14:13:18 JST [2012/08/05 1:13:18 ET]
Table 'Whirlpool' 9-max Seat #1 is the button
Seat 1: DONK1967 ($24.38 in chips) 
Seat 2: Perstenev ($13.36 in chips) 
Seat 3: wtu1986 ($25.48 in chips) 
Seat 4: troms20 ($26.40 in chips) 
Seat 5: Noviekid ($39.26 in chips) 
Seat 6: Loholov ($17.11 in chips) 
Seat 7: johnbaco1209 ($23.65 in chips) 
Seat 8: chiyuki ($54.80 in chips) 
Seat 9: Dejacob ($26.39 in chips) 
Perstenev: posts small blind $0.10
wtu1986: posts big blind $0.25
*** HOLE CARDS ***
Dealt to chiyuki [4d Kh]
troms20: folds 
Noviekid: raises $0.25 to $0.50
Loholov: folds 
johnbaco1209: folds 
chiyuki: folds 
Dejacob: folds 
DONK1967: folds 
Perstenev: calls $0.40
wtu1986: folds 
*** FLOP *** [Kc 9s 2d]
Perstenev: checks 
Noviekid: checks 
*** TURN *** [Kc 9s 2d] [6d]
Perstenev: bets $0.59
Noviekid: folds 
Uncalled bet ($0.59) returned to Perstenev
Perstenev collected $1.19 from pot
Perstenev: doesn't show hand 
*** SUMMARY ***
Total pot $1.25 | Rake $0.06 
Board [Kc 9s 2d 6d]
Seat 1: DONK1967 (button) folded before Flop (didn't bet)
Seat 2: Perstenev (small blind) collected ($1.19)
Seat 3: wtu1986 (big blind) folded before Flop
Seat 4: troms20 folded before Flop (didn't bet)
Seat 5: Noviekid folded on the Turn
Seat 6: Loholov folded before Flop (didn't bet)
Seat 7: johnbaco1209 folded before Flop (didn't bet)
Seat 8: chiyuki folded before Flop (didn't bet)
Seat 9: Dejacob folded before Flop (didn't bet)



PokerStars Zoom Hand #84299359575:  Hold'em No Limit ($0.10/$0.25) - 2012/08/05 14:14:03 JST [2012/08/05 1:14:03 ET]
Table 'Whirlpool' 9-max Seat #1 is the button
Seat 1: wtu1986 ($29.33 in chips) 
Seat 2: giorgos_k ($21.97 in chips) 
Seat 3: chiyuki ($54.05 in chips) 
Seat 4: phate-1up ($25 in chips) 
Seat 5: Dejacob ($36.63 in chips) 
Seat 6: kamikkaze ($13.97 in chips) 
Seat 7: agurio ($29.72 in chips) 
Seat 8: Th3Fog ($14.67 in chips) 
Seat 9: RomarioJa ($11.63 in chips) 
giorgos_k: posts small blind $0.10
chiyuki: posts big blind $0.25
*** HOLE CARDS ***
Dealt to chiyuki [2h 5d]
phate-1up: raises $0.50 to $0.75
Dejacob: folds 
kamikkaze: raises $13.22 to $13.97 and is all-in
agurio: folds 
Th3Fog: folds 
RomarioJa: folds 
wtu1986: folds 
giorgos_k: calls $13.87
chiyuki: folds 
phate-1up: folds 
*** FLOP *** [8h 2s 9d]
*** TURN *** [8h 2s 9d] [2d]
*** RIVER *** [8h 2s 9d 2d] [6d]
*** SHOW DOWN ***
giorgos_k: shows [Js Ad] (a pair of Deuces)
kamikkaze: shows [Jd Jc] (two pair, Jacks and Deuces)
kamikkaze collected $27.64 from pot
*** SUMMARY ***
Total pot $28.94 | Rake $1.30 
Board [8h 2s 9d 2d 6d]
Seat 1: wtu1986 (button) folded before Flop (didn't bet)
Seat 2: giorgos_k (small blind) showed [Js Ad] and lost with a pair of Deuces
Seat 3: chiyuki (big blind) folded before Flop
Seat 4: phate-1up folded before Flop
Seat 5: Dejacob folded before Flop (didn't bet)
Seat 6: kamikkaze showed [Jd Jc] and won ($27.64) with two pair, Jacks and Deuces
Seat 7: agurio folded before Flop (didn't bet)
Seat 8: Th3Fog folded before Flop (didn't bet)
Seat 9: RomarioJa folded before Flop (didn't bet)



PokerStars Zoom Hand #84299362810:  Hold'em No Limit ($0.10/$0.25) - 2012/08/05 14:14:16 JST [2012/08/05 1:14:16 ET]
Table 'Whirlpool' 9-max Seat #1 is the button
Seat 1: Faraz ($19.17 in chips) 
Seat 2: chiyuki ($53.80 in chips) 
Seat 3: Tom1999 ($5.07 in chips) 
Seat 4: ll_LaMeR_ll ($38.99 in chips) 
Seat 5: Loholov ($15.35 in chips) 
Seat 6: KeLevro0 ($11.80 in chips) 
Seat 7: BlOnDhOlIc ($52.31 in chips) 
Seat 8: el pore 5 ($16.59 in chips) 
Seat 9: WARIBANA7777 ($13.45 in chips) 
chiyuki: posts small blind $0.10
Tom1999: posts big blind $0.25
*** HOLE CARDS ***
Dealt to chiyuki [4h 7c]
ll_LaMeR_ll: raises $0.50 to $0.75
Loholov: folds 
KeLevro0: folds 
BlOnDhOlIc: folds 
el pore 5: calls $0.75
WARIBANA7777: folds 
Faraz: calls $0.75
chiyuki: folds 
Tom1999: folds 
*** FLOP *** [Kd Qc Td]
ll_LaMeR_ll: bets $1.16
el pore 5: folds 
Faraz: folds 
Uncalled bet ($1.16) returned to ll_LaMeR_ll
ll_LaMeR_ll collected $2.48 from pot
ll_LaMeR_ll: doesn't show hand 
*** SUMMARY ***
Total pot $2.60 | Rake $0.12 
Board [Kd Qc Td]
Seat 1: Faraz (button) folded on the Flop
Seat 2: chiyuki (small blind) folded before Flop
Seat 3: Tom1999 (big blind) folded before Flop
Seat 4: ll_LaMeR_ll collected ($2.48)
Seat 5: Loholov folded before Flop (didn't bet)
Seat 6: KeLevro0 folded before Flop (didn't bet)
Seat 7: BlOnDhOlIc folded before Flop (didn't bet)
Seat 8: el pore 5 folded on the Flop
Seat 9: WARIBANA7777 folded before Flop (didn't bet)



PokerStars Zoom Hand #84299358300:  Hold'em No Limit ($0.10/$0.25) - 2012/08/05 14:13:58 JST [2012/08/05 1:13:58 ET]
Table 'Whirlpool' 9-max Seat #1 is the button
Seat 1: acamrash ($12.15 in chips) 
Seat 2: rellik1981 ($25.20 in chips) 
Seat 3: seula i ($30.45 in chips) 
Seat 4: RikkStroken ($15.41 in chips) 
Seat 5: chiyuki ($54.05 in chips) 
Seat 6: KAKamiro ($62.56 in chips) 
Seat 7: Rudolf ($41.77 in chips) 
Seat 8: Suhoff76 ($25.25 in chips) 
Seat 9: Th3Fog ($14.67 in chips) 
rellik1981: posts small blind $0.10
seula i: posts big blind $0.25
*** HOLE CARDS ***
Dealt to chiyuki [Ad 2c]
RikkStroken: folds 
chiyuki: folds 
KAKamiro: calls $0.25
Rudolf: folds 
Suhoff76: folds 
Th3Fog: folds 
acamrash: raises $0.36 to $0.61
rellik1981: folds 
seula i: folds 
KAKamiro: calls $0.36
*** FLOP *** [Ah 7d Ac]
KAKamiro: checks 
acamrash: bets $0.99
KAKamiro: calls $0.99
*** TURN *** [Ah 7d Ac] [As]
KAKamiro: checks 
acamrash: bets $1.42
KAKamiro: calls $1.42
*** RIVER *** [Ah 7d Ac As] [Th]
KAKamiro: checks 
acamrash: checks 
*** SHOW DOWN ***
KAKamiro: shows [4d 4c] (a full house, Aces full of Fours)
acamrash: mucks hand 
KAKamiro collected $6.10 from pot
*** SUMMARY ***
Total pot $6.39 | Rake $0.29 
Board [Ah 7d Ac As Th]
Seat 1: acamrash (button) mucked [5d 6c]
Seat 2: rellik1981 (small blind) folded before Flop
Seat 3: seula i (big blind) folded before Flop
Seat 4: RikkStroken folded before Flop (didn't bet)
Seat 5: chiyuki folded before Flop (didn't bet)
Seat 6: KAKamiro showed [4d 4c] and won ($6.10) with a full house, Aces full of Fours
Seat 7: Rudolf folded before Flop (didn't bet)
Seat 8: Suhoff76 folded before Flop (didn't bet)
Seat 9: Th3Fog folded before Flop (didn't bet)



PokerStars Zoom Hand #84299363847:  Hold'em No Limit ($0.10/$0.25) - 2012/08/05 14:14:20 JST [2012/08/05 1:14:20 ET]
Table 'Whirlpool' 9-max Seat #1 is the button
Seat 1: chiyuki ($53.70 in chips) 
Seat 2: Nerkit ($10.69 in chips) 
Seat 3: JLajoie ($25 in chips) 
Seat 4: eyesJeJa ($25.53 in chips) 
Seat 5: KeLevro0 ($11.80 in chips) 
Seat 6: Suhoff76 ($25.35 in chips) 
Seat 7: PetitAlejo ($31.22 in chips) 
Seat 8: WARIBANA7777 ($13.45 in chips) 
Seat 9: acamrash ($13.40 in chips) 
Nerkit: posts small blind $0.10
JLajoie: posts big blind $0.25
*** HOLE CARDS ***
Dealt to chiyuki [9d Jh]
eyesJeJa: folds 
KeLevro0: folds 
Suhoff76: folds 
PetitAlejo: folds 
WARIBANA7777: folds 
acamrash: folds 
chiyuki: raises $0.50 to $0.75
Nerkit: calls $0.65
JLajoie: folds 
*** FLOP *** [Qh 4d 4s]
Nerkit: checks 
chiyuki: bets $1
Nerkit: raises $2 to $3
chiyuki: folds 
Uncalled bet ($2) returned to Nerkit
Nerkit collected $3.58 from pot
Nerkit: doesn't show hand 
*** SUMMARY ***
Total pot $3.75 | Rake $0.17 
Board [Qh 4d 4s]
Seat 1: chiyuki (button) folded on the Flop
Seat 2: Nerkit (small blind) collected ($3.58)
Seat 3: JLajoie (big blind) folded before Flop
Seat 4: eyesJeJa folded before Flop (didn't bet)
Seat 5: KeLevro0 folded before Flop (didn't bet)
Seat 6: Suhoff76 folded before Flop (didn't bet)
Seat 7: PetitAlejo folded before Flop (didn't bet)
Seat 8: WARIBANA7777 folded before Flop (didn't bet)
Seat 9: acamrash folded before Flop (didn't bet)



PokerStars Zoom Hand #84299373611:  Hold'em No Limit ($0.10/$0.25) - 2012/08/05 14:15:00 JST [2012/08/05 1:15:00 ET]
Table 'Whirlpool' 9-max Seat #1 is the button
Seat 1: luriks27 ($25.92 in chips) 
Seat 2: Dejacob ($26.14 in chips) 
Seat 3: ladymadon107 ($7.71 in chips) 
Seat 4: phate-1up ($27.05 in chips) 
Seat 5: Loholov ($16.51 in chips) 
Seat 6: Roglus ($66.93 in chips) 
Seat 7: wtu1986 ($29.33 in chips) 
Seat 8: BlOnDhOlIc ($60.21 in chips) 
Seat 9: chiyuki ($51.95 in chips) 
Dejacob: posts small blind $0.10
ladymadon107: posts big blind $0.25
*** HOLE CARDS ***
Dealt to chiyuki [6h Ah]
phate-1up: folds 
Loholov: folds 
Roglus: folds 
wtu1986: raises $0.50 to $0.75
BlOnDhOlIc: folds 
chiyuki: folds 
luriks27: folds 
Dejacob: folds 
ladymadon107: calls $0.50
*** FLOP *** [3c As 9d]
ladymadon107: checks 
wtu1986: bets $1.14
ladymadon107: folds 
Uncalled bet ($1.14) returned to wtu1986
wtu1986 collected $1.53 from pot
wtu1986: doesn't show hand 
*** SUMMARY ***
Total pot $1.60 | Rake $0.07 
Board [3c As 9d]
Seat 1: luriks27 (button) folded before Flop (didn't bet)
Seat 2: Dejacob (small blind) folded before Flop
Seat 3: ladymadon107 (big blind) folded on the Flop
Seat 4: phate-1up folded before Flop (didn't bet)
Seat 5: Loholov folded before Flop (didn't bet)
Seat 6: Roglus folded before Flop (didn't bet)
Seat 7: wtu1986 collected ($1.53)
Seat 8: BlOnDhOlIc folded before Flop (didn't bet)
Seat 9: chiyuki folded before Flop (didn't bet)



PokerStars Zoom Hand #84299381360:  Hold'em No Limit ($0.10/$0.25) - 2012/08/05 14:15:31 JST [2012/08/05 1:15:31 ET]
Table 'Whirlpool' 9-max Seat #1 is the button
Seat 1: gunbowler ($145.80 in chips) 
Seat 2: D@vidMed ($70.99 in chips) 
Seat 3: PetitAlejo ($35.76 in chips) 
Seat 4: WARIBANA7777 ($13.10 in chips) 
Seat 5: Scruf13 ($5.51 in chips) 
Seat 6: Spartacus675 ($29.17 in chips) 
Seat 7: chiyuki ($51.95 in chips) 
Seat 8: ChrisCDee ($25.88 in chips) 
Seat 9: Th3Fog ($75.93 in chips) 
D@vidMed: posts small blind $0.10
PetitAlejo: posts big blind $0.25
*** HOLE CARDS ***
Dealt to chiyuki [3d 7h]
WARIBANA7777: folds 
Scruf13: raises $1.75 to $2
Spartacus675: folds 
chiyuki: folds 
ChrisCDee: folds 
Th3Fog: folds 
gunbowler: folds 
D@vidMed: folds 
PetitAlejo: folds 
Uncalled bet ($1.75) returned to Scruf13
Scruf13 collected $0.60 from pot
Scruf13: doesn't show hand 
*** SUMMARY ***
Total pot $0.60 | Rake $0 
Seat 1: gunbowler (button) folded before Flop (didn't bet)
Seat 2: D@vidMed (small blind) folded before Flop
Seat 3: PetitAlejo (big blind) folded before Flop
Seat 4: WARIBANA7777 folded before Flop (didn't bet)
Seat 5: Scruf13 collected ($0.60)
Seat 6: Spartacus675 folded before Flop (didn't bet)
Seat 7: chiyuki folded before Flop (didn't bet)
Seat 8: ChrisCDee folded before Flop (didn't bet)
Seat 9: Th3Fog folded before Flop (didn't bet)



PokerStars Zoom Hand #84299377861:  Hold'em No Limit ($0.10/$0.25) - 2012/08/05 14:15:17 JST [2012/08/05 1:15:17 ET]
Table 'Whirlpool' 9-max Seat #1 is the button
Seat 1: RomarioJa ($16.98 in chips) 
Seat 2: Ellen1947 ($40.55 in chips) 
Seat 3: ChrisCDee ($26.13 in chips) 
Seat 4: slapshot2011 ($34.79 in chips) 
Seat 5: chiyuki ($51.95 in chips) 
Seat 6: acamrash ($12.50 in chips) 
Seat 7: agurio ($27.03 in chips) 
Seat 8: WARIBANA7777 ($13.10 in chips) 
Seat 9: eyesJeJa ($25 in chips) 
Ellen1947: posts small blind $0.10
ChrisCDee: posts big blind $0.25
*** HOLE CARDS ***
Dealt to chiyuki [3s 5c]
slapshot2011: folds 
chiyuki: folds 
acamrash: folds 
agurio: folds 
WARIBANA7777: folds 
eyesJeJa: folds 
RomarioJa: raises $0.37 to $0.62
Ellen1947: calls $0.52
ChrisCDee: folds 
*** FLOP *** [3d Td 6c]
Ellen1947: checks 
RomarioJa: bets $0.93
Ellen1947: folds 
Uncalled bet ($0.93) returned to RomarioJa
RomarioJa collected $1.42 from pot
RomarioJa: doesn't show hand 
*** SUMMARY ***
Total pot $1.49 | Rake $0.07 
Board [3d Td 6c]
Seat 1: RomarioJa (button) collected ($1.42)
Seat 2: Ellen1947 (small blind) folded on the Flop
Seat 3: ChrisCDee (big blind) folded before Flop
Seat 4: slapshot2011 folded before Flop (didn't bet)
Seat 5: chiyuki folded before Flop (didn't bet)
Seat 6: acamrash folded before Flop (didn't bet)
Seat 7: agurio folded before Flop (didn't bet)
Seat 8: WARIBANA7777 folded before Flop (didn't bet)
Seat 9: eyesJeJa folded before Flop (didn't bet)



PokerStars Zoom Hand #84299382385:  Hold'em No Limit ($0.10/$0.25) - 2012/08/05 14:15:35 JST [2012/08/05 1:15:35 ET]
Table 'Whirlpool' 9-max Seat #1 is the button
Seat 1: flyinprits ($34.86 in chips) 
Seat 2: deadmoneykid ($23.15 in chips) 
Seat 3: Nerkit ($9.88 in chips) 
Seat 4: chiyuki ($51.95 in chips) 
Seat 5: WARIBANA7777 ($13.10 in chips) 
Seat 6: Suhoff76 ($25 in chips) 
Seat 7: seula i ($30.10 in chips) 
Seat 8: Perstenev ($12.92 in chips) 
Seat 9: phate-1up ($25 in chips) 
deadmoneykid: posts small blind $0.10
Nerkit: posts big blind $0.25
*** HOLE CARDS ***
Dealt to chiyuki [6c 2h]
chiyuki: folds 
WARIBANA7777: folds 
Suhoff76: folds 
seula i: folds 
Perstenev: folds 
phate-1up: folds 
flyinprits: raises $0.50 to $0.75
deadmoneykid: folds 
Nerkit: folds 
Uncalled bet ($0.50) returned to flyinprits
flyinprits collected $0.60 from pot
flyinprits: doesn't show hand 
*** SUMMARY ***
Total pot $0.60 | Rake $0 
Seat 1: flyinprits (button) collected ($0.60)
Seat 2: deadmoneykid (small blind) folded before Flop
Seat 3: Nerkit (big blind) folded before Flop
Seat 4: chiyuki folded before Flop (didn't bet)
Seat 5: WARIBANA7777 folded before Flop (didn't bet)
Seat 6: Suhoff76 folded before Flop (didn't bet)
Seat 7: seula i folded before Flop (didn't bet)
Seat 8: Perstenev folded before Flop (didn't bet)
Seat 9: phate-1up folded before Flop (didn't bet)



PokerStars Zoom Hand #84299383419:  Hold'em No Limit ($0.10/$0.25) - 2012/08/05 14:15:39 JST [2012/08/05 1:15:39 ET]
Table 'Whirlpool' 9-max Seat #1 is the button
Seat 1: taksist889 ($39.92 in chips) 
Seat 2: phate-1up ($26.80 in chips) 
Seat 3: eyesJeJa ($25 in chips) 
Seat 4: chiyuki ($51.95 in chips) 
Seat 5: BlOnDhOlIc ($59.96 in chips) 
Seat 6: Jene4kaBest ($12.15 in chips) 
Seat 7: fezman ($16.83 in chips) 
Seat 8: troms20 ($26.05 in chips) 
Seat 9: Anafim ($12.50 in chips) 
phate-1up: posts small blind $0.10
eyesJeJa: posts big blind $0.25
*** HOLE CARDS ***
Dealt to chiyuki [5s 7h]
chiyuki: folds 
BlOnDhOlIc: raises $0.37 to $0.62
Jene4kaBest: folds 
fezman: folds 
troms20: folds 
Anafim: folds 
taksist889: folds 
phate-1up: folds 
eyesJeJa: folds 
Uncalled bet ($0.37) returned to BlOnDhOlIc
BlOnDhOlIc collected $0.60 from pot
BlOnDhOlIc: doesn't show hand 
*** SUMMARY ***
Total pot $0.60 | Rake $0 
Seat 1: taksist889 (button) folded before Flop (didn't bet)
Seat 2: phate-1up (small blind) folded before Flop
Seat 3: eyesJeJa (big blind) folded before Flop
Seat 4: chiyuki folded before Flop (didn't bet)
Seat 5: BlOnDhOlIc collected ($0.60)
Seat 6: Jene4kaBest folded before Flop (didn't bet)
Seat 7: fezman folded before Flop (didn't bet)
Seat 8: troms20 folded before Flop (didn't bet)
Seat 9: Anafim folded before Flop (didn't bet)



PokerStars Zoom Hand #84299384151:  Hold'em No Limit ($0.10/$0.25) - 2012/08/05 14:15:42 JST [2012/08/05 1:15:42 ET]
Table 'Whirlpool' 9-max Seat #1 is the button
Seat 1: chiyuki ($51.95 in chips) 
Seat 2: Suhoff76 ($25 in chips) 
Seat 3: PetitAlejo ($35.31 in chips) 
Seat 4: deadmoneykid ($24.30 in chips) 
Seat 5: 4ydo yogurt ($18.02 in chips) 
Seat 6: phate-1up ($25.35 in chips) 
Seat 7: Rudolf ($41.52 in chips) 
Seat 8: Ellen1947 ($28.40 in chips) 
Seat 9: D@vidMed ($70.89 in chips) 
Suhoff76: posts small blind $0.10
PetitAlejo: posts big blind $0.25
*** HOLE CARDS ***
Dealt to chiyuki [Ac 3c]
deadmoneykid: folds 
4ydo yogurt: folds 
phate-1up: folds 
Rudolf: folds 
Ellen1947: folds 
D@vidMed: folds 
chiyuki: raises $0.50 to $0.75
Suhoff76: folds 
PetitAlejo: folds 
Uncalled bet ($0.50) returned to chiyuki
chiyuki collected $0.60 from pot
chiyuki: doesn't show hand 
*** SUMMARY ***
Total pot $0.60 | Rake $0 
Seat 1: chiyuki (button) collected ($0.60)
Seat 2: Suhoff76 (small blind) folded before Flop
Seat 3: PetitAlejo (big blind) folded before Flop
Seat 4: deadmoneykid folded before Flop (didn't bet)
Seat 5: 4ydo yogurt folded before Flop (didn't bet)
Seat 6: phate-1up folded before Flop (didn't bet)
Seat 7: Rudolf folded before Flop (didn't bet)
Seat 8: Ellen1947 folded before Flop (didn't bet)
Seat 9: D@vidMed folded before Flop (didn't bet)



PokerStars Zoom Hand #84299379206:  Hold'em No Limit ($0.10/$0.25) - 2012/08/05 14:15:22 JST [2012/08/05 1:15:22 ET]
Table 'Whirlpool' 9-max Seat #1 is the button
Seat 1: ygoegoe ($28.31 in chips) 
Seat 2: Landybob ($38.01 in chips) 
Seat 3: BlOnDhOlIc ($60.21 in chips) 
Seat 4: Wilcox76607 ($24.35 in chips) 
Seat 5: troms20 ($21.84 in chips) 
Seat 6: agurio ($29.37 in chips) 
Seat 7: acamrash ($13.30 in chips) 
Seat 8: chiyuki ($51.95 in chips) 
Seat 9: RomarioJa ($12.60 in chips) 
Landybob: posts small blind $0.10
BlOnDhOlIc: posts big blind $0.25
*** HOLE CARDS ***
Dealt to chiyuki [8c 6s]
Wilcox76607: raises $0.25 to $0.50
troms20: folds 
agurio: calls $0.50
acamrash: folds 
chiyuki: folds 
RomarioJa: folds 
ygoegoe: folds 
Landybob: calls $0.40
BlOnDhOlIc: folds 
*** FLOP *** [Kh Kc Qh]
Landybob: checks 
Wilcox76607: bets $0.50
agurio: calls $0.50
Landybob: calls $0.50
*** TURN *** [Kh Kc Qh] [2h]
Landybob: checks 
Wilcox76607: bets $0.75
agurio: folds 
Landybob: calls $0.75
*** RIVER *** [Kh Kc Qh 2h] [5h]
Landybob: checks 
Wilcox76607: checks 
*** SHOW DOWN ***
Landybob: shows [As Qs] (two pair, Kings and Queens)
Wilcox76607: mucks hand 
Landybob collected $4.54 from pot
*** SUMMARY ***
Total pot $4.75 | Rake $0.21 
Board [Kh Kc Qh 2h 5h]
Seat 1: ygoegoe (button) folded before Flop (didn't bet)
Seat 2: Landybob (small blind) showed [As Qs] and won ($4.54) with two pair, Kings and Queens
Seat 3: BlOnDhOlIc (big blind) folded before Flop
Seat 4: Wilcox76607 mucked [Tc Qc]
Seat 5: troms20 folded before Flop (didn't bet)
Seat 6: agurio folded on the Turn
Seat 7: acamrash folded before Flop (didn't bet)
Seat 8: chiyuki folded before Flop (didn't bet)
Seat 9: RomarioJa folded before Flop (didn't bet)



PokerStars Zoom Hand #84299391405:  Hold'em No Limit ($0.10/$0.25) - 2012/08/05 14:16:12 JST [2012/08/05 1:16:12 ET]
Table 'Whirlpool' 9-max Seat #1 is the button
Seat 1: Nerkit ($9.53 in chips) 
Seat 2: simonzez ($50.37 in chips) 
Seat 3: chiyuki ($52.30 in chips) 
Seat 4: Loholov ($19.55 in chips) 
Seat 5: seula i ($25 in chips) 
Seat 6: acamrash ($14.08 in chips) 
Seat 7: flyinprits ($35.21 in chips) 
Seat 8: wtu1986 ($24.90 in chips) 
Seat 9: Suhoff76 ($25 in chips) 
simonzez: posts small blind $0.10
chiyuki: posts big blind $0.25
*** HOLE CARDS ***
Dealt to chiyuki [As Kh]
Loholov: folds 
seula i: folds 
acamrash: folds 
flyinprits: folds 
wtu1986: folds 
Suhoff76: folds 
Nerkit: folds 
simonzez: calls $0.15
chiyuki: raises $0.75 to $1
simonzez: calls $0.75
*** FLOP *** [Jc Qd 6d]
simonzez: checks 
chiyuki: bets $1
simonzez: calls $1
*** TURN *** [Jc Qd 6d] [Qc]
simonzez: checks 
chiyuki: checks 
*** RIVER *** [Jc Qd 6d Qc] [Qs]
simonzez: bets $0.75
chiyuki: calls $0.75
*** SHOW DOWN ***
simonzez: shows [2d 3d] (three of a kind, Queens)
chiyuki: shows [As Kh] (three of a kind, Queens - Ace kicker)
chiyuki collected $5.25 from pot
*** SUMMARY ***
Total pot $5.50 | Rake $0.25 
Board [Jc Qd 6d Qc Qs]
Seat 1: Nerkit (button) folded before Flop (didn't bet)
Seat 2: simonzez (small blind) showed [2d 3d] and lost with three of a kind, Queens
Seat 3: chiyuki (big blind) showed [As Kh] and won ($5.25) with three of a kind, Queens
Seat 4: Loholov folded before Flop (didn't bet)
Seat 5: seula i folded before Flop (didn't bet)
Seat 6: acamrash folded before Flop (didn't bet)
Seat 7: flyinprits folded before Flop (didn't bet)
Seat 8: wtu1986 folded before Flop (didn't bet)
Seat 9: Suhoff76 folded before Flop (didn't bet)



PokerStars Zoom Hand #84299403619:  Hold'em No Limit ($0.10/$0.25) - 2012/08/05 14:17:01 JST [2012/08/05 1:17:01 ET]
Table 'Whirlpool' 9-max Seat #1 is the button
Seat 1: Ellen1947 ($28.05 in chips) 
Seat 2: Tom1999 ($6.75 in chips) 
Seat 3: Landybob ($40.80 in chips) 
Seat 4: 4thepeople ($24.01 in chips) 
Seat 5: ll_LaMeR_ll ($47.62 in chips) 
Seat 6: ygoegoe ($27.96 in chips) 
Seat 7: slapshot2011 ($33.59 in chips) 
Seat 8: Nerkit ($11.90 in chips) 
Seat 9: chiyuki ($54.70 in chips) 
Tom1999: posts small blind $0.10
Landybob: posts big blind $0.25
*** HOLE CARDS ***
Dealt to chiyuki [2d Qs]
4thepeople: folds 
ll_LaMeR_ll: folds 
ygoegoe: folds 
slapshot2011: raises $0.50 to $0.75
Nerkit: folds 
chiyuki: folds 
Ellen1947: folds 
Tom1999: folds 
Landybob: folds 
Uncalled bet ($0.50) returned to slapshot2011
slapshot2011 collected $0.60 from pot
slapshot2011: doesn't show hand 
*** SUMMARY ***
Total pot $0.60 | Rake $0 
Seat 1: Ellen1947 (button) folded before Flop (didn't bet)
Seat 2: Tom1999 (small blind) folded before Flop
Seat 3: Landybob (big blind) folded before Flop
Seat 4: 4thepeople folded before Flop (didn't bet)
Seat 5: ll_LaMeR_ll folded before Flop (didn't bet)
Seat 6: ygoegoe folded before Flop (didn't bet)
Seat 7: slapshot2011 collected ($0.60)
Seat 8: Nerkit folded before Flop (didn't bet)
Seat 9: chiyuki folded before Flop (didn't bet)



PokerStars Zoom Hand #84299404819:  Hold'em No Limit ($0.10/$0.25) - 2012/08/05 14:17:07 JST [2012/08/05 1:17:07 ET]
Table 'Whirlpool' 9-max Seat #1 is the button
Seat 1: Dejacob ($25 in chips) 
Seat 2: kamikkaze ($16.53 in chips) 
Seat 3: flyinprits ($35.21 in chips) 
Seat 4: RomarioJa ($13.43 in chips) 
Seat 5: RikkStroken ($26.96 in chips) 
Seat 6: chiyuki ($54.70 in chips) 
Seat 7: Spartacus675 ($29.84 in chips) 
Seat 8: Ellen1947 ($28.05 in chips) 
Seat 9: Perstenev ($13.62 in chips) 
kamikkaze: posts small blind $0.10
flyinprits: posts big blind $0.25
*** HOLE CARDS ***
Dealt to chiyuki [7s 6c]
RomarioJa: raises $0.50 to $0.75
RikkStroken: folds 
chiyuki: folds 
Spartacus675: folds 
Ellen1947: folds 
Perstenev: folds 
Dejacob: folds 
kamikkaze: folds 
flyinprits: folds 
Uncalled bet ($0.50) returned to RomarioJa
RomarioJa collected $0.60 from pot
RomarioJa: doesn't show hand 
*** SUMMARY ***
Total pot $0.60 | Rake $0 
Seat 1: Dejacob (button) folded before Flop (didn't bet)
Seat 2: kamikkaze (small blind) folded before Flop
Seat 3: flyinprits (big blind) folded before Flop
Seat 4: RomarioJa collected ($0.60)
Seat 5: RikkStroken folded before Flop (didn't bet)
Seat 6: chiyuki folded before Flop (didn't bet)
Seat 7: Spartacus675 folded before Flop (didn't bet)
Seat 8: Ellen1947 folded before Flop (didn't bet)
Seat 9: Perstenev folded before Flop (didn't bet)



PokerStars Zoom Hand #84299402387:  Hold'em No Limit ($0.10/$0.25) - 2012/08/05 14:16:56 JST [2012/08/05 1:16:56 ET]
Table 'Whirlpool' 9-max Seat #1 is the button
Seat 1: Dan Royal ($42.96 in chips) 
Seat 2: chiyuki ($54.80 in chips) 
Seat 3: softdesign ($72.02 in chips) 
Seat 4: dushvan ($30.92 in chips) 
Seat 5: Landybob ($40.80 in chips) 
Seat 6: Th3Fog ($46.86 in chips) 
Seat 7: ll_LaMeR_ll ($47.62 in chips) 
Seat 8: ygoegoe ($27.96 in chips) 
Seat 9: simonzez ($47.62 in chips) 
chiyuki: posts small blind $0.10
softdesign: posts big blind $0.25
*** HOLE CARDS ***
Dealt to chiyuki [2d 9c]
dushvan: folds 
Landybob: folds 
Th3Fog: raises $0.47 to $0.72
ll_LaMeR_ll: folds 
ygoegoe: folds 
simonzez: folds 
Dan Royal: calls $0.72
chiyuki: folds 
softdesign: folds 
*** FLOP *** [4h Ks Kd]
Th3Fog: checks 
Dan Royal: checks 
*** TURN *** [4h Ks Kd] [Kc]
Th3Fog: bets $0.75
Dan Royal: calls $0.75
*** RIVER *** [4h Ks Kd Kc] [7d]
Th3Fog: checks 
Dan Royal: checks 
*** SHOW DOWN ***
Th3Fog: shows [Ad Js] (three of a kind, Kings)
Dan Royal: mucks hand 
Th3Fog collected $3.14 from pot
*** SUMMARY ***
Total pot $3.29 | Rake $0.15 
Board [4h Ks Kd Kc 7d]
Seat 1: Dan Royal (button) mucked [Ah 2h]
Seat 2: chiyuki (small blind) folded before Flop
Seat 3: softdesign (big blind) folded before Flop
Seat 4: dushvan folded before Flop (didn't bet)
Seat 5: Landybob folded before Flop (didn't bet)
Seat 6: Th3Fog showed [Ad Js] and won ($3.14) with three of a kind, Kings
Seat 7: ll_LaMeR_ll folded before Flop (didn't bet)
Seat 8: ygoegoe folded before Flop (didn't bet)
Seat 9: simonzez folded before Flop (didn't bet)



PokerStars Zoom Hand #84299405806:  Hold'em No Limit ($0.10/$0.25) - 2012/08/05 14:17:11 JST [2012/08/05 1:17:11 ET]
Table 'Whirlpool' 9-max Seat #1 is the button
Seat 1: kamikkaze ($16.43 in chips) 
Seat 2: Lasutchik ($8.68 in chips) 
Seat 3: PetitAlejo ($34.87 in chips) 
Seat 4: simonzez ($47.62 in chips) 
Seat 5: Perstenev ($13.62 in chips) 
Seat 6: Spartacus675 ($29.84 in chips) 
Seat 7: roksmokndonk ($33.11 in chips) 
Seat 8: chiyuki ($54.70 in chips) 
Seat 9: Suhoff76 ($25 in chips) 
Lasutchik: posts small blind $0.10
PetitAlejo: posts big blind $0.25
*** HOLE CARDS ***
Dealt to chiyuki [8s Qh]
simonzez: folds 
Perstenev: folds 
Spartacus675: folds 
roksmokndonk: folds 
chiyuki: folds 
Suhoff76: folds 
kamikkaze: folds 
Lasutchik: calls $0.15
PetitAlejo: checks 
*** FLOP *** [2c 3s 3h]
Lasutchik: bets $0.25
PetitAlejo: folds 
Uncalled bet ($0.25) returned to Lasutchik
Lasutchik collected $0.48 from pot
Lasutchik: doesn't show hand 
*** SUMMARY ***
Total pot $0.50 | Rake $0.02 
Board [2c 3s 3h]
Seat 1: kamikkaze (button) folded before Flop (didn't bet)
Seat 2: Lasutchik (small blind) collected ($0.48)
Seat 3: PetitAlejo (big blind) folded on the Flop
Seat 4: simonzez folded before Flop (didn't bet)
Seat 5: Perstenev folded before Flop (didn't bet)
Seat 6: Spartacus675 folded before Flop (didn't bet)
Seat 7: roksmokndonk folded before Flop (didn't bet)
Seat 8: chiyuki folded before Flop (didn't bet)
Seat 9: Suhoff76 folded before Flop (didn't bet)



PokerStars Zoom Hand #84299408600:  Hold'em No Limit ($0.10/$0.25) - 2012/08/05 14:17:22 JST [2012/08/05 1:17:22 ET]
Table 'Whirlpool' 9-max Seat #1 is the button
Seat 1: Perstenev ($12.92 in chips) 
Seat 2: Dejacob ($29.36 in chips) 
Seat 3: Vahe50 ($33.22 in chips) 
Seat 4: acamrash ($8.43 in chips) 
Seat 5: Ellen1947 ($41.42 in chips) 
Seat 6: silvno31 ($36.65 in chips) 
Seat 7: chiyuki ($54.70 in chips) 
Seat 8: wtu1986 ($32.67 in chips) 
Seat 9: seula i ($26.75 in chips) 
Dejacob: posts small blind $0.10
Vahe50: posts big blind $0.25
*** HOLE CARDS ***
Dealt to chiyuki [5h 4c]
acamrash: folds 
Ellen1947: folds 
silvno31: folds 
chiyuki: folds 
wtu1986: folds 
seula i: folds 
Perstenev: folds 
Dejacob: folds 
Uncalled bet ($0.15) returned to Vahe50
Vahe50 collected $0.20 from pot
Vahe50: doesn't show hand 
*** SUMMARY ***
Total pot $0.20 | Rake $0 
Seat 1: Perstenev (button) folded before Flop (didn't bet)
Seat 2: Dejacob (small blind) folded before Flop
Seat 3: Vahe50 (big blind) collected ($0.20)
Seat 4: acamrash folded before Flop (didn't bet)
Seat 5: Ellen1947 folded before Flop (didn't bet)
Seat 6: silvno31 folded before Flop (didn't bet)
Seat 7: chiyuki folded before Flop (didn't bet)
Seat 8: wtu1986 folded before Flop (didn't bet)
Seat 9: seula i folded before Flop (didn't bet)



PokerStars Zoom Hand #84299410645:  Hold'em No Limit ($0.10/$0.25) - 2012/08/05 14:17:30 JST [2012/08/05 1:17:30 ET]
Table 'Whirlpool' 9-max Seat #1 is the button
Seat 1: Th3Fog ($48.53 in chips) 
Seat 2: Spartacus675 ($29.84 in chips) 
Seat 3: Nerkit ($11.90 in chips) 
Seat 4: chiyuki ($54.70 in chips) 
Seat 5: Suhoff76 ($26.48 in chips) 
Seat 6: KeLevro0 ($10.03 in chips) 
Seat 7: acamrash ($8.43 in chips) 
Seat 8: BlOnDhOlIc ($59.96 in chips) 
Seat 9: Dejacob ($25 in chips) 
Spartacus675: posts small blind $0.10
Nerkit: posts big blind $0.25
*** HOLE CARDS ***
Dealt to chiyuki [4s 9d]
chiyuki: folds 
Suhoff76: folds 
KeLevro0: folds 
acamrash: folds 
BlOnDhOlIc: folds 
Dejacob: folds 
Th3Fog: raises $0.35 to $0.60
Spartacus675: folds 
Nerkit: folds 
Uncalled bet ($0.35) returned to Th3Fog
Th3Fog collected $0.60 from pot
Th3Fog: doesn't show hand 
*** SUMMARY ***
Total pot $0.60 | Rake $0 
Seat 1: Th3Fog (button) collected ($0.60)
Seat 2: Spartacus675 (small blind) folded before Flop
Seat 3: Nerkit (big blind) folded before Flop
Seat 4: chiyuki folded before Flop (didn't bet)
Seat 5: Suhoff76 folded before Flop (didn't bet)
Seat 6: KeLevro0 folded before Flop (didn't bet)
Seat 7: acamrash folded before Flop (didn't bet)
Seat 8: BlOnDhOlIc folded before Flop (didn't bet)
Seat 9: Dejacob folded before Flop (didn't bet)



PokerStars Zoom Hand #84299412394:  Hold'em No Limit ($0.10/$0.25) - 2012/08/05 14:17:37 JST [2012/08/05 1:17:37 ET]
Table 'Whirlpool' 9-max Seat #1 is the button
Seat 1: hirozo ($35.43 in chips) 
Seat 2: carlosrbr ($55.17 in chips) 
Seat 3: chiyuki ($54.70 in chips) 
Seat 4: KAKamiro ($62.42 in chips) 
Seat 5: acamrash ($31.35 in chips) 
Seat 6: kkbruins0408 ($12.50 in chips) 
Seat 7: Th3Fog ($74.93 in chips) 
Seat 8: ChrisCDee ($25 in chips) 
Seat 9: Nerkit ($10.40 in chips) 
carlosrbr: posts small blind $0.10
chiyuki: posts big blind $0.25
*** HOLE CARDS ***
Dealt to chiyuki [9h Tc]
KAKamiro: calls $0.25
acamrash: folds 
kkbruins0408: folds 
Th3Fog: folds 
ChrisCDee: folds 
Nerkit: folds 
hirozo: folds 
carlosrbr: folds 
chiyuki: checks 
*** FLOP *** [9c 2d 8s]
chiyuki: checks 
KAKamiro: checks 
*** TURN *** [9c 2d 8s] [Td]
chiyuki: bets $0.50
KAKamiro: calls $0.50
*** RIVER *** [9c 2d 8s Td] [5d]
chiyuki: bets $1.50
KAKamiro: raises $2 to $3.50
chiyuki: calls $2
*** SHOW DOWN ***
KAKamiro: shows [Qd 3d] (a flush, Queen high)
chiyuki: mucks hand 
KAKamiro collected $8.21 from pot
*** SUMMARY ***
Total pot $8.60 | Rake $0.39 
Board [9c 2d 8s Td 5d]
Seat 1: hirozo (button) folded before Flop (didn't bet)
Seat 2: carlosrbr (small blind) folded before Flop
Seat 3: chiyuki (big blind) mucked [9h Tc]
Seat 4: KAKamiro showed [Qd 3d] and won ($8.21) with a flush, Queen high
Seat 5: acamrash folded before Flop (didn't bet)
Seat 6: kkbruins0408 folded before Flop (didn't bet)
Seat 7: Th3Fog folded before Flop (didn't bet)
Seat 8: ChrisCDee folded before Flop (didn't bet)
Seat 9: Nerkit folded before Flop (didn't bet)



PokerStars Zoom Hand #84299434800:  Hold'em No Limit ($0.10/$0.25) - 2012/08/05 14:19:08 JST [2012/08/05 1:19:08 ET]
Table 'Whirlpool' 9-max Seat #1 is the button
Seat 1: hirozo ($35.93 in chips) 
Seat 2: PetitAlejo ($34.62 in chips) 
Seat 3: kamikkaze ($31.37 in chips) 
Seat 4: acamrash ($15.99 in chips) 
Seat 5: Suhoff76 ($26.48 in chips) 
Seat 6: BlOnDhOlIc ($38.06 in chips) 
Seat 7: chiyuki ($50.45 in chips) 
Seat 8: Th3Fog ($49.58 in chips) 
Seat 9: carlosrbr ($50.80 in chips) 
PetitAlejo: posts small blind $0.10
kamikkaze: posts big blind $0.25
*** HOLE CARDS ***
Dealt to chiyuki [9s 3d]
acamrash: folds 
Suhoff76: folds 
BlOnDhOlIc has timed out
BlOnDhOlIc: folds 
chiyuki: folds 
Th3Fog: folds 
carlosrbr: folds 
hirozo: folds 
PetitAlejo: raises $0.50 to $0.75
kamikkaze: folds 
Uncalled bet ($0.50) returned to PetitAlejo
PetitAlejo collected $0.50 from pot
PetitAlejo: doesn't show hand 
*** SUMMARY ***
Total pot $0.50 | Rake $0 
Seat 1: hirozo (button) folded before Flop (didn't bet)
Seat 2: PetitAlejo (small blind) collected ($0.50)
Seat 3: kamikkaze (big blind) folded before Flop
Seat 4: acamrash folded before Flop (didn't bet)
Seat 5: Suhoff76 folded before Flop (didn't bet)
Seat 6: BlOnDhOlIc folded before Flop (didn't bet)
Seat 7: chiyuki folded before Flop (didn't bet)
Seat 8: Th3Fog folded before Flop (didn't bet)
Seat 9: carlosrbr folded before Flop (didn't bet)



PokerStars Zoom Hand #84299436507:  Hold'em No Limit ($0.10/$0.25) - 2012/08/05 14:19:15 JST [2012/08/05 1:19:15 ET]
Table 'Whirlpool' 9-max Seat #1 is the button
Seat 1: chiyuki ($50.45 in chips) 
Seat 2: troms20 ($58.33 in chips) 
Seat 3: Th3Fog ($17.47 in chips) 
Seat 4: Loholov ($17.55 in chips) 
Seat 5: WARIBANA7777 ($14.34 in chips) 
Seat 6: Perstenev ($13 in chips) 
Seat 7: hirozo ($35.93 in chips) 
Seat 8: cr0lox ($21.45 in chips) 
Seat 9: Déculotter69 ($16.10 in chips) 
troms20: posts small blind $0.10
Th3Fog: posts big blind $0.25
*** HOLE CARDS ***
Dealt to chiyuki [Th Qd]
Loholov: folds 
WARIBANA7777: folds 
Perstenev: folds 
hirozo: folds 
cr0lox: folds 
Déculotter69: raises $0.50 to $0.75
chiyuki: folds 
troms20: calls $0.65
Th3Fog: folds 
*** FLOP *** [6h 9s 6d]
troms20: checks 
Déculotter69: bets $1
troms20: folds 
Uncalled bet ($1) returned to Déculotter69
Déculotter69 collected $1.67 from pot
Déculotter69: doesn't show hand 
*** SUMMARY ***
Total pot $1.75 | Rake $0.08 
Board [6h 9s 6d]
Seat 1: chiyuki (button) folded before Flop (didn't bet)
Seat 2: troms20 (small blind) folded on the Flop
Seat 3: Th3Fog (big blind) folded before Flop
Seat 4: Loholov folded before Flop (didn't bet)
Seat 5: WARIBANA7777 folded before Flop (didn't bet)
Seat 6: Perstenev folded before Flop (didn't bet)
Seat 7: hirozo folded before Flop (didn't bet)
Seat 8: cr0lox folded before Flop (didn't bet)
Seat 9: Déculotter69 collected ($1.67)



PokerStars Zoom Hand #84299442107:  Hold'em No Limit ($0.10/$0.25) - 2012/08/05 14:19:38 JST [2012/08/05 1:19:38 ET]
Table 'Whirlpool' 9-max Seat #1 is the button
Seat 1: kamikkaze ($31.12 in chips) 
Seat 2: agurio ($26.70 in chips) 
Seat 3: Vahe50 ($19.81 in chips) 
Seat 4: KeLevro0 ($12.25 in chips) 
Seat 5: craden500 ($18.95 in chips) 
Seat 6: chiyuki ($50.35 in chips) 
Seat 7: PetitAlejo ($29.52 in chips) 
Seat 8: RomarioJa ($12.50 in chips) 
Seat 9: deadmoneykid ($31.57 in chips) 
agurio: posts small blind $0.10
Vahe50: posts big blind $0.25
*** HOLE CARDS ***
Dealt to chiyuki [4c 3d]
KeLevro0: folds 
craden500: folds 
chiyuki: folds 
PetitAlejo: folds 
RomarioJa: folds 
deadmoneykid: folds 
kamikkaze: folds 
agurio: folds 
Uncalled bet ($0.15) returned to Vahe50
Vahe50 collected $0.20 from pot
Vahe50: doesn't show hand 
*** SUMMARY ***
Total pot $0.20 | Rake $0 
Seat 1: kamikkaze (button) folded before Flop (didn't bet)
Seat 2: agurio (small blind) folded before Flop
Seat 3: Vahe50 (big blind) collected ($0.20)
Seat 4: KeLevro0 folded before Flop (didn't bet)
Seat 5: craden500 folded before Flop (didn't bet)
Seat 6: chiyuki folded before Flop (didn't bet)
Seat 7: PetitAlejo folded before Flop (didn't bet)
Seat 8: RomarioJa folded before Flop (didn't bet)
Seat 9: deadmoneykid folded before Flop (didn't bet)



PokerStars Zoom Hand #84299441040:  Hold'em No Limit ($0.10/$0.25) - 2012/08/05 14:19:34 JST [2012/08/05 1:19:34 ET]
Table 'Whirlpool' 9-max Seat #1 is the button
Seat 1: leo2095 ($11.22 in chips) 
Seat 2: chiyuki ($50.45 in chips) 
Seat 3: Th3Fog ($74.18 in chips) 
Seat 4: PetitAlejo ($29.52 in chips) 
Seat 5: Roglus ($59.09 in chips) 
Seat 6: WARIBANA7777 ($14.09 in chips) 
Seat 7: troms20 ($27.08 in chips) 
Seat 8: Suhoff76 ($31.45 in chips) 
Seat 9: eyesJeJa ($25 in chips) 
chiyuki: posts small blind $0.10
Th3Fog: posts big blind $0.25
*** HOLE CARDS ***
Dealt to chiyuki [2s 7d]
PetitAlejo: folds 
Roglus: folds 
WARIBANA7777: folds 
troms20: folds 
Suhoff76: raises $0.32 to $0.57
eyesJeJa: folds 
leo2095: raises $0.32 to $0.89
chiyuki: folds 
Th3Fog: folds 
Suhoff76: calls $0.32
*** FLOP *** [5s 2c Qs]
Suhoff76: checks 
leo2095: checks 
*** TURN *** [5s 2c Qs] [Ts]
Suhoff76: bets $1.33
leo2095: calls $1.33
*** RIVER *** [5s 2c Qs Ts] [2d]
Suhoff76: bets $0.70
leo2095: calls $0.70
*** SHOW DOWN ***
Suhoff76: shows [5h Ah] (two pair, Fives and Deuces)
leo2095: shows [Qd Ad] (two pair, Queens and Deuces)
leo2095 collected $5.91 from pot
*** SUMMARY ***
Total pot $6.19 | Rake $0.28 
Board [5s 2c Qs Ts 2d]
Seat 1: leo2095 (button) showed [Qd Ad] and won ($5.91) with two pair, Queens and Deuces
Seat 2: chiyuki (small blind) folded before Flop
Seat 3: Th3Fog (big blind) folded before Flop
Seat 4: PetitAlejo folded before Flop (didn't bet)
Seat 5: Roglus folded before Flop (didn't bet)
Seat 6: WARIBANA7777 folded before Flop (didn't bet)
Seat 7: troms20 folded before Flop (didn't bet)
Seat 8: Suhoff76 showed [5h Ah] and lost with two pair, Fives and Deuces
Seat 9: eyesJeJa folded before Flop (didn't bet)



PokerStars Zoom Hand #84299445081:  Hold'em No Limit ($0.10/$0.25) - 2012/08/05 14:19:50 JST [2012/08/05 1:19:50 ET]
Table 'Whirlpool' 9-max Seat #1 is the button
Seat 1: KeLevro0 ($8.01 in chips) 
Seat 2: PetitAlejo ($36.21 in chips) 
Seat 3: Jene4kaBest ($12.66 in chips) 
Seat 4: deadmoneykid ($23.10 in chips) 
Seat 5: Dejacob ($40.27 in chips) 
Seat 6: acamrash ($11.45 in chips) 
Seat 7: Faraz ($21.47 in chips) 
Seat 8: chiyuki ($50.35 in chips) 
Seat 9: phate-1up ($27.07 in chips) 
PetitAlejo: posts small blind $0.10
Jene4kaBest: posts big blind $0.25
*** HOLE CARDS ***
Dealt to chiyuki [6h 4s]
deadmoneykid: folds 
Dejacob: folds 
acamrash: folds 
Faraz: folds 
chiyuki: folds 
phate-1up: folds 
KeLevro0: raises $0.42 to $0.67
PetitAlejo: folds 
Jene4kaBest: folds 
Uncalled bet ($0.42) returned to KeLevro0
KeLevro0 collected $0.60 from pot
KeLevro0: doesn't show hand 
*** SUMMARY ***
Total pot $0.60 | Rake $0 
Seat 1: KeLevro0 (button) collected ($0.60)
Seat 2: PetitAlejo (small blind) folded before Flop
Seat 3: Jene4kaBest (big blind) folded before Flop
Seat 4: deadmoneykid folded before Flop (didn't bet)
Seat 5: Dejacob folded before Flop (didn't bet)
Seat 6: acamrash folded before Flop (didn't bet)
Seat 7: Faraz folded before Flop (didn't bet)
Seat 8: chiyuki folded before Flop (didn't bet)
Seat 9: phate-1up folded before Flop (didn't bet)



PokerStars Zoom Hand #84299447739:  Hold'em No Limit ($0.10/$0.25) - 2012/08/05 14:20:01 JST [2012/08/05 1:20:01 ET]
Table 'Whirlpool' 9-max Seat #1 is the button
Seat 1: AlfredE525 ($15 in chips) 
Seat 2: Nerkit ($12.50 in chips) 
Seat 3: RikkStroken ($11.45 in chips) 
Seat 4: hirozo ($33.22 in chips) 
Seat 5: flyinprits ($28.34 in chips) 
Seat 6: Déculotter69 ($17.02 in chips) 
Seat 7: WARIBANA7777 ($13.99 in chips) 
Seat 8: fezman ($14.23 in chips) 
Seat 9: chiyuki ($50.35 in chips) 
Nerkit: posts small blind $0.10
RikkStroken: posts big blind $0.25
*** HOLE CARDS ***
Dealt to chiyuki [2d 9d]
hirozo: folds 
flyinprits: raises $0.50 to $0.75
Déculotter69: folds 
WARIBANA7777: folds 
fezman: folds 
chiyuki: folds 
AlfredE525: folds 
Nerkit: folds 
RikkStroken: folds 
Uncalled bet ($0.50) returned to flyinprits
flyinprits collected $0.60 from pot
flyinprits: doesn't show hand 
*** SUMMARY ***
Total pot $0.60 | Rake $0 
Seat 1: AlfredE525 (button) folded before Flop (didn't bet)
Seat 2: Nerkit (small blind) folded before Flop
Seat 3: RikkStroken (big blind) folded before Flop
Seat 4: hirozo folded before Flop (didn't bet)
Seat 5: flyinprits collected ($0.60)
Seat 6: Déculotter69 folded before Flop (didn't bet)
Seat 7: WARIBANA7777 folded before Flop (didn't bet)
Seat 8: fezman folded before Flop (didn't bet)
Seat 9: chiyuki folded before Flop (didn't bet)



PokerStars Zoom Hand #84299443541:  Hold'em No Limit ($0.10/$0.25) - 2012/08/05 14:19:44 JST [2012/08/05 1:19:44 ET]
Table 'Whirlpool' 9-max Seat #1 is the button
Seat 1: Suhoff76 ($26.38 in chips) 
Seat 2: Perstenev ($12.75 in chips) 
Seat 3: kkbruins0408 ($13.91 in chips) 
Seat 4: seula i ($27.74 in chips) 
Seat 5: PetitAlejo ($34.87 in chips) 
Seat 6: phate-1up ($25 in chips) 
Seat 7: deadmoneykid ($31.57 in chips) 
Seat 8: kamikkaze ($12.10 in chips) 
Seat 9: chiyuki ($50.35 in chips) 
Perstenev: posts small blind $0.10
kkbruins0408: posts big blind $0.25
*** HOLE CARDS ***
Dealt to chiyuki [8h 3c]
seula i: folds 
PetitAlejo: folds 
phate-1up: folds 
deadmoneykid: folds 
kamikkaze: folds 
chiyuki: folds 
Suhoff76: raises $0.32 to $0.57
Perstenev: folds 
kkbruins0408: calls $0.32
*** FLOP *** [9c Ad Th]
kkbruins0408: checks 
Suhoff76: bets $0.77
kkbruins0408: calls $0.77
*** TURN *** [9c Ad Th] [Kh]
kkbruins0408: checks 
Suhoff76: checks 
*** RIVER *** [9c Ad Th Kh] [9d]
kkbruins0408: checks 
Suhoff76: checks 
*** SHOW DOWN ***
kkbruins0408: shows [Td Qc] (two pair, Tens and Nines)
Suhoff76: shows [Qs Ah] (two pair, Aces and Nines)
Suhoff76 collected $2.65 from pot
*** SUMMARY ***
Total pot $2.78 | Rake $0.13 
Board [9c Ad Th Kh 9d]
Seat 1: Suhoff76 (button) showed [Qs Ah] and won ($2.65) with two pair, Aces and Nines
Seat 2: Perstenev (small blind) folded before Flop
Seat 3: kkbruins0408 (big blind) showed [Td Qc] and lost with two pair, Tens and Nines
Seat 4: seula i folded before Flop (didn't bet)
Seat 5: PetitAlejo folded before Flop (didn't bet)
Seat 6: phate-1up folded before Flop (didn't bet)
Seat 7: deadmoneykid folded before Flop (didn't bet)
Seat 8: kamikkaze folded before Flop (didn't bet)
Seat 9: chiyuki folded before Flop (didn't bet)



PokerStars Zoom Hand #84299446307:  Hold'em No Limit ($0.10/$0.25) - 2012/08/05 14:19:55 JST [2012/08/05 1:19:55 ET]
Table 'Whirlpool' 9-max Seat #1 is the button
Seat 1: deadmoneykid ($23.10 in chips) 
Seat 2: ChrisCDee ($68.13 in chips) 
Seat 3: RomarioJa ($10.91 in chips) 
Seat 4: softdesign ($70.03 in chips) 
Seat 5: chiyuki ($50.35 in chips) 
Seat 6: troms20 ($21.49 in chips) 
Seat 7: RikkStroken ($21.31 in chips) 
Seat 8: flyinprits ($28.34 in chips) 
Seat 9: wtu1986 ($24.93 in chips) 
ChrisCDee: posts small blind $0.10
RomarioJa: posts big blind $0.25
*** HOLE CARDS ***
Dealt to chiyuki [Qd 8d]
softdesign: folds 
chiyuki: folds 
troms20: folds 
RikkStroken: folds 
flyinprits: folds 
wtu1986: raises $0.50 to $0.75
deadmoneykid: folds 
ChrisCDee: folds 
RomarioJa: folds 
Uncalled bet ($0.50) returned to wtu1986
wtu1986 collected $0.60 from pot
wtu1986: doesn't show hand 
*** SUMMARY ***
Total pot $0.60 | Rake $0 
Seat 1: deadmoneykid (button) folded before Flop (didn't bet)
Seat 2: ChrisCDee (small blind) folded before Flop
Seat 3: RomarioJa (big blind) folded before Flop
Seat 4: softdesign folded before Flop (didn't bet)
Seat 5: chiyuki folded before Flop (didn't bet)
Seat 6: troms20 folded before Flop (didn't bet)
Seat 7: RikkStroken folded before Flop (didn't bet)
Seat 8: flyinprits folded before Flop (didn't bet)
Seat 9: wtu1986 collected ($0.60)



PokerStars Zoom Hand #84299448466:  Hold'em No Limit ($0.10/$0.25) - 2012/08/05 14:20:04 JST [2012/08/05 1:20:04 ET]
Table 'Whirlpool' 9-max Seat #1 is the button
Seat 1: Vahe50 ($19.91 in chips) 
Seat 2: Dan Royal ($41.24 in chips) 
Seat 3: chiyuki ($50.35 in chips) 
Seat 4: troms20 ($26.83 in chips) 
Seat 5: agurio ($26.60 in chips) 
Seat 6: jeff0923 ($25.51 in chips) 
Seat 7: 4thepeople ($22.88 in chips) 
Seat 8: Dejacob ($25 in chips) 
Seat 9: kamikkaze ($31.02 in chips) 
Dan Royal: posts small blind $0.10
chiyuki: posts big blind $0.25
*** HOLE CARDS ***
Dealt to chiyuki [Th Ah]
troms20: folds 
agurio: folds 
jeff0923: folds 
4thepeople: calls $0.25
Dejacob: folds 
kamikkaze: folds 
Vahe50 has timed out
Vahe50: folds 
Dan Royal: calls $0.15
chiyuki: checks 
*** FLOP *** [Kc 9h 8c]
Dan Royal: checks 
chiyuki: checks 
4thepeople: checks 
*** TURN *** [Kc 9h 8c] [6h]
Dan Royal: bets $0.50
chiyuki: calls $0.50
4thepeople: folds 
*** RIVER *** [Kc 9h 8c 6h] [Js]
Dan Royal: bets $1
chiyuki: folds 
Uncalled bet ($1) returned to Dan Royal
Dan Royal collected $1.67 from pot
Dan Royal: doesn't show hand 
*** SUMMARY ***
Total pot $1.75 | Rake $0.08 
Board [Kc 9h 8c 6h Js]
Seat 1: Vahe50 (button) folded before Flop (didn't bet)
Seat 2: Dan Royal (small blind) collected ($1.67)
Seat 3: chiyuki (big blind) folded on the River
Seat 4: troms20 folded before Flop (didn't bet)
Seat 5: agurio folded before Flop (didn't bet)
Seat 6: jeff0923 folded before Flop (didn't bet)
Seat 7: 4thepeople folded on the Turn
Seat 8: Dejacob folded before Flop (didn't bet)
Seat 9: kamikkaze folded before Flop (didn't bet)



PokerStars Zoom Hand #84299461423:  Hold'em No Limit ($0.10/$0.25) - 2012/08/05 14:20:57 JST [2012/08/05 1:20:57 ET]
Table 'Whirlpool' 9-max Seat #1 is the button
Seat 1: chiyuki ($49.60 in chips) 
Seat 2: Loholov ($15 in chips) 
Seat 3: RomarioJa ($14.26 in chips) 
Seat 4: phate-1up ($25.25 in chips) 
Seat 5: Lasutchik ($56.63 in chips) 
Seat 6: Dejacob ($26.49 in chips) 
Seat 7: dushvan ($29.57 in chips) 
Seat 8: silvno31 ($34.25 in chips) 
Seat 9: PetitAlejo ($29.52 in chips) 
Loholov: posts small blind $0.10
RomarioJa: posts big blind $0.25
*** HOLE CARDS ***
Dealt to chiyuki [Ac 2s]
phate-1up: folds 
Lasutchik: folds 
Dejacob: folds 
dushvan: folds 
silvno31: folds 
PetitAlejo: folds 
chiyuki: folds 
Loholov: folds 
Uncalled bet ($0.15) returned to RomarioJa
RomarioJa collected $0.20 from pot
RomarioJa: doesn't show hand 
*** SUMMARY ***
Total pot $0.20 | Rake $0 
Seat 1: chiyuki (button) folded before Flop (didn't bet)
Seat 2: Loholov (small blind) folded before Flop
Seat 3: RomarioJa (big blind) collected ($0.20)
Seat 4: phate-1up folded before Flop (didn't bet)
Seat 5: Lasutchik folded before Flop (didn't bet)
Seat 6: Dejacob folded before Flop (didn't bet)
Seat 7: dushvan folded before Flop (didn't bet)
Seat 8: silvno31 folded before Flop (didn't bet)
Seat 9: PetitAlejo folded before Flop (didn't bet)



PokerStars Zoom Hand #84299462382:  Hold'em No Limit ($0.10/$0.25) - 2012/08/05 14:21:01 JST [2012/08/05 1:21:01 ET]
Table 'Whirlpool' 9-max Seat #1 is the button
Seat 1: Suhoff76 ($27.79 in chips) 
Seat 2: silvno31 ($34.25 in chips) 
Seat 3: Noviekid ($90.72 in chips) 
Seat 4: troms20 ($26.48 in chips) 
Seat 5: chiyuki ($49.60 in chips) 
Seat 6: PetitAlejo ($29.52 in chips) 
Seat 7: deadmoneykid ($22.28 in chips) 
Seat 8: seula i ($25 in chips) 
Seat 9: hirozo ($32.87 in chips) 
silvno31: posts small blind $0.10
Noviekid: posts big blind $0.25
*** HOLE CARDS ***
Dealt to chiyuki [Kd Ts]
troms20: folds 
chiyuki: folds 
PetitAlejo: folds 
deadmoneykid: folds 
seula i: folds 
hirozo: folds 
Suhoff76: folds 
silvno31: folds 
Uncalled bet ($0.15) returned to Noviekid
Noviekid collected $0.20 from pot
Noviekid: doesn't show hand 
*** SUMMARY ***
Total pot $0.20 | Rake $0 
Seat 1: Suhoff76 (button) folded before Flop (didn't bet)
Seat 2: silvno31 (small blind) folded before Flop
Seat 3: Noviekid (big blind) collected ($0.20)
Seat 4: troms20 folded before Flop (didn't bet)
Seat 5: chiyuki folded before Flop (didn't bet)
Seat 6: PetitAlejo folded before Flop (didn't bet)
Seat 7: deadmoneykid folded before Flop (didn't bet)
Seat 8: seula i folded before Flop (didn't bet)
Seat 9: hirozo folded before Flop (didn't bet)



PokerStars Zoom Hand #84299463368:  Hold'em No Limit ($0.10/$0.25) - 2012/08/05 14:21:05 JST [2012/08/05 1:21:05 ET]
Table 'Whirlpool' 9-max Seat #1 is the button
Seat 1: Th3Fog ($16.87 in chips) 
Seat 2: chiyuki ($49.60 in chips) 
Seat 3: Roglus ($55.49 in chips) 
Seat 4: Suhoff76 ($25 in chips) 
Seat 5: roksmokndonk ($30.96 in chips) 
Seat 6: AlfredE525 ($15.35 in chips) 
Seat 7: D@vidMed ($67.09 in chips) 
Seat 8: Perstenev ($11.14 in chips) 
Seat 9: silvno31 ($34.15 in chips) 
chiyuki: posts small blind $0.10
Roglus: posts big blind $0.25
*** HOLE CARDS ***
Dealt to chiyuki [Qs Ad]
Suhoff76: folds 
roksmokndonk: raises $0.50 to $0.75
AlfredE525: folds 
D@vidMed: calls $0.75
Perstenev: folds 
silvno31: folds 
Th3Fog: calls $0.75
chiyuki: folds 
Roglus: calls $0.50
*** FLOP *** [3h 6h 3c]
Roglus: checks 
roksmokndonk: checks 
D@vidMed: bets $0.82
Th3Fog: folds 
Roglus: calls $0.82
roksmokndonk: calls $0.82
*** TURN *** [3h 6h 3c] [2c]
Roglus: bets $1.85
roksmokndonk: folds 
D@vidMed: folds 
Uncalled bet ($1.85) returned to Roglus
Roglus collected $5.31 from pot
Roglus: doesn't show hand 
*** SUMMARY ***
Total pot $5.56 | Rake $0.25 
Board [3h 6h 3c 2c]
Seat 1: Th3Fog (button) folded on the Flop
Seat 2: chiyuki (small blind) folded before Flop
Seat 3: Roglus (big blind) collected ($5.31)
Seat 4: Suhoff76 folded before Flop (didn't bet)
Seat 5: roksmokndonk folded on the Turn
Seat 6: AlfredE525 folded before Flop (didn't bet)
Seat 7: D@vidMed folded on the Turn
Seat 8: Perstenev folded before Flop (didn't bet)
Seat 9: silvno31 folded before Flop (didn't bet)



PokerStars Zoom Hand #84299476299:  Hold'em No Limit ($0.10/$0.25) - 2012/08/05 14:21:58 JST [2012/08/05 1:21:58 ET]
Table 'Whirlpool' 9-max Seat #1 is the button
Seat 1: roksmokndonk ($29.39 in chips) 
Seat 2: kamikkaze ($15 in chips) 
Seat 3: seula i ($25 in chips) 
Seat 4: Suhoff76 ($28.18 in chips) 
Seat 5: dushvan ($29.57 in chips) 
Seat 6: RikkStroken ($19.31 in chips) 
Seat 7: chiyuki ($49.50 in chips) 
Seat 8: Dejacob ($27.16 in chips) 
Seat 9: wtu1986 ($31.39 in chips) 
kamikkaze: posts small blind $0.10
seula i: posts big blind $0.25
*** HOLE CARDS ***
Dealt to chiyuki [8h Ks]
Suhoff76: raises $0.50 to $0.75
dushvan: folds 
RikkStroken: folds 
chiyuki: folds 
Dejacob: folds 
wtu1986: folds 
roksmokndonk: folds 
kamikkaze: folds 
seula i: folds 
Uncalled bet ($0.50) returned to Suhoff76
Suhoff76 collected $0.60 from pot
Suhoff76: doesn't show hand 
*** SUMMARY ***
Total pot $0.60 | Rake $0 
Seat 1: roksmokndonk (button) folded before Flop (didn't bet)
Seat 2: kamikkaze (small blind) folded before Flop
Seat 3: seula i (big blind) folded before Flop
Seat 4: Suhoff76 collected ($0.60)
Seat 5: dushvan folded before Flop (didn't bet)
Seat 6: RikkStroken folded before Flop (didn't bet)
Seat 7: chiyuki folded before Flop (didn't bet)
Seat 8: Dejacob folded before Flop (didn't bet)
Seat 9: wtu1986 folded before Flop (didn't bet)



PokerStars Zoom Hand #84299478575:  Hold'em No Limit ($0.10/$0.25) - 2012/08/05 14:22:06 JST [2012/08/05 1:22:06 ET]
Table 'Whirlpool' 9-max Seat #1 is the button
Seat 1: troms20 ($54.90 in chips) 
Seat 2: deadmoneykid ($30.80 in chips) 
Seat 3: PetitAlejo ($50.46 in chips) 
Seat 4: Loholov ($15 in chips) 
Seat 5: kamikkaze ($31.37 in chips) 
Seat 6: chiyuki ($49.50 in chips) 
Seat 7: Nerkit ($9.90 in chips) 
Seat 8: roksmokndonk ($29.39 in chips) 
Seat 9: Perstenev ($13.31 in chips) 
deadmoneykid: posts small blind $0.10
PetitAlejo: posts big blind $0.25
*** HOLE CARDS ***
Dealt to chiyuki [Qs 6s]
Loholov: folds 
kamikkaze: folds 
chiyuki: folds 
Nerkit: folds 
roksmokndonk: folds 
Perstenev: folds 
troms20: folds 
deadmoneykid: folds 
Uncalled bet ($0.15) returned to PetitAlejo
PetitAlejo collected $0.20 from pot
PetitAlejo: doesn't show hand 
*** SUMMARY ***
Total pot $0.20 | Rake $0 
Seat 1: troms20 (button) folded before Flop (didn't bet)
Seat 2: deadmoneykid (small blind) folded before Flop
Seat 3: PetitAlejo (big blind) collected ($0.20)
Seat 4: Loholov folded before Flop (didn't bet)
Seat 5: kamikkaze folded before Flop (didn't bet)
Seat 6: chiyuki folded before Flop (didn't bet)
Seat 7: Nerkit folded before Flop (didn't bet)
Seat 8: roksmokndonk folded before Flop (didn't bet)
Seat 9: Perstenev folded before Flop (didn't bet)



PokerStars Zoom Hand #84299479815:  Hold'em No Limit ($0.10/$0.25) - 2012/08/05 14:22:11 JST [2012/08/05 1:22:11 ET]
Table 'Whirlpool' 9-max Seat #1 is the button
Seat 1: Suhoff76 ($28.53 in chips) 
Seat 2: Perstenev ($13.31 in chips) 
Seat 3: Loholov ($15 in chips) 
Seat 4: chiyuki ($49.50 in chips) 
Seat 5: RikkStroken ($19.31 in chips) 
Seat 6: roksmokndonk ($29.39 in chips) 
Seat 7: bonethugs699 ($24.65 in chips) 
Seat 8: Ellen1947 ($39.12 in chips) 
Seat 9: KeLevro0 ($11.80 in chips) 
Perstenev: posts small blind $0.10
Loholov: posts big blind $0.25
*** HOLE CARDS ***
Dealt to chiyuki [3c Th]
chiyuki: folds 
RikkStroken: raises $0.50 to $0.75
roksmokndonk: folds 
bonethugs699: raises $1.65 to $2.40
Ellen1947: folds 
KeLevro0: folds 
Suhoff76: folds 
Perstenev: folds 
Loholov: folds 
RikkStroken: raises $4.10 to $6.50
bonethugs699: calls $4.10
*** FLOP *** [9c Ad Ks]
RikkStroken: bets $5.75
bonethugs699: folds 
Uncalled bet ($5.75) returned to RikkStroken
RikkStroken collected $12.75 from pot
RikkStroken: doesn't show hand 
*** SUMMARY ***
Total pot $13.35 | Rake $0.60 
Board [9c Ad Ks]
Seat 1: Suhoff76 (button) folded before Flop (didn't bet)
Seat 2: Perstenev (small blind) folded before Flop
Seat 3: Loholov (big blind) folded before Flop
Seat 4: chiyuki folded before Flop (didn't bet)
Seat 5: RikkStroken collected ($12.75)
Seat 6: roksmokndonk folded before Flop (didn't bet)
Seat 7: bonethugs699 folded on the Flop
Seat 8: Ellen1947 folded before Flop (didn't bet)
Seat 9: KeLevro0 folded before Flop (didn't bet)



PokerStars Zoom Hand #84299484805:  Hold'em No Limit ($0.10/$0.25) - 2012/08/05 14:22:31 JST [2012/08/05 1:22:31 ET]
Table 'Whirlpool' 9-max Seat #1 is the button
Seat 1: deadmoneykid ($30.70 in chips) 
Seat 2: wtu1986 ($25 in chips) 
Seat 3: DanielWhyte ($21.38 in chips) 
Seat 4: KeLevro0 ($10.02 in chips) 
Seat 5: chiyuki ($49.50 in chips) 
Seat 6: Suhoff76 ($28.28 in chips) 
Seat 7: Paranoix1990 ($5.72 in chips) 
Seat 8: kamikkaze ($18.27 in chips) 
Seat 9: simonzez ($50.45 in chips) 
wtu1986: posts small blind $0.10
DanielWhyte: posts big blind $0.25
*** HOLE CARDS ***
Dealt to chiyuki [Tc 6h]
KeLevro0: folds 
chiyuki: folds 
Suhoff76: folds 
Paranoix1990: folds 
kamikkaze: folds 
simonzez: calls $0.25
deadmoneykid: folds 
wtu1986: folds 
DanielWhyte: checks 
*** FLOP *** [9s 4h 7h]
DanielWhyte: checks 
simonzez: bets $0.50
DanielWhyte: folds 
Uncalled bet ($0.50) returned to simonzez
simonzez collected $0.57 from pot
simonzez: doesn't show hand 
*** SUMMARY ***
Total pot $0.60 | Rake $0.03 
Board [9s 4h 7h]
Seat 1: deadmoneykid (button) folded before Flop (didn't bet)
Seat 2: wtu1986 (small blind) folded before Flop
Seat 3: DanielWhyte (big blind) folded on the Flop
Seat 4: KeLevro0 folded before Flop (didn't bet)
Seat 5: chiyuki folded before Flop (didn't bet)
Seat 6: Suhoff76 folded before Flop (didn't bet)
Seat 7: Paranoix1990 folded before Flop (didn't bet)
Seat 8: kamikkaze folded before Flop (didn't bet)
Seat 9: simonzez collected ($0.57)



PokerStars Zoom Hand #84299487002:  Hold'em No Limit ($0.10/$0.25) - 2012/08/05 14:22:40 JST [2012/08/05 1:22:40 ET]
Table 'Whirlpool' 9-max Seat #1 is the button
Seat 1: Roglus ($60.93 in chips) 
Seat 2: Suhoff76 ($25 in chips) 
Seat 3: deadmoneykid ($21.53 in chips) 
Seat 4: acamrash ($11.75 in chips) 
Seat 5: mariuka1 ($10.30 in chips) 
Seat 6: Th3Fog ($16.02 in chips) 
Seat 7: chiyuki ($49.50 in chips) 
Seat 8: kamikkaze ($14.65 in chips) 
Seat 9: D@vidMed ($65.42 in chips) 
Suhoff76: posts small blind $0.10
deadmoneykid: posts big blind $0.25
*** HOLE CARDS ***
Dealt to chiyuki [2c 5d]
acamrash: raises $0.36 to $0.61
mariuka1: folds 
Th3Fog: folds 
chiyuki: folds 
kamikkaze: folds 
D@vidMed: folds 
Roglus: folds 
Suhoff76: folds 
deadmoneykid: folds 
Uncalled bet ($0.36) returned to acamrash
acamrash collected $0.60 from pot
acamrash: doesn't show hand 
*** SUMMARY ***
Total pot $0.60 | Rake $0 
Seat 1: Roglus (button) folded before Flop (didn't bet)
Seat 2: Suhoff76 (small blind) folded before Flop
Seat 3: deadmoneykid (big blind) folded before Flop
Seat 4: acamrash collected ($0.60)
Seat 5: mariuka1 folded before Flop (didn't bet)
Seat 6: Th3Fog folded before Flop (didn't bet)
Seat 7: chiyuki folded before Flop (didn't bet)
Seat 8: kamikkaze folded before Flop (didn't bet)
Seat 9: D@vidMed folded before Flop (didn't bet)



PokerStars Zoom Hand #84299486023:  Hold'em No Limit ($0.10/$0.25) - 2012/08/05 14:22:36 JST [2012/08/05 1:22:36 ET]
Table 'Whirlpool' 9-max Seat #1 is the button
Seat 1: hirozo ($32.52 in chips) 
Seat 2: PetitAlejo ($33.51 in chips) 
Seat 3: Dejacob ($46.61 in chips) 
Seat 4: Landybob ($42.65 in chips) 
Seat 5: Loholov ($15.25 in chips) 
Seat 6: kamikkaze ($14.65 in chips) 
Seat 7: acamrash ($11.75 in chips) 
Seat 8: chiyuki ($49.50 in chips) 
Seat 9: Lasutchik ($68.70 in chips) 
PetitAlejo: posts small blind $0.10
Dejacob: posts big blind $0.25
*** HOLE CARDS ***
Dealt to chiyuki [7h 5s]
Landybob: folds 
Loholov: folds 
kamikkaze: folds 
acamrash: folds 
chiyuki: folds 
Lasutchik: folds 
hirozo: raises $0.25 to $0.50
PetitAlejo: folds 
Dejacob: folds 
Uncalled bet ($0.25) returned to hirozo
hirozo collected $0.60 from pot
hirozo: doesn't show hand 
*** SUMMARY ***
Total pot $0.60 | Rake $0 
Seat 1: hirozo (button) collected ($0.60)
Seat 2: PetitAlejo (small blind) folded before Flop
Seat 3: Dejacob (big blind) folded before Flop
Seat 4: Landybob folded before Flop (didn't bet)
Seat 5: Loholov folded before Flop (didn't bet)
Seat 6: kamikkaze folded before Flop (didn't bet)
Seat 7: acamrash folded before Flop (didn't bet)
Seat 8: chiyuki folded before Flop (didn't bet)
Seat 9: Lasutchik folded before Flop (didn't bet)



PokerStars Zoom Hand #84299488711:  Hold'em No Limit ($0.10/$0.25) - 2012/08/05 14:22:47 JST [2012/08/05 1:22:47 ET]
Table 'Whirlpool' 9-max Seat #1 is the button
Seat 1: Dan Royal ($39.53 in chips) 
Seat 2: acamrash ($12.50 in chips) 
Seat 3: chiyuki ($49.50 in chips) 
Seat 4: wtu1986 ($31.74 in chips) 
Seat 5: Jene4kaBest ($11.91 in chips) 
Seat 6: fezman ($16.65 in chips) 
Seat 7: cr0lox ($17.88 in chips) 
Seat 8: bonethugs699 ($25 in chips) 
Seat 9: troms20 ($29.75 in chips) 
acamrash: posts small blind $0.10
chiyuki: posts big blind $0.25
*** HOLE CARDS ***
Dealt to chiyuki [7d As]
wtu1986: folds 
Jene4kaBest: folds 
fezman: raises $0.25 to $0.50
cr0lox: raises $0.75 to $1.25
bonethugs699: folds 
troms20: folds 
Dan Royal: folds 
acamrash: folds 
chiyuki: folds 
fezman: folds 
Uncalled bet ($0.75) returned to cr0lox
cr0lox collected $1.35 from pot
cr0lox: doesn't show hand 
*** SUMMARY ***
Total pot $1.35 | Rake $0 
Seat 1: Dan Royal (button) folded before Flop (didn't bet)
Seat 2: acamrash (small blind) folded before Flop
Seat 3: chiyuki (big blind) folded before Flop
Seat 4: wtu1986 folded before Flop (didn't bet)
Seat 5: Jene4kaBest folded before Flop (didn't bet)
Seat 6: fezman folded before Flop
Seat 7: cr0lox collected ($1.35)
Seat 8: bonethugs699 folded before Flop (didn't bet)
Seat 9: troms20 folded before Flop (didn't bet)



PokerStars Zoom Hand #84299481111:  Hold'em No Limit ($0.10/$0.25) - 2012/08/05 14:22:16 JST [2012/08/05 1:22:16 ET]
Table 'Whirlpool' 9-max Seat #1 is the button
Seat 1: chiyuki ($49.50 in chips) 
Seat 2: Perstenev ($11.97 in chips) 
Seat 3: RomarioJa ($14.71 in chips) 
Seat 4: Vahe50 ($19.41 in chips) 
Seat 5: Lasutchik ($7.21 in chips) 
Seat 6: Suhoff76 ($27.49 in chips) 
Seat 7: Loholov ($15.25 in chips) 
Seat 8: kamikkaze ($19.73 in chips) 
Seat 9: phate-1up ($37.76 in chips) 
Perstenev: posts small blind $0.10
RomarioJa: posts big blind $0.25
*** HOLE CARDS ***
Dealt to chiyuki [Qs 8s]
Vahe50: raises $0.50 to $0.75
Lasutchik: folds 
Suhoff76: folds 
Loholov: folds 
kamikkaze: folds 
phate-1up: folds 
chiyuki: folds 
Perstenev: calls $0.65
RomarioJa: raises $1.65 to $2.40
Vahe50: calls $1.65
Perstenev: calls $1.65
*** FLOP *** [Tc 8h Kh]
Perstenev: checks 
RomarioJa: bets $3.40
Vahe50: raises $4.10 to $7.50
Perstenev: folds 
RomarioJa: raises $4.81 to $12.31 and is all-in
Vahe50: calls $4.81
*** TURN *** [Tc 8h Kh] [Jh]
*** RIVER *** [Tc 8h Kh Jh] [5c]
*** SHOW DOWN ***
RomarioJa: shows [Ah Ad] (a pair of Aces)
Vahe50: mucks hand 
RomarioJa collected $30.39 from pot
*** SUMMARY ***
Total pot $31.82 | Rake $1.43 
Board [Tc 8h Kh Jh 5c]
Seat 1: chiyuki (button) folded before Flop (didn't bet)
Seat 2: Perstenev (small blind) folded on the Flop
Seat 3: RomarioJa (big blind) showed [Ah Ad] and won ($30.39) with a pair of Aces
Seat 4: Vahe50 mucked [Kd As]
Seat 5: Lasutchik folded before Flop (didn't bet)
Seat 6: Suhoff76 folded before Flop (didn't bet)
Seat 7: Loholov folded before Flop (didn't bet)
Seat 8: kamikkaze folded before Flop (didn't bet)
Seat 9: phate-1up folded before Flop (didn't bet)



PokerStars Zoom Hand #84299494470:  Hold'em No Limit ($0.10/$0.25) - 2012/08/05 14:23:11 JST [2012/08/05 1:23:11 ET]
Table 'Whirlpool' 9-max Seat #1 is the button
Seat 1: wtu1986 ($31.84 in chips) 
Seat 2: carlosrbr ($64.39 in chips) 
Seat 3: dushvan ($28.32 in chips) 
Seat 4: Dejacob ($27.51 in chips) 
Seat 5: RikkStroken ($14.26 in chips) 
Seat 6: chiyuki ($49.25 in chips) 
Seat 7: Suhoff76 ($29.28 in chips) 
Seat 8: acamrash ($12.40 in chips) 
Seat 9: kamikkaze ($19.83 in chips) 
carlosrbr: posts small blind $0.10
dushvan: posts big blind $0.25
*** HOLE CARDS ***
Dealt to chiyuki [Qs 2h]
Dejacob: folds 
RikkStroken: folds 
chiyuki: folds 
Suhoff76: folds 
acamrash: folds 
kamikkaze: raises $0.76 to $1.01
wtu1986: folds 
carlosrbr: calls $0.91
dushvan: folds 
*** FLOP *** [9c 7c Qd]
carlosrbr: checks 
kamikkaze: checks 
*** TURN *** [9c 7c Qd] [8d]
carlosrbr: checks 
kamikkaze: checks 
*** RIVER *** [9c 7c Qd 8d] [Kh]
carlosrbr: bets $1.50
kamikkaze: folds 
Uncalled bet ($1.50) returned to carlosrbr
carlosrbr collected $2.17 from pot
carlosrbr: doesn't show hand 
*** SUMMARY ***
Total pot $2.27 | Rake $0.10 
Board [9c 7c Qd 8d Kh]
Seat 1: wtu1986 (button) folded before Flop (didn't bet)
Seat 2: carlosrbr (small blind) collected ($2.17)
Seat 3: dushvan (big blind) folded before Flop
Seat 4: Dejacob folded before Flop (didn't bet)
Seat 5: RikkStroken folded before Flop (didn't bet)
Seat 6: chiyuki folded before Flop (didn't bet)
Seat 7: Suhoff76 folded before Flop (didn't bet)
Seat 8: acamrash folded before Flop (didn't bet)
Seat 9: kamikkaze folded on the River



PokerStars Zoom Hand #84299495703:  Hold'em No Limit ($0.10/$0.25) - 2012/08/05 14:23:16 JST [2012/08/05 1:23:16 ET]
Table 'Whirlpool' 9-max Seat #1 is the button
Seat 1: Th3Fog ($49.75 in chips) 
Seat 2: chiyuki ($49.25 in chips) 
Seat 3: Lasutchik ($7.21 in chips) 
Seat 4: roksmokndonk ($29.04 in chips) 
Seat 5: Vahe50 ($23.25 in chips) 
Seat 6: seula i ($26.79 in chips) 
Seat 7: Perstenev ($13.53 in chips) 
Seat 8: PetitAlejo ($49.71 in chips) 
Seat 9: Dejacob ($31.36 in chips) 
chiyuki: posts small blind $0.10
Lasutchik: posts big blind $0.25
*** HOLE CARDS ***
Dealt to chiyuki [9s 2d]
roksmokndonk: folds 
Vahe50: folds 
seula i: raises $0.50 to $0.75
Perstenev: calls $0.75
PetitAlejo: folds 
Dejacob: folds 
Th3Fog: folds 
chiyuki: folds 
Lasutchik: folds 
*** FLOP *** [9d 3d 6h]
seula i: bets $1.25
Perstenev: calls $1.25
*** TURN *** [9d 3d 6h] [As]
seula i: bets $2.50
Perstenev: calls $2.50
*** RIVER *** [9d 3d 6h As] [7c]
seula i: checks 
Perstenev: bets $3.25
seula i: calls $3.25
*** SHOW DOWN ***
Perstenev: shows [3c 3h] (three of a kind, Threes)
seula i: mucks hand 
Perstenev collected $15.14 from pot
*** SUMMARY ***
Total pot $15.85 | Rake $0.71 
Board [9d 3d 6h As 7c]
Seat 1: Th3Fog (button) folded before Flop (didn't bet)
Seat 2: chiyuki (small blind) folded before Flop
Seat 3: Lasutchik (big blind) folded before Flop
Seat 4: roksmokndonk folded before Flop (didn't bet)
Seat 5: Vahe50 folded before Flop (didn't bet)
Seat 6: seula i mucked [8h 8c]
Seat 7: Perstenev showed [3c 3h] and won ($15.14) with three of a kind, Threes
Seat 8: PetitAlejo folded before Flop (didn't bet)
Seat 9: Dejacob folded before Flop (didn't bet)



PokerStars Zoom Hand #84299497667:  Hold'em No Limit ($0.10/$0.25) - 2012/08/05 14:23:24 JST [2012/08/05 1:23:24 ET]
Table 'Whirlpool' 9-max Seat #1 is the button
Seat 1: RikkStroken ($14.26 in chips) 
Seat 2: leo2095 ($13.64 in chips) 
Seat 3: troms20 ($44.84 in chips) 
Seat 4: simonzez ($51.79 in chips) 
Seat 5: hirozo ($32.87 in chips) 
Seat 6: Dejacob ($31.36 in chips) 
Seat 7: PetitAlejo ($49.71 in chips) 
Seat 8: ygoegoe ($27.06 in chips) 
Seat 9: chiyuki ($49.15 in chips) 
leo2095: posts small blind $0.10
troms20: posts big blind $0.25
*** HOLE CARDS ***
Dealt to chiyuki [6c 5h]
simonzez: calls $0.25
hirozo: folds 
Dejacob: folds 
PetitAlejo: folds 
ygoegoe: raises $0.75 to $1
chiyuki: folds 
RikkStroken: folds 
leo2095: calls $0.90
troms20: folds 
simonzez: calls $0.75
*** FLOP *** [7c Tc Kh]
leo2095: checks 
simonzez: checks 
ygoegoe: checks 
*** TURN *** [7c Tc Kh] [9s]
leo2095: bets $0.75
simonzez: calls $0.75
ygoegoe: calls $0.75
*** RIVER *** [7c Tc Kh 9s] [5s]
leo2095: bets $2
simonzez: folds 
ygoegoe: folds 
Uncalled bet ($2) returned to leo2095
leo2095 collected $5.25 from pot
leo2095: doesn't show hand 
*** SUMMARY ***
Total pot $5.50 | Rake $0.25 
Board [7c Tc Kh 9s 5s]
Seat 1: RikkStroken (button) folded before Flop (didn't bet)
Seat 2: leo2095 (small blind) collected ($5.25)
Seat 3: troms20 (big blind) folded before Flop
Seat 4: simonzez folded on the River
Seat 5: hirozo folded before Flop (didn't bet)
Seat 6: Dejacob folded before Flop (didn't bet)
Seat 7: PetitAlejo folded before Flop (didn't bet)
Seat 8: ygoegoe folded on the River
Seat 9: chiyuki folded before Flop (didn't bet)



PokerStars Zoom Hand #84299501697:  Hold'em No Limit ($0.10/$0.25) - 2012/08/05 14:23:40 JST [2012/08/05 1:23:40 ET]
Table 'Whirlpool' 9-max Seat #1 is the button
Seat 1: roksmokndonk ($28.94 in chips) 
Seat 2: dushvan ($28.07 in chips) 
Seat 3: Lasutchik ($68.70 in chips) 
Seat 4: chiyuki ($49.15 in chips) 
Seat 5: phate-1up ($30.15 in chips) 
Seat 6: Loholov ($15 in chips) 
Seat 7: RikkStroken ($14.26 in chips) 
Seat 8: Suhoff76 ($25 in chips) 
Seat 9: caro196661cv ($31.01 in chips) 
dushvan: posts small blind $0.10
Lasutchik: posts big blind $0.25
*** HOLE CARDS ***
Dealt to chiyuki [Ts 8c]
chiyuki: folds 
phate-1up: folds 
Loholov: folds 
RikkStroken: raises $0.25 to $0.50
Suhoff76: folds 
caro196661cv: folds 
roksmokndonk: folds 
dushvan: folds 
Lasutchik: calls $0.25
*** FLOP *** [7c 4d 7h]
Lasutchik: checks 
RikkStroken: bets $0.50
Lasutchik: calls $0.50
*** TURN *** [7c 4d 7h] [3s]
Lasutchik: checks 
RikkStroken: bets $1.25
Lasutchik: raises $2.30 to $3.55
RikkStroken: folds 
Uncalled bet ($2.30) returned to Lasutchik
Lasutchik collected $4.39 from pot
Lasutchik: doesn't show hand 
*** SUMMARY ***
Total pot $4.60 | Rake $0.21 
Board [7c 4d 7h 3s]
Seat 1: roksmokndonk (button) folded before Flop (didn't bet)
Seat 2: dushvan (small blind) folded before Flop
Seat 3: Lasutchik (big blind) collected ($4.39)
Seat 4: chiyuki folded before Flop (didn't bet)
Seat 5: phate-1up folded before Flop (didn't bet)
Seat 6: Loholov folded before Flop (didn't bet)
Seat 7: RikkStroken folded on the Turn
Seat 8: Suhoff76 folded before Flop (didn't bet)
Seat 9: caro196661cv folded before Flop (didn't bet)



PokerStars Zoom Hand #84299502659:  Hold'em No Limit ($0.10/$0.25) - 2012/08/05 14:23:44 JST [2012/08/05 1:23:44 ET]
Table 'Whirlpool' 9-max Seat #1 is the button
Seat 1: 1Karina1 ($25 in chips) 
Seat 2: mariuka1 ($7.30 in chips) 
Seat 3: hirozo ($27.37 in chips) 
Seat 4: chiyuki ($49.15 in chips) 
Seat 5: el pore 5 ($15.07 in chips) 
Seat 6: Th3Fog ($72.33 in chips) 
Seat 7: Suhoff76 ($25 in chips) 
Seat 8: troms20 ($44.59 in chips) 
Seat 9: seula i ($25.01 in chips) 
mariuka1: posts small blind $0.10
hirozo: posts big blind $0.25
*** HOLE CARDS ***
Dealt to chiyuki [Kc Kd]
chiyuki: raises $0.50 to $0.75
el pore 5: folds 
Th3Fog: folds 
Suhoff76: folds 
troms20: calls $0.75
seula i: folds 
1Karina1: folds 
mariuka1: calls $0.65
hirozo: folds 
*** FLOP *** [4s 7s Ad]
mariuka1: checks 
chiyuki: bets $1.25
troms20: calls $1.25
mariuka1: calls $1.25
*** TURN *** [4s 7s Ad] [Js]
mariuka1: checks 
chiyuki: checks 
troms20: checks 
*** RIVER *** [4s 7s Ad Js] [9h]
mariuka1: checks 
chiyuki: checks 
troms20: bets $4
mariuka1: calls $4
chiyuki: folds 
*** SHOW DOWN ***
troms20: shows [Qc Ac] (a pair of Aces)
mariuka1: mucks hand 
troms20 collected $13.61 from pot
*** SUMMARY ***
Total pot $14.25 | Rake $0.64 
Board [4s 7s Ad Js 9h]
Seat 1: 1Karina1 (button) folded before Flop (didn't bet)
Seat 2: mariuka1 (small blind) mucked [Ah 6d]
Seat 3: hirozo (big blind) folded before Flop
Seat 4: chiyuki folded on the River
Seat 5: el pore 5 folded before Flop (didn't bet)
Seat 6: Th3Fog folded before Flop (didn't bet)
Seat 7: Suhoff76 folded before Flop (didn't bet)
Seat 8: troms20 showed [Qc Ac] and won ($13.61) with a pair of Aces
Seat 9: seula i folded before Flop (didn't bet)



PokerStars Zoom Hand #84299521038:  Hold'em No Limit ($0.10/$0.25) - 2012/08/05 14:24:59 JST [2012/08/05 1:24:59 ET]
Table 'Whirlpool' 9-max Seat #1 is the button
Seat 1: chiyuki ($47.15 in chips) 
Seat 2: Nerkit ($11.97 in chips) 
Seat 3: Perstenev ($12.56 in chips) 
Seat 4: Dejacob ($47.88 in chips) 
Seat 5: KeLevro0 ($12.55 in chips) 
Seat 6: kamikkaze ($15.84 in chips) 
Seat 7: Loholov ($17.04 in chips) 
Seat 8: PetitAlejo ($50.46 in chips) 
Seat 9: wtu1986 ($31.39 in chips) 
Nerkit: posts small blind $0.10
Perstenev: posts big blind $0.25
*** HOLE CARDS ***
Dealt to chiyuki [8s 3d]
Dejacob: folds 
KeLevro0: folds 
kamikkaze: folds 
Loholov: folds 
PetitAlejo: folds 
wtu1986: folds 
chiyuki: folds 
Nerkit: folds 
Uncalled bet ($0.15) returned to Perstenev
Perstenev collected $0.20 from pot
Perstenev: doesn't show hand 
*** SUMMARY ***
Total pot $0.20 | Rake $0 
Seat 1: chiyuki (button) folded before Flop (didn't bet)
Seat 2: Nerkit (small blind) folded before Flop
Seat 3: Perstenev (big blind) collected ($0.20)
Seat 4: Dejacob folded before Flop (didn't bet)
Seat 5: KeLevro0 folded before Flop (didn't bet)
Seat 6: kamikkaze folded before Flop (didn't bet)
Seat 7: Loholov folded before Flop (didn't bet)
Seat 8: PetitAlejo folded before Flop (didn't bet)
Seat 9: wtu1986 folded before Flop (didn't bet)



PokerStars Zoom Hand #84299525361:  Hold'em No Limit ($0.10/$0.25) - 2012/08/05 14:25:16 JST [2012/08/05 1:25:16 ET]
Table 'Whirlpool' 9-max Seat #1 is the button
Seat 1: dushvan ($27.97 in chips) 
Seat 2: wtu1986 ($25.22 in chips) 
Seat 3: chiyuki ($47.15 in chips) 
Seat 4: RikkStroken ($12.26 in chips) 
Seat 5: RomarioJa ($13.45 in chips) 
Seat 6: KeLevro0 ($12.55 in chips) 
Seat 7: Suhoff76 ($25 in chips) 
Seat 8: hirozo ($31.53 in chips) 
Seat 9: AlfredE525 ($14.76 in chips) 
wtu1986: posts small blind $0.10
chiyuki: posts big blind $0.25
*** HOLE CARDS ***
Dealt to chiyuki [Qd 6s]
RikkStroken: folds 
RomarioJa: folds 
KeLevro0: folds 
Suhoff76: folds 
hirozo: folds 
AlfredE525: folds 
dushvan: raises $0.50 to $0.75
wtu1986: folds 
chiyuki: folds 
Uncalled bet ($0.50) returned to dushvan
dushvan collected $0.60 from pot
dushvan: doesn't show hand 
*** SUMMARY ***
Total pot $0.60 | Rake $0 
Seat 1: dushvan (button) collected ($0.60)
Seat 2: wtu1986 (small blind) folded before Flop
Seat 3: chiyuki (big blind) folded before Flop
Seat 4: RikkStroken folded before Flop (didn't bet)
Seat 5: RomarioJa folded before Flop (didn't bet)
Seat 6: KeLevro0 folded before Flop (didn't bet)
Seat 7: Suhoff76 folded before Flop (didn't bet)
Seat 8: hirozo folded before Flop (didn't bet)
Seat 9: AlfredE525 folded before Flop (didn't bet)



PokerStars Zoom Hand #84299523080:  Hold'em No Limit ($0.10/$0.25) - 2012/08/05 14:25:07 JST [2012/08/05 1:25:07 ET]
Table 'Whirlpool' 9-max Seat #1 is the button
Seat 1: troms20 ($20.93 in chips) 
Seat 2: Loholov ($20.18 in chips) 
Seat 3: Perstenev ($20.57 in chips) 
Seat 4: kamikkaze ($13.42 in chips) 
Seat 5: chiyuki ($47.15 in chips) 
Seat 6: Déculotter69 ($21.55 in chips) 
Seat 7: cr0lox ($17.88 in chips) 
Seat 8: slapshot2011 ($36.58 in chips) 
Seat 9: wtu1986 ($25 in chips) 
Loholov: posts small blind $0.10
Perstenev: posts big blind $0.25
*** HOLE CARDS ***
Dealt to chiyuki [Js 2c]
kamikkaze: raises $0.25 to $0.50
chiyuki: folds 
Déculotter69: folds 
cr0lox: calls $0.50
slapshot2011: folds 
wtu1986: folds 
troms20: folds 
Loholov: folds 
Perstenev: folds 
*** FLOP *** [Qd Ac 9h]
kamikkaze: checks 
cr0lox: bets $0.96
kamikkaze: calls $0.96
*** TURN *** [Qd Ac 9h] [4h]
kamikkaze: checks 
cr0lox: bets $2.34
kamikkaze: calls $2.34
*** RIVER *** [Qd Ac 9h 4h] [7d]
kamikkaze: checks 
cr0lox: bets $5.69
kamikkaze: calls $5.69
*** SHOW DOWN ***
cr0lox: shows [7s As] (two pair, Aces and Sevens)
kamikkaze: mucks hand 
cr0lox collected $18.46 from pot
*** SUMMARY ***
Total pot $19.33 | Rake $0.87 
Board [Qd Ac 9h 4h 7d]
Seat 1: troms20 (button) folded before Flop (didn't bet)
Seat 2: Loholov (small blind) folded before Flop
Seat 3: Perstenev (big blind) folded before Flop
Seat 4: kamikkaze mucked [Ad Tc]
Seat 5: chiyuki folded before Flop (didn't bet)
Seat 6: Déculotter69 folded before Flop (didn't bet)
Seat 7: cr0lox showed [7s As] and won ($18.46) with two pair, Aces and Sevens
Seat 8: slapshot2011 folded before Flop (didn't bet)
Seat 9: wtu1986 folded before Flop (didn't bet)



PokerStars Zoom Hand #84299520047:  Hold'em No Limit ($0.10/$0.25) - 2012/08/05 14:24:55 JST [2012/08/05 1:24:55 ET]
Table 'Whirlpool' 9-max Seat #1 is the button
Seat 1: troms20 ($29.50 in chips) 
Seat 2: RomarioJa ($14.05 in chips) 
Seat 3: 1Karina1 ($25.25 in chips) 
Seat 4: hirozo ($27.02 in chips) 
Seat 5: leo2095 ($32.98 in chips) 
Seat 6: kamikkaze ($13.52 in chips) 
Seat 7: Perstenev ($12.56 in chips) 
Seat 8: chiyuki ($47.15 in chips) 
Seat 9: Ellen1947 ($27.81 in chips) 
RomarioJa: posts small blind $0.10
1Karina1: posts big blind $0.25
*** HOLE CARDS ***
Dealt to chiyuki [3s 7s]
hirozo: folds 
leo2095: folds 
kamikkaze: folds 
Perstenev: folds 
chiyuki: folds 
Ellen1947: raises $0.50 to $0.75
troms20: folds 
RomarioJa: raises $1.45 to $2.20
1Karina1: folds 
Ellen1947: calls $1.45
*** FLOP *** [2s 5c 6h]
RomarioJa: checks 
Ellen1947: bets $4.44
RomarioJa: raises $7.41 to $11.85 and is all-in
Ellen1947: calls $7.41
*** TURN *** [2s 5c 6h] [Jc]
*** RIVER *** [2s 5c 6h Jc] [8c]
*** SHOW DOWN ***
RomarioJa: shows [Kd Ks] (a pair of Kings)
Ellen1947: mucks hand 
RomarioJa collected $27.07 from pot
*** SUMMARY ***
Total pot $28.35 | Rake $1.28 
Board [2s 5c 6h Jc 8c]
Seat 1: troms20 (button) folded before Flop (didn't bet)
Seat 2: RomarioJa (small blind) showed [Kd Ks] and won ($27.07) with a pair of Kings
Seat 3: 1Karina1 (big blind) folded before Flop
Seat 4: hirozo folded before Flop (didn't bet)
Seat 5: leo2095 folded before Flop (didn't bet)
Seat 6: kamikkaze folded before Flop (didn't bet)
Seat 7: Perstenev folded before Flop (didn't bet)
Seat 8: chiyuki folded before Flop (didn't bet)
Seat 9: Ellen1947 mucked [9d 8d]



PokerStars Zoom Hand #84299531031:  Hold'em No Limit ($0.10/$0.25) - 2012/08/05 14:25:40 JST [2012/08/05 1:25:40 ET]
Table 'Whirlpool' 9-max Seat #1 is the button
Seat 1: slapshot2011 ($36.48 in chips) 
Seat 2: chiyuki ($46.90 in chips) 
Seat 3: roksmokndonk ($28.42 in chips) 
Seat 4: DanielWhyte ($40.91 in chips) 
Seat 5: wtu1986 ($25.12 in chips) 
Seat 6: mariuka1 ($2.82 in chips) 
Seat 7: phate-1up ($28.75 in chips) 
Seat 8: RikkStroken ($26.96 in chips) 
Seat 9: Loholov ($20.08 in chips) 
chiyuki: posts small blind $0.10
roksmokndonk: posts big blind $0.25
*** HOLE CARDS ***
Dealt to chiyuki [7c Jc]
DanielWhyte: folds 
wtu1986: folds 
mariuka1: folds 
phate-1up: folds 
RikkStroken: folds 
Loholov: folds 
slapshot2011: folds 
chiyuki: folds 
Uncalled bet ($0.15) returned to roksmokndonk
roksmokndonk collected $0.20 from pot
roksmokndonk: doesn't show hand 
*** SUMMARY ***
Total pot $0.20 | Rake $0 
Seat 1: slapshot2011 (button) folded before Flop (didn't bet)
Seat 2: chiyuki (small blind) folded before Flop
Seat 3: roksmokndonk (big blind) collected ($0.20)
Seat 4: DanielWhyte folded before Flop (didn't bet)
Seat 5: wtu1986 folded before Flop (didn't bet)
Seat 6: mariuka1 folded before Flop (didn't bet)
Seat 7: phate-1up folded before Flop (didn't bet)
Seat 8: RikkStroken folded before Flop (didn't bet)
Seat 9: Loholov folded before Flop (didn't bet)



PokerStars Zoom Hand #84299536254:  Hold'em No Limit ($0.10/$0.25) - 2012/08/05 14:26:01 JST [2012/08/05 1:26:01 ET]
Table 'Whirlpool' 9-max Seat #1 is the button
Seat 1: RomarioJa ($27.07 in chips) 
Seat 2: phate-1up ($25 in chips) 
Seat 3: wtu1986 ($25.25 in chips) 
Seat 4: Nerkit ($11.62 in chips) 
Seat 5: ladymadon107 ($5.99 in chips) 
Seat 6: Vahe50 ($14.10 in chips) 
Seat 7: troms20 ($52.66 in chips) 
Seat 8: KeLevro0 ($12.20 in chips) 
Seat 9: chiyuki ($46.80 in chips) 
phate-1up: posts small blind $0.10
wtu1986: posts big blind $0.25
*** HOLE CARDS ***
Dealt to chiyuki [8d Th]
Nerkit: folds 
ladymadon107: folds 
Vahe50: folds 
troms20: folds 
KeLevro0: folds 
chiyuki: folds 
RomarioJa: folds 
phate-1up: folds 
Uncalled bet ($0.15) returned to wtu1986
wtu1986 collected $0.20 from pot
wtu1986: doesn't show hand 
*** SUMMARY ***
Total pot $0.20 | Rake $0 
Seat 1: RomarioJa (button) folded before Flop (didn't bet)
Seat 2: phate-1up (small blind) folded before Flop
Seat 3: wtu1986 (big blind) collected ($0.20)
Seat 4: Nerkit folded before Flop (didn't bet)
Seat 5: ladymadon107 folded before Flop (didn't bet)
Seat 6: Vahe50 folded before Flop (didn't bet)
Seat 7: troms20 folded before Flop (didn't bet)
Seat 8: KeLevro0 folded before Flop (didn't bet)
Seat 9: chiyuki folded before Flop (didn't bet)



PokerStars Zoom Hand #84299540836:  Hold'em No Limit ($0.10/$0.25) - 2012/08/05 14:26:20 JST [2012/08/05 1:26:20 ET]
Table 'Whirlpool' 9-max Seat #1 is the button
Seat 1: ChrisCDee ($37.26 in chips) 
Seat 2: RikkStroken ($12.01 in chips) 
Seat 3: Alvinpe85 ($61.02 in chips) 
Seat 4: RomarioJa ($12.70 in chips) 
Seat 5: acamrash ($9.29 in chips) 
Seat 6: eskeyp ($15.34 in chips) 
Seat 7: chiyuki ($46.80 in chips) 
Seat 8: Vahe50 ($25.25 in chips) 
Seat 9: troms20 ($20.68 in chips) 
RikkStroken: posts small blind $0.10
Alvinpe85: posts big blind $0.25
*** HOLE CARDS ***
Dealt to chiyuki [3d Kd]
RomarioJa: folds 
acamrash: folds 
eskeyp: folds 
chiyuki: folds 
Vahe50: folds 
troms20: folds 
ChrisCDee: raises $0.50 to $0.75
RikkStroken: folds 
Alvinpe85: folds 
Uncalled bet ($0.50) returned to ChrisCDee
ChrisCDee collected $0.60 from pot
ChrisCDee: doesn't show hand 
*** SUMMARY ***
Total pot $0.60 | Rake $0 
Seat 1: ChrisCDee (button) collected ($0.60)
Seat 2: RikkStroken (small blind) folded before Flop
Seat 3: Alvinpe85 (big blind) folded before Flop
Seat 4: RomarioJa folded before Flop (didn't bet)
Seat 5: acamrash folded before Flop (didn't bet)
Seat 6: eskeyp folded before Flop (didn't bet)
Seat 7: chiyuki folded before Flop (didn't bet)
Seat 8: Vahe50 folded before Flop (didn't bet)
Seat 9: troms20 folded before Flop (didn't bet)



PokerStars Zoom Hand #84299545517:  Hold'em No Limit ($0.10/$0.25) - 2012/08/05 14:26:39 JST [2012/08/05 1:26:39 ET]
Table 'Whirlpool' 9-max Seat #1 is the button
Seat 1: D@vidMed ($78.03 in chips) 
Seat 2: RomarioJa ($11.46 in chips) 
Seat 3: Vahe50 ($25.25 in chips) 
Seat 4: seula i ($36.31 in chips) 
Seat 5: DanielWhyte ($39.91 in chips) 
Seat 6: hirozo ($38.42 in chips) 
Seat 7: 4ydo yogurt ($16.38 in chips) 
Seat 8: chiyuki ($46.80 in chips) 
Seat 9: KeLevro0 ($12.59 in chips) 
RomarioJa: posts small blind $0.10
Vahe50: posts big blind $0.25
*** HOLE CARDS ***
Dealt to chiyuki [6d 2h]
seula i: folds 
DanielWhyte: folds 
hirozo: folds 
4ydo yogurt: folds 
chiyuki: folds 
KeLevro0: folds 
D@vidMed: folds 
RomarioJa: folds 
Uncalled bet ($0.15) returned to Vahe50
Vahe50 collected $0.20 from pot
Vahe50: doesn't show hand 
*** SUMMARY ***
Total pot $0.20 | Rake $0 
Seat 1: D@vidMed (button) folded before Flop (didn't bet)
Seat 2: RomarioJa (small blind) folded before Flop
Seat 3: Vahe50 (big blind) collected ($0.20)
Seat 4: seula i folded before Flop (didn't bet)
Seat 5: DanielWhyte folded before Flop (didn't bet)
Seat 6: hirozo folded before Flop (didn't bet)
Seat 7: 4ydo yogurt folded before Flop (didn't bet)
Seat 8: chiyuki folded before Flop (didn't bet)
Seat 9: KeLevro0 folded before Flop (didn't bet)



PokerStars Zoom Hand #84299542053:  Hold'em No Limit ($0.10/$0.25) - 2012/08/05 14:26:25 JST [2012/08/05 1:26:25 ET]
Table 'Whirlpool' 9-max Seat #1 is the button
Seat 1: acamrash ($9.29 in chips) 
Seat 2: seula i ($31.48 in chips) 
Seat 3: troms20 ($52.66 in chips) 
Seat 4: PetitAlejo ($33.16 in chips) 
Seat 5: chiyuki ($46.80 in chips) 
Seat 6: RomarioJa ($11.46 in chips) 
Seat 7: ygoegoe ($27.34 in chips) 
Seat 8: KeLevro0 ($12.69 in chips) 
Seat 9: Lasutchik ($6.86 in chips) 
seula i: posts small blind $0.10
troms20: posts big blind $0.25
*** HOLE CARDS ***
Dealt to chiyuki [4c 8h]
PetitAlejo: folds 
chiyuki: folds 
RomarioJa: folds 
ygoegoe: folds 
KeLevro0: folds 
Lasutchik: folds 
acamrash: folds 
seula i: folds 
Uncalled bet ($0.15) returned to troms20
troms20 collected $0.20 from pot
troms20: doesn't show hand 
*** SUMMARY ***
Total pot $0.20 | Rake $0 
Seat 1: acamrash (button) folded before Flop (didn't bet)
Seat 2: seula i (small blind) folded before Flop
Seat 3: troms20 (big blind) collected ($0.20)
Seat 4: PetitAlejo folded before Flop (didn't bet)
Seat 5: chiyuki folded before Flop (didn't bet)
Seat 6: RomarioJa folded before Flop (didn't bet)
Seat 7: ygoegoe folded before Flop (didn't bet)
Seat 8: KeLevro0 folded before Flop (didn't bet)
Seat 9: Lasutchik folded before Flop (didn't bet)



PokerStars Zoom Hand #84299546748:  Hold'em No Limit ($0.10/$0.25) - 2012/08/05 14:26:45 JST [2012/08/05 1:26:45 ET]
Table 'Whirlpool' 9-max Seat #1 is the button
Seat 1: 4ydo yogurt ($16.38 in chips) 
Seat 2: caro196661cv ($28.32 in chips) 
Seat 3: AlfredE525 ($13.38 in chips) 
Seat 4: chiyuki ($46.80 in chips) 
Seat 5: KeLevro0 ($12.59 in chips) 
Seat 6: troms20 ($49.50 in chips) 
Seat 7: Dejacob ($47.53 in chips) 
Seat 8: deadmoneykid ($22.49 in chips) 
Seat 9: DanielWhyte ($39.91 in chips) 
caro196661cv: posts small blind $0.10
AlfredE525: posts big blind $0.25
*** HOLE CARDS ***
Dealt to chiyuki [6d Kc]
chiyuki: folds 
KeLevro0: folds 
troms20: folds 
Dejacob: raises $0.50 to $0.75
deadmoneykid: folds 
DanielWhyte: folds 
4ydo yogurt: calls $0.75
caro196661cv: folds 
AlfredE525: folds 
*** FLOP *** [Qs Th 7d]
Dejacob: bets $1.25
4ydo yogurt: folds 
Uncalled bet ($1.25) returned to Dejacob
Dejacob collected $1.77 from pot
Dejacob: doesn't show hand 
*** SUMMARY ***
Total pot $1.85 | Rake $0.08 
Board [Qs Th 7d]
Seat 1: 4ydo yogurt (button) folded on the Flop
Seat 2: caro196661cv (small blind) folded before Flop
Seat 3: AlfredE525 (big blind) folded before Flop
Seat 4: chiyuki folded before Flop (didn't bet)
Seat 5: KeLevro0 folded before Flop (didn't bet)
Seat 6: troms20 folded before Flop (didn't bet)
Seat 7: Dejacob collected ($1.77)
Seat 8: deadmoneykid folded before Flop (didn't bet)
Seat 9: DanielWhyte folded before Flop (didn't bet)



PokerStars Zoom Hand #84299547970:  Hold'em No Limit ($0.10/$0.25) - 2012/08/05 14:26:50 JST [2012/08/05 1:26:50 ET]
Table 'Whirlpool' 9-max Seat #1 is the button
Seat 1: caro196661cv ($28.22 in chips) 
Seat 2: DanielWhyte ($39.91 in chips) 
Seat 3: znake77 ($17 in chips) 
Seat 4: Lasutchik ($6.86 in chips) 
Seat 5: troms20 ($49.50 in chips) 
Seat 6: ygoegoe ($27.34 in chips) 
Seat 7: chiyuki ($46.80 in chips) 
Seat 8: hirozo ($36.56 in chips) 
Seat 9: kamikkaze ($17.73 in chips) 
DanielWhyte: posts small blind $0.10
znake77: posts big blind $0.25
*** HOLE CARDS ***
Dealt to chiyuki [Ah Jh]
Lasutchik: folds 
troms20: folds 
ygoegoe: folds 
chiyuki: raises $0.50 to $0.75
hirozo: folds 
kamikkaze: raises $16.98 to $17.73 and is all-in
caro196661cv: folds 
DanielWhyte: folds 
znake77: folds 
chiyuki: folds 
Uncalled bet ($16.98) returned to kamikkaze
kamikkaze collected $1.85 from pot
kamikkaze: doesn't show hand 
*** SUMMARY ***
Total pot $1.85 | Rake $0 
Seat 1: caro196661cv (button) folded before Flop (didn't bet)
Seat 2: DanielWhyte (small blind) folded before Flop
Seat 3: znake77 (big blind) folded before Flop
Seat 4: Lasutchik folded before Flop (didn't bet)
Seat 5: troms20 folded before Flop (didn't bet)
Seat 6: ygoegoe folded before Flop (didn't bet)
Seat 7: chiyuki folded before Flop
Seat 8: hirozo folded before Flop (didn't bet)
Seat 9: kamikkaze collected ($1.85)



PokerStars Zoom Hand #84299553643:  Hold'em No Limit ($0.10/$0.25) - 2012/08/05 14:27:13 JST [2012/08/05 1:27:13 ET]
Table 'Whirlpool' 9-max Seat #1 is the button
Seat 1: Nerkit ($14.83 in chips) 
Seat 2: kamikkaze ($18.83 in chips) 
Seat 3: chiyuki ($45.95 in chips) 
Seat 4: Perstenev ($12.03 in chips) 
Seat 5: Dejacob ($48.55 in chips) 
Seat 6: Alvinpe85 ($39.76 in chips) 
Seat 7: el pore 5 ($16.77 in chips) 
Seat 8: WARIBANA7777 ($11.29 in chips) 
Seat 9: RomarioJa ($11.36 in chips) 
kamikkaze: posts small blind $0.10
chiyuki: posts big blind $0.25
*** HOLE CARDS ***
Dealt to chiyuki [6d Td]
Perstenev: folds 
Dejacob: folds 
Alvinpe85: folds 
el pore 5: folds 
WARIBANA7777: folds 
RomarioJa: folds 
Nerkit: folds 
kamikkaze: folds 
Uncalled bet ($0.15) returned to chiyuki
chiyuki collected $0.20 from pot
chiyuki: doesn't show hand 
*** SUMMARY ***
Total pot $0.20 | Rake $0 
Seat 1: Nerkit (button) folded before Flop (didn't bet)
Seat 2: kamikkaze (small blind) folded before Flop
Seat 3: chiyuki (big blind) collected ($0.20)
Seat 4: Perstenev folded before Flop (didn't bet)
Seat 5: Dejacob folded before Flop (didn't bet)
Seat 6: Alvinpe85 folded before Flop (didn't bet)
Seat 7: el pore 5 folded before Flop (didn't bet)
Seat 8: WARIBANA7777 folded before Flop (didn't bet)
Seat 9: RomarioJa folded before Flop (didn't bet)



PokerStars Zoom Hand #84299552620:  Hold'em No Limit ($0.10/$0.25) - 2012/08/05 14:27:09 JST [2012/08/05 1:27:09 ET]
Table 'Whirlpool' 9-max Seat #1 is the button
Seat 1: roksmokndonk ($27.67 in chips) 
Seat 2: chiyuki ($46.05 in chips) 
Seat 3: ll_LaMeR_ll ($54.65 in chips) 
Seat 4: 4thepeople ($29.10 in chips) 
Seat 5: wtu1986 ($24.77 in chips) 
Seat 6: Suhoff76 ($26.82 in chips) 
Seat 7: caro196661cv ($28.22 in chips) 
Seat 8: Nerkit ($9.60 in chips) 
Seat 9: WARIBANA7777 ($11.29 in chips) 
chiyuki: posts small blind $0.10
ll_LaMeR_ll: posts big blind $0.25
*** HOLE CARDS ***
Dealt to chiyuki [5d 4c]
4thepeople: folds 
wtu1986: folds 
Suhoff76: raises $0.32 to $0.57
caro196661cv: raises $0.68 to $1.25
Nerkit: folds 
WARIBANA7777: folds 
roksmokndonk: folds 
chiyuki: folds 
ll_LaMeR_ll: folds 
Suhoff76: folds 
Uncalled bet ($0.68) returned to caro196661cv
caro196661cv collected $1.49 from pot
caro196661cv: doesn't show hand 
*** SUMMARY ***
Total pot $1.49 | Rake $0 
Seat 1: roksmokndonk (button) folded before Flop (didn't bet)
Seat 2: chiyuki (small blind) folded before Flop
Seat 3: ll_LaMeR_ll (big blind) folded before Flop
Seat 4: 4thepeople folded before Flop (didn't bet)
Seat 5: wtu1986 folded before Flop (didn't bet)
Seat 6: Suhoff76 folded before Flop
Seat 7: caro196661cv collected ($1.49)
Seat 8: Nerkit folded before Flop (didn't bet)
Seat 9: WARIBANA7777 folded before Flop (didn't bet)



PokerStars Zoom Hand #84299557359:  Hold'em No Limit ($0.10/$0.25) - 2012/08/05 14:27:28 JST [2012/08/05 1:27:28 ET]
Table 'Whirlpool' 9-max Seat #1 is the button
Seat 1: chiyuki ($46.05 in chips) 
Seat 2: KCDOGG10 ($20 in chips) 
Seat 3: Wilcox76607 ($14.21 in chips) 
Seat 4: 4plankton ($17.38 in chips) 
Seat 5: Suhoff76 ($26.25 in chips) 
Seat 6: Nerkit ($14.83 in chips) 
Seat 7: wtu1986 ($24.77 in chips) 
Seat 8: KeLevro0 ($11.85 in chips) 
Seat 9: Perstenev ($11.70 in chips) 
KCDOGG10: posts small blind $0.10
Wilcox76607: posts big blind $0.25
*** HOLE CARDS ***
Dealt to chiyuki [6d Js]
4plankton: folds 
Suhoff76: folds 
Nerkit: folds 
wtu1986: folds 
KeLevro0: folds 
Perstenev: folds 
chiyuki: folds 
KCDOGG10: raises $0.25 to $0.50
Wilcox76607: folds 
Uncalled bet ($0.25) returned to KCDOGG10
KCDOGG10 collected $0.50 from pot
KCDOGG10: doesn't show hand 
*** SUMMARY ***
Total pot $0.50 | Rake $0 
Seat 1: chiyuki (button) folded before Flop (didn't bet)
Seat 2: KCDOGG10 (small blind) collected ($0.50)
Seat 3: Wilcox76607 (big blind) folded before Flop
Seat 4: 4plankton folded before Flop (didn't bet)
Seat 5: Suhoff76 folded before Flop (didn't bet)
Seat 6: Nerkit folded before Flop (didn't bet)
Seat 7: wtu1986 folded before Flop (didn't bet)
Seat 8: KeLevro0 folded before Flop (didn't bet)
Seat 9: Perstenev folded before Flop (didn't bet)



PokerStars Zoom Hand #84299544772:  Hold'em No Limit ($0.10/$0.25) - 2012/08/05 14:26:36 JST [2012/08/05 1:26:36 ET]
Table 'Whirlpool' 9-max Seat #1 is the button
Seat 1: Dan Royal ($40.98 in chips) 
Seat 2: PetitAlejo ($50.21 in chips) 
Seat 3: troms20 ($29.30 in chips) 
Seat 4: kamikkaze ($16.87 in chips) 
Seat 5: phate-1up ($25 in chips) 
Seat 6: chiyuki ($46.80 in chips) 
Seat 7: RikkStroken ($11.91 in chips) 
Seat 8: sparky5224 ($44.57 in chips) 
Seat 9: el pore 5 ($17.52 in chips) 
PetitAlejo: posts small blind $0.10
troms20: posts big blind $0.25
*** HOLE CARDS ***
Dealt to chiyuki [6d 5c]
kamikkaze: folds 
phate-1up: raises $0.50 to $0.75
chiyuki: folds 
RikkStroken: folds 
sparky5224: folds 
el pore 5: calls $0.75
Dan Royal: folds 
PetitAlejo: folds 
troms20: calls $0.50
*** FLOP *** [9s Qc Ks]
troms20: checks 
phate-1up: bets $1.75
el pore 5: folds 
troms20: raises $4 to $5.75
phate-1up: folds 
Uncalled bet ($4) returned to troms20
troms20 collected $5.59 from pot
troms20: doesn't show hand 
*** SUMMARY ***
Total pot $5.85 | Rake $0.26 
Board [9s Qc Ks]
Seat 1: Dan Royal (button) folded before Flop (didn't bet)
Seat 2: PetitAlejo (small blind) folded before Flop
Seat 3: troms20 (big blind) collected ($5.59)
Seat 4: kamikkaze folded before Flop (didn't bet)
Seat 5: phate-1up folded on the Flop
Seat 6: chiyuki folded before Flop (didn't bet)
Seat 7: RikkStroken folded before Flop (didn't bet)
Seat 8: sparky5224 folded before Flop (didn't bet)
Seat 9: el pore 5 folded on the Flop



PokerStars Zoom Hand #84299560054:  Hold'em No Limit ($0.10/$0.25) - 2012/08/05 14:27:39 JST [2012/08/05 1:27:39 ET]
Table 'Whirlpool' 9-max Seat #1 is the button
Seat 1: 4plankton ($17.28 in chips) 
Seat 2: JLajoie ($37.69 in chips) 
Seat 3: yane73 ($13.67 in chips) 
Seat 4: Dafleche ($18.25 in chips) 
Seat 5: ChrisCDee ($66.46 in chips) 
Seat 6: mariuka1 ($12.15 in chips) 
Seat 7: Lasutchik ($6.51 in chips) 
Seat 8: hl77777 ($14.70 in chips) 
Seat 9: chiyuki ($46.05 in chips) 
JLajoie: posts small blind $0.10
yane73: posts big blind $0.25
*** HOLE CARDS ***
Dealt to chiyuki [Kd 9s]
Dafleche: folds 
ChrisCDee: folds 
mariuka1: folds 
Lasutchik: folds 
hl77777: folds 
chiyuki: folds 
4plankton: folds 
JLajoie: folds 
Uncalled bet ($0.15) returned to yane73
yane73 collected $0.20 from pot
yane73: doesn't show hand 
*** SUMMARY ***
Total pot $0.20 | Rake $0 
Seat 1: 4plankton (button) folded before Flop (didn't bet)
Seat 2: JLajoie (small blind) folded before Flop
Seat 3: yane73 (big blind) collected ($0.20)
Seat 4: Dafleche folded before Flop (didn't bet)
Seat 5: ChrisCDee folded before Flop (didn't bet)
Seat 6: mariuka1 folded before Flop (didn't bet)
Seat 7: Lasutchik folded before Flop (didn't bet)
Seat 8: hl77777 folded before Flop (didn't bet)
Seat 9: chiyuki folded before Flop (didn't bet)



PokerStars Zoom Hand #84299560746:  Hold'em No Limit ($0.10/$0.25) - 2012/08/05 14:27:42 JST [2012/08/05 1:27:42 ET]
Table 'Whirlpool' 9-max Seat #1 is the button
Seat 1: timbof7 ($20.48 in chips) 
Seat 2: JLajoie ($26.79 in chips) 
Seat 3: Nerkit ($14.83 in chips) 
Seat 4: caro196661cv ($29.14 in chips) 
Seat 5: DanielWhyte ($39.56 in chips) 
Seat 6: Yogi707 ($13.80 in chips) 
Seat 7: ladymadon107 ($8.13 in chips) 
Seat 8: chiyuki ($46.05 in chips) 
Seat 9: bonethugs699 ($15.77 in chips) 
JLajoie: posts small blind $0.10
Nerkit: posts big blind $0.25
*** HOLE CARDS ***
Dealt to chiyuki [5s 7d]
caro196661cv: folds 
DanielWhyte: folds 
Yogi707: raises $0.50 to $0.75
ladymadon107: folds 
chiyuki: folds 
bonethugs699: folds 
timbof7: folds 
JLajoie: folds 
Nerkit: folds 
Uncalled bet ($0.50) returned to Yogi707
Yogi707 collected $0.60 from pot
Yogi707: doesn't show hand 
*** SUMMARY ***
Total pot $0.60 | Rake $0 
Seat 1: timbof7 (button) folded before Flop (didn't bet)
Seat 2: JLajoie (small blind) folded before Flop
Seat 3: Nerkit (big blind) folded before Flop
Seat 4: caro196661cv folded before Flop (didn't bet)
Seat 5: DanielWhyte folded before Flop (didn't bet)
Seat 6: Yogi707 collected ($0.60)
Seat 7: ladymadon107 folded before Flop (didn't bet)
Seat 8: chiyuki folded before Flop (didn't bet)
Seat 9: bonethugs699 folded before Flop (didn't bet)



PokerStars Zoom Hand #84299561522:  Hold'em No Limit ($0.10/$0.25) - 2012/08/05 14:27:45 JST [2012/08/05 1:27:45 ET]
Table 'Whirlpool' 9-max Seat #1 is the button
Seat 1: KCDOGG10 ($20.25 in chips) 
Seat 2: Alvinpe85 ($40.01 in chips) 
Seat 3: chiyuki ($46.05 in chips) 
Seat 4: D@vidMed ($77.68 in chips) 
Seat 5: Suhoff76 ($32.41 in chips) 
Seat 6: eskeyp ($14.09 in chips) 
Seat 7: BlOnDhOlIc ($59.46 in chips) 
Seat 8: PetitAlejo ($32.06 in chips) 
Seat 9: carlosrbr ($61.20 in chips) 
Alvinpe85: posts small blind $0.10
chiyuki: posts big blind $0.25
*** HOLE CARDS ***
Dealt to chiyuki [Ac Qh]
D@vidMed: folds 
Suhoff76: folds 
eskeyp: folds 
BlOnDhOlIc: raises $0.25 to $0.50
PetitAlejo: folds 
carlosrbr: folds 
KCDOGG10: folds 
Alvinpe85: folds 
chiyuki: calls $0.25
*** FLOP *** [5h 5s Qs]
chiyuki: checks 
BlOnDhOlIc: bets $0.78
chiyuki: calls $0.78
*** TURN *** [5h 5s Qs] [3d]
chiyuki: checks 
BlOnDhOlIc: checks 
*** RIVER *** [5h 5s Qs 3d] [Td]
chiyuki: bets $1.50
BlOnDhOlIc: folds 
Uncalled bet ($1.50) returned to chiyuki
chiyuki collected $2.54 from pot
chiyuki: doesn't show hand 
*** SUMMARY ***
Total pot $2.66 | Rake $0.12 
Board [5h 5s Qs 3d Td]
Seat 1: KCDOGG10 (button) folded before Flop (didn't bet)
Seat 2: Alvinpe85 (small blind) folded before Flop
Seat 3: chiyuki (big blind) collected ($2.54)
Seat 4: D@vidMed folded before Flop (didn't bet)
Seat 5: Suhoff76 folded before Flop (didn't bet)
Seat 6: eskeyp folded before Flop (didn't bet)
Seat 7: BlOnDhOlIc folded on the River
Seat 8: PetitAlejo folded before Flop (didn't bet)
Seat 9: carlosrbr folded before Flop (didn't bet)



PokerStars Zoom Hand #84299559116:  Hold'em No Limit ($0.10/$0.25) - 2012/08/05 14:27:35 JST [2012/08/05 1:27:35 ET]
Table 'Whirlpool' 9-max Seat #1 is the button
Seat 1: Perstenev ($11.93 in chips) 
Seat 2: ll_LaMeR_ll ($54.40 in chips) 
Seat 3: sparky5224 ($44.32 in chips) 
Seat 4: Nerkit ($14.83 in chips) 
Seat 5: wtu1986 ($24.77 in chips) 
Seat 6: chiyuki ($46.05 in chips) 
Seat 7: 1Karina1 ($25 in chips) 
Seat 8: ladymadon107 ($8.13 in chips) 
Seat 9: KeLevro0 ($9.07 in chips) 
ll_LaMeR_ll: posts small blind $0.10
sparky5224: posts big blind $0.25
*** HOLE CARDS ***
Dealt to chiyuki [Kd 8h]
Nerkit: folds 
wtu1986: folds 
chiyuki: folds 
1Karina1: folds 
ladymadon107: folds 
KeLevro0: raises $0.42 to $0.67
Perstenev: folds 
ll_LaMeR_ll: folds 
sparky5224: calls $0.42
*** FLOP *** [8s 4s 3c]
sparky5224: checks 
KeLevro0: bets $0.77
sparky5224: folds 
Uncalled bet ($0.77) returned to KeLevro0
KeLevro0 collected $1.38 from pot
KeLevro0: doesn't show hand 
*** SUMMARY ***
Total pot $1.44 | Rake $0.06 
Board [8s 4s 3c]
Seat 1: Perstenev (button) folded before Flop (didn't bet)
Seat 2: ll_LaMeR_ll (small blind) folded before Flop
Seat 3: sparky5224 (big blind) folded on the Flop
Seat 4: Nerkit folded before Flop (didn't bet)
Seat 5: wtu1986 folded before Flop (didn't bet)
Seat 6: chiyuki folded before Flop (didn't bet)
Seat 7: 1Karina1 folded before Flop (didn't bet)
Seat 8: ladymadon107 folded before Flop (didn't bet)
Seat 9: KeLevro0 collected ($1.38)



PokerStars Zoom Hand #84299574515:  Hold'em No Limit ($0.10/$0.25) - 2012/08/05 14:28:39 JST [2012/08/05 1:28:39 ET]
Table 'Whirlpool' 9-max Seat #1 is the button
Seat 1: phate-1up ($32.92 in chips) 
Seat 2: KrystalAA ($12.25 in chips) 
Seat 3: KeLevro0 ($9.78 in chips) 
Seat 4: 1Karina1 ($25 in chips) 
Seat 5: Lasutchik ($70.61 in chips) 
Seat 6: taksist889 ($23.51 in chips) 
Seat 7: silvno31 ($34.94 in chips) 
Seat 8: Nerkit ($12.44 in chips) 
Seat 9: chiyuki ($47.31 in chips) 
KrystalAA: posts small blind $0.10
KeLevro0: posts big blind $0.25
*** HOLE CARDS ***
Dealt to chiyuki [2s Td]
1Karina1: folds 
Lasutchik: folds 
taksist889: folds 
silvno31: folds 
Nerkit: folds 
chiyuki: folds 
phate-1up: raises $0.50 to $0.75
KrystalAA: folds 
KeLevro0: folds 
Uncalled bet ($0.50) returned to phate-1up
phate-1up collected $0.60 from pot
phate-1up: doesn't show hand 
*** SUMMARY ***
Total pot $0.60 | Rake $0 
Seat 1: phate-1up (button) collected ($0.60)
Seat 2: KrystalAA (small blind) folded before Flop
Seat 3: KeLevro0 (big blind) folded before Flop
Seat 4: 1Karina1 folded before Flop (didn't bet)
Seat 5: Lasutchik folded before Flop (didn't bet)
Seat 6: taksist889 folded before Flop (didn't bet)
Seat 7: silvno31 folded before Flop (didn't bet)
Seat 8: Nerkit folded before Flop (didn't bet)
Seat 9: chiyuki folded before Flop (didn't bet)



PokerStars Zoom Hand #84299571033:  Hold'em No Limit ($0.10/$0.25) - 2012/08/05 14:28:25 JST [2012/08/05 1:28:25 ET]
Table 'Whirlpool' 9-max Seat #1 is the button
Seat 1: yane73 ($13.67 in chips) 
Seat 2: wtu1986 ($24.52 in chips) 
Seat 3: Suhoff76 ($32.41 in chips) 
Seat 4: hirozo ($29.03 in chips) 
Seat 5: chiyuki ($47.31 in chips) 
Seat 6: softdesign ($68.41 in chips) 
Seat 7: acamrash ($10.39 in chips) 
Seat 8: Lasutchik ($70.61 in chips) 
Seat 9: 1Karina1 ($25 in chips) 
wtu1986: posts small blind $0.10
Suhoff76: posts big blind $0.25
*** HOLE CARDS ***
Dealt to chiyuki [3c 5s]
hirozo: folds 
chiyuki: folds 
softdesign: folds 
acamrash: folds 
Lasutchik: folds 
1Karina1: folds 
yane73: raises $0.50 to $0.75
wtu1986: folds 
Suhoff76: folds 
Uncalled bet ($0.50) returned to yane73
yane73 collected $0.60 from pot
yane73: doesn't show hand 
*** SUMMARY ***
Total pot $0.60 | Rake $0 
Seat 1: yane73 (button) collected ($0.60)
Seat 2: wtu1986 (small blind) folded before Flop
Seat 3: Suhoff76 (big blind) folded before Flop
Seat 4: hirozo folded before Flop (didn't bet)
Seat 5: chiyuki folded before Flop (didn't bet)
Seat 6: softdesign folded before Flop (didn't bet)
Seat 7: acamrash folded before Flop (didn't bet)
Seat 8: Lasutchik folded before Flop (didn't bet)
Seat 9: 1Karina1 folded before Flop (didn't bet)



PokerStars Zoom Hand #84299577173:  Hold'em No Limit ($0.10/$0.25) - 2012/08/05 14:28:50 JST [2012/08/05 1:28:50 ET]
Table 'Whirlpool' 9-max Seat #1 is the button
Seat 1: hirozo ($38.38 in chips) 
Seat 2: chiyuki ($47.31 in chips) 
Seat 3: JLajoie ($37.24 in chips) 
Seat 4: WARIBANA7777 ($14.44 in chips) 
Seat 5: deadmoneykid ($22.14 in chips) 
Seat 6: Perstenev ($11.68 in chips) 
Seat 7: phate-1up ($41.09 in chips) 
Seat 8: Dafleche ($19.60 in chips) 
Seat 9: 1Karina1 ($25 in chips) 
chiyuki: posts small blind $0.10
JLajoie: posts big blind $0.25
*** HOLE CARDS ***
Dealt to chiyuki [Ac Kc]
WARIBANA7777: folds 
deadmoneykid: folds 
Perstenev: folds 
phate-1up: folds 
Dafleche: calls $0.25
1Karina1: folds 
hirozo: folds 
chiyuki: raises $0.75 to $1
JLajoie: folds 
Dafleche: calls $0.75
*** FLOP *** [Ah 6d 3h]
chiyuki: bets $1.25
Dafleche: folds 
Uncalled bet ($1.25) returned to chiyuki
chiyuki collected $2.15 from pot
chiyuki: doesn't show hand 
*** SUMMARY ***
Total pot $2.25 | Rake $0.10 
Board [Ah 6d 3h]
Seat 1: hirozo (button) folded before Flop (didn't bet)
Seat 2: chiyuki (small blind) collected ($2.15)
Seat 3: JLajoie (big blind) folded before Flop
Seat 4: WARIBANA7777 folded before Flop (didn't bet)
Seat 5: deadmoneykid folded before Flop (didn't bet)
Seat 6: Perstenev folded before Flop (didn't bet)
Seat 7: phate-1up folded before Flop (didn't bet)
Seat 8: Dafleche folded on the Flop
Seat 9: 1Karina1 folded before Flop (didn't bet)



PokerStars Zoom Hand #84299575465:  Hold'em No Limit ($0.10/$0.25) - 2012/08/05 14:28:43 JST [2012/08/05 1:28:43 ET]
Table 'Whirlpool' 9-max Seat #1 is the button
Seat 1: Lasutchik ($70.61 in chips) 
Seat 2: Nerkit ($12.44 in chips) 
Seat 3: acamrash ($10.39 in chips) 
Seat 4: ygoegoe ($25 in chips) 
Seat 5: bonethugs699 ($15.27 in chips) 
Seat 6: silvno31 ($34.94 in chips) 
Seat 7: chiyuki ($47.31 in chips) 
Seat 8: DanielWhyte ($39.21 in chips) 
Seat 9: Perstenev ($22.77 in chips) 
Nerkit: posts small blind $0.10
acamrash: posts big blind $0.25
*** HOLE CARDS ***
Dealt to chiyuki [Kd 7d]
ygoegoe: folds 
bonethugs699: raises $0.35 to $0.60
silvno31: folds 
chiyuki: folds 
DanielWhyte: folds 
Perstenev: folds 
Lasutchik: folds 
Nerkit: calls $0.50
acamrash: folds 
*** FLOP *** [2c 8s 4c]
Nerkit: checks 
bonethugs699: checks 
*** TURN *** [2c 8s 4c] [Ks]
Nerkit: checks 
bonethugs699: bets $0.86
Nerkit: folds 
Uncalled bet ($0.86) returned to bonethugs699
bonethugs699 collected $1.38 from pot
bonethugs699: doesn't show hand 
*** SUMMARY ***
Total pot $1.45 | Rake $0.07 
Board [2c 8s 4c Ks]
Seat 1: Lasutchik (button) folded before Flop (didn't bet)
Seat 2: Nerkit (small blind) folded on the Turn
Seat 3: acamrash (big blind) folded before Flop
Seat 4: ygoegoe folded before Flop (didn't bet)
Seat 5: bonethugs699 collected ($1.38)
Seat 6: silvno31 folded before Flop (didn't bet)
Seat 7: chiyuki folded before Flop (didn't bet)
Seat 8: DanielWhyte folded before Flop (didn't bet)
Seat 9: Perstenev folded before Flop (didn't bet)



PokerStars Zoom Hand #84299576470:  Hold'em No Limit ($0.10/$0.25) - 2012/08/05 14:28:47 JST [2012/08/05 1:28:47 ET]
Table 'Whirlpool' 9-max Seat #1 is the button
Seat 1: KrystalAA ($11.75 in chips) 
Seat 2: kamikkaze ($15.90 in chips) 
Seat 3: Lasutchik ($70.61 in chips) 
Seat 4: silvno31 ($34.94 in chips) 
Seat 5: loca-loca888 ($42.18 in chips) 
Seat 6: chiyuki ($47.31 in chips) 
Seat 7: Paranoix1990 ($14.77 in chips) 
Seat 8: BlOnDhOlIc ($35.71 in chips) 
Seat 9: Jene4kaBest ($12.40 in chips) 
kamikkaze: posts small blind $0.10
Lasutchik: posts big blind $0.25
*** HOLE CARDS ***
Dealt to chiyuki [Qc 4c]
silvno31: folds 
loca-loca888: raises $0.75 to $1
chiyuki: folds 
Paranoix1990: calls $1
BlOnDhOlIc: folds 
Jene4kaBest: folds 
KrystalAA: folds 
kamikkaze: folds 
Lasutchik: folds 
*** FLOP *** [5c 5d 2h]
loca-loca888: bets $1.30
Paranoix1990: folds 
Uncalled bet ($1.30) returned to loca-loca888
loca-loca888 collected $2.24 from pot
loca-loca888: doesn't show hand 
*** SUMMARY ***
Total pot $2.35 | Rake $0.11 
Board [5c 5d 2h]
Seat 1: KrystalAA (button) folded before Flop (didn't bet)
Seat 2: kamikkaze (small blind) folded before Flop
Seat 3: Lasutchik (big blind) folded before Flop
Seat 4: silvno31 folded before Flop (didn't bet)
Seat 5: loca-loca888 collected ($2.24)
Seat 6: chiyuki folded before Flop (didn't bet)
Seat 7: Paranoix1990 folded on the Flop
Seat 8: BlOnDhOlIc folded before Flop (didn't bet)
Seat 9: Jene4kaBest folded before Flop (didn't bet)



PokerStars Zoom Hand #84299572312:  Hold'em No Limit ($0.10/$0.25) - 2012/08/05 14:28:30 JST [2012/08/05 1:28:30 ET]
Table 'Whirlpool' 9-max Seat #1 is the button
Seat 1: chiyuki ($47.31 in chips) 
Seat 2: JLajoie ($37.34 in chips) 
Seat 3: deadmoneykid ($27.28 in chips) 
Seat 4: RikkStroken ($11.91 in chips) 
Seat 5: Loholov ($19.93 in chips) 
Seat 6: znake77 ($16.36 in chips) 
Seat 7: kamikkaze ($15.90 in chips) 
Seat 8: KeLevro0 ($9.78 in chips) 
Seat 9: phate-1up ($32.92 in chips) 
JLajoie: posts small blind $0.10
deadmoneykid: posts big blind $0.25
*** HOLE CARDS ***
Dealt to chiyuki [Ac 9h]
RikkStroken: folds 
Loholov: raises $0.50 to $0.75
znake77: calls $0.75
kamikkaze: folds 
KeLevro0: folds 
phate-1up: folds 
chiyuki: folds 
JLajoie: folds 
deadmoneykid: calls $0.50
*** FLOP *** [2d 5h 4d]
deadmoneykid: checks 
Loholov: checks 
znake77: bets $1.50
deadmoneykid: folds 
Loholov: calls $1.50
*** TURN *** [2d 5h 4d] [Th]
Loholov: checks 
znake77: bets $3.75
Loholov: calls $3.75
*** RIVER *** [2d 5h 4d Th] [3d]
Loholov: bets $5.75
znake77: calls $5.75
*** SHOW DOWN ***
Loholov: shows [Qd Td] (a flush, Queen high)
znake77: mucks hand 
Loholov collected $23.25 from pot
*** SUMMARY ***
Total pot $24.35 | Rake $1.10 
Board [2d 5h 4d Th 3d]
Seat 1: chiyuki (button) folded before Flop (didn't bet)
Seat 2: JLajoie (small blind) folded before Flop
Seat 3: deadmoneykid (big blind) folded on the Flop
Seat 4: RikkStroken folded before Flop (didn't bet)
Seat 5: Loholov showed [Qd Td] and won ($23.25) with a flush, Queen high
Seat 6: znake77 mucked [Tc As]
Seat 7: kamikkaze folded before Flop (didn't bet)
Seat 8: KeLevro0 folded before Flop (didn't bet)
Seat 9: phate-1up folded before Flop (didn't bet)



PokerStars Zoom Hand #84299587222:  Hold'em No Limit ($0.10/$0.25) - 2012/08/05 14:29:32 JST [2012/08/05 1:29:32 ET]
Table 'Whirlpool' 9-max Seat #1 is the button
Seat 1: deadmoneykid ($26.53 in chips) 
Seat 2: Feros 99 ($23.90 in chips) 
Seat 3: chiyuki ($48.46 in chips) 
Seat 4: Faraz ($18.79 in chips) 
Seat 5: flyinprits ($27.67 in chips) 
Seat 6: silvno31 ($34.94 in chips) 
Seat 7: 1Karina1 ($25 in chips) 
Seat 8: Nerkit ($10.82 in chips) 
Seat 9: ladymadon107 ($7.98 in chips) 
Feros 99: posts small blind $0.10
chiyuki: posts big blind $0.25
*** HOLE CARDS ***
Dealt to chiyuki [Js Ah]
Faraz: folds 
flyinprits: folds 
silvno31: folds 
1Karina1: folds 
Nerkit: folds 
ladymadon107: folds 
deadmoneykid: folds 
Feros 99: folds 
Uncalled bet ($0.15) returned to chiyuki
chiyuki collected $0.20 from pot
chiyuki: doesn't show hand 
*** SUMMARY ***
Total pot $0.20 | Rake $0 
Seat 1: deadmoneykid (button) folded before Flop (didn't bet)
Seat 2: Feros 99 (small blind) folded before Flop
Seat 3: chiyuki (big blind) collected ($0.20)
Seat 4: Faraz folded before Flop (didn't bet)
Seat 5: flyinprits folded before Flop (didn't bet)
Seat 6: silvno31 folded before Flop (didn't bet)
Seat 7: 1Karina1 folded before Flop (didn't bet)
Seat 8: Nerkit folded before Flop (didn't bet)
Seat 9: ladymadon107 folded before Flop (didn't bet)



PokerStars Zoom Hand #84299582028:  Hold'em No Limit ($0.10/$0.25) - 2012/08/05 14:29:11 JST [2012/08/05 1:29:11 ET]
Table 'Whirlpool' 9-max Seat #1 is the button
Seat 1: KrystalAA ($12.50 in chips) 
Seat 2: ZhukOFFskI ($22.06 in chips) 
Seat 3: WARIBANA7777 ($14.34 in chips) 
Seat 4: phate-1up ($41.09 in chips) 
Seat 5: chiyuki ($48.46 in chips) 
Seat 6: Dafleche ($18.60 in chips) 
Seat 7: Landybob ($42.98 in chips) 
Seat 8: PillZ86 ($6.35 in chips) 
Seat 9: PetitAlejo ($31.61 in chips) 
ZhukOFFskI: posts small blind $0.10
WARIBANA7777: posts big blind $0.25
*** HOLE CARDS ***
Dealt to chiyuki [Th 7c]
phate-1up: folds 
chiyuki: folds 
Dafleche: folds 
Landybob: raises $0.50 to $0.75
PillZ86: calls $0.75
PetitAlejo: folds 
KrystalAA: folds 
ZhukOFFskI: calls $0.65
WARIBANA7777: folds 
*** FLOP *** [7d 2h Ah]
ZhukOFFskI: checks 
Landybob: bets $0.95
PillZ86: raises $4.65 to $5.60 and is all-in
ZhukOFFskI: folds 
Landybob: folds 
Uncalled bet ($4.65) returned to PillZ86
PillZ86 collected $4.20 from pot
PillZ86: doesn't show hand 
*** SUMMARY ***
Total pot $4.40 | Rake $0.20 
Board [7d 2h Ah]
Seat 1: KrystalAA (button) folded before Flop (didn't bet)
Seat 2: ZhukOFFskI (small blind) folded on the Flop
Seat 3: WARIBANA7777 (big blind) folded before Flop
Seat 4: phate-1up folded before Flop (didn't bet)
Seat 5: chiyuki folded before Flop (didn't bet)
Seat 6: Dafleche folded before Flop (didn't bet)
Seat 7: Landybob folded on the Flop
Seat 8: PillZ86 collected ($4.20)
Seat 9: PetitAlejo folded before Flop (didn't bet)



PokerStars Zoom Hand #84299583258:  Hold'em No Limit ($0.10/$0.25) - 2012/08/05 14:29:16 JST [2012/08/05 1:29:16 ET]
Table 'Whirlpool' 9-max Seat #1 is the button
Seat 1: kamikkaze ($32.07 in chips) 
Seat 2: phate-1up ($41.09 in chips) 
Seat 3: cofla tito ($13 in chips) 
Seat 4: softdesign ($68.41 in chips) 
Seat 5: 1Karina1 ($26.78 in chips) 
Seat 6: Nerkit ($10.92 in chips) 
Seat 7: RomarioJa ($10.79 in chips) 
Seat 8: chiyuki ($48.46 in chips) 
Seat 9: BlOnDhOlIc ($86.43 in chips) 
phate-1up: posts small blind $0.10
cofla tito: posts big blind $0.25
*** HOLE CARDS ***
Dealt to chiyuki [Th Qh]
softdesign: calls $0.25
1Karina1: folds 
Nerkit: folds 
RomarioJa: folds 
chiyuki: folds 
BlOnDhOlIc: folds 
kamikkaze: folds 
phate-1up: folds 
cofla tito: checks 
*** FLOP *** [Ah 3s 4c]
cofla tito: checks 
softdesign: checks 
*** TURN *** [Ah 3s 4c] [9s]
cofla tito: checks 
softdesign: checks 
*** RIVER *** [Ah 3s 4c 9s] [Kd]
cofla tito: checks 
softdesign: bets $1
cofla tito: folds 
Uncalled bet ($1) returned to softdesign
softdesign collected $0.57 from pot
softdesign: doesn't show hand 
*** SUMMARY ***
Total pot $0.60 | Rake $0.03 
Board [Ah 3s 4c 9s Kd]
Seat 1: kamikkaze (button) folded before Flop (didn't bet)
Seat 2: phate-1up (small blind) folded before Flop
Seat 3: cofla tito (big blind) folded on the River
Seat 4: softdesign collected ($0.57)
Seat 5: 1Karina1 folded before Flop (didn't bet)
Seat 6: Nerkit folded before Flop (didn't bet)
Seat 7: RomarioJa folded before Flop (didn't bet)
Seat 8: chiyuki folded before Flop (didn't bet)
Seat 9: BlOnDhOlIc folded before Flop (didn't bet)



PokerStars Zoom Hand #84299590259:  Hold'em No Limit ($0.10/$0.25) - 2012/08/05 14:29:44 JST [2012/08/05 1:29:44 ET]
Table 'Whirlpool' 9-max Seat #1 is the button
Seat 1: phate-1up ($25 in chips) 
Seat 2: PetitAlejo ($31.36 in chips) 
Seat 3: KrystalAA ($12.50 in chips) 
Seat 4: Suhoff76 ($32.41 in chips) 
Seat 5: Vahe50 ($25.34 in chips) 
Seat 6: DanielWhyte ($38.86 in chips) 
Seat 7: chiyuki ($48.56 in chips) 
Seat 8: ZhukOFFskI ($24.65 in chips) 
Seat 9: seula i ($33.64 in chips) 
PetitAlejo: posts small blind $0.10
KrystalAA: posts big blind $0.25
*** HOLE CARDS ***
Dealt to chiyuki [2c 2d]
Suhoff76: folds 
Vahe50: folds 
DanielWhyte: folds 
chiyuki: folds 
ZhukOFFskI: folds 
seula i: folds 
phate-1up: raises $0.50 to $0.75
PetitAlejo: folds 
KrystalAA: folds 
Uncalled bet ($0.50) returned to phate-1up
phate-1up collected $0.60 from pot
phate-1up: doesn't show hand 
*** SUMMARY ***
Total pot $0.60 | Rake $0 
Seat 1: phate-1up (button) collected ($0.60)
Seat 2: PetitAlejo (small blind) folded before Flop
Seat 3: KrystalAA (big blind) folded before Flop
Seat 4: Suhoff76 folded before Flop (didn't bet)
Seat 5: Vahe50 folded before Flop (didn't bet)
Seat 6: DanielWhyte folded before Flop (didn't bet)
Seat 7: chiyuki folded before Flop (didn't bet)
Seat 8: ZhukOFFskI folded before Flop (didn't bet)
Seat 9: seula i folded before Flop (didn't bet)



PokerStars Zoom Hand #84299592268:  Hold'em No Limit ($0.10/$0.25) - 2012/08/05 14:29:52 JST [2012/08/05 1:29:52 ET]
Table 'Whirlpool' 9-max Seat #1 is the button
Seat 1: kamikkaze ($18.03 in chips) 
Seat 2: Vahe50 ($25.34 in chips) 
Seat 3: hirozo ($38.63 in chips) 
Seat 4: chiyuki ($48.56 in chips) 
Seat 5: Suhoff76 ($25.65 in chips) 
Seat 6: 4thepeople ($23.80 in chips) 
Seat 7: KeLevro0 ($9.74 in chips) 
Seat 8: troms20 ($31.49 in chips) 
Seat 9: PetitAlejo ($40.99 in chips) 
Vahe50: posts small blind $0.10
hirozo: posts big blind $0.25
*** HOLE CARDS ***
Dealt to chiyuki [Ah 8c]
chiyuki: folds 
Suhoff76: folds 
4thepeople: folds 
KeLevro0: folds 
troms20: folds 
PetitAlejo: raises $0.50 to $0.75
kamikkaze: folds 
Vahe50: folds 
hirozo: folds 
Uncalled bet ($0.50) returned to PetitAlejo
PetitAlejo collected $0.60 from pot
PetitAlejo: doesn't show hand 
*** SUMMARY ***
Total pot $0.60 | Rake $0 
Seat 1: kamikkaze (button) folded before Flop (didn't bet)
Seat 2: Vahe50 (small blind) folded before Flop
Seat 3: hirozo (big blind) folded before Flop
Seat 4: chiyuki folded before Flop (didn't bet)
Seat 5: Suhoff76 folded before Flop (didn't bet)
Seat 6: 4thepeople folded before Flop (didn't bet)
Seat 7: KeLevro0 folded before Flop (didn't bet)
Seat 8: troms20 folded before Flop (didn't bet)
Seat 9: PetitAlejo collected ($0.60)



PokerStars Zoom Hand #84299586225:  Hold'em No Limit ($0.10/$0.25) - 2012/08/05 14:29:28 JST [2012/08/05 1:29:28 ET]
Table 'Whirlpool' 9-max Seat #1 is the button
Seat 1: ChrisCDee ($66.11 in chips) 
Seat 2: kamikkaze ($18.13 in chips) 
Seat 3: Dejacob ($35.76 in chips) 
Seat 4: chiyuki ($48.46 in chips) 
Seat 5: PetitAlejo ($52.86 in chips) 
Seat 6: RomarioJa ($13.81 in chips) 
Seat 7: troms20 ($31.49 in chips) 
Seat 8: ygoegoe ($27.16 in chips) 
Seat 9: Suhoff76 ($25.25 in chips) 
kamikkaze: posts small blind $0.10
Dejacob: posts big blind $0.25
*** HOLE CARDS ***
Dealt to chiyuki [8h Ac]
chiyuki: folds 
PetitAlejo: folds 
RomarioJa: folds 
troms20 has timed out
troms20: folds 
ygoegoe: folds 
Suhoff76: folds 
ChrisCDee: raises $0.50 to $0.75
kamikkaze: folds 
Dejacob: calls $0.50
*** FLOP *** [Td Kd Ah]
Dejacob: checks 
ChrisCDee: checks 
*** TURN *** [Td Kd Ah] [Th]
Dejacob: bets $1.25
ChrisCDee: folds 
Uncalled bet ($1.25) returned to Dejacob
Dejacob collected $1.53 from pot
Dejacob: doesn't show hand 
*** SUMMARY ***
Total pot $1.60 | Rake $0.07 
Board [Td Kd Ah Th]
Seat 1: ChrisCDee (button) folded on the Turn
Seat 2: kamikkaze (small blind) folded before Flop
Seat 3: Dejacob (big blind) collected ($1.53)
Seat 4: chiyuki folded before Flop (didn't bet)
Seat 5: PetitAlejo folded before Flop (didn't bet)
Seat 6: RomarioJa folded before Flop (didn't bet)
Seat 7: troms20 folded before Flop (didn't bet)
Seat 8: ygoegoe folded before Flop (didn't bet)
Seat 9: Suhoff76 folded before Flop (didn't bet)



PokerStars Zoom Hand #84299593462:  Hold'em No Limit ($0.10/$0.25) - 2012/08/05 14:29:57 JST [2012/08/05 1:29:57 ET]
Table 'Whirlpool' 9-max Seat #1 is the button
Seat 1: BlOnDhOlIc ($35.36 in chips) 
Seat 2: chiyuki ($48.56 in chips) 
Seat 3: kamikkaze ($18.03 in chips) 
Seat 4: DanielWhyte ($38.86 in chips) 
Seat 5: Suhoff76 ($27.80 in chips) 
Seat 6: phate-1up ($40.74 in chips) 
Seat 7: 4plankton ($23.86 in chips) 
Seat 8: johnbaco1209 ($29.21 in chips) 
Seat 9: bonethugs699 ($30.89 in chips) 
chiyuki: posts small blind $0.10
kamikkaze: posts big blind $0.25
*** HOLE CARDS ***
Dealt to chiyuki [Ac 4s]
DanielWhyte: folds 
Suhoff76: folds 
phate-1up: folds 
4plankton: folds 
johnbaco1209: folds 
bonethugs699: raises $0.35 to $0.60
BlOnDhOlIc: folds 
chiyuki: folds 
kamikkaze: folds 
Uncalled bet ($0.35) returned to bonethugs699
bonethugs699 collected $0.60 from pot
bonethugs699: doesn't show hand 
*** SUMMARY ***
Total pot $0.60 | Rake $0 
Seat 1: BlOnDhOlIc (button) folded before Flop (didn't bet)
Seat 2: chiyuki (small blind) folded before Flop
Seat 3: kamikkaze (big blind) folded before Flop
Seat 4: DanielWhyte folded before Flop (didn't bet)
Seat 5: Suhoff76 folded before Flop (didn't bet)
Seat 6: phate-1up folded before Flop (didn't bet)
Seat 7: 4plankton folded before Flop (didn't bet)
Seat 8: johnbaco1209 folded before Flop (didn't bet)
Seat 9: bonethugs699 collected ($0.60)



PokerStars Zoom Hand #84299597247:  Hold'em No Limit ($0.10/$0.25) - 2012/08/05 14:30:12 JST [2012/08/05 1:30:12 ET]
Table 'Whirlpool' 9-max Seat #1 is the button
Seat 1: Suhoff76 ($32.06 in chips) 
Seat 2: ygoegoe ($25 in chips) 
Seat 3: KeLevro0 ($9.74 in chips) 
Seat 4: cofla tito ($12.75 in chips) 
Seat 5: chiyuki ($48.46 in chips) 
Seat 6: 4plankton ($23.61 in chips) 
Seat 7: DanielWhyte ($38.86 in chips) 
Seat 8: Dan Royal ($29.68 in chips) 
Seat 9: Nerkit ($11.49 in chips) 
ygoegoe: posts small blind $0.10
KeLevro0: posts big blind $0.25
*** HOLE CARDS ***
Dealt to chiyuki [4h Kh]
cofla tito: folds 
chiyuki: folds 
4plankton: folds 
DanielWhyte: folds 
Dan Royal: raises $0.50 to $0.75
Nerkit: folds 
Suhoff76: folds 
ygoegoe: folds 
KeLevro0: folds 
Uncalled bet ($0.50) returned to Dan Royal
Dan Royal collected $0.60 from pot
Dan Royal: doesn't show hand 
*** SUMMARY ***
Total pot $0.60 | Rake $0 
Seat 1: Suhoff76 (button) folded before Flop (didn't bet)
Seat 2: ygoegoe (small blind) folded before Flop
Seat 3: KeLevro0 (big blind) folded before Flop
Seat 4: cofla tito folded before Flop (didn't bet)
Seat 5: chiyuki folded before Flop (didn't bet)
Seat 6: 4plankton folded before Flop (didn't bet)
Seat 7: DanielWhyte folded before Flop (didn't bet)
Seat 8: Dan Royal collected ($0.60)
Seat 9: Nerkit folded before Flop (didn't bet)



PokerStars Zoom Hand #84299590964:  Hold'em No Limit ($0.10/$0.25) - 2012/08/05 14:29:47 JST [2012/08/05 1:29:47 ET]
Table 'Whirlpool' 9-max Seat #1 is the button
Seat 1: chiyuki ($48.56 in chips) 
Seat 2: Th3Fog ($53.06 in chips) 
Seat 3: carlosrbr ($68.74 in chips) 
Seat 4: Jene4kaBest ($12.62 in chips) 
Seat 5: KeLevro0 ($13.17 in chips) 
Seat 6: Ellen1947 ($23.96 in chips) 
Seat 7: wtu1986 ($30.42 in chips) 
Seat 8: Landybob ($41.28 in chips) 
Seat 9: flyinprits ($27.67 in chips) 
Th3Fog: posts small blind $0.10
carlosrbr: posts big blind $0.25
*** HOLE CARDS ***
Dealt to chiyuki [4c 5c]
Jene4kaBest: folds 
KeLevro0: folds 
Ellen1947: raises $0.50 to $0.75
wtu1986: folds 
Landybob: folds 
flyinprits: folds 
chiyuki: folds 
Th3Fog: calls $0.65
carlosrbr: folds 
*** FLOP *** [4h Jh 3h]
Th3Fog: checks 
Ellen1947: checks 
*** TURN *** [4h Jh 3h] [3s]
Th3Fog: bets $0.73
Ellen1947: calls $0.73
*** RIVER *** [4h Jh 3h 3s] [8c]
Th3Fog: bets $1.35
Ellen1947: raises $4.45 to $5.80
Th3Fog: folds 
Uncalled bet ($4.45) returned to Ellen1947
Ellen1947 collected $5.64 from pot
Ellen1947: doesn't show hand 
*** SUMMARY ***
Total pot $5.91 | Rake $0.27 
Board [4h Jh 3h 3s 8c]
Seat 1: chiyuki (button) folded before Flop (didn't bet)
Seat 2: Th3Fog (small blind) folded on the River
Seat 3: carlosrbr (big blind) folded before Flop
Seat 4: Jene4kaBest folded before Flop (didn't bet)
Seat 5: KeLevro0 folded before Flop (didn't bet)
Seat 6: Ellen1947 collected ($5.64)
Seat 7: wtu1986 folded before Flop (didn't bet)
Seat 8: Landybob folded before Flop (didn't bet)
Seat 9: flyinprits folded before Flop (didn't bet)



PokerStars Zoom Hand #84299598941:  Hold'em No Limit ($0.10/$0.25) - 2012/08/05 14:30:19 JST [2012/08/05 1:30:19 ET]
Table 'Whirlpool' 9-max Seat #1 is the button
Seat 1: hirozo ($38.28 in chips) 
Seat 2: cofla tito ($12.75 in chips) 
Seat 3: Perstenev ($11.58 in chips) 
Seat 4: silvno31 ($35.04 in chips) 
Seat 5: pef1331 ($28.54 in chips) 
Seat 6: chiyuki ($48.46 in chips) 
Seat 7: BlOnDhOlIc ($69.33 in chips) 
Seat 8: phate-1up ($40.74 in chips) 
Seat 9: KeLevro0 ($12.92 in chips) 
cofla tito: posts small blind $0.10
Perstenev: posts big blind $0.25
*** HOLE CARDS ***
Dealt to chiyuki [Ks Js]
silvno31: raises $0.50 to $0.75
pef1331: folds 
chiyuki: folds 
BlOnDhOlIc: raises $1.50 to $2.25
phate-1up: folds 
KeLevro0: folds 
hirozo: folds 
cofla tito: folds 
Perstenev: folds 
silvno31: calls $1.50
*** FLOP *** [7h Jh 6d]
silvno31: checks 
BlOnDhOlIc: bets $2.75
silvno31: calls $2.75
*** TURN *** [7h Jh 6d] [5h]
silvno31: checks 
BlOnDhOlIc: checks 
*** RIVER *** [7h Jh 6d 5h] [3s]
silvno31: bets $2.25
BlOnDhOlIc: calls $2.25
*** SHOW DOWN ***
silvno31: shows [Tc Ts] (a pair of Tens)
BlOnDhOlIc: shows [Ac Ad] (a pair of Aces)
BlOnDhOlIc collected $14.18 from pot
*** SUMMARY ***
Total pot $14.85 | Rake $0.67 
Board [7h Jh 6d 5h 3s]
Seat 1: hirozo (button) folded before Flop (didn't bet)
Seat 2: cofla tito (small blind) folded before Flop
Seat 3: Perstenev (big blind) folded before Flop
Seat 4: silvno31 showed [Tc Ts] and lost with a pair of Tens
Seat 5: pef1331 folded before Flop (didn't bet)
Seat 6: chiyuki folded before Flop (didn't bet)
Seat 7: BlOnDhOlIc showed [Ac Ad] and won ($14.18) with a pair of Aces
Seat 8: phate-1up folded before Flop (didn't bet)
Seat 9: KeLevro0 folded before Flop (didn't bet)



PokerStars Zoom Hand #84299601415:  Hold'em No Limit ($0.10/$0.25) - 2012/08/05 14:30:30 JST [2012/08/05 1:30:30 ET]
Table 'Whirlpool' 9-max Seat #1 is the button
Seat 1: PetitAlejo ($31.61 in chips) 
Seat 2: Loholov ($24.35 in chips) 
Seat 3: chiyuki ($48.46 in chips) 
Seat 4: Yogi707 ($12.34 in chips) 
Seat 5: Perstenev ($21.82 in chips) 
Seat 6: seula i ($25 in chips) 
Seat 7: ygoegoe ($26.91 in chips) 
Seat 8: AlfredE525 ($16.67 in chips) 
Seat 9: phate-1up ($27.37 in chips) 
Loholov: posts small blind $0.10
chiyuki: posts big blind $0.25
*** HOLE CARDS ***
Dealt to chiyuki [5c Jh]
Yogi707: raises $0.50 to $0.75
Perstenev: folds 
seula i: folds 
ygoegoe: folds 
AlfredE525: folds 
phate-1up: folds 
PetitAlejo: folds 
Loholov: calls $0.65
chiyuki: folds 
*** FLOP *** [7c 7s 2c]
Loholov: checks 
Yogi707: checks 
*** TURN *** [7c 7s 2c] [Ac]
Loholov: checks 
Yogi707: bets $0.83
Loholov: calls $0.83
*** RIVER *** [7c 7s 2c Ac] [2s]
Loholov: checks 
Yogi707: bets $1.63
Loholov: folds 
Uncalled bet ($1.63) returned to Yogi707
Yogi707 collected $3.26 from pot
Yogi707: doesn't show hand 
*** SUMMARY ***
Total pot $3.41 | Rake $0.15 
Board [7c 7s 2c Ac 2s]
Seat 1: PetitAlejo (button) folded before Flop (didn't bet)
Seat 2: Loholov (small blind) folded on the River
Seat 3: chiyuki (big blind) folded before Flop
Seat 4: Yogi707 collected ($3.26)
Seat 5: Perstenev folded before Flop (didn't bet)
Seat 6: seula i folded before Flop (didn't bet)
Seat 7: ygoegoe folded before Flop (didn't bet)
Seat 8: AlfredE525 folded before Flop (didn't bet)
Seat 9: phate-1up folded before Flop (didn't bet)



PokerStars Zoom Hand #84299604845:  Hold'em No Limit ($0.10/$0.25) - 2012/08/05 14:30:44 JST [2012/08/05 1:30:44 ET]
Table 'Whirlpool' 9-max Seat #1 is the button
Seat 1: Ellen1947 ($26.77 in chips) 
Seat 2: 4ydo yogurt ($11.76 in chips) 
Seat 3: Dejacob ($48.77 in chips) 
Seat 4: KeLevro0 ($9.08 in chips) 
Seat 5: Vahe50 ($25.59 in chips) 
Seat 6: BlOnDhOlIc ($25 in chips) 
Seat 7: 4thepeople ($25.50 in chips) 
Seat 8: chiyuki ($48.21 in chips) 
Seat 9: pef1331 ($28.29 in chips) 
4ydo yogurt: posts small blind $0.10
Dejacob: posts big blind $0.25
*** HOLE CARDS ***
Dealt to chiyuki [3h 8c]
KeLevro0: folds 
Vahe50: raises $0.50 to $0.75
BlOnDhOlIc: folds 
4thepeople: calls $0.75
chiyuki: folds 
pef1331: folds 
Ellen1947: folds 
4ydo yogurt: folds 
Dejacob: folds 
*** FLOP *** [Ah 7c Jd]
Vahe50: bets $1
4thepeople: folds 
Uncalled bet ($1) returned to Vahe50
Vahe50 collected $1.77 from pot
Vahe50: doesn't show hand 
*** SUMMARY ***
Total pot $1.85 | Rake $0.08 
Board [Ah 7c Jd]
Seat 1: Ellen1947 (button) folded before Flop (didn't bet)
Seat 2: 4ydo yogurt (small blind) folded before Flop
Seat 3: Dejacob (big blind) folded before Flop
Seat 4: KeLevro0 folded before Flop (didn't bet)
Seat 5: Vahe50 collected ($1.77)
Seat 6: BlOnDhOlIc folded before Flop (didn't bet)
Seat 7: 4thepeople folded on the Flop
Seat 8: chiyuki folded before Flop (didn't bet)
Seat 9: pef1331 folded before Flop (didn't bet)



PokerStars Zoom Hand #84299606053:  Hold'em No Limit ($0.10/$0.25) - 2012/08/05 14:30:49 JST [2012/08/05 1:30:49 ET]
Table 'Whirlpool' 9-max Seat #1 is the button
Seat 1: Loholov ($16.85 in chips) 
Seat 2: pef1331 ($28.29 in chips) 
Seat 3: 1Karina1 ($25 in chips) 
Seat 4: Alvinpe85 ($50.36 in chips) 
Seat 5: phate-1up ($27.37 in chips) 
Seat 6: KrystalAA ($12 in chips) 
Seat 7: chiyuki ($48.21 in chips) 
Seat 8: Suhoff76 ($25.40 in chips) 
Seat 9: Ellen1947 ($26.77 in chips) 
pef1331: posts small blind $0.10
1Karina1: posts big blind $0.25
*** HOLE CARDS ***
Dealt to chiyuki [7s As]
Alvinpe85: folds 
phate-1up: folds 
KrystalAA: folds 
chiyuki: folds 
Suhoff76: folds 
Ellen1947: folds 
Loholov: raises $0.50 to $0.75
pef1331: folds 
1Karina1: calls $0.50
*** FLOP *** [7c Ac 7h]
1Karina1: bets $1
Loholov: calls $1
*** TURN *** [7c Ac 7h] [2s]
1Karina1: checks 
Loholov: bets $1.75
1Karina1: folds 
Uncalled bet ($1.75) returned to Loholov
Loholov collected $3.44 from pot
Loholov: doesn't show hand 
*** SUMMARY ***
Total pot $3.60 | Rake $0.16 
Board [7c Ac 7h 2s]
Seat 1: Loholov (button) collected ($3.44)
Seat 2: pef1331 (small blind) folded before Flop
Seat 3: 1Karina1 (big blind) folded on the Turn
Seat 4: Alvinpe85 folded before Flop (didn't bet)
Seat 5: phate-1up folded before Flop (didn't bet)
Seat 6: KrystalAA folded before Flop (didn't bet)
Seat 7: chiyuki folded before Flop (didn't bet)
Seat 8: Suhoff76 folded before Flop (didn't bet)
Seat 9: Ellen1947 folded before Flop (didn't bet)



PokerStars Zoom Hand #84299606795:  Hold'em No Limit ($0.10/$0.25) - 2012/08/05 14:30:52 JST [2012/08/05 1:30:52 ET]
Table 'Whirlpool' 9-max Seat #1 is the button
Seat 1: chiyuki ($48.21 in chips) 
Seat 2: RikkStroken ($18.97 in chips) 
Seat 3: flyinprits ($12.42 in chips) 
Seat 4: caro196661cv ($28.38 in chips) 
Seat 5: Perstenev ($12.75 in chips) 
Seat 6: peng2astic ($23.29 in chips) 
Seat 7: seula i ($61.39 in chips) 
Seat 8: cofla tito ($12.65 in chips) 
Seat 9: Wilcox76607 ($13.59 in chips) 
RikkStroken: posts small blind $0.10
flyinprits: posts big blind $0.25
*** HOLE CARDS ***
Dealt to chiyuki [7s 7c]
caro196661cv: folds 
Perstenev: folds 
peng2astic: folds 
seula i: folds 
cofla tito: folds 
Wilcox76607: folds 
chiyuki: raises $0.50 to $0.75
RikkStroken: folds 
flyinprits: folds 
Uncalled bet ($0.50) returned to chiyuki
chiyuki collected $0.60 from pot
chiyuki: doesn't show hand 
*** SUMMARY ***
Total pot $0.60 | Rake $0 
Seat 1: chiyuki (button) collected ($0.60)
Seat 2: RikkStroken (small blind) folded before Flop
Seat 3: flyinprits (big blind) folded before Flop
Seat 4: caro196661cv folded before Flop (didn't bet)
Seat 5: Perstenev folded before Flop (didn't bet)
Seat 6: peng2astic folded before Flop (didn't bet)
Seat 7: seula i folded before Flop (didn't bet)
Seat 8: cofla tito folded before Flop (didn't bet)
Seat 9: Wilcox76607 folded before Flop (didn't bet)



PokerStars Zoom Hand #84299598166:  Hold'em No Limit ($0.10/$0.25) - 2012/08/05 14:30:16 JST [2012/08/05 1:30:16 ET]
Table 'Whirlpool' 9-max Seat #1 is the button
Seat 1: eskeyp ($8.10 in chips) 
Seat 2: AlfredE525 ($16.77 in chips) 
Seat 3: caro196661cv ($28.63 in chips) 
Seat 4: PetitAlejo ($52.51 in chips) 
Seat 5: 4plankton ($23.61 in chips) 
Seat 6: ChrisCDee ($37.07 in chips) 
Seat 7: WARIBANA7777 ($13.74 in chips) 
Seat 8: Suhoff76 ($25 in chips) 
Seat 9: chiyuki ($48.46 in chips) 
AlfredE525: posts small blind $0.10
caro196661cv: posts big blind $0.25
*** HOLE CARDS ***
Dealt to chiyuki [5s Qs]
PetitAlejo: folds 
4plankton: raises $0.25 to $0.50
ChrisCDee: folds 
WARIBANA7777: raises $0.75 to $1.25
Suhoff76: folds 
chiyuki: folds 
eskeyp: folds 
AlfredE525: folds 
caro196661cv: folds 
4plankton: calls $0.75
*** FLOP *** [2d 4c Ks]
4plankton: checks 
WARIBANA7777: bets $0.49
4plankton: raises $0.49 to $0.98
WARIBANA7777: calls $0.49
*** TURN *** [2d 4c Ks] [6c]
4plankton: checks 
WARIBANA7777: bets $1.51
4plankton: calls $1.51
*** RIVER *** [2d 4c Ks 6c] [4s]
4plankton: checks 
WARIBANA7777: checks 
*** SHOW DOWN ***
4plankton: shows [As Qh] (a pair of Fours)
WARIBANA7777: shows [Tc Ts] (two pair, Tens and Fours)
WARIBANA7777 collected $7.48 from pot
*** SUMMARY ***
Total pot $7.83 | Rake $0.35 
Board [2d 4c Ks 6c 4s]
Seat 1: eskeyp (button) folded before Flop (didn't bet)
Seat 2: AlfredE525 (small blind) folded before Flop
Seat 3: caro196661cv (big blind) folded before Flop
Seat 4: PetitAlejo folded before Flop (didn't bet)
Seat 5: 4plankton showed [As Qh] and lost with a pair of Fours
Seat 6: ChrisCDee folded before Flop (didn't bet)
Seat 7: WARIBANA7777 showed [Tc Ts] and won ($7.48) with two pair, Tens and Fours
Seat 8: Suhoff76 folded before Flop (didn't bet)
Seat 9: chiyuki folded before Flop (didn't bet)



PokerStars Zoom Hand #84299619119:  Hold'em No Limit ($0.10/$0.25) - 2012/08/05 14:31:43 JST [2012/08/05 1:31:43 ET]
Table 'Whirlpool' 9-max Seat #1 is the button
Seat 1: Ladyteazer ($24.79 in chips) 
Seat 2: Suhoff76 ($27.30 in chips) 
Seat 3: RikkStroken ($35.76 in chips) 
Seat 4: BlOnDhOlIc ($37.43 in chips) 
Seat 5: seula i ($32.29 in chips) 
Seat 6: silvno31 ($28.04 in chips) 
Seat 7: Th3Fog ($17.78 in chips) 
Seat 8: kamikkaze ($15 in chips) 
Seat 9: chiyuki ($48.46 in chips) 
Suhoff76: posts small blind $0.10
RikkStroken: posts big blind $0.25
*** HOLE CARDS ***
Dealt to chiyuki [Kc 8s]
BlOnDhOlIc: folds 
seula i: folds 
silvno31: folds 
Th3Fog: folds 
kamikkaze: folds 
chiyuki: folds 
Ladyteazer: folds 
Suhoff76: folds 
Uncalled bet ($0.15) returned to RikkStroken
RikkStroken collected $0.20 from pot
RikkStroken: doesn't show hand 
*** SUMMARY ***
Total pot $0.20 | Rake $0 
Seat 1: Ladyteazer (button) folded before Flop (didn't bet)
Seat 2: Suhoff76 (small blind) folded before Flop
Seat 3: RikkStroken (big blind) collected ($0.20)
Seat 4: BlOnDhOlIc folded before Flop (didn't bet)
Seat 5: seula i folded before Flop (didn't bet)
Seat 6: silvno31 folded before Flop (didn't bet)
Seat 7: Th3Fog folded before Flop (didn't bet)
Seat 8: kamikkaze folded before Flop (didn't bet)
Seat 9: chiyuki folded before Flop (didn't bet)



PokerStars Zoom Hand #84299620370:  Hold'em No Limit ($0.10/$0.25) - 2012/08/05 14:31:48 JST [2012/08/05 1:31:48 ET]
Table 'Whirlpool' 9-max Seat #1 is the button
Seat 1: chiyuki ($48.46 in chips) 
Seat 2: Roglus ($78.20 in chips) 
Seat 3: Dejacob ($48.52 in chips) 
Seat 4: phate-1up ($33.97 in chips) 
Seat 5: kamikkaze ($15 in chips) 
Seat 6: Suhoff76 ($25 in chips) 
Seat 7: troms20 ($20.33 in chips) 
Seat 8: fuguangps ($25 in chips) 
Seat 9: yane73 ($21.88 in chips) 
Roglus: posts small blind $0.10
Dejacob: posts big blind $0.25
*** HOLE CARDS ***
Dealt to chiyuki [3c 7h]
phate-1up: folds 
kamikkaze: folds 
Suhoff76: folds 
troms20: folds 
fuguangps: folds 
yane73: folds 
chiyuki: folds 
Roglus: raises $0.50 to $0.75
Dejacob: folds 
Uncalled bet ($0.50) returned to Roglus
Roglus collected $0.50 from pot
Roglus: doesn't show hand 
*** SUMMARY ***
Total pot $0.50 | Rake $0 
Seat 1: chiyuki (button) folded before Flop (didn't bet)
Seat 2: Roglus (small blind) collected ($0.50)
Seat 3: Dejacob (big blind) folded before Flop
Seat 4: phate-1up folded before Flop (didn't bet)
Seat 5: kamikkaze folded before Flop (didn't bet)
Seat 6: Suhoff76 folded before Flop (didn't bet)
Seat 7: troms20 folded before Flop (didn't bet)
Seat 8: fuguangps folded before Flop (didn't bet)
Seat 9: yane73 folded before Flop (didn't bet)



PokerStars Zoom Hand #84299614968:  Hold'em No Limit ($0.10/$0.25) - 2012/08/05 14:31:25 JST [2012/08/05 1:31:25 ET]
Table 'Whirlpool' 9-max Seat #1 is the button
Seat 1: Dejacob ($48.52 in chips) 
Seat 2: chiyuki ($48.56 in chips) 
Seat 3: wtu1986 ($24.50 in chips) 
Seat 4: RikkStroken ($18.87 in chips) 
Seat 5: 4thepeople ($24.50 in chips) 
Seat 6: KCDOGG10 ($25 in chips) 
Seat 7: Perstenev ($12.65 in chips) 
Seat 8: ZhukOFFskI ($24.30 in chips) 
Seat 9: KeLevro0 ($8.73 in chips) 
chiyuki: posts small blind $0.10
wtu1986: posts big blind $0.25
*** HOLE CARDS ***
Dealt to chiyuki [5h 6d]
RikkStroken: folds 
4thepeople: folds 
KCDOGG10: folds 
Perstenev: raises $0.50 to $0.75
ZhukOFFskI: folds 
KeLevro0: calls $0.75
Dejacob: folds 
chiyuki: folds 
wtu1986: folds 
*** FLOP *** [Jh Qd Qs]
Perstenev: checks 
KeLevro0: bets $0.99
Perstenev: folds 
Uncalled bet ($0.99) returned to KeLevro0
KeLevro0 collected $1.77 from pot
KeLevro0: doesn't show hand 
*** SUMMARY ***
Total pot $1.85 | Rake $0.08 
Board [Jh Qd Qs]
Seat 1: Dejacob (button) folded before Flop (didn't bet)
Seat 2: chiyuki (small blind) folded before Flop
Seat 3: wtu1986 (big blind) folded before Flop
Seat 4: RikkStroken folded before Flop (didn't bet)
Seat 5: 4thepeople folded before Flop (didn't bet)
Seat 6: KCDOGG10 folded before Flop (didn't bet)
Seat 7: Perstenev folded on the Flop
Seat 8: ZhukOFFskI folded before Flop (didn't bet)
Seat 9: KeLevro0 collected ($1.77)



PokerStars Zoom Hand #84299623037:  Hold'em No Limit ($0.10/$0.25) - 2012/08/05 14:31:59 JST [2012/08/05 1:31:59 ET]
Table 'Whirlpool' 9-max Seat #1 is the button
Seat 1: fuguangps ($30.02 in chips) 
Seat 2: RikkStroken ($81.04 in chips) 
Seat 3: cofla tito ($11.55 in chips) 
Seat 4: el pore 5 ($17.91 in chips) 
Seat 5: Ladyteazer ($24.79 in chips) 
Seat 6: chiyuki ($48.46 in chips) 
Seat 7: phate-1up ($33.97 in chips) 
Seat 8: kamikkaze ($15 in chips) 
Seat 9: Th3Fog ($17.78 in chips) 
RikkStroken: posts small blind $0.10
cofla tito: posts big blind $0.25
*** HOLE CARDS ***
Dealt to chiyuki [9h 8h]
el pore 5: folds 
Ladyteazer: folds 
chiyuki: folds 
phate-1up: folds 
kamikkaze: folds 
Th3Fog: folds 
fuguangps: folds 
RikkStroken: folds 
Uncalled bet ($0.15) returned to cofla tito
cofla tito collected $0.20 from pot
cofla tito: doesn't show hand 
*** SUMMARY ***
Total pot $0.20 | Rake $0 
Seat 1: fuguangps (button) folded before Flop (didn't bet)
Seat 2: RikkStroken (small blind) folded before Flop
Seat 3: cofla tito (big blind) collected ($0.20)
Seat 4: el pore 5 folded before Flop (didn't bet)
Seat 5: Ladyteazer folded before Flop (didn't bet)
Seat 6: chiyuki folded before Flop (didn't bet)
Seat 7: phate-1up folded before Flop (didn't bet)
Seat 8: kamikkaze folded before Flop (didn't bet)
Seat 9: Th3Fog folded before Flop (didn't bet)



PokerStars Zoom Hand #84299615964:  Hold'em No Limit ($0.10/$0.25) - 2012/08/05 14:31:29 JST [2012/08/05 1:31:29 ET]
Table 'Whirlpool' 9-max Seat #1 is the button
Seat 1: Paranoix1990 ($12.37 in chips) 
Seat 2: seula i ($61.39 in chips) 
Seat 3: puffy5533 ($25.19 in chips) 
Seat 4: cofla tito ($11.65 in chips) 
Seat 5: 4thepeople ($24.50 in chips) 
Seat 6: chiyuki ($48.46 in chips) 
Seat 7: phate-1up ($26.81 in chips) 
Seat 8: Suhoff76 ($32.16 in chips) 
Seat 9: 1Karina1 ($25 in chips) 
seula i: posts small blind $0.10
puffy5533: posts big blind $0.25
*** HOLE CARDS ***
Dealt to chiyuki [5c Ac]
cofla tito: folds 
4thepeople: calls $0.25
chiyuki: folds 
phate-1up: folds 
Suhoff76: calls $0.25
1Karina1: raises $1 to $1.25
Paranoix1990: folds 
seula i: folds 
puffy5533: folds 
4thepeople: folds 
Suhoff76: folds 
Uncalled bet ($1) returned to 1Karina1
1Karina1 collected $1.10 from pot
1Karina1: doesn't show hand 
*** SUMMARY ***
Total pot $1.10 | Rake $0 
Seat 1: Paranoix1990 (button) folded before Flop (didn't bet)
Seat 2: seula i (small blind) folded before Flop
Seat 3: puffy5533 (big blind) folded before Flop
Seat 4: cofla tito folded before Flop (didn't bet)
Seat 5: 4thepeople folded before Flop
Seat 6: chiyuki folded before Flop (didn't bet)
Seat 7: phate-1up folded before Flop (didn't bet)
Seat 8: Suhoff76 folded before Flop
Seat 9: 1Karina1 collected ($1.10)



PokerStars Zoom Hand #84299621102:  Hold'em No Limit ($0.10/$0.25) - 2012/08/05 14:31:51 JST [2012/08/05 1:31:51 ET]
Table 'Whirlpool' 9-max Seat #1 is the button
Seat 1: Alvinpe85 ($49.51 in chips) 
Seat 2: 1Karina1 ($25.45 in chips) 
Seat 3: 4ydo yogurt ($10.36 in chips) 
Seat 4: simonzez ($54.18 in chips) 
Seat 5: BlOnDhOlIc ($37.43 in chips) 
Seat 6: JLajoie ($36.48 in chips) 
Seat 7: ChrisCDee ($64.61 in chips) 
Seat 8: chiyuki ($48.46 in chips) 
Seat 9: wtu1986 ($25 in chips) 
1Karina1: posts small blind $0.10
4ydo yogurt: posts big blind $0.25
*** HOLE CARDS ***
Dealt to chiyuki [4d 2c]
simonzez: folds 
BlOnDhOlIc: folds 
JLajoie: folds 
ChrisCDee: folds 
chiyuki: folds 
wtu1986: folds 
Alvinpe85 has timed out
Alvinpe85: folds 
1Karina1: folds 
Uncalled bet ($0.15) returned to 4ydo yogurt
4ydo yogurt collected $0.20 from pot
4ydo yogurt: doesn't show hand 
*** SUMMARY ***
Total pot $0.20 | Rake $0 
Seat 1: Alvinpe85 (button) folded before Flop (didn't bet)
Seat 2: 1Karina1 (small blind) folded before Flop
Seat 3: 4ydo yogurt (big blind) collected ($0.20)
Seat 4: simonzez folded before Flop (didn't bet)
Seat 5: BlOnDhOlIc folded before Flop (didn't bet)
Seat 6: JLajoie folded before Flop (didn't bet)
Seat 7: ChrisCDee folded before Flop (didn't bet)
Seat 8: chiyuki folded before Flop (didn't bet)
Seat 9: wtu1986 folded before Flop (didn't bet)



PokerStars Zoom Hand #84299624051:  Hold'em No Limit ($0.10/$0.25) - 2012/08/05 14:32:03 JST [2012/08/05 1:32:03 ET]
Table 'Whirlpool' 9-max Seat #1 is the button
Seat 1: Dejacob ($28.54 in chips) 
Seat 2: KeLevro0 ($12.07 in chips) 
Seat 3: seula i ($32.29 in chips) 
Seat 4: chiyuki ($48.46 in chips) 
Seat 5: Alvinpe85 ($64.04 in chips) 
Seat 6: roksmokndonk ($21.63 in chips) 
Seat 7: RikkStroken ($80.94 in chips) 
Seat 8: Nerkit ($16.22 in chips) 
Seat 9: Perstenev ($7.11 in chips) 
KeLevro0: posts small blind $0.10
seula i: posts big blind $0.25
*** HOLE CARDS ***
Dealt to chiyuki [5h Qh]
chiyuki: folds 
Alvinpe85: folds 
roksmokndonk: folds 
RikkStroken: folds 
Nerkit: folds 
Perstenev: folds 
Dejacob: folds 
KeLevro0: folds 
Uncalled bet ($0.15) returned to seula i
seula i collected $0.20 from pot
seula i: doesn't show hand 
*** SUMMARY ***
Total pot $0.20 | Rake $0 
Seat 1: Dejacob (button) folded before Flop (didn't bet)
Seat 2: KeLevro0 (small blind) folded before Flop
Seat 3: seula i (big blind) collected ($0.20)
Seat 4: chiyuki folded before Flop (didn't bet)
Seat 5: Alvinpe85 folded before Flop (didn't bet)
Seat 6: roksmokndonk folded before Flop (didn't bet)
Seat 7: RikkStroken folded before Flop (didn't bet)
Seat 8: Nerkit folded before Flop (didn't bet)
Seat 9: Perstenev folded before Flop (didn't bet)



PokerStars Zoom Hand #84299622068:  Hold'em No Limit ($0.10/$0.25) - 2012/08/05 14:31:55 JST [2012/08/05 1:31:55 ET]
Table 'Whirlpool' 9-max Seat #1 is the button
Seat 1: KeLevro0 ($12.07 in chips) 
Seat 2: 4plankton ($19.87 in chips) 
Seat 3: RikkStroken ($12.26 in chips) 
Seat 4: Dan Royal ($31.61 in chips) 
Seat 5: chiyuki ($48.46 in chips) 
Seat 6: Ladyteazer ($24.79 in chips) 
Seat 7: fuguangps ($25.60 in chips) 
Seat 8: DanielWhyte ($54.22 in chips) 
Seat 9: troms20 ($49.25 in chips) 
4plankton: posts small blind $0.10
RikkStroken: posts big blind $0.25
*** HOLE CARDS ***
Dealt to chiyuki [Jh 7h]
Dan Royal: raises $0.25 to $0.50
chiyuki: folds 
Ladyteazer: folds 
fuguangps: folds 
DanielWhyte: folds 
troms20: folds 
KeLevro0: folds 
4plankton: folds 
RikkStroken: calls $0.25
*** FLOP *** [Qs 8s Ks]
RikkStroken: checks 
Dan Royal: bets $1
RikkStroken: calls $1
*** TURN *** [Qs 8s Ks] [Js]
RikkStroken: checks 
Dan Royal: checks 
*** RIVER *** [Qs 8s Ks Js] [4c]
RikkStroken: bets $1.25
Dan Royal: calls $1.25
*** SHOW DOWN ***
RikkStroken: shows [Ts Ad] (a flush, King high)
Dan Royal: mucks hand 
RikkStroken collected $5.35 from pot
*** SUMMARY ***
Total pot $5.60 | Rake $0.25 
Board [Qs 8s Ks Js 4c]
Seat 1: KeLevro0 (button) folded before Flop (didn't bet)
Seat 2: 4plankton (small blind) folded before Flop
Seat 3: RikkStroken (big blind) showed [Ts Ad] and won ($5.35) with a flush, King high
Seat 4: Dan Royal mucked [Qh Qc]
Seat 5: chiyuki folded before Flop (didn't bet)
Seat 6: Ladyteazer folded before Flop (didn't bet)
Seat 7: fuguangps folded before Flop (didn't bet)
Seat 8: DanielWhyte folded before Flop (didn't bet)
Seat 9: troms20 folded before Flop (didn't bet)



PokerStars Zoom Hand #84299625283:  Hold'em No Limit ($0.10/$0.25) - 2012/08/05 14:32:08 JST [2012/08/05 1:32:08 ET]
Table 'Whirlpool' 9-max Seat #1 is the button
Seat 1: Roglus ($78.45 in chips) 
Seat 2: sparky5224 ($44.04 in chips) 
Seat 3: chiyuki ($48.46 in chips) 
Seat 4: Perstenev ($10.73 in chips) 
Seat 5: Th3Fog ($17.78 in chips) 
Seat 6: DanielWhyte ($54.22 in chips) 
Seat 7: loca-loca888 ($47.83 in chips) 
Seat 8: Dejacob ($36.16 in chips) 
Seat 9: Spartacus675 ($34.51 in chips) 
sparky5224: posts small blind $0.10
chiyuki: posts big blind $0.25
*** HOLE CARDS ***
Dealt to chiyuki [8s Kh]
Perstenev: calls $0.25
Th3Fog: folds 
DanielWhyte: folds 
loca-loca888: folds 
Dejacob: folds 
Spartacus675: folds 
Roglus: folds 
sparky5224: folds 
chiyuki: checks 
*** FLOP *** [3d 6s Qs]
chiyuki: checks 
Perstenev: checks 
*** TURN *** [3d 6s Qs] [5d]
chiyuki: checks 
Perstenev: bets $0.57
chiyuki: folds 
Uncalled bet ($0.57) returned to Perstenev
Perstenev collected $0.57 from pot
Perstenev: doesn't show hand 
*** SUMMARY ***
Total pot $0.60 | Rake $0.03 
Board [3d 6s Qs 5d]
Seat 1: Roglus (button) folded before Flop (didn't bet)
Seat 2: sparky5224 (small blind) folded before Flop
Seat 3: chiyuki (big blind) folded on the Turn
Seat 4: Perstenev collected ($0.57)
Seat 5: Th3Fog folded before Flop (didn't bet)
Seat 6: DanielWhyte folded before Flop (didn't bet)
Seat 7: loca-loca888 folded before Flop (didn't bet)
Seat 8: Dejacob folded before Flop (didn't bet)
Seat 9: Spartacus675 folded before Flop (didn't bet)



PokerStars Zoom Hand #84299637688:  Hold'em No Limit ($0.10/$0.25) - 2012/08/05 14:32:59 JST [2012/08/05 1:32:59 ET]
Table 'Whirlpool' 9-max Seat #1 is the button
Seat 1: seula i ($32.29 in chips) 
Seat 2: ll_LaMeR_ll ($73.18 in chips) 
Seat 3: Loholov ($15 in chips) 
Seat 4: deadmoneykid ($25.43 in chips) 
Seat 5: fuguangps ($25 in chips) 
Seat 6: cofla tito ($11.15 in chips) 
Seat 7: chiyuki ($48.21 in chips) 
Seat 8: stalkerec ($9.15 in chips) 
Seat 9: hl77777 ($9.40 in chips) 
ll_LaMeR_ll: posts small blind $0.10
Loholov: posts big blind $0.25
*** HOLE CARDS ***
Dealt to chiyuki [6h Th]
deadmoneykid has timed out
deadmoneykid: folds 
fuguangps: folds 
cofla tito: folds 
chiyuki: folds 
stalkerec: folds 
hl77777: folds 
seula i: folds 
ll_LaMeR_ll: raises $0.50 to $0.75
Loholov: raises $1 to $1.75
ll_LaMeR_ll: calls $1
*** FLOP *** [8s Td 2d]
ll_LaMeR_ll: bets $0.75
Loholov: raises $2 to $2.75
ll_LaMeR_ll: raises $4.15 to $6.90
Loholov: calls $4.15
*** TURN *** [8s Td 2d] [2s]
ll_LaMeR_ll: checks 
Loholov: checks 
*** RIVER *** [8s Td 2d 2s] [5d]
ll_LaMeR_ll: bets $6
Loholov said, "fish i pidaras"
Loholov: folds 
Uncalled bet ($6) returned to ll_LaMeR_ll
ll_LaMeR_ll said, "lol"
ll_LaMeR_ll collected $16.52 from pot
ll_LaMeR_ll: doesn't show hand 
*** SUMMARY ***
Total pot $17.30 | Rake $0.78 
Board [8s Td 2d 2s 5d]
Seat 1: seula i (button) folded before Flop (didn't bet)
Seat 2: ll_LaMeR_ll (small blind) collected ($16.52)
Seat 3: Loholov (big blind) folded on the River
Seat 4: deadmoneykid folded before Flop (didn't bet)
Seat 5: fuguangps folded before Flop (didn't bet)
Seat 6: cofla tito folded before Flop (didn't bet)
Seat 7: chiyuki folded before Flop (didn't bet)
Seat 8: stalkerec folded before Flop (didn't bet)
Seat 9: hl77777 folded before Flop (didn't bet)



PokerStars Zoom Hand #84299639460:  Hold'em No Limit ($0.10/$0.25) - 2012/08/05 14:33:06 JST [2012/08/05 1:33:06 ET]
Table 'Whirlpool' 9-max Seat #1 is the button
Seat 1: Suhoff76 ($30.08 in chips) 
Seat 2: chiyuki ($48.21 in chips) 
Seat 3: Vahe50 ($27.16 in chips) 
Seat 4: Dan Royal ($28.11 in chips) 
Seat 5: seula i ($32.29 in chips) 
Seat 6: KrystalAA ($12.60 in chips) 
Seat 7: taksist889 ($20.31 in chips) 
Seat 8: JLajoie ($26.15 in chips) 
Seat 9: WARIBANA7777 ($16.88 in chips) 
chiyuki: posts small blind $0.10
Vahe50: posts big blind $0.25
*** HOLE CARDS ***
Dealt to chiyuki [Qd Qh]
Dan Royal: folds 
seula i: folds 
KrystalAA: raises $0.46 to $0.71
taksist889: calls $0.71
JLajoie: folds 
WARIBANA7777: folds 
Suhoff76: folds 
chiyuki: raises $1.71 to $2.42
Vahe50: folds 
KrystalAA: calls $1.71
taksist889: calls $1.71
*** FLOP *** [4s Kc 6d]
chiyuki: checks 
KrystalAA: checks 
taksist889: checks 
*** TURN *** [4s Kc 6d] [3h]
chiyuki: bets $3.58
KrystalAA: calls $3.58
taksist889: folds 
*** RIVER *** [4s Kc 6d 3h] [5h]
chiyuki: checks 
KrystalAA: bets $6.60 and is all-in
chiyuki: calls $6.60
*** SHOW DOWN ***
KrystalAA: shows [6c 6h] (three of a kind, Sixes)
chiyuki: mucks hand 
KrystalAA collected $26.62 from pot
*** SUMMARY ***
Total pot $27.87 | Rake $1.25 
Board [4s Kc 6d 3h 5h]
Seat 1: Suhoff76 (button) folded before Flop (didn't bet)
Seat 2: chiyuki (small blind) mucked [Qd Qh]
Seat 3: Vahe50 (big blind) folded before Flop
Seat 4: Dan Royal folded before Flop (didn't bet)
Seat 5: seula i folded before Flop (didn't bet)
Seat 6: KrystalAA showed [6c 6h] and won ($26.62) with three of a kind, Sixes
Seat 7: taksist889 folded on the Turn
Seat 8: JLajoie folded before Flop (didn't bet)
Seat 9: WARIBANA7777 folded before Flop (didn't bet)



PokerStars Zoom Hand #84299665451:  Hold'em No Limit ($0.10/$0.25) - 2012/08/05 14:34:52 JST [2012/08/05 1:34:52 ET]
Table 'Whirlpool' 9-max Seat #1 is the button
Seat 1: Alvinpe85 ($49.26 in chips) 
Seat 2: Suhoff76 ($25.55 in chips) 
Seat 3: troms20 ($48.05 in chips) 
Seat 4: ChrisCDee ($68.46 in chips) 
Seat 5: KrystalAA ($26.62 in chips) 
Seat 6: seula i ($28.53 in chips) 
Seat 7: KeLevro0 ($10 in chips) 
Seat 8: WARIBANA7777 ($15.88 in chips) 
Seat 9: chiyuki ($35.61 in chips) 
Suhoff76: posts small blind $0.10
troms20: posts big blind $0.25
*** HOLE CARDS ***
Dealt to chiyuki [9s As]
ChrisCDee: folds 
KrystalAA: folds 
seula i: folds 
KeLevro0: folds 
WARIBANA7777: folds 
chiyuki: folds 
Alvinpe85: raises $0.37 to $0.62
Suhoff76: folds 
troms20: folds 
Uncalled bet ($0.37) returned to Alvinpe85
Alvinpe85 collected $0.60 from pot
Alvinpe85: doesn't show hand 
*** SUMMARY ***
Total pot $0.60 | Rake $0 
Seat 1: Alvinpe85 (button) collected ($0.60)
Seat 2: Suhoff76 (small blind) folded before Flop
Seat 3: troms20 (big blind) folded before Flop
Seat 4: ChrisCDee folded before Flop (didn't bet)
Seat 5: KrystalAA folded before Flop (didn't bet)
Seat 6: seula i folded before Flop (didn't bet)
Seat 7: KeLevro0 folded before Flop (didn't bet)
Seat 8: WARIBANA7777 folded before Flop (didn't bet)
Seat 9: chiyuki folded before Flop (didn't bet)



PokerStars Zoom Hand #84299664720:  Hold'em No Limit ($0.10/$0.25) - 2012/08/05 14:34:49 JST [2012/08/05 1:34:49 ET]
Table 'Whirlpool' 9-max Seat #1 is the button
Seat 1: KeLevro0 ($9.10 in chips) 
Seat 2: Ellen1947 ($31.97 in chips) 
Seat 3: fuguangps ($26.42 in chips) 
Seat 4: chiyuki ($35.61 in chips) 
Seat 5: Dejacob ($35.41 in chips) 
Seat 6: Walturrr ($23.90 in chips) 
Seat 7: Perstenev ($8.76 in chips) 
Seat 8: seula i ($34.06 in chips) 
Seat 9: BlOnDhOlIc ($37.87 in chips) 
Ellen1947: posts small blind $0.10
fuguangps: posts big blind $0.25
*** HOLE CARDS ***
Dealt to chiyuki [Th 8d]
chiyuki: folds 
Dejacob: folds 
Walturrr: folds 
Perstenev: raises $0.50 to $0.75
seula i: folds 
BlOnDhOlIc: folds 
KeLevro0: calls $0.75
Ellen1947: folds 
fuguangps: folds 
*** FLOP *** [3c Jh Kh]
Perstenev: bets $1.32
KeLevro0: folds 
Uncalled bet ($1.32) returned to Perstenev
Perstenev collected $1.77 from pot
Perstenev: doesn't show hand 
*** SUMMARY ***
Total pot $1.85 | Rake $0.08 
Board [3c Jh Kh]
Seat 1: KeLevro0 (button) folded on the Flop
Seat 2: Ellen1947 (small blind) folded before Flop
Seat 3: fuguangps (big blind) folded before Flop
Seat 4: chiyuki folded before Flop (didn't bet)
Seat 5: Dejacob folded before Flop (didn't bet)
Seat 6: Walturrr folded before Flop (didn't bet)
Seat 7: Perstenev collected ($1.77)
Seat 8: seula i folded before Flop (didn't bet)
Seat 9: BlOnDhOlIc folded before Flop (didn't bet)



PokerStars Zoom Hand #84299668417:  Hold'em No Limit ($0.10/$0.25) - 2012/08/05 14:35:04 JST [2012/08/05 1:35:04 ET]
Table 'Whirlpool' 9-max Seat #1 is the button
Seat 1: puffy5533 ($24.94 in chips) 
Seat 2: sparky5224 ($43.44 in chips) 
Seat 3: Nerkit ($12.50 in chips) 
Seat 4: 4ydo yogurt ($11.41 in chips) 
Seat 5: Loholov ($15 in chips) 
Seat 6: fuguangps ($25.27 in chips) 
Seat 7: dushvan ($47.24 in chips) 
Seat 8: chiyuki ($35.61 in chips) 
Seat 9: bigred1102 ($24.75 in chips) 
sparky5224: posts small blind $0.10
Nerkit: posts big blind $0.25
*** HOLE CARDS ***
Dealt to chiyuki [5c Kd]
4ydo yogurt: folds 
Loholov: folds 
fuguangps: folds 
dushvan: folds 
chiyuki: folds 
bigred1102: raises $0.25 to $0.50
puffy5533: folds 
sparky5224: folds 
Nerkit: calls $0.25
*** FLOP *** [9h Tc 3d]
Nerkit: checks 
bigred1102: bets $0.50
Nerkit: calls $0.50
*** TURN *** [9h Tc 3d] [7d]
Nerkit: checks 
bigred1102: bets $0.75
Nerkit: folds 
Uncalled bet ($0.75) returned to bigred1102
bigred1102 collected $2.01 from pot
bigred1102: doesn't show hand 
*** SUMMARY ***
Total pot $2.10 | Rake $0.09 
Board [9h Tc 3d 7d]
Seat 1: puffy5533 (button) folded before Flop (didn't bet)
Seat 2: sparky5224 (small blind) folded before Flop
Seat 3: Nerkit (big blind) folded on the Turn
Seat 4: 4ydo yogurt folded before Flop (didn't bet)
Seat 5: Loholov folded before Flop (didn't bet)
Seat 6: fuguangps folded before Flop (didn't bet)
Seat 7: dushvan folded before Flop (didn't bet)
Seat 8: chiyuki folded before Flop (didn't bet)
Seat 9: bigred1102 collected ($2.01)



PokerStars Zoom Hand #84299667168:  Hold'em No Limit ($0.10/$0.25) - 2012/08/05 14:34:59 JST [2012/08/05 1:34:59 ET]
Table 'Whirlpool' 9-max Seat #1 is the button
Seat 1: RikkStroken ($36.38 in chips) 
Seat 2: ChrisCDee ($68.46 in chips) 
Seat 3: wtu1986 ($25 in chips) 
Seat 4: sparky5224 ($43.44 in chips) 
Seat 5: chiyuki ($35.61 in chips) 
Seat 6: JLajoie ($45.30 in chips) 
Seat 7: KrystalAA ($15.26 in chips) 
Seat 8: Suhoff76 ($26.36 in chips) 
Seat 9: Walturrr ($23.90 in chips) 
ChrisCDee: posts small blind $0.10
wtu1986: posts big blind $0.25
*** HOLE CARDS ***
Dealt to chiyuki [Ac 9h]
sparky5224: folds 
chiyuki: folds 
JLajoie: folds 
KrystalAA: folds 
Suhoff76: folds 
Walturrr: raises $0.47 to $0.72
RikkStroken: folds 
ChrisCDee: folds 
wtu1986: calls $0.47
*** FLOP *** [Js 3d 6d]
wtu1986: checks 
Walturrr: bets $0.85
wtu1986: folds 
Uncalled bet ($0.85) returned to Walturrr
Walturrr collected $1.47 from pot
Walturrr: doesn't show hand 
*** SUMMARY ***
Total pot $1.54 | Rake $0.07 
Board [Js 3d 6d]
Seat 1: RikkStroken (button) folded before Flop (didn't bet)
Seat 2: ChrisCDee (small blind) folded before Flop
Seat 3: wtu1986 (big blind) folded on the Flop
Seat 4: sparky5224 folded before Flop (didn't bet)
Seat 5: chiyuki folded before Flop (didn't bet)
Seat 6: JLajoie folded before Flop (didn't bet)
Seat 7: KrystalAA folded before Flop (didn't bet)
Seat 8: Suhoff76 folded before Flop (didn't bet)
Seat 9: Walturrr collected ($1.47)



PokerStars Zoom Hand #84299669151:  Hold'em No Limit ($0.10/$0.25) - 2012/08/05 14:35:07 JST [2012/08/05 1:35:07 ET]
Table 'Whirlpool' 9-max Seat #1 is the button
Seat 1: ZhukOFFskI ($23.60 in chips) 
Seat 2: ygoegoe ($25.02 in chips) 
Seat 3: chiyuki ($35.61 in chips) 
Seat 4: GovGus ($25.35 in chips) 
Seat 5: Jene4kaBest ($13.45 in chips) 
Seat 6: 4thepeople ($27.66 in chips) 
Seat 7: Vahe50 ($26.81 in chips) 
Seat 8: Dejacob ($35.41 in chips) 
Seat 9: Perstenev ($10.72 in chips) 
ygoegoe: posts small blind $0.10
chiyuki: posts big blind $0.25
*** HOLE CARDS ***
Dealt to chiyuki [Ad Qc]
GovGus: folds 
Jene4kaBest: folds 
4thepeople: folds 
Vahe50: folds 
Dejacob: folds 
Perstenev: folds 
ZhukOFFskI: raises $0.50 to $0.75
ygoegoe: folds 
chiyuki: raises $1.50 to $2.25
ZhukOFFskI: calls $1.50
*** FLOP *** [3c 3d Ah]
chiyuki: bets $2.25
ZhukOFFskI: folds 
Uncalled bet ($2.25) returned to chiyuki
chiyuki collected $4.39 from pot
chiyuki: doesn't show hand 
*** SUMMARY ***
Total pot $4.60 | Rake $0.21 
Board [3c 3d Ah]
Seat 1: ZhukOFFskI (button) folded on the Flop
Seat 2: ygoegoe (small blind) folded before Flop
Seat 3: chiyuki (big blind) collected ($4.39)
Seat 4: GovGus folded before Flop (didn't bet)
Seat 5: Jene4kaBest folded before Flop (didn't bet)
Seat 6: 4thepeople folded before Flop (didn't bet)
Seat 7: Vahe50 folded before Flop (didn't bet)
Seat 8: Dejacob folded before Flop (didn't bet)
Seat 9: Perstenev folded before Flop (didn't bet)



PokerStars Zoom Hand #84299681531:  Hold'em No Limit ($0.10/$0.25) - 2012/08/05 14:35:58 JST [2012/08/05 1:35:58 ET]
Table 'Whirlpool' 9-max Seat #1 is the button
Seat 1: chiyuki ($37.75 in chips) 
Seat 2: fuguangps ($30.27 in chips) 
Seat 3: Lasutchik ($73.72 in chips) 
Seat 4: wtu1986 ($25 in chips) 
Seat 5: hl77777 ($12.40 in chips) 
Seat 6: wildy29 ($11.31 in chips) 
Seat 7: Jene4kaBest ($13.35 in chips) 
Seat 8: Ellen1947 ($31.87 in chips) 
Seat 9: deadmoneykid ($28.94 in chips) 
fuguangps: posts small blind $0.10
Lasutchik: posts big blind $0.25
*** HOLE CARDS ***
Dealt to chiyuki [Jc 9d]
wtu1986: folds 
hl77777: folds 
wildy29: folds 
Jene4kaBest: folds 
Ellen1947: folds 
deadmoneykid: folds 
chiyuki: folds 
fuguangps: folds 
Uncalled bet ($0.15) returned to Lasutchik
Lasutchik collected $0.20 from pot
Lasutchik: doesn't show hand 
*** SUMMARY ***
Total pot $0.20 | Rake $0 
Seat 1: chiyuki (button) folded before Flop (didn't bet)
Seat 2: fuguangps (small blind) folded before Flop
Seat 3: Lasutchik (big blind) collected ($0.20)
Seat 4: wtu1986 folded before Flop (didn't bet)
Seat 5: hl77777 folded before Flop (didn't bet)
Seat 6: wildy29 folded before Flop (didn't bet)
Seat 7: Jene4kaBest folded before Flop (didn't bet)
Seat 8: Ellen1947 folded before Flop (didn't bet)
Seat 9: deadmoneykid folded before Flop (didn't bet)



PokerStars Zoom Hand #84299682744:  Hold'em No Limit ($0.10/$0.25) - 2012/08/05 14:36:03 JST [2012/08/05 1:36:03 ET]
Table 'Whirlpool' 9-max Seat #1 is the button
Seat 1: silvno31 ($26.94 in chips) 
Seat 2: RikkStroken ($82.20 in chips) 
Seat 3: Ellen1947 ($31.87 in chips) 
Seat 4: Jene4kaBest ($13.35 in chips) 
Seat 5: igor*gemert ($24.40 in chips) 
Seat 6: phate-1up ($26.84 in chips) 
Seat 7: chiyuki ($37.75 in chips) 
Seat 8: Nerkit ($11.40 in chips) 
Seat 9: ZhukOFFskI ($29.23 in chips) 
RikkStroken: posts small blind $0.10
Ellen1947: posts big blind $0.25
*** HOLE CARDS ***
Dealt to chiyuki [7c As]
Jene4kaBest: folds 
igor*gemert: folds 
phate-1up: folds 
chiyuki: folds 
Nerkit: folds 
ZhukOFFskI: folds 
silvno31: raises $0.50 to $0.75
RikkStroken: folds 
Ellen1947: folds 
Uncalled bet ($0.50) returned to silvno31
silvno31 collected $0.60 from pot
silvno31: doesn't show hand 
*** SUMMARY ***
Total pot $0.60 | Rake $0 
Seat 1: silvno31 (button) collected ($0.60)
Seat 2: RikkStroken (small blind) folded before Flop
Seat 3: Ellen1947 (big blind) folded before Flop
Seat 4: Jene4kaBest folded before Flop (didn't bet)
Seat 5: igor*gemert folded before Flop (didn't bet)
Seat 6: phate-1up folded before Flop (didn't bet)
Seat 7: chiyuki folded before Flop (didn't bet)
Seat 8: Nerkit folded before Flop (didn't bet)
Seat 9: ZhukOFFskI folded before Flop (didn't bet)



PokerStars Zoom Hand #84299683974:  Hold'em No Limit ($0.10/$0.25) - 2012/08/05 14:36:08 JST [2012/08/05 1:36:08 ET]
Table 'Whirlpool' 9-max Seat #1 is the button
Seat 1: Vahe50 ($26.46 in chips) 
Seat 2: igor*gemert ($24.40 in chips) 
Seat 3: ZhukOFFskI ($29.23 in chips) 
Seat 4: Loholov ($15.75 in chips) 
Seat 5: BlOnDhOlIc ($80.74 in chips) 
Seat 6: chiyuki ($37.75 in chips) 
Seat 7: Perstenev ($10.37 in chips) 
Seat 8: Wilcox76607 ($14.30 in chips) 
Seat 9: fuguangps ($25 in chips) 
igor*gemert: posts small blind $0.10
ZhukOFFskI: posts big blind $0.25
*** HOLE CARDS ***
Dealt to chiyuki [7c 9s]
Loholov: folds 
BlOnDhOlIc: folds 
chiyuki: folds 
Perstenev: folds 
Wilcox76607: folds 
fuguangps: raises $0.50 to $0.75
Vahe50: folds 
igor*gemert: folds 
ZhukOFFskI: folds 
Uncalled bet ($0.50) returned to fuguangps
fuguangps collected $0.60 from pot
fuguangps: doesn't show hand 
*** SUMMARY ***
Total pot $0.60 | Rake $0 
Seat 1: Vahe50 (button) folded before Flop (didn't bet)
Seat 2: igor*gemert (small blind) folded before Flop
Seat 3: ZhukOFFskI (big blind) folded before Flop
Seat 4: Loholov folded before Flop (didn't bet)
Seat 5: BlOnDhOlIc folded before Flop (didn't bet)
Seat 6: chiyuki folded before Flop (didn't bet)
Seat 7: Perstenev folded before Flop (didn't bet)
Seat 8: Wilcox76607 folded before Flop (didn't bet)
Seat 9: fuguangps collected ($0.60)



PokerStars Zoom Hand #84299685703:  Hold'em No Limit ($0.10/$0.25) - 2012/08/05 14:36:15 JST [2012/08/05 1:36:15 ET]
Table 'Whirlpool' 9-max Seat #1 is the button
Seat 1: GovGus ($25 in chips) 
Seat 2: chiyuki ($37.75 in chips) 
Seat 3: Suhoff76 ($27.11 in chips) 
Seat 4: phate-1up ($26.84 in chips) 
Seat 5: igor*gemert ($24.30 in chips) 
Seat 6: Nerkit ($11.40 in chips) 
Seat 7: Dejacob ($35.06 in chips) 
Seat 8: deadmoneykid ($28.94 in chips) 
Seat 9: Jene4kaBest ($13.35 in chips) 
chiyuki: posts small blind $0.10
Suhoff76: posts big blind $0.25
*** HOLE CARDS ***
Dealt to chiyuki [Qh 5c]
phate-1up: folds 
igor*gemert: calls $0.25
Nerkit: folds 
Dejacob: folds 
deadmoneykid: folds 
Jene4kaBest: folds 
GovGus: folds 
chiyuki: folds 
Suhoff76: checks 
*** FLOP *** [Kc 4c Qc]
Suhoff76: checks 
igor*gemert: bets $0.70
Suhoff76: folds 
Uncalled bet ($0.70) returned to igor*gemert
igor*gemert collected $0.57 from pot
igor*gemert: doesn't show hand 
*** SUMMARY ***
Total pot $0.60 | Rake $0.03 
Board [Kc 4c Qc]
Seat 1: GovGus (button) folded before Flop (didn't bet)
Seat 2: chiyuki (small blind) folded before Flop
Seat 3: Suhoff76 (big blind) folded on the Flop
Seat 4: phate-1up folded before Flop (didn't bet)
Seat 5: igor*gemert collected ($0.57)
Seat 6: Nerkit folded before Flop (didn't bet)
Seat 7: Dejacob folded before Flop (didn't bet)
Seat 8: deadmoneykid folded before Flop (didn't bet)
Seat 9: Jene4kaBest folded before Flop (didn't bet)



PokerStars Zoom Hand #84299689565:  Hold'em No Limit ($0.10/$0.25) - 2012/08/05 14:36:32 JST [2012/08/05 1:36:32 ET]
Table 'Whirlpool' 9-max Seat #1 is the button
Seat 1: phate-1up ($40.81 in chips) 
Seat 2: mariuka1 ($7.13 in chips) 
Seat 3: Perstenev ($10.27 in chips) 
Seat 4: troms20 ($47.45 in chips) 
Seat 5: chiyuki ($37.65 in chips) 
Seat 6: RikkStroken ($14.08 in chips) 
Seat 7: ChrisCDee ($25 in chips) 
Seat 8: wtu1986 ($24.90 in chips) 
Seat 9: cr0lox ($25.12 in chips) 
mariuka1: posts small blind $0.10
Perstenev: posts big blind $0.25
*** HOLE CARDS ***
Dealt to chiyuki [Qs 8h]
troms20: folds 
chiyuki: folds 
RikkStroken: folds 
ChrisCDee: folds 
wtu1986: folds 
cr0lox: folds 
phate-1up: folds 
mariuka1: folds 
Uncalled bet ($0.15) returned to Perstenev
Perstenev collected $0.20 from pot
Perstenev: doesn't show hand 
*** SUMMARY ***
Total pot $0.20 | Rake $0 
Seat 1: phate-1up (button) folded before Flop (didn't bet)
Seat 2: mariuka1 (small blind) folded before Flop
Seat 3: Perstenev (big blind) collected ($0.20)
Seat 4: troms20 folded before Flop (didn't bet)
Seat 5: chiyuki folded before Flop (didn't bet)
Seat 6: RikkStroken folded before Flop (didn't bet)
Seat 7: ChrisCDee folded before Flop (didn't bet)
Seat 8: wtu1986 folded before Flop (didn't bet)
Seat 9: cr0lox folded before Flop (didn't bet)



PokerStars Zoom Hand #84299692277:  Hold'em No Limit ($0.10/$0.25) - 2012/08/05 14:36:43 JST [2012/08/05 1:36:43 ET]
Table 'Whirlpool' 9-max Seat #1 is the button
Seat 1: ZhukOFFskI ($21.10 in chips) 
Seat 2: wildy29 ($10.81 in chips) 
Seat 3: Walturrr ($24.28 in chips) 
Seat 4: peng2astic ($14 in chips) 
Seat 5: Perstenev ($8.28 in chips) 
Seat 6: fuguangps ($26.09 in chips) 
Seat 7: KrystalAA ($9.05 in chips) 
Seat 8: chiyuki ($37.65 in chips) 
Seat 9: KeLevro0 ($9.08 in chips) 
wildy29: posts small blind $0.10
Walturrr: posts big blind $0.25
*** HOLE CARDS ***
Dealt to chiyuki [8s 3c]
peng2astic: folds 
Perstenev: folds 
fuguangps: folds 
KrystalAA: raises $0.46 to $0.71
chiyuki: folds 
KeLevro0: folds 
ZhukOFFskI: folds 
wildy29: folds 
Walturrr: folds 
Uncalled bet ($0.46) returned to KrystalAA
KrystalAA collected $0.60 from pot
KrystalAA: doesn't show hand 
*** SUMMARY ***
Total pot $0.60 | Rake $0 
Seat 1: ZhukOFFskI (button) folded before Flop (didn't bet)
Seat 2: wildy29 (small blind) folded before Flop
Seat 3: Walturrr (big blind) folded before Flop
Seat 4: peng2astic folded before Flop (didn't bet)
Seat 5: Perstenev folded before Flop (didn't bet)
Seat 6: fuguangps folded before Flop (didn't bet)
Seat 7: KrystalAA collected ($0.60)
Seat 8: chiyuki folded before Flop (didn't bet)
Seat 9: KeLevro0 folded before Flop (didn't bet)



PokerStars Zoom Hand #84299688582:  Hold'em No Limit ($0.10/$0.25) - 2012/08/05 14:36:28 JST [2012/08/05 1:36:28 ET]
Table 'Whirlpool' 9-max Seat #1 is the button
Seat 1: caro196661cv ($40.85 in chips) 
Seat 2: cofla tito ($10.40 in chips) 
Seat 3: led52 ($12.50 in chips) 
Seat 4: stalkerec ($7.84 in chips) 
Seat 5: deadmoneykid ($28.94 in chips) 
Seat 6: Nerkit ($11.52 in chips) 
Seat 7: mariuka1 ($7.13 in chips) 
Seat 8: Vahe50 ($26.46 in chips) 
Seat 9: chiyuki ($37.65 in chips) 
cofla tito: posts small blind $0.10
led52: posts big blind $0.25
*** HOLE CARDS ***
Dealt to chiyuki [6h 7c]
stalkerec: folds 
deadmoneykid: folds 
Nerkit: folds 
mariuka1: folds 
Vahe50: raises $0.25 to $0.50
chiyuki: folds 
caro196661cv: folds 
cofla tito: folds 
led52: folds 
Uncalled bet ($0.25) returned to Vahe50
Vahe50 collected $0.60 from pot
Vahe50: doesn't show hand 
*** SUMMARY ***
Total pot $0.60 | Rake $0 
Seat 1: caro196661cv (button) folded before Flop (didn't bet)
Seat 2: cofla tito (small blind) folded before Flop
Seat 3: led52 (big blind) folded before Flop
Seat 4: stalkerec folded before Flop (didn't bet)
Seat 5: deadmoneykid folded before Flop (didn't bet)
Seat 6: Nerkit folded before Flop (didn't bet)
Seat 7: mariuka1 folded before Flop (didn't bet)
Seat 8: Vahe50 collected ($0.60)
Seat 9: chiyuki folded before Flop (didn't bet)



PokerStars Zoom Hand #84299691106:  Hold'em No Limit ($0.10/$0.25) - 2012/08/05 14:36:38 JST [2012/08/05 1:36:38 ET]
Table 'Whirlpool' 9-max Seat #1 is the button
Seat 1: ZhukOFFskI ($32.46 in chips) 
Seat 2: KCDOGG10 ($22.57 in chips) 
Seat 3: Jene4kaBest ($13.35 in chips) 
Seat 4: chiyuki ($37.65 in chips) 
Seat 5: BlOnDhOlIc ($84.70 in chips) 
Seat 6: ChrisCDee ($25 in chips) 
Seat 7: Suhoff76 ($28.97 in chips) 
Seat 8: cr0lox ($25.12 in chips) 
Seat 9: Dejacob ($34.96 in chips) 
KCDOGG10: posts small blind $0.10
Jene4kaBest: posts big blind $0.25
*** HOLE CARDS ***
Dealt to chiyuki [3s As]
chiyuki: folds 
BlOnDhOlIc: folds 
ChrisCDee: folds 
Suhoff76: raises $0.32 to $0.57
cr0lox: folds 
Dejacob: calls $0.57
ZhukOFFskI: folds 
KCDOGG10: folds 
Jene4kaBest: folds 
*** FLOP *** [4d 8c 5h]
Suhoff76: checks 
Dejacob: checks 
*** TURN *** [4d 8c 5h] [8h]
Suhoff76: checks 
Dejacob: bets $1
Suhoff76: folds 
Uncalled bet ($1) returned to Dejacob
Dejacob collected $1.42 from pot
Dejacob: doesn't show hand 
*** SUMMARY ***
Total pot $1.49 | Rake $0.07 
Board [4d 8c 5h 8h]
Seat 1: ZhukOFFskI (button) folded before Flop (didn't bet)
Seat 2: KCDOGG10 (small blind) folded before Flop
Seat 3: Jene4kaBest (big blind) folded before Flop
Seat 4: chiyuki folded before Flop (didn't bet)
Seat 5: BlOnDhOlIc folded before Flop (didn't bet)
Seat 6: ChrisCDee folded before Flop (didn't bet)
Seat 7: Suhoff76 folded on the Turn
Seat 8: cr0lox folded before Flop (didn't bet)
Seat 9: Dejacob collected ($1.42)



PokerStars Zoom Hand #84299694489:  Hold'em No Limit ($0.10/$0.25) - 2012/08/05 14:36:52 JST [2012/08/05 1:36:52 ET]
Table 'Whirlpool' 9-max Seat #1 is the button
Seat 1: ZhukOFFskI ($28.88 in chips) 
Seat 2: Dejacob ($25 in chips) 
Seat 3: chiyuki ($37.65 in chips) 
Seat 4: znake77 ($7.02 in chips) 
Seat 5: Jene4kaBest ($13.10 in chips) 
Seat 6: phate-1up ($37.50 in chips) 
Seat 7: Perstenev ($9.08 in chips) 
Seat 8: KCDOGG10 ($22.47 in chips) 
Seat 9: KeLevro0 ($8 in chips) 
Dejacob: posts small blind $0.10
chiyuki: posts big blind $0.25
*** HOLE CARDS ***
Dealt to chiyuki [7h 9c]
znake77: folds 
Jene4kaBest: folds 
phate-1up: folds 
Perstenev: folds 
KCDOGG10: raises $0.50 to $0.75
KeLevro0: folds 
ZhukOFFskI: folds 
Dejacob: calls $0.65
chiyuki: folds 
*** FLOP *** [Th 6c Kc]
Dejacob: checks 
KCDOGG10: bets $1
Dejacob: calls $1
*** TURN *** [Th 6c Kc] [Qh]
Dejacob: checks 
KCDOGG10: checks 
*** RIVER *** [Th 6c Kc Qh] [2c]
Dejacob: checks 
KCDOGG10: checks 
*** SHOW DOWN ***
Dejacob: shows [Ts Ac] (a pair of Tens)
KCDOGG10: mucks hand 
Dejacob collected $3.58 from pot
*** SUMMARY ***
Total pot $3.75 | Rake $0.17 
Board [Th 6c Kc Qh 2c]
Seat 1: ZhukOFFskI (button) folded before Flop (didn't bet)
Seat 2: Dejacob (small blind) showed [Ts Ac] and won ($3.58) with a pair of Tens
Seat 3: chiyuki (big blind) folded before Flop
Seat 4: znake77 folded before Flop (didn't bet)
Seat 5: Jene4kaBest folded before Flop (didn't bet)
Seat 6: phate-1up folded before Flop (didn't bet)
Seat 7: Perstenev folded before Flop (didn't bet)
Seat 8: KCDOGG10 mucked [7d 2d]
Seat 9: KeLevro0 folded before Flop (didn't bet)



PokerStars Zoom Hand #84299700779:  Hold'em No Limit ($0.10/$0.25) - 2012/08/05 14:37:17 JST [2012/08/05 1:37:17 ET]
Table 'Whirlpool' 9-max Seat #1 is the button
Seat 1: WARIBANA7777 ($15.61 in chips) 
Seat 2: seula i ($31.89 in chips) 
Seat 3: roksmokndonk ($23.58 in chips) 
Seat 4: KeLevro0 ($7.90 in chips) 
Seat 5: phate-1up ($40.81 in chips) 
Seat 6: Landybob ($40.31 in chips) 
Seat 7: chiyuki ($37.40 in chips) 
Seat 8: GovGus ($26.48 in chips) 
Seat 9: stalkerec ($6.99 in chips) 
seula i: posts small blind $0.10
roksmokndonk: posts big blind $0.25
*** HOLE CARDS ***
Dealt to chiyuki [Kd 7s]
KeLevro0: folds 
phate-1up: folds 
Landybob: folds 
chiyuki: folds 
GovGus: folds 
stalkerec: folds 
WARIBANA7777: folds 
seula i: raises $0.50 to $0.75
roksmokndonk: calls $0.50
*** FLOP *** [Th 9d 2d]
seula i: checks 
roksmokndonk: checks 
*** TURN *** [Th 9d 2d] [Qs]
seula i: checks 
roksmokndonk: checks 
*** RIVER *** [Th 9d 2d Qs] [6s]
seula i: checks 
roksmokndonk: checks 
*** SHOW DOWN ***
seula i: shows [Ac Jh] (high card Ace)
roksmokndonk: shows [Jd Ah] (high card Ace)
seula i collected $0.72 from pot
roksmokndonk collected $0.71 from pot
seula i is disconnected 
*** SUMMARY ***
Total pot $1.50 | Rake $0.07 
Board [Th 9d 2d Qs 6s]
Seat 1: WARIBANA7777 (button) folded before Flop (didn't bet)
Seat 2: seula i (small blind) showed [Ac Jh] and won ($0.72) with high card Ace
Seat 3: roksmokndonk (big blind) showed [Jd Ah] and won ($0.71) with high card Ace
Seat 4: KeLevro0 folded before Flop (didn't bet)
Seat 5: phate-1up folded before Flop (didn't bet)
Seat 6: Landybob folded before Flop (didn't bet)
Seat 7: chiyuki folded before Flop (didn't bet)
Seat 8: GovGus folded before Flop (didn't bet)
Seat 9: stalkerec folded before Flop (didn't bet)



PokerStars Zoom Hand #84299708397:  Hold'em No Limit ($0.10/$0.25) - 2012/08/05 14:37:49 JST [2012/08/05 1:37:49 ET]
Table 'Whirlpool' 9-max Seat #1 is the button
Seat 1: KAKamiro ($25.91 in chips) 
Seat 2: hl77777 ($12.15 in chips) 
Seat 3: WARIBANA7777 ($15.61 in chips) 
Seat 4: RikkStroken ($30.78 in chips) 
Seat 5: KeLevro0 ($7.65 in chips) 
Seat 6: chiyuki ($37.40 in chips) 
Seat 7: 4plankton ($27.38 in chips) 
Seat 8: loca-loca888 ($49.46 in chips) 
Seat 9: troms20 ($63.46 in chips) 
hl77777: posts small blind $0.10
WARIBANA7777: posts big blind $0.25
*** HOLE CARDS ***
Dealt to chiyuki [Qd Kc]
RikkStroken: folds 
KeLevro0: folds 
chiyuki: raises $0.50 to $0.75
4plankton: folds 
loca-loca888: folds 
troms20: folds 
KAKamiro: folds 
hl77777: folds 
WARIBANA7777: folds 
Uncalled bet ($0.50) returned to chiyuki
chiyuki collected $0.60 from pot
chiyuki: doesn't show hand 
*** SUMMARY ***
Total pot $0.60 | Rake $0 
Seat 1: KAKamiro (button) folded before Flop (didn't bet)
Seat 2: hl77777 (small blind) folded before Flop
Seat 3: WARIBANA7777 (big blind) folded before Flop
Seat 4: RikkStroken folded before Flop (didn't bet)
Seat 5: KeLevro0 folded before Flop (didn't bet)
Seat 6: chiyuki collected ($0.60)
Seat 7: 4plankton folded before Flop (didn't bet)
Seat 8: loca-loca888 folded before Flop (didn't bet)
Seat 9: troms20 folded before Flop (didn't bet)



PokerStars Zoom Hand #84299699766:  Hold'em No Limit ($0.10/$0.25) - 2012/08/05 14:37:13 JST [2012/08/05 1:37:13 ET]
Table 'Whirlpool' 9-max Seat #1 is the button
Seat 1: stalkerec ($6.99 in chips) 
Seat 2: led52 ($12.25 in chips) 
Seat 3: KrystalAA ($9.30 in chips) 
Seat 4: chiyuki ($37.40 in chips) 
Seat 5: Landybob ($40.31 in chips) 
Seat 6: WARIBANA7777 ($15.61 in chips) 
Seat 7: taksist889 ($20.22 in chips) 
Seat 8: Suhoff76 ($26.86 in chips) 
Seat 9: Gichboy ($13.75 in chips) 
led52: posts small blind $0.10
KrystalAA: posts big blind $0.25
*** HOLE CARDS ***
Dealt to chiyuki [7d Js]
chiyuki: folds 
Landybob: folds 
WARIBANA7777: folds 
taksist889: raises $0.50 to $0.75
Suhoff76: folds 
Gichboy: calls $0.75
stalkerec: folds 
led52: folds 
KrystalAA: folds 
*** FLOP *** [2h 8d 9d]
taksist889: bets $1.25
Gichboy: calls $1.25
*** TURN *** [2h 8d 9d] [7c]
taksist889: checks 
Gichboy: bets $1.75
taksist889: calls $1.75
*** RIVER *** [2h 8d 9d 7c] [8s]
taksist889: checks 
Gichboy: checks 
*** SHOW DOWN ***
taksist889: shows [4s 4h] (two pair, Eights and Fours)
Gichboy: mucks hand 
taksist889 collected $7.50 from pot
*** SUMMARY ***
Total pot $7.85 | Rake $0.35 
Board [2h 8d 9d 7c 8s]
Seat 1: stalkerec (button) folded before Flop (didn't bet)
Seat 2: led52 (small blind) folded before Flop
Seat 3: KrystalAA (big blind) folded before Flop
Seat 4: chiyuki folded before Flop (didn't bet)
Seat 5: Landybob folded before Flop (didn't bet)
Seat 6: WARIBANA7777 folded before Flop (didn't bet)
Seat 7: taksist889 showed [4s 4h] and won ($7.50) with two pair, Eights and Fours
Seat 8: Suhoff76 folded before Flop (didn't bet)
Seat 9: Gichboy mucked [Kh Ts]



PokerStars Zoom Hand #84299702718:  Hold'em No Limit ($0.10/$0.25) - 2012/08/05 14:37:25 JST [2012/08/05 1:37:25 ET]
Table 'Whirlpool' 9-max Seat #1 is the button
Seat 1: chiyuki ($37.40 in chips) 
Seat 2: phate-1up ($40.81 in chips) 
Seat 3: ChrisCDee ($71.32 in chips) 
Seat 4: KrystalAA ($15.26 in chips) 
Seat 5: seula i ($26.38 in chips) 
Seat 6: jacquelinewu ($25 in chips) 
Seat 7: Suhoff76 ($25.89 in chips) 
Seat 8: Ellen1947 ($31.52 in chips) 
Seat 9: GovGus ($35.43 in chips) 
phate-1up: posts small blind $0.10
ChrisCDee: posts big blind $0.25
*** HOLE CARDS ***
Dealt to chiyuki [8s Kh]
KrystalAA: folds 
seula i: raises $0.25 to $0.50
jacquelinewu: calls $0.50
Suhoff76: folds 
Ellen1947: folds 
GovGus: folds 
chiyuki: folds 
phate-1up: folds 
ChrisCDee: folds 
*** FLOP *** [6c 3c As]
seula i: checks 
jacquelinewu: checks 
*** TURN *** [6c 3c As] [9c]
seula i: checks 
jacquelinewu: checks 
*** RIVER *** [6c 3c As 9c] [8h]
seula i: checks 
jacquelinewu: checks 
*** SHOW DOWN ***
seula i: shows [2s 2h] (a pair of Deuces)
jacquelinewu: shows [Jd Jc] (a pair of Jacks)
jacquelinewu collected $1.29 from pot
seula i is disconnected 
*** SUMMARY ***
Total pot $1.35 | Rake $0.06 
Board [6c 3c As 9c 8h]
Seat 1: chiyuki (button) folded before Flop (didn't bet)
Seat 2: phate-1up (small blind) folded before Flop
Seat 3: ChrisCDee (big blind) folded before Flop
Seat 4: KrystalAA folded before Flop (didn't bet)
Seat 5: seula i showed [2s 2h] and lost with a pair of Deuces
Seat 6: jacquelinewu showed [Jd Jc] and won ($1.29) with a pair of Jacks
Seat 7: Suhoff76 folded before Flop (didn't bet)
Seat 8: Ellen1947 folded before Flop (didn't bet)
Seat 9: GovGus folded before Flop (didn't bet)



PokerStars Zoom Hand #84299712119:  Hold'em No Limit ($0.10/$0.25) - 2012/08/05 14:38:04 JST [2012/08/05 1:38:04 ET]
Table 'Whirlpool' 9-max Seat #1 is the button
Seat 1: cr0lox ($24.30 in chips) 
Seat 2: chiyuki ($37.75 in chips) 
Seat 3: stalkerec ($5.30 in chips) 
Seat 4: ZhukOFFskI ($34.44 in chips) 
Seat 5: 4thepeople ($26.61 in chips) 
Seat 6: DanielWhyte ($50.17 in chips) 
Seat 7: Suhoff76 ($26.76 in chips) 
Seat 8: silvno31 ($29.36 in chips) 
Seat 9: led52 ($12.15 in chips) 
chiyuki: posts small blind $0.10
stalkerec: posts big blind $0.25
*** HOLE CARDS ***
Dealt to chiyuki [2d 4d]
ZhukOFFskI: folds 
4thepeople: calls $0.25
DanielWhyte: folds 
Suhoff76: folds 
silvno31: folds 
led52: folds 
cr0lox: folds 
chiyuki: folds 
stalkerec: checks 
*** FLOP *** [9d 3d 6s]
stalkerec: checks 
4thepeople: bets $0.25
stalkerec: folds 
Uncalled bet ($0.25) returned to 4thepeople
4thepeople collected $0.57 from pot
4thepeople: doesn't show hand 
*** SUMMARY ***
Total pot $0.60 | Rake $0.03 
Board [9d 3d 6s]
Seat 1: cr0lox (button) folded before Flop (didn't bet)
Seat 2: chiyuki (small blind) folded before Flop
Seat 3: stalkerec (big blind) folded on the Flop
Seat 4: ZhukOFFskI folded before Flop (didn't bet)
Seat 5: 4thepeople collected ($0.57)
Seat 6: DanielWhyte folded before Flop (didn't bet)
Seat 7: Suhoff76 folded before Flop (didn't bet)
Seat 8: silvno31 folded before Flop (didn't bet)
Seat 9: led52 folded before Flop (didn't bet)



PokerStars Zoom Hand #84299713873:  Hold'em No Limit ($0.10/$0.25) - 2012/08/05 14:38:11 JST [2012/08/05 1:38:11 ET]
Table 'Whirlpool' 9-max Seat #1 is the button
Seat 1: PillZ86 ($7.37 in chips) 
Seat 2: el pore 5 ($30.57 in chips) 
Seat 3: Lasutchik ($75.83 in chips) 
Seat 4: KrystalAA ($9.05 in chips) 
Seat 5: laurentzu84 ($30.75 in chips) 
Seat 6: mariuka1 ($6.22 in chips) 
Seat 7: 4ydo yogurt ($11.32 in chips) 
Seat 8: Landybob ($40.21 in chips) 
Seat 9: chiyuki ($37.65 in chips) 
el pore 5: posts small blind $0.10
Lasutchik: posts big blind $0.25
*** HOLE CARDS ***
Dealt to chiyuki [Js As]
KrystalAA: folds 
laurentzu84: folds 
mariuka1: folds 
4ydo yogurt: raises $0.37 to $0.62
Landybob: folds 
chiyuki: folds 
PillZ86: folds 
el pore 5: folds 
Lasutchik: calls $0.37
*** FLOP *** [5c Qh Th]
Lasutchik: checks 
4ydo yogurt: checks 
*** TURN *** [5c Qh Th] [8s]
Lasutchik: bets $0.65
4ydo yogurt: folds 
Uncalled bet ($0.65) returned to Lasutchik
Lasutchik collected $1.28 from pot
Lasutchik: doesn't show hand 
*** SUMMARY ***
Total pot $1.34 | Rake $0.06 
Board [5c Qh Th 8s]
Seat 1: PillZ86 (button) folded before Flop (didn't bet)
Seat 2: el pore 5 (small blind) folded before Flop
Seat 3: Lasutchik (big blind) collected ($1.28)
Seat 4: KrystalAA folded before Flop (didn't bet)
Seat 5: laurentzu84 folded before Flop (didn't bet)
Seat 6: mariuka1 folded before Flop (didn't bet)
Seat 7: 4ydo yogurt folded on the Turn
Seat 8: Landybob folded before Flop (didn't bet)
Seat 9: chiyuki folded before Flop (didn't bet)



PokerStars Zoom Hand #84299717528:  Hold'em No Limit ($0.10/$0.25) - 2012/08/05 14:38:26 JST [2012/08/05 1:38:26 ET]
Table 'Whirlpool' 9-max Seat #1 is the button
Seat 1: 4thepeople ($26.93 in chips) 
Seat 2: mjmichi ($25.10 in chips) 
Seat 3: fuguangps ($26.93 in chips) 
Seat 4: chiyuki ($37.65 in chips) 
Seat 5: GovGus ($34.71 in chips) 
Seat 6: laurentzu84 ($30.75 in chips) 
Seat 7: Loholov ($15 in chips) 
Seat 8: KimPa39 ($24.65 in chips) 
Seat 9: silvno31 ($29.36 in chips) 
mjmichi: posts small blind $0.10
fuguangps: posts big blind $0.25
*** HOLE CARDS ***
Dealt to chiyuki [3c 2s]
chiyuki: folds 
GovGus: folds 
laurentzu84: folds 
Loholov: folds 
KimPa39: folds 
silvno31: folds 
4thepeople: folds 
mjmichi: raises $0.50 to $0.75
fuguangps: folds 
Uncalled bet ($0.50) returned to mjmichi
mjmichi collected $0.50 from pot
mjmichi: doesn't show hand 
*** SUMMARY ***
Total pot $0.50 | Rake $0 
Seat 1: 4thepeople (button) folded before Flop (didn't bet)
Seat 2: mjmichi (small blind) collected ($0.50)
Seat 3: fuguangps (big blind) folded before Flop
Seat 4: chiyuki folded before Flop (didn't bet)
Seat 5: GovGus folded before Flop (didn't bet)
Seat 6: laurentzu84 folded before Flop (didn't bet)
Seat 7: Loholov folded before Flop (didn't bet)
Seat 8: KimPa39 folded before Flop (didn't bet)
Seat 9: silvno31 folded before Flop (didn't bet)



PokerStars Zoom Hand #84299723723:  Hold'em No Limit ($0.10/$0.25) - 2012/08/05 14:38:52 JST [2012/08/05 1:38:52 ET]
Table 'Whirlpool' 9-max Seat #1 is the button
Seat 1: Suhoff76 ($26.51 in chips) 
Seat 2: hirozo ($32.94 in chips) 
Seat 3: Walturrr ($26.97 in chips) 
Seat 4: chiyuki ($37.65 in chips) 
Seat 5: Loholov ($15.25 in chips) 
Seat 6: Yogi707 ($16.37 in chips) 
Seat 7: Dejacob ($27.28 in chips) 
Seat 8: cofla tito ($11.09 in chips) 
Seat 9: phate-1up ($27.19 in chips) 
hirozo: posts small blind $0.10
Walturrr: posts big blind $0.25
*** HOLE CARDS ***
Dealt to chiyuki [9s 4d]
chiyuki: folds 
Loholov: folds 
Yogi707: folds 
Dejacob: folds 
cofla tito: folds 
phate-1up: folds 
Suhoff76: folds 
hirozo: raises $0.25 to $0.50
Walturrr: calls $0.25
*** FLOP *** [Td Qs 4c]
hirozo: bets $0.64
Walturrr: folds 
Uncalled bet ($0.64) returned to hirozo
hirozo collected $0.96 from pot
hirozo: doesn't show hand 
*** SUMMARY ***
Total pot $1 | Rake $0.04 
Board [Td Qs 4c]
Seat 1: Suhoff76 (button) folded before Flop (didn't bet)
Seat 2: hirozo (small blind) collected ($0.96)
Seat 3: Walturrr (big blind) folded on the Flop
Seat 4: chiyuki folded before Flop (didn't bet)
Seat 5: Loholov folded before Flop (didn't bet)
Seat 6: Yogi707 folded before Flop (didn't bet)
Seat 7: Dejacob folded before Flop (didn't bet)
Seat 8: cofla tito folded before Flop (didn't bet)
Seat 9: phate-1up folded before Flop (didn't bet)



PokerStars Zoom Hand #84299718977:  Hold'em No Limit ($0.10/$0.25) - 2012/08/05 14:38:32 JST [2012/08/05 1:38:32 ET]
Table 'Whirlpool' 9-max Seat #1 is the button
Seat 1: azizmimi ($12.50 in chips) 
Seat 2: mariuka1 ($6.22 in chips) 
Seat 3: hirozo ($25.25 in chips) 
Seat 4: fuguangps ($32.25 in chips) 
Seat 5: Loholov ($15 in chips) 
Seat 6: Jene4kaBest ($12 in chips) 
Seat 7: led52 ($12.15 in chips) 
Seat 8: chiyuki ($37.65 in chips) 
Seat 9: GovGus ($25 in chips) 
mariuka1: posts small blind $0.10
hirozo: posts big blind $0.25
*** HOLE CARDS ***
Dealt to chiyuki [7h 7s]
fuguangps: raises $0.50 to $0.75
Loholov: folds 
Jene4kaBest: folds 
led52: folds 
chiyuki: folds 
GovGus: folds 
azizmimi: raises $0.75 to $1.50
mariuka1: folds 
hirozo: folds 
fuguangps: calls $0.75
*** FLOP *** [Js 2h Ac]
fuguangps: checks 
azizmimi: checks 
*** TURN *** [Js 2h Ac] [2s]
fuguangps: bets $2.56
azizmimi: calls $2.56
*** RIVER *** [Js 2h Ac 2s] [5h]
fuguangps: bets $8.50
azizmimi: folds 
Uncalled bet ($8.50) returned to fuguangps
fuguangps collected $8.09 from pot
fuguangps: doesn't show hand 
*** SUMMARY ***
Total pot $8.47 | Rake $0.38 
Board [Js 2h Ac 2s 5h]
Seat 1: azizmimi (button) folded on the River
Seat 2: mariuka1 (small blind) folded before Flop
Seat 3: hirozo (big blind) folded before Flop
Seat 4: fuguangps collected ($8.09)
Seat 5: Loholov folded before Flop (didn't bet)
Seat 6: Jene4kaBest folded before Flop (didn't bet)
Seat 7: led52 folded before Flop (didn't bet)
Seat 8: chiyuki folded before Flop (didn't bet)
Seat 9: GovGus folded before Flop (didn't bet)



PokerStars Zoom Hand #84299724703:  Hold'em No Limit ($0.10/$0.25) - 2012/08/05 14:38:56 JST [2012/08/05 1:38:56 ET]
Table 'Whirlpool' 9-max Seat #1 is the button
Seat 1: ZhukOFFskI ($34.09 in chips) 
Seat 2: chiyuki ($37.65 in chips) 
Seat 3: yane73 ($22.30 in chips) 
Seat 4: igor*gemert ($23.52 in chips) 
Seat 5: stalkerec ($4.95 in chips) 
Seat 6: Gichboy ($8.65 in chips) 
Seat 7: KrystalAA ($25.59 in chips) 
Seat 8: Perstenev ($12.05 in chips) 
Seat 9: snejokCoxx ($12.15 in chips) 
chiyuki: posts small blind $0.10
yane73: posts big blind $0.25
*** HOLE CARDS ***
Dealt to chiyuki [9d Jd]
igor*gemert: folds 
stalkerec: folds 
Gichboy: raises $0.25 to $0.50
KrystalAA: calls $0.50
Perstenev: calls $0.50
snejokCoxx: folds 
ZhukOFFskI: folds 
chiyuki: calls $0.40
yane73: raises $0.75 to $1.25
Gichboy: calls $0.75
KrystalAA: calls $0.75
Perstenev: calls $0.75
chiyuki: calls $0.75
*** FLOP *** [Kd 7h 9c]
chiyuki: checks 
yane73: bets $2.75
Gichboy: folds 
KrystalAA: folds 
Perstenev: folds 
chiyuki: folds 
Uncalled bet ($2.75) returned to yane73
yane73 collected $5.97 from pot
yane73: doesn't show hand 
*** SUMMARY ***
Total pot $6.25 | Rake $0.28 
Board [Kd 7h 9c]
Seat 1: ZhukOFFskI (button) folded before Flop (didn't bet)
Seat 2: chiyuki (small blind) folded on the Flop
Seat 3: yane73 (big blind) collected ($5.97)
Seat 4: igor*gemert folded before Flop (didn't bet)
Seat 5: stalkerec folded before Flop (didn't bet)
Seat 6: Gichboy folded on the Flop
Seat 7: KrystalAA folded on the Flop
Seat 8: Perstenev folded on the Flop
Seat 9: snejokCoxx folded before Flop (didn't bet)



PokerStars Zoom Hand #84299744614:  Hold'em No Limit ($0.10/$0.25) - 2012/08/05 14:40:18 JST [2012/08/05 1:40:18 ET]
Table 'Whirlpool' 9-max Seat #1 is the button
Seat 1: snejokCoxx ($11.80 in chips) 
Seat 2: BlOnDhOlIc ($82.74 in chips) 
Seat 3: chiyuki ($36.40 in chips) 
Seat 4: Walturrr ($27.91 in chips) 
Seat 5: dushvan ($42.29 in chips) 
Seat 6: Gichboy ($13.99 in chips) 
Seat 7: deadmoneykid ($24.43 in chips) 
Seat 8: fuguangps ($26.58 in chips) 
Seat 9: GovGus ($34.91 in chips) 
BlOnDhOlIc: posts small blind $0.10
chiyuki: posts big blind $0.25
*** HOLE CARDS ***
Dealt to chiyuki [8c 2c]
Walturrr: folds 
dushvan: folds 
Gichboy: folds 
deadmoneykid: folds 
fuguangps: folds 
GovGus: folds 
snejokCoxx: folds 
BlOnDhOlIc: raises $0.25 to $0.50
chiyuki: calls $0.25
*** FLOP *** [3c 5s 2h]
BlOnDhOlIc: bets $0.72
chiyuki: raises $1.28 to $2
BlOnDhOlIc: calls $1.28
*** TURN *** [3c 5s 2h] [As]
BlOnDhOlIc: checks 
chiyuki: bets $2.50
BlOnDhOlIc: raises $3.75 to $6.25
chiyuki: folds 
Uncalled bet ($3.75) returned to BlOnDhOlIc
BlOnDhOlIc collected $9.55 from pot
BlOnDhOlIc: doesn't show hand 
*** SUMMARY ***
Total pot $10 | Rake $0.45 
Board [3c 5s 2h As]
Seat 1: snejokCoxx (button) folded before Flop (didn't bet)
Seat 2: BlOnDhOlIc (small blind) collected ($9.55)
Seat 3: chiyuki (big blind) folded on the Turn
Seat 4: Walturrr folded before Flop (didn't bet)
Seat 5: dushvan folded before Flop (didn't bet)
Seat 6: Gichboy folded before Flop (didn't bet)
Seat 7: deadmoneykid folded before Flop (didn't bet)
Seat 8: fuguangps folded before Flop (didn't bet)
Seat 9: GovGus folded before Flop (didn't bet)



PokerStars Zoom Hand #84299766985:  Hold'em No Limit ($0.10/$0.25) - 2012/08/05 14:41:50 JST [2012/08/05 1:41:50 ET]
Table 'Whirlpool' 9-max Seat #1 is the button
Seat 1: seula i ($31.86 in chips) 
Seat 2: fuguangps ($30.71 in chips) 
Seat 3: KeLevro0 ($12.50 in chips) 
Seat 4: dushvan ($42.29 in chips) 
Seat 5: hl77777 ($13.35 in chips) 
Seat 6: BlOnDhOlIc ($40.56 in chips) 
Seat 7: led52 ($12.92 in chips) 
Seat 8: ZhukOFFskI ($34.76 in chips) 
Seat 9: chiyuki ($31.40 in chips) 
fuguangps: posts small blind $0.10
KeLevro0: posts big blind $0.25
*** HOLE CARDS ***
Dealt to chiyuki [2c Jd]
dushvan: folds 
hl77777: folds 
BlOnDhOlIc: folds 
led52: raises $0.50 to $0.75
ZhukOFFskI: folds 
chiyuki: folds 
seula i: folds 
fuguangps: folds 
KeLevro0: folds 
Uncalled bet ($0.50) returned to led52
led52 collected $0.60 from pot
led52: doesn't show hand 
*** SUMMARY ***
Total pot $0.60 | Rake $0 
Seat 1: seula i (button) folded before Flop (didn't bet)
Seat 2: fuguangps (small blind) folded before Flop
Seat 3: KeLevro0 (big blind) folded before Flop
Seat 4: dushvan folded before Flop (didn't bet)
Seat 5: hl77777 folded before Flop (didn't bet)
Seat 6: BlOnDhOlIc folded before Flop (didn't bet)
Seat 7: led52 collected ($0.60)
Seat 8: ZhukOFFskI folded before Flop (didn't bet)
Seat 9: chiyuki folded before Flop (didn't bet)



PokerStars Zoom Hand #84299772629:  Hold'em No Limit ($0.10/$0.25) - 2012/08/05 14:42:13 JST [2012/08/05 1:42:13 ET]
Table 'Whirlpool' 9-max Seat #1 is the button
Seat 1: Walturrr ($24.78 in chips) 
Seat 2: Cyanidoff ($25 in chips) 
Seat 3: snejokCoxx ($13.02 in chips) 
Seat 4: fuguangps ($30.61 in chips) 
Seat 5: chiyuki ($31.40 in chips) 
Seat 6: Nerkit ($16.10 in chips) 
Seat 7: hirozo ($25.78 in chips) 
Seat 8: Perstenev ($8.68 in chips) 
Seat 9: jacquelinewu ($25 in chips) 
Cyanidoff: posts small blind $0.10
snejokCoxx: posts big blind $0.25
*** HOLE CARDS ***
Dealt to chiyuki [7s Kh]
fuguangps: folds 
chiyuki: folds 
Nerkit: folds 
hirozo: folds 
Perstenev: folds 
jacquelinewu: folds 
Walturrr: folds 
Cyanidoff: folds 
Uncalled bet ($0.15) returned to snejokCoxx
snejokCoxx collected $0.20 from pot
snejokCoxx: doesn't show hand 
*** SUMMARY ***
Total pot $0.20 | Rake $0 
Seat 1: Walturrr (button) folded before Flop (didn't bet)
Seat 2: Cyanidoff (small blind) folded before Flop
Seat 3: snejokCoxx (big blind) collected ($0.20)
Seat 4: fuguangps folded before Flop (didn't bet)
Seat 5: chiyuki folded before Flop (didn't bet)
Seat 6: Nerkit folded before Flop (didn't bet)
Seat 7: hirozo folded before Flop (didn't bet)
Seat 8: Perstenev folded before Flop (didn't bet)
Seat 9: jacquelinewu folded before Flop (didn't bet)



PokerStars Zoom Hand #84299774067:  Hold'em No Limit ($0.10/$0.25) - 2012/08/05 14:42:19 JST [2012/08/05 1:42:19 ET]
Table 'Whirlpool' 9-max Seat #1 is the button
Seat 1: chiyuki ($31.40 in chips) 
Seat 2: a_tasmanian ($23.53 in chips) 
Seat 3: dushvan ($42.19 in chips) 
Seat 4: bigred1102 ($21.04 in chips) 
Seat 5: ZhukOFFskI ($34.76 in chips) 
Seat 6: Walturrr ($24.78 in chips) 
Seat 7: KeLevro0 ($12.60 in chips) 
Seat 8: KrystalAA ($23.99 in chips) 
Seat 9: Cyanidoff ($25 in chips) 
a_tasmanian: posts small blind $0.10
dushvan: posts big blind $0.25
*** HOLE CARDS ***
Dealt to chiyuki [6c 4h]
bigred1102: folds 
ZhukOFFskI: folds 
Walturrr: folds 
KeLevro0: folds 
KrystalAA: folds 
Cyanidoff: raises $0.50 to $0.75
chiyuki: folds 
a_tasmanian: folds 
dushvan: folds 
Uncalled bet ($0.50) returned to Cyanidoff
Cyanidoff collected $0.60 from pot
Cyanidoff: doesn't show hand 
*** SUMMARY ***
Total pot $0.60 | Rake $0 
Seat 1: chiyuki (button) folded before Flop (didn't bet)
Seat 2: a_tasmanian (small blind) folded before Flop
Seat 3: dushvan (big blind) folded before Flop
Seat 4: bigred1102 folded before Flop (didn't bet)
Seat 5: ZhukOFFskI folded before Flop (didn't bet)
Seat 6: Walturrr folded before Flop (didn't bet)
Seat 7: KeLevro0 folded before Flop (didn't bet)
Seat 8: KrystalAA folded before Flop (didn't bet)
Seat 9: Cyanidoff collected ($0.60)



PokerStars Zoom Hand #84299775054:  Hold'em No Limit ($0.10/$0.25) - 2012/08/05 14:42:24 JST [2012/08/05 1:42:24 ET]
Table 'Whirlpool' 9-max Seat #1 is the button
Seat 1: Dejacob ($35.95 in chips) 
Seat 2: stalkerec ($7.01 in chips) 
Seat 3: JokerJudge ($20.97 in chips) 
Seat 4: BlOnDhOlIc ($40.31 in chips) 
Seat 5: chiyuki ($31.40 in chips) 
Seat 6: led52 ($12.41 in chips) 
Seat 7: PillZ86 ($14.72 in chips) 
Seat 8: hirozo ($38.43 in chips) 
Seat 9: mjmichi ($25 in chips) 
stalkerec: posts small blind $0.10
JokerJudge: posts big blind $0.25
*** HOLE CARDS ***
Dealt to chiyuki [9h 7d]
BlOnDhOlIc: folds 
chiyuki: folds 
led52: folds 
PillZ86: folds 
hirozo: folds 
mjmichi: folds 
Dejacob: folds 
stalkerec: raises $0.50 to $0.75
JokerJudge: folds 
Uncalled bet ($0.50) returned to stalkerec
stalkerec collected $0.50 from pot
stalkerec: doesn't show hand 
*** SUMMARY ***
Total pot $0.50 | Rake $0 
Seat 1: Dejacob (button) folded before Flop (didn't bet)
Seat 2: stalkerec (small blind) collected ($0.50)
Seat 3: JokerJudge (big blind) folded before Flop
Seat 4: BlOnDhOlIc folded before Flop (didn't bet)
Seat 5: chiyuki folded before Flop (didn't bet)
Seat 6: led52 folded before Flop (didn't bet)
Seat 7: PillZ86 folded before Flop (didn't bet)
Seat 8: hirozo folded before Flop (didn't bet)
Seat 9: mjmichi folded before Flop (didn't bet)



PokerStars Zoom Hand #84299768748:  Hold'em No Limit ($0.10/$0.25) - 2012/08/05 14:41:57 JST [2012/08/05 1:41:57 ET]
Table 'Whirlpool' 9-max Seat #1 is the button
Seat 1: BlOnDhOlIc ($40.56 in chips) 
Seat 2: Vahe50 ($15 in chips) 
Seat 3: hl77777 ($8.92 in chips) 
Seat 4: stalkerec ($7.44 in chips) 
Seat 5: Perstenev ($13.71 in chips) 
Seat 6: jacquelinewu ($33.56 in chips) 
Seat 7: chiyuki ($31.40 in chips) 
Seat 8: Loholov ($15.75 in chips) 
Seat 9: Nerkit ($11.05 in chips) 
Vahe50: posts small blind $0.10
hl77777: posts big blind $0.25
*** HOLE CARDS ***
Dealt to chiyuki [2c 8c]
stalkerec: calls $0.25
Perstenev: folds 
jacquelinewu: folds 
chiyuki: folds 
Loholov: folds 
Nerkit: folds 
BlOnDhOlIc: folds 
Vahe50: calls $0.15
hl77777: checks 
*** FLOP *** [Jd 4h Qc]
Vahe50: checks 
hl77777: checks 
stalkerec: checks 
*** TURN *** [Jd 4h Qc] [Tc]
Vahe50: bets $0.50
hl77777: calls $0.50
stalkerec: folds 
*** RIVER *** [Jd 4h Qc Tc] [5h]
Vahe50: bets $0.75
hl77777: folds 
Uncalled bet ($0.75) returned to Vahe50
Vahe50 collected $1.67 from pot
Vahe50: doesn't show hand 
*** SUMMARY ***
Total pot $1.75 | Rake $0.08 
Board [Jd 4h Qc Tc 5h]
Seat 1: BlOnDhOlIc (button) folded before Flop (didn't bet)
Seat 2: Vahe50 (small blind) collected ($1.67)
Seat 3: hl77777 (big blind) folded on the River
Seat 4: stalkerec folded on the Turn
Seat 5: Perstenev folded before Flop (didn't bet)
Seat 6: jacquelinewu folded before Flop (didn't bet)
Seat 7: chiyuki folded before Flop (didn't bet)
Seat 8: Loholov folded before Flop (didn't bet)
Seat 9: Nerkit folded before Flop (didn't bet)



PokerStars Zoom Hand #84299765543:  Hold'em No Limit ($0.10/$0.25) - 2012/08/05 14:41:44 JST [2012/08/05 1:41:44 ET]
Table 'Whirlpool' 9-max Seat #1 is the button
Seat 1: KrystalAA ($11.58 in chips) 
Seat 2: deepakmbh ($25.10 in chips) 
Seat 3: Perstenev ($12.71 in chips) 
Seat 4: ll_LaMeR_ll ($78.83 in chips) 
Seat 5: 4thepeople ($27.14 in chips) 
Seat 6: chiyuki ($31.40 in chips) 
Seat 7: Walturrr ($25.34 in chips) 
Seat 8: troms20 ($28.94 in chips) 
Seat 9: KeLevro0 ($12.59 in chips) 
deepakmbh: posts small blind $0.10
Perstenev: posts big blind $0.25
*** HOLE CARDS ***
Dealt to chiyuki [Kc 7c]
ll_LaMeR_ll: folds 
4thepeople: calls $0.25
chiyuki: folds 
Walturrr: folds 
troms20: folds 
KeLevro0: folds 
KrystalAA: calls $0.25
deepakmbh: calls $0.15
Perstenev: checks 
*** FLOP *** [2c Qh 6s]
deepakmbh: bets $0.75
Perstenev: folds 
4thepeople: calls $0.75
KrystalAA: calls $0.75
*** TURN *** [2c Qh 6s] [5s]
deepakmbh: checks 
4thepeople: bets $1
KrystalAA: raises $3.92 to $4.92
deepakmbh: folds 
4thepeople: raises $10.83 to $15.75
KrystalAA: calls $5.66 and is all-in
Uncalled bet ($5.17) returned to 4thepeople
*** RIVER *** [2c Qh 6s 5s] [Tc]
*** SHOW DOWN ***
4thepeople: shows [Ad Qc] (a pair of Queens)
KrystalAA: shows [6h 5d] (two pair, Sixes and Fives)
KrystalAA collected $23.31 from pot
*** SUMMARY ***
Total pot $24.41 | Rake $1.10 
Board [2c Qh 6s 5s Tc]
Seat 1: KrystalAA (button) showed [6h 5d] and won ($23.31) with two pair, Sixes and Fives
Seat 2: deepakmbh (small blind) folded on the Turn
Seat 3: Perstenev (big blind) folded on the Flop
Seat 4: ll_LaMeR_ll folded before Flop (didn't bet)
Seat 5: 4thepeople showed [Ad Qc] and lost with a pair of Queens
Seat 6: chiyuki folded before Flop (didn't bet)
Seat 7: Walturrr folded before Flop (didn't bet)
Seat 8: troms20 folded before Flop (didn't bet)
Seat 9: KeLevro0 folded before Flop (didn't bet)



PokerStars Zoom Hand #84299763317:  Hold'em No Limit ($0.10/$0.25) - 2012/08/05 14:41:35 JST [2012/08/05 1:41:35 ET]
Table 'Whirlpool' 9-max Seat #1 is the button
Seat 1: chiyuki ($31.40 in chips) 
Seat 2: hirozo ($39.07 in chips) 
Seat 3: Dejacob ($25 in chips) 
Seat 4: KrystalAA ($11.58 in chips) 
Seat 5: Phaedrus...3 ($25 in chips) 
Seat 6: troms20 ($26.67 in chips) 
Seat 7: fuguangps ($30.71 in chips) 
Seat 8: KeLevro0 ($12.69 in chips) 
Seat 9: wildy29 ($14.11 in chips) 
hirozo: posts small blind $0.10
Dejacob: posts big blind $0.25
*** HOLE CARDS ***
Dealt to chiyuki [Th 4s]
KrystalAA: folds 
Phaedrus...3: folds 
troms20: folds 
fuguangps: folds 
KeLevro0: folds 
wildy29: calls $0.25
chiyuki: folds 
hirozo: raises $0.75 to $1
Dejacob: folds 
wildy29: calls $0.75
*** FLOP *** [7c 6h As]
hirozo: checks 
wildy29: checks 
*** TURN *** [7c 6h As] [9h]
hirozo: bets $1.43
wildy29: folds 
Uncalled bet ($1.43) returned to hirozo
hirozo collected $2.15 from pot
hirozo: doesn't show hand 
*** SUMMARY ***
Total pot $2.25 | Rake $0.10 
Board [7c 6h As 9h]
Seat 1: chiyuki (button) folded before Flop (didn't bet)
Seat 2: hirozo (small blind) collected ($2.15)
Seat 3: Dejacob (big blind) folded before Flop
Seat 4: KrystalAA folded before Flop (didn't bet)
Seat 5: Phaedrus...3 folded before Flop (didn't bet)
Seat 6: troms20 folded before Flop (didn't bet)
Seat 7: fuguangps folded before Flop (didn't bet)
Seat 8: KeLevro0 folded before Flop (didn't bet)
Seat 9: wildy29 folded on the Turn



PokerStars Zoom Hand #84299771903:  Hold'em No Limit ($0.10/$0.25) - 2012/08/05 14:42:10 JST [2012/08/05 1:42:10 ET]
Table 'Whirlpool' 9-max Seat #1 is the button
Seat 1: WARIBANA7777 ($23.02 in chips) 
Seat 2: simonzez ($28.51 in chips) 
Seat 3: tribunpdm ($25 in chips) 
Seat 4: KimPa39 ($23.94 in chips) 
Seat 5: ChrisCDee ($36.54 in chips) 
Seat 6: chiyuki ($31.40 in chips) 
Seat 7: mid22 ($12.60 in chips) 
Seat 8: KeLevro0 ($12.15 in chips) 
Seat 9: seula i ($116.96 in chips) 
simonzez: posts small blind $0.10
tribunpdm: posts big blind $0.25
*** HOLE CARDS ***
Dealt to chiyuki [Ts 9c]
KimPa39: folds 
ChrisCDee: folds 
chiyuki: folds 
mid22: folds 
KeLevro0: folds 
seula i: folds 
WARIBANA7777: folds 
simonzez: calls $0.15
tribunpdm: checks 
*** FLOP *** [Ah Qh Kh]
simonzez: bets $0.50
tribunpdm: calls $0.50
*** TURN *** [Ah Qh Kh] [5s]
simonzez: bets $0.75
tribunpdm: calls $0.75
*** RIVER *** [Ah Qh Kh 5s] [5c]
simonzez: bets $1.50
tribunpdm: calls $1.50
*** SHOW DOWN ***
simonzez: shows [Jd 2h] (a pair of Fives)
tribunpdm: shows [Th 8h] (a flush, Ace high)
tribunpdm collected $5.73 from pot
*** SUMMARY ***
Total pot $6 | Rake $0.27 
Board [Ah Qh Kh 5s 5c]
Seat 1: WARIBANA7777 (button) folded before Flop (didn't bet)
Seat 2: simonzez (small blind) showed [Jd 2h] and lost with a pair of Fives
Seat 3: tribunpdm (big blind) showed [Th 8h] and won ($5.73) with a flush, Ace high
Seat 4: KimPa39 folded before Flop (didn't bet)
Seat 5: ChrisCDee folded before Flop (didn't bet)
Seat 6: chiyuki folded before Flop (didn't bet)
Seat 7: mid22 folded before Flop (didn't bet)
Seat 8: KeLevro0 folded before Flop (didn't bet)
Seat 9: seula i folded before Flop (didn't bet)



PokerStars Zoom Hand #84299776267:  Hold'em No Limit ($0.10/$0.25) - 2012/08/05 14:42:29 JST [2012/08/05 1:42:29 ET]
Table 'Whirlpool' 9-max Seat #1 is the button
Seat 1: led52 ($12.41 in chips) 
Seat 2: Walturrr ($24.78 in chips) 
Seat 3: colorado2108 ($17.96 in chips) 
Seat 4: chiyuki ($31.40 in chips) 
Seat 5: Nerkit ($11.05 in chips) 
Seat 6: KAKamiro ($24.56 in chips) 
Seat 7: hirozo ($38.43 in chips) 
Seat 8: igor*gemert ($24.97 in chips) 
Seat 9: ZhukOFFskI ($33.59 in chips) 
Walturrr: posts small blind $0.10
colorado2108: posts big blind $0.25
*** HOLE CARDS ***
Dealt to chiyuki [3s 9c]
chiyuki: folds 
Nerkit: folds 
KAKamiro: folds 
hirozo: folds 
igor*gemert: folds 
ZhukOFFskI: raises $0.50 to $0.75
led52: folds 
Walturrr: folds 
colorado2108: folds 
Uncalled bet ($0.50) returned to ZhukOFFskI
ZhukOFFskI collected $0.60 from pot
ZhukOFFskI: doesn't show hand 
*** SUMMARY ***
Total pot $0.60 | Rake $0 
Seat 1: led52 (button) folded before Flop (didn't bet)
Seat 2: Walturrr (small blind) folded before Flop
Seat 3: colorado2108 (big blind) folded before Flop
Seat 4: chiyuki folded before Flop (didn't bet)
Seat 5: Nerkit folded before Flop (didn't bet)
Seat 6: KAKamiro folded before Flop (didn't bet)
Seat 7: hirozo folded before Flop (didn't bet)
Seat 8: igor*gemert folded before Flop (didn't bet)
Seat 9: ZhukOFFskI collected ($0.60)



PokerStars Zoom Hand #84299783515:  Hold'em No Limit ($0.10/$0.25) - 2012/08/05 14:42:58 JST [2012/08/05 1:42:58 ET]
Table 'Whirlpool' 9-max Seat #1 is the button
Seat 1: Ladyteazer ($31.28 in chips) 
Seat 2: Nerkit ($13.01 in chips) 
Seat 3: wildy29 ($13.11 in chips) 
Seat 4: JokerJudge ($24.65 in chips) 
Seat 5: igor*gemert ($24.97 in chips) 
Seat 6: led52 ($11.10 in chips) 
Seat 7: yane73 ($22.42 in chips) 
Seat 8: Perstenev ($11.26 in chips) 
Seat 9: chiyuki ($31.05 in chips) 
Nerkit: posts small blind $0.10
wildy29: posts big blind $0.25
*** HOLE CARDS ***
Dealt to chiyuki [Qc 6s]
JokerJudge: folds 
igor*gemert: folds 
led52: folds 
yane73: folds 
Perstenev: folds 
chiyuki: folds 
Ladyteazer: folds 
Nerkit: folds 
Uncalled bet ($0.15) returned to wildy29
wildy29 collected $0.20 from pot
wildy29: doesn't show hand 
*** SUMMARY ***
Total pot $0.20 | Rake $0 
Seat 1: Ladyteazer (button) folded before Flop (didn't bet)
Seat 2: Nerkit (small blind) folded before Flop
Seat 3: wildy29 (big blind) collected ($0.20)
Seat 4: JokerJudge folded before Flop (didn't bet)
Seat 5: igor*gemert folded before Flop (didn't bet)
Seat 6: led52 folded before Flop (didn't bet)
Seat 7: yane73 folded before Flop (didn't bet)
Seat 8: Perstenev folded before Flop (didn't bet)
Seat 9: chiyuki folded before Flop (didn't bet)



PokerStars Zoom Hand #84299777252:  Hold'em No Limit ($0.10/$0.25) - 2012/08/05 14:42:33 JST [2012/08/05 1:42:33 ET]
Table 'Whirlpool' 9-max Seat #1 is the button
Seat 1: fuguangps ($27.05 in chips) 
Seat 2: PillZ86 ($14.72 in chips) 
Seat 3: chiyuki ($31.40 in chips) 
Seat 4: KAKamiro ($24.56 in chips) 
Seat 5: snejokCoxx ($13.12 in chips) 
Seat 6: hirozo ($38.43 in chips) 
Seat 7: Dejacob ($35.95 in chips) 
Seat 8: Nerkit ($11.05 in chips) 
Seat 9: seula i ($33.46 in chips) 
PillZ86: posts small blind $0.10
chiyuki: posts big blind $0.25
*** HOLE CARDS ***
Dealt to chiyuki [Kd Jd]
KAKamiro: calls $0.25
snejokCoxx: folds 
hirozo: folds 
Dejacob: folds 
Nerkit: folds 
seula i: raises $0.75 to $1
fuguangps: calls $1
PillZ86: folds 
chiyuki: folds 
KAKamiro: calls $0.75
*** FLOP *** [Ks 7c 6h]
KAKamiro: checks 
seula i: bets $1.75
fuguangps: folds 
KAKamiro: calls $1.75
*** TURN *** [Ks 7c 6h] [7s]
KAKamiro: checks 
seula i: checks 
*** RIVER *** [Ks 7c 6h 7s] [Ad]
KAKamiro: checks 
seula i: checks 
*** SHOW DOWN ***
KAKamiro: shows [7d 4d] (three of a kind, Sevens)
seula i: mucks hand 
KAKamiro collected $6.54 from pot
*** SUMMARY ***
Total pot $6.85 | Rake $0.31 
Board [Ks 7c 6h 7s Ad]
Seat 1: fuguangps (button) folded on the Flop
Seat 2: PillZ86 (small blind) folded before Flop
Seat 3: chiyuki (big blind) folded before Flop
Seat 4: KAKamiro showed [7d 4d] and won ($6.54) with three of a kind, Sevens
Seat 5: snejokCoxx folded before Flop (didn't bet)
Seat 6: hirozo folded before Flop (didn't bet)
Seat 7: Dejacob folded before Flop (didn't bet)
Seat 8: Nerkit folded before Flop (didn't bet)
Seat 9: seula i mucked [5h 5c]



PokerStars Zoom Hand #84299784939:  Hold'em No Limit ($0.10/$0.25) - 2012/08/05 14:43:04 JST [2012/08/05 1:43:04 ET]
Table 'Whirlpool' 9-max Seat #1 is the button
Seat 1: slapshot2011 ($33.73 in chips) 
Seat 2: 4ydo yogurt ($14.47 in chips) 
Seat 3: 1Karina1 ($43.27 in chips) 
Seat 4: peng2astic ($14.25 in chips) 
Seat 5: KeLevro0 ($12.15 in chips) 
Seat 6: el pore 5 ($30.74 in chips) 
Seat 7: Perstenev ($14.51 in chips) 
Seat 8: chiyuki ($31.05 in chips) 
Seat 9: Sal y Limon1 ($24.75 in chips) 
4ydo yogurt: posts small blind $0.10
1Karina1: posts big blind $0.25
*** HOLE CARDS ***
Dealt to chiyuki [3s Ts]
peng2astic: raises $0.50 to $0.75
KeLevro0: folds 
el pore 5: folds 
Perstenev: folds 
chiyuki: folds 
Sal y Limon1: folds 
slapshot2011: folds 
4ydo yogurt: folds 
1Karina1: folds 
Uncalled bet ($0.50) returned to peng2astic
peng2astic collected $0.60 from pot
peng2astic: doesn't show hand 
*** SUMMARY ***
Total pot $0.60 | Rake $0 
Seat 1: slapshot2011 (button) folded before Flop (didn't bet)
Seat 2: 4ydo yogurt (small blind) folded before Flop
Seat 3: 1Karina1 (big blind) folded before Flop
Seat 4: peng2astic collected ($0.60)
Seat 5: KeLevro0 folded before Flop (didn't bet)
Seat 6: el pore 5 folded before Flop (didn't bet)
Seat 7: Perstenev folded before Flop (didn't bet)
Seat 8: chiyuki folded before Flop (didn't bet)
Seat 9: Sal y Limon1 folded before Flop (didn't bet)



PokerStars Zoom Hand #84299786633:  Hold'em No Limit ($0.10/$0.25) - 2012/08/05 14:43:11 JST [2012/08/05 1:43:11 ET]
Table 'Whirlpool' 9-max Seat #1 is the button
Seat 1: chiyuki ($31.05 in chips) 
Seat 2: fuguangps ($30.36 in chips) 
Seat 3: KimPa39 ($24.96 in chips) 
Seat 4: hirozo ($34.33 in chips) 
Seat 5: ZhukOFFskI ($34.41 in chips) 
Seat 6: Perstenev ($8.33 in chips) 
Seat 7: ll_LaMeR_ll ($74.43 in chips) 
Seat 8: jacquelinewu ($25 in chips) 
Seat 9: Dejacob ($30.27 in chips) 
fuguangps: posts small blind $0.10
KimPa39: posts big blind $0.25
*** HOLE CARDS ***
Dealt to chiyuki [Kd 7d]
hirozo: folds 
ZhukOFFskI: folds 
Perstenev: folds 
ll_LaMeR_ll: folds 
jacquelinewu: folds 
Dejacob: folds 
chiyuki: raises $0.50 to $0.75
fuguangps: folds 
KimPa39: folds 
Uncalled bet ($0.50) returned to chiyuki
chiyuki collected $0.60 from pot
chiyuki: doesn't show hand 
*** SUMMARY ***
Total pot $0.60 | Rake $0 
Seat 1: chiyuki (button) collected ($0.60)
Seat 2: fuguangps (small blind) folded before Flop
Seat 3: KimPa39 (big blind) folded before Flop
Seat 4: hirozo folded before Flop (didn't bet)
Seat 5: ZhukOFFskI folded before Flop (didn't bet)
Seat 6: Perstenev folded before Flop (didn't bet)
Seat 7: ll_LaMeR_ll folded before Flop (didn't bet)
Seat 8: jacquelinewu folded before Flop (didn't bet)
Seat 9: Dejacob folded before Flop (didn't bet)



PokerStars Zoom Hand #84299769952:  Hold'em No Limit ($0.10/$0.25) - 2012/08/05 14:42:02 JST [2012/08/05 1:42:02 ET]
Table 'Whirlpool' 9-max Seat #1 is the button
Seat 1: 1Karina1 ($28.88 in chips) 
Seat 2: Alvinpe85 ($43.56 in chips) 
Seat 3: debstar27 ($27.06 in chips) 
Seat 4: ChrisCDee ($29.48 in chips) 
Seat 5: GovGus ($25 in chips) 
Seat 6: Dejacob ($35.95 in chips) 
Seat 7: Perstenev ($13.71 in chips) 
Seat 8: chiyuki ($31.40 in chips) 
Seat 9: mjmichi ($28.33 in chips) 
Alvinpe85: posts small blind $0.10
debstar27: posts big blind $0.25
*** HOLE CARDS ***
Dealt to chiyuki [9s 3c]
ChrisCDee: folds 
GovGus: folds 
Dejacob: folds 
Perstenev: folds 
chiyuki: folds 
mjmichi: folds 
1Karina1: raises $0.50 to $0.75
Alvinpe85: folds 
debstar27: calls $0.50
*** FLOP *** [Qc Kh Kc]
debstar27: checks 
1Karina1: checks 
*** TURN *** [Qc Kh Kc] [Jd]
debstar27: checks 
1Karina1: bets $1
debstar27: folds 
Uncalled bet ($1) returned to 1Karina1
1Karina1 collected $1.53 from pot
1Karina1: doesn't show hand 
*** SUMMARY ***
Total pot $1.60 | Rake $0.07 
Board [Qc Kh Kc Jd]
Seat 1: 1Karina1 (button) collected ($1.53)
Seat 2: Alvinpe85 (small blind) folded before Flop
Seat 3: debstar27 (big blind) folded on the Turn
Seat 4: ChrisCDee folded before Flop (didn't bet)
Seat 5: GovGus folded before Flop (didn't bet)
Seat 6: Dejacob folded before Flop (didn't bet)
Seat 7: Perstenev folded before Flop (didn't bet)
Seat 8: chiyuki folded before Flop (didn't bet)
Seat 9: mjmichi folded before Flop (didn't bet)



PokerStars Zoom Hand #84299781775:  Hold'em No Limit ($0.10/$0.25) - 2012/08/05 14:42:51 JST [2012/08/05 1:42:51 ET]
Table 'Whirlpool' 9-max Seat #1 is the button
Seat 1: KrystalAA ($10.79 in chips) 
Seat 2: chiyuki ($31.15 in chips) 
Seat 3: Alvinpe85 ($43.46 in chips) 
Seat 4: simonzez ($25.51 in chips) 
Seat 5: tribunpdm ($27.73 in chips) 
Seat 6: KeLevro0 ($12.15 in chips) 
Seat 7: cofla tito ($15.12 in chips) 
Seat 8: dushvan ($41.94 in chips) 
Seat 9: hirozo ($34.33 in chips) 
chiyuki: posts small blind $0.10
Alvinpe85: posts big blind $0.25
*** HOLE CARDS ***
Dealt to chiyuki [3h 4h]
simonzez: calls $0.25
tribunpdm: folds 
KeLevro0: folds 
cofla tito: calls $0.25
dushvan: folds 
hirozo: folds 
KrystalAA: folds 
chiyuki: folds 
Alvinpe85: checks 
*** FLOP *** [5c 8d 5h]
Alvinpe85: checks 
simonzez: checks 
cofla tito: bets $0.50
Alvinpe85: folds 
simonzez: calls $0.50
*** TURN *** [5c 8d 5h] [7h]
simonzez: checks 
cofla tito: checks 
*** RIVER *** [5c 8d 5h 7h] [8h]
simonzez: bets $1.25
cofla tito: folds 
Uncalled bet ($1.25) returned to simonzez
simonzez collected $1.77 from pot
simonzez: doesn't show hand 
*** SUMMARY ***
Total pot $1.85 | Rake $0.08 
Board [5c 8d 5h 7h 8h]
Seat 1: KrystalAA (button) folded before Flop (didn't bet)
Seat 2: chiyuki (small blind) folded before Flop
Seat 3: Alvinpe85 (big blind) folded on the Flop
Seat 4: simonzez collected ($1.77)
Seat 5: tribunpdm folded before Flop (didn't bet)
Seat 6: KeLevro0 folded before Flop (didn't bet)
Seat 7: cofla tito folded on the River
Seat 8: dushvan folded before Flop (didn't bet)
Seat 9: hirozo folded before Flop (didn't bet)



PokerStars Zoom Hand #84299792595:  Hold'em No Limit ($0.10/$0.25) - 2012/08/05 14:43:35 JST [2012/08/05 1:43:35 ET]
Table 'Whirlpool' 9-max Seat #1 is the button
Seat 1: KeLevro0 ($11.90 in chips) 
Seat 2: seula i ($30.71 in chips) 
Seat 3: Perstenev ($13.76 in chips) 
Seat 4: hirozo ($40.57 in chips) 
Seat 5: Dan Royal ($46.82 in chips) 
Seat 6: mariuka1 ($12.15 in chips) 
Seat 7: chiyuki ($31.40 in chips) 
Seat 8: Dejacob ($32.22 in chips) 
Seat 9: KimPa39 ($24.71 in chips) 
seula i: posts small blind $0.10
Perstenev: posts big blind $0.25
*** HOLE CARDS ***
Dealt to chiyuki [Qs Tc]
hirozo: folds 
Dan Royal: folds 
mariuka1: folds 
chiyuki: folds 
Dejacob: raises $0.50 to $0.75
KimPa39: folds 
KeLevro0: folds 
seula i: folds 
Perstenev: folds 
Uncalled bet ($0.50) returned to Dejacob
Dejacob collected $0.60 from pot
Dejacob: doesn't show hand 
*** SUMMARY ***
Total pot $0.60 | Rake $0 
Seat 1: KeLevro0 (button) folded before Flop (didn't bet)
Seat 2: seula i (small blind) folded before Flop
Seat 3: Perstenev (big blind) folded before Flop
Seat 4: hirozo folded before Flop (didn't bet)
Seat 5: Dan Royal folded before Flop (didn't bet)
Seat 6: mariuka1 folded before Flop (didn't bet)
Seat 7: chiyuki folded before Flop (didn't bet)
Seat 8: Dejacob collected ($0.60)
Seat 9: KimPa39 folded before Flop (didn't bet)



PokerStars Zoom Hand #84299793799:  Hold'em No Limit ($0.10/$0.25) - 2012/08/05 14:43:41 JST [2012/08/05 1:43:41 ET]
Table 'Whirlpool' 9-max Seat #1 is the button
Seat 1: mjmichi ($25 in chips) 
Seat 2: KimPa39 ($24.71 in chips) 
Seat 3: jacquelinewu ($25 in chips) 
Seat 4: wildy29 ($13.11 in chips) 
Seat 5: mariuka1 ($12.15 in chips) 
Seat 6: chiyuki ($31.40 in chips) 
Seat 7: Dan Royal ($46.82 in chips) 
Seat 8: KrystalAA ($10.79 in chips) 
Seat 9: PillZ86 ($13.87 in chips) 
KimPa39: posts small blind $0.10
jacquelinewu: posts big blind $0.25
*** HOLE CARDS ***
Dealt to chiyuki [6s 9d]
wildy29: raises $0.25 to $0.50
mariuka1: folds 
chiyuki: folds 
Dan Royal: folds 
KrystalAA: folds 
PillZ86: folds 
mjmichi: folds 
KimPa39: folds 
jacquelinewu: folds 
Uncalled bet ($0.25) returned to wildy29
wildy29 collected $0.60 from pot
wildy29: doesn't show hand 
*** SUMMARY ***
Total pot $0.60 | Rake $0 
Seat 1: mjmichi (button) folded before Flop (didn't bet)
Seat 2: KimPa39 (small blind) folded before Flop
Seat 3: jacquelinewu (big blind) folded before Flop
Seat 4: wildy29 collected ($0.60)
Seat 5: mariuka1 folded before Flop (didn't bet)
Seat 6: chiyuki folded before Flop (didn't bet)
Seat 7: Dan Royal folded before Flop (didn't bet)
Seat 8: KrystalAA folded before Flop (didn't bet)
Seat 9: PillZ86 folded before Flop (didn't bet)



PokerStars Zoom Hand #84299795978:  Hold'em No Limit ($0.10/$0.25) - 2012/08/05 14:43:50 JST [2012/08/05 1:43:50 ET]
Table 'Whirlpool' 9-max Seat #1 is the button
Seat 1: led52 ($12.31 in chips) 
Seat 2: KeLevro0 ($12.70 in chips) 
Seat 3: hirozo ($38.68 in chips) 
Seat 4: KimPa39 ($24.61 in chips) 
Seat 5: chiyuki ($31.40 in chips) 
Seat 6: mjmichi ($25 in chips) 
Seat 7: BlOnDhOlIc ($78.41 in chips) 
Seat 8: seula i ($30.61 in chips) 
Seat 9: ZhukOFFskI ($33.84 in chips) 
KeLevro0: posts small blind $0.10
hirozo: posts big blind $0.25
*** HOLE CARDS ***
Dealt to chiyuki [8c 4h]
KimPa39: folds 
chiyuki: folds 
mjmichi: folds 
BlOnDhOlIc: raises $0.37 to $0.62
seula i: folds 
ZhukOFFskI: folds 
led52: folds 
KeLevro0: folds 
hirozo: folds 
Uncalled bet ($0.37) returned to BlOnDhOlIc
BlOnDhOlIc collected $0.60 from pot
BlOnDhOlIc: doesn't show hand 
*** SUMMARY ***
Total pot $0.60 | Rake $0 
Seat 1: led52 (button) folded before Flop (didn't bet)
Seat 2: KeLevro0 (small blind) folded before Flop
Seat 3: hirozo (big blind) folded before Flop
Seat 4: KimPa39 folded before Flop (didn't bet)
Seat 5: chiyuki folded before Flop (didn't bet)
Seat 6: mjmichi folded before Flop (didn't bet)
Seat 7: BlOnDhOlIc collected ($0.60)
Seat 8: seula i folded before Flop (didn't bet)
Seat 9: ZhukOFFskI folded before Flop (didn't bet)



PokerStars Zoom Hand #84299797165:  Hold'em No Limit ($0.10/$0.25) - 2012/08/05 14:43:55 JST [2012/08/05 1:43:55 ET]
Table 'Whirlpool' 9-max Seat #1 is the button
Seat 1: snejokCoxx ($24.73 in chips) 
Seat 2: chiyuki ($31.40 in chips) 
Seat 3: led52 ($10.62 in chips) 
Seat 4: Vahe50 ($16.27 in chips) 
Seat 5: Nerkit ($11.91 in chips) 
Seat 6: seula i ($25.53 in chips) 
Seat 7: mjmichi ($25 in chips) 
Seat 8: KimPa39 ($24.61 in chips) 
Seat 9: Alvinpe85 ($63.14 in chips) 
chiyuki: posts small blind $0.10
led52: posts big blind $0.25
*** HOLE CARDS ***
Dealt to chiyuki [Ac Jd]
Vahe50: folds 
Nerkit: folds 
seula i: folds 
mjmichi: folds 
KimPa39: folds 
Alvinpe85: folds 
snejokCoxx: raises $0.40 to $0.65
chiyuki: raises $1.40 to $2.05
led52: folds 
snejokCoxx: folds 
Uncalled bet ($1.40) returned to chiyuki
chiyuki collected $1.55 from pot
chiyuki: doesn't show hand 
*** SUMMARY ***
Total pot $1.55 | Rake $0 
Seat 1: snejokCoxx (button) folded before Flop
Seat 2: chiyuki (small blind) collected ($1.55)
Seat 3: led52 (big blind) folded before Flop
Seat 4: Vahe50 folded before Flop (didn't bet)
Seat 5: Nerkit folded before Flop (didn't bet)
Seat 6: seula i folded before Flop (didn't bet)
Seat 7: mjmichi folded before Flop (didn't bet)
Seat 8: KimPa39 folded before Flop (didn't bet)
Seat 9: Alvinpe85 folded before Flop (didn't bet)



PokerStars Zoom Hand #84299810406:  Hold'em No Limit ($0.10/$0.25) - 2012/08/05 14:44:50 JST [2012/08/05 1:44:50 ET]
Table 'Whirlpool' 9-max Seat #1 is the button
Seat 1: Nerkit ($11.66 in chips) 
Seat 2: fuguangps ($25.70 in chips) 
Seat 3: DanielWhyte ($49.44 in chips) 
Seat 4: 1Karina1 ($45.07 in chips) 
Seat 5: mjmichi ($25.10 in chips) 
Seat 6: hl77777 ($8.92 in chips) 
Seat 7: ZhukOFFskI ($36.25 in chips) 
Seat 8: KeLevro0 ($10.77 in chips) 
Seat 9: chiyuki ($32.05 in chips) 
fuguangps: posts small blind $0.10
DanielWhyte: posts big blind $0.25
*** HOLE CARDS ***
Dealt to chiyuki [9d Tc]
1Karina1: folds 
mjmichi: folds 
hl77777: folds 
ZhukOFFskI: raises $0.50 to $0.75
KeLevro0: folds 
chiyuki: folds 
Nerkit: folds 
fuguangps: folds 
DanielWhyte: folds 
Uncalled bet ($0.50) returned to ZhukOFFskI
ZhukOFFskI collected $0.60 from pot
ZhukOFFskI: doesn't show hand 
*** SUMMARY ***
Total pot $0.60 | Rake $0 
Seat 1: Nerkit (button) folded before Flop (didn't bet)
Seat 2: fuguangps (small blind) folded before Flop
Seat 3: DanielWhyte (big blind) folded before Flop
Seat 4: 1Karina1 folded before Flop (didn't bet)
Seat 5: mjmichi folded before Flop (didn't bet)
Seat 6: hl77777 folded before Flop (didn't bet)
Seat 7: ZhukOFFskI collected ($0.60)
Seat 8: KeLevro0 folded before Flop (didn't bet)
Seat 9: chiyuki folded before Flop (didn't bet)



PokerStars Zoom Hand #84299814023:  Hold'em No Limit ($0.10/$0.25) - 2012/08/05 14:45:05 JST [2012/08/05 1:45:05 ET]
Table 'Whirlpool' 9-max Seat #1 is the button
Seat 1: GovGus ($29.31 in chips) 
Seat 2: hirozo ($26.08 in chips) 
Seat 3: led52 ($11.32 in chips) 
Seat 4: KrystalAA ($24.16 in chips) 
Seat 5: chiyuki ($32.05 in chips) 
Seat 6: WARIBANA7777 ($17.76 in chips) 
Seat 7: ll_LaMeR_ll ($73.75 in chips) 
Seat 8: KeLevro0 ($12.25 in chips) 
Seat 9: peng2astic ($13.40 in chips) 
hirozo: posts small blind $0.10
led52: posts big blind $0.25
*** HOLE CARDS ***
Dealt to chiyuki [3s Jd]
KrystalAA: folds 
chiyuki: folds 
WARIBANA7777: folds 
ll_LaMeR_ll: raises $0.50 to $0.75
KeLevro0: calls $0.75
peng2astic: raises $12.65 to $13.40 and is all-in
GovGus: folds 
hirozo: folds 
led52: folds 
ll_LaMeR_ll: folds 
KeLevro0: folds 
Uncalled bet ($12.65) returned to peng2astic
peng2astic collected $2.60 from pot
peng2astic: doesn't show hand 
*** SUMMARY ***
Total pot $2.60 | Rake $0 
Seat 1: GovGus (button) folded before Flop (didn't bet)
Seat 2: hirozo (small blind) folded before Flop
Seat 3: led52 (big blind) folded before Flop
Seat 4: KrystalAA folded before Flop (didn't bet)
Seat 5: chiyuki folded before Flop (didn't bet)
Seat 6: WARIBANA7777 folded before Flop (didn't bet)
Seat 7: ll_LaMeR_ll folded before Flop
Seat 8: KeLevro0 folded before Flop
Seat 9: peng2astic collected ($2.60)



PokerStars Zoom Hand #84299812370:  Hold'em No Limit ($0.10/$0.25) - 2012/08/05 14:44:58 JST [2012/08/05 1:44:58 ET]
Table 'Whirlpool' 9-max Seat #1 is the button
Seat 1: Dafleche ($7.22 in chips) 
Seat 2: deepakmbh ($29.86 in chips) 
Seat 3: KeLevro0 ($10.77 in chips) 
Seat 4: hl77777 ($8.92 in chips) 
Seat 5: hirozo ($26.08 in chips) 
Seat 6: BlOnDhOlIc ($36.35 in chips) 
Seat 7: chiyuki ($32.05 in chips) 
Seat 8: jacquelinewu ($26.97 in chips) 
Seat 9: Phaedrus...3 ($26.39 in chips) 
deepakmbh: posts small blind $0.10
KeLevro0: posts big blind $0.25
*** HOLE CARDS ***
Dealt to chiyuki [7c 2d]
hl77777: folds 
hirozo: folds 
BlOnDhOlIc: folds 
chiyuki: folds 
jacquelinewu: folds 
Phaedrus...3: folds 
Dafleche: folds 
deepakmbh: raises $0.25 to $0.50
KeLevro0: calls $0.25
*** FLOP *** [3c 8h 6c]
deepakmbh: checks 
KeLevro0: checks 
*** TURN *** [3c 8h 6c] [Qd]
deepakmbh: bets $0.70
KeLevro0: calls $0.70
*** RIVER *** [3c 8h 6c Qd] [Qs]
deepakmbh: checks 
KeLevro0: bets $1.75
deepakmbh: folds 
Uncalled bet ($1.75) returned to KeLevro0
KeLevro0 collected $2.29 from pot
KeLevro0: doesn't show hand 
*** SUMMARY ***
Total pot $2.40 | Rake $0.11 
Board [3c 8h 6c Qd Qs]
Seat 1: Dafleche (button) folded before Flop (didn't bet)
Seat 2: deepakmbh (small blind) folded on the River
Seat 3: KeLevro0 (big blind) collected ($2.29)
Seat 4: hl77777 folded before Flop (didn't bet)
Seat 5: hirozo folded before Flop (didn't bet)
Seat 6: BlOnDhOlIc folded before Flop (didn't bet)
Seat 7: chiyuki folded before Flop (didn't bet)
Seat 8: jacquelinewu folded before Flop (didn't bet)
Seat 9: Phaedrus...3 folded before Flop (didn't bet)



PokerStars Zoom Hand #84299806146:  Hold'em No Limit ($0.10/$0.25) - 2012/08/05 14:44:32 JST [2012/08/05 1:44:32 ET]
Table 'Whirlpool' 9-max Seat #1 is the button
Seat 1: BlOnDhOlIc ($36.35 in chips) 
Seat 2: troublesomm ($25 in chips) 
Seat 3: chiyuki ($32.30 in chips) 
Seat 4: deadmoneykid ($24.65 in chips) 
Seat 5: KeLevro0 ($10.77 in chips) 
Seat 6: Nerkit ($12.50 in chips) 
Seat 7: led52 ($11.32 in chips) 
Seat 8: Walturrr ($31.21 in chips) 
Seat 9: debstar27 ($22.35 in chips) 
troublesomm: posts small blind $0.10
chiyuki: posts big blind $0.25
*** HOLE CARDS ***
Dealt to chiyuki [8c 2c]
deadmoneykid: folds 
KeLevro0: folds 
Nerkit: folds 
led52: folds 
Walturrr: raises $0.50 to $0.75
debstar27: calls $0.75
BlOnDhOlIc: folds 
troublesomm: folds 
chiyuki: folds 
*** FLOP *** [2d 4d 9c]
Walturrr: checks 
debstar27: checks 
*** TURN *** [2d 4d 9c] [3c]
Walturrr: checks 
debstar27: bets $0.88
Walturrr: calls $0.88
*** RIVER *** [2d 4d 9c 3c] [4c]
Walturrr: checks 
debstar27: bets $2.41
Walturrr: folds 
Uncalled bet ($2.41) returned to debstar27
debstar27 collected $3.45 from pot
debstar27: doesn't show hand 
*** SUMMARY ***
Total pot $3.61 | Rake $0.16 
Board [2d 4d 9c 3c 4c]
Seat 1: BlOnDhOlIc (button) folded before Flop (didn't bet)
Seat 2: troublesomm (small blind) folded before Flop
Seat 3: chiyuki (big blind) folded before Flop
Seat 4: deadmoneykid folded before Flop (didn't bet)
Seat 5: KeLevro0 folded before Flop (didn't bet)
Seat 6: Nerkit folded before Flop (didn't bet)
Seat 7: led52 folded before Flop (didn't bet)
Seat 8: Walturrr folded on the River
Seat 9: debstar27 collected ($3.45)



PokerStars Zoom Hand #84299815454:  Hold'em No Limit ($0.10/$0.25) - 2012/08/05 14:45:11 JST [2012/08/05 1:45:11 ET]
Table 'Whirlpool' 9-max Seat #1 is the button
Seat 1: mid22 ($8.45 in chips) 
Seat 2: tkd_joker ($24.40 in chips) 
Seat 3: a_tasmanian ($25.02 in chips) 
Seat 4: Dejacob ($25 in chips) 
Seat 5: igor*gemert ($22.87 in chips) 
Seat 6: silvno31 ($32.65 in chips) 
Seat 7: KeLevro0 ($11.90 in chips) 
Seat 8: chiyuki ($32.05 in chips) 
Seat 9: stalkerec ($6.45 in chips) 
tkd_joker: posts small blind $0.10
a_tasmanian: posts big blind $0.25
*** HOLE CARDS ***
Dealt to chiyuki [Ah Jh]
Dejacob: folds 
igor*gemert: folds 
silvno31: folds 
KeLevro0: folds 
chiyuki: raises $0.50 to $0.75
stalkerec: calls $0.75
mid22: folds 
tkd_joker: folds 
a_tasmanian: calls $0.50
*** FLOP *** [Tc 6d Kc]
a_tasmanian: checks 
chiyuki: checks 
stalkerec: checks 
*** TURN *** [Tc 6d Kc] [9c]
a_tasmanian: checks 
chiyuki: checks 
stalkerec: checks 
*** RIVER *** [Tc 6d Kc 9c] [4d]
a_tasmanian: bets $2
chiyuki: folds 
stalkerec: folds 
Uncalled bet ($2) returned to a_tasmanian
a_tasmanian collected $2.24 from pot
a_tasmanian: doesn't show hand 
*** SUMMARY ***
Total pot $2.35 | Rake $0.11 
Board [Tc 6d Kc 9c 4d]
Seat 1: mid22 (button) folded before Flop (didn't bet)
Seat 2: tkd_joker (small blind) folded before Flop
Seat 3: a_tasmanian (big blind) collected ($2.24)
Seat 4: Dejacob folded before Flop (didn't bet)
Seat 5: igor*gemert folded before Flop (didn't bet)
Seat 6: silvno31 folded before Flop (didn't bet)
Seat 7: KeLevro0 folded before Flop (didn't bet)
Seat 8: chiyuki folded on the River
Seat 9: stalkerec folded on the River



PokerStars Zoom Hand #84299831917:  Hold'em No Limit ($0.10/$0.25) - 2012/08/05 14:46:19 JST [2012/08/05 1:46:19 ET]
Table 'Whirlpool' 9-max Seat #1 is the button
Seat 1: chiyuki ($31.30 in chips) 
Seat 2: Nerkit ($10.05 in chips) 
Seat 3: Perstenev ($13.87 in chips) 
Seat 4: Ellen1947 ($30.24 in chips) 
Seat 5: troublesomm ($25 in chips) 
Seat 6: seula i ($28.76 in chips) 
Seat 7: igor*gemert ($25.60 in chips) 
Seat 8: Tom1999 ($15 in chips) 
Seat 9: jacquelinewu ($36.91 in chips) 
Nerkit: posts small blind $0.10
Perstenev: posts big blind $0.25
*** HOLE CARDS ***
Dealt to chiyuki [9h Js]
Ellen1947: folds 
troublesomm: folds 
seula i: folds 
igor*gemert: folds 
Tom1999: raises $0.50 to $0.75
jacquelinewu: folds 
chiyuki: folds 
Nerkit: folds 
Perstenev: folds 
Uncalled bet ($0.50) returned to Tom1999
Tom1999 collected $0.60 from pot
Tom1999: doesn't show hand 
*** SUMMARY ***
Total pot $0.60 | Rake $0 
Seat 1: chiyuki (button) folded before Flop (didn't bet)
Seat 2: Nerkit (small blind) folded before Flop
Seat 3: Perstenev (big blind) folded before Flop
Seat 4: Ellen1947 folded before Flop (didn't bet)
Seat 5: troublesomm folded before Flop (didn't bet)
Seat 6: seula i folded before Flop (didn't bet)
Seat 7: igor*gemert folded before Flop (didn't bet)
Seat 8: Tom1999 collected ($0.60)
Seat 9: jacquelinewu folded before Flop (didn't bet)



PokerStars Zoom Hand #84299829005:  Hold'em No Limit ($0.10/$0.25) - 2012/08/05 14:46:07 JST [2012/08/05 1:46:07 ET]
Table 'Whirlpool' 9-max Seat #1 is the button
Seat 1: fuguangps ($25 in chips) 
Seat 2: led52 ($10.02 in chips) 
Seat 3: phate-1up ($40.99 in chips) 
Seat 4: chiyuki ($31.30 in chips) 
Seat 5: Nerkit ($12.15 in chips) 
Seat 6: hirozo ($39.55 in chips) 
Seat 7: igor*gemert ($19.37 in chips) 
Seat 8: KrystalAA ($15.57 in chips) 
Seat 9: troublesomm ($25 in chips) 
led52: posts small blind $0.10
phate-1up: posts big blind $0.25
*** HOLE CARDS ***
Dealt to chiyuki [Ts Ks]
chiyuki: folds 
Nerkit: folds 
hirozo: folds 
igor*gemert: folds 
KrystalAA: raises $0.46 to $0.71
troublesomm: folds 
fuguangps: calls $0.71
led52: folds 
phate-1up: folds 
*** FLOP *** [2h Qh Jh]
KrystalAA: checks 
fuguangps: bets $1.09
KrystalAA: folds 
Uncalled bet ($1.09) returned to fuguangps
fuguangps collected $1.69 from pot
fuguangps: doesn't show hand 
*** SUMMARY ***
Total pot $1.77 | Rake $0.08 
Board [2h Qh Jh]
Seat 1: fuguangps (button) collected ($1.69)
Seat 2: led52 (small blind) folded before Flop
Seat 3: phate-1up (big blind) folded before Flop
Seat 4: chiyuki folded before Flop (didn't bet)
Seat 5: Nerkit folded before Flop (didn't bet)
Seat 6: hirozo folded before Flop (didn't bet)
Seat 7: igor*gemert folded before Flop (didn't bet)
Seat 8: KrystalAA folded on the Flop
Seat 9: troublesomm folded before Flop (didn't bet)



PokerStars Zoom Hand #84299830184:  Hold'em No Limit ($0.10/$0.25) - 2012/08/05 14:46:12 JST [2012/08/05 1:46:12 ET]
Table 'Whirlpool' 9-max Seat #1 is the button
Seat 1: GovGus ($25.35 in chips) 
Seat 2: BlOnDhOlIc ($92.46 in chips) 
Seat 3: deadmoneykid ($22.65 in chips) 
Seat 4: phate-1up ($37.18 in chips) 
Seat 5: Ellen1947 ($30.24 in chips) 
Seat 6: chiyuki ($31.30 in chips) 
Seat 7: troublesomm ($25 in chips) 
Seat 8: snejokCoxx ($19.10 in chips) 
Seat 9: dushvan ($41.59 in chips) 
BlOnDhOlIc: posts small blind $0.10
deadmoneykid: posts big blind $0.25
*** HOLE CARDS ***
Dealt to chiyuki [4s 8c]
phate-1up: folds 
Ellen1947: folds 
chiyuki: folds 
troublesomm: folds 
snejokCoxx: raises $0.40 to $0.65
dushvan: folds 
GovGus: folds 
BlOnDhOlIc: folds 
deadmoneykid: folds 
Uncalled bet ($0.40) returned to snejokCoxx
snejokCoxx collected $0.60 from pot
snejokCoxx: doesn't show hand 
*** SUMMARY ***
Total pot $0.60 | Rake $0 
Seat 1: GovGus (button) folded before Flop (didn't bet)
Seat 2: BlOnDhOlIc (small blind) folded before Flop
Seat 3: deadmoneykid (big blind) folded before Flop
Seat 4: phate-1up folded before Flop (didn't bet)
Seat 5: Ellen1947 folded before Flop (didn't bet)
Seat 6: chiyuki folded before Flop (didn't bet)
Seat 7: troublesomm folded before Flop (didn't bet)
Seat 8: snejokCoxx collected ($0.60)
Seat 9: dushvan folded before Flop (didn't bet)



PokerStars Zoom Hand #84299833430:  Hold'em No Limit ($0.10/$0.25) - 2012/08/05 14:46:25 JST [2012/08/05 1:46:25 ET]
Table 'Whirlpool' 9-max Seat #1 is the button
Seat 1: Alvinpe85 ($61.84 in chips) 
Seat 2: chiyuki ($31.30 in chips) 
Seat 3: simonzez ($26.96 in chips) 
Seat 4: ZhukOFFskI ($28.38 in chips) 
Seat 5: Nerkit ($9.95 in chips) 
Seat 6: seula i ($28.76 in chips) 
Seat 7: stalkerec ($5.60 in chips) 
Seat 8: WARIBANA7777 ($24.88 in chips) 
Seat 9: BlOnDhOlIc ($35.35 in chips) 
chiyuki: posts small blind $0.10
simonzez: posts big blind $0.25
*** HOLE CARDS ***
Dealt to chiyuki [Ac Qh]
ZhukOFFskI: folds 
Nerkit: folds 
seula i: folds 
stalkerec: folds 
WARIBANA7777: folds 
BlOnDhOlIc: folds 
Alvinpe85: folds 
chiyuki: raises $0.50 to $0.75
simonzez: calls $0.50
*** FLOP *** [8s 6d 6c]
chiyuki: checks 
simonzez: bets $1
chiyuki: folds 
Uncalled bet ($1) returned to simonzez
simonzez collected $1.43 from pot
simonzez: doesn't show hand 
*** SUMMARY ***
Total pot $1.50 | Rake $0.07 
Board [8s 6d 6c]
Seat 1: Alvinpe85 (button) folded before Flop (didn't bet)
Seat 2: chiyuki (small blind) folded on the Flop
Seat 3: simonzez (big blind) collected ($1.43)
Seat 4: ZhukOFFskI folded before Flop (didn't bet)
Seat 5: Nerkit folded before Flop (didn't bet)
Seat 6: seula i folded before Flop (didn't bet)
Seat 7: stalkerec folded before Flop (didn't bet)
Seat 8: WARIBANA7777 folded before Flop (didn't bet)
Seat 9: BlOnDhOlIc folded before Flop (didn't bet)



PokerStars Zoom Hand #84299843756:  Hold'em No Limit ($0.10/$0.25) - 2012/08/05 14:47:07 JST [2012/08/05 1:47:07 ET]
Table 'Whirlpool' 9-max Seat #1 is the button
Seat 1: mariuka1 ($10.33 in chips) 
Seat 2: Dejacob ($25 in chips) 
Seat 3: chiyuki ($30.55 in chips) 
Seat 4: 4plankton ($28.13 in chips) 
Seat 5: fuguangps ($25.88 in chips) 
Seat 6: phate-1up ($56.96 in chips) 
Seat 7: Sal y Limon1 ($26.23 in chips) 
Seat 8: KrystalAA ($23.81 in chips) 
Seat 9: ZhukOFFskI ($28.38 in chips) 
Dejacob: posts small blind $0.10
chiyuki: posts big blind $0.25
*** HOLE CARDS ***
Dealt to chiyuki [Ah 3c]
4plankton: calls $0.25
fuguangps: folds 
phate-1up: folds 
Sal y Limon1: folds 
KrystalAA: folds 
ZhukOFFskI: folds 
mariuka1: raises $0.45 to $0.70
Dejacob: calls $0.60
chiyuki: folds 
4plankton: calls $0.45
*** FLOP *** [6s 6d 5s]
Dejacob: checks 
4plankton: checks 
mariuka1: bets $1.68
Dejacob: raises $3.07 to $4.75
4plankton: folds 
mariuka1: folds 
Uncalled bet ($3.07) returned to Dejacob
Dejacob collected $5.45 from pot
Dejacob: doesn't show hand 
*** SUMMARY ***
Total pot $5.71 | Rake $0.26 
Board [6s 6d 5s]
Seat 1: mariuka1 (button) folded on the Flop
Seat 2: Dejacob (small blind) collected ($5.45)
Seat 3: chiyuki (big blind) folded before Flop
Seat 4: 4plankton folded on the Flop
Seat 5: fuguangps folded before Flop (didn't bet)
Seat 6: phate-1up folded before Flop (didn't bet)
Seat 7: Sal y Limon1 folded before Flop (didn't bet)
Seat 8: KrystalAA folded before Flop (didn't bet)
Seat 9: ZhukOFFskI folded before Flop (didn't bet)



PokerStars Zoom Hand #84299850422:  Hold'em No Limit ($0.10/$0.25) - 2012/08/05 14:47:35 JST [2012/08/05 1:47:35 ET]
Table 'Whirlpool' 9-max Seat #1 is the button
Seat 1: seula i ($116.96 in chips) 
Seat 2: Nagus3x ($22.51 in chips) 
Seat 3: KeLevro0 ($12.50 in chips) 
Seat 4: 1Karina1 ($25 in chips) 
Seat 5: silvno31 ($22.82 in chips) 
Seat 6: ll_LaMeR_ll ($82.62 in chips) 
Seat 7: Perstenev ($16.72 in chips) 
Seat 8: chiyuki ($30.30 in chips) 
Seat 9: led52 ($10.81 in chips) 
Nagus3x: posts small blind $0.10
KeLevro0: posts big blind $0.25
*** HOLE CARDS ***
Dealt to chiyuki [5d 2c]
1Karina1: folds 
silvno31: folds 
ll_LaMeR_ll: raises $0.50 to $0.75
Perstenev: folds 
chiyuki: folds 
led52: folds 
seula i: folds 
Nagus3x: folds 
KeLevro0: folds 
Uncalled bet ($0.50) returned to ll_LaMeR_ll
ll_LaMeR_ll collected $0.60 from pot
ll_LaMeR_ll: doesn't show hand 
*** SUMMARY ***
Total pot $0.60 | Rake $0 
Seat 1: seula i (button) folded before Flop (didn't bet)
Seat 2: Nagus3x (small blind) folded before Flop
Seat 3: KeLevro0 (big blind) folded before Flop
Seat 4: 1Karina1 folded before Flop (didn't bet)
Seat 5: silvno31 folded before Flop (didn't bet)
Seat 6: ll_LaMeR_ll collected ($0.60)
Seat 7: Perstenev folded before Flop (didn't bet)
Seat 8: chiyuki folded before Flop (didn't bet)
Seat 9: led52 folded before Flop (didn't bet)



PokerStars Zoom Hand #84299849435:  Hold'em No Limit ($0.10/$0.25) - 2012/08/05 14:47:31 JST [2012/08/05 1:47:31 ET]
Table 'Whirlpool' 9-max Seat #1 is the button
Seat 1: igor*gemert ($16.67 in chips) 
Seat 2: Walturrr ($34.95 in chips) 
Seat 3: HighDuka ($22.06 in chips) 
Seat 4: Dejacob ($30.47 in chips) 
Seat 5: Nagus3x ($22.51 in chips) 
Seat 6: cr0lox ($19.46 in chips) 
Seat 7: hirozo ($52.28 in chips) 
Seat 8: Nerkit ($11.21 in chips) 
Seat 9: chiyuki ($30.30 in chips) 
Walturrr: posts small blind $0.10
HighDuka: posts big blind $0.25
*** HOLE CARDS ***
Dealt to chiyuki [9d 3c]
Dejacob: folds 
Nagus3x: folds 
cr0lox: folds 
hirozo: folds 
Nerkit: folds 
chiyuki: folds 
igor*gemert: raises $0.25 to $0.50
Walturrr: folds 
HighDuka: calls $0.25
*** FLOP *** [7c 5c Kd]
HighDuka: bets $0.25
igor*gemert: calls $0.25
*** TURN *** [7c 5c Kd] [Qd]
HighDuka: bets $0.75
igor*gemert: calls $0.75
*** RIVER *** [7c 5c Kd Qd] [6h]
HighDuka: bets $3.25
igor*gemert: folds 
Uncalled bet ($3.25) returned to HighDuka
HighDuka collected $2.96 from pot
HighDuka: doesn't show hand 
*** SUMMARY ***
Total pot $3.10 | Rake $0.14 
Board [7c 5c Kd Qd 6h]
Seat 1: igor*gemert (button) folded on the River
Seat 2: Walturrr (small blind) folded before Flop
Seat 3: HighDuka (big blind) collected ($2.96)
Seat 4: Dejacob folded before Flop (didn't bet)
Seat 5: Nagus3x folded before Flop (didn't bet)
Seat 6: cr0lox folded before Flop (didn't bet)
Seat 7: hirozo folded before Flop (didn't bet)
Seat 8: Nerkit folded before Flop (didn't bet)
Seat 9: chiyuki folded before Flop (didn't bet)



PokerStars Zoom Hand #84299851363:  Hold'em No Limit ($0.10/$0.25) - 2012/08/05 14:47:39 JST [2012/08/05 1:47:39 ET]
Table 'Whirlpool' 9-max Seat #1 is the button
Seat 1: Nerkit ($9.95 in chips) 
Seat 2: mid22 ($8.78 in chips) 
Seat 3: 4plankton ($27.43 in chips) 
Seat 4: jacquelinewu ($25 in chips) 
Seat 5: el pore 5 ($27.96 in chips) 
Seat 6: 1Karina1 ($25 in chips) 
Seat 7: chiyuki ($30.30 in chips) 
Seat 8: BlOnDhOlIc ($92.01 in chips) 
Seat 9: troublesomm ($26.10 in chips) 
mid22: posts small blind $0.10
4plankton: posts big blind $0.25
*** HOLE CARDS ***
Dealt to chiyuki [8c 8s]
jacquelinewu: folds 
el pore 5: calls $0.25
1Karina1: folds 
chiyuki: folds 
BlOnDhOlIc: folds 
troublesomm: folds 
Nerkit: folds 
mid22: folds 
4plankton: checks 
*** FLOP *** [Ad Tc 6h]
4plankton: checks 
el pore 5: bets $0.50
4plankton: folds 
Uncalled bet ($0.50) returned to el pore 5
el pore 5 collected $0.57 from pot
el pore 5: doesn't show hand 
*** SUMMARY ***
Total pot $0.60 | Rake $0.03 
Board [Ad Tc 6h]
Seat 1: Nerkit (button) folded before Flop (didn't bet)
Seat 2: mid22 (small blind) folded before Flop
Seat 3: 4plankton (big blind) folded on the Flop
Seat 4: jacquelinewu folded before Flop (didn't bet)
Seat 5: el pore 5 collected ($0.57)
Seat 6: 1Karina1 folded before Flop (didn't bet)
Seat 7: chiyuki folded before Flop (didn't bet)
Seat 8: BlOnDhOlIc folded before Flop (didn't bet)
Seat 9: troublesomm folded before Flop (didn't bet)



PokerStars Zoom Hand #84299857206:  Hold'em No Limit ($0.10/$0.25) - 2012/08/05 14:48:03 JST [2012/08/05 1:48:03 ET]
Table 'Whirlpool' 9-max Seat #1 is the button
Seat 1: hirozo ($40.22 in chips) 
Seat 2: BlOnDhOlIc ($35 in chips) 
Seat 3: troublesomm ($26.10 in chips) 
Seat 4: chiyuki ($30.30 in chips) 
Seat 5: gunbowler ($145.39 in chips) 
Seat 6: Nerkit ($12.58 in chips) 
Seat 7: ll_LaMeR_ll ($82.97 in chips) 
Seat 8: fuguangps ($31.40 in chips) 
Seat 9: GovGus ($29.66 in chips) 
BlOnDhOlIc: posts small blind $0.10
troublesomm: posts big blind $0.25
*** HOLE CARDS ***
Dealt to chiyuki [3d 2h]
chiyuki: folds 
gunbowler: folds 
Nerkit: folds 
ll_LaMeR_ll: raises $0.50 to $0.75
fuguangps: folds 
GovGus: folds 
hirozo: folds 
BlOnDhOlIc: calls $0.65
troublesomm: folds 
*** FLOP *** [8d 3h Ac]
BlOnDhOlIc: checks 
ll_LaMeR_ll: bets $1
BlOnDhOlIc: folds 
Uncalled bet ($1) returned to ll_LaMeR_ll
ll_LaMeR_ll collected $1.67 from pot
ll_LaMeR_ll: doesn't show hand 
*** SUMMARY ***
Total pot $1.75 | Rake $0.08 
Board [8d 3h Ac]
Seat 1: hirozo (button) folded before Flop (didn't bet)
Seat 2: BlOnDhOlIc (small blind) folded on the Flop
Seat 3: troublesomm (big blind) folded before Flop
Seat 4: chiyuki folded before Flop (didn't bet)
Seat 5: gunbowler folded before Flop (didn't bet)
Seat 6: Nerkit folded before Flop (didn't bet)
Seat 7: ll_LaMeR_ll collected ($1.67)
Seat 8: fuguangps folded before Flop (didn't bet)
Seat 9: GovGus folded before Flop (didn't bet)



PokerStars Zoom Hand #84299855190:  Hold'em No Limit ($0.10/$0.25) - 2012/08/05 14:47:55 JST [2012/08/05 1:47:55 ET]
Table 'Whirlpool' 9-max Seat #1 is the button
Seat 1: bigred1102 ($33.17 in chips) 
Seat 2: Dejacob ($30.47 in chips) 
Seat 3: hirozo ($52.28 in chips) 
Seat 4: Nerkit ($12.58 in chips) 
Seat 5: chiyuki ($30.30 in chips) 
Seat 6: DanielWhyte ($48.82 in chips) 
Seat 7: BlOnDhOlIc ($35 in chips) 
Seat 8: Perstenev ($13.27 in chips) 
Seat 9: PillZ86 ($12.28 in chips) 
Dejacob: posts small blind $0.10
hirozo: posts big blind $0.25
*** HOLE CARDS ***
Dealt to chiyuki [9d 4c]
Nerkit: folds 
chiyuki: folds 
DanielWhyte: folds 
BlOnDhOlIc: folds 
Perstenev: folds 
PillZ86: raises $0.25 to $0.50
bigred1102: folds 
Dejacob: folds 
hirozo: calls $0.25
*** FLOP *** [Th Qh 6s]
hirozo: checks 
PillZ86: bets $0.50
hirozo: raises $1.03 to $1.53
PillZ86: raises $10.25 to $11.78 and is all-in
hirozo: folds 
Uncalled bet ($10.25) returned to PillZ86
PillZ86 collected $3.97 from pot
PillZ86: doesn't show hand 
*** SUMMARY ***
Total pot $4.16 | Rake $0.19 
Board [Th Qh 6s]
Seat 1: bigred1102 (button) folded before Flop (didn't bet)
Seat 2: Dejacob (small blind) folded before Flop
Seat 3: hirozo (big blind) folded on the Flop
Seat 4: Nerkit folded before Flop (didn't bet)
Seat 5: chiyuki folded before Flop (didn't bet)
Seat 6: DanielWhyte folded before Flop (didn't bet)
Seat 7: BlOnDhOlIc folded before Flop (didn't bet)
Seat 8: Perstenev folded before Flop (didn't bet)
Seat 9: PillZ86 collected ($3.97)



PokerStars Zoom Hand #84299855933:  Hold'em No Limit ($0.10/$0.25) - 2012/08/05 14:47:58 JST [2012/08/05 1:47:58 ET]
Table 'Whirlpool' 9-max Seat #1 is the button
Seat 1: Nagibator441 ($13.99 in chips) 
Seat 2: deepakmbh ($40.99 in chips) 
Seat 3: Phaedrus...3 ($25.51 in chips) 
Seat 4: chiyuki ($30.30 in chips) 
Seat 5: ll_LaMeR_ll ($82.97 in chips) 
Seat 6: Perstenev ($13.27 in chips) 
Seat 7: Walturrr ($34.85 in chips) 
Seat 8: Nerkit ($12.58 in chips) 
Seat 9: Paranoix1990 ($27.89 in chips) 
deepakmbh: posts small blind $0.10
Phaedrus...3: posts big blind $0.25
*** HOLE CARDS ***
Dealt to chiyuki [3d 9h]
chiyuki: folds 
ll_LaMeR_ll: folds 
Perstenev: folds 
Walturrr: raises $0.47 to $0.72
Nerkit: folds 
Paranoix1990: calls $0.72
Nagibator441: folds 
deepakmbh: calls $0.62
Phaedrus...3: folds 
*** FLOP *** [Kd 2h 9d]
deepakmbh: checks 
Walturrr: bets $1.10
Paranoix1990: folds 
deepakmbh: folds 
Uncalled bet ($1.10) returned to Walturrr
Walturrr collected $2.30 from pot
Walturrr: doesn't show hand 
*** SUMMARY ***
Total pot $2.41 | Rake $0.11 
Board [Kd 2h 9d]
Seat 1: Nagibator441 (button) folded before Flop (didn't bet)
Seat 2: deepakmbh (small blind) folded on the Flop
Seat 3: Phaedrus...3 (big blind) folded before Flop
Seat 4: chiyuki folded before Flop (didn't bet)
Seat 5: ll_LaMeR_ll folded before Flop (didn't bet)
Seat 6: Perstenev folded before Flop (didn't bet)
Seat 7: Walturrr collected ($2.30)
Seat 8: Nerkit folded before Flop (didn't bet)
Seat 9: Paranoix1990 folded on the Flop



PokerStars Zoom Hand #84299864032:  Hold'em No Limit ($0.10/$0.25) - 2012/08/05 14:48:32 JST [2012/08/05 1:48:32 ET]
Table 'Whirlpool' 9-max Seat #1 is the button
Seat 1: stalkerec ($0.82 in chips) 
Seat 2: ZhukOFFskI ($28.13 in chips) 
Seat 3: chiyuki ($30.30 in chips) 
Seat 4: hirozo ($40.22 in chips) 
Seat 5: cofla tito ($9.84 in chips) 
Seat 6: PillZ86 ($14.22 in chips) 
Seat 7: Perstenev ($23.32 in chips) 
Seat 8: troublesomm ($30.57 in chips) 
Seat 9: ChrisCDee ($35.58 in chips) 
ZhukOFFskI: posts small blind $0.10
chiyuki: posts big blind $0.25
*** HOLE CARDS ***
Dealt to chiyuki [Ts 2c]
hirozo: folds 
cofla tito: folds 
PillZ86: folds 
Perstenev: folds 
troublesomm: raises $0.50 to $0.75
ChrisCDee: folds 
stalkerec: folds 
ZhukOFFskI: folds 
chiyuki: folds 
Uncalled bet ($0.50) returned to troublesomm
troublesomm collected $0.60 from pot
troublesomm: doesn't show hand 
*** SUMMARY ***
Total pot $0.60 | Rake $0 
Seat 1: stalkerec (button) folded before Flop (didn't bet)
Seat 2: ZhukOFFskI (small blind) folded before Flop
Seat 3: chiyuki (big blind) folded before Flop
Seat 4: hirozo folded before Flop (didn't bet)
Seat 5: cofla tito folded before Flop (didn't bet)
Seat 6: PillZ86 folded before Flop (didn't bet)
Seat 7: Perstenev folded before Flop (didn't bet)
Seat 8: troublesomm collected ($0.60)
Seat 9: ChrisCDee folded before Flop (didn't bet)



PokerStars Zoom Hand #84299862084:  Hold'em No Limit ($0.10/$0.25) - 2012/08/05 14:48:23 JST [2012/08/05 1:48:23 ET]
Table 'Whirlpool' 9-max Seat #1 is the button
Seat 1: chiyuki ($30.30 in chips) 
Seat 2: Perstenev ($13.27 in chips) 
Seat 3: jacquelinewu ($25 in chips) 
Seat 4: led52 ($14.50 in chips) 
Seat 5: laurentzu84 ($25.35 in chips) 
Seat 6: bigred1102 ($33.17 in chips) 
Seat 7: hirozo ($40.22 in chips) 
Seat 8: Dafleche ($14.30 in chips) 
Seat 9: 4plankton ($27.18 in chips) 
Perstenev: posts small blind $0.10
jacquelinewu: posts big blind $0.25
*** HOLE CARDS ***
Dealt to chiyuki [8h 6s]
led52: folds 
laurentzu84: folds 
bigred1102: calls $0.25
hirozo: folds 
Dafleche: folds 
4plankton: folds 
chiyuki: folds 
Perstenev: calls $0.15
jacquelinewu: checks 
*** FLOP *** [Ts 7c Qd]
Perstenev: checks 
jacquelinewu: checks 
bigred1102: bets $0.50
Perstenev: folds 
jacquelinewu: folds 
Uncalled bet ($0.50) returned to bigred1102
bigred1102 collected $0.72 from pot
bigred1102: doesn't show hand 
*** SUMMARY ***
Total pot $0.75 | Rake $0.03 
Board [Ts 7c Qd]
Seat 1: chiyuki (button) folded before Flop (didn't bet)
Seat 2: Perstenev (small blind) folded on the Flop
Seat 3: jacquelinewu (big blind) folded on the Flop
Seat 4: led52 folded before Flop (didn't bet)
Seat 5: laurentzu84 folded before Flop (didn't bet)
Seat 6: bigred1102 collected ($0.72)
Seat 7: hirozo folded before Flop (didn't bet)
Seat 8: Dafleche folded before Flop (didn't bet)
Seat 9: 4plankton folded before Flop (didn't bet)



PokerStars Zoom Hand #84299867131:  Hold'em No Limit ($0.10/$0.25) - 2012/08/05 14:48:45 JST [2012/08/05 1:48:45 ET]
Table 'Whirlpool' 9-max Seat #1 is the button
Seat 1: fuguangps ($64.94 in chips) 
Seat 2: chiyuki ($30.05 in chips) 
Seat 3: deadmoneykid ($24.90 in chips) 
Seat 4: azizmimi ($8.56 in chips) 
Seat 5: DanielWhyte ($47.32 in chips) 
Seat 6: led52 ($12.05 in chips) 
Seat 7: 1Karina1 ($45.84 in chips) 
Seat 8: ZhukOFFskI ($28.03 in chips) 
Seat 9: KeLevro0 ($11.90 in chips) 
chiyuki: posts small blind $0.10
deadmoneykid: posts big blind $0.25
*** HOLE CARDS ***
Dealt to chiyuki [4d 7s]
azizmimi: folds 
DanielWhyte: folds 
led52: folds 
1Karina1: folds 
ZhukOFFskI: folds 
KeLevro0: folds 
fuguangps: folds 
chiyuki: folds 
Uncalled bet ($0.15) returned to deadmoneykid
deadmoneykid collected $0.20 from pot
deadmoneykid: doesn't show hand 
*** SUMMARY ***
Total pot $0.20 | Rake $0 
Seat 1: fuguangps (button) folded before Flop (didn't bet)
Seat 2: chiyuki (small blind) folded before Flop
Seat 3: deadmoneykid (big blind) collected ($0.20)
Seat 4: azizmimi folded before Flop (didn't bet)
Seat 5: DanielWhyte folded before Flop (didn't bet)
Seat 6: led52 folded before Flop (didn't bet)
Seat 7: 1Karina1 folded before Flop (didn't bet)
Seat 8: ZhukOFFskI folded before Flop (didn't bet)
Seat 9: KeLevro0 folded before Flop (didn't bet)



PokerStars Zoom Hand #84299858401:  Hold'em No Limit ($0.10/$0.25) - 2012/08/05 14:48:08 JST [2012/08/05 1:48:08 ET]
Table 'Whirlpool' 9-max Seat #1 is the button
Seat 1: KrystalAA ($12.47 in chips) 
Seat 2: GovGus ($29.66 in chips) 
Seat 3: hl77777 ($11.22 in chips) 
Seat 4: dushvan ($41.94 in chips) 
Seat 5: Nerkit ($12.58 in chips) 
Seat 6: seula i ($39.24 in chips) 
Seat 7: chiyuki ($30.30 in chips) 
Seat 8: colorado2108 ($4.41 in chips) 
Seat 9: led52 ($14.50 in chips) 
GovGus: posts small blind $0.10
hl77777: posts big blind $0.25
*** HOLE CARDS ***
Dealt to chiyuki [Ks 3h]
dushvan: raises $0.37 to $0.62
Nerkit: folds 
seula i: folds 
chiyuki: folds 
colorado2108: calls $0.62
led52: folds 
KrystalAA: raises $1.70 to $2.32
GovGus: folds 
hl77777: folds 
dushvan: folds 
colorado2108: calls $1.70
*** FLOP *** [8d 6c 9s]
colorado2108: checks 
KrystalAA: bets $10.15 and is all-in
colorado2108: calls $2.09 and is all-in
Uncalled bet ($8.06) returned to KrystalAA
*** TURN *** [8d 6c 9s] [Tc]
*** RIVER *** [8d 6c 9s Tc] [9c]
*** SHOW DOWN ***
colorado2108: shows [Ts Kc] (two pair, Tens and Nines)
KrystalAA: shows [Qc Qs] (two pair, Queens and Nines)
KrystalAA collected $9.35 from pot
*** SUMMARY ***
Total pot $9.79 | Rake $0.44 
Board [8d 6c 9s Tc 9c]
Seat 1: KrystalAA (button) showed [Qc Qs] and won ($9.35) with two pair, Queens and Nines
Seat 2: GovGus (small blind) folded before Flop
Seat 3: hl77777 (big blind) folded before Flop
Seat 4: dushvan folded before Flop
Seat 5: Nerkit folded before Flop (didn't bet)
Seat 6: seula i folded before Flop (didn't bet)
Seat 7: chiyuki folded before Flop (didn't bet)
Seat 8: colorado2108 showed [Ts Kc] and lost with two pair, Tens and Nines
Seat 9: led52 folded before Flop (didn't bet)



PokerStars Zoom Hand #84299869873:  Hold'em No Limit ($0.10/$0.25) - 2012/08/05 14:48:56 JST [2012/08/05 1:48:56 ET]
Table 'Whirlpool' 9-max Seat #1 is the button
Seat 1: Dejacob ($26.22 in chips) 
Seat 2: deepakmbh ($42.97 in chips) 
Seat 3: el pore 5 ($28.18 in chips) 
Seat 4: Walturrr ($26.16 in chips) 
Seat 5: Cyanidoff ($31.14 in chips) 
Seat 6: tkd_joker ($23.10 in chips) 
Seat 7: snejokCoxx ($11.15 in chips) 
Seat 8: chiyuki ($29.95 in chips) 
Seat 9: led52 ($12.40 in chips) 
deepakmbh: posts small blind $0.10
el pore 5: posts big blind $0.25
*** HOLE CARDS ***
Dealt to chiyuki [4c 9h]
Walturrr: folds 
Cyanidoff: folds 
tkd_joker: calls $0.25
snejokCoxx: folds 
chiyuki: folds 
led52: folds 
Dejacob: folds 
deepakmbh: folds 
el pore 5: checks 
*** FLOP *** [8h 9d 6h]
el pore 5: checks 
tkd_joker: bets $0.25
el pore 5: folds 
Uncalled bet ($0.25) returned to tkd_joker
tkd_joker collected $0.57 from pot
tkd_joker: doesn't show hand 
*** SUMMARY ***
Total pot $0.60 | Rake $0.03 
Board [8h 9d 6h]
Seat 1: Dejacob (button) folded before Flop (didn't bet)
Seat 2: deepakmbh (small blind) folded before Flop
Seat 3: el pore 5 (big blind) folded on the Flop
Seat 4: Walturrr folded before Flop (didn't bet)
Seat 5: Cyanidoff folded before Flop (didn't bet)
Seat 6: tkd_joker collected ($0.57)
Seat 7: snejokCoxx folded before Flop (didn't bet)
Seat 8: chiyuki folded before Flop (didn't bet)
Seat 9: led52 folded before Flop (didn't bet)



PokerStars Zoom Hand #84299872538:  Hold'em No Limit ($0.10/$0.25) - 2012/08/05 14:49:07 JST [2012/08/05 1:49:07 ET]
Table 'Whirlpool' 9-max Seat #1 is the button
Seat 1: ZhukOFFskI ($28.16 in chips) 
Seat 2: mjmichi ($30.29 in chips) 
Seat 3: BlOnDhOlIc ($90.01 in chips) 
Seat 4: snejokCoxx ($11.15 in chips) 
Seat 5: chiyuki ($29.95 in chips) 
Seat 6: jacquelinewu ($46.48 in chips) 
Seat 7: troublesomm ($25 in chips) 
Seat 8: Cyanidoff ($31.14 in chips) 
Seat 9: Dejacob ($26.22 in chips) 
mjmichi: posts small blind $0.10
BlOnDhOlIc: posts big blind $0.25
*** HOLE CARDS ***
Dealt to chiyuki [Ac 6s]
snejokCoxx: folds 
chiyuki: folds 
jacquelinewu: folds 
troublesomm: folds 
Cyanidoff: folds 
Dejacob: folds 
ZhukOFFskI: folds 
mjmichi: folds 
Uncalled bet ($0.15) returned to BlOnDhOlIc
BlOnDhOlIc collected $0.20 from pot
BlOnDhOlIc: doesn't show hand 
*** SUMMARY ***
Total pot $0.20 | Rake $0 
Seat 1: ZhukOFFskI (button) folded before Flop (didn't bet)
Seat 2: mjmichi (small blind) folded before Flop
Seat 3: BlOnDhOlIc (big blind) collected ($0.20)
Seat 4: snejokCoxx folded before Flop (didn't bet)
Seat 5: chiyuki folded before Flop (didn't bet)
Seat 6: jacquelinewu folded before Flop (didn't bet)
Seat 7: troublesomm folded before Flop (didn't bet)
Seat 8: Cyanidoff folded before Flop (didn't bet)
Seat 9: Dejacob folded before Flop (didn't bet)



PokerStars Zoom Hand #84299863107:  Hold'em No Limit ($0.10/$0.25) - 2012/08/05 14:48:28 JST [2012/08/05 1:48:28 ET]
Table 'Whirlpool' 9-max Seat #1 is the button
Seat 1: 1Karina1 ($25 in chips) 
Seat 2: 4plankton ($27.18 in chips) 
Seat 3: laurentzu84 ($25.35 in chips) 
Seat 4: led52 ($12.15 in chips) 
Seat 5: tribunpdm ($17.55 in chips) 
Seat 6: chiyuki ($30.30 in chips) 
Seat 7: cofla tito ($9.84 in chips) 
Seat 8: mjmichi ($25.15 in chips) 
Seat 9: snejokCoxx ($11.15 in chips) 
4plankton: posts small blind $0.10
laurentzu84: posts big blind $0.25
*** HOLE CARDS ***
Dealt to chiyuki [9c 3d]
led52: folds 
tribunpdm: raises $0.50 to $0.75
chiyuki: folds 
cofla tito: folds 
mjmichi: folds 
snejokCoxx: folds 
1Karina1: folds 
4plankton: folds 
laurentzu84: raises $0.75 to $1.50
tribunpdm: raises $1.50 to $3
laurentzu84: calls $1.50
*** FLOP *** [6h Jh Td]
laurentzu84: checks 
tribunpdm: bets $3
laurentzu84: calls $3
*** TURN *** [6h Jh Td] [2s]
laurentzu84: checks 
tribunpdm: bets $4
laurentzu84: raises $7.75 to $11.75
tribunpdm: calls $7.55 and is all-in
Uncalled bet ($0.20) returned to laurentzu84
*** RIVER *** [6h Jh Td 2s] [Js]
*** SHOW DOWN ***
laurentzu84: shows [Ks Ts] (two pair, Jacks and Tens)
tribunpdm: shows [Kc Kd] (two pair, Kings and Jacks)
tribunpdm collected $33.62 from pot
*** SUMMARY ***
Total pot $35.20 | Rake $1.58 
Board [6h Jh Td 2s Js]
Seat 1: 1Karina1 (button) folded before Flop (didn't bet)
Seat 2: 4plankton (small blind) folded before Flop
Seat 3: laurentzu84 (big blind) showed [Ks Ts] and lost with two pair, Jacks and Tens
Seat 4: led52 folded before Flop (didn't bet)
Seat 5: tribunpdm showed [Kc Kd] and won ($33.62) with two pair, Kings and Jacks
Seat 6: chiyuki folded before Flop (didn't bet)
Seat 7: cofla tito folded before Flop (didn't bet)
Seat 8: mjmichi folded before Flop (didn't bet)
Seat 9: snejokCoxx folded before Flop (didn't bet)



PokerStars Zoom Hand #84299870810:  Hold'em No Limit ($0.10/$0.25) - 2012/08/05 14:49:00 JST [2012/08/05 1:49:00 ET]
Table 'Whirlpool' 9-max Seat #1 is the button
Seat 1: deepakmbh ($42.87 in chips) 
Seat 2: phate-1up ($46.44 in chips) 
Seat 3: mjmichi ($41.95 in chips) 
Seat 4: bigred1102 ($33.64 in chips) 
Seat 5: chiyuki ($29.95 in chips) 
Seat 6: kamikkaze ($16.40 in chips) 
Seat 7: troublesomm ($30.92 in chips) 
Seat 8: Sal y Limon1 ($25.88 in chips) 
Seat 9: BlOnDhOlIc ($34 in chips) 
phate-1up: posts small blind $0.10
mjmichi: posts big blind $0.25
*** HOLE CARDS ***
Dealt to chiyuki [9s 7c]
bigred1102: raises $0.25 to $0.50
chiyuki: folds 
kamikkaze: folds 
troublesomm: folds 
Sal y Limon1: folds 
BlOnDhOlIc: folds 
deepakmbh: calls $0.50
phate-1up: folds 
mjmichi: folds 
*** FLOP *** [Kd Qh 8c]
bigred1102: bets $0.75
deepakmbh: calls $0.75
*** TURN *** [Kd Qh 8c] [4c]
bigred1102: bets $0.75
deepakmbh: calls $0.75
*** RIVER *** [Kd Qh 8c 4c] [6h]
bigred1102: bets $0.75
deepakmbh: folds 
Uncalled bet ($0.75) returned to bigred1102
bigred1102 collected $4.15 from pot
bigred1102: doesn't show hand 
*** SUMMARY ***
Total pot $4.35 | Rake $0.20 
Board [Kd Qh 8c 4c 6h]
Seat 1: deepakmbh (button) folded on the River
Seat 2: phate-1up (small blind) folded before Flop
Seat 3: mjmichi (big blind) folded before Flop
Seat 4: bigred1102 collected ($4.15)
Seat 5: chiyuki folded before Flop (didn't bet)
Seat 6: kamikkaze folded before Flop (didn't bet)
Seat 7: troublesomm folded before Flop (didn't bet)
Seat 8: Sal y Limon1 folded before Flop (didn't bet)
Seat 9: BlOnDhOlIc folded before Flop (didn't bet)



PokerStars Zoom Hand #84299868128:  Hold'em No Limit ($0.10/$0.25) - 2012/08/05 14:48:49 JST [2012/08/05 1:48:49 ET]
Table 'Whirlpool' 9-max Seat #1 is the button
Seat 1: KimPa39 ($24.25 in chips) 
Seat 2: azizmimi ($8.56 in chips) 
Seat 3: 1Karina1 ($45.84 in chips) 
Seat 4: BlOnDhOlIc ($34 in chips) 
Seat 5: ChrisCDee ($35.58 in chips) 
Seat 6: gunbowler ($145.14 in chips) 
Seat 7: jacquelinewu ($25 in chips) 
Seat 8: Alvinpe85 ($57.34 in chips) 
Seat 9: chiyuki ($29.95 in chips) 
azizmimi: posts small blind $0.10
1Karina1: posts big blind $0.25
*** HOLE CARDS ***
Dealt to chiyuki [As 5h]
BlOnDhOlIc: folds 
ChrisCDee: folds 
gunbowler: folds 
jacquelinewu: raises $0.50 to $0.75
Alvinpe85: folds 
chiyuki: folds 
KimPa39: folds 
azizmimi: folds 
1Karina1: calls $0.50
*** FLOP *** [Ac Jd 4s]
1Karina1: bets $1
jacquelinewu: raises $2.50 to $3.50
1Karina1: raises $5.75 to $9.25
jacquelinewu: raises $15 to $24.25 and is all-in
1Karina1: calls $15
*** TURN *** [Ac Jd 4s] [8d]
*** RIVER *** [Ac Jd 4s 8d] [9c]
*** SHOW DOWN ***
1Karina1: shows [Ah Jc] (two pair, Aces and Jacks)
jacquelinewu: shows [4h 4c] (three of a kind, Fours)
jacquelinewu collected $48.10 from pot
*** SUMMARY ***
Total pot $50.10 | Rake $2 
Board [Ac Jd 4s 8d 9c]
Seat 1: KimPa39 (button) folded before Flop (didn't bet)
Seat 2: azizmimi (small blind) folded before Flop
Seat 3: 1Karina1 (big blind) showed [Ah Jc] and lost with two pair, Aces and Jacks
Seat 4: BlOnDhOlIc folded before Flop (didn't bet)
Seat 5: ChrisCDee folded before Flop (didn't bet)
Seat 6: gunbowler folded before Flop (didn't bet)
Seat 7: jacquelinewu showed [4h 4c] and won ($48.10) with three of a kind, Fours
Seat 8: Alvinpe85 folded before Flop (didn't bet)
Seat 9: chiyuki folded before Flop (didn't bet)



PokerStars Zoom Hand #84299873777:  Hold'em No Limit ($0.10/$0.25) - 2012/08/05 14:49:12 JST [2012/08/05 1:49:12 ET]
Table 'Whirlpool' 9-max Seat #1 is the button
Seat 1: hl77777 ($10.97 in chips) 
Seat 2: chiyuki ($29.95 in chips) 
Seat 3: Perstenev ($13 in chips) 
Seat 4: troublesomm ($25 in chips) 
Seat 5: phate-1up ($29.83 in chips) 
Seat 6: mrvalet841 ($25.42 in chips) 
Seat 7: kamikkaze ($16.40 in chips) 
Seat 8: ChrisCDee ($30.88 in chips) 
Seat 9: mjmichi ($30.19 in chips) 
chiyuki: posts small blind $0.10
Perstenev: posts big blind $0.25
*** HOLE CARDS ***
Dealt to chiyuki [9s 9h]
troublesomm: folds 
phate-1up: folds 
mrvalet841: folds 
kamikkaze: raises $0.38 to $0.63
ChrisCDee: folds 
mjmichi: folds 
hl77777: folds 
chiyuki: calls $0.53
Perstenev: calls $0.38
*** FLOP *** [2d Ad Tc]
chiyuki: checks 
Perstenev: checks 
kamikkaze: bets $1.17
chiyuki: folds 
Perstenev: folds 
Uncalled bet ($1.17) returned to kamikkaze
kamikkaze collected $1.81 from pot
kamikkaze: doesn't show hand 
*** SUMMARY ***
Total pot $1.89 | Rake $0.08 
Board [2d Ad Tc]
Seat 1: hl77777 (button) folded before Flop (didn't bet)
Seat 2: chiyuki (small blind) folded on the Flop
Seat 3: Perstenev (big blind) folded on the Flop
Seat 4: troublesomm folded before Flop (didn't bet)
Seat 5: phate-1up folded before Flop (didn't bet)
Seat 6: mrvalet841 folded before Flop (didn't bet)
Seat 7: kamikkaze collected ($1.81)
Seat 8: ChrisCDee folded before Flop (didn't bet)
Seat 9: mjmichi folded before Flop (didn't bet)



PokerStars Zoom Hand #84299871558:  Hold'em No Limit ($0.10/$0.25) - 2012/08/05 14:49:03 JST [2012/08/05 1:49:03 ET]
Table 'Whirlpool' 9-max Seat #1 is the button
Seat 1: Alvinpe85 ($57.34 in chips) 
Seat 2: KrystalAA ($29.14 in chips) 
Seat 3: Walturrr ($35.71 in chips) 
Seat 4: ZhukOFFskI ($28.16 in chips) 
Seat 5: fuguangps ($32.09 in chips) 
Seat 6: chiyuki ($29.95 in chips) 
Seat 7: KeLevro0 ($11.90 in chips) 
Seat 8: kamikkaze ($16.40 in chips) 
Seat 9: deadmoneykid ($25 in chips) 
KrystalAA: posts small blind $0.10
Walturrr: posts big blind $0.25
*** HOLE CARDS ***
Dealt to chiyuki [3s Ks]
ZhukOFFskI: folds 
fuguangps: folds 
chiyuki: folds 
KeLevro0: folds 
kamikkaze: folds 
deadmoneykid: raises $0.25 to $0.50
Alvinpe85: raises $1.25 to $1.75
KrystalAA: folds 
Walturrr: folds 
deadmoneykid: folds 
Uncalled bet ($1.25) returned to Alvinpe85
Alvinpe85 collected $1.35 from pot
Alvinpe85: doesn't show hand 
*** SUMMARY ***
Total pot $1.35 | Rake $0 
Seat 1: Alvinpe85 (button) collected ($1.35)
Seat 2: KrystalAA (small blind) folded before Flop
Seat 3: Walturrr (big blind) folded before Flop
Seat 4: ZhukOFFskI folded before Flop (didn't bet)
Seat 5: fuguangps folded before Flop (didn't bet)
Seat 6: chiyuki folded before Flop (didn't bet)
Seat 7: KeLevro0 folded before Flop (didn't bet)
Seat 8: kamikkaze folded before Flop (didn't bet)
Seat 9: deadmoneykid folded before Flop



PokerStars Zoom Hand #84299882038:  Hold'em No Limit ($0.10/$0.25) - 2012/08/05 14:49:47 JST [2012/08/05 1:49:47 ET]
Table 'Whirlpool' 9-max Seat #1 is the button
Seat 1: snejokCoxx ($12.86 in chips) 
Seat 2: troublesomm ($25 in chips) 
Seat 3: chiyuki ($29.32 in chips) 
Seat 4: Tom1999 ($25.29 in chips) 
Seat 5: KrystalAA ($17.41 in chips) 
Seat 6: Dan Royal ($45.29 in chips) 
Seat 7: Perstenev ($12.02 in chips) 
Seat 8: deepakmbh ($40.87 in chips) 
Seat 9: 1Karina1 ($25 in chips) 
troublesomm: posts small blind $0.10
chiyuki: posts big blind $0.25
*** HOLE CARDS ***
Dealt to chiyuki [5d 6d]
Tom1999: folds 
KrystalAA: folds 
Dan Royal: raises $0.50 to $0.75
Perstenev: folds 
deepakmbh: folds 
1Karina1: folds 
snejokCoxx: raises $1.25 to $2
troublesomm: folds 
chiyuki: folds 
Dan Royal: folds 
Uncalled bet ($1.25) returned to snejokCoxx
snejokCoxx collected $1.85 from pot
snejokCoxx: doesn't show hand 
*** SUMMARY ***
Total pot $1.85 | Rake $0 
Seat 1: snejokCoxx (button) collected ($1.85)
Seat 2: troublesomm (small blind) folded before Flop
Seat 3: chiyuki (big blind) folded before Flop
Seat 4: Tom1999 folded before Flop (didn't bet)
Seat 5: KrystalAA folded before Flop (didn't bet)
Seat 6: Dan Royal folded before Flop
Seat 7: Perstenev folded before Flop (didn't bet)
Seat 8: deepakmbh folded before Flop (didn't bet)
Seat 9: 1Karina1 folded before Flop (didn't bet)



PokerStars Zoom Hand #84299888213:  Hold'em No Limit ($0.10/$0.25) - 2012/08/05 14:50:11 JST [2012/08/05 1:50:11 ET]
Table 'Whirlpool' 9-max Seat #1 is the button
Seat 1: ZhukOFFskI ($28.91 in chips) 
Seat 2: led52 ($12.25 in chips) 
Seat 3: BlOnDhOlIc ($34.74 in chips) 
Seat 4: hl77777 ($14.72 in chips) 
Seat 5: colorado2108 ($14.85 in chips) 
Seat 6: ll_LaMeR_ll ($79.38 in chips) 
Seat 7: chiyuki ($29.07 in chips) 
Seat 8: snejokCoxx ($13.96 in chips) 
Seat 9: troublesomm ($25.35 in chips) 
led52: posts small blind $0.10
BlOnDhOlIc: posts big blind $0.25
*** HOLE CARDS ***
Dealt to chiyuki [8s 5d]
hl77777: folds 
colorado2108: raises $0.25 to $0.50
ll_LaMeR_ll: folds 
chiyuki: folds 
snejokCoxx: folds 
troublesomm: folds 
ZhukOFFskI: folds 
led52: folds 
BlOnDhOlIc: folds 
Uncalled bet ($0.25) returned to colorado2108
colorado2108 collected $0.60 from pot
colorado2108: doesn't show hand 
*** SUMMARY ***
Total pot $0.60 | Rake $0 
Seat 1: ZhukOFFskI (button) folded before Flop (didn't bet)
Seat 2: led52 (small blind) folded before Flop
Seat 3: BlOnDhOlIc (big blind) folded before Flop
Seat 4: hl77777 folded before Flop (didn't bet)
Seat 5: colorado2108 collected ($0.60)
Seat 6: ll_LaMeR_ll folded before Flop (didn't bet)
Seat 7: chiyuki folded before Flop (didn't bet)
Seat 8: snejokCoxx folded before Flop (didn't bet)
Seat 9: troublesomm folded before Flop (didn't bet)



PokerStars Zoom Hand #84299880847:  Hold'em No Limit ($0.10/$0.25) - 2012/08/05 14:49:42 JST [2012/08/05 1:49:42 ET]
Table 'Whirlpool' 9-max Seat #1 is the button
Seat 1: chiyuki ($29.32 in chips) 
Seat 2: Landybob ($34.86 in chips) 
Seat 3: tribunpdm ($33.62 in chips) 
Seat 4: Perstenev ($12.02 in chips) 
Seat 5: deepakmbh ($40.87 in chips) 
Seat 6: Jene4kaBest ($14.23 in chips) 
Seat 7: Nerkit ($9.60 in chips) 
Seat 8: Phaedrus...3 ($25 in chips) 
Seat 9: Dafleche ($16.83 in chips) 
Landybob: posts small blind $0.10
tribunpdm: posts big blind $0.25
*** HOLE CARDS ***
Dealt to chiyuki [8h 5d]
Perstenev: folds 
deepakmbh: folds 
Jene4kaBest: folds 
Nerkit: folds 
Phaedrus...3: folds 
Dafleche: calls $0.25
chiyuki: folds 
Landybob: folds 
tribunpdm: checks 
*** FLOP *** [5c Jc Jh]
tribunpdm: checks 
Dafleche: bets $0.50
tribunpdm: calls $0.50
*** TURN *** [5c Jc Jh] [6s]
tribunpdm: checks 
Dafleche: bets $1
tribunpdm: calls $1
*** RIVER *** [5c Jc Jh 6s] [Td]
tribunpdm: checks 
Dafleche: checks 
*** SHOW DOWN ***
tribunpdm: shows [5h 3s] (two pair, Jacks and Fives)
Dafleche: shows [7c 7d] (two pair, Jacks and Sevens)
Dafleche collected $3.44 from pot
*** SUMMARY ***
Total pot $3.60 | Rake $0.16 
Board [5c Jc Jh 6s Td]
Seat 1: chiyuki (button) folded before Flop (didn't bet)
Seat 2: Landybob (small blind) folded before Flop
Seat 3: tribunpdm (big blind) showed [5h 3s] and lost with two pair, Jacks and Fives
Seat 4: Perstenev folded before Flop (didn't bet)
Seat 5: deepakmbh folded before Flop (didn't bet)
Seat 6: Jene4kaBest folded before Flop (didn't bet)
Seat 7: Nerkit folded before Flop (didn't bet)
Seat 8: Phaedrus...3 folded before Flop (didn't bet)
Seat 9: Dafleche showed [7c 7d] and won ($3.44) with two pair, Jacks and Sevens



PokerStars Zoom Hand #84299889166:  Hold'em No Limit ($0.10/$0.25) - 2012/08/05 14:50:15 JST [2012/08/05 1:50:15 ET]
Table 'Whirlpool' 9-max Seat #1 is the button
Seat 1: KrystalAA ($14.86 in chips) 
Seat 2: ZhukOFFskI ($28.91 in chips) 
Seat 3: mjmichi ($41.95 in chips) 
Seat 4: phate-1up ($46.09 in chips) 
Seat 5: deadmoneykid ($22.15 in chips) 
Seat 6: HighDuka ($27.74 in chips) 
Seat 7: hirozo ($25 in chips) 
Seat 8: troublesomm ($25.35 in chips) 
Seat 9: chiyuki ($29.07 in chips) 
ZhukOFFskI: posts small blind $0.10
mjmichi: posts big blind $0.25
*** HOLE CARDS ***
Dealt to chiyuki [Tc 7d]
phate-1up: folds 
deadmoneykid: folds 
HighDuka: folds 
hirozo: folds 
troublesomm: folds 
chiyuki: folds 
KrystalAA: folds 
ZhukOFFskI: folds 
Uncalled bet ($0.15) returned to mjmichi
mjmichi collected $0.20 from pot
mjmichi: doesn't show hand 
*** SUMMARY ***
Total pot $0.20 | Rake $0 
Seat 1: KrystalAA (button) folded before Flop (didn't bet)
Seat 2: ZhukOFFskI (small blind) folded before Flop
Seat 3: mjmichi (big blind) collected ($0.20)
Seat 4: phate-1up folded before Flop (didn't bet)
Seat 5: deadmoneykid folded before Flop (didn't bet)
Seat 6: HighDuka folded before Flop (didn't bet)
Seat 7: hirozo folded before Flop (didn't bet)
Seat 8: troublesomm folded before Flop (didn't bet)
Seat 9: chiyuki folded before Flop (didn't bet)



PokerStars Zoom Hand #84299891593:  Hold'em No Limit ($0.10/$0.25) - 2012/08/05 14:50:25 JST [2012/08/05 1:50:25 ET]
Table 'Whirlpool' 9-max Seat #1 is the button
Seat 1: chiyuki ($29.07 in chips) 
Seat 2: mjmichi ($25.10 in chips) 
Seat 3: led52 ($11.40 in chips) 
Seat 4: hirozo ($51.25 in chips) 
Seat 5: phate-1up ($72.63 in chips) 
Seat 6: hl77777 ($14.72 in chips) 
Seat 7: Dejacob ($26.40 in chips) 
Seat 8: Perstenev ($12.27 in chips) 
Seat 9: kamikkaze ($16.73 in chips) 
mjmichi: posts small blind $0.10
led52: posts big blind $0.25
*** HOLE CARDS ***
Dealt to chiyuki [2d Jd]
hirozo: folds 
phate-1up: folds 
hl77777: raises $0.50 to $0.75
Dejacob: folds 
Perstenev: folds 
kamikkaze: folds 
chiyuki: folds 
mjmichi: folds 
led52: folds 
Uncalled bet ($0.50) returned to hl77777
hl77777 collected $0.60 from pot
hl77777: doesn't show hand 
*** SUMMARY ***
Total pot $0.60 | Rake $0 
Seat 1: chiyuki (button) folded before Flop (didn't bet)
Seat 2: mjmichi (small blind) folded before Flop
Seat 3: led52 (big blind) folded before Flop
Seat 4: hirozo folded before Flop (didn't bet)
Seat 5: phate-1up folded before Flop (didn't bet)
Seat 6: hl77777 collected ($0.60)
Seat 7: Dejacob folded before Flop (didn't bet)
Seat 8: Perstenev folded before Flop (didn't bet)
Seat 9: kamikkaze folded before Flop (didn't bet)



PokerStars Zoom Hand #84299895101:  Hold'em No Limit ($0.10/$0.25) - 2012/08/05 14:50:39 JST [2012/08/05 1:50:39 ET]
Table 'Whirlpool' 9-max Seat #1 is the button
Seat 1: a_tasmanian ($47.49 in chips) 
Seat 2: hirozo ($42.69 in chips) 
Seat 3: ZhukOFFskI ($27.81 in chips) 
Seat 4: simonzez ($26.43 in chips) 
Seat 5: Jene4kaBest ($13.38 in chips) 
Seat 6: troublesomm ($25 in chips) 
Seat 7: Perstenev ($11.67 in chips) 
Seat 8: chiyuki ($29.07 in chips) 
Seat 9: KeLevro0 ($11.80 in chips) 
hirozo: posts small blind $0.10
ZhukOFFskI: posts big blind $0.25
*** HOLE CARDS ***
Dealt to chiyuki [Kh 3d]
simonzez: calls $0.25
Jene4kaBest: folds 
troublesomm: folds 
Perstenev: folds 
chiyuki: folds 
KeLevro0: folds 
a_tasmanian: folds 
hirozo: folds 
ZhukOFFskI: raises $0.75 to $1
simonzez: folds 
Uncalled bet ($0.75) returned to ZhukOFFskI
ZhukOFFskI collected $0.60 from pot
ZhukOFFskI: doesn't show hand 
*** SUMMARY ***
Total pot $0.60 | Rake $0 
Seat 1: a_tasmanian (button) folded before Flop (didn't bet)
Seat 2: hirozo (small blind) folded before Flop
Seat 3: ZhukOFFskI (big blind) collected ($0.60)
Seat 4: simonzez folded before Flop
Seat 5: Jene4kaBest folded before Flop (didn't bet)
Seat 6: troublesomm folded before Flop (didn't bet)
Seat 7: Perstenev folded before Flop (didn't bet)
Seat 8: chiyuki folded before Flop (didn't bet)
Seat 9: KeLevro0 folded before Flop (didn't bet)



PokerStars Zoom Hand #84299893814:  Hold'em No Limit ($0.10/$0.25) - 2012/08/05 14:50:34 JST [2012/08/05 1:50:34 ET]
Table 'Whirlpool' 9-max Seat #1 is the button
Seat 1: ChrisCDee ($33.16 in chips) 
Seat 2: led52 ($11.90 in chips) 
Seat 3: snejokCoxx ($13.96 in chips) 
Seat 4: chiyuki ($29.07 in chips) 
Seat 5: Nerkit ($11 in chips) 
Seat 6: mjmichi ($25.44 in chips) 
Seat 7: troublesomm ($31.25 in chips) 
Seat 8: jacquelinewu ($46.58 in chips) 
Seat 9: phate-1up ($72.63 in chips) 
led52: posts small blind $0.10
snejokCoxx: posts big blind $0.25
*** HOLE CARDS ***
Dealt to chiyuki [Kc 2s]
chiyuki: folds 
Nerkit: folds 
mjmichi: folds 
troublesomm: folds 
jacquelinewu: folds 
phate-1up: folds 
ChrisCDee: raises $0.50 to $0.75
led52: raises $1.25 to $2
snejokCoxx: folds 
ChrisCDee: calls $1.25
*** FLOP *** [Js Kd Qs]
led52: bets $2.25
ChrisCDee: folds 
Uncalled bet ($2.25) returned to led52
led52 collected $4.06 from pot
led52: doesn't show hand 
*** SUMMARY ***
Total pot $4.25 | Rake $0.19 
Board [Js Kd Qs]
Seat 1: ChrisCDee (button) folded on the Flop
Seat 2: led52 (small blind) collected ($4.06)
Seat 3: snejokCoxx (big blind) folded before Flop
Seat 4: chiyuki folded before Flop (didn't bet)
Seat 5: Nerkit folded before Flop (didn't bet)
Seat 6: mjmichi folded before Flop (didn't bet)
Seat 7: troublesomm folded before Flop (didn't bet)
Seat 8: jacquelinewu folded before Flop (didn't bet)
Seat 9: phate-1up folded before Flop (didn't bet)



PokerStars Zoom Hand #84299896119:  Hold'em No Limit ($0.10/$0.25) - 2012/08/05 14:50:43 JST [2012/08/05 1:50:43 ET]
Table 'Whirlpool' 9-max Seat #1 is the button
Seat 1: Dan Royal ($44.19 in chips) 
Seat 2: ChrisCDee ($70.84 in chips) 
Seat 3: led52 ($12.15 in chips) 
Seat 4: ZhukOFFskI ($28.81 in chips) 
Seat 5: Wilcox76607 ($38.31 in chips) 
Seat 6: chiyuki ($29.07 in chips) 
Seat 7: jacquelinewu ($46.58 in chips) 
Seat 8: Perstenev ($14.02 in chips) 
Seat 9: Walturrr ($29.60 in chips) 
ChrisCDee: posts small blind $0.10
led52: posts big blind $0.25
*** HOLE CARDS ***
Dealt to chiyuki [2c 2h]
ZhukOFFskI: folds 
Wilcox76607: folds 
chiyuki: folds 
jacquelinewu: folds 
Perstenev: folds 
Walturrr: raises $0.47 to $0.72
Dan Royal: calls $0.72
ChrisCDee: folds 
led52: raises $1.78 to $2.50
Walturrr: folds 
Dan Royal: folds 
Uncalled bet ($1.78) returned to led52
led52 collected $2.26 from pot
led52: doesn't show hand 
*** SUMMARY ***
Total pot $2.26 | Rake $0 
Seat 1: Dan Royal (button) folded before Flop
Seat 2: ChrisCDee (small blind) folded before Flop
Seat 3: led52 (big blind) collected ($2.26)
Seat 4: ZhukOFFskI folded before Flop (didn't bet)
Seat 5: Wilcox76607 folded before Flop (didn't bet)
Seat 6: chiyuki folded before Flop (didn't bet)
Seat 7: jacquelinewu folded before Flop (didn't bet)
Seat 8: Perstenev folded before Flop (didn't bet)
Seat 9: Walturrr folded before Flop



PokerStars Zoom Hand #84299902039:  Hold'em No Limit ($0.10/$0.25) - 2012/08/05 14:51:08 JST [2012/08/05 1:51:08 ET]
Table 'Whirlpool' 9-max Seat #1 is the button
Seat 1: troublesomm ($25.35 in chips) 
Seat 2: chiyuki ($29.07 in chips) 
Seat 3: hirozo ($25.35 in chips) 
Seat 4: seula i ($27.01 in chips) 
Seat 5: yane73 ($39.84 in chips) 
Seat 6: BlOnDhOlIc ($34 in chips) 
Seat 7: Sal y Limon1 ($25.08 in chips) 
Seat 8: ll_LaMeR_ll ($80.30 in chips) 
Seat 9: GovGus ($25 in chips) 
chiyuki: posts small blind $0.10
hirozo: posts big blind $0.25
*** HOLE CARDS ***
Dealt to chiyuki [Qs Ad]
seula i: folds 
yane73: raises $0.50 to $0.75
BlOnDhOlIc: folds 
Sal y Limon1: folds 
ll_LaMeR_ll: folds 
GovGus: raises $1.50 to $2.25
troublesomm: folds 
chiyuki: folds 
hirozo: folds 
yane73: folds 
Uncalled bet ($1.50) returned to GovGus
GovGus collected $1.85 from pot
GovGus: doesn't show hand 
*** SUMMARY ***
Total pot $1.85 | Rake $0 
Seat 1: troublesomm (button) folded before Flop (didn't bet)
Seat 2: chiyuki (small blind) folded before Flop
Seat 3: hirozo (big blind) folded before Flop
Seat 4: seula i folded before Flop (didn't bet)
Seat 5: yane73 folded before Flop
Seat 6: BlOnDhOlIc folded before Flop (didn't bet)
Seat 7: Sal y Limon1 folded before Flop (didn't bet)
Seat 8: ll_LaMeR_ll folded before Flop (didn't bet)
Seat 9: GovGus collected ($1.85)



PokerStars Zoom Hand #84299897828:  Hold'em No Limit ($0.10/$0.25) - 2012/08/05 14:50:50 JST [2012/08/05 1:50:50 ET]
Table 'Whirlpool' 9-max Seat #1 is the button
Seat 1: GovGus ($29.49 in chips) 
Seat 2: 1Karina1 ($31.85 in chips) 
Seat 3: troublesomm ($31.25 in chips) 
Seat 4: Tom1999 ($18.13 in chips) 
Seat 5: Nagibator441 ($10.99 in chips) 
Seat 6: Perstenev ($14.02 in chips) 
Seat 7: chiyuki ($29.07 in chips) 
Seat 8: Cyanidoff ($25.78 in chips) 
Seat 9: hirozo ($42.59 in chips) 
1Karina1: posts small blind $0.10
troublesomm: posts big blind $0.25
*** HOLE CARDS ***
Dealt to chiyuki [Qs 5d]
Tom1999: folds 
Nagibator441: folds 
Perstenev: raises $0.50 to $0.75
chiyuki: folds 
Cyanidoff: folds 
hirozo: raises $1.60 to $2.35
GovGus: folds 
1Karina1: raises $5.15 to $7.50
troublesomm: folds 
Perstenev: folds 
hirozo: raises $16 to $23.50
1Karina1: raises $8.35 to $31.85 and is all-in
hirozo: calls $8.35
*** FLOP *** [Jc 8d 2c]
*** TURN *** [Jc 8d 2c] [9s]
*** RIVER *** [Jc 8d 2c 9s] [4c]
*** SHOW DOWN ***
1Karina1: shows [Kd Kc] (a pair of Kings)
hirozo: shows [Ac As] (a pair of Aces)
hirozo collected $62.70 from pot
*** SUMMARY ***
Total pot $64.70 | Rake $2 
Board [Jc 8d 2c 9s 4c]
Seat 1: GovGus (button) folded before Flop (didn't bet)
Seat 2: 1Karina1 (small blind) showed [Kd Kc] and lost with a pair of Kings
Seat 3: troublesomm (big blind) folded before Flop
Seat 4: Tom1999 folded before Flop (didn't bet)
Seat 5: Nagibator441 folded before Flop (didn't bet)
Seat 6: Perstenev folded before Flop
Seat 7: chiyuki folded before Flop (didn't bet)
Seat 8: Cyanidoff folded before Flop (didn't bet)
Seat 9: hirozo showed [Ac As] and won ($62.70) with a pair of Aces



PokerStars Zoom Hand #84299908775:  Hold'em No Limit ($0.10/$0.25) - 2012/08/05 14:51:35 JST [2012/08/05 1:51:35 ET]
Table 'Whirlpool' 9-max Seat #1 is the button
Seat 1: GovGus ($26.10 in chips) 
Seat 2: Dejacob ($25 in chips) 
Seat 3: chiyuki ($28.97 in chips) 
Seat 4: Lars111 ($30.69 in chips) 
Seat 5: Walturrr ($26.70 in chips) 
Seat 6: mjmichi ($25 in chips) 
Seat 7: hirozo ($73.44 in chips) 
Seat 8: 1Karina1 ($25 in chips) 
Seat 9: Nerkit ($9.99 in chips) 
Dejacob: posts small blind $0.10
chiyuki: posts big blind $0.25
*** HOLE CARDS ***
Dealt to chiyuki [Ah Qd]
Lars111: folds 
Walturrr: raises $0.47 to $0.72
mjmichi: folds 
hirozo: folds 
1Karina1: folds 
Nerkit: folds 
GovGus: folds 
Dejacob: folds 
chiyuki: calls $0.47
*** FLOP *** [9h 3c 5h]
chiyuki: checks 
Walturrr: bets $0.85
chiyuki: folds 
Uncalled bet ($0.85) returned to Walturrr
Walturrr collected $1.47 from pot
Walturrr: doesn't show hand 
*** SUMMARY ***
Total pot $1.54 | Rake $0.07 
Board [9h 3c 5h]
Seat 1: GovGus (button) folded before Flop (didn't bet)
Seat 2: Dejacob (small blind) folded before Flop
Seat 3: chiyuki (big blind) folded on the Flop
Seat 4: Lars111 folded before Flop (didn't bet)
Seat 5: Walturrr collected ($1.47)
Seat 6: mjmichi folded before Flop (didn't bet)
Seat 7: hirozo folded before Flop (didn't bet)
Seat 8: 1Karina1 folded before Flop (didn't bet)
Seat 9: Nerkit folded before Flop (didn't bet)



PokerStars Zoom Hand #84299919512:  Hold'em No Limit ($0.10/$0.25) - 2012/08/05 14:52:19 JST [2012/08/05 1:52:19 ET]
Table 'Whirlpool' 9-max Seat #1 is the button
Seat 1: snejokCoxx ($12 in chips) 
Seat 2: Ellen1947 ($43.30 in chips) 
Seat 3: laurentzu84 ($37.55 in chips) 
Seat 4: chiyuki ($28.25 in chips) 
Seat 5: KAKamiro ($24.90 in chips) 
Seat 6: hl77777 ($16.71 in chips) 
Seat 7: DonSimonUsa ($21.57 in chips) 
Seat 8: Nerkit ($9.14 in chips) 
Seat 9: KrystalAA ($27.78 in chips) 
Ellen1947: posts small blind $0.10
laurentzu84: posts big blind $0.25
*** HOLE CARDS ***
Dealt to chiyuki [3c Kd]
chiyuki: folds 
KAKamiro: calls $0.25
hl77777: folds 
DonSimonUsa: folds 
Nerkit: folds 
KrystalAA: folds 
snejokCoxx: folds 
Ellen1947: folds 
laurentzu84: checks 
*** FLOP *** [9d 9c 2d]
laurentzu84: checks 
KAKamiro: bets $0.75
laurentzu84: folds 
Uncalled bet ($0.75) returned to KAKamiro
KAKamiro collected $0.57 from pot
KAKamiro: doesn't show hand 
*** SUMMARY ***
Total pot $0.60 | Rake $0.03 
Board [9d 9c 2d]
Seat 1: snejokCoxx (button) folded before Flop (didn't bet)
Seat 2: Ellen1947 (small blind) folded before Flop
Seat 3: laurentzu84 (big blind) folded on the Flop
Seat 4: chiyuki folded before Flop (didn't bet)
Seat 5: KAKamiro collected ($0.57)
Seat 6: hl77777 folded before Flop (didn't bet)
Seat 7: DonSimonUsa folded before Flop (didn't bet)
Seat 8: Nerkit folded before Flop (didn't bet)
Seat 9: KrystalAA folded before Flop (didn't bet)



PokerStars Zoom Hand #84299922961:  Hold'em No Limit ($0.10/$0.25) - 2012/08/05 14:52:33 JST [2012/08/05 1:52:33 ET]
Table 'Whirlpool' 9-max Seat #1 is the button
Seat 1: yane73 ($34.84 in chips) 
Seat 2: KeLevro0 ($11.90 in chips) 
Seat 3: Nerkit ($9.65 in chips) 
Seat 4: 1Karina1 ($25 in chips) 
Seat 5: chiyuki ($28.25 in chips) 
Seat 6: Perstenev ($13.63 in chips) 
Seat 7: KrystalAA ($27.78 in chips) 
Seat 8: deadmoneykid ($24.47 in chips) 
Seat 9: GovGus ($27.83 in chips) 
KeLevro0: posts small blind $0.10
Nerkit: posts big blind $0.25
*** HOLE CARDS ***
Dealt to chiyuki [4h 5h]
1Karina1: folds 
chiyuki: folds 
Perstenev: folds 
KrystalAA: folds 
deadmoneykid: folds 
GovGus: folds 
yane73: folds 
KeLevro0: folds 
Uncalled bet ($0.15) returned to Nerkit
Nerkit collected $0.20 from pot
Nerkit: doesn't show hand 
*** SUMMARY ***
Total pot $0.20 | Rake $0 
Seat 1: yane73 (button) folded before Flop (didn't bet)
Seat 2: KeLevro0 (small blind) folded before Flop
Seat 3: Nerkit (big blind) collected ($0.20)
Seat 4: 1Karina1 folded before Flop (didn't bet)
Seat 5: chiyuki folded before Flop (didn't bet)
Seat 6: Perstenev folded before Flop (didn't bet)
Seat 7: KrystalAA folded before Flop (didn't bet)
Seat 8: deadmoneykid folded before Flop (didn't bet)
Seat 9: GovGus folded before Flop (didn't bet)



PokerStars Zoom Hand #84299920973:  Hold'em No Limit ($0.10/$0.25) - 2012/08/05 14:52:25 JST [2012/08/05 1:52:25 ET]
Table 'Whirlpool' 9-max Seat #1 is the button
Seat 1: ChrisCDee ($70.39 in chips) 
Seat 2: Perstenev ($16.33 in chips) 
Seat 3: KimPa39 ($21.35 in chips) 
Seat 4: BlOnDhOlIc ($86.21 in chips) 
Seat 5: azizmimi ($12.71 in chips) 
Seat 6: mjmichi ($25.44 in chips) 
Seat 7: jacquelinewu ($25.35 in chips) 
Seat 8: Nerkit ($9.89 in chips) 
Seat 9: chiyuki ($28.25 in chips) 
Perstenev: posts small blind $0.10
KimPa39: posts big blind $0.25
*** HOLE CARDS ***
Dealt to chiyuki [Jc 5c]
BlOnDhOlIc: folds 
azizmimi: folds 
mjmichi: raises $0.50 to $0.75
jacquelinewu: folds 
Nerkit: folds 
chiyuki: folds 
ChrisCDee: folds 
Perstenev: folds 
KimPa39: folds 
Uncalled bet ($0.50) returned to mjmichi
mjmichi collected $0.60 from pot
mjmichi: doesn't show hand 
*** SUMMARY ***
Total pot $0.60 | Rake $0 
Seat 1: ChrisCDee (button) folded before Flop (didn't bet)
Seat 2: Perstenev (small blind) folded before Flop
Seat 3: KimPa39 (big blind) folded before Flop
Seat 4: BlOnDhOlIc folded before Flop (didn't bet)
Seat 5: azizmimi folded before Flop (didn't bet)
Seat 6: mjmichi collected ($0.60)
Seat 7: jacquelinewu folded before Flop (didn't bet)
Seat 8: Nerkit folded before Flop (didn't bet)
Seat 9: chiyuki folded before Flop (didn't bet)



PokerStars Zoom Hand #84299924731:  Hold'em No Limit ($0.10/$0.25) - 2012/08/05 14:52:40 JST [2012/08/05 1:52:40 ET]
Table 'Whirlpool' 9-max Seat #1 is the button
Seat 1: troublesomm ($25 in chips) 
Seat 2: led52 ($10.80 in chips) 
Seat 3: GovGus ($27.24 in chips) 
Seat 4: chiyuki ($28.25 in chips) 
Seat 5: mid22 ($9.63 in chips) 
Seat 6: deadmoneykid ($28.27 in chips) 
Seat 7: phate-1up ($72.03 in chips) 
Seat 8: Jene4kaBest ($17.89 in chips) 
Seat 9: laurentzu84 ($37.30 in chips) 
led52: posts small blind $0.10
GovGus: posts big blind $0.25
*** HOLE CARDS ***
Dealt to chiyuki [Td 4c]
chiyuki: folds 
mid22: folds 
deadmoneykid: folds 
phate-1up: folds 
Jene4kaBest: folds 
laurentzu84: folds 
troublesomm: folds 
led52: folds 
Uncalled bet ($0.15) returned to GovGus
GovGus collected $0.20 from pot
GovGus: doesn't show hand 
*** SUMMARY ***
Total pot $0.20 | Rake $0 
Seat 1: troublesomm (button) folded before Flop (didn't bet)
Seat 2: led52 (small blind) folded before Flop
Seat 3: GovGus (big blind) collected ($0.20)
Seat 4: chiyuki folded before Flop (didn't bet)
Seat 5: mid22 folded before Flop (didn't bet)
Seat 6: deadmoneykid folded before Flop (didn't bet)
Seat 7: phate-1up folded before Flop (didn't bet)
Seat 8: Jene4kaBest folded before Flop (didn't bet)
Seat 9: laurentzu84 folded before Flop (didn't bet)



PokerStars Zoom Hand #84299925738:  Hold'em No Limit ($0.10/$0.25) - 2012/08/05 14:52:44 JST [2012/08/05 1:52:44 ET]
Table 'Whirlpool' 9-max Seat #1 is the button
Seat 1: chiyuki ($28.25 in chips) 
Seat 2: seula i ($113.86 in chips) 
Seat 3: deadmoneykid ($28.27 in chips) 
Seat 4: BlOnDhOlIc ($33.55 in chips) 
Seat 5: gunbowler ($146.14 in chips) 
Seat 6: phate-1up ($72.03 in chips) 
Seat 7: led52 ($13.61 in chips) 
Seat 8: Alvinpe85 ($50.99 in chips) 
Seat 9: slapshot2011 ($54.33 in chips) 
seula i: posts small blind $0.10
deadmoneykid: posts big blind $0.25
*** HOLE CARDS ***
Dealt to chiyuki [Jc 2d]
BlOnDhOlIc: folds 
gunbowler: folds 
phate-1up: folds 
led52: folds 
Alvinpe85: folds 
slapshot2011: folds 
chiyuki: folds 
seula i: raises $0.50 to $0.75
deadmoneykid: folds 
Uncalled bet ($0.50) returned to seula i
seula i collected $0.50 from pot
seula i: doesn't show hand 
*** SUMMARY ***
Total pot $0.50 | Rake $0 
Seat 1: chiyuki (button) folded before Flop (didn't bet)
Seat 2: seula i (small blind) collected ($0.50)
Seat 3: deadmoneykid (big blind) folded before Flop
Seat 4: BlOnDhOlIc folded before Flop (didn't bet)
Seat 5: gunbowler folded before Flop (didn't bet)
Seat 6: phate-1up folded before Flop (didn't bet)
Seat 7: led52 folded before Flop (didn't bet)
Seat 8: Alvinpe85 folded before Flop (didn't bet)
Seat 9: slapshot2011 folded before Flop (didn't bet)



PokerStars Zoom Hand #84299926529:  Hold'em No Limit ($0.10/$0.25) - 2012/08/05 14:52:47 JST [2012/08/05 1:52:47 ET]
Table 'Whirlpool' 9-max Seat #1 is the button
Seat 1: Walturrr ($26.96 in chips) 
Seat 2: tribunpdm ($28.37 in chips) 
Seat 3: chiyuki ($28.25 in chips) 
Seat 4: Perstenev ($15.98 in chips) 
Seat 5: troublesomm ($31 in chips) 
Seat 6: Ellen1947 ($29.01 in chips) 
Seat 7: cofla tito ($8.28 in chips) 
Seat 8: Vahe50 ($14.39 in chips) 
Seat 9: ChrisCDee ($70.39 in chips) 
tribunpdm: posts small blind $0.10
chiyuki: posts big blind $0.25
*** HOLE CARDS ***
Dealt to chiyuki [Th Jd]
Perstenev: folds 
troublesomm: folds 
Ellen1947: folds 
cofla tito: folds 
Vahe50: raises $0.50 to $0.75
ChrisCDee: folds 
Walturrr: folds 
tribunpdm: folds 
chiyuki: folds 
Uncalled bet ($0.50) returned to Vahe50
Vahe50 collected $0.60 from pot
Vahe50: doesn't show hand 
*** SUMMARY ***
Total pot $0.60 | Rake $0 
Seat 1: Walturrr (button) folded before Flop (didn't bet)
Seat 2: tribunpdm (small blind) folded before Flop
Seat 3: chiyuki (big blind) folded before Flop
Seat 4: Perstenev folded before Flop (didn't bet)
Seat 5: troublesomm folded before Flop (didn't bet)
Seat 6: Ellen1947 folded before Flop (didn't bet)
Seat 7: cofla tito folded before Flop (didn't bet)
Seat 8: Vahe50 collected ($0.60)
Seat 9: ChrisCDee folded before Flop (didn't bet)



PokerStars Zoom Hand #84299933309:  Hold'em No Limit ($0.10/$0.25) - 2012/08/05 14:53:15 JST [2012/08/05 1:53:15 ET]
Table 'Whirlpool' 9-max Seat #1 is the button
Seat 1: BlOnDhOlIc ($33.30 in chips) 
Seat 2: chiyuki ($28 in chips) 
Seat 3: mid22 ($7.63 in chips) 
Seat 4: hirozo ($25 in chips) 
Seat 5: dushvan ($37.72 in chips) 
Seat 6: Dejacob ($25 in chips) 
Seat 7: Sal y Limon1 ($24.85 in chips) 
Seat 8: kamikkaze ($15.35 in chips) 
Seat 9: led52 ($10.70 in chips) 
chiyuki: posts small blind $0.10
mid22: posts big blind $0.25
*** HOLE CARDS ***
Dealt to chiyuki [Jh Th]
hirozo: folds 
dushvan: folds 
Dejacob: folds 
Sal y Limon1: folds 
kamikkaze: folds 
led52: raises $0.50 to $0.75
BlOnDhOlIc: folds 
chiyuki: folds 
mid22: calls $0.50
*** FLOP *** [9s Js Qc]
mid22: bets $0.75
led52: calls $0.75
*** TURN *** [9s Js Qc] [5d]
mid22: bets $0.75
led52: folds 
Uncalled bet ($0.75) returned to mid22
mid22 collected $2.96 from pot
mid22: doesn't show hand 
*** SUMMARY ***
Total pot $3.10 | Rake $0.14 
Board [9s Js Qc 5d]
Seat 1: BlOnDhOlIc (button) folded before Flop (didn't bet)
Seat 2: chiyuki (small blind) folded before Flop
Seat 3: mid22 (big blind) collected ($2.96)
Seat 4: hirozo folded before Flop (didn't bet)
Seat 5: dushvan folded before Flop (didn't bet)
Seat 6: Dejacob folded before Flop (didn't bet)
Seat 7: Sal y Limon1 folded before Flop (didn't bet)
Seat 8: kamikkaze folded before Flop (didn't bet)
Seat 9: led52 folded on the Turn



PokerStars Zoom Hand #84299923930:  Hold'em No Limit ($0.10/$0.25) - 2012/08/05 14:52:37 JST [2012/08/05 1:52:37 ET]
Table 'Whirlpool' 9-max Seat #1 is the button
Seat 1: PillZ86 ($15.80 in chips) 
Seat 2: slapshot2011 ($54.43 in chips) 
Seat 3: 1Karina1 ($25 in chips) 
Seat 4: BlOnDhOlIc ($35.14 in chips) 
Seat 5: Nerkit ($9.89 in chips) 
Seat 6: wildy29 ($26.05 in chips) 
Seat 7: seula i ($29.38 in chips) 
Seat 8: chiyuki ($28.25 in chips) 
Seat 9: Wilcox76607 ($37.06 in chips) 
slapshot2011: posts small blind $0.10
1Karina1: posts big blind $0.25
*** HOLE CARDS ***
Dealt to chiyuki [6d As]
BlOnDhOlIc: folds 
Nerkit: raises $0.50 to $0.75
wildy29: calls $0.75
seula i: folds 
chiyuki: folds 
Wilcox76607: folds 
PillZ86: folds 
slapshot2011: folds 
1Karina1: folds 
*** FLOP *** [Tc 6c Qd]
Nerkit: bets $0.92
wildy29: raises $0.92 to $1.84
Nerkit: calls $0.92
*** TURN *** [Tc 6c Qd] [Qh]
Nerkit: checks 
wildy29: bets $1.50
Nerkit: calls $1.50
*** RIVER *** [Tc 6c Qd Qh] [Qs]
Nerkit: checks 
wildy29: bets $3.25
Nerkit: folds 
Uncalled bet ($3.25) returned to wildy29
wildy29 collected $8.15 from pot
wildy29: doesn't show hand 
*** SUMMARY ***
Total pot $8.53 | Rake $0.38 
Board [Tc 6c Qd Qh Qs]
Seat 1: PillZ86 (button) folded before Flop (didn't bet)
Seat 2: slapshot2011 (small blind) folded before Flop
Seat 3: 1Karina1 (big blind) folded before Flop
Seat 4: BlOnDhOlIc folded before Flop (didn't bet)
Seat 5: Nerkit folded on the River
Seat 6: wildy29 collected ($8.15)
Seat 7: seula i folded before Flop (didn't bet)
Seat 8: chiyuki folded before Flop (didn't bet)
Seat 9: Wilcox76607 folded before Flop (didn't bet)



PokerStars Zoom Hand #84299937765:  Hold'em No Limit ($0.10/$0.25) - 2012/08/05 14:53:33 JST [2012/08/05 1:53:33 ET]
Table 'Whirlpool' 9-max Seat #1 is the button
Seat 1: jacquelinewu ($39.48 in chips) 
Seat 2: deadmoneykid ($29.05 in chips) 
Seat 3: Alvinpe85 ($59.39 in chips) 
Seat 4: Nerkit ($18.75 in chips) 
Seat 5: Ellen1947 ($43.55 in chips) 
Seat 6: Phaedrus...3 ($25 in chips) 
Seat 7: chiyuki ($27.90 in chips) 
Seat 8: 4plankton ($29.04 in chips) 
Seat 9: Dan Royal ($44.41 in chips) 
deadmoneykid: posts small blind $0.10
Alvinpe85: posts big blind $0.25
*** HOLE CARDS ***
Dealt to chiyuki [4c Qc]
Nerkit: folds 
Ellen1947: raises $0.50 to $0.75
Phaedrus...3: folds 
chiyuki: folds 
4plankton: folds 
Dan Royal: folds 
jacquelinewu: folds 
deadmoneykid: folds 
Alvinpe85: folds 
Uncalled bet ($0.50) returned to Ellen1947
Ellen1947 collected $0.60 from pot
Ellen1947: doesn't show hand 
*** SUMMARY ***
Total pot $0.60 | Rake $0 
Seat 1: jacquelinewu (button) folded before Flop (didn't bet)
Seat 2: deadmoneykid (small blind) folded before Flop
Seat 3: Alvinpe85 (big blind) folded before Flop
Seat 4: Nerkit folded before Flop (didn't bet)
Seat 5: Ellen1947 collected ($0.60)
Seat 6: Phaedrus...3 folded before Flop (didn't bet)
Seat 7: chiyuki folded before Flop (didn't bet)
Seat 8: 4plankton folded before Flop (didn't bet)
Seat 9: Dan Royal folded before Flop (didn't bet)



PokerStars Zoom Hand #84299931805:  Hold'em No Limit ($0.10/$0.25) - 2012/08/05 14:53:08 JST [2012/08/05 1:53:08 ET]
Table 'Whirlpool' 9-max Seat #1 is the button
Seat 1: deadmoneykid ($21.70 in chips) 
Seat 2: yane73 ($36.99 in chips) 
Seat 3: hobby56 ($15.56 in chips) 
Seat 4: Perstenev ($13.17 in chips) 
Seat 5: troublesomm ($25 in chips) 
Seat 6: chiyuki ($28 in chips) 
Seat 7: Dafleche ($20.11 in chips) 
Seat 8: Walturrr ($26.95 in chips) 
Seat 9: seula i ($114.11 in chips) 
yane73: posts small blind $0.10
hobby56: posts big blind $0.25
*** HOLE CARDS ***
Dealt to chiyuki [Qd 9s]
Perstenev: folds 
troublesomm: folds 
chiyuki: folds 
Dafleche: folds 
Walturrr: folds 
seula i: folds 
deadmoneykid: raises $0.25 to $0.50
yane73: calls $0.40
hobby56: calls $0.25
*** FLOP *** [7s 6d 7h]
yane73: checks 
hobby56: checks 
deadmoneykid: checks 
*** TURN *** [7s 6d 7h] [2c]
yane73: bets $1.25
hobby56: folds 
deadmoneykid: folds 
Uncalled bet ($1.25) returned to yane73
yane73 collected $1.43 from pot
yane73: doesn't show hand 
*** SUMMARY ***
Total pot $1.50 | Rake $0.07 
Board [7s 6d 7h 2c]
Seat 1: deadmoneykid (button) folded on the Turn
Seat 2: yane73 (small blind) collected ($1.43)
Seat 3: hobby56 (big blind) folded on the Turn
Seat 4: Perstenev folded before Flop (didn't bet)
Seat 5: troublesomm folded before Flop (didn't bet)
Seat 6: chiyuki folded before Flop (didn't bet)
Seat 7: Dafleche folded before Flop (didn't bet)
Seat 8: Walturrr folded before Flop (didn't bet)
Seat 9: seula i folded before Flop (didn't bet)



PokerStars Zoom Hand #84299940935:  Hold'em No Limit ($0.10/$0.25) - 2012/08/05 14:53:46 JST [2012/08/05 1:53:46 ET]
Table 'Whirlpool' 9-max Seat #1 is the button
Seat 1: ZhukOFFskI ($28.78 in chips) 
Seat 2: Landybob ($38.89 in chips) 
Seat 3: kamikkaze ($15.35 in chips) 
Seat 4: seula i ($40.31 in chips) 
Seat 5: hl77777 ($16.26 in chips) 
Seat 6: PillZ86 ($16.15 in chips) 
Seat 7: KeLevro0 ($10.15 in chips) 
Seat 8: Sal y Limon1 ($24.99 in chips) 
Seat 9: chiyuki ($27.90 in chips) 
Landybob: posts small blind $0.10
kamikkaze: posts big blind $0.25
*** HOLE CARDS ***
Dealt to chiyuki [Kd 4h]
seula i: folds 
hl77777: folds 
PillZ86: folds 
KeLevro0: folds 
Sal y Limon1: raises $0.50 to $0.75
chiyuki: folds 
ZhukOFFskI: folds 
Landybob: folds 
kamikkaze: folds 
Uncalled bet ($0.50) returned to Sal y Limon1
Sal y Limon1 collected $0.60 from pot
Sal y Limon1: doesn't show hand 
*** SUMMARY ***
Total pot $0.60 | Rake $0 
Seat 1: ZhukOFFskI (button) folded before Flop (didn't bet)
Seat 2: Landybob (small blind) folded before Flop
Seat 3: kamikkaze (big blind) folded before Flop
Seat 4: seula i folded before Flop (didn't bet)
Seat 5: hl77777 folded before Flop (didn't bet)
Seat 6: PillZ86 folded before Flop (didn't bet)
Seat 7: KeLevro0 folded before Flop (didn't bet)
Seat 8: Sal y Limon1 collected ($0.60)
Seat 9: chiyuki folded before Flop (didn't bet)



PokerStars Zoom Hand #84299942396:  Hold'em No Limit ($0.10/$0.25) - 2012/08/05 14:53:52 JST [2012/08/05 1:53:52 ET]
Table 'Whirlpool' 9-max Seat #1 is the button
Seat 1: Perstenev ($13.73 in chips) 
Seat 2: Nerkit ($18.75 in chips) 
Seat 3: Walturrr ($33.39 in chips) 
Seat 4: Lars111 ($33.61 in chips) 
Seat 5: hl77777 ($11.80 in chips) 
Seat 6: KeLevro0 ($11.68 in chips) 
Seat 7: seula i ($40.31 in chips) 
Seat 8: chiyuki ($27.90 in chips) 
Seat 9: deadmoneykid ($28.95 in chips) 
Nerkit: posts small blind $0.10
Walturrr: posts big blind $0.25
*** HOLE CARDS ***
Dealt to chiyuki [5c Kc]
Lars111: folds 
hl77777: folds 
KeLevro0: folds 
seula i: folds 
chiyuki: folds 
deadmoneykid: folds 
Perstenev: folds 
Nerkit: folds 
Uncalled bet ($0.15) returned to Walturrr
Walturrr collected $0.20 from pot
Walturrr: doesn't show hand 
*** SUMMARY ***
Total pot $0.20 | Rake $0 
Seat 1: Perstenev (button) folded before Flop (didn't bet)
Seat 2: Nerkit (small blind) folded before Flop
Seat 3: Walturrr (big blind) collected ($0.20)
Seat 4: Lars111 folded before Flop (didn't bet)
Seat 5: hl77777 folded before Flop (didn't bet)
Seat 6: KeLevro0 folded before Flop (didn't bet)
Seat 7: seula i folded before Flop (didn't bet)
Seat 8: chiyuki folded before Flop (didn't bet)
Seat 9: deadmoneykid folded before Flop (didn't bet)



PokerStars Zoom Hand #84299943910:  Hold'em No Limit ($0.10/$0.25) - 2012/08/05 14:53:58 JST [2012/08/05 1:53:58 ET]
Table 'Whirlpool' 9-max Seat #1 is the button
Seat 1: chiyuki ($27.90 in chips) 
Seat 2: BlOnDhOlIc ($33.30 in chips) 
Seat 3: tribunpdm ($27.02 in chips) 
Seat 4: deadmoneykid ($24.12 in chips) 
Seat 5: KrystalAA ($14.86 in chips) 
Seat 6: Tom1999 ($19.11 in chips) 
Seat 7: slapshot2011 ($52.83 in chips) 
Seat 8: bigred1102 ($40.01 in chips) 
Seat 9: hl77777 ($11.80 in chips) 
BlOnDhOlIc: posts small blind $0.10
tribunpdm: posts big blind $0.25
*** HOLE CARDS ***
Dealt to chiyuki [4c 5d]
deadmoneykid: folds 
KrystalAA: folds 
Tom1999: folds 
slapshot2011: folds 
bigred1102: raises $0.25 to $0.50
hl77777: folds 
chiyuki: folds 
BlOnDhOlIc: folds 
tribunpdm: folds 
Uncalled bet ($0.25) returned to bigred1102
bigred1102 collected $0.60 from pot
bigred1102: doesn't show hand 
*** SUMMARY ***
Total pot $0.60 | Rake $0 
Seat 1: chiyuki (button) folded before Flop (didn't bet)
Seat 2: BlOnDhOlIc (small blind) folded before Flop
Seat 3: tribunpdm (big blind) folded before Flop
Seat 4: deadmoneykid folded before Flop (didn't bet)
Seat 5: KrystalAA folded before Flop (didn't bet)
Seat 6: Tom1999 folded before Flop (didn't bet)
Seat 7: slapshot2011 folded before Flop (didn't bet)
Seat 8: bigred1102 collected ($0.60)
Seat 9: hl77777 folded before Flop (didn't bet)



PokerStars Zoom Hand #84299944872:  Hold'em No Limit ($0.10/$0.25) - 2012/08/05 14:54:02 JST [2012/08/05 1:54:02 ET]
Table 'Whirlpool' 9-max Seat #1 is the button
Seat 1: DutchShultzs ($25 in chips) 
Seat 2: Tom1999 ($19.11 in chips) 
Seat 3: Lars111 ($33.61 in chips) 
Seat 4: GovGus ($27.24 in chips) 
Seat 5: snejokCoxx ($11.55 in chips) 
Seat 6: Sal y Limon1 ($24.75 in chips) 
Seat 7: chiyuki ($27.90 in chips) 
Seat 8: PAMBOS.L ($15.32 in chips) 
Seat 9: pativyko ($15.79 in chips) 
Tom1999: posts small blind $0.10
Lars111: posts big blind $0.25
*** HOLE CARDS ***
Dealt to chiyuki [8s 5d]
GovGus: folds 
snejokCoxx: folds 
Sal y Limon1: folds 
chiyuki: folds 
PAMBOS.L: folds 
pativyko: raises $0.50 to $0.75
DutchShultzs: folds 
Tom1999: calls $0.65
Lars111: folds 
*** FLOP *** [9h 2s Qs]
Tom1999: checks 
pativyko: bets $1.25
Tom1999: raises $1.25 to $2.50
pativyko: calls $1.25
*** TURN *** [9h 2s Qs] [6h]
Tom1999: bets $3.22
pativyko: folds 
Uncalled bet ($3.22) returned to Tom1999
Tom1999 collected $6.45 from pot
Tom1999: doesn't show hand 
*** SUMMARY ***
Total pot $6.75 | Rake $0.30 
Board [9h 2s Qs 6h]
Seat 1: DutchShultzs (button) folded before Flop (didn't bet)
Seat 2: Tom1999 (small blind) collected ($6.45)
Seat 3: Lars111 (big blind) folded before Flop
Seat 4: GovGus folded before Flop (didn't bet)
Seat 5: snejokCoxx folded before Flop (didn't bet)
Seat 6: Sal y Limon1 folded before Flop (didn't bet)
Seat 7: chiyuki folded before Flop (didn't bet)
Seat 8: PAMBOS.L folded before Flop (didn't bet)
Seat 9: pativyko folded on the Turn



PokerStars Zoom Hand #84299945855:  Hold'em No Limit ($0.10/$0.25) - 2012/08/05 14:54:06 JST [2012/08/05 1:54:06 ET]
Table 'Whirlpool' 9-max Seat #1 is the button
Seat 1: Nerkit ($15.35 in chips) 
Seat 2: chiyuki ($27.90 in chips) 
Seat 3: slapshot2011 ($52.83 in chips) 
Seat 4: simonzez ($19.67 in chips) 
Seat 5: Walturrr ($26.85 in chips) 
Seat 6: troublesomm ($25 in chips) 
Seat 7: Sal y Limon1 ($25.34 in chips) 
Seat 8: KrystalAA ($14.86 in chips) 
Seat 9: KimPa39 ($18.11 in chips) 
chiyuki: posts small blind $0.10
slapshot2011: posts big blind $0.25
*** HOLE CARDS ***
Dealt to chiyuki [Js 2s]
simonzez: folds 
Walturrr: folds 
troublesomm: raises $0.50 to $0.75
Sal y Limon1: folds 
KrystalAA: folds 
KimPa39: folds 
Nerkit: folds 
chiyuki: folds 
slapshot2011: calls $0.50
*** FLOP *** [Tc 7c Jd]
slapshot2011: checks 
troublesomm: checks 
*** TURN *** [Tc 7c Jd] [7h]
slapshot2011: bets $0.75
troublesomm: calls $0.75
*** RIVER *** [Tc 7c Jd 7h] [Ks]
slapshot2011: bets $0.75
troublesomm: calls $0.75
*** SHOW DOWN ***
slapshot2011: shows [Kh 3h] (two pair, Kings and Sevens)
troublesomm: shows [Kd Ac] (two pair, Kings and Sevens - Ace kicker)
troublesomm collected $4.39 from pot
*** SUMMARY ***
Total pot $4.60 | Rake $0.21 
Board [Tc 7c Jd 7h Ks]
Seat 1: Nerkit (button) folded before Flop (didn't bet)
Seat 2: chiyuki (small blind) folded before Flop
Seat 3: slapshot2011 (big blind) showed [Kh 3h] and lost with two pair, Kings and Sevens
Seat 4: simonzez folded before Flop (didn't bet)
Seat 5: Walturrr folded before Flop (didn't bet)
Seat 6: troublesomm showed [Kd Ac] and won ($4.39) with two pair, Kings and Sevens
Seat 7: Sal y Limon1 folded before Flop (didn't bet)
Seat 8: KrystalAA folded before Flop (didn't bet)
Seat 9: KimPa39 folded before Flop (didn't bet)



PokerStars Zoom Hand #84299940166:  Hold'em No Limit ($0.10/$0.25) - 2012/08/05 14:53:43 JST [2012/08/05 1:53:43 ET]
Table 'Whirlpool' 9-max Seat #1 is the button
Seat 1: deepakmbh ($47.70 in chips) 
Seat 2: cofla tito ($8.38 in chips) 
Seat 3: Vahe50 ($14.74 in chips) 
Seat 4: jacquelinewu ($26.95 in chips) 
Seat 5: chiyuki ($27.90 in chips) 
Seat 6: snejokCoxx ($11.55 in chips) 
Seat 7: phate-1up ($31.72 in chips) 
Seat 8: BlOnDhOlIc ($88.77 in chips) 
Seat 9: mjmichi ($25.44 in chips) 
cofla tito: posts small blind $0.10
Vahe50: posts big blind $0.25
*** HOLE CARDS ***
Dealt to chiyuki [Th 5d]
jacquelinewu: folds 
chiyuki: folds 
snejokCoxx: folds 
phate-1up: raises $0.50 to $0.75
BlOnDhOlIc: folds 
mjmichi: folds 
deepakmbh: folds 
cofla tito: calls $0.65
Vahe50: folds 
*** FLOP *** [5s Qs 9d]
cofla tito: checks 
phate-1up: checks 
*** TURN *** [5s Qs 9d] [As]
cofla tito: bets $0.50
phate-1up: folds 
Uncalled bet ($0.50) returned to cofla tito
cofla tito collected $1.67 from pot
cofla tito: doesn't show hand 
*** SUMMARY ***
Total pot $1.75 | Rake $0.08 
Board [5s Qs 9d As]
Seat 1: deepakmbh (button) folded before Flop (didn't bet)
Seat 2: cofla tito (small blind) collected ($1.67)
Seat 3: Vahe50 (big blind) folded before Flop
Seat 4: jacquelinewu folded before Flop (didn't bet)
Seat 5: chiyuki folded before Flop (didn't bet)
Seat 6: snejokCoxx folded before Flop (didn't bet)
Seat 7: phate-1up folded on the Turn
Seat 8: BlOnDhOlIc folded before Flop (didn't bet)
Seat 9: mjmichi folded before Flop (didn't bet)



PokerStars Zoom Hand #84299947855:  Hold'em No Limit ($0.10/$0.25) - 2012/08/05 14:54:14 JST [2012/08/05 1:54:14 ET]
Table 'Whirlpool' 9-max Seat #1 is the button
Seat 1: hirozo ($26 in chips) 
Seat 2: DutchShultzs ($25 in chips) 
Seat 3: Ellen1947 ($43.80 in chips) 
Seat 4: canammark ($40.39 in chips) 
Seat 5: chiyuki ($27.80 in chips) 
Seat 6: ZhukOFFskI ($27.81 in chips) 
Seat 7: Tom1999 ($29.47 in chips) 
Seat 8: Ladyteazer ($10.91 in chips) 
Seat 9: jacquelinewu ($26.85 in chips) 
DutchShultzs: posts small blind $0.10
Ellen1947: posts big blind $0.25
*** HOLE CARDS ***
Dealt to chiyuki [2c Kc]
canammark: folds 
chiyuki: folds 
ZhukOFFskI: folds 
Tom1999: folds 
Ladyteazer: raises $0.25 to $0.50
jacquelinewu: calls $0.50
hirozo: folds 
DutchShultzs: folds 
Ellen1947: folds 
*** FLOP *** [5c 4c Js]
Ladyteazer: bets $0.75
jacquelinewu: calls $0.75
*** TURN *** [5c 4c Js] [Ad]
Ladyteazer: checks 
jacquelinewu: bets $1.75
Ladyteazer: folds 
Uncalled bet ($1.75) returned to jacquelinewu
jacquelinewu collected $2.72 from pot
jacquelinewu: doesn't show hand 
*** SUMMARY ***
Total pot $2.85 | Rake $0.13 
Board [5c 4c Js Ad]
Seat 1: hirozo (button) folded before Flop (didn't bet)
Seat 2: DutchShultzs (small blind) folded before Flop
Seat 3: Ellen1947 (big blind) folded before Flop
Seat 4: canammark folded before Flop (didn't bet)
Seat 5: chiyuki folded before Flop (didn't bet)
Seat 6: ZhukOFFskI folded before Flop (didn't bet)
Seat 7: Tom1999 folded before Flop (didn't bet)
Seat 8: Ladyteazer folded on the Turn
Seat 9: jacquelinewu collected ($2.72)



PokerStars Zoom Hand #84299955489:  Hold'em No Limit ($0.10/$0.25) - 2012/08/05 14:54:46 JST [2012/08/05 1:54:46 ET]
Table 'Whirlpool' 9-max Seat #1 is the button
Seat 1: Tom1999 ($29.22 in chips) 
Seat 2: laurentzu84 ($27.10 in chips) 
Seat 3: Ellen1947 ($31.08 in chips) 
Seat 4: hirozo ($70.11 in chips) 
Seat 5: Wilcox76607 ($37.98 in chips) 
Seat 6: chiyuki ($27.55 in chips) 
Seat 7: DutchShultzs ($26.10 in chips) 
Seat 8: troublesomm ($25.25 in chips) 
Seat 9: Alvinpe85 ($59.39 in chips) 
laurentzu84: posts small blind $0.10
Ellen1947: posts big blind $0.25
*** HOLE CARDS ***
Dealt to chiyuki [5h 3c]
hirozo: folds 
Wilcox76607: folds 
chiyuki: folds 
DutchShultzs: folds 
troublesomm: folds 
Alvinpe85: raises $0.37 to $0.62
Tom1999: calls $0.62
laurentzu84: folds 
Ellen1947: raises $30.46 to $31.08 and is all-in
Alvinpe85: folds 
Tom1999: folds 
Uncalled bet ($30.46) returned to Ellen1947
Ellen1947 collected $1.96 from pot
Ellen1947: doesn't show hand 
*** SUMMARY ***
Total pot $1.96 | Rake $0 
Seat 1: Tom1999 (button) folded before Flop
Seat 2: laurentzu84 (small blind) folded before Flop
Seat 3: Ellen1947 (big blind) collected ($1.96)
Seat 4: hirozo folded before Flop (didn't bet)
Seat 5: Wilcox76607 folded before Flop (didn't bet)
Seat 6: chiyuki folded before Flop (didn't bet)
Seat 7: DutchShultzs folded before Flop (didn't bet)
Seat 8: troublesomm folded before Flop (didn't bet)
Seat 9: Alvinpe85 folded before Flop



PokerStars Zoom Hand #84299957430:  Hold'em No Limit ($0.10/$0.25) - 2012/08/05 14:54:54 JST [2012/08/05 1:54:54 ET]
Table 'Whirlpool' 9-max Seat #1 is the button
Seat 1: Nerkit ($12.25 in chips) 
Seat 2: azizmimi ($18.97 in chips) 
Seat 3: 1Karina1 ($29.09 in chips) 
Seat 4: Walturrr ($33.49 in chips) 
Seat 5: led52 ($13.61 in chips) 
Seat 6: chiyuki ($27.55 in chips) 
Seat 7: DutchShultzs ($25.75 in chips) 
Seat 8: Gichboy ($10.64 in chips) 
Seat 9: phate-1up ($45.04 in chips) 
azizmimi: posts small blind $0.10
1Karina1: posts big blind $0.25
*** HOLE CARDS ***
Dealt to chiyuki [5d 7s]
Walturrr: folds 
led52: folds 
chiyuki: folds 
DutchShultzs: folds 
Gichboy: folds 
phate-1up: folds 
Nerkit: raises $0.50 to $0.75
azizmimi: folds 
1Karina1: folds 
Uncalled bet ($0.50) returned to Nerkit
Nerkit collected $0.60 from pot
Nerkit: doesn't show hand 
*** SUMMARY ***
Total pot $0.60 | Rake $0 
Seat 1: Nerkit (button) collected ($0.60)
Seat 2: azizmimi (small blind) folded before Flop
Seat 3: 1Karina1 (big blind) folded before Flop
Seat 4: Walturrr folded before Flop (didn't bet)
Seat 5: led52 folded before Flop (didn't bet)
Seat 6: chiyuki folded before Flop (didn't bet)
Seat 7: DutchShultzs folded before Flop (didn't bet)
Seat 8: Gichboy folded before Flop (didn't bet)
Seat 9: phate-1up folded before Flop (didn't bet)



PokerStars Zoom Hand #84299949108:  Hold'em No Limit ($0.10/$0.25) - 2012/08/05 14:54:19 JST [2012/08/05 1:54:19 ET]
Table 'Whirlpool' 9-max Seat #1 is the button
Seat 1: DutchShultzs ($25.75 in chips) 
Seat 2: KeLevro0 ($11.68 in chips) 
Seat 3: chiyuki ($27.80 in chips) 
Seat 4: hl77777 ($11.80 in chips) 
Seat 5: jacquelinewu ($44.35 in chips) 
Seat 6: Alvinpe85 ($51.64 in chips) 
Seat 7: KrystalAA ($14.86 in chips) 
Seat 8: Dan Royal ($43.16 in chips) 
Seat 9: phate-1up ($71.68 in chips) 
KeLevro0: posts small blind $0.10
chiyuki: posts big blind $0.25
*** HOLE CARDS ***
Dealt to chiyuki [4h 3d]
hl77777: folds 
jacquelinewu: raises $0.50 to $0.75
Alvinpe85: folds 
KrystalAA: folds 
Dan Royal: folds 
phate-1up: calls $0.75
DutchShultzs: folds 
KeLevro0: folds 
chiyuki: folds 
*** FLOP *** [8s 8d Qs]
jacquelinewu: checks 
phate-1up: checks 
*** TURN *** [8s 8d Qs] [Jh]
jacquelinewu: checks 
phate-1up: bets $1.25
jacquelinewu: calls $1.25
*** RIVER *** [8s 8d Qs Jh] [5d]
jacquelinewu: checks 
phate-1up: checks 
*** SHOW DOWN ***
jacquelinewu: shows [Kh Kd] (two pair, Kings and Eights)
phate-1up: mucks hand 
jacquelinewu collected $4.15 from pot
*** SUMMARY ***
Total pot $4.35 | Rake $0.20 
Board [8s 8d Qs Jh 5d]
Seat 1: DutchShultzs (button) folded before Flop (didn't bet)
Seat 2: KeLevro0 (small blind) folded before Flop
Seat 3: chiyuki (big blind) folded before Flop
Seat 4: hl77777 folded before Flop (didn't bet)
Seat 5: jacquelinewu showed [Kh Kd] and won ($4.15) with two pair, Kings and Eights
Seat 6: Alvinpe85 folded before Flop (didn't bet)
Seat 7: KrystalAA folded before Flop (didn't bet)
Seat 8: Dan Royal folded before Flop (didn't bet)
Seat 9: phate-1up mucked [Ts Td]



PokerStars Zoom Hand #84299958176:  Hold'em No Limit ($0.10/$0.25) - 2012/08/05 14:54:57 JST [2012/08/05 1:54:57 ET]
Table 'Whirlpool' 9-max Seat #1 is the button
Seat 1: led52 ($12.50 in chips) 
Seat 2: seula i ($113.61 in chips) 
Seat 3: KeLevro0 ($12.43 in chips) 
Seat 4: Tom1999 ($22.31 in chips) 
Seat 5: deadmoneykid ($28.62 in chips) 
Seat 6: GovGus ($26.99 in chips) 
Seat 7: kesstukas25 ($16.34 in chips) 
Seat 8: chiyuki ($27.55 in chips) 
Seat 9: Dejacob ($25 in chips) 
seula i: posts small blind $0.10
KeLevro0: posts big blind $0.25
*** HOLE CARDS ***
Dealt to chiyuki [9s 8d]
Tom1999: folds 
deadmoneykid: folds 
GovGus: folds 
kesstukas25: folds 
chiyuki: folds 
Dejacob: folds 
led52: raises $0.50 to $0.75
seula i: calls $0.65
KeLevro0: folds 
*** FLOP *** [7c 8h 3h]
seula i: checks 
led52: bets $1
seula i: folds 
Uncalled bet ($1) returned to led52
led52 collected $1.67 from pot
led52: doesn't show hand 
*** SUMMARY ***
Total pot $1.75 | Rake $0.08 
Board [7c 8h 3h]
Seat 1: led52 (button) collected ($1.67)
Seat 2: seula i (small blind) folded on the Flop
Seat 3: KeLevro0 (big blind) folded before Flop
Seat 4: Tom1999 folded before Flop (didn't bet)
Seat 5: deadmoneykid folded before Flop (didn't bet)
Seat 6: GovGus folded before Flop (didn't bet)
Seat 7: kesstukas25 folded before Flop (didn't bet)
Seat 8: chiyuki folded before Flop (didn't bet)
Seat 9: Dejacob folded before Flop (didn't bet)



PokerStars Zoom Hand #84299959234:  Hold'em No Limit ($0.10/$0.25) - 2012/08/05 14:55:01 JST [2012/08/05 1:55:01 ET]
Table 'Whirlpool' 9-max Seat #1 is the button
Seat 1: chiyuki ($27.55 in chips) 
Seat 2: el pore 5 ($27.99 in chips) 
Seat 3: Paranoix1990 ($23.30 in chips) 
Seat 4: jacquelinewu ($47.25 in chips) 
Seat 5: kesstukas25 ($16.34 in chips) 
Seat 6: DutchShultzs ($26.10 in chips) 
Seat 7: ZhukOFFskI ($28.51 in chips) 
Seat 8: dushvan ($36.22 in chips) 
Seat 9: Perstenev ($12.93 in chips) 
el pore 5: posts small blind $0.10
Paranoix1990: posts big blind $0.25
*** HOLE CARDS ***
Dealt to chiyuki [9c 9s]
jacquelinewu: folds 
kesstukas25: folds 
DutchShultzs: raises $0.50 to $0.75
ZhukOFFskI: calls $0.75
dushvan: folds 
Perstenev: folds 
chiyuki: calls $0.75
el pore 5: folds 
Paranoix1990: calls $0.50
*** FLOP *** [Jd 4c Kd]
Paranoix1990: checks 
DutchShultzs: bets $1.70
ZhukOFFskI: folds 
chiyuki: folds 
Paranoix1990: folds 
Uncalled bet ($1.70) returned to DutchShultzs
DutchShultzs collected $2.96 from pot
DutchShultzs: doesn't show hand 
*** SUMMARY ***
Total pot $3.10 | Rake $0.14 
Board [Jd 4c Kd]
Seat 1: chiyuki (button) folded on the Flop
Seat 2: el pore 5 (small blind) folded before Flop
Seat 3: Paranoix1990 (big blind) folded on the Flop
Seat 4: jacquelinewu folded before Flop (didn't bet)
Seat 5: kesstukas25 folded before Flop (didn't bet)
Seat 6: DutchShultzs collected ($2.96)
Seat 7: ZhukOFFskI folded on the Flop
Seat 8: dushvan folded before Flop (didn't bet)
Seat 9: Perstenev folded before Flop (didn't bet)



PokerStars Zoom Hand #84299956428:  Hold'em No Limit ($0.10/$0.25) - 2012/08/05 14:54:50 JST [2012/08/05 1:54:50 ET]
Table 'Whirlpool' 9-max Seat #1 is the button
Seat 1: hirozo ($40.50 in chips) 
Seat 2: snejokCoxx ($10.80 in chips) 
Seat 3: Wilcox76607 ($37.98 in chips) 
Seat 4: GovGus ($26.99 in chips) 
Seat 5: Walturrr ($33.49 in chips) 
Seat 6: cofla tito ($9.30 in chips) 
Seat 7: BlOnDhOlIc ($32.95 in chips) 
Seat 8: 1Karina1 ($29.09 in chips) 
Seat 9: chiyuki ($27.55 in chips) 
snejokCoxx: posts small blind $0.10
Wilcox76607: posts big blind $0.25
*** HOLE CARDS ***
Dealt to chiyuki [6h 3s]
GovGus: folds 
Walturrr: folds 
cofla tito: folds 
BlOnDhOlIc: raises $0.25 to $0.50
1Karina1: folds 
chiyuki: folds 
hirozo: calls $0.50
snejokCoxx: folds 
Wilcox76607: calls $0.25
*** FLOP *** [5s 9c 8c]
Wilcox76607: bets $1
BlOnDhOlIc: folds 
hirozo: raises $1.77 to $2.77
Wilcox76607: calls $1.77
*** TURN *** [5s 9c 8c] [Kh]
Wilcox76607: checks 
hirozo: bets $4.55
Wilcox76607: folds 
Uncalled bet ($4.55) returned to hirozo
hirozo collected $6.82 from pot
hirozo: doesn't show hand 
*** SUMMARY ***
Total pot $7.14 | Rake $0.32 
Board [5s 9c 8c Kh]
Seat 1: hirozo (button) collected ($6.82)
Seat 2: snejokCoxx (small blind) folded before Flop
Seat 3: Wilcox76607 (big blind) folded on the Turn
Seat 4: GovGus folded before Flop (didn't bet)
Seat 5: Walturrr folded before Flop (didn't bet)
Seat 6: cofla tito folded before Flop (didn't bet)
Seat 7: BlOnDhOlIc folded on the Flop
Seat 8: 1Karina1 folded before Flop (didn't bet)
Seat 9: chiyuki folded before Flop (didn't bet)



PokerStars Zoom Hand #84299970930:  Hold'em No Limit ($0.10/$0.25) - 2012/08/05 14:55:57 JST [2012/08/05 1:55:57 ET]
Table 'Whirlpool' 9-max Seat #1 is the button
Seat 1: KrystalAA ($33.69 in chips) 
Seat 2: Walturrr ($26.23 in chips) 
Seat 3: Dan Royal ($32.81 in chips) 
Seat 4: DonSimonUsa ($18.68 in chips) 
Seat 5: troublesomm ($25 in chips) 
Seat 6: Paranoix1990 ($22.55 in chips) 
Seat 7: chiyuki ($26.80 in chips) 
Seat 8: Nerkit ($14.90 in chips) 
Seat 9: deadmoneykid ($25.68 in chips) 
Walturrr: posts small blind $0.10
Dan Royal: posts big blind $0.25
*** HOLE CARDS ***
Dealt to chiyuki [9s 8h]
DonSimonUsa: folds 
troublesomm: folds 
Paranoix1990: folds 
chiyuki: folds 
Nerkit: folds 
deadmoneykid: folds 
KrystalAA: folds 
Walturrr: folds 
Uncalled bet ($0.15) returned to Dan Royal
Dan Royal collected $0.20 from pot
Dan Royal: doesn't show hand 
*** SUMMARY ***
Total pot $0.20 | Rake $0 
Seat 1: KrystalAA (button) folded before Flop (didn't bet)
Seat 2: Walturrr (small blind) folded before Flop
Seat 3: Dan Royal (big blind) collected ($0.20)
Seat 4: DonSimonUsa folded before Flop (didn't bet)
Seat 5: troublesomm folded before Flop (didn't bet)
Seat 6: Paranoix1990 folded before Flop (didn't bet)
Seat 7: chiyuki folded before Flop (didn't bet)
Seat 8: Nerkit folded before Flop (didn't bet)
Seat 9: deadmoneykid folded before Flop (didn't bet)



PokerStars Zoom Hand #84299970150:  Hold'em No Limit ($0.10/$0.25) - 2012/08/05 14:55:53 JST [2012/08/05 1:55:53 ET]
Table 'Whirlpool' 9-max Seat #1 is the button
Seat 1: 1Karina1 ($25.25 in chips) 
Seat 2: cofla tito ($7.99 in chips) 
Seat 3: deadmoneykid ($21.10 in chips) 
Seat 4: Walturrr ($26.23 in chips) 
Seat 5: chiyuki ($26.80 in chips) 
Seat 6: DonSimonUsa ($18.68 in chips) 
Seat 7: Jene4kaBest ($17.02 in chips) 
Seat 8: KeLevro0 ($11.33 in chips) 
Seat 9: Perstenev ($14.98 in chips) 
cofla tito: posts small blind $0.10
deadmoneykid: posts big blind $0.25
*** HOLE CARDS ***
Dealt to chiyuki [5s Ad]
Walturrr: folds 
chiyuki: folds 
DonSimonUsa: folds 
Jene4kaBest: folds 
KeLevro0: folds 
Perstenev: folds 
1Karina1: folds 
cofla tito: calls $0.15
deadmoneykid: raises $0.50 to $0.75
cofla tito: raises $7.24 to $7.99 and is all-in
deadmoneykid: folds 
Uncalled bet ($7.24) returned to cofla tito
cofla tito collected $1.50 from pot
cofla tito: doesn't show hand 
*** SUMMARY ***
Total pot $1.50 | Rake $0 
Seat 1: 1Karina1 (button) folded before Flop (didn't bet)
Seat 2: cofla tito (small blind) collected ($1.50)
Seat 3: deadmoneykid (big blind) folded before Flop
Seat 4: Walturrr folded before Flop (didn't bet)
Seat 5: chiyuki folded before Flop (didn't bet)
Seat 6: DonSimonUsa folded before Flop (didn't bet)
Seat 7: Jene4kaBest folded before Flop (didn't bet)
Seat 8: KeLevro0 folded before Flop (didn't bet)
Seat 9: Perstenev folded before Flop (didn't bet)



PokerStars Zoom Hand #84299972043:  Hold'em No Limit ($0.10/$0.25) - 2012/08/05 14:56:03 JST [2012/08/05 1:56:03 ET]
Table 'Whirlpool' 9-max Seat #1 is the button
Seat 1: Nagibator441 ($10.39 in chips) 
Seat 2: troublesomm ($25 in chips) 
Seat 3: chiyuki ($26.80 in chips) 
Seat 4: KeLevro0 ($11.55 in chips) 
Seat 5: hl77777 ($12.50 in chips) 
Seat 6: Wilcox76607 ($34.71 in chips) 
Seat 7: hirozo ($25.65 in chips) 
Seat 8: KAKamiro ($29.41 in chips) 
Seat 9: GovGus ($28.96 in chips) 
troublesomm: posts small blind $0.10
chiyuki: posts big blind $0.25
*** HOLE CARDS ***
Dealt to chiyuki [9h 7s]
KeLevro0: folds 
hl77777: folds 
Wilcox76607: folds 
hirozo: folds 
KAKamiro: folds 
GovGus: raises $0.75 to $1
Nagibator441: folds 
troublesomm: folds 
chiyuki: folds 
Uncalled bet ($0.75) returned to GovGus
GovGus collected $0.60 from pot
GovGus: doesn't show hand 
*** SUMMARY ***
Total pot $0.60 | Rake $0 
Seat 1: Nagibator441 (button) folded before Flop (didn't bet)
Seat 2: troublesomm (small blind) folded before Flop
Seat 3: chiyuki (big blind) folded before Flop
Seat 4: KeLevro0 folded before Flop (didn't bet)
Seat 5: hl77777 folded before Flop (didn't bet)
Seat 6: Wilcox76607 folded before Flop (didn't bet)
Seat 7: hirozo folded before Flop (didn't bet)
Seat 8: KAKamiro folded before Flop (didn't bet)
Seat 9: GovGus collected ($0.60)



PokerStars Zoom Hand #84299977997:  Hold'em No Limit ($0.10/$0.25) - 2012/08/05 14:56:33 JST [2012/08/05 1:56:33 ET]
Table 'Whirlpool' 9-max Seat #1 is the button
Seat 1: Sal y Limon1 ($24.75 in chips) 
Seat 2: chiyuki ($26.55 in chips) 
Seat 3: Dejacob ($35.21 in chips) 
Seat 4: el pore 5 ($25.49 in chips) 
Seat 5: jacquelinewu ($31.38 in chips) 
Seat 6: DutchShultzs ($25.25 in chips) 
Seat 7: 1Karina1 ($25.35 in chips) 
Seat 8: Tom1999 ($24.37 in chips) 
Seat 9: Landybob ($40.82 in chips) 
chiyuki: posts small blind $0.10
Dejacob: posts big blind $0.25
*** HOLE CARDS ***
Dealt to chiyuki [2c 8h]
el pore 5: raises $0.50 to $0.75
jacquelinewu: folds 
DutchShultzs: folds 
1Karina1: folds 
Tom1999: raises $0.75 to $1.50
Landybob: folds 
Sal y Limon1: folds 
chiyuki: folds 
Dejacob: folds 
el pore 5: calls $0.75
*** FLOP *** [7h 5d 4d]
el pore 5: checks 
Tom1999: bets $1.25
el pore 5: folds 
Uncalled bet ($1.25) returned to Tom1999
Tom1999 collected $3.20 from pot
Tom1999: doesn't show hand 
*** SUMMARY ***
Total pot $3.35 | Rake $0.15 
Board [7h 5d 4d]
Seat 1: Sal y Limon1 (button) folded before Flop (didn't bet)
Seat 2: chiyuki (small blind) folded before Flop
Seat 3: Dejacob (big blind) folded before Flop
Seat 4: el pore 5 folded on the Flop
Seat 5: jacquelinewu folded before Flop (didn't bet)
Seat 6: DutchShultzs folded before Flop (didn't bet)
Seat 7: 1Karina1 folded before Flop (didn't bet)
Seat 8: Tom1999 collected ($3.20)
Seat 9: Landybob folded before Flop (didn't bet)



PokerStars Zoom Hand #84299979365:  Hold'em No Limit ($0.10/$0.25) - 2012/08/05 14:56:40 JST [2012/08/05 1:56:40 ET]
Table 'Whirlpool' 9-max Seat #1 is the button
Seat 1: troublesomm ($32.49 in chips) 
Seat 2: kesstukas25 ($14.05 in chips) 
Seat 3: KimPa39 ($34.74 in chips) 
Seat 4: jacquelinewu ($31.38 in chips) 
Seat 5: Dejacob ($34.96 in chips) 
Seat 6: chiyuki ($26.45 in chips) 
Seat 7: gunbowler ($157 in chips) 
Seat 8: Lars111 ($33.31 in chips) 
Seat 9: ChrisCDee ($30.41 in chips) 
kesstukas25: posts small blind $0.10
KimPa39: posts big blind $0.25
*** HOLE CARDS ***
Dealt to chiyuki [8d 8s]
jacquelinewu: folds 
Dejacob: folds 
chiyuki: raises $0.50 to $0.75
gunbowler: folds 
Lars111: folds 
ChrisCDee: calls $0.75
troublesomm: folds 
kesstukas25: calls $0.65
KimPa39: folds 
*** FLOP *** [Ac 2c 9c]
kesstukas25: checks 
chiyuki: checks 
ChrisCDee: checks 
*** TURN *** [Ac 2c 9c] [4c]
kesstukas25: bets $1
chiyuki: folds 
ChrisCDee: folds 
Uncalled bet ($1) returned to kesstukas25
kesstukas25 collected $2.39 from pot
kesstukas25: doesn't show hand 
*** SUMMARY ***
Total pot $2.50 | Rake $0.11 
Board [Ac 2c 9c 4c]
Seat 1: troublesomm (button) folded before Flop (didn't bet)
Seat 2: kesstukas25 (small blind) collected ($2.39)
Seat 3: KimPa39 (big blind) folded before Flop
Seat 4: jacquelinewu folded before Flop (didn't bet)
Seat 5: Dejacob folded before Flop (didn't bet)
Seat 6: chiyuki folded on the Turn
Seat 7: gunbowler folded before Flop (didn't bet)
Seat 8: Lars111 folded before Flop (didn't bet)
Seat 9: ChrisCDee folded on the Turn



PokerStars Zoom Hand #84299988591:  Hold'em No Limit ($0.10/$0.25) - 2012/08/05 14:57:27 JST [2012/08/05 1:57:27 ET]
Table 'Whirlpool' 9-max Seat #1 is the button
Seat 1: KrystalAA ($15.09 in chips) 
Seat 2: kaplya2010 ($14.77 in chips) 
Seat 3: KeLevro0 ($10.98 in chips) 
Seat 4: 1Karina1 ($26.74 in chips) 
Seat 5: hirozo ($25.40 in chips) 
Seat 6: Sal y Limon1 ($24.75 in chips) 
Seat 7: Alvinpe85 ($49.27 in chips) 
Seat 8: chiyuki ($25.70 in chips) 
Seat 9: Faantomace ($24.93 in chips) 
kaplya2010: posts small blind $0.10
KeLevro0: posts big blind $0.25
*** HOLE CARDS ***
Dealt to chiyuki [5h Kd]
1Karina1: folds 
hirozo: folds 
Sal y Limon1: folds 
Alvinpe85: folds 
chiyuki: folds 
Faantomace: folds 
KrystalAA: folds 
kaplya2010: folds 
Uncalled bet ($0.15) returned to KeLevro0
KeLevro0 collected $0.20 from pot
KeLevro0: doesn't show hand 
*** SUMMARY ***
Total pot $0.20 | Rake $0 
Seat 1: KrystalAA (button) folded before Flop (didn't bet)
Seat 2: kaplya2010 (small blind) folded before Flop
Seat 3: KeLevro0 (big blind) collected ($0.20)
Seat 4: 1Karina1 folded before Flop (didn't bet)
Seat 5: hirozo folded before Flop (didn't bet)
Seat 6: Sal y Limon1 folded before Flop (didn't bet)
Seat 7: Alvinpe85 folded before Flop (didn't bet)
Seat 8: chiyuki folded before Flop (didn't bet)
Seat 9: Faantomace folded before Flop (didn't bet)



PokerStars Zoom Hand #84299991189:  Hold'em No Limit ($0.10/$0.25) - 2012/08/05 14:57:40 JST [2012/08/05 1:57:40 ET]
Table 'Whirlpool' 9-max Seat #1 is the button
Seat 1: phate-1up ($69.43 in chips) 
Seat 2: troublesomm ($25.77 in chips) 
Seat 3: Cyanidoff ($31.48 in chips) 
Seat 4: hl77777 ($12.15 in chips) 
Seat 5: chiyuki ($25.70 in chips) 
Seat 6: 111ii111 ($15.10 in chips) 
Seat 7: DutchShultzs ($25 in chips) 
Seat 8: canammark ($37.79 in chips) 
Seat 9: Sal y Limon1 ($24.75 in chips) 
troublesomm: posts small blind $0.10
Cyanidoff: posts big blind $0.25
*** HOLE CARDS ***
Dealt to chiyuki [Kd Jc]
hl77777: folds 
chiyuki: folds 
111ii111: folds 
DutchShultzs: folds 
canammark: folds 
Sal y Limon1: folds 
phate-1up: folds 
troublesomm: folds 
Uncalled bet ($0.15) returned to Cyanidoff
Cyanidoff collected $0.20 from pot
Cyanidoff: doesn't show hand 
*** SUMMARY ***
Total pot $0.20 | Rake $0 
Seat 1: phate-1up (button) folded before Flop (didn't bet)
Seat 2: troublesomm (small blind) folded before Flop
Seat 3: Cyanidoff (big blind) collected ($0.20)
Seat 4: hl77777 folded before Flop (didn't bet)
Seat 5: chiyuki folded before Flop (didn't bet)
Seat 6: 111ii111 folded before Flop (didn't bet)
Seat 7: DutchShultzs folded before Flop (didn't bet)
Seat 8: canammark folded before Flop (didn't bet)
Seat 9: Sal y Limon1 folded before Flop (didn't bet)



PokerStars Zoom Hand #84299990184:  Hold'em No Limit ($0.10/$0.25) - 2012/08/05 14:57:35 JST [2012/08/05 1:57:35 ET]
Table 'Whirlpool' 9-max Seat #1 is the button
Seat 1: Alvinpe85 ($49.27 in chips) 
Seat 2: Cyanidoff ($31.58 in chips) 
Seat 3: 1Karina1 ($25 in chips) 
Seat 4: snejokCoxx ($10.35 in chips) 
Seat 5: Dejacob ($26.51 in chips) 
Seat 6: seula i ($25.13 in chips) 
Seat 7: Gichboy ($12.75 in chips) 
Seat 8: DutchShultzs ($25 in chips) 
Seat 9: chiyuki ($25.70 in chips) 
Cyanidoff: posts small blind $0.10
1Karina1: posts big blind $0.25
*** HOLE CARDS ***
Dealt to chiyuki [Jd 3d]
snejokCoxx: folds 
Dejacob: folds 
seula i: folds 
Gichboy: folds 
DutchShultzs: folds 
chiyuki: folds 
Alvinpe85: folds 
Cyanidoff: folds 
Uncalled bet ($0.15) returned to 1Karina1
1Karina1 collected $0.20 from pot
1Karina1: doesn't show hand 
*** SUMMARY ***
Total pot $0.20 | Rake $0 
Seat 1: Alvinpe85 (button) folded before Flop (didn't bet)
Seat 2: Cyanidoff (small blind) folded before Flop
Seat 3: 1Karina1 (big blind) collected ($0.20)
Seat 4: snejokCoxx folded before Flop (didn't bet)
Seat 5: Dejacob folded before Flop (didn't bet)
Seat 6: seula i folded before Flop (didn't bet)
Seat 7: Gichboy folded before Flop (didn't bet)
Seat 8: DutchShultzs folded before Flop (didn't bet)
Seat 9: chiyuki folded before Flop (didn't bet)



PokerStars Zoom Hand #84299989392:  Hold'em No Limit ($0.10/$0.25) - 2012/08/05 14:57:31 JST [2012/08/05 1:57:31 ET]
Table 'Whirlpool' 9-max Seat #1 is the button
Seat 1: bigred1102 ($36.48 in chips) 
Seat 2: 1Karina1 ($26.74 in chips) 
Seat 3: Dejacob ($26.56 in chips) 
Seat 4: chiyuki ($25.70 in chips) 
Seat 5: DutchShultzs ($25 in chips) 
Seat 6: kesstukas25 ($15.69 in chips) 
Seat 7: pativyko ($7.19 in chips) 
Seat 8: Littlea029 ($24.25 in chips) 
Seat 9: phate-1up ($53.44 in chips) 
1Karina1: posts small blind $0.10
Dejacob: posts big blind $0.25
*** HOLE CARDS ***
Dealt to chiyuki [Td Qs]
chiyuki: folds 
DutchShultzs: folds 
kesstukas25: folds 
pativyko: raises $0.50 to $0.75
Littlea029: folds 
phate-1up: folds 
bigred1102: folds 
1Karina1: folds 
Dejacob: calls $0.50
*** FLOP *** [3c 8c Tc]
Dejacob: checks 
pativyko: bets $0.75
Dejacob: folds 
Uncalled bet ($0.75) returned to pativyko
pativyko collected $1.53 from pot
pativyko: doesn't show hand 
*** SUMMARY ***
Total pot $1.60 | Rake $0.07 
Board [3c 8c Tc]
Seat 1: bigred1102 (button) folded before Flop (didn't bet)
Seat 2: 1Karina1 (small blind) folded before Flop
Seat 3: Dejacob (big blind) folded on the Flop
Seat 4: chiyuki folded before Flop (didn't bet)
Seat 5: DutchShultzs folded before Flop (didn't bet)
Seat 6: kesstukas25 folded before Flop (didn't bet)
Seat 7: pativyko collected ($1.53)
Seat 8: Littlea029 folded before Flop (didn't bet)
Seat 9: phate-1up folded before Flop (didn't bet)



PokerStars Zoom Hand #84299991953:  Hold'em No Limit ($0.10/$0.25) - 2012/08/05 14:57:44 JST [2012/08/05 1:57:44 ET]
Table 'Whirlpool' 9-max Seat #1 is the button
Seat 1: 111ii111 ($15.10 in chips) 
Seat 2: bigred1102 ($36.48 in chips) 
Seat 3: chiyuki ($25.70 in chips) 
Seat 4: Dan Royal ($32.41 in chips) 
Seat 5: miramax89 ($17.62 in chips) 
Seat 6: Ellen1947 ($32.49 in chips) 
Seat 7: jacquelinewu ($30.09 in chips) 
Seat 8: phate-1up ($53.44 in chips) 
Seat 9: Nerkit ($11.15 in chips) 
bigred1102: posts small blind $0.10
chiyuki: posts big blind $0.25
*** HOLE CARDS ***
Dealt to chiyuki [Th Td]
Dan Royal: folds 
miramax89: folds 
Ellen1947: folds 
jacquelinewu: raises $0.50 to $0.75
phate-1up: folds 
Nerkit: folds 
111ii111: calls $0.75
bigred1102: calls $0.65
chiyuki: raises $2 to $2.75
jacquelinewu: calls $2
111ii111: calls $2
bigred1102: calls $2
*** FLOP *** [5s Qs 6c]
bigred1102: checks 
chiyuki: checks 
jacquelinewu: checks 
111ii111: checks 
*** TURN *** [5s Qs 6c] [8s]
bigred1102: bets $0.75
chiyuki: calls $0.75
jacquelinewu: calls $0.75
111ii111: calls $0.75
*** RIVER *** [5s Qs 6c 8s] [Ah]
bigred1102: checks 
chiyuki: checks 
jacquelinewu: checks 
111ii111: bets $11.60 and is all-in
bigred1102: folds 
chiyuki: folds 
jacquelinewu: folds 
Uncalled bet ($11.60) returned to 111ii111
111ii111 collected $13.37 from pot
111ii111: doesn't show hand 
*** SUMMARY ***
Total pot $14 | Rake $0.63 
Board [5s Qs 6c 8s Ah]
Seat 1: 111ii111 (button) collected ($13.37)
Seat 2: bigred1102 (small blind) folded on the River
Seat 3: chiyuki (big blind) folded on the River
Seat 4: Dan Royal folded before Flop (didn't bet)
Seat 5: miramax89 folded before Flop (didn't bet)
Seat 6: Ellen1947 folded before Flop (didn't bet)
Seat 7: jacquelinewu folded on the River
Seat 8: phate-1up folded before Flop (didn't bet)
Seat 9: Nerkit folded before Flop (didn't bet)



PokerStars Zoom Hand #84300012198:  Hold'em No Limit ($0.10/$0.25) - 2012/08/05 14:59:27 JST [2012/08/05 1:59:27 ET]
Table 'Whirlpool' 9-max Seat #1 is the button
Seat 1: Perstenev ($13.88 in chips) 
Seat 2: chiyuki ($22.20 in chips) 
Seat 3: 1Karina1 ($26.29 in chips) 
Seat 4: Dafleche ($46.83 in chips) 
Seat 5: Cyanidoff ($37.07 in chips) 
Seat 6: laurentzu84 ($53.43 in chips) 
Seat 7: KeLevro0 ($9.83 in chips) 
Seat 8: DutchShultzs ($29.21 in chips) 
Seat 9: mid22 ($18.63 in chips) 
chiyuki: posts small blind $0.10
1Karina1: posts big blind $0.25
*** HOLE CARDS ***
Dealt to chiyuki [Js 8c]
Dafleche: calls $0.25
Cyanidoff: folds 
laurentzu84: folds 
KeLevro0: folds 
DutchShultzs: raises $0.85 to $1.10
mid22: folds 
Perstenev: folds 
chiyuki: folds 
1Karina1: folds 
Dafleche: folds 
Uncalled bet ($0.85) returned to DutchShultzs
DutchShultzs collected $0.85 from pot
DutchShultzs: doesn't show hand 
*** SUMMARY ***
Total pot $0.85 | Rake $0 
Seat 1: Perstenev (button) folded before Flop (didn't bet)
Seat 2: chiyuki (small blind) folded before Flop
Seat 3: 1Karina1 (big blind) folded before Flop
Seat 4: Dafleche folded before Flop
Seat 5: Cyanidoff folded before Flop (didn't bet)
Seat 6: laurentzu84 folded before Flop (didn't bet)
Seat 7: KeLevro0 folded before Flop (didn't bet)
Seat 8: DutchShultzs collected ($0.85)
Seat 9: mid22 folded before Flop (didn't bet)



PokerStars Zoom Hand #84300015590:  Hold'em No Limit ($0.10/$0.25) - 2012/08/05 14:59:44 JST [2012/08/05 1:59:44 ET]
Table 'Whirlpool' 9-max Seat #1 is the button
Seat 1: 4plankton ($16.83 in chips) 
Seat 2: mjmichi ($25 in chips) 
Seat 3: KeLevro0 ($11.06 in chips) 
Seat 4: Perstenev ($8.94 in chips) 
Seat 5: deadmoneykid ($27.77 in chips) 
Seat 6: ChrisCDee ($26.51 in chips) 
Seat 7: chiyuki ($22.10 in chips) 
Seat 8: phate-1up ($52.34 in chips) 
Seat 9: yane73 ($58.76 in chips) 
mjmichi: posts small blind $0.10
KeLevro0: posts big blind $0.25
*** HOLE CARDS ***
Dealt to chiyuki [Qh 6h]
Perstenev: folds 
deadmoneykid: folds 
ChrisCDee: folds 
chiyuki: folds 
phate-1up: folds 
yane73: folds 
4plankton: folds 
mjmichi: raises $0.50 to $0.75
KeLevro0: folds 
Uncalled bet ($0.50) returned to mjmichi
mjmichi collected $0.50 from pot
mjmichi: doesn't show hand 
*** SUMMARY ***
Total pot $0.50 | Rake $0 
Seat 1: 4plankton (button) folded before Flop (didn't bet)
Seat 2: mjmichi (small blind) collected ($0.50)
Seat 3: KeLevro0 (big blind) folded before Flop
Seat 4: Perstenev folded before Flop (didn't bet)
Seat 5: deadmoneykid folded before Flop (didn't bet)
Seat 6: ChrisCDee folded before Flop (didn't bet)
Seat 7: chiyuki folded before Flop (didn't bet)
Seat 8: phate-1up folded before Flop (didn't bet)
Seat 9: yane73 folded before Flop (didn't bet)



PokerStars Zoom Hand #84300013973:  Hold'em No Limit ($0.10/$0.25) - 2012/08/05 14:59:36 JST [2012/08/05 1:59:36 ET]
Table 'Whirlpool' 9-max Seat #1 is the button
Seat 1: chiyuki ($22.10 in chips) 
Seat 2: deadmoneykid ($27.87 in chips) 
Seat 3: silvno31 ($14 in chips) 
Seat 4: jacquelinewu ($33.83 in chips) 
Seat 5: KeLevro0 ($9.83 in chips) 
Seat 6: Perstenev ($8.94 in chips) 
Seat 7: ChrisCDee ($26.51 in chips) 
Seat 8: Landybob ($41.49 in chips) 
Seat 9: 111ii111 ($24.87 in chips) 
deadmoneykid: posts small blind $0.10
silvno31: posts big blind $0.25
*** HOLE CARDS ***
Dealt to chiyuki [5h 8c]
jacquelinewu: raises $0.50 to $0.75
KeLevro0: folds 
Perstenev: folds 
ChrisCDee: folds 
Landybob: folds 
111ii111: folds 
chiyuki: folds 
deadmoneykid: folds 
silvno31: calls $0.50
*** FLOP *** [8h Qh Ks]
silvno31: bets $1.25
jacquelinewu: calls $1.25
*** TURN *** [8h Qh Ks] [Qs]
silvno31: bets $12 and is all-in
jacquelinewu: folds 
Uncalled bet ($12) returned to silvno31
silvno31 collected $3.92 from pot
silvno31: doesn't show hand 
*** SUMMARY ***
Total pot $4.10 | Rake $0.18 
Board [8h Qh Ks Qs]
Seat 1: chiyuki (button) folded before Flop (didn't bet)
Seat 2: deadmoneykid (small blind) folded before Flop
Seat 3: silvno31 (big blind) collected ($3.92)
Seat 4: jacquelinewu folded on the Turn
Seat 5: KeLevro0 folded before Flop (didn't bet)
Seat 6: Perstenev folded before Flop (didn't bet)
Seat 7: ChrisCDee folded before Flop (didn't bet)
Seat 8: Landybob folded before Flop (didn't bet)
Seat 9: 111ii111 folded before Flop (didn't bet)



PokerStars Zoom Hand #84300017427:  Hold'em No Limit ($0.10/$0.25) - 2012/08/05 14:59:53 JST [2012/08/05 1:59:53 ET]
Table 'Whirlpool' 9-max Seat #1 is the button
Seat 1: cofla tito ($10.60 in chips) 
Seat 2: Perstenev ($9.03 in chips) 
Seat 3: Silveystryk ($25 in chips) 
Seat 4: edilson_ita ($11.01 in chips) 
Seat 5: chiyuki ($22.10 in chips) 
Seat 6: snejokCoxx ($12.15 in chips) 
Seat 7: DutchShultzs ($33.80 in chips) 
Seat 8: tribunpdm ($27.50 in chips) 
Seat 9: phate-1up ($52.34 in chips) 
Perstenev: posts small blind $0.10
Silveystryk: posts big blind $0.25
*** HOLE CARDS ***
Dealt to chiyuki [3h 6h]
edilson_ita: folds 
chiyuki: folds 
snejokCoxx: folds 
DutchShultzs: folds 
tribunpdm: folds 
phate-1up: folds 
cofla tito: folds 
Perstenev: folds 
Uncalled bet ($0.15) returned to Silveystryk
Silveystryk collected $0.20 from pot
Silveystryk: doesn't show hand 
*** SUMMARY ***
Total pot $0.20 | Rake $0 
Seat 1: cofla tito (button) folded before Flop (didn't bet)
Seat 2: Perstenev (small blind) folded before Flop
Seat 3: Silveystryk (big blind) collected ($0.20)
Seat 4: edilson_ita folded before Flop (didn't bet)
Seat 5: chiyuki folded before Flop (didn't bet)
Seat 6: snejokCoxx folded before Flop (didn't bet)
Seat 7: DutchShultzs folded before Flop (didn't bet)
Seat 8: tribunpdm folded before Flop (didn't bet)
Seat 9: phate-1up folded before Flop (didn't bet)



PokerStars Zoom Hand #84300019002:  Hold'em No Limit ($0.10/$0.25) - 2012/08/05 15:00:01 JST [2012/08/05 2:00:01 ET]
Table 'Whirlpool' 9-max Seat #1 is the button
Seat 1: Nerkit ($19.49 in chips) 
Seat 2: River_GmbH ($14.40 in chips) 
Seat 3: yane73 ($58.76 in chips) 
Seat 4: ZhukOFFskI ($28.23 in chips) 
Seat 5: phate-1up ($25 in chips) 
Seat 6: chiyuki ($22.10 in chips) 
Seat 7: deadmoneykid ($26.77 in chips) 
Seat 8: troublesomm ($37.48 in chips) 
Seat 9: GovGus ($34.31 in chips) 
River_GmbH: posts small blind $0.10
yane73: posts big blind $0.25
*** HOLE CARDS ***
Dealt to chiyuki [2s Jh]
ZhukOFFskI: folds 
phate-1up: folds 
chiyuki: folds 
deadmoneykid: folds 
troublesomm: folds 
GovGus: folds 
Nerkit: folds 
River_GmbH: folds 
Uncalled bet ($0.15) returned to yane73
yane73 collected $0.20 from pot
yane73: doesn't show hand 
*** SUMMARY ***
Total pot $0.20 | Rake $0 
Seat 1: Nerkit (button) folded before Flop (didn't bet)
Seat 2: River_GmbH (small blind) folded before Flop
Seat 3: yane73 (big blind) collected ($0.20)
Seat 4: ZhukOFFskI folded before Flop (didn't bet)
Seat 5: phate-1up folded before Flop (didn't bet)
Seat 6: chiyuki folded before Flop (didn't bet)
Seat 7: deadmoneykid folded before Flop (didn't bet)
Seat 8: troublesomm folded before Flop (didn't bet)
Seat 9: GovGus folded before Flop (didn't bet)



PokerStars Zoom Hand #84300019782:  Hold'em No Limit ($0.10/$0.25) - 2012/08/05 15:00:05 JST [2012/08/05 2:00:05 ET]
Table 'Whirlpool' 9-max Seat #1 is the button
Seat 1: ZhukOFFskI ($28.23 in chips) 
Seat 2: PillZ86 ($11.55 in chips) 
Seat 3: Perstenev ($8.94 in chips) 
Seat 4: chiyuki ($22.10 in chips) 
Seat 5: deadmoneykid ($28.95 in chips) 
Seat 6: Gichboy ($11.25 in chips) 
Seat 7: phate-1up ($25 in chips) 
Seat 8: mjmichi ($25.25 in chips) 
Seat 9: Jene4kaBest ($15.67 in chips) 
PillZ86: posts small blind $0.10
Perstenev: posts big blind $0.25
*** HOLE CARDS ***
Dealt to chiyuki [Qc 9d]
chiyuki: folds 
deadmoneykid: folds 
Gichboy: calls $0.25
phate-1up: folds 
mjmichi: folds 
Jene4kaBest: folds 
ZhukOFFskI: folds 
PillZ86: folds 
Perstenev: checks 
*** FLOP *** [Ac Qs 8d]
Perstenev: checks 
Gichboy: bets $0.25
Perstenev: folds 
Uncalled bet ($0.25) returned to Gichboy
Gichboy collected $0.57 from pot
Gichboy: doesn't show hand 
*** SUMMARY ***
Total pot $0.60 | Rake $0.03 
Board [Ac Qs 8d]
Seat 1: ZhukOFFskI (button) folded before Flop (didn't bet)
Seat 2: PillZ86 (small blind) folded before Flop
Seat 3: Perstenev (big blind) folded on the Flop
Seat 4: chiyuki folded before Flop (didn't bet)
Seat 5: deadmoneykid folded before Flop (didn't bet)
Seat 6: Gichboy collected ($0.57)
Seat 7: phate-1up folded before Flop (didn't bet)
Seat 8: mjmichi folded before Flop (didn't bet)
Seat 9: Jene4kaBest folded before Flop (didn't bet)



PokerStars Zoom Hand #84300021595:  Hold'em No Limit ($0.10/$0.25) - 2012/08/05 15:00:14 JST [2012/08/05 2:00:14 ET]
Table 'Whirlpool' 9-max Seat #1 is the button
Seat 1: INSP!RON ($25.25 in chips) 
Seat 2: edilson_ita ($10.76 in chips) 
Seat 3: bigred1102 ($45.44 in chips) 
Seat 4: softdesign ($63.04 in chips) 
Seat 5: dushvan ($43.53 in chips) 
Seat 6: troublesomm ($28.40 in chips) 
Seat 7: kamikkaze ($15 in chips) 
Seat 8: 1Karina1 ($25.94 in chips) 
Seat 9: chiyuki ($22.10 in chips) 
edilson_ita: posts small blind $0.10
bigred1102: posts big blind $0.25
*** HOLE CARDS ***
Dealt to chiyuki [Jd 9d]
softdesign: folds 
dushvan: folds 
troublesomm: folds 
kamikkaze: folds 
1Karina1: folds 
chiyuki: folds 
INSP!RON: raises $0.35 to $0.60
edilson_ita: folds 
bigred1102: calls $0.35
*** FLOP *** [Ad 4s 9c]
bigred1102: checks 
INSP!RON: bets $0.90
bigred1102: folds 
Uncalled bet ($0.90) returned to INSP!RON
INSP!RON collected $1.24 from pot
INSP!RON: doesn't show hand 
*** SUMMARY ***
Total pot $1.30 | Rake $0.06 
Board [Ad 4s 9c]
Seat 1: INSP!RON (button) collected ($1.24)
Seat 2: edilson_ita (small blind) folded before Flop
Seat 3: bigred1102 (big blind) folded on the Flop
Seat 4: softdesign folded before Flop (didn't bet)
Seat 5: dushvan folded before Flop (didn't bet)
Seat 6: troublesomm folded before Flop (didn't bet)
Seat 7: kamikkaze folded before Flop (didn't bet)
Seat 8: 1Karina1 folded before Flop (didn't bet)
Seat 9: chiyuki folded before Flop (didn't bet)



PokerStars Zoom Hand #84300022402:  Hold'em No Limit ($0.10/$0.25) - 2012/08/05 15:00:18 JST [2012/08/05 2:00:18 ET]
Table 'Whirlpool' 9-max Seat #1 is the button
Seat 1: Ellen1947 ($45.26 in chips) 
Seat 2: snejokCoxx ($10.63 in chips) 
Seat 3: deadmoneykid ($28.95 in chips) 
Seat 4: River_GmbH ($14.65 in chips) 
Seat 5: KrystalAA ($32.92 in chips) 
Seat 6: chiyuki ($22.10 in chips) 
Seat 7: GovGus ($34.31 in chips) 
Seat 8: hirozo ($69.25 in chips) 
Seat 9: phate-1up ($34.84 in chips) 
snejokCoxx: posts small blind $0.10
deadmoneykid: posts big blind $0.25
*** HOLE CARDS ***
Dealt to chiyuki [Ks 5h]
River_GmbH: folds 
KrystalAA: folds 
chiyuki: folds 
GovGus: folds 
hirozo: folds 
phate-1up: raises $0.50 to $0.75
Ellen1947: folds 
snejokCoxx: folds 
deadmoneykid: folds 
Uncalled bet ($0.50) returned to phate-1up
phate-1up collected $0.60 from pot
phate-1up: doesn't show hand 
*** SUMMARY ***
Total pot $0.60 | Rake $0 
Seat 1: Ellen1947 (button) folded before Flop (didn't bet)
Seat 2: snejokCoxx (small blind) folded before Flop
Seat 3: deadmoneykid (big blind) folded before Flop
Seat 4: River_GmbH folded before Flop (didn't bet)
Seat 5: KrystalAA folded before Flop (didn't bet)
Seat 6: chiyuki folded before Flop (didn't bet)
Seat 7: GovGus folded before Flop (didn't bet)
Seat 8: hirozo folded before Flop (didn't bet)
Seat 9: phate-1up collected ($0.60)



PokerStars Zoom Hand #84300023541:  Hold'em No Limit ($0.10/$0.25) - 2012/08/05 15:00:24 JST [2012/08/05 2:00:24 ET]
Table 'Whirlpool' 9-max Seat #1 is the button
Seat 1: chiyuki ($22.10 in chips) 
Seat 2: Phaedrus...3 ($22.83 in chips) 
Seat 3: 1Karina1 ($25.94 in chips) 
Seat 4: Nerkit ($19.49 in chips) 
Seat 5: INSP!RON ($25 in chips) 
Seat 6: Perstenev ($8.93 in chips) 
Seat 7: PillZ86 ($11.20 in chips) 
Seat 8: ChrisCDee ($69.29 in chips) 
Seat 9: Alvinpe85 ($50.43 in chips) 
Phaedrus...3: posts small blind $0.10
1Karina1: posts big blind $0.25
*** HOLE CARDS ***
Dealt to chiyuki [4s 8h]
Nerkit: folds 
INSP!RON: folds 
Perstenev: folds 
PillZ86: folds 
ChrisCDee: folds 
Alvinpe85: raises $0.37 to $0.62
chiyuki: folds 
Phaedrus...3: folds 
1Karina1: folds 
Uncalled bet ($0.37) returned to Alvinpe85
Alvinpe85 collected $0.60 from pot
Alvinpe85: doesn't show hand 
*** SUMMARY ***
Total pot $0.60 | Rake $0 
Seat 1: chiyuki (button) folded before Flop (didn't bet)
Seat 2: Phaedrus...3 (small blind) folded before Flop
Seat 3: 1Karina1 (big blind) folded before Flop
Seat 4: Nerkit folded before Flop (didn't bet)
Seat 5: INSP!RON folded before Flop (didn't bet)
Seat 6: Perstenev folded before Flop (didn't bet)
Seat 7: PillZ86 folded before Flop (didn't bet)
Seat 8: ChrisCDee folded before Flop (didn't bet)
Seat 9: Alvinpe85 collected ($0.60)



PokerStars Zoom Hand #84300018240:  Hold'em No Limit ($0.10/$0.25) - 2012/08/05 14:59:57 JST [2012/08/05 1:59:57 ET]
Table 'Whirlpool' 9-max Seat #1 is the button
Seat 1: tribunpdm ($27.50 in chips) 
Seat 2: DutchShultzs ($33.80 in chips) 
Seat 3: edilson_ita ($11.01 in chips) 
Seat 4: deepakmbh ($48.36 in chips) 
Seat 5: phate-1up ($52.34 in chips) 
Seat 6: deadmoneykid ($26.77 in chips) 
Seat 7: yane73 ($58.76 in chips) 
Seat 8: chiyuki ($22.10 in chips) 
Seat 9: hirozo ($74.01 in chips) 
DutchShultzs: posts small blind $0.10
edilson_ita: posts big blind $0.25
*** HOLE CARDS ***
Dealt to chiyuki [7h Kd]
deepakmbh: raises $0.50 to $0.75
phate-1up: folds 
deadmoneykid: folds 
yane73: folds 
chiyuki: folds 
hirozo: calls $0.75
tribunpdm: calls $0.75
DutchShultzs: folds 
edilson_ita: folds 
*** FLOP *** [Jd 6c 3d]
deepakmbh: checks 
hirozo: checks 
tribunpdm: bets $1.50
deepakmbh: calls $1.50
hirozo: folds 
*** TURN *** [Jd 6c 3d] [7d]
deepakmbh: checks 
tribunpdm: checks 
*** RIVER *** [Jd 6c 3d 7d] [Qs]
deepakmbh: bets $4.50
tribunpdm: folds 
Uncalled bet ($4.50) returned to deepakmbh
deepakmbh collected $5.35 from pot
deepakmbh: doesn't show hand 
*** SUMMARY ***
Total pot $5.60 | Rake $0.25 
Board [Jd 6c 3d 7d Qs]
Seat 1: tribunpdm (button) folded on the River
Seat 2: DutchShultzs (small blind) folded before Flop
Seat 3: edilson_ita (big blind) folded before Flop
Seat 4: deepakmbh collected ($5.35)
Seat 5: phate-1up folded before Flop (didn't bet)
Seat 6: deadmoneykid folded before Flop (didn't bet)
Seat 7: yane73 folded before Flop (didn't bet)
Seat 8: chiyuki folded before Flop (didn't bet)
Seat 9: hirozo folded on the Flop



PokerStars Zoom Hand #84300025395:  Hold'em No Limit ($0.10/$0.25) - 2012/08/05 15:00:34 JST [2012/08/05 2:00:34 ET]
Table 'Whirlpool' 9-max Seat #1 is the button
Seat 1: Perstenev ($8.59 in chips) 
Seat 2: cofla tito ($10.45 in chips) 
Seat 3: chiyuki ($22.10 in chips) 
Seat 4: Nerkit ($14.07 in chips) 
Seat 5: Paranoix1990 ($19.33 in chips) 
Seat 6: PillZ86 ($11.20 in chips) 
Seat 7: wildy29 ($13.25 in chips) 
Seat 8: deadmoneykid ($25.88 in chips) 
Seat 9: Silveystryk ($24.65 in chips) 
cofla tito: posts small blind $0.10
chiyuki: posts big blind $0.25
*** HOLE CARDS ***
Dealt to chiyuki [Kh 3h]
Nerkit: folds 
Paranoix1990: folds 
PillZ86 has timed out
PillZ86: folds 
wildy29: raises $0.75 to $1
deadmoneykid: folds 
Silveystryk: folds 
Perstenev: folds 
cofla tito: folds 
chiyuki: folds 
Uncalled bet ($0.75) returned to wildy29
wildy29 collected $0.60 from pot
wildy29: doesn't show hand 
*** SUMMARY ***
Total pot $0.60 | Rake $0 
Seat 1: Perstenev (button) folded before Flop (didn't bet)
Seat 2: cofla tito (small blind) folded before Flop
Seat 3: chiyuki (big blind) folded before Flop
Seat 4: Nerkit folded before Flop (didn't bet)
Seat 5: Paranoix1990 folded before Flop (didn't bet)
Seat 6: PillZ86 folded before Flop (didn't bet)
Seat 7: wildy29 collected ($0.60)
Seat 8: deadmoneykid folded before Flop (didn't bet)
Seat 9: Silveystryk folded before Flop (didn't bet)



PokerStars Zoom Hand #84300024392:  Hold'em No Limit ($0.10/$0.25) - 2012/08/05 15:00:29 JST [2012/08/05 2:00:29 ET]
Table 'Whirlpool' 9-max Seat #1 is the button
Seat 1: dushvan ($43.53 in chips) 
Seat 2: INSP!RON ($25 in chips) 
Seat 3: GovGus ($26.35 in chips) 
Seat 4: cofla tito ($10.45 in chips) 
Seat 5: Perstenev ($8.93 in chips) 
Seat 6: colorado2108 ($27.85 in chips) 
Seat 7: chiyuki ($22.10 in chips) 
Seat 8: KimPa39 ($34.47 in chips) 
Seat 9: metrio982 ($12.25 in chips) 
INSP!RON: posts small blind $0.10
GovGus: posts big blind $0.25
*** HOLE CARDS ***
Dealt to chiyuki [Ac Ts]
cofla tito: folds 
Perstenev: folds 
colorado2108: folds 
chiyuki: folds 
KimPa39: folds 
metrio982: calls $0.25
dushvan: folds 
INSP!RON: raises $1 to $1.25
GovGus: folds 
metrio982: calls $1
*** FLOP *** [8d 8h 2h]
INSP!RON: bets $1.65
metrio982: folds 
Uncalled bet ($1.65) returned to INSP!RON
INSP!RON collected $2.63 from pot
INSP!RON: doesn't show hand 
*** SUMMARY ***
Total pot $2.75 | Rake $0.12 
Board [8d 8h 2h]
Seat 1: dushvan (button) folded before Flop (didn't bet)
Seat 2: INSP!RON (small blind) collected ($2.63)
Seat 3: GovGus (big blind) folded before Flop
Seat 4: cofla tito folded before Flop (didn't bet)
Seat 5: Perstenev folded before Flop (didn't bet)
Seat 6: colorado2108 folded before Flop (didn't bet)
Seat 7: chiyuki folded before Flop (didn't bet)
Seat 8: KimPa39 folded before Flop (didn't bet)
Seat 9: metrio982 folded on the Flop



PokerStars Zoom Hand #84300031863:  Hold'em No Limit ($0.10/$0.25) - 2012/08/05 15:01:04 JST [2012/08/05 2:01:04 ET]
Table 'Whirlpool' 9-max Seat #1 is the button
Seat 1: 1Karina1 ($25 in chips) 
Seat 2: chiyuki ($21.85 in chips) 
Seat 3: Tom1999 ($28.18 in chips) 
Seat 4: GovGus ($26 in chips) 
Seat 5: KrystalAA ($32 in chips) 
Seat 6: ZhukOFFskI ($46.07 in chips) 
Seat 7: deadmoneykid ($27.87 in chips) 
Seat 8: simonzez ($26.43 in chips) 
Seat 9: rorfo23 ($21.34 in chips) 
chiyuki: posts small blind $0.10
Tom1999: posts big blind $0.25
*** HOLE CARDS ***
Dealt to chiyuki [Ts Th]
GovGus: folds 
KrystalAA: folds 
ZhukOFFskI: folds 
deadmoneykid: folds 
simonzez: calls $0.25
rorfo23: folds 
1Karina1: folds 
chiyuki: raises $0.75 to $1
Tom1999: calls $0.75
simonzez: calls $0.75
*** FLOP *** [6c 8d Qc]
chiyuki: bets $1.50
Tom1999: calls $1.50
simonzez: calls $1.50
*** TURN *** [6c 8d Qc] [Jd]
chiyuki: checks 
Tom1999: checks 
simonzez: checks 
*** RIVER *** [6c 8d Qc Jd] [8c]
chiyuki: checks 
Tom1999: bets $1
simonzez: raises $1 to $2
chiyuki: folds 
Tom1999: calls $1
*** SHOW DOWN ***
simonzez: shows [8h 7h] (three of a kind, Eights)
Tom1999: mucks hand 
simonzez collected $10.98 from pot
*** SUMMARY ***
Total pot $11.50 | Rake $0.52 
Board [6c 8d Qc Jd 8c]
Seat 1: 1Karina1 (button) folded before Flop (didn't bet)
Seat 2: chiyuki (small blind) folded on the River
Seat 3: Tom1999 (big blind) mucked [Td Js]
Seat 4: GovGus folded before Flop (didn't bet)
Seat 5: KrystalAA folded before Flop (didn't bet)
Seat 6: ZhukOFFskI folded before Flop (didn't bet)
Seat 7: deadmoneykid folded before Flop (didn't bet)
Seat 8: simonzez showed [8h 7h] and won ($10.98) with three of a kind, Eights
Seat 9: rorfo23 folded before Flop (didn't bet)



PokerStars Zoom Hand #84300046836:  Hold'em No Limit ($0.10/$0.25) - 2012/08/05 15:02:07 JST [2012/08/05 2:02:07 ET]
Table 'Whirlpool' 9-max Seat #1 is the button
Seat 1: Tom1999 ($23.68 in chips) 
Seat 2: 1Karina1 ($25 in chips) 
Seat 3: deadmoneykid ($26.80 in chips) 
Seat 4: hirozo ($29.20 in chips) 
Seat 5: Littlea029 ($24.73 in chips) 
Seat 6: simonzez ($32.91 in chips) 
Seat 7: kesstukas25 ($14.09 in chips) 
Seat 8: chiyuki ($25 in chips) 
Seat 9: Silveystryk ($24 in chips) 
1Karina1: posts small blind $0.10
deadmoneykid: posts big blind $0.25
*** HOLE CARDS ***
Dealt to chiyuki [5c Ad]
hirozo: folds 
Littlea029: folds 
simonzez: folds 
kesstukas25: folds 
chiyuki: folds 
Silveystryk: folds 
Tom1999: folds 
1Karina1: folds 
Uncalled bet ($0.15) returned to deadmoneykid
deadmoneykid collected $0.20 from pot
deadmoneykid: doesn't show hand 
*** SUMMARY ***
Total pot $0.20 | Rake $0 
Seat 1: Tom1999 (button) folded before Flop (didn't bet)
Seat 2: 1Karina1 (small blind) folded before Flop
Seat 3: deadmoneykid (big blind) collected ($0.20)
Seat 4: hirozo folded before Flop (didn't bet)
Seat 5: Littlea029 folded before Flop (didn't bet)
Seat 6: simonzez folded before Flop (didn't bet)
Seat 7: kesstukas25 folded before Flop (didn't bet)
Seat 8: chiyuki folded before Flop (didn't bet)
Seat 9: Silveystryk folded before Flop (didn't bet)



PokerStars Zoom Hand #84300051621:  Hold'em No Limit ($0.10/$0.25) - 2012/08/05 15:02:27 JST [2012/08/05 2:02:27 ET]
Table 'Whirlpool' 9-max Seat #1 is the button
Seat 1: kamikkaze ($14.90 in chips) 
Seat 2: jacquelinewu ($34.23 in chips) 
Seat 3: Silveystryk ($24.75 in chips) 
Seat 4: chiyuki ($25 in chips) 
Seat 5: Nerkit ($12.85 in chips) 
Seat 6: silvno31 ($15.99 in chips) 
Seat 7: 1Karina1 ($25 in chips) 
Seat 8: KrystalAA ($33.61 in chips) 
Seat 9: ChrisCDee ($25.97 in chips) 
jacquelinewu: posts small blind $0.10
Silveystryk: posts big blind $0.25
*** HOLE CARDS ***
Dealt to chiyuki [Ad Ac]
chiyuki: raises $0.50 to $0.75
Nerkit: folds 
silvno31: folds 
1Karina1: folds 
KrystalAA: folds 
ChrisCDee: folds 
kamikkaze: folds 
jacquelinewu: folds 
Silveystryk: folds 
Uncalled bet ($0.50) returned to chiyuki
chiyuki collected $0.60 from pot
chiyuki: doesn't show hand 
*** SUMMARY ***
Total pot $0.60 | Rake $0 
Seat 1: kamikkaze (button) folded before Flop (didn't bet)
Seat 2: jacquelinewu (small blind) folded before Flop
Seat 3: Silveystryk (big blind) folded before Flop
Seat 4: chiyuki collected ($0.60)
Seat 5: Nerkit folded before Flop (didn't bet)
Seat 6: silvno31 folded before Flop (didn't bet)
Seat 7: 1Karina1 folded before Flop (didn't bet)
Seat 8: KrystalAA folded before Flop (didn't bet)
Seat 9: ChrisCDee folded before Flop (didn't bet)



PokerStars Zoom Hand #84300054600:  Hold'em No Limit ($0.10/$0.25) - 2012/08/05 15:02:40 JST [2012/08/05 2:02:40 ET]
Table 'Whirlpool' 9-max Seat #1 is the button
Seat 1: 1Karina1 ($25 in chips) 
Seat 2: ll_LaMeR_ll ($101.52 in chips) 
Seat 3: snejokCoxx ($13.33 in chips) 
Seat 4: kesstukas25 ($18.22 in chips) 
Seat 5: chiyuki ($25.35 in chips) 
Seat 6: River_GmbH ($12.55 in chips) 
Seat 7: deadmoneykid ($26.90 in chips) 
Seat 8: seula i ($40.69 in chips) 
Seat 9: MOReilly000 ($25.60 in chips) 
ll_LaMeR_ll: posts small blind $0.10
snejokCoxx: posts big blind $0.25
*** HOLE CARDS ***
Dealt to chiyuki [7h 4h]
kesstukas25: folds 
chiyuki: folds 
River_GmbH: folds 
deadmoneykid: folds 
seula i: folds 
MOReilly000: raises $0.50 to $0.75
1Karina1: folds 
ll_LaMeR_ll: folds 
snejokCoxx: folds 
Uncalled bet ($0.50) returned to MOReilly000
MOReilly000 collected $0.60 from pot
MOReilly000: doesn't show hand 
*** SUMMARY ***
Total pot $0.60 | Rake $0 
Seat 1: 1Karina1 (button) folded before Flop (didn't bet)
Seat 2: ll_LaMeR_ll (small blind) folded before Flop
Seat 3: snejokCoxx (big blind) folded before Flop
Seat 4: kesstukas25 folded before Flop (didn't bet)
Seat 5: chiyuki folded before Flop (didn't bet)
Seat 6: River_GmbH folded before Flop (didn't bet)
Seat 7: deadmoneykid folded before Flop (didn't bet)
Seat 8: seula i folded before Flop (didn't bet)
Seat 9: MOReilly000 collected ($0.60)



PokerStars Zoom Hand #84300055818:  Hold'em No Limit ($0.10/$0.25) - 2012/08/05 15:02:45 JST [2012/08/05 2:02:45 ET]
Table 'Whirlpool' 9-max Seat #1 is the button
Seat 1: Roglus ($20.28 in chips) 
Seat 2: puffy5533 ($28.82 in chips) 
Seat 3: DutchShultzs ($25.69 in chips) 
Seat 4: Streikel ($17.62 in chips) 
Seat 5: Dan Royal ($25 in chips) 
Seat 6: kesstukas25 ($18.22 in chips) 
Seat 7: kamikkaze ($13.40 in chips) 
Seat 8: ll_LaMeR_ll ($101.42 in chips) 
Seat 9: chiyuki ($25.35 in chips) 
puffy5533: posts small blind $0.10
DutchShultzs: posts big blind $0.25
*** HOLE CARDS ***
Dealt to chiyuki [Ks Ac]
Streikel: folds 
Dan Royal: folds 
kesstukas25: folds 
kamikkaze: folds 
ll_LaMeR_ll: folds 
chiyuki: raises $0.50 to $0.75
Roglus: calls $0.75
puffy5533: folds 
DutchShultzs: folds 
*** FLOP *** [3c 3d Qc]
chiyuki: bets $1
Roglus: calls $1
*** TURN *** [3c 3d Qc] [Kc]
chiyuki: bets $3
Roglus: calls $3
*** RIVER *** [3c 3d Qc Kc] [2s]
chiyuki: bets $4.50
Roglus: folds 
Uncalled bet ($4.50) returned to chiyuki
chiyuki collected $9.41 from pot
chiyuki: doesn't show hand 
*** SUMMARY ***
Total pot $9.85 | Rake $0.44 
Board [3c 3d Qc Kc 2s]
Seat 1: Roglus (button) folded on the River
Seat 2: puffy5533 (small blind) folded before Flop
Seat 3: DutchShultzs (big blind) folded before Flop
Seat 4: Streikel folded before Flop (didn't bet)
Seat 5: Dan Royal folded before Flop (didn't bet)
Seat 6: kesstukas25 folded before Flop (didn't bet)
Seat 7: kamikkaze folded before Flop (didn't bet)
Seat 8: ll_LaMeR_ll folded before Flop (didn't bet)
Seat 9: chiyuki collected ($9.41)



PokerStars Zoom Hand #84300065677:  Hold'em No Limit ($0.10/$0.25) - 2012/08/05 15:03:25 JST [2012/08/05 2:03:25 ET]
Table 'Whirlpool' 9-max Seat #1 is the button
Seat 1: azizmimi ($28.99 in chips) 
Seat 2: Andrei 23rus ($24.25 in chips) 
Seat 3: seula i ($34.66 in chips) 
Seat 4: snejokCoxx ($13.55 in chips) 
Seat 5: risekuku468 ($40.01 in chips) 
Seat 6: troublesomm ($28.50 in chips) 
Seat 7: chiyuki ($30.01 in chips) 
Seat 8: 1Karina1 ($25 in chips) 
Seat 9: Nerkit ($12.50 in chips) 
Andrei 23rus: posts small blind $0.10
seula i: posts big blind $0.25
*** HOLE CARDS ***
Dealt to chiyuki [6c 3s]
snejokCoxx: folds 
risekuku468: folds 
troublesomm: folds 
chiyuki: folds 
1Karina1: folds 
Nerkit: folds 
azizmimi: raises $0.75 to $1
Andrei 23rus: folds 
seula i: folds 
Uncalled bet ($0.75) returned to azizmimi
azizmimi collected $0.60 from pot
azizmimi: doesn't show hand 
*** SUMMARY ***
Total pot $0.60 | Rake $0 
Seat 1: azizmimi (button) collected ($0.60)
Seat 2: Andrei 23rus (small blind) folded before Flop
Seat 3: seula i (big blind) folded before Flop
Seat 4: snejokCoxx folded before Flop (didn't bet)
Seat 5: risekuku468 folded before Flop (didn't bet)
Seat 6: troublesomm folded before Flop (didn't bet)
Seat 7: chiyuki folded before Flop (didn't bet)
Seat 8: 1Karina1 folded before Flop (didn't bet)
Seat 9: Nerkit folded before Flop (didn't bet)



PokerStars Zoom Hand #84300067879:  Hold'em No Limit ($0.10/$0.25) - 2012/08/05 15:03:34 JST [2012/08/05 2:03:34 ET]
Table 'Whirlpool' 9-max Seat #1 is the button
Seat 1: ygoegoe ($25 in chips) 
Seat 2: bigred1102 ($31.51 in chips) 
Seat 3: chiyuki ($30.01 in chips) 
Seat 4: troublesomm ($28.50 in chips) 
Seat 5: mjmichi ($25 in chips) 
Seat 6: kesstukas25 ($12.50 in chips) 
Seat 7: womble32 ($28.37 in chips) 
Seat 8: KimPa39 ($28.12 in chips) 
Seat 9: jacquelinewu ($25 in chips) 
bigred1102: posts small blind $0.10
chiyuki: posts big blind $0.25
*** HOLE CARDS ***
Dealt to chiyuki [2d 3h]
troublesomm: folds 
mjmichi: folds 
kesstukas25: folds 
womble32: folds 
KimPa39: folds 
jacquelinewu: folds 
ygoegoe: folds 
bigred1102: raises $0.25 to $0.50
chiyuki: folds 
Uncalled bet ($0.25) returned to bigred1102
bigred1102 collected $0.50 from pot
bigred1102: doesn't show hand 
*** SUMMARY ***
Total pot $0.50 | Rake $0 
Seat 1: ygoegoe (button) folded before Flop (didn't bet)
Seat 2: bigred1102 (small blind) collected ($0.50)
Seat 3: chiyuki (big blind) folded before Flop
Seat 4: troublesomm folded before Flop (didn't bet)
Seat 5: mjmichi folded before Flop (didn't bet)
Seat 6: kesstukas25 folded before Flop (didn't bet)
Seat 7: womble32 folded before Flop (didn't bet)
Seat 8: KimPa39 folded before Flop (didn't bet)
Seat 9: jacquelinewu folded before Flop (didn't bet)



PokerStars Zoom Hand #84300066697:  Hold'em No Limit ($0.10/$0.25) - 2012/08/05 15:03:29 JST [2012/08/05 2:03:29 ET]
Table 'Whirlpool' 9-max Seat #1 is the button
Seat 1: chiyuki ($30.01 in chips) 
Seat 2: ygoegoe ($25 in chips) 
Seat 3: INSP!RON ($25 in chips) 
Seat 4: el pore 5 ($14.88 in chips) 
Seat 5: Silveystryk ($29.47 in chips) 
Seat 6: KAKamiro ($20.81 in chips) 
Seat 7: Alvinpe85 ($48.08 in chips) 
Seat 8: 1Karina1 ($27.76 in chips) 
Seat 9: tribunpdm ($30.87 in chips) 
ygoegoe: posts small blind $0.10
INSP!RON: posts big blind $0.25
*** HOLE CARDS ***
Dealt to chiyuki [9h Td]
el pore 5: folds 
Silveystryk: folds 
KAKamiro: calls $0.25
Alvinpe85: folds 
1Karina1: folds 
tribunpdm: calls $0.25
chiyuki: folds 
ygoegoe: folds 
INSP!RON: checks 
*** FLOP *** [8s Jh 7s]
INSP!RON: checks 
KAKamiro: bets $0.75
tribunpdm: calls $0.75
INSP!RON: folds 
*** TURN *** [8s Jh 7s] [9c]
KAKamiro: bets $0.75
tribunpdm: calls $0.75
*** RIVER *** [8s Jh 7s 9c] [5d]
KAKamiro: bets $1.50
tribunpdm: folds 
Uncalled bet ($1.50) returned to KAKamiro
KAKamiro collected $3.68 from pot
KAKamiro: doesn't show hand 
*** SUMMARY ***
Total pot $3.85 | Rake $0.17 
Board [8s Jh 7s 9c 5d]
Seat 1: chiyuki (button) folded before Flop (didn't bet)
Seat 2: ygoegoe (small blind) folded before Flop
Seat 3: INSP!RON (big blind) folded on the Flop
Seat 4: el pore 5 folded before Flop (didn't bet)
Seat 5: Silveystryk folded before Flop (didn't bet)
Seat 6: KAKamiro collected ($3.68)
Seat 7: Alvinpe85 folded before Flop (didn't bet)
Seat 8: 1Karina1 folded before Flop (didn't bet)
Seat 9: tribunpdm folded on the River



PokerStars Zoom Hand #84300073590:  Hold'em No Limit ($0.10/$0.25) - 2012/08/05 15:03:56 JST [2012/08/05 2:03:56 ET]
Table 'Whirlpool' 9-max Seat #1 is the button
Seat 1: seula i ($106.86 in chips) 
Seat 2: chiyuki ($29.76 in chips) 
Seat 3: deadmoneykid ($26.90 in chips) 
Seat 4: kamikkaze ($14.87 in chips) 
Seat 5: snejokCoxx ($10.28 in chips) 
Seat 6: ZhukOFFskI ($40.81 in chips) 
Seat 7: INSP!RON ($25 in chips) 
Seat 8: yane73 ($75.44 in chips) 
Seat 9: deepakmbh ($31.42 in chips) 
chiyuki: posts small blind $0.10
deadmoneykid: posts big blind $0.25
*** HOLE CARDS ***
Dealt to chiyuki [Qc 7d]
kamikkaze: folds 
snejokCoxx: folds 
ZhukOFFskI: folds 
INSP!RON: raises $0.50 to $0.75
yane73: folds 
deepakmbh: calls $0.75
seula i: calls $0.75
chiyuki: folds 
deadmoneykid: folds 
*** FLOP *** [8c Ks Jc]
INSP!RON: checks 
deepakmbh: bets $2
seula i: folds 
INSP!RON: folds 
Uncalled bet ($2) returned to deepakmbh
deepakmbh collected $2.48 from pot
deepakmbh: doesn't show hand 
*** SUMMARY ***
Total pot $2.60 | Rake $0.12 
Board [8c Ks Jc]
Seat 1: seula i (button) folded on the Flop
Seat 2: chiyuki (small blind) folded before Flop
Seat 3: deadmoneykid (big blind) folded before Flop
Seat 4: kamikkaze folded before Flop (didn't bet)
Seat 5: snejokCoxx folded before Flop (didn't bet)
Seat 6: ZhukOFFskI folded before Flop (didn't bet)
Seat 7: INSP!RON folded on the Flop
Seat 8: yane73 folded before Flop (didn't bet)
Seat 9: deepakmbh collected ($2.48)



PokerStars Zoom Hand #84300083309:  Hold'em No Limit ($0.10/$0.25) - 2012/08/05 15:04:36 JST [2012/08/05 2:04:36 ET]
Table 'Whirlpool' 9-max Seat #1 is the button
Seat 1: mjmichi ($28.97 in chips) 
Seat 2: snejokCoxx ($13.30 in chips) 
Seat 3: DutchShultzs ($26.36 in chips) 
Seat 4: Nerkit ($11.75 in chips) 
Seat 5: starreset ($25.78 in chips) 
Seat 6: kamikkaze ($15.62 in chips) 
Seat 7: ZhukOFFskI ($48.09 in chips) 
Seat 8: deepakmbh ($33.15 in chips) 
Seat 9: chiyuki ($29.66 in chips) 
snejokCoxx: posts small blind $0.10
DutchShultzs: posts big blind $0.25
*** HOLE CARDS ***
Dealt to chiyuki [Qh 4c]
Nerkit: folds 
starreset: folds 
kamikkaze: folds 
ZhukOFFskI: folds 
deepakmbh: folds 
chiyuki: folds 
mjmichi: folds 
snejokCoxx: folds 
Uncalled bet ($0.15) returned to DutchShultzs
DutchShultzs collected $0.20 from pot
DutchShultzs: doesn't show hand 
*** SUMMARY ***
Total pot $0.20 | Rake $0 
Seat 1: mjmichi (button) folded before Flop (didn't bet)
Seat 2: snejokCoxx (small blind) folded before Flop
Seat 3: DutchShultzs (big blind) collected ($0.20)
Seat 4: Nerkit folded before Flop (didn't bet)
Seat 5: starreset folded before Flop (didn't bet)
Seat 6: kamikkaze folded before Flop (didn't bet)
Seat 7: ZhukOFFskI folded before Flop (didn't bet)
Seat 8: deepakmbh folded before Flop (didn't bet)
Seat 9: chiyuki folded before Flop (didn't bet)



PokerStars Zoom Hand #84300082057:  Hold'em No Limit ($0.10/$0.25) - 2012/08/05 15:04:31 JST [2012/08/05 2:04:31 ET]
Table 'Whirlpool' 9-max Seat #1 is the button
Seat 1: seula i ($25 in chips) 
Seat 2: deadmoneykid ($30.36 in chips) 
Seat 3: WARIBANA7777 ($15.53 in chips) 
Seat 4: troublesomm ($25 in chips) 
Seat 5: DutchShultzs ($26.36 in chips) 
Seat 6: PillZ86 ($22.25 in chips) 
Seat 7: NuMetal88 ($25 in chips) 
Seat 8: chiyuki ($29.66 in chips) 
Seat 9: moku36 ($17.53 in chips) 
deadmoneykid: posts small blind $0.10
WARIBANA7777: posts big blind $0.25
*** HOLE CARDS ***
Dealt to chiyuki [Ah 6d]
troublesomm: folds 
DutchShultzs: folds 
PillZ86: folds 
NuMetal88: folds 
chiyuki: folds 
moku36: folds 
seula i: folds 
deadmoneykid: folds 
Uncalled bet ($0.15) returned to WARIBANA7777
WARIBANA7777 collected $0.20 from pot
WARIBANA7777: doesn't show hand 
*** SUMMARY ***
Total pot $0.20 | Rake $0 
Seat 1: seula i (button) folded before Flop (didn't bet)
Seat 2: deadmoneykid (small blind) folded before Flop
Seat 3: WARIBANA7777 (big blind) collected ($0.20)
Seat 4: troublesomm folded before Flop (didn't bet)
Seat 5: DutchShultzs folded before Flop (didn't bet)
Seat 6: PillZ86 folded before Flop (didn't bet)
Seat 7: NuMetal88 folded before Flop (didn't bet)
Seat 8: chiyuki folded before Flop (didn't bet)
Seat 9: moku36 folded before Flop (didn't bet)



PokerStars Zoom Hand #84300080274:  Hold'em No Limit ($0.10/$0.25) - 2012/08/05 15:04:24 JST [2012/08/05 2:04:24 ET]
Table 'Whirlpool' 9-max Seat #1 is the button
Seat 1: el pore 5 ($16.46 in chips) 
Seat 2: troublesomm ($36.78 in chips) 
Seat 3: GovGus ($28.95 in chips) 
Seat 4: chiyuki ($29.66 in chips) 
Seat 5: Littlea029 ($29.96 in chips) 
Seat 6: Nerkit ($11.75 in chips) 
Seat 7: seula i ($37.44 in chips) 
Seat 8: kesstukas25 ($13.62 in chips) 
Seat 9: gunbowler ($194.41 in chips) 
troublesomm: posts small blind $0.10
GovGus: posts big blind $0.25
*** HOLE CARDS ***
Dealt to chiyuki [4d 2s]
chiyuki: folds 
Littlea029: folds 
Nerkit: folds 
seula i: folds 
kesstukas25: folds 
gunbowler: raises $0.50 to $0.75
el pore 5: folds 
troublesomm: folds 
GovGus: calls $0.50
*** FLOP *** [5d 6c Ts]
GovGus: checks 
gunbowler: bets $1
GovGus: folds 
Uncalled bet ($1) returned to gunbowler
gunbowler collected $1.53 from pot
gunbowler: doesn't show hand 
*** SUMMARY ***
Total pot $1.60 | Rake $0.07 
Board [5d 6c Ts]
Seat 1: el pore 5 (button) folded before Flop (didn't bet)
Seat 2: troublesomm (small blind) folded before Flop
Seat 3: GovGus (big blind) folded on the Flop
Seat 4: chiyuki folded before Flop (didn't bet)
Seat 5: Littlea029 folded before Flop (didn't bet)
Seat 6: Nerkit folded before Flop (didn't bet)
Seat 7: seula i folded before Flop (didn't bet)
Seat 8: kesstukas25 folded before Flop (didn't bet)
Seat 9: gunbowler collected ($1.53)



PokerStars Zoom Hand #84300081038:  Hold'em No Limit ($0.10/$0.25) - 2012/08/05 15:04:27 JST [2012/08/05 2:04:27 ET]
Table 'Whirlpool' 9-max Seat #1 is the button
Seat 1: Dejacob ($26.23 in chips) 
Seat 2: phate-1up ($25.53 in chips) 
Seat 3: jacquelinewu ($35.48 in chips) 
Seat 4: snejokCoxx ($10.18 in chips) 
Seat 5: chiyuki ($29.66 in chips) 
Seat 6: troublesomm ($25 in chips) 
Seat 7: KrystalAA ($33.49 in chips) 
Seat 8: moku36 ($17.53 in chips) 
Seat 9: Ellen1947 ($31.14 in chips) 
phate-1up: posts small blind $0.10
jacquelinewu: posts big blind $0.25
*** HOLE CARDS ***
Dealt to chiyuki [3h 4d]
snejokCoxx: raises $0.40 to $0.65
chiyuki: folds 
troublesomm: folds 
KrystalAA: folds 
moku36: folds 
Ellen1947: folds 
Dejacob: folds 
phate-1up: folds 
jacquelinewu: raises $1.10 to $1.75
snejokCoxx: folds 
Uncalled bet ($1.10) returned to jacquelinewu
jacquelinewu collected $1.40 from pot
jacquelinewu: doesn't show hand 
*** SUMMARY ***
Total pot $1.40 | Rake $0 
Seat 1: Dejacob (button) folded before Flop (didn't bet)
Seat 2: phate-1up (small blind) folded before Flop
Seat 3: jacquelinewu (big blind) collected ($1.40)
Seat 4: snejokCoxx folded before Flop
Seat 5: chiyuki folded before Flop (didn't bet)
Seat 6: troublesomm folded before Flop (didn't bet)
Seat 7: KrystalAA folded before Flop (didn't bet)
Seat 8: moku36 folded before Flop (didn't bet)
Seat 9: Ellen1947 folded before Flop (didn't bet)



PokerStars Zoom Hand #84300085387:  Hold'em No Limit ($0.10/$0.25) - 2012/08/05 15:04:44 JST [2012/08/05 2:04:44 ET]
Table 'Whirlpool' 9-max Seat #1 is the button
Seat 1: kamikkaze ($15.62 in chips) 
Seat 2: pandaaaaaa ($12.50 in chips) 
Seat 3: svg51 ($15 in chips) 
Seat 4: starreset ($25.78 in chips) 
Seat 5: womble32 ($28.37 in chips) 
Seat 6: chiyuki ($29.66 in chips) 
Seat 7: moku36 ($17.53 in chips) 
Seat 8: seula i ($25 in chips) 
Seat 9: Silveystryk ($23.90 in chips) 
pandaaaaaa: posts small blind $0.10
svg51: posts big blind $0.25
*** HOLE CARDS ***
Dealt to chiyuki [Ah 3d]
starreset: folds 
womble32: folds 
chiyuki: folds 
moku36: folds 
seula i: folds 
Silveystryk: folds 
kamikkaze: raises $0.38 to $0.63
pandaaaaaa: folds 
svg51: folds 
Uncalled bet ($0.38) returned to kamikkaze
kamikkaze collected $0.60 from pot
kamikkaze: doesn't show hand 
*** SUMMARY ***
Total pot $0.60 | Rake $0 
Seat 1: kamikkaze (button) collected ($0.60)
Seat 2: pandaaaaaa (small blind) folded before Flop
Seat 3: svg51 (big blind) folded before Flop
Seat 4: starreset folded before Flop (didn't bet)
Seat 5: womble32 folded before Flop (didn't bet)
Seat 6: chiyuki folded before Flop (didn't bet)
Seat 7: moku36 folded before Flop (didn't bet)
Seat 8: seula i folded before Flop (didn't bet)
Seat 9: Silveystryk folded before Flop (didn't bet)



PokerStars Zoom Hand #84300087749:  Hold'em No Limit ($0.10/$0.25) - 2012/08/05 15:04:53 JST [2012/08/05 2:04:53 ET]
Table 'Whirlpool' 9-max Seat #1 is the button
Seat 1: River_GmbH ($13.15 in chips) 
Seat 2: ZhukOFFskI ($29.58 in chips) 
Seat 3: Spheroff ($24.90 in chips) 
Seat 4: chiyuki ($29.66 in chips) 
Seat 5: GovGus ($26 in chips) 
Seat 6: moku36 ($17.53 in chips) 
Seat 7: DutchShultzs ($26.46 in chips) 
Seat 8: phate-1up ($25.46 in chips) 
Seat 9: WARIBANA7777 ($15.63 in chips) 
ZhukOFFskI: posts small blind $0.10
Spheroff: posts big blind $0.25
*** HOLE CARDS ***
Dealt to chiyuki [Qh 6c]
chiyuki: folds 
GovGus: folds 
moku36 has timed out
moku36: folds 
DutchShultzs: folds 
phate-1up: folds 
WARIBANA7777: folds 
River_GmbH: folds 
ZhukOFFskI: folds 
Uncalled bet ($0.15) returned to Spheroff
Spheroff collected $0.20 from pot
Spheroff: doesn't show hand 
*** SUMMARY ***
Total pot $0.20 | Rake $0 
Seat 1: River_GmbH (button) folded before Flop (didn't bet)
Seat 2: ZhukOFFskI (small blind) folded before Flop
Seat 3: Spheroff (big blind) collected ($0.20)
Seat 4: chiyuki folded before Flop (didn't bet)
Seat 5: GovGus folded before Flop (didn't bet)
Seat 6: moku36 folded before Flop (didn't bet)
Seat 7: DutchShultzs folded before Flop (didn't bet)
Seat 8: phate-1up folded before Flop (didn't bet)
Seat 9: WARIBANA7777 folded before Flop (didn't bet)



PokerStars Zoom Hand #84300084352:  Hold'em No Limit ($0.10/$0.25) - 2012/08/05 15:04:40 JST [2012/08/05 2:04:40 ET]
Table 'Whirlpool' 9-max Seat #1 is the button
Seat 1: NuMetal88 ($25 in chips) 
Seat 2: simonzez ($23.91 in chips) 
Seat 3: JhonnyP1979 ($7.28 in chips) 
Seat 4: MOReilly000 ($30.98 in chips) 
Seat 5: troublesomm ($28.40 in chips) 
Seat 6: Perstenev ($11.75 in chips) 
Seat 7: chiyuki ($29.66 in chips) 
Seat 8: Silveystryk ($23.90 in chips) 
Seat 9: kamikkaze ($15.62 in chips) 
simonzez: posts small blind $0.10
JhonnyP1979: posts big blind $0.25
*** HOLE CARDS ***
Dealt to chiyuki [3d 7d]
MOReilly000: calls $0.25
troublesomm: folds 
Perstenev: folds 
chiyuki: folds 
Silveystryk: folds 
kamikkaze: folds 
NuMetal88: folds 
simonzez: calls $0.15
JhonnyP1979: checks 
*** FLOP *** [As 6h 2h]
simonzez: checks 
JhonnyP1979: checks 
MOReilly000: bets $1
simonzez: folds 
JhonnyP1979: calls $1
*** TURN *** [As 6h 2h] [8c]
JhonnyP1979: checks 
MOReilly000: bets $1.75
JhonnyP1979: calls $1.75
*** RIVER *** [As 6h 2h 8c] [8d]
JhonnyP1979: checks 
MOReilly000: bets $13.50
JhonnyP1979: folds 
Uncalled bet ($13.50) returned to MOReilly000
MOReilly000 collected $5.97 from pot
MOReilly000: doesn't show hand 
*** SUMMARY ***
Total pot $6.25 | Rake $0.28 
Board [As 6h 2h 8c 8d]
Seat 1: NuMetal88 (button) folded before Flop (didn't bet)
Seat 2: simonzez (small blind) folded on the Flop
Seat 3: JhonnyP1979 (big blind) folded on the River
Seat 4: MOReilly000 collected ($5.97)
Seat 5: troublesomm folded before Flop (didn't bet)
Seat 6: Perstenev folded before Flop (didn't bet)
Seat 7: chiyuki folded before Flop (didn't bet)
Seat 8: Silveystryk folded before Flop (didn't bet)
Seat 9: kamikkaze folded before Flop (didn't bet)



PokerStars Zoom Hand #84300088820:  Hold'em No Limit ($0.10/$0.25) - 2012/08/05 15:04:57 JST [2012/08/05 2:04:57 ET]
Table 'Whirlpool' 9-max Seat #1 is the button
Seat 1: chiyuki ($29.66 in chips) 
Seat 2: ygoegoe ($25.66 in chips) 
Seat 3: womble32 ($28.37 in chips) 
Seat 4: seula i ($37.44 in chips) 
Seat 5: Streikel ($16.52 in chips) 
Seat 6: snejokCoxx ($11.98 in chips) 
Seat 7: Roglus ($13.57 in chips) 
Seat 8: jacquelinewu ($36.23 in chips) 
Seat 9: NuMetal88 ($25 in chips) 
ygoegoe: posts small blind $0.10
womble32: posts big blind $0.25
*** HOLE CARDS ***
Dealt to chiyuki [Th Jh]
seula i: folds 
Streikel: folds 
snejokCoxx: folds 
Roglus: folds 
jacquelinewu: folds 
NuMetal88: folds 
chiyuki: raises $0.50 to $0.75
ygoegoe: raises $1.75 to $2.50
womble32: folds 
chiyuki: folds 
Uncalled bet ($1.75) returned to ygoegoe
ygoegoe collected $1.75 from pot
ygoegoe: doesn't show hand 
*** SUMMARY ***
Total pot $1.75 | Rake $0 
Seat 1: chiyuki (button) folded before Flop
Seat 2: ygoegoe (small blind) collected ($1.75)
Seat 3: womble32 (big blind) folded before Flop
Seat 4: seula i folded before Flop (didn't bet)
Seat 5: Streikel folded before Flop (didn't bet)
Seat 6: snejokCoxx folded before Flop (didn't bet)
Seat 7: Roglus folded before Flop (didn't bet)
Seat 8: jacquelinewu folded before Flop (didn't bet)
Seat 9: NuMetal88 folded before Flop (didn't bet)



PokerStars Zoom Hand #84300102081:  Hold'em No Limit ($0.10/$0.25) - 2012/08/05 15:05:50 JST [2012/08/05 2:05:50 ET]
Table 'Whirlpool' 9-max Seat #1 is the button
Seat 1: turbotom122 ($19.63 in chips) 
Seat 2: chiyuki ($28.91 in chips) 
Seat 3: ygoegoe ($26.66 in chips) 
Seat 4: Dejacob ($25 in chips) 
Seat 5: DutchShultzs ($26.36 in chips) 
Seat 6: ZhukOFFskI ($47.84 in chips) 
Seat 7: Ellen1947 ($30.64 in chips) 
Seat 8: colorado2108 ($53.85 in chips) 
Seat 9: hirozo ($50.87 in chips) 
chiyuki: posts small blind $0.10
ygoegoe: posts big blind $0.25
*** HOLE CARDS ***
Dealt to chiyuki [5d 7d]
Dejacob: folds 
DutchShultzs: folds 
ZhukOFFskI: folds 
Ellen1947: folds 
colorado2108: folds 
hirozo: folds 
turbotom122: folds 
chiyuki: folds 
Uncalled bet ($0.15) returned to ygoegoe
ygoegoe collected $0.20 from pot
ygoegoe: doesn't show hand 
*** SUMMARY ***
Total pot $0.20 | Rake $0 
Seat 1: turbotom122 (button) folded before Flop (didn't bet)
Seat 2: chiyuki (small blind) folded before Flop
Seat 3: ygoegoe (big blind) collected ($0.20)
Seat 4: Dejacob folded before Flop (didn't bet)
Seat 5: DutchShultzs folded before Flop (didn't bet)
Seat 6: ZhukOFFskI folded before Flop (didn't bet)
Seat 7: Ellen1947 folded before Flop (didn't bet)
Seat 8: colorado2108 folded before Flop (didn't bet)
Seat 9: hirozo folded before Flop (didn't bet)



PokerStars Zoom Hand #84300104482:  Hold'em No Limit ($0.10/$0.25) - 2012/08/05 15:05:59 JST [2012/08/05 2:05:59 ET]
Table 'Whirlpool' 9-max Seat #1 is the button
Seat 1: Dejacob ($40.76 in chips) 
Seat 2: snejokCoxx ($9.28 in chips) 
Seat 3: MOReilly000 ($33.95 in chips) 
Seat 4: NuMetal88 ($34.47 in chips) 
Seat 5: Dan Royal ($23.52 in chips) 
Seat 6: deepakmbh ($61.66 in chips) 
Seat 7: deadmoneykid ($25.91 in chips) 
Seat 8: chiyuki ($28.81 in chips) 
Seat 9: Nerkit ($11.75 in chips) 
snejokCoxx: posts small blind $0.10
MOReilly000: posts big blind $0.25
*** HOLE CARDS ***
Dealt to chiyuki [2c 3s]
NuMetal88: folds 
Dan Royal: folds 
deepakmbh: raises $0.50 to $0.75
deadmoneykid: folds 
chiyuki: folds 
Nerkit: folds 
Dejacob: folds 
snejokCoxx: folds 
MOReilly000: folds 
Uncalled bet ($0.50) returned to deepakmbh
deepakmbh collected $0.60 from pot
deepakmbh: doesn't show hand 
*** SUMMARY ***
Total pot $0.60 | Rake $0 
Seat 1: Dejacob (button) folded before Flop (didn't bet)
Seat 2: snejokCoxx (small blind) folded before Flop
Seat 3: MOReilly000 (big blind) folded before Flop
Seat 4: NuMetal88 folded before Flop (didn't bet)
Seat 5: Dan Royal folded before Flop (didn't bet)
Seat 6: deepakmbh collected ($0.60)
Seat 7: deadmoneykid folded before Flop (didn't bet)
Seat 8: chiyuki folded before Flop (didn't bet)
Seat 9: Nerkit folded before Flop (didn't bet)



PokerStars Zoom Hand #84300105207:  Hold'em No Limit ($0.10/$0.25) - 2012/08/05 15:06:02 JST [2012/08/05 2:06:02 ET]
Table 'Whirlpool' 9-max Seat #1 is the button
Seat 1: Rilko1975 ($25.79 in chips) 
Seat 2: ZhukOFFskI ($47.84 in chips) 
Seat 3: chiyuki ($28.81 in chips) 
Seat 4: Dan Royal ($23.52 in chips) 
Seat 5: seula i ($106.79 in chips) 
Seat 6: moku36 ($17.18 in chips) 
Seat 7: Streikel ($6.01 in chips) 
Seat 8: Perstenev ($10.75 in chips) 
Seat 9: 4plankton ($21.80 in chips) 
ZhukOFFskI: posts small blind $0.10
chiyuki: posts big blind $0.25
*** HOLE CARDS ***
Dealt to chiyuki [9h 7h]
Dan Royal: folds 
seula i: folds 
moku36: folds 
Streikel: folds 
Perstenev: folds 
4plankton: calls $0.25
Rilko1975: folds 
ZhukOFFskI: calls $0.15
chiyuki: checks 
*** FLOP *** [8h 8c 2h]
ZhukOFFskI: checks 
chiyuki: checks 
4plankton: checks 
*** TURN *** [8h 8c 2h] [Jd]
ZhukOFFskI: bets $0.50
chiyuki: calls $0.50
4plankton: folds 
*** RIVER *** [8h 8c 2h Jd] [7c]
ZhukOFFskI: checks 
chiyuki: checks 
*** SHOW DOWN ***
ZhukOFFskI: shows [Kh Jh] (two pair, Jacks and Eights)
chiyuki: mucks hand 
ZhukOFFskI collected $1.67 from pot
*** SUMMARY ***
Total pot $1.75 | Rake $0.08 
Board [8h 8c 2h Jd 7c]
Seat 1: Rilko1975 (button) folded before Flop (didn't bet)
Seat 2: ZhukOFFskI (small blind) showed [Kh Jh] and won ($1.67) with two pair, Jacks and Eights
Seat 3: chiyuki (big blind) mucked [9h 7h]
Seat 4: Dan Royal folded before Flop (didn't bet)
Seat 5: seula i folded before Flop (didn't bet)
Seat 6: moku36 folded before Flop (didn't bet)
Seat 7: Streikel folded before Flop (didn't bet)
Seat 8: Perstenev folded before Flop (didn't bet)
Seat 9: 4plankton folded on the Turn



PokerStars Zoom Hand #84300117319:  Hold'em No Limit ($0.10/$0.25) - 2012/08/05 15:06:50 JST [2012/08/05 2:06:50 ET]
Table 'Whirlpool' 9-max Seat #1 is the button
Seat 1: NuMetal88 ($34.12 in chips) 
Seat 2: dushvan ($44.83 in chips) 
Seat 3: ZhukOFFskI ($48.76 in chips) 
Seat 4: Silveystryk ($22.30 in chips) 
Seat 5: hirozo ($50.97 in chips) 
Seat 6: KrystalAA ($33.14 in chips) 
Seat 7: seula i ($31.71 in chips) 
Seat 8: troublesomm ($27.88 in chips) 
Seat 9: chiyuki ($28.06 in chips) 
dushvan: posts small blind $0.10
ZhukOFFskI: posts big blind $0.25
*** HOLE CARDS ***
Dealt to chiyuki [5d 7s]
Silveystryk: folds 
hirozo: folds 
KrystalAA: folds 
seula i: folds 
troublesomm: folds 
chiyuki: folds 
NuMetal88: folds 
dushvan: raises $0.50 to $0.75
ZhukOFFskI: folds 
Uncalled bet ($0.50) returned to dushvan
dushvan collected $0.50 from pot
dushvan: doesn't show hand 
*** SUMMARY ***
Total pot $0.50 | Rake $0 
Seat 1: NuMetal88 (button) folded before Flop (didn't bet)
Seat 2: dushvan (small blind) collected ($0.50)
Seat 3: ZhukOFFskI (big blind) folded before Flop
Seat 4: Silveystryk folded before Flop (didn't bet)
Seat 5: hirozo folded before Flop (didn't bet)
Seat 6: KrystalAA folded before Flop (didn't bet)
Seat 7: seula i folded before Flop (didn't bet)
Seat 8: troublesomm folded before Flop (didn't bet)
Seat 9: chiyuki folded before Flop (didn't bet)



PokerStars Zoom Hand #84300120909:  Hold'em No Limit ($0.10/$0.25) - 2012/08/05 15:07:04 JST [2012/08/05 2:07:04 ET]
Table 'Whirlpool' 9-max Seat #1 is the button
Seat 1: Perstenev ($10.65 in chips) 
Seat 2: 1Karina1 ($27.95 in chips) 
Seat 3: masterkoolb ($12.50 in chips) 
Seat 4: turbotom122 ($19.63 in chips) 
Seat 5: chiyuki ($28.06 in chips) 
Seat 6: kamikkaze ($15.27 in chips) 
Seat 7: kesstukas25 ($12.60 in chips) 
Seat 8: KeLevro0 ($9.52 in chips) 
Seat 9: seula i ($25 in chips) 
1Karina1: posts small blind $0.10
masterkoolb: posts big blind $0.25
*** HOLE CARDS ***
Dealt to chiyuki [7c Th]
turbotom122: folds 
chiyuki: folds 
kamikkaze: folds 
kesstukas25: folds 
KeLevro0: folds 
seula i: folds 
Perstenev: folds 
1Karina1: folds 
Uncalled bet ($0.15) returned to masterkoolb
masterkoolb collected $0.20 from pot
masterkoolb: doesn't show hand 
*** SUMMARY ***
Total pot $0.20 | Rake $0 
Seat 1: Perstenev (button) folded before Flop (didn't bet)
Seat 2: 1Karina1 (small blind) folded before Flop
Seat 3: masterkoolb (big blind) collected ($0.20)
Seat 4: turbotom122 folded before Flop (didn't bet)
Seat 5: chiyuki folded before Flop (didn't bet)
Seat 6: kamikkaze folded before Flop (didn't bet)
Seat 7: kesstukas25 folded before Flop (didn't bet)
Seat 8: KeLevro0 folded before Flop (didn't bet)
Seat 9: seula i folded before Flop (didn't bet)



PokerStars Zoom Hand #84300118847:  Hold'em No Limit ($0.10/$0.25) - 2012/08/05 15:06:56 JST [2012/08/05 2:06:56 ET]
Table 'Whirlpool' 9-max Seat #1 is the button
Seat 1: seula i ($31.71 in chips) 
Seat 2: Robchie ($24.66 in chips) 
Seat 3: el pore 5 ($18.57 in chips) 
Seat 4: Silveystryk ($22.30 in chips) 
Seat 5: kamikkaze ($15.37 in chips) 
Seat 6: chiyuki ($28.06 in chips) 
Seat 7: DutchShultzs ($27.31 in chips) 
Seat 8: KeLevro0 ($14.62 in chips) 
Seat 9: wildy29 ($18.85 in chips) 
Robchie: posts small blind $0.10
el pore 5: posts big blind $0.25
*** HOLE CARDS ***
Dealt to chiyuki [8c 5s]
Silveystryk: folds 
kamikkaze: folds 
chiyuki: folds 
DutchShultzs: folds 
KeLevro0: folds 
wildy29: folds 
seula i: raises $0.50 to $0.75
Robchie: calls $0.65
el pore 5: folds 
*** FLOP *** [5c 5d 2s]
Robchie: bets $1
seula i: folds 
Uncalled bet ($1) returned to Robchie
Robchie collected $1.67 from pot
Robchie: doesn't show hand 
*** SUMMARY ***
Total pot $1.75 | Rake $0.08 
Board [5c 5d 2s]
Seat 1: seula i (button) folded on the Flop
Seat 2: Robchie (small blind) collected ($1.67)
Seat 3: el pore 5 (big blind) folded before Flop
Seat 4: Silveystryk folded before Flop (didn't bet)
Seat 5: kamikkaze folded before Flop (didn't bet)
Seat 6: chiyuki folded before Flop (didn't bet)
Seat 7: DutchShultzs folded before Flop (didn't bet)
Seat 8: KeLevro0 folded before Flop (didn't bet)
Seat 9: wildy29 folded before Flop (didn't bet)



PokerStars Zoom Hand #84300123221:  Hold'em No Limit ($0.10/$0.25) - 2012/08/05 15:07:13 JST [2012/08/05 2:07:13 ET]
Table 'Whirlpool' 9-max Seat #1 is the button
Seat 1: chiyuki ($28.06 in chips) 
Seat 2: DutchShultzs ($26.11 in chips) 
Seat 3: womble32 ($29.04 in chips) 
Seat 4: JhonnyP1979 ($5.69 in chips) 
Seat 5: pandaaaaaa ($12.50 in chips) 
Seat 6: rorfo23 ($15.76 in chips) 
Seat 7: River_GmbH ($17.12 in chips) 
Seat 8: INSP!RON ($27.46 in chips) 
Seat 9: troublesomm ($40.86 in chips) 
DutchShultzs: posts small blind $0.10
womble32: posts big blind $0.25
*** HOLE CARDS ***
Dealt to chiyuki [5d 7c]
JhonnyP1979: folds 
pandaaaaaa: folds 
rorfo23: folds 
River_GmbH: raises $0.50 to $0.75
INSP!RON: folds 
troublesomm: folds 
chiyuki: folds 
DutchShultzs: folds 
womble32: folds 
Uncalled bet ($0.50) returned to River_GmbH
River_GmbH collected $0.60 from pot
River_GmbH: doesn't show hand 
*** SUMMARY ***
Total pot $0.60 | Rake $0 
Seat 1: chiyuki (button) folded before Flop (didn't bet)
Seat 2: DutchShultzs (small blind) folded before Flop
Seat 3: womble32 (big blind) folded before Flop
Seat 4: JhonnyP1979 folded before Flop (didn't bet)
Seat 5: pandaaaaaa folded before Flop (didn't bet)
Seat 6: rorfo23 folded before Flop (didn't bet)
Seat 7: River_GmbH collected ($0.60)
Seat 8: INSP!RON folded before Flop (didn't bet)
Seat 9: troublesomm folded before Flop (didn't bet)



PokerStars Zoom Hand #84300124722:  Hold'em No Limit ($0.10/$0.25) - 2012/08/05 15:07:19 JST [2012/08/05 2:07:19 ET]
Table 'Whirlpool' 9-max Seat #1 is the button
Seat 1: Robchie ($25.58 in chips) 
Seat 2: snejokCoxx ($12.60 in chips) 
Seat 3: Nerkit ($12.15 in chips) 
Seat 4: chiyuki ($27.96 in chips) 
Seat 5: rorfo23 ($15.76 in chips) 
Seat 6: NuMetal88 ($34.12 in chips) 
Seat 7: Lasutchik ($75.93 in chips) 
Seat 8: masterkoolb ($12.50 in chips) 
Seat 9: el pore 5 ($18.32 in chips) 
snejokCoxx: posts small blind $0.10
Nerkit: posts big blind $0.25
*** HOLE CARDS ***
Dealt to chiyuki [5h Ks]
chiyuki: folds 
rorfo23: folds 
NuMetal88: folds 
Lasutchik: folds 
masterkoolb: folds 
el pore 5: folds 
Robchie: folds 
snejokCoxx: folds 
Uncalled bet ($0.15) returned to Nerkit
Nerkit collected $0.20 from pot
Nerkit: doesn't show hand 
*** SUMMARY ***
Total pot $0.20 | Rake $0 
Seat 1: Robchie (button) folded before Flop (didn't bet)
Seat 2: snejokCoxx (small blind) folded before Flop
Seat 3: Nerkit (big blind) collected ($0.20)
Seat 4: chiyuki folded before Flop (didn't bet)
Seat 5: rorfo23 folded before Flop (didn't bet)
Seat 6: NuMetal88 folded before Flop (didn't bet)
Seat 7: Lasutchik folded before Flop (didn't bet)
Seat 8: masterkoolb folded before Flop (didn't bet)
Seat 9: el pore 5 folded before Flop (didn't bet)



PokerStars Zoom Hand #84300119907:  Hold'em No Limit ($0.10/$0.25) - 2012/08/05 15:07:00 JST [2012/08/05 2:07:00 ET]
Table 'Whirlpool' 9-max Seat #1 is the button
Seat 1: hirozo ($72.13 in chips) 
Seat 2: wildy29 ($18.85 in chips) 
Seat 3: snejokCoxx ($13.82 in chips) 
Seat 4: Perstenev ($10.65 in chips) 
Seat 5: jeades ($13.15 in chips) 
Seat 6: troublesomm ($28.05 in chips) 
Seat 7: chiyuki ($28.06 in chips) 
Seat 8: drunk_bender ($25.88 in chips) 
Seat 9: GovGus ($25 in chips) 
wildy29: posts small blind $0.10
snejokCoxx: posts big blind $0.25
*** HOLE CARDS ***
Dealt to chiyuki [Kd 4d]
Perstenev: folds 
jeades: folds 
troublesomm: folds 
chiyuki: folds 
drunk_bender: folds 
GovGus: raises $0.75 to $1
hirozo: folds 
wildy29: folds 
snejokCoxx: folds 
Uncalled bet ($0.75) returned to GovGus
GovGus collected $0.60 from pot
GovGus: doesn't show hand 
*** SUMMARY ***
Total pot $0.60 | Rake $0 
Seat 1: hirozo (button) folded before Flop (didn't bet)
Seat 2: wildy29 (small blind) folded before Flop
Seat 3: snejokCoxx (big blind) folded before Flop
Seat 4: Perstenev folded before Flop (didn't bet)
Seat 5: jeades folded before Flop (didn't bet)
Seat 6: troublesomm folded before Flop (didn't bet)
Seat 7: chiyuki folded before Flop (didn't bet)
Seat 8: drunk_bender folded before Flop (didn't bet)
Seat 9: GovGus collected ($0.60)



PokerStars Zoom Hand #84300125782:  Hold'em No Limit ($0.10/$0.25) - 2012/08/05 15:07:23 JST [2012/08/05 2:07:23 ET]
Table 'Whirlpool' 9-max Seat #1 is the button
Seat 1: Dejacob ($25 in chips) 
Seat 2: svg51 ($16.62 in chips) 
Seat 3: chiyuki ($27.96 in chips) 
Seat 4: KrystalAA ($33.49 in chips) 
Seat 5: Vahe50 ($13.94 in chips) 
Seat 6: DutchShultzs ($33.19 in chips) 
Seat 7: phate-1up ($48.71 in chips) 
Seat 8: hirozo ($50.97 in chips) 
Seat 9: Robchie ($25.58 in chips) 
svg51: posts small blind $0.10
chiyuki: posts big blind $0.25
*** HOLE CARDS ***
Dealt to chiyuki [Td 2s]
KrystalAA: folds 
Vahe50: folds 
DutchShultzs: folds 
phate-1up: folds 
hirozo: folds 
Robchie: folds 
Dejacob: folds 
svg51: folds 
Uncalled bet ($0.15) returned to chiyuki
chiyuki collected $0.20 from pot
chiyuki: doesn't show hand 
*** SUMMARY ***
Total pot $0.20 | Rake $0 
Seat 1: Dejacob (button) folded before Flop (didn't bet)
Seat 2: svg51 (small blind) folded before Flop
Seat 3: chiyuki (big blind) collected ($0.20)
Seat 4: KrystalAA folded before Flop (didn't bet)
Seat 5: Vahe50 folded before Flop (didn't bet)
Seat 6: DutchShultzs folded before Flop (didn't bet)
Seat 7: phate-1up folded before Flop (didn't bet)
Seat 8: hirozo folded before Flop (didn't bet)
Seat 9: Robchie folded before Flop (didn't bet)



PokerStars Zoom Hand #84300136215:  Hold'em No Limit ($0.10/$0.25) - 2012/08/05 15:08:05 JST [2012/08/05 2:08:05 ET]
Table 'Whirlpool' 9-max Seat #1 is the button
Seat 1: MOReilly000 ($34.70 in chips) 
Seat 2: Perstenev ($10.40 in chips) 
Seat 3: mid22 ($17.18 in chips) 
Seat 4: phate-1up ($48.61 in chips) 
Seat 5: Nerkit ($9.05 in chips) 
Seat 6: troublesomm ($28.23 in chips) 
Seat 7: JhonnyP1979 ($3.09 in chips) 
Seat 8: seula i ($42.42 in chips) 
Seat 9: chiyuki ($28.06 in chips) 
Perstenev: posts small blind $0.10
mid22: posts big blind $0.25
*** HOLE CARDS ***
Dealt to chiyuki [Qh 8c]
phate-1up: folds 
Nerkit: folds 
troublesomm: folds 
JhonnyP1979: raises $0.50 to $0.75
seula i: folds 
chiyuki: folds 
MOReilly000: folds 
Perstenev: folds 
mid22: folds 
Uncalled bet ($0.50) returned to JhonnyP1979
JhonnyP1979 collected $0.60 from pot
JhonnyP1979: doesn't show hand 
*** SUMMARY ***
Total pot $0.60 | Rake $0 
Seat 1: MOReilly000 (button) folded before Flop (didn't bet)
Seat 2: Perstenev (small blind) folded before Flop
Seat 3: mid22 (big blind) folded before Flop
Seat 4: phate-1up folded before Flop (didn't bet)
Seat 5: Nerkit folded before Flop (didn't bet)
Seat 6: troublesomm folded before Flop (didn't bet)
Seat 7: JhonnyP1979 collected ($0.60)
Seat 8: seula i folded before Flop (didn't bet)
Seat 9: chiyuki folded before Flop (didn't bet)



PokerStars Zoom Hand #84300133978:  Hold'em No Limit ($0.10/$0.25) - 2012/08/05 15:07:56 JST [2012/08/05 2:07:56 ET]
Table 'Whirlpool' 9-max Seat #1 is the button
Seat 1: snejokCoxx ($13.55 in chips) 
Seat 2: phate-1up ($53.56 in chips) 
Seat 3: Dejacob ($39.91 in chips) 
Seat 4: kesstukas25 ($12.50 in chips) 
Seat 5: GovGus ($29.45 in chips) 
Seat 6: womble32 ($28.69 in chips) 
Seat 7: DutchShultzs ($27.31 in chips) 
Seat 8: chiyuki ($28.06 in chips) 
Seat 9: Faantomace ($10.32 in chips) 
phate-1up: posts small blind $0.10
Dejacob: posts big blind $0.25
*** HOLE CARDS ***
Dealt to chiyuki [3h 6d]
kesstukas25: folds 
GovGus: folds 
womble32: folds 
DutchShultzs: folds 
chiyuki: folds 
Faantomace: raises $10.07 to $10.32 and is all-in
snejokCoxx: folds 
phate-1up: folds 
Dejacob: folds 
Uncalled bet ($10.07) returned to Faantomace
Faantomace collected $0.60 from pot
Faantomace: doesn't show hand 
*** SUMMARY ***
Total pot $0.60 | Rake $0 
Seat 1: snejokCoxx (button) folded before Flop (didn't bet)
Seat 2: phate-1up (small blind) folded before Flop
Seat 3: Dejacob (big blind) folded before Flop
Seat 4: kesstukas25 folded before Flop (didn't bet)
Seat 5: GovGus folded before Flop (didn't bet)
Seat 6: womble32 folded before Flop (didn't bet)
Seat 7: DutchShultzs folded before Flop (didn't bet)
Seat 8: chiyuki folded before Flop (didn't bet)
Seat 9: Faantomace collected ($0.60)



PokerStars Zoom Hand #84300123984:  Hold'em No Limit ($0.10/$0.25) - 2012/08/05 15:07:16 JST [2012/08/05 2:07:16 ET]
Table 'Whirlpool' 9-max Seat #1 is the button
Seat 1: phate-1up ($25.25 in chips) 
Seat 2: chiyuki ($28.06 in chips) 
Seat 3: ChrisCDee ($45.40 in chips) 
Seat 4: risekuku468 ($39.47 in chips) 
Seat 5: DanielWhyte ($56.49 in chips) 
Seat 6: seula i ($25 in chips) 
Seat 7: Silveystryk ($27.94 in chips) 
Seat 8: hobby56 ($13.31 in chips) 
Seat 9: luyifei ($10.48 in chips) 
chiyuki: posts small blind $0.10
ChrisCDee: posts big blind $0.25
*** HOLE CARDS ***
Dealt to chiyuki [7c 5s]
risekuku468: folds 
DanielWhyte: folds 
seula i: folds 
Silveystryk: folds 
hobby56: raises $0.45 to $0.70
luyifei: calls $0.70
phate-1up: folds 
chiyuki: folds 
ChrisCDee: calls $0.45
*** FLOP *** [5c 9h Kh]
ChrisCDee: checks 
hobby56: bets $1.30
luyifei: raises $2.45 to $3.75
ChrisCDee: folds 
hobby56: calls $2.45
*** TURN *** [5c 9h Kh] [7s]
hobby56: checks 
luyifei: bets $6.03 and is all-in
hobby56: calls $6.03
*** RIVER *** [5c 9h Kh 7s] [Js]
*** SHOW DOWN ***
hobby56: shows [Kd Ac] (a pair of Kings)
luyifei: shows [9c 9s] (three of a kind, Nines)
luyifei collected $20.78 from pot
*** SUMMARY ***
Total pot $21.76 | Rake $0.98 
Board [5c 9h Kh 7s Js]
Seat 1: phate-1up (button) folded before Flop (didn't bet)
Seat 2: chiyuki (small blind) folded before Flop
Seat 3: ChrisCDee (big blind) folded on the Flop
Seat 4: risekuku468 folded before Flop (didn't bet)
Seat 5: DanielWhyte folded before Flop (didn't bet)
Seat 6: seula i folded before Flop (didn't bet)
Seat 7: Silveystryk folded before Flop (didn't bet)
Seat 8: hobby56 showed [Kd Ac] and lost with a pair of Kings
Seat 9: luyifei showed [9c 9s] and won ($20.78) with three of a kind, Nines



PokerStars Zoom Hand #84300136988:  Hold'em No Limit ($0.10/$0.25) - 2012/08/05 15:08:08 JST [2012/08/05 2:08:08 ET]
Table 'Whirlpool' 9-max Seat #1 is the button
Seat 1: chiyuki ($28.06 in chips) 
Seat 2: Silveystryk ($27.69 in chips) 
Seat 3: 1Karina1 ($25 in chips) 
Seat 4: DutchShultzs ($35.53 in chips) 
Seat 5: womble32 ($28.69 in chips) 
Seat 6: hirozo ($72.03 in chips) 
Seat 7: tribunpdm ($30.32 in chips) 
Seat 8: jacquelinewu ($25 in chips) 
Seat 9: mjmichi ($27.78 in chips) 
Silveystryk: posts small blind $0.10
1Karina1: posts big blind $0.25
*** HOLE CARDS ***
Dealt to chiyuki [8h 9h]
DutchShultzs: folds 
womble32: folds 
hirozo: folds 
tribunpdm: raises $0.50 to $0.75
jacquelinewu: folds 
mjmichi: folds 
chiyuki: folds 
Silveystryk: folds 
1Karina1: calls $0.50
*** FLOP *** [Qh 5c Jh]
1Karina1: checks 
tribunpdm: bets $1.25
1Karina1: folds 
Uncalled bet ($1.25) returned to tribunpdm
tribunpdm collected $1.53 from pot
tribunpdm: doesn't show hand 
*** SUMMARY ***
Total pot $1.60 | Rake $0.07 
Board [Qh 5c Jh]
Seat 1: chiyuki (button) folded before Flop (didn't bet)
Seat 2: Silveystryk (small blind) folded before Flop
Seat 3: 1Karina1 (big blind) folded on the Flop
Seat 4: DutchShultzs folded before Flop (didn't bet)
Seat 5: womble32 folded before Flop (didn't bet)
Seat 6: hirozo folded before Flop (didn't bet)
Seat 7: tribunpdm collected ($1.53)
Seat 8: jacquelinewu folded before Flop (didn't bet)
Seat 9: mjmichi folded before Flop (didn't bet)



PokerStars Zoom Hand #84300140549:  Hold'em No Limit ($0.10/$0.25) - 2012/08/05 15:08:22 JST [2012/08/05 2:08:22 ET]
Table 'Whirlpool' 9-max Seat #1 is the button
Seat 1: Dejacob ($39.66 in chips) 
Seat 2: KrystalAA ($32.88 in chips) 
Seat 3: Yoshimac ($13.18 in chips) 
Seat 4: DanielWhyte ($56.94 in chips) 
Seat 5: chiyuki ($28.06 in chips) 
Seat 6: ygoegoe ($27.40 in chips) 
Seat 7: Silveystryk ($21.95 in chips) 
Seat 8: MOReilly000 ($34.70 in chips) 
Seat 9: deepakmbh ($40.10 in chips) 
KrystalAA: posts small blind $0.10
Yoshimac: posts big blind $0.25
*** HOLE CARDS ***
Dealt to chiyuki [Ah 6d]
DanielWhyte: folds 
chiyuki: folds 
ygoegoe: folds 
Silveystryk: folds 
MOReilly000: raises $0.75 to $1
deepakmbh: folds 
Dejacob: folds 
KrystalAA: folds 
Yoshimac: raises $2.75 to $3.75
MOReilly000: folds 
Uncalled bet ($2.75) returned to Yoshimac
Yoshimac collected $2.10 from pot
Yoshimac: doesn't show hand 
*** SUMMARY ***
Total pot $2.10 | Rake $0 
Seat 1: Dejacob (button) folded before Flop (didn't bet)
Seat 2: KrystalAA (small blind) folded before Flop
Seat 3: Yoshimac (big blind) collected ($2.10)
Seat 4: DanielWhyte folded before Flop (didn't bet)
Seat 5: chiyuki folded before Flop (didn't bet)
Seat 6: ygoegoe folded before Flop (didn't bet)
Seat 7: Silveystryk folded before Flop (didn't bet)
Seat 8: MOReilly000 folded before Flop
Seat 9: deepakmbh folded before Flop (didn't bet)



PokerStars Zoom Hand #84300132134:  Hold'em No Limit ($0.10/$0.25) - 2012/08/05 15:07:49 JST [2012/08/05 2:07:49 ET]
Table 'Whirlpool' 9-max Seat #1 is the button
Seat 1: snejokCoxx ($13.47 in chips) 
Seat 2: DutchShultzs ($32.94 in chips) 
Seat 3: Dan Royal ($16.62 in chips) 
Seat 4: Silveystryk ($27.69 in chips) 
Seat 5: Dejacob ($39.91 in chips) 
Seat 6: chiyuki ($28.06 in chips) 
Seat 7: Jene4kaBest ($7.19 in chips) 
Seat 8: ZhukOFFskI ($29.58 in chips) 
Seat 9: Andrei 23rus ($19.55 in chips) 
DutchShultzs: posts small blind $0.10
Dan Royal: posts big blind $0.25
*** HOLE CARDS ***
Dealt to chiyuki [6c 2d]
Silveystryk: folds 
Dejacob: folds 
chiyuki: folds 
Jene4kaBest: folds 
ZhukOFFskI: folds 
Andrei 23rus: folds 
snejokCoxx: raises $0.40 to $0.65
DutchShultzs: folds 
Dan Royal: calls $0.40
*** FLOP *** [9d 5s Jc]
Dan Royal: checks 
snejokCoxx: bets $0.72
Dan Royal: raises $0.72 to $1.44
snejokCoxx: calls $0.72
*** TURN *** [9d 5s Jc] [Ah]
Dan Royal: checks 
snejokCoxx: checks 
*** RIVER *** [9d 5s Jc Ah] [5d]
Dan Royal: checks 
snejokCoxx: checks 
*** SHOW DOWN ***
Dan Royal: shows [8h Ks] (a pair of Fives)
snejokCoxx: mucks hand 
Dan Royal collected $4.09 from pot
*** SUMMARY ***
Total pot $4.28 | Rake $0.19 
Board [9d 5s Jc Ah 5d]
Seat 1: snejokCoxx (button) mucked [Qd Th]
Seat 2: DutchShultzs (small blind) folded before Flop
Seat 3: Dan Royal (big blind) showed [8h Ks] and won ($4.09) with a pair of Fives
Seat 4: Silveystryk folded before Flop (didn't bet)
Seat 5: Dejacob folded before Flop (didn't bet)
Seat 6: chiyuki folded before Flop (didn't bet)
Seat 7: Jene4kaBest folded before Flop (didn't bet)
Seat 8: ZhukOFFskI folded before Flop (didn't bet)
Seat 9: Andrei 23rus folded before Flop (didn't bet)



PokerStars Zoom Hand #84300142825:  Hold'em No Limit ($0.10/$0.25) - 2012/08/05 15:08:31 JST [2012/08/05 2:08:31 ET]
Table 'Whirlpool' 9-max Seat #1 is the button
Seat 1: snejokCoxx ($13.55 in chips) 
Seat 2: Tom1999 ($19.19 in chips) 
Seat 3: hirozo ($72.03 in chips) 
Seat 4: Perstenev ($10.30 in chips) 
Seat 5: chiyuki ($28.06 in chips) 
Seat 6: JhonnyP1979 ($3.44 in chips) 
Seat 7: ZhukOFFskI ($36.71 in chips) 
Seat 8: troublesomm ($26.07 in chips) 
Seat 9: Dejacob ($25 in chips) 
Tom1999: posts small blind $0.10
hirozo: posts big blind $0.25
*** HOLE CARDS ***
Dealt to chiyuki [6h 3d]
Perstenev: folds 
chiyuki: folds 
JhonnyP1979: folds 
ZhukOFFskI: raises $0.50 to $0.75
troublesomm: folds 
Dejacob: calls $0.75
snejokCoxx: folds 
Tom1999: folds 
hirozo: folds 
*** FLOP *** [5h Ks 9c]
ZhukOFFskI: bets $1.06
Dejacob: folds 
Uncalled bet ($1.06) returned to ZhukOFFskI
ZhukOFFskI collected $1.77 from pot
ZhukOFFskI: doesn't show hand 
*** SUMMARY ***
Total pot $1.85 | Rake $0.08 
Board [5h Ks 9c]
Seat 1: snejokCoxx (button) folded before Flop (didn't bet)
Seat 2: Tom1999 (small blind) folded before Flop
Seat 3: hirozo (big blind) folded before Flop
Seat 4: Perstenev folded before Flop (didn't bet)
Seat 5: chiyuki folded before Flop (didn't bet)
Seat 6: JhonnyP1979 folded before Flop (didn't bet)
Seat 7: ZhukOFFskI collected ($1.77)
Seat 8: troublesomm folded before Flop (didn't bet)
Seat 9: Dejacob folded on the Flop



PokerStars Zoom Hand #84300145427:  Hold'em No Limit ($0.10/$0.25) - 2012/08/05 15:08:41 JST [2012/08/05 2:08:41 ET]
Table 'Whirlpool' 9-max Seat #1 is the button
Seat 1: DanielWhyte ($56.84 in chips) 
Seat 2: Littlea029 ($32.30 in chips) 
Seat 3: Streikel ($9.21 in chips) 
Seat 4: kesstukas25 ($12.50 in chips) 
Seat 5: INSP!RON ($25 in chips) 
Seat 6: snejokCoxx ($12.60 in chips) 
Seat 7: chiyuki ($27.96 in chips) 
Seat 8: troublesomm ($40.51 in chips) 
Seat 9: Saruotiss ($21.68 in chips) 
Littlea029: posts small blind $0.10
Streikel: posts big blind $0.25
*** HOLE CARDS ***
Dealt to chiyuki [2s Qd]
kesstukas25: folds 
INSP!RON: folds 
snejokCoxx: folds 
chiyuki: folds 
troublesomm: folds 
Saruotiss: folds 
DanielWhyte: folds 
Littlea029: calls $0.15
Streikel: raises $0.75 to $1
Littlea029: calls $0.75
*** FLOP *** [Jh Qs 9c]
Littlea029: checks 
Streikel: bets $1.25
Littlea029: folds 
Uncalled bet ($1.25) returned to Streikel
Streikel collected $1.91 from pot
Streikel: doesn't show hand 
*** SUMMARY ***
Total pot $2 | Rake $0.09 
Board [Jh Qs 9c]
Seat 1: DanielWhyte (button) folded before Flop (didn't bet)
Seat 2: Littlea029 (small blind) folded on the Flop
Seat 3: Streikel (big blind) collected ($1.91)
Seat 4: kesstukas25 folded before Flop (didn't bet)
Seat 5: INSP!RON folded before Flop (didn't bet)
Seat 6: snejokCoxx folded before Flop (didn't bet)
Seat 7: chiyuki folded before Flop (didn't bet)
Seat 8: troublesomm folded before Flop (didn't bet)
Seat 9: Saruotiss folded before Flop (didn't bet)



PokerStars Zoom Hand #84300132969:  Hold'em No Limit ($0.10/$0.25) - 2012/08/05 15:07:52 JST [2012/08/05 2:07:52 ET]
Table 'Whirlpool' 9-max Seat #1 is the button
Seat 1: KrystalAA ($35.26 in chips) 
Seat 2: jeades ($12.90 in chips) 
Seat 3: ChrisCDee ($63.85 in chips) 
Seat 4: kaplya2010 ($26.15 in chips) 
Seat 5: seula i ($42.42 in chips) 
Seat 6: MOReilly000 ($34.95 in chips) 
Seat 7: chiyuki ($28.06 in chips) 
Seat 8: deadmoneykid ($25.56 in chips) 
Seat 9: phate-1up ($48.61 in chips) 
jeades: posts small blind $0.10
ChrisCDee: posts big blind $0.25
*** HOLE CARDS ***
Dealt to chiyuki [2c 9d]
kaplya2010: calls $0.25
seula i: folds 
MOReilly000: folds 
chiyuki: folds 
deadmoneykid: calls $0.25
phate-1up: folds 
KrystalAA: calls $0.25
jeades: raises $1.25 to $1.50
ChrisCDee: folds 
kaplya2010: calls $1.25
deadmoneykid: folds 
KrystalAA: calls $1.25
*** FLOP *** [9h 5d 2d]
jeades: bets $2.39
kaplya2010: folds 
KrystalAA: calls $2.39
*** TURN *** [9h 5d 2d] [5h]
jeades: bets $4.67
KrystalAA: folds 
Uncalled bet ($4.67) returned to jeades
jeades collected $9.34 from pot
jeades: doesn't show hand 
*** SUMMARY ***
Total pot $9.78 | Rake $0.44 
Board [9h 5d 2d 5h]
Seat 1: KrystalAA (button) folded on the Turn
Seat 2: jeades (small blind) collected ($9.34)
Seat 3: ChrisCDee (big blind) folded before Flop
Seat 4: kaplya2010 folded on the Flop
Seat 5: seula i folded before Flop (didn't bet)
Seat 6: MOReilly000 folded before Flop (didn't bet)
Seat 7: chiyuki folded before Flop (didn't bet)
Seat 8: deadmoneykid folded before Flop
Seat 9: phate-1up folded before Flop (didn't bet)



PokerStars Zoom Hand #84300144121:  Hold'em No Limit ($0.10/$0.25) - 2012/08/05 15:08:36 JST [2012/08/05 2:08:36 ET]
Table 'Whirlpool' 9-max Seat #1 is the button
Seat 1: kamikkaze ($14.92 in chips) 
Seat 2: chiyuki ($28.06 in chips) 
Seat 3: DutchShultzs ($32.84 in chips) 
Seat 4: troublesomm ($26.07 in chips) 
Seat 5: jacquelinewu ($25 in chips) 
Seat 6: deadmoneykid ($30.32 in chips) 
Seat 7: kesstukas25 ($12.50 in chips) 
Seat 8: phate-1up ($53.46 in chips) 
Seat 9: Alvinpe85 ($45.06 in chips) 
chiyuki: posts small blind $0.10
DutchShultzs: posts big blind $0.25
*** HOLE CARDS ***
Dealt to chiyuki [9c Jc]
troublesomm: folds 
jacquelinewu: raises $0.50 to $0.75
deadmoneykid: folds 
kesstukas25: folds 
phate-1up: folds 
Alvinpe85: calls $0.75
kamikkaze: folds 
chiyuki: folds 
DutchShultzs: folds 
*** FLOP *** [As 5s Ks]
jacquelinewu: checks 
Alvinpe85: checks 
*** TURN *** [As 5s Ks] [4d]
jacquelinewu: checks 
Alvinpe85: checks 
*** RIVER *** [As 5s Ks 4d] [5h]
jacquelinewu: checks 
Alvinpe85: checks 
*** SHOW DOWN ***
jacquelinewu: shows [Jd Jh] (two pair, Jacks and Fives)
Alvinpe85: mucks hand 
jacquelinewu collected $1.77 from pot
*** SUMMARY ***
Total pot $1.85 | Rake $0.08 
Board [As 5s Ks 4d 5h]
Seat 1: kamikkaze (button) folded before Flop (didn't bet)
Seat 2: chiyuki (small blind) folded before Flop
Seat 3: DutchShultzs (big blind) folded before Flop
Seat 4: troublesomm folded before Flop (didn't bet)
Seat 5: jacquelinewu showed [Jd Jh] and won ($1.77) with two pair, Jacks and Fives
Seat 6: deadmoneykid folded before Flop (didn't bet)
Seat 7: kesstukas25 folded before Flop (didn't bet)
Seat 8: phate-1up folded before Flop (didn't bet)
Seat 9: Alvinpe85 mucked [8s 8c]



PokerStars Zoom Hand #84300147268:  Hold'em No Limit ($0.10/$0.25) - 2012/08/05 15:08:48 JST [2012/08/05 2:08:48 ET]
Table 'Whirlpool' 9-max Seat #1 is the button
Seat 1: Vahe50 ($14.51 in chips) 
Seat 2: kesstukas25 ($12.50 in chips) 
Seat 3: chiyuki ($27.96 in chips) 
Seat 4: Silveystryk ($27.59 in chips) 
Seat 5: 1Karina1 ($30.04 in chips) 
Seat 6: phate-1up ($53.46 in chips) 
Seat 7: NuMetal88 ($33.77 in chips) 
Seat 8: dushvan ($45.08 in chips) 
Seat 9: troublesomm ($27.88 in chips) 
kesstukas25: posts small blind $0.10
chiyuki: posts big blind $0.25
*** HOLE CARDS ***
Dealt to chiyuki [Qh Th]
Silveystryk: calls $0.25
1Karina1: folds 
phate-1up: folds 
NuMetal88: folds 
dushvan: folds 
troublesomm: folds 
Vahe50: folds 
kesstukas25: folds 
chiyuki: checks 
*** FLOP *** [Ks Qd 6d]
chiyuki: checks 
Silveystryk: bets $0.25
chiyuki: calls $0.25
*** TURN *** [Ks Qd 6d] [8d]
chiyuki: checks 
Silveystryk: checks 
*** RIVER *** [Ks Qd 6d 8d] [6c]
chiyuki: bets $0.75
Silveystryk: folds 
Uncalled bet ($0.75) returned to chiyuki
chiyuki collected $1.05 from pot
chiyuki: doesn't show hand 
*** SUMMARY ***
Total pot $1.10 | Rake $0.05 
Board [Ks Qd 6d 8d 6c]
Seat 1: Vahe50 (button) folded before Flop (didn't bet)
Seat 2: kesstukas25 (small blind) folded before Flop
Seat 3: chiyuki (big blind) collected ($1.05)
Seat 4: Silveystryk folded on the River
Seat 5: 1Karina1 folded before Flop (didn't bet)
Seat 6: phate-1up folded before Flop (didn't bet)
Seat 7: NuMetal88 folded before Flop (didn't bet)
Seat 8: dushvan folded before Flop (didn't bet)
Seat 9: troublesomm folded before Flop (didn't bet)



PokerStars Zoom Hand #84300158336:  Hold'em No Limit ($0.10/$0.25) - 2012/08/05 15:09:32 JST [2012/08/05 2:09:32 ET]
Table 'Whirlpool' 9-max Seat #1 is the button
Seat 1: dushvan ($44.83 in chips) 
Seat 2: 1Karina1 ($25 in chips) 
Seat 3: Silveystryk ($23.43 in chips) 
Seat 4: Perstenev ($16.02 in chips) 
Seat 5: deepakmbh ($41.85 in chips) 
Seat 6: chiyuki ($28.51 in chips) 
Seat 7: Nagibator441 ($10.04 in chips) 
Seat 8: DutchShultzs ($32.49 in chips) 
Seat 9: deadmoneykid ($24.88 in chips) 
1Karina1: posts small blind $0.10
Silveystryk: posts big blind $0.25
*** HOLE CARDS ***
Dealt to chiyuki [Td 2d]
Perstenev: folds 
deepakmbh: folds 
chiyuki: folds 
Nagibator441: raises $0.50 to $0.75
DutchShultzs: folds 
deadmoneykid: folds 
dushvan: folds 
1Karina1: folds 
Silveystryk: folds 
Uncalled bet ($0.50) returned to Nagibator441
Nagibator441 collected $0.60 from pot
Nagibator441: doesn't show hand 
*** SUMMARY ***
Total pot $0.60 | Rake $0 
Seat 1: dushvan (button) folded before Flop (didn't bet)
Seat 2: 1Karina1 (small blind) folded before Flop
Seat 3: Silveystryk (big blind) folded before Flop
Seat 4: Perstenev folded before Flop (didn't bet)
Seat 5: deepakmbh folded before Flop (didn't bet)
Seat 6: chiyuki folded before Flop (didn't bet)
Seat 7: Nagibator441 collected ($0.60)
Seat 8: DutchShultzs folded before Flop (didn't bet)
Seat 9: deadmoneykid folded before Flop (didn't bet)



PokerStars Zoom Hand #84300160902:  Hold'em No Limit ($0.10/$0.25) - 2012/08/05 15:09:42 JST [2012/08/05 2:09:42 ET]
Table 'Whirlpool' 9-max Seat #1 is the button
Seat 1: mid22 ($12.73 in chips) 
Seat 2: Ellen1947 ($28.45 in chips) 
Seat 3: 4ydo yogurt ($33.08 in chips) 
Seat 4: colorado2108 ($42.98 in chips) 
Seat 5: deadmoneykid ($25.31 in chips) 
Seat 6: 1Karina1 ($29.69 in chips) 
Seat 7: Silveystryk ($23.18 in chips) 
Seat 8: ZhukOFFskI ($49.53 in chips) 
Seat 9: chiyuki ($28.51 in chips) 
Ellen1947: posts small blind $0.10
4ydo yogurt: posts big blind $0.25
*** HOLE CARDS ***
Dealt to chiyuki [Ad Tc]
colorado2108: folds 
deadmoneykid: folds 
1Karina1: folds 
Silveystryk: folds 
ZhukOFFskI: folds 
chiyuki: folds 
mid22: folds 
Ellen1947: folds 
Uncalled bet ($0.15) returned to 4ydo yogurt
4ydo yogurt collected $0.20 from pot
4ydo yogurt: doesn't show hand 
*** SUMMARY ***
Total pot $0.20 | Rake $0 
Seat 1: mid22 (button) folded before Flop (didn't bet)
Seat 2: Ellen1947 (small blind) folded before Flop
Seat 3: 4ydo yogurt (big blind) collected ($0.20)
Seat 4: colorado2108 folded before Flop (didn't bet)
Seat 5: deadmoneykid folded before Flop (didn't bet)
Seat 6: 1Karina1 folded before Flop (didn't bet)
Seat 7: Silveystryk folded before Flop (didn't bet)
Seat 8: ZhukOFFskI folded before Flop (didn't bet)
Seat 9: chiyuki folded before Flop (didn't bet)



PokerStars Zoom Hand #84300159393:  Hold'em No Limit ($0.10/$0.25) - 2012/08/05 15:09:36 JST [2012/08/05 2:09:36 ET]
Table 'Whirlpool' 9-max Seat #1 is the button
Seat 1: chiyuki ($28.51 in chips) 
Seat 2: Lasutchik ($75.58 in chips) 
Seat 3: troublesomm ($40.51 in chips) 
Seat 4: INSP!RON ($32.45 in chips) 
Seat 5: 1Karina1 ($30 in chips) 
Seat 6: edilson_ita ($23.39 in chips) 
Seat 7: DanielWhyte ($57.19 in chips) 
Seat 8: snejokCoxx ($11.38 in chips) 
Seat 9: 4ydo yogurt ($33.08 in chips) 
Lasutchik: posts small blind $0.10
troublesomm: posts big blind $0.25
*** HOLE CARDS ***
Dealt to chiyuki [Jc 3c]
INSP!RON: folds 
1Karina1: folds 
edilson_ita: folds 
DanielWhyte: folds 
snejokCoxx: folds 
4ydo yogurt: folds 
chiyuki: folds 
Lasutchik: calls $0.15
troublesomm: checks 
*** FLOP *** [Ac 4h 5s]
Lasutchik: bets $0.25
troublesomm: folds 
Uncalled bet ($0.25) returned to Lasutchik
Lasutchik collected $0.48 from pot
Lasutchik: doesn't show hand 
*** SUMMARY ***
Total pot $0.50 | Rake $0.02 
Board [Ac 4h 5s]
Seat 1: chiyuki (button) folded before Flop (didn't bet)
Seat 2: Lasutchik (small blind) collected ($0.48)
Seat 3: troublesomm (big blind) folded on the Flop
Seat 4: INSP!RON folded before Flop (didn't bet)
Seat 5: 1Karina1 folded before Flop (didn't bet)
Seat 6: edilson_ita folded before Flop (didn't bet)
Seat 7: DanielWhyte folded before Flop (didn't bet)
Seat 8: snejokCoxx folded before Flop (didn't bet)
Seat 9: 4ydo yogurt folded before Flop (didn't bet)



PokerStars Zoom Hand #84300162234:  Hold'em No Limit ($0.10/$0.25) - 2012/08/05 15:09:47 JST [2012/08/05 2:09:47 ET]
Table 'Whirlpool' 9-max Seat #1 is the button
Seat 1: kamikkaze ($15.43 in chips) 
Seat 2: simonzez ($28.72 in chips) 
Seat 3: INSP!RON ($32.45 in chips) 
Seat 4: drunk_bender ($26.24 in chips) 
Seat 5: snejokCoxx ($13.20 in chips) 
Seat 6: silvno31 ($27.50 in chips) 
Seat 7: 1Karina1 ($29.69 in chips) 
Seat 8: chiyuki ($28.51 in chips) 
Seat 9: Dejacob ($25 in chips) 
simonzez: posts small blind $0.10
INSP!RON: posts big blind $0.25
*** HOLE CARDS ***
Dealt to chiyuki [5c Ah]
drunk_bender: folds 
snejokCoxx: folds 
silvno31: folds 
1Karina1: folds 
chiyuki: folds 
Dejacob: raises $0.75 to $1
kamikkaze: folds 
simonzez: folds 
INSP!RON: folds 
Uncalled bet ($0.75) returned to Dejacob
Dejacob collected $0.60 from pot
Dejacob: doesn't show hand 
*** SUMMARY ***
Total pot $0.60 | Rake $0 
Seat 1: kamikkaze (button) folded before Flop (didn't bet)
Seat 2: simonzez (small blind) folded before Flop
Seat 3: INSP!RON (big blind) folded before Flop
Seat 4: drunk_bender folded before Flop (didn't bet)
Seat 5: snejokCoxx folded before Flop (didn't bet)
Seat 6: silvno31 folded before Flop (didn't bet)
Seat 7: 1Karina1 folded before Flop (didn't bet)
Seat 8: chiyuki folded before Flop (didn't bet)
Seat 9: Dejacob collected ($0.60)



PokerStars Zoom Hand #84300164017:  Hold'em No Limit ($0.10/$0.25) - 2012/08/05 15:09:54 JST [2012/08/05 2:09:54 ET]
Table 'Whirlpool' 9-max Seat #1 is the button
Seat 1: Alvinpe85 ($44.21 in chips) 
Seat 2: chiyuki ($28.51 in chips) 
Seat 3: Sal y Limon1 ($24.75 in chips) 
Seat 4: starreset ($29.59 in chips) 
Seat 5: snejokCoxx ($10.11 in chips) 
Seat 6: Dan Royal ($20.55 in chips) 
Seat 7: INSP!RON ($25 in chips) 
Seat 8: moku36 ($20.47 in chips) 
Seat 9: Nerkit ($9.30 in chips) 
chiyuki: posts small blind $0.10
Sal y Limon1: posts big blind $0.25
*** HOLE CARDS ***
Dealt to chiyuki [4d Jc]
starreset: raises $0.50 to $0.75
snejokCoxx: folds 
Dan Royal: folds 
INSP!RON: folds 
moku36: folds 
Nerkit: folds 
Alvinpe85: folds 
chiyuki: folds 
Sal y Limon1: folds 
Uncalled bet ($0.50) returned to starreset
starreset collected $0.60 from pot
starreset: doesn't show hand 
*** SUMMARY ***
Total pot $0.60 | Rake $0 
Seat 1: Alvinpe85 (button) folded before Flop (didn't bet)
Seat 2: chiyuki (small blind) folded before Flop
Seat 3: Sal y Limon1 (big blind) folded before Flop
Seat 4: starreset collected ($0.60)
Seat 5: snejokCoxx folded before Flop (didn't bet)
Seat 6: Dan Royal folded before Flop (didn't bet)
Seat 7: INSP!RON folded before Flop (didn't bet)
Seat 8: moku36 folded before Flop (didn't bet)
Seat 9: Nerkit folded before Flop (didn't bet)



PokerStars Zoom Hand #84300165313:  Hold'em No Limit ($0.10/$0.25) - 2012/08/05 15:09:59 JST [2012/08/05 2:09:59 ET]
Table 'Whirlpool' 9-max Seat #1 is the button
Seat 1: kamikkaze ($14.75 in chips) 
Seat 2: Silveystryk ($23.18 in chips) 
Seat 3: Nerkit ($12.10 in chips) 
Seat 4: chiyuki ($28.41 in chips) 
Seat 5: drunk_bender ($26.14 in chips) 
Seat 6: jacquelinewu ($36.49 in chips) 
Seat 7: DutchShultzs ($28.30 in chips) 
Seat 8: ygoegoe ($27.05 in chips) 
Seat 9: seula i ($101 in chips) 
Silveystryk: posts small blind $0.10
Nerkit: posts big blind $0.25
*** HOLE CARDS ***
Dealt to chiyuki [Qd 2c]
chiyuki: folds 
drunk_bender: folds 
jacquelinewu: folds 
DutchShultzs: folds 
ygoegoe: folds 
seula i: raises $0.50 to $0.75
kamikkaze: folds 
Silveystryk: folds 
Nerkit: folds 
Uncalled bet ($0.50) returned to seula i
seula i collected $0.60 from pot
seula i: doesn't show hand 
*** SUMMARY ***
Total pot $0.60 | Rake $0 
Seat 1: kamikkaze (button) folded before Flop (didn't bet)
Seat 2: Silveystryk (small blind) folded before Flop
Seat 3: Nerkit (big blind) folded before Flop
Seat 4: chiyuki folded before Flop (didn't bet)
Seat 5: drunk_bender folded before Flop (didn't bet)
Seat 6: jacquelinewu folded before Flop (didn't bet)
Seat 7: DutchShultzs folded before Flop (didn't bet)
Seat 8: ygoegoe folded before Flop (didn't bet)
Seat 9: seula i collected ($0.60)



PokerStars Zoom Hand #84300163233:  Hold'em No Limit ($0.10/$0.25) - 2012/08/05 15:09:51 JST [2012/08/05 2:09:51 ET]
Table 'Whirlpool' 9-max Seat #1 is the button
Seat 1: hirozo ($47.72 in chips) 
Seat 2: drunk_bender ($26.24 in chips) 
Seat 3: Tom1999 ($14.92 in chips) 
Seat 4: simonzez ($28.62 in chips) 
Seat 5: chiyuki ($28.51 in chips) 
Seat 6: masterkoolb ($13.62 in chips) 
Seat 7: jacquelinewu ($36.49 in chips) 
Seat 8: seula i ($41.07 in chips) 
Seat 9: Perstenev ($12.65 in chips) 
drunk_bender: posts small blind $0.10
Tom1999: posts big blind $0.25
*** HOLE CARDS ***
Dealt to chiyuki [6d 3h]
simonzez: folds 
chiyuki: folds 
masterkoolb: folds 
jacquelinewu: folds 
seula i: folds 
Perstenev: folds 
hirozo: raises $0.25 to $0.50
drunk_bender: folds 
Tom1999: raises $0.75 to $1.25
hirozo: folds 
Uncalled bet ($0.75) returned to Tom1999
Tom1999 collected $1.10 from pot
Tom1999: doesn't show hand 
*** SUMMARY ***
Total pot $1.10 | Rake $0 
Seat 1: hirozo (button) folded before Flop
Seat 2: drunk_bender (small blind) folded before Flop
Seat 3: Tom1999 (big blind) collected ($1.10)
Seat 4: simonzez folded before Flop (didn't bet)
Seat 5: chiyuki folded before Flop (didn't bet)
Seat 6: masterkoolb folded before Flop (didn't bet)
Seat 7: jacquelinewu folded before Flop (didn't bet)
Seat 8: seula i folded before Flop (didn't bet)
Seat 9: Perstenev folded before Flop (didn't bet)



PokerStars Zoom Hand #84300167606:  Hold'em No Limit ($0.10/$0.25) - 2012/08/05 15:10:09 JST [2012/08/05 2:10:09 ET]
Table 'Whirlpool' 9-max Seat #1 is the button
Seat 1: hirozo ($80.56 in chips) 
Seat 2: kamikkaze ($14.75 in chips) 
Seat 3: chiyuki ($28.41 in chips) 
Seat 4: 1Karina1 ($25 in chips) 
Seat 5: Alvinpe85 ($44.21 in chips) 
Seat 6: Roglus ($7.73 in chips) 
Seat 7: Dejacob ($25.25 in chips) 
Seat 8: Gichboy ($8.60 in chips) 
Seat 9: Rafioso ($12.15 in chips) 
kamikkaze: posts small blind $0.10
chiyuki: posts big blind $0.25
*** HOLE CARDS ***
Dealt to chiyuki [5d 9s]
1Karina1: folds 
Alvinpe85: raises $0.50 to $0.75
Roglus: folds 
Dejacob: folds 
Gichboy: folds 
Rafioso: folds 
hirozo: folds 
kamikkaze: folds 
chiyuki: folds 
Uncalled bet ($0.50) returned to Alvinpe85
Alvinpe85 collected $0.60 from pot
Alvinpe85: doesn't show hand 
*** SUMMARY ***
Total pot $0.60 | Rake $0 
Seat 1: hirozo (button) folded before Flop (didn't bet)
Seat 2: kamikkaze (small blind) folded before Flop
Seat 3: chiyuki (big blind) folded before Flop
Seat 4: 1Karina1 folded before Flop (didn't bet)
Seat 5: Alvinpe85 collected ($0.60)
Seat 6: Roglus folded before Flop (didn't bet)
Seat 7: Dejacob folded before Flop (didn't bet)
Seat 8: Gichboy folded before Flop (didn't bet)
Seat 9: Rafioso folded before Flop (didn't bet)



PokerStars Zoom Hand #84300166815:  Hold'em No Limit ($0.10/$0.25) - 2012/08/05 15:10:05 JST [2012/08/05 2:10:05 ET]
Table 'Whirlpool' 9-max Seat #1 is the button
Seat 1: Rafioso ($12.15 in chips) 
Seat 2: AAAKK777 ($36.14 in chips) 
Seat 3: kwkim73 ($25 in chips) 
Seat 4: chiyuki ($28.41 in chips) 
Seat 5: womble32 ($26.34 in chips) 
Seat 6: Perstenev ($12.65 in chips) 
Seat 7: ygoegoe ($27.05 in chips) 
Seat 8: tribunpdm ($30.25 in chips) 
Seat 9: seula i ($37.31 in chips) 
AAAKK777: posts small blind $0.10
kwkim73: posts big blind $0.25
*** HOLE CARDS ***
Dealt to chiyuki [4d Td]
chiyuki: folds 
womble32: folds 
Perstenev: folds 
ygoegoe: raises $0.50 to $0.75
tribunpdm: folds 
seula i: calls $0.75
Rafioso: folds 
AAAKK777: raises $0.75 to $1.50
kwkim73: folds 
ygoegoe: raises $2 to $3.50
seula i: folds 
AAAKK777: calls $2
*** FLOP *** [Qd 7d 6c]
AAAKK777: checks 
ygoegoe: bets $4
AAAKK777: folds 
Uncalled bet ($4) returned to ygoegoe
ygoegoe collected $7.64 from pot
ygoegoe: doesn't show hand 
*** SUMMARY ***
Total pot $8 | Rake $0.36 
Board [Qd 7d 6c]
Seat 1: Rafioso (button) folded before Flop (didn't bet)
Seat 2: AAAKK777 (small blind) folded on the Flop
Seat 3: kwkim73 (big blind) folded before Flop
Seat 4: chiyuki folded before Flop (didn't bet)
Seat 5: womble32 folded before Flop (didn't bet)
Seat 6: Perstenev folded before Flop (didn't bet)
Seat 7: ygoegoe collected ($7.64)
Seat 8: tribunpdm folded before Flop (didn't bet)
Seat 9: seula i folded before Flop



PokerStars Zoom Hand #84300171977:  Hold'em No Limit ($0.10/$0.25) - 2012/08/05 15:10:26 JST [2012/08/05 2:10:26 ET]
Table 'Whirlpool' 9-max Seat #1 is the button
Seat 1: JhonnyP1979 ($6.05 in chips) 
Seat 2: Dan Royal ($21.40 in chips) 
Seat 3: Perstenev ($12.60 in chips) 
Seat 4: troublesomm ($25.77 in chips) 
Seat 5: NuMetal88 ($25 in chips) 
Seat 6: phate-1up ($25 in chips) 
Seat 7: Silveystryk ($23.89 in chips) 
Seat 8: Faantomace ($13.73 in chips) 
Seat 9: chiyuki ($28.16 in chips) 
Dan Royal: posts small blind $0.10
Perstenev: posts big blind $0.25
*** HOLE CARDS ***
Dealt to chiyuki [7d 7h]
troublesomm: folds 
NuMetal88: folds 
phate-1up: folds 
Silveystryk: folds 
Faantomace: folds 
chiyuki: raises $0.50 to $0.75
JhonnyP1979: calls $0.75
Dan Royal: folds 
Perstenev: folds 
*** FLOP *** [Qh Kh 8s]
chiyuki: checks 
JhonnyP1979: bets $1.32
chiyuki: folds 
Uncalled bet ($1.32) returned to JhonnyP1979
JhonnyP1979 collected $1.77 from pot
JhonnyP1979: doesn't show hand 
*** SUMMARY ***
Total pot $1.85 | Rake $0.08 
Board [Qh Kh 8s]
Seat 1: JhonnyP1979 (button) collected ($1.77)
Seat 2: Dan Royal (small blind) folded before Flop
Seat 3: Perstenev (big blind) folded before Flop
Seat 4: troublesomm folded before Flop (didn't bet)
Seat 5: NuMetal88 folded before Flop (didn't bet)
Seat 6: phate-1up folded before Flop (didn't bet)
Seat 7: Silveystryk folded before Flop (didn't bet)
Seat 8: Faantomace folded before Flop (didn't bet)
Seat 9: chiyuki folded on the Flop



PokerStars Zoom Hand #84300169904:  Hold'em No Limit ($0.10/$0.25) - 2012/08/05 15:10:18 JST [2012/08/05 2:10:18 ET]
Table 'Whirlpool' 9-max Seat #1 is the button
Seat 1: seula i ($29.96 in chips) 
Seat 2: Dejacob ($25.41 in chips) 
Seat 3: Nerkit ($9.57 in chips) 
Seat 4: pandaaaaaa ($12.72 in chips) 
Seat 5: jacquelinewu ($47.97 in chips) 
Seat 6: Vahe50 ($14.11 in chips) 
Seat 7: snejokCoxx ($12.25 in chips) 
Seat 8: chiyuki ($28.16 in chips) 
Seat 9: Yoshimac ($14.28 in chips) 
Dejacob: posts small blind $0.10
Nerkit: posts big blind $0.25
*** HOLE CARDS ***
Dealt to chiyuki [3s Ac]
pandaaaaaa: raises $0.75 to $1
jacquelinewu: calls $1
Vahe50: folds 
snejokCoxx: folds 
chiyuki: folds 
Yoshimac: folds 
seula i: folds 
Dejacob: folds 
Nerkit: folds 
*** FLOP *** [Ks 7s 9s]
pandaaaaaa: bets $2
jacquelinewu: calls $2
*** TURN *** [Ks 7s 9s] [Kc]
pandaaaaaa: bets $7.25
jacquelinewu: raises $14.39 to $21.64
pandaaaaaa: calls $2.47 and is all-in
Uncalled bet ($11.92) returned to jacquelinewu
*** RIVER *** [Ks 7s 9s Kc] [6s]
*** SHOW DOWN ***
pandaaaaaa: shows [Ad Kh] (three of a kind, Kings)
jacquelinewu: shows [Ah Kd] (three of a kind, Kings)
pandaaaaaa collected $12.32 from pot
jacquelinewu collected $12.31 from pot
*** SUMMARY ***
Total pot $25.79 | Rake $1.16 
Board [Ks 7s 9s Kc 6s]
Seat 1: seula i (button) folded before Flop (didn't bet)
Seat 2: Dejacob (small blind) folded before Flop
Seat 3: Nerkit (big blind) folded before Flop
Seat 4: pandaaaaaa showed [Ad Kh] and won ($12.32) with three of a kind, Kings
Seat 5: jacquelinewu showed [Ah Kd] and won ($12.31) with three of a kind, Kings
Seat 6: Vahe50 folded before Flop (didn't bet)
Seat 7: snejokCoxx folded before Flop (didn't bet)
Seat 8: chiyuki folded before Flop (didn't bet)
Seat 9: Yoshimac folded before Flop (didn't bet)



PokerStars Zoom Hand #84300170944:  Hold'em No Limit ($0.10/$0.25) - 2012/08/05 15:10:22 JST [2012/08/05 2:10:22 ET]
Table 'Whirlpool' 9-max Seat #1 is the button
Seat 1: deadmoneykid ($25.31 in chips) 
Seat 2: Yoshimac ($14.28 in chips) 
Seat 3: turbotom122 ($27.84 in chips) 
Seat 4: DanielWhyte ($57.04 in chips) 
Seat 5: KrystalAA ($25.73 in chips) 
Seat 6: chiyuki ($28.16 in chips) 
Seat 7: JhonnyP1979 ($6.05 in chips) 
Seat 8: Dan Royal ($21.40 in chips) 
Seat 9: kamikkaze ($14.65 in chips) 
Yoshimac: posts small blind $0.10
turbotom122: posts big blind $0.25
*** HOLE CARDS ***
Dealt to chiyuki [Jc 3s]
DanielWhyte: folds 
KrystalAA: folds 
chiyuki: folds 
JhonnyP1979: folds 
Dan Royal: folds 
kamikkaze: folds 
deadmoneykid: folds 
Yoshimac: raises $0.75 to $1
turbotom122: calls $0.75
*** FLOP *** [Th Kh 9s]
Yoshimac: checks 
turbotom122: bets $2
Yoshimac: folds 
Uncalled bet ($2) returned to turbotom122
turbotom122 collected $1.91 from pot
turbotom122: doesn't show hand 
*** SUMMARY ***
Total pot $2 | Rake $0.09 
Board [Th Kh 9s]
Seat 1: deadmoneykid (button) folded before Flop (didn't bet)
Seat 2: Yoshimac (small blind) folded on the Flop
Seat 3: turbotom122 (big blind) collected ($1.91)
Seat 4: DanielWhyte folded before Flop (didn't bet)
Seat 5: KrystalAA folded before Flop (didn't bet)
Seat 6: chiyuki folded before Flop (didn't bet)
Seat 7: JhonnyP1979 folded before Flop (didn't bet)
Seat 8: Dan Royal folded before Flop (didn't bet)
Seat 9: kamikkaze folded before Flop (didn't bet)



PokerStars Zoom Hand #84300183522:  Hold'em No Limit ($0.10/$0.25) - 2012/08/05 15:11:11 JST [2012/08/05 2:11:11 ET]
Table 'Whirlpool' 9-max Seat #1 is the button
Seat 1: wildy29 ($32.75 in chips) 
Seat 2: pandaaaaaa ($12.32 in chips) 
Seat 3: ygoegoe ($25.25 in chips) 
Seat 4: mjmichi ($31.39 in chips) 
Seat 5: KeLevro0 ($14.52 in chips) 
Seat 6: 1Karina1 ($29.40 in chips) 
Seat 7: chiyuki ($27.31 in chips) 
Seat 8: kamikkaze ($14.30 in chips) 
Seat 9: laurentzu84 ($33.71 in chips) 
pandaaaaaa: posts small blind $0.10
ygoegoe: posts big blind $0.25
*** HOLE CARDS ***
Dealt to chiyuki [Ah 4h]
mjmichi: folds 
KeLevro0: raises $0.42 to $0.67
1Karina1: folds 
chiyuki: folds 
kamikkaze: folds 
laurentzu84: folds 
wildy29: folds 
pandaaaaaa: folds 
ygoegoe: folds 
Uncalled bet ($0.42) returned to KeLevro0
KeLevro0 collected $0.60 from pot
KeLevro0: doesn't show hand 
*** SUMMARY ***
Total pot $0.60 | Rake $0 
Seat 1: wildy29 (button) folded before Flop (didn't bet)
Seat 2: pandaaaaaa (small blind) folded before Flop
Seat 3: ygoegoe (big blind) folded before Flop
Seat 4: mjmichi folded before Flop (didn't bet)
Seat 5: KeLevro0 collected ($0.60)
Seat 6: 1Karina1 folded before Flop (didn't bet)
Seat 7: chiyuki folded before Flop (didn't bet)
Seat 8: kamikkaze folded before Flop (didn't bet)
Seat 9: laurentzu84 folded before Flop (didn't bet)



PokerStars Zoom Hand #84300181698:  Hold'em No Limit ($0.10/$0.25) - 2012/08/05 15:11:04 JST [2012/08/05 2:11:04 ET]
Table 'Whirlpool' 9-max Seat #1 is the button
Seat 1: Saruotiss ($24.39 in chips) 
Seat 2: jacquelinewu ($47.56 in chips) 
Seat 3: starreset ($30.37 in chips) 
Seat 4: Perstenev ($10.40 in chips) 
Seat 5: troublesomm ($28.10 in chips) 
Seat 6: Tom1999 ($16.20 in chips) 
Seat 7: AAAKK777 ($32.64 in chips) 
Seat 8: chiyuki ($27.41 in chips) 
Seat 9: Alvinpe85 ($45.95 in chips) 
jacquelinewu: posts small blind $0.10
starreset: posts big blind $0.25
*** HOLE CARDS ***
Dealt to chiyuki [4c Ks]
Perstenev: folds 
troublesomm: folds 
Tom1999: folds 
AAAKK777: raises $1 to $1.25
chiyuki: folds 
Alvinpe85: folds 
Saruotiss: folds 
jacquelinewu: folds 
starreset: folds 
Uncalled bet ($1) returned to AAAKK777
AAAKK777 collected $0.60 from pot
AAAKK777: doesn't show hand 
*** SUMMARY ***
Total pot $0.60 | Rake $0 
Seat 1: Saruotiss (button) folded before Flop (didn't bet)
Seat 2: jacquelinewu (small blind) folded before Flop
Seat 3: starreset (big blind) folded before Flop
Seat 4: Perstenev folded before Flop (didn't bet)
Seat 5: troublesomm folded before Flop (didn't bet)
Seat 6: Tom1999 folded before Flop (didn't bet)
Seat 7: AAAKK777 collected ($0.60)
Seat 8: chiyuki folded before Flop (didn't bet)
Seat 9: Alvinpe85 folded before Flop (didn't bet)



PokerStars Zoom Hand #84300178670:  Hold'em No Limit ($0.10/$0.25) - 2012/08/05 15:10:52 JST [2012/08/05 2:10:52 ET]
Table 'Whirlpool' 9-max Seat #1 is the button
Seat 1: chiyuki ($27.41 in chips) 
Seat 2: troublesomm ($39.76 in chips) 
Seat 3: ygoegoe ($31.19 in chips) 
Seat 4: moku36 ($19.67 in chips) 
Seat 5: hirozo ($80.91 in chips) 
Seat 6: Ellen1947 ($28.45 in chips) 
Seat 7: seula i ($36.56 in chips) 
Seat 8: Lasutchik ($75.56 in chips) 
Seat 9: 1Karina1 ($25 in chips) 
troublesomm: posts small blind $0.10
ygoegoe: posts big blind $0.25
*** HOLE CARDS ***
Dealt to chiyuki [6d 4h]
moku36: folds 
hirozo: folds 
Ellen1947: folds 
seula i: folds 
Lasutchik: folds 
1Karina1: folds 
chiyuki: folds 
troublesomm: raises $0.50 to $0.75
ygoegoe: calls $0.50
*** FLOP *** [Kd 6s Td]
troublesomm: checks 
ygoegoe: checks 
*** TURN *** [Kd 6s Td] [Jd]
troublesomm: checks 
ygoegoe: bets $0.95
troublesomm: folds 
Uncalled bet ($0.95) returned to ygoegoe
ygoegoe collected $1.43 from pot
ygoegoe: doesn't show hand 
*** SUMMARY ***
Total pot $1.50 | Rake $0.07 
Board [Kd 6s Td Jd]
Seat 1: chiyuki (button) folded before Flop (didn't bet)
Seat 2: troublesomm (small blind) folded on the Turn
Seat 3: ygoegoe (big blind) collected ($1.43)
Seat 4: moku36 folded before Flop (didn't bet)
Seat 5: hirozo folded before Flop (didn't bet)
Seat 6: Ellen1947 folded before Flop (didn't bet)
Seat 7: seula i folded before Flop (didn't bet)
Seat 8: Lasutchik folded before Flop (didn't bet)
Seat 9: 1Karina1 folded before Flop (didn't bet)



PokerStars Zoom Hand #84300184797:  Hold'em No Limit ($0.10/$0.25) - 2012/08/05 15:11:16 JST [2012/08/05 2:11:16 ET]
Table 'Whirlpool' 9-max Seat #1 is the button
Seat 1: snejokCoxx ($10.38 in chips) 
Seat 2: Jene4kaBest ($3.19 in chips) 
Seat 3: pandaaaaaa ($12.22 in chips) 
Seat 4: Nagibator441 ($14.27 in chips) 
Seat 5: chiyuki ($27.31 in chips) 
Seat 6: kesstukas25 ($12.50 in chips) 
Seat 7: 4plankton ($20.39 in chips) 
Seat 8: laurentzu84 ($33.71 in chips) 
Seat 9: kamikkaze ($14.30 in chips) 
Jene4kaBest: posts small blind $0.10
pandaaaaaa: posts big blind $0.25
*** HOLE CARDS ***
Dealt to chiyuki [3d 9d]
Nagibator441: folds 
chiyuki: folds 
kesstukas25: folds 
4plankton: folds 
laurentzu84: folds 
kamikkaze: folds 
snejokCoxx: folds 
Jene4kaBest: folds 
Uncalled bet ($0.15) returned to pandaaaaaa
pandaaaaaa collected $0.20 from pot
pandaaaaaa: doesn't show hand 
*** SUMMARY ***
Total pot $0.20 | Rake $0 
Seat 1: snejokCoxx (button) folded before Flop (didn't bet)
Seat 2: Jene4kaBest (small blind) folded before Flop
Seat 3: pandaaaaaa (big blind) collected ($0.20)
Seat 4: Nagibator441 folded before Flop (didn't bet)
Seat 5: chiyuki folded before Flop (didn't bet)
Seat 6: kesstukas25 folded before Flop (didn't bet)
Seat 7: 4plankton folded before Flop (didn't bet)
Seat 8: laurentzu84 folded before Flop (didn't bet)
Seat 9: kamikkaze folded before Flop (didn't bet)



PokerStars Zoom Hand #84300182455:  Hold'em No Limit ($0.10/$0.25) - 2012/08/05 15:11:07 JST [2012/08/05 2:11:07 ET]
Table 'Whirlpool' 9-max Seat #1 is the button
Seat 1: masterkoolb ($17.55 in chips) 
Seat 2: chiyuki ($27.41 in chips) 
Seat 3: Dejacob ($25.25 in chips) 
Seat 4: snejokCoxx ($13.20 in chips) 
Seat 5: Nagibator441 ($14.27 in chips) 
Seat 6: Nerkit ($12 in chips) 
Seat 7: kwkim73 ($25 in chips) 
Seat 8: JhonnyP1979 ($7.07 in chips) 
Seat 9: seula i ($36.56 in chips) 
chiyuki: posts small blind $0.10
Dejacob: posts big blind $0.25
*** HOLE CARDS ***
Dealt to chiyuki [9h 6d]
snejokCoxx: folds 
Nagibator441: folds 
Nerkit: folds 
kwkim73: folds 
JhonnyP1979: raises $0.37 to $0.62
seula i: raises $1.38 to $2
masterkoolb: folds 
chiyuki: folds 
Dejacob: folds 
JhonnyP1979: folds 
Uncalled bet ($1.38) returned to seula i
seula i collected $1.59 from pot
seula i: doesn't show hand 
*** SUMMARY ***
Total pot $1.59 | Rake $0 
Seat 1: masterkoolb (button) folded before Flop (didn't bet)
Seat 2: chiyuki (small blind) folded before Flop
Seat 3: Dejacob (big blind) folded before Flop
Seat 4: snejokCoxx folded before Flop (didn't bet)
Seat 5: Nagibator441 folded before Flop (didn't bet)
Seat 6: Nerkit folded before Flop (didn't bet)
Seat 7: kwkim73 folded before Flop (didn't bet)
Seat 8: JhonnyP1979 folded before Flop
Seat 9: seula i collected ($1.59)



PokerStars Zoom Hand #84300186085:  Hold'em No Limit ($0.10/$0.25) - 2012/08/05 15:11:22 JST [2012/08/05 2:11:22 ET]
Table 'Whirlpool' 9-max Seat #1 is the button
Seat 1: tribunpdm ($29.65 in chips) 
Seat 2: kesstukas25 ($14.08 in chips) 
Seat 3: KeLevro0 ($12.40 in chips) 
Seat 4: kamikkaze ($14.30 in chips) 
Seat 5: 4plankton ($20.39 in chips) 
Seat 6: NuMetal88 ($25.25 in chips) 
Seat 7: Roglus ($9.73 in chips) 
Seat 8: Alvinpe85 ($45.95 in chips) 
Seat 9: chiyuki ($27.31 in chips) 
kesstukas25: posts small blind $0.10
KeLevro0: posts big blind $0.25
*** HOLE CARDS ***
Dealt to chiyuki [Ac 2c]
kamikkaze: raises $0.50 to $0.75
4plankton: folds 
NuMetal88: folds 
Roglus: calls $0.75
Alvinpe85: folds 
chiyuki: folds 
tribunpdm: folds 
kesstukas25: folds 
KeLevro0: folds 
*** FLOP *** [Th 7s 3h]
kamikkaze: checks 
Roglus: checks 
*** TURN *** [Th 7s 3h] [6h]
kamikkaze: checks 
Roglus: checks 
*** RIVER *** [Th 7s 3h 6h] [Ah]
kamikkaze: checks 
Roglus: checks 
*** SHOW DOWN ***
kamikkaze: shows [Ks Ad] (a pair of Aces)
Roglus: shows [5h 5d] (a flush, Ace high)
Roglus collected $1.77 from pot
*** SUMMARY ***
Total pot $1.85 | Rake $0.08 
Board [Th 7s 3h 6h Ah]
Seat 1: tribunpdm (button) folded before Flop (didn't bet)
Seat 2: kesstukas25 (small blind) folded before Flop
Seat 3: KeLevro0 (big blind) folded before Flop
Seat 4: kamikkaze showed [Ks Ad] and lost with a pair of Aces
Seat 5: 4plankton folded before Flop (didn't bet)
Seat 6: NuMetal88 folded before Flop (didn't bet)
Seat 7: Roglus showed [5h 5d] and won ($1.77) with a flush, Ace high
Seat 8: Alvinpe85 folded before Flop (didn't bet)
Seat 9: chiyuki folded before Flop (didn't bet)



PokerStars Zoom Hand #84300188149:  Hold'em No Limit ($0.10/$0.25) - 2012/08/05 15:11:30 JST [2012/08/05 2:11:30 ET]
Table 'Whirlpool' 9-max Seat #1 is the button
Seat 1: Jene4kaBest ($3.09 in chips) 
Seat 2: DutchShultzs ($34.49 in chips) 
Seat 3: chiyuki ($27.31 in chips) 
Seat 4: Perstenev ($14.76 in chips) 
Seat 5: NuMetal88 ($25.15 in chips) 
Seat 6: ZhukOFFskI ($36.73 in chips) 
Seat 7: troublesomm ($28.10 in chips) 
Seat 8: Dejacob ($25 in chips) 
Seat 9: Sal y Limon1 ($24.75 in chips) 
DutchShultzs: posts small blind $0.10
chiyuki: posts big blind $0.25
*** HOLE CARDS ***
Dealt to chiyuki [Ad Td]
Perstenev: folds 
NuMetal88: folds 
ZhukOFFskI: folds 
troublesomm: folds 
Dejacob: folds 
Sal y Limon1: folds 
Jene4kaBest: folds 
DutchShultzs: raises $0.50 to $0.75
chiyuki: raises $1.50 to $2.25
DutchShultzs: folds 
Uncalled bet ($1.50) returned to chiyuki
chiyuki collected $1.50 from pot
chiyuki: doesn't show hand 
*** SUMMARY ***
Total pot $1.50 | Rake $0 
Seat 1: Jene4kaBest (button) folded before Flop (didn't bet)
Seat 2: DutchShultzs (small blind) folded before Flop
Seat 3: chiyuki (big blind) collected ($1.50)
Seat 4: Perstenev folded before Flop (didn't bet)
Seat 5: NuMetal88 folded before Flop (didn't bet)
Seat 6: ZhukOFFskI folded before Flop (didn't bet)
Seat 7: troublesomm folded before Flop (didn't bet)
Seat 8: Dejacob folded before Flop (didn't bet)
Seat 9: Sal y Limon1 folded before Flop (didn't bet)



PokerStars Zoom Hand #84300197256:  Hold'em No Limit ($0.10/$0.25) - 2012/08/05 15:12:06 JST [2012/08/05 2:12:06 ET]
Table 'Whirlpool' 9-max Seat #1 is the button
Seat 1: 1Karina1 ($29.34 in chips) 
Seat 2: Tom1999 ($23.47 in chips) 
Seat 3: hirozo ($71.33 in chips) 
Seat 4: Dejacob ($25 in chips) 
Seat 5: Jene4kaBest ($2.84 in chips) 
Seat 6: chiyuki ($28.06 in chips) 
Seat 7: pandaaaaaa ($9.70 in chips) 
Seat 8: Perstenev ($14.41 in chips) 
Seat 9: DanielWhyte ($59.62 in chips) 
Tom1999: posts small blind $0.10
hirozo: posts big blind $0.25
*** HOLE CARDS ***
Dealt to chiyuki [2h 4h]
Dejacob: folds 
Jene4kaBest: folds 
chiyuki: folds 
pandaaaaaa: folds 
Perstenev: folds 
DanielWhyte: folds 
1Karina1: folds 
Tom1999: folds 
Uncalled bet ($0.15) returned to hirozo
hirozo collected $0.20 from pot
hirozo: doesn't show hand 
*** SUMMARY ***
Total pot $0.20 | Rake $0 
Seat 1: 1Karina1 (button) folded before Flop (didn't bet)
Seat 2: Tom1999 (small blind) folded before Flop
Seat 3: hirozo (big blind) collected ($0.20)
Seat 4: Dejacob folded before Flop (didn't bet)
Seat 5: Jene4kaBest folded before Flop (didn't bet)
Seat 6: chiyuki folded before Flop (didn't bet)
Seat 7: pandaaaaaa folded before Flop (didn't bet)
Seat 8: Perstenev folded before Flop (didn't bet)
Seat 9: DanielWhyte folded before Flop (didn't bet)



PokerStars Zoom Hand #84300199388:  Hold'em No Limit ($0.10/$0.25) - 2012/08/05 15:12:14 JST [2012/08/05 2:12:14 ET]
Table 'Whirlpool' 9-max Seat #1 is the button
Seat 1: GovGus ($25 in chips) 
Seat 2: Paranoix1990 ($10.19 in chips) 
Seat 3: WARIBANA7777 ($17.46 in chips) 
Seat 4: womble32 ($27.21 in chips) 
Seat 5: Sal y Limon1 ($24.75 in chips) 
Seat 6: jacquelinewu ($25.35 in chips) 
Seat 7: Perstenev ($14.41 in chips) 
Seat 8: chiyuki ($28.06 in chips) 
Seat 9: colorado2108 ($49.21 in chips) 
Paranoix1990: posts small blind $0.10
WARIBANA7777: posts big blind $0.25
*** HOLE CARDS ***
Dealt to chiyuki [4s 9s]
womble32: folds 
Sal y Limon1: folds 
jacquelinewu: folds 
Perstenev: folds 
chiyuki: folds 
colorado2108: raises $0.25 to $0.50
GovGus: folds 
Paranoix1990: folds 
WARIBANA7777: folds 
Uncalled bet ($0.25) returned to colorado2108
colorado2108 collected $0.60 from pot
colorado2108: doesn't show hand 
*** SUMMARY ***
Total pot $0.60 | Rake $0 
Seat 1: GovGus (button) folded before Flop (didn't bet)
Seat 2: Paranoix1990 (small blind) folded before Flop
Seat 3: WARIBANA7777 (big blind) folded before Flop
Seat 4: womble32 folded before Flop (didn't bet)
Seat 5: Sal y Limon1 folded before Flop (didn't bet)
Seat 6: jacquelinewu folded before Flop (didn't bet)
Seat 7: Perstenev folded before Flop (didn't bet)
Seat 8: chiyuki folded before Flop (didn't bet)
Seat 9: colorado2108 collected ($0.60)



PokerStars Zoom Hand #84300201598:  Hold'em No Limit ($0.10/$0.25) - 2012/08/05 15:12:23 JST [2012/08/05 2:12:23 ET]
Table 'Whirlpool' 9-max Seat #1 is the button
Seat 1: Silveystryk ($19.98 in chips) 
Seat 2: 1Karina1 ($29.05 in chips) 
Seat 3: el pore 5 ($12.56 in chips) 
Seat 4: deepakmbh ($46.81 in chips) 
Seat 5: tribunpdm ($32.13 in chips) 
Seat 6: kwkim73 ($29.55 in chips) 
Seat 7: chiyuki ($28.06 in chips) 
Seat 8: KeLevro0 ($12.50 in chips) 
Seat 9: pandaaaaaa ($9.45 in chips) 
1Karina1: posts small blind $0.10
el pore 5: posts big blind $0.25
*** HOLE CARDS ***
Dealt to chiyuki [9d 4h]
deepakmbh: folds 
tribunpdm: folds 
kwkim73: raises $0.50 to $0.75
chiyuki: folds 
KeLevro0: folds 
pandaaaaaa: folds 
Silveystryk: folds 
1Karina1: folds 
el pore 5: folds 
Uncalled bet ($0.50) returned to kwkim73
kwkim73 collected $0.60 from pot
kwkim73: doesn't show hand 
*** SUMMARY ***
Total pot $0.60 | Rake $0 
Seat 1: Silveystryk (button) folded before Flop (didn't bet)
Seat 2: 1Karina1 (small blind) folded before Flop
Seat 3: el pore 5 (big blind) folded before Flop
Seat 4: deepakmbh folded before Flop (didn't bet)
Seat 5: tribunpdm folded before Flop (didn't bet)
Seat 6: kwkim73 collected ($0.60)
Seat 7: chiyuki folded before Flop (didn't bet)
Seat 8: KeLevro0 folded before Flop (didn't bet)
Seat 9: pandaaaaaa folded before Flop (didn't bet)



PokerStars Zoom Hand #84300202603:  Hold'em No Limit ($0.10/$0.25) - 2012/08/05 15:12:27 JST [2012/08/05 2:12:27 ET]
Table 'Whirlpool' 9-max Seat #1 is the button
Seat 1: KeLevro0 ($12.50 in chips) 
Seat 2: chiyuki ($28.06 in chips) 
Seat 3: DutchShultzs ($25.74 in chips) 
Seat 4: River_GmbH ($17.89 in chips) 
Seat 5: svg51 ($12.87 in chips) 
Seat 6: hirozo ($33.20 in chips) 
Seat 7: rorfo23 ($16.76 in chips) 
Seat 8: Ellen1947 ($26.95 in chips) 
Seat 9: ygoegoe ($31.77 in chips) 
chiyuki: posts small blind $0.10
DutchShultzs: posts big blind $0.25
*** HOLE CARDS ***
Dealt to chiyuki [Kc Kh]
River_GmbH: folds 
svg51: folds 
hirozo: folds 
rorfo23: folds 
Ellen1947: folds 
ygoegoe: raises $0.50 to $0.75
KeLevro0: calls $0.75
chiyuki: raises $2.25 to $3
DutchShultzs: folds 
ygoegoe: folds 
KeLevro0: folds 
Uncalled bet ($2.25) returned to chiyuki
chiyuki collected $2.50 from pot
chiyuki: doesn't show hand 
*** SUMMARY ***
Total pot $2.50 | Rake $0 
Seat 1: KeLevro0 (button) folded before Flop
Seat 2: chiyuki (small blind) collected ($2.50)
Seat 3: DutchShultzs (big blind) folded before Flop
Seat 4: River_GmbH folded before Flop (didn't bet)
Seat 5: svg51 folded before Flop (didn't bet)
Seat 6: hirozo folded before Flop (didn't bet)
Seat 7: rorfo23 folded before Flop (didn't bet)
Seat 8: Ellen1947 folded before Flop (didn't bet)
Seat 9: ygoegoe folded before Flop



PokerStars Zoom Hand #84300194157:  Hold'em No Limit ($0.10/$0.25) - 2012/08/05 15:11:54 JST [2012/08/05 2:11:54 ET]
Table 'Whirlpool' 9-max Seat #1 is the button
Seat 1: chiyuki ($28.06 in chips) 
Seat 2: wildy29 ($31.75 in chips) 
Seat 3: Silveystryk ($20.33 in chips) 
Seat 4: simonzez ($25.87 in chips) 
Seat 5: Vahe50 ($14.56 in chips) 
Seat 6: Rilko1975 ($31.16 in chips) 
Seat 7: troublesomm ($25.07 in chips) 
Seat 8: 1Karina1 ($25 in chips) 
Seat 9: INSP!RON ($32.90 in chips) 
wildy29: posts small blind $0.10
Silveystryk: posts big blind $0.25
*** HOLE CARDS ***
Dealt to chiyuki [Qs Kc]
simonzez: folds 
Vahe50: folds 
Rilko1975: folds 
troublesomm: folds 
1Karina1: folds 
INSP!RON: raises $0.50 to $0.75
chiyuki: folds 
wildy29: calls $0.65
Silveystryk: folds 
*** FLOP *** [7s Qd 4c]
wildy29: bets $0.25
INSP!RON: raises $1.05 to $1.30
wildy29: calls $1.05
*** TURN *** [7s Qd 4c] [9h]
wildy29: checks 
INSP!RON: checks 
*** RIVER *** [7s Qd 4c 9h] [9d]
wildy29: bets $1
INSP!RON: folds 
Uncalled bet ($1) returned to wildy29
wildy29 collected $4.15 from pot
wildy29: doesn't show hand 
*** SUMMARY ***
Total pot $4.35 | Rake $0.20 
Board [7s Qd 4c 9h 9d]
Seat 1: chiyuki (button) folded before Flop (didn't bet)
Seat 2: wildy29 (small blind) collected ($4.15)
Seat 3: Silveystryk (big blind) folded before Flop
Seat 4: simonzez folded before Flop (didn't bet)
Seat 5: Vahe50 folded before Flop (didn't bet)
Seat 6: Rilko1975 folded before Flop (didn't bet)
Seat 7: troublesomm folded before Flop (didn't bet)
Seat 8: 1Karina1 folded before Flop (didn't bet)
Seat 9: INSP!RON folded on the River



PokerStars Zoom Hand #84300200629:  Hold'em No Limit ($0.10/$0.25) - 2012/08/05 15:12:19 JST [2012/08/05 2:12:19 ET]
Table 'Whirlpool' 9-max Seat #1 is the button
Seat 1: DanielWhyte ($59.62 in chips) 
Seat 2: seula i ($37.28 in chips) 
Seat 3: KrystalAA ($37.24 in chips) 
Seat 4: chiyuki ($28.06 in chips) 
Seat 5: ZhukOFFskI ($30.98 in chips) 
Seat 6: 1Karina1 ($29.34 in chips) 
Seat 7: Sal y Limon1 ($24.75 in chips) 
Seat 8: Gichboy ($2.75 in chips) 
Seat 9: el pore 5 ($12.56 in chips) 
seula i: posts small blind $0.10
KrystalAA: posts big blind $0.25
*** HOLE CARDS ***
Dealt to chiyuki [5c 9h]
chiyuki: folds 
ZhukOFFskI: folds 
1Karina1: folds 
Sal y Limon1: folds 
Gichboy: calls $0.25
el pore 5: folds 
DanielWhyte: folds 
seula i: raises $0.75 to $1
KrystalAA: folds 
Gichboy: calls $0.75
*** FLOP *** [2d Qd Ks]
seula i: checks 
Gichboy: checks 
*** TURN *** [2d Qd Ks] [2h]
seula i: checks 
Gichboy: checks 
*** RIVER *** [2d Qd Ks 2h] [8c]
seula i: checks 
Gichboy: checks 
*** SHOW DOWN ***
seula i: shows [5h 5d] (two pair, Fives and Deuces)
Gichboy: mucks hand 
seula i collected $2.15 from pot
*** SUMMARY ***
Total pot $2.25 | Rake $0.10 
Board [2d Qd Ks 2h 8c]
Seat 1: DanielWhyte (button) folded before Flop (didn't bet)
Seat 2: seula i (small blind) showed [5h 5d] and won ($2.15) with two pair, Fives and Deuces
Seat 3: KrystalAA (big blind) folded before Flop
Seat 4: chiyuki folded before Flop (didn't bet)
Seat 5: ZhukOFFskI folded before Flop (didn't bet)
Seat 6: 1Karina1 folded before Flop (didn't bet)
Seat 7: Sal y Limon1 folded before Flop (didn't bet)
Seat 8: Gichboy mucked [Jc Ah]
Seat 9: el pore 5 folded before Flop (didn't bet)



PokerStars Zoom Hand #84300212723:  Hold'em No Limit ($0.10/$0.25) - 2012/08/05 15:13:08 JST [2012/08/05 2:13:08 ET]
Table 'Whirlpool' 9-max Seat #1 is the button
Seat 1: kamikkaze ($12.85 in chips) 
Seat 2: Perstenev ($14.16 in chips) 
Seat 3: PAMBOS.L ($20.40 in chips) 
Seat 4: hirozo ($80.91 in chips) 
Seat 5: chiyuki ($29.81 in chips) 
Seat 6: ygoegoe ($31.02 in chips) 
Seat 7: GovGus ($34.50 in chips) 
Seat 8: ChrisCDee ($45.71 in chips) 
Seat 9: snejokCoxx ($11.79 in chips) 
Perstenev: posts small blind $0.10
PAMBOS.L: posts big blind $0.25
*** HOLE CARDS ***
Dealt to chiyuki [3d 9d]
hirozo: folds 
chiyuki: folds 
ygoegoe: folds 
GovGus: folds 
ChrisCDee: folds 
snejokCoxx: folds 
kamikkaze: folds 
Perstenev: folds 
Uncalled bet ($0.15) returned to PAMBOS.L
PAMBOS.L collected $0.20 from pot
PAMBOS.L: doesn't show hand 
*** SUMMARY ***
Total pot $0.20 | Rake $0 
Seat 1: kamikkaze (button) folded before Flop (didn't bet)
Seat 2: Perstenev (small blind) folded before Flop
Seat 3: PAMBOS.L (big blind) collected ($0.20)
Seat 4: hirozo folded before Flop (didn't bet)
Seat 5: chiyuki folded before Flop (didn't bet)
Seat 6: ygoegoe folded before Flop (didn't bet)
Seat 7: GovGus folded before Flop (didn't bet)
Seat 8: ChrisCDee folded before Flop (didn't bet)
Seat 9: snejokCoxx folded before Flop (didn't bet)



PokerStars Zoom Hand #84300214479:  Hold'em No Limit ($0.10/$0.25) - 2012/08/05 15:13:15 JST [2012/08/05 2:13:15 ET]
Table 'Whirlpool' 9-max Seat #1 is the button
Seat 1: phate-1up ($53.65 in chips) 
Seat 2: Alvinpe85 ($45.50 in chips) 
Seat 3: chiyuki ($29.81 in chips) 
Seat 4: masterkoolb ($12.50 in chips) 
Seat 5: ChrisCDee ($25.72 in chips) 
Seat 6: risekuku468 ($36.77 in chips) 
Seat 7: Saruotiss ($46.18 in chips) 
Seat 8: snejokCoxx ($10.03 in chips) 
Seat 9: Dejacob ($25 in chips) 
Alvinpe85: posts small blind $0.10
chiyuki: posts big blind $0.25
*** HOLE CARDS ***
Dealt to chiyuki [3s 9c]
masterkoolb: folds 
ChrisCDee: folds 
risekuku468: folds 
Saruotiss: raises $0.50 to $0.75
snejokCoxx: folds 
Dejacob: folds 
phate-1up: folds 
Alvinpe85: folds 
chiyuki: folds 
Uncalled bet ($0.50) returned to Saruotiss
Saruotiss collected $0.60 from pot
Saruotiss: doesn't show hand 
*** SUMMARY ***
Total pot $0.60 | Rake $0 
Seat 1: phate-1up (button) folded before Flop (didn't bet)
Seat 2: Alvinpe85 (small blind) folded before Flop
Seat 3: chiyuki (big blind) folded before Flop
Seat 4: masterkoolb folded before Flop (didn't bet)
Seat 5: ChrisCDee folded before Flop (didn't bet)
Seat 6: risekuku468 folded before Flop (didn't bet)
Seat 7: Saruotiss collected ($0.60)
Seat 8: snejokCoxx folded before Flop (didn't bet)
Seat 9: Dejacob folded before Flop (didn't bet)



PokerStars Zoom Hand #84300219296:  Hold'em No Limit ($0.10/$0.25) - 2012/08/05 15:13:34 JST [2012/08/05 2:13:34 ET]
Table 'Whirlpool' 9-max Seat #1 is the button
Seat 1: troublesomm ($39.69 in chips) 
Seat 2: Roglus ($8.80 in chips) 
Seat 3: kwkim73 ($25 in chips) 
Seat 4: chiyuki ($29.56 in chips) 
Seat 5: JhonnyP1979 ($5.61 in chips) 
Seat 6: INSP!RON ($26.37 in chips) 
Seat 7: seula i ($101.85 in chips) 
Seat 8: deadmoneykid ($32.21 in chips) 
Seat 9: 4ydo yogurt ($39.38 in chips) 
Roglus: posts small blind $0.10
kwkim73: posts big blind $0.25
*** HOLE CARDS ***
Dealt to chiyuki [6d 3h]
chiyuki: folds 
JhonnyP1979: folds 
INSP!RON: raises $0.50 to $0.75
seula i: folds 
deadmoneykid: folds 
4ydo yogurt: folds 
troublesomm: folds 
Roglus: folds 
kwkim73: folds 
Uncalled bet ($0.50) returned to INSP!RON
INSP!RON collected $0.60 from pot
INSP!RON: doesn't show hand 
*** SUMMARY ***
Total pot $0.60 | Rake $0 
Seat 1: troublesomm (button) folded before Flop (didn't bet)
Seat 2: Roglus (small blind) folded before Flop
Seat 3: kwkim73 (big blind) folded before Flop
Seat 4: chiyuki folded before Flop (didn't bet)
Seat 5: JhonnyP1979 folded before Flop (didn't bet)
Seat 6: INSP!RON collected ($0.60)
Seat 7: seula i folded before Flop (didn't bet)
Seat 8: deadmoneykid folded before Flop (didn't bet)
Seat 9: 4ydo yogurt folded before Flop (didn't bet)



PokerStars Zoom Hand #84300211751:  Hold'em No Limit ($0.10/$0.25) - 2012/08/05 15:13:04 JST [2012/08/05 2:13:04 ET]
Table 'Whirlpool' 9-max Seat #1 is the button
Seat 1: Ellen1947 ($21.85 in chips) 
Seat 2: simonzez ($24.62 in chips) 
Seat 3: GovGus ($31.26 in chips) 
Seat 4: chiyuki ($29.81 in chips) 
Seat 5: snejokCoxx ($10.03 in chips) 
Seat 6: kesstukas25 ($12.98 in chips) 
Seat 7: Paranoix1990 ($10.09 in chips) 
Seat 8: KrystalAA ($29.95 in chips) 
Seat 9: Jene4kaBest ($3.09 in chips) 
simonzez: posts small blind $0.10
GovGus: posts big blind $0.25
*** HOLE CARDS ***
Dealt to chiyuki [9d Kh]
chiyuki: folds 
snejokCoxx: folds 
kesstukas25: folds 
Paranoix1990: folds 
KrystalAA: folds 
Jene4kaBest: folds 
Ellen1947: folds 
simonzez: calls $0.15
GovGus: raises $0.75 to $1
simonzez: calls $0.75
*** FLOP *** [Jc 4d Ah]
simonzez: checks 
GovGus: bets $1.25
simonzez: calls $1.25
*** TURN *** [Jc 4d Ah] [Js]
simonzez: checks 
GovGus: bets $2.50
simonzez: folds 
Uncalled bet ($2.50) returned to GovGus
GovGus collected $4.30 from pot
GovGus: doesn't show hand 
*** SUMMARY ***
Total pot $4.50 | Rake $0.20 
Board [Jc 4d Ah Js]
Seat 1: Ellen1947 (button) folded before Flop (didn't bet)
Seat 2: simonzez (small blind) folded on the Turn
Seat 3: GovGus (big blind) collected ($4.30)
Seat 4: chiyuki folded before Flop (didn't bet)
Seat 5: snejokCoxx folded before Flop (didn't bet)
Seat 6: kesstukas25 folded before Flop (didn't bet)
Seat 7: Paranoix1990 folded before Flop (didn't bet)
Seat 8: KrystalAA folded before Flop (didn't bet)
Seat 9: Jene4kaBest folded before Flop (didn't bet)



PokerStars Zoom Hand #84300224156:  Hold'em No Limit ($0.10/$0.25) - 2012/08/05 15:13:54 JST [2012/08/05 2:13:54 ET]
Table 'Whirlpool' 9-max Seat #1 is the button
Seat 1: svg51 ($13.82 in chips) 
Seat 2: chiyuki ($29.56 in chips) 
Seat 3: Dejacob ($42.32 in chips) 
Seat 4: masterkoolb ($12.50 in chips) 
Seat 5: DutchShultzs ($34.33 in chips) 
Seat 6: troublesomm ($25 in chips) 
Seat 7: kwkim73 ($25 in chips) 
Seat 8: Yoshimac ($12.23 in chips) 
Seat 9: KeLevro0 ($11.75 in chips) 
chiyuki: posts small blind $0.10
Dejacob: posts big blind $0.25
*** HOLE CARDS ***
Dealt to chiyuki [2s As]
masterkoolb: folds 
DutchShultzs: folds 
troublesomm: folds 
kwkim73: folds 
Yoshimac: folds 
KeLevro0: folds 
svg51: folds 
chiyuki: raises $0.50 to $0.75
Dejacob: calls $0.50
*** FLOP *** [Ad Qc 5h]
chiyuki: checks 
Dejacob: checks 
*** TURN *** [Ad Qc 5h] [7c]
chiyuki: bets $0.71
Dejacob: folds 
Uncalled bet ($0.71) returned to chiyuki
chiyuki collected $1.43 from pot
chiyuki: doesn't show hand 
*** SUMMARY ***
Total pot $1.50 | Rake $0.07 
Board [Ad Qc 5h 7c]
Seat 1: svg51 (button) folded before Flop (didn't bet)
Seat 2: chiyuki (small blind) collected ($1.43)
Seat 3: Dejacob (big blind) folded on the Turn
Seat 4: masterkoolb folded before Flop (didn't bet)
Seat 5: DutchShultzs folded before Flop (didn't bet)
Seat 6: troublesomm folded before Flop (didn't bet)
Seat 7: kwkim73 folded before Flop (didn't bet)
Seat 8: Yoshimac folded before Flop (didn't bet)
Seat 9: KeLevro0 folded before Flop (didn't bet)



PokerStars Zoom Hand #84300221585:  Hold'em No Limit ($0.10/$0.25) - 2012/08/05 15:13:44 JST [2012/08/05 2:13:44 ET]
Table 'Whirlpool' 9-max Seat #1 is the button
Seat 1: Sal y Limon1 ($24.75 in chips) 
Seat 2: kamikkaze ($12.60 in chips) 
Seat 3: Rilko1975 ($31.51 in chips) 
Seat 4: phate-1up ($25.25 in chips) 
Seat 5: 4plankton ($18.94 in chips) 
Seat 6: DutchShultzs ($25 in chips) 
Seat 7: GovGus ($26.02 in chips) 
Seat 8: KrystalAA ($21.21 in chips) 
Seat 9: chiyuki ($29.56 in chips) 
kamikkaze: posts small blind $0.10
Rilko1975: posts big blind $0.25
*** HOLE CARDS ***
Dealt to chiyuki [3s Kc]
phate-1up: folds 
4plankton: folds 
DutchShultzs: folds 
GovGus: folds 
KrystalAA: folds 
chiyuki: folds 
Sal y Limon1: raises $0.35 to $0.60
kamikkaze: calls $0.50
Rilko1975: calls $0.35
*** FLOP *** [Qs 8h Qh]
kamikkaze: checks 
Rilko1975: bets $0.75
Sal y Limon1: folds 
kamikkaze: folds 
Uncalled bet ($0.75) returned to Rilko1975
Rilko1975 collected $1.72 from pot
Rilko1975: doesn't show hand 
*** SUMMARY ***
Total pot $1.80 | Rake $0.08 
Board [Qs 8h Qh]
Seat 1: Sal y Limon1 (button) folded on the Flop
Seat 2: kamikkaze (small blind) folded on the Flop
Seat 3: Rilko1975 (big blind) collected ($1.72)
Seat 4: phate-1up folded before Flop (didn't bet)
Seat 5: 4plankton folded before Flop (didn't bet)
Seat 6: DutchShultzs folded before Flop (didn't bet)
Seat 7: GovGus folded before Flop (didn't bet)
Seat 8: KrystalAA folded before Flop (didn't bet)
Seat 9: chiyuki folded before Flop (didn't bet)



PokerStars Zoom Hand #84300223159:  Hold'em No Limit ($0.10/$0.25) - 2012/08/05 15:13:50 JST [2012/08/05 2:13:50 ET]
Table 'Whirlpool' 9-max Seat #1 is the button
Seat 1: chiyuki ($29.56 in chips) 
Seat 2: DPsemplic ($6.16 in chips) 
Seat 3: womble32 ($26.46 in chips) 
Seat 4: masterkoolb ($12.50 in chips) 
Seat 5: troublesomm ($25 in chips) 
Seat 6: puffy5533 ($24.65 in chips) 
Seat 7: 4ydo yogurt ($39.38 in chips) 
Seat 8: Alvinpe85 ($41.72 in chips) 
Seat 9: GravyWalrus ($11.81 in chips) 
DPsemplic: posts small blind $0.10
womble32: posts big blind $0.25
*** HOLE CARDS ***
Dealt to chiyuki [Qs 5d]
masterkoolb: folds 
troublesomm: folds 
puffy5533: folds 
4ydo yogurt: raises $0.50 to $0.75
Alvinpe85: raises $1.50 to $2.25
GravyWalrus: folds 
chiyuki: folds 
DPsemplic: calls $2.15
womble32: folds 
4ydo yogurt: folds 
*** FLOP *** [6c Th Ah]
DPsemplic: checks 
Alvinpe85: bets $3.15
DPsemplic: raises $0.76 to $3.91 and is all-in
Alvinpe85: calls $0.76
*** TURN *** [6c Th Ah] [9c]
*** RIVER *** [6c Th Ah 9c] [7d]
*** SHOW DOWN ***
DPsemplic: shows [Qc Qd] (a pair of Queens)
Alvinpe85: shows [Ad Ac] (three of a kind, Aces)
Alvinpe85 collected $12.72 from pot
*** SUMMARY ***
Total pot $13.32 | Rake $0.60 
Board [6c Th Ah 9c 7d]
Seat 1: chiyuki (button) folded before Flop (didn't bet)
Seat 2: DPsemplic (small blind) showed [Qc Qd] and lost with a pair of Queens
Seat 3: womble32 (big blind) folded before Flop
Seat 4: masterkoolb folded before Flop (didn't bet)
Seat 5: troublesomm folded before Flop (didn't bet)
Seat 6: puffy5533 folded before Flop (didn't bet)
Seat 7: 4ydo yogurt folded before Flop
Seat 8: Alvinpe85 showed [Ad Ac] and won ($12.72) with three of a kind, Aces
Seat 9: GravyWalrus folded before Flop (didn't bet)



PokerStars Zoom Hand #84300222348:  Hold'em No Limit ($0.10/$0.25) - 2012/08/05 15:13:47 JST [2012/08/05 2:13:47 ET]
Table 'Whirlpool' 9-max Seat #1 is the button
Seat 1: INSP!RON ($31.10 in chips) 
Seat 2: yane73 ($42.98 in chips) 
Seat 3: Tom1999 ($20.72 in chips) 
Seat 4: seula i ($101.85 in chips) 
Seat 5: Roglus ($8.70 in chips) 
Seat 6: chiyuki ($29.56 in chips) 
Seat 7: KeLevro0 ($11.75 in chips) 
Seat 8: pandaaaaaa ($9.72 in chips) 
Seat 9: hirozo ($46.37 in chips) 
yane73: posts small blind $0.10
Tom1999: posts big blind $0.25
*** HOLE CARDS ***
Dealt to chiyuki [6s 8s]
seula i: folds 
Roglus: folds 
chiyuki: folds 
KeLevro0: folds 
pandaaaaaa: folds 
hirozo: folds 
INSP!RON: raises $0.35 to $0.60
yane73: raises $0.65 to $1.25
Tom1999: calls $1
INSP!RON: calls $0.65
*** FLOP *** [3d 8d 2h]
yane73: bets $3.75
Tom1999: calls $3.75
INSP!RON: folds 
*** TURN *** [3d 8d 2h] [Jd]
yane73: bets $8.25
Tom1999: raises $7.47 to $15.72 and is all-in
yane73: calls $7.47
*** RIVER *** [3d 8d 2h Jd] [3s]
*** SHOW DOWN ***
yane73: shows [Qh Ah] (a pair of Threes)
Tom1999: shows [9h 9s] (two pair, Nines and Threes)
Tom1999 collected $40.77 from pot
*** SUMMARY ***
Total pot $42.69 | Rake $1.92 
Board [3d 8d 2h Jd 3s]
Seat 1: INSP!RON (button) folded on the Flop
Seat 2: yane73 (small blind) showed [Qh Ah] and lost with a pair of Threes
Seat 3: Tom1999 (big blind) showed [9h 9s] and won ($40.77) with two pair, Nines and Threes
Seat 4: seula i folded before Flop (didn't bet)
Seat 5: Roglus folded before Flop (didn't bet)
Seat 6: chiyuki folded before Flop (didn't bet)
Seat 7: KeLevro0 folded before Flop (didn't bet)
Seat 8: pandaaaaaa folded before Flop (didn't bet)
Seat 9: hirozo folded before Flop (didn't bet)



PokerStars Zoom Hand #84300220304:  Hold'em No Limit ($0.10/$0.25) - 2012/08/05 15:13:38 JST [2012/08/05 2:13:38 ET]
Table 'Whirlpool' 9-max Seat #1 is the button
Seat 1: jacquelinewu ($38 in chips) 
Seat 2: ZhukOFFskI ($37.83 in chips) 
Seat 3: snejokCoxx ($11.15 in chips) 
Seat 4: Rilko1975 ($31.51 in chips) 
Seat 5: Dejacob ($25 in chips) 
Seat 6: WARIBANA7777 ($17.11 in chips) 
Seat 7: chiyuki ($29.56 in chips) 
Seat 8: seula i ($101.85 in chips) 
Seat 9: 1Karina1 ($30.11 in chips) 
ZhukOFFskI: posts small blind $0.10
snejokCoxx: posts big blind $0.25
*** HOLE CARDS ***
Dealt to chiyuki [3h 2h]
Rilko1975: folds 
Dejacob: folds 
WARIBANA7777: folds 
chiyuki: folds 
seula i: folds 
1Karina1: raises $0.50 to $0.75
jacquelinewu: folds 
ZhukOFFskI: calls $0.65
snejokCoxx: folds 
*** FLOP *** [4s 5s 5d]
ZhukOFFskI: checks 
1Karina1: bets $1.25
ZhukOFFskI: raises $1.75 to $3
1Karina1: calls $1.75
*** TURN *** [4s 5s 5d] [7c]
ZhukOFFskI: bets $4.44
1Karina1: calls $4.44
*** RIVER *** [4s 5s 5d 7c] [2d]
ZhukOFFskI: checks 
1Karina1: checks 
*** SHOW DOWN ***
ZhukOFFskI: shows [Qh Ad] (a pair of Fives)
1Karina1: shows [Qc Qd] (two pair, Queens and Fives)
1Karina1 collected $15.88 from pot
*** SUMMARY ***
Total pot $16.63 | Rake $0.75 
Board [4s 5s 5d 7c 2d]
Seat 1: jacquelinewu (button) folded before Flop (didn't bet)
Seat 2: ZhukOFFskI (small blind) showed [Qh Ad] and lost with a pair of Fives
Seat 3: snejokCoxx (big blind) folded before Flop
Seat 4: Rilko1975 folded before Flop (didn't bet)
Seat 5: Dejacob folded before Flop (didn't bet)
Seat 6: WARIBANA7777 folded before Flop (didn't bet)
Seat 7: chiyuki folded before Flop (didn't bet)
Seat 8: seula i folded before Flop (didn't bet)
Seat 9: 1Karina1 showed [Qc Qd] and won ($15.88) with two pair, Queens and Fives



PokerStars Zoom Hand #84300231507:  Hold'em No Limit ($0.10/$0.25) - 2012/08/05 15:14:23 JST [2012/08/05 2:14:23 ET]
Table 'Whirlpool' 9-max Seat #1 is the button
Seat 1: Silveystryk ($22.84 in chips) 
Seat 2: jacquelinewu ($25.96 in chips) 
Seat 3: chiyuki ($30.24 in chips) 
Seat 4: 4plankton ($19.65 in chips) 
Seat 5: Dejacob ($25.77 in chips) 
Seat 6: Perstenev ($12.92 in chips) 
Seat 7: DutchShultzs ($32.64 in chips) 
Seat 8: seula i ($28.76 in chips) 
Seat 9: ChrisCDee ($25.47 in chips) 
jacquelinewu: posts small blind $0.10
chiyuki: posts big blind $0.25
*** HOLE CARDS ***
Dealt to chiyuki [Ks Qs]
4plankton: folds 
Dejacob: folds 
Perstenev: folds 
DutchShultzs: raises $0.50 to $0.75
seula i: folds 
ChrisCDee: folds 
Silveystryk: folds 
jacquelinewu: folds 
chiyuki: calls $0.50
*** FLOP *** [5d 2s 3h]
chiyuki: checks 
DutchShultzs: bets $1.20
chiyuki: folds 
Uncalled bet ($1.20) returned to DutchShultzs
DutchShultzs collected $1.53 from pot
DutchShultzs: doesn't show hand 
*** SUMMARY ***
Total pot $1.60 | Rake $0.07 
Board [5d 2s 3h]
Seat 1: Silveystryk (button) folded before Flop (didn't bet)
Seat 2: jacquelinewu (small blind) folded before Flop
Seat 3: chiyuki (big blind) folded on the Flop
Seat 4: 4plankton folded before Flop (didn't bet)
Seat 5: Dejacob folded before Flop (didn't bet)
Seat 6: Perstenev folded before Flop (didn't bet)
Seat 7: DutchShultzs collected ($1.53)
Seat 8: seula i folded before Flop (didn't bet)
Seat 9: ChrisCDee folded before Flop (didn't bet)



PokerStars Zoom Hand #84300243254:  Hold'em No Limit ($0.10/$0.25) - 2012/08/05 15:15:10 JST [2012/08/05 2:15:10 ET]
Table 'Whirlpool' 9-max Seat #1 is the button
Seat 1: GovGus ($25.67 in chips) 
Seat 2: River_GmbH ($15.04 in chips) 
Seat 3: Jene4kaBest ($12.15 in chips) 
Seat 4: dushvan ($32.94 in chips) 
Seat 5: Dejacob ($41.47 in chips) 
Seat 6: chiyuki ($29.49 in chips) 
Seat 7: silvno31 ($28.59 in chips) 
Seat 8: kwkim73 ($25 in chips) 
Seat 9: KrystalAA ($21.31 in chips) 
River_GmbH: posts small blind $0.10
Jene4kaBest: posts big blind $0.25
*** HOLE CARDS ***
Dealt to chiyuki [2d 4c]
dushvan: folds 
Dejacob: raises $0.50 to $0.75
chiyuki: folds 
silvno31: folds 
kwkim73: folds 
KrystalAA: calls $0.75
GovGus: folds 
River_GmbH: folds 
Jene4kaBest: folds 
*** FLOP *** [3c 3d 9c]
Dejacob: bets $1
KrystalAA: folds 
Uncalled bet ($1) returned to Dejacob
Dejacob collected $1.77 from pot
Dejacob: doesn't show hand 
*** SUMMARY ***
Total pot $1.85 | Rake $0.08 
Board [3c 3d 9c]
Seat 1: GovGus (button) folded before Flop (didn't bet)
Seat 2: River_GmbH (small blind) folded before Flop
Seat 3: Jene4kaBest (big blind) folded before Flop
Seat 4: dushvan folded before Flop (didn't bet)
Seat 5: Dejacob collected ($1.77)
Seat 6: chiyuki folded before Flop (didn't bet)
Seat 7: silvno31 folded before Flop (didn't bet)
Seat 8: kwkim73 folded before Flop (didn't bet)
Seat 9: KrystalAA folded on the Flop



PokerStars Zoom Hand #84300248111:  Hold'em No Limit ($0.10/$0.25) - 2012/08/05 15:15:29 JST [2012/08/05 2:15:29 ET]
Table 'Whirlpool' 9-max Seat #1 is the button
Seat 1: nastya040 ($18.37 in chips) 
Seat 2: deadmoneykid ($31.34 in chips) 
Seat 3: Gichboy ($27.32 in chips) 
Seat 4: Sal y Limon1 ($26.58 in chips) 
Seat 5: snejokCoxx ($11.44 in chips) 
Seat 6: ZhukOFFskI ($47.45 in chips) 
Seat 7: phate-1up ($29.07 in chips) 
Seat 8: chiyuki ($29.49 in chips) 
Seat 9: 1Karina1 ($29.38 in chips) 
deadmoneykid: posts small blind $0.10
Gichboy: posts big blind $0.25
*** HOLE CARDS ***
Dealt to chiyuki [Kd 7d]
Sal y Limon1: folds 
snejokCoxx: folds 
ZhukOFFskI: raises $0.50 to $0.75
phate-1up: folds 
chiyuki: folds 
1Karina1: folds 
nastya040: folds 
deadmoneykid: folds 
Gichboy: folds 
Uncalled bet ($0.50) returned to ZhukOFFskI
ZhukOFFskI collected $0.60 from pot
ZhukOFFskI: doesn't show hand 
*** SUMMARY ***
Total pot $0.60 | Rake $0 
Seat 1: nastya040 (button) folded before Flop (didn't bet)
Seat 2: deadmoneykid (small blind) folded before Flop
Seat 3: Gichboy (big blind) folded before Flop
Seat 4: Sal y Limon1 folded before Flop (didn't bet)
Seat 5: snejokCoxx folded before Flop (didn't bet)
Seat 6: ZhukOFFskI collected ($0.60)
Seat 7: phate-1up folded before Flop (didn't bet)
Seat 8: chiyuki folded before Flop (didn't bet)
Seat 9: 1Karina1 folded before Flop (didn't bet)



PokerStars Zoom Hand #84300248891:  Hold'em No Limit ($0.10/$0.25) - 2012/08/05 15:15:32 JST [2012/08/05 2:15:32 ET]
Table 'Whirlpool' 9-max Seat #1 is the button
Seat 1: troublesomm ($25.30 in chips) 
Seat 2: DutchShultzs ($41.13 in chips) 
Seat 3: mjmichi ($36.29 in chips) 
Seat 4: WARIBANA7777 ($17.54 in chips) 
Seat 5: chiyuki ($29.49 in chips) 
Seat 6: GovGus ($35.35 in chips) 
Seat 7: KrystalAA ($26.85 in chips) 
Seat 8: d8hetniet ($14.14 in chips) 
Seat 9: kamikkaze ($16.58 in chips) 
DutchShultzs: posts small blind $0.10
mjmichi: posts big blind $0.25
*** HOLE CARDS ***
Dealt to chiyuki [8c 8h]
WARIBANA7777: folds 
chiyuki: folds 
GovGus: folds 
KrystalAA: folds 
d8hetniet: raises $0.50 to $0.75
kamikkaze: folds 
troublesomm: folds 
DutchShultzs: folds 
mjmichi: folds 
Uncalled bet ($0.50) returned to d8hetniet
d8hetniet collected $0.60 from pot
d8hetniet: doesn't show hand 
*** SUMMARY ***
Total pot $0.60 | Rake $0 
Seat 1: troublesomm (button) folded before Flop (didn't bet)
Seat 2: DutchShultzs (small blind) folded before Flop
Seat 3: mjmichi (big blind) folded before Flop
Seat 4: WARIBANA7777 folded before Flop (didn't bet)
Seat 5: chiyuki folded before Flop (didn't bet)
Seat 6: GovGus folded before Flop (didn't bet)
Seat 7: KrystalAA folded before Flop (didn't bet)
Seat 8: d8hetniet collected ($0.60)
Seat 9: kamikkaze folded before Flop (didn't bet)



PokerStars Zoom Hand #84300245020:  Hold'em No Limit ($0.10/$0.25) - 2012/08/05 15:15:17 JST [2012/08/05 2:15:17 ET]
Table 'Whirlpool' 9-max Seat #1 is the button
Seat 1: Ellen1947 ($24.25 in chips) 
Seat 2: hirozo ($74.46 in chips) 
Seat 3: GovGus ($33.31 in chips) 
Seat 4: ZhukOFFskI ($29.39 in chips) 
Seat 5: KeLevro0 ($11.40 in chips) 
Seat 6: mid22 ($16.18 in chips) 
Seat 7: kwkim73 ($25 in chips) 
Seat 8: Littlea029 ($30.76 in chips) 
Seat 9: chiyuki ($29.49 in chips) 
hirozo: posts small blind $0.10
GovGus: posts big blind $0.25
*** HOLE CARDS ***
Dealt to chiyuki [Ks Qc]
ZhukOFFskI: folds 
KeLevro0: folds 
mid22: calls $0.25
kwkim73: folds 
Littlea029: folds 
chiyuki: folds 
Ellen1947: raises $0.37 to $0.62
hirozo: folds 
GovGus: folds 
mid22: calls $0.37
*** FLOP *** [7s 6c 8s]
mid22: checks 
Ellen1947: bets $1.14
mid22: calls $1.14
*** TURN *** [7s 6c 8s] [7c]
mid22: checks 
Ellen1947: checks 
*** RIVER *** [7s 6c 8s 7c] [Ac]
mid22: bets $0.50
Ellen1947: calls $0.50
*** SHOW DOWN ***
mid22: shows [Ad 9h] (two pair, Aces and Sevens)
Ellen1947: mucks hand 
mid22 collected $4.65 from pot
*** SUMMARY ***
Total pot $4.87 | Rake $0.22 
Board [7s 6c 8s 7c Ac]
Seat 1: Ellen1947 (button) mucked [9s 9c]
Seat 2: hirozo (small blind) folded before Flop
Seat 3: GovGus (big blind) folded before Flop
Seat 4: ZhukOFFskI folded before Flop (didn't bet)
Seat 5: KeLevro0 folded before Flop (didn't bet)
Seat 6: mid22 showed [Ad 9h] and won ($4.65) with two pair, Aces and Sevens
Seat 7: kwkim73 folded before Flop (didn't bet)
Seat 8: Littlea029 folded before Flop (didn't bet)
Seat 9: chiyuki folded before Flop (didn't bet)



PokerStars Zoom Hand #84300252151:  Hold'em No Limit ($0.10/$0.25) - 2012/08/05 15:15:45 JST [2012/08/05 2:15:45 ET]
Table 'Whirlpool' 9-max Seat #1 is the button
Seat 1: Perstenev ($12.57 in chips) 
Seat 2: GovGus ($33.06 in chips) 
Seat 3: Sal y Limon1 ($26.58 in chips) 
Seat 4: Dejacob ($25 in chips) 
Seat 5: DutchShultzs ($25.40 in chips) 
Seat 6: hirozo ($80.66 in chips) 
Seat 7: chiyuki ($29.49 in chips) 
Seat 8: masterkoolb ($12.50 in chips) 
Seat 9: Gichboy ($12.75 in chips) 
GovGus: posts small blind $0.10
Sal y Limon1: posts big blind $0.25
*** HOLE CARDS ***
Dealt to chiyuki [4s 8h]
Dejacob: folds 
DutchShultzs: folds 
hirozo: folds 
chiyuki: folds 
masterkoolb: folds 
Gichboy: folds 
Perstenev: folds 
GovGus: raises $0.50 to $0.75
Sal y Limon1: folds 
Uncalled bet ($0.50) returned to GovGus
GovGus collected $0.50 from pot
GovGus: doesn't show hand 
*** SUMMARY ***
Total pot $0.50 | Rake $0 
Seat 1: Perstenev (button) folded before Flop (didn't bet)
Seat 2: GovGus (small blind) collected ($0.50)
Seat 3: Sal y Limon1 (big blind) folded before Flop
Seat 4: Dejacob folded before Flop (didn't bet)
Seat 5: DutchShultzs folded before Flop (didn't bet)
Seat 6: hirozo folded before Flop (didn't bet)
Seat 7: chiyuki folded before Flop (didn't bet)
Seat 8: masterkoolb folded before Flop (didn't bet)
Seat 9: Gichboy folded before Flop (didn't bet)



PokerStars Zoom Hand #84300253165:  Hold'em No Limit ($0.10/$0.25) - 2012/08/05 15:15:49 JST [2012/08/05 2:15:49 ET]
Table 'Whirlpool' 9-max Seat #1 is the button
Seat 1: chiyuki ($29.49 in chips) 
Seat 2: Dejacob ($25 in chips) 
Seat 3: ygoegoe ($30.67 in chips) 
Seat 4: silvno31 ($28.34 in chips) 
Seat 5: grand maitre ($24.40 in chips) 
Seat 6: hirozo ($32.85 in chips) 
Seat 7: seula i ($95.85 in chips) 
Seat 8: Rilko1975 ($24.65 in chips) 
Seat 9: laurentzu84 ($28.13 in chips) 
Dejacob: posts small blind $0.10
ygoegoe: posts big blind $0.25
*** HOLE CARDS ***
Dealt to chiyuki [5d 6h]
silvno31: raises $0.50 to $0.75
grand maitre: folds 
hirozo: folds 
seula i: folds 
Rilko1975: folds 
laurentzu84: calls $0.75
chiyuki: folds 
Dejacob: folds 
ygoegoe: folds 
*** FLOP *** [9s Jc Ah]
silvno31: checks 
laurentzu84: bets $0.75
silvno31: calls $0.75
*** TURN *** [9s Jc Ah] [Kh]
silvno31: checks 
laurentzu84: bets $2.50
silvno31: folds 
Uncalled bet ($2.50) returned to laurentzu84
laurentzu84 collected $3.20 from pot
laurentzu84: doesn't show hand 
*** SUMMARY ***
Total pot $3.35 | Rake $0.15 
Board [9s Jc Ah Kh]
Seat 1: chiyuki (button) folded before Flop (didn't bet)
Seat 2: Dejacob (small blind) folded before Flop
Seat 3: ygoegoe (big blind) folded before Flop
Seat 4: silvno31 folded on the Turn
Seat 5: grand maitre folded before Flop (didn't bet)
Seat 6: hirozo folded before Flop (didn't bet)
Seat 7: seula i folded before Flop (didn't bet)
Seat 8: Rilko1975 folded before Flop (didn't bet)
Seat 9: laurentzu84 collected ($3.20)



PokerStars Zoom Hand #84300259476:  Hold'em No Limit ($0.10/$0.25) - 2012/08/05 15:16:15 JST [2012/08/05 2:16:15 ET]
Table 'Whirlpool' 9-max Seat #1 is the button
Seat 1: mid22 ($18.57 in chips) 
Seat 2: chiyuki ($29.49 in chips) 
Seat 3: DutchShultzs ($41.03 in chips) 
Seat 4: phate-1up ($28.97 in chips) 
Seat 5: nastya040 ($18.37 in chips) 
Seat 6: KrystalAA ($20.46 in chips) 
Seat 7: Alvinpe85 ($50.10 in chips) 
Seat 8: DanielWhyte ($67.66 in chips) 
Seat 9: colorado2108 ($37.06 in chips) 
chiyuki: posts small blind $0.10
DutchShultzs: posts big blind $0.25
*** HOLE CARDS ***
Dealt to chiyuki [4d 8c]
phate-1up: raises $0.50 to $0.75
nastya040: folds 
KrystalAA: folds 
Alvinpe85: folds 
DanielWhyte: folds 
colorado2108: folds 
mid22: folds 
chiyuki: folds 
DutchShultzs: folds 
Uncalled bet ($0.50) returned to phate-1up
phate-1up collected $0.60 from pot
phate-1up: doesn't show hand 
*** SUMMARY ***
Total pot $0.60 | Rake $0 
Seat 1: mid22 (button) folded before Flop (didn't bet)
Seat 2: chiyuki (small blind) folded before Flop
Seat 3: DutchShultzs (big blind) folded before Flop
Seat 4: phate-1up collected ($0.60)
Seat 5: nastya040 folded before Flop (didn't bet)
Seat 6: KrystalAA folded before Flop (didn't bet)
Seat 7: Alvinpe85 folded before Flop (didn't bet)
Seat 8: DanielWhyte folded before Flop (didn't bet)
Seat 9: colorado2108 folded before Flop (didn't bet)



PokerStars Zoom Hand #84300260512:  Hold'em No Limit ($0.10/$0.25) - 2012/08/05 15:16:19 JST [2012/08/05 2:16:19 ET]
Table 'Whirlpool' 9-max Seat #1 is the button
Seat 1: turbotom122 ($27.22 in chips) 
Seat 2: fima00000007 ($12.60 in chips) 
Seat 3: chiyuki ($29.39 in chips) 
Seat 4: HighDuka ($27.18 in chips) 
Seat 5: mid22 ($18.57 in chips) 
Seat 6: troublesomm ($25.05 in chips) 
Seat 7: jacquelinewu ($36.10 in chips) 
Seat 8: deadmoneykid ($26.87 in chips) 
Seat 9: Lasutchik ($74.71 in chips) 
fima00000007: posts small blind $0.10
chiyuki: posts big blind $0.25
*** HOLE CARDS ***
Dealt to chiyuki [Jd Ks]
HighDuka: folds 
mid22: folds 
troublesomm: folds 
jacquelinewu: folds 
deadmoneykid: folds 
Lasutchik: folds 
turbotom122: folds 
fima00000007: folds 
Uncalled bet ($0.15) returned to chiyuki
chiyuki collected $0.20 from pot
chiyuki: doesn't show hand 
*** SUMMARY ***
Total pot $0.20 | Rake $0 
Seat 1: turbotom122 (button) folded before Flop (didn't bet)
Seat 2: fima00000007 (small blind) folded before Flop
Seat 3: chiyuki (big blind) collected ($0.20)
Seat 4: HighDuka folded before Flop (didn't bet)
Seat 5: mid22 folded before Flop (didn't bet)
Seat 6: troublesomm folded before Flop (didn't bet)
Seat 7: jacquelinewu folded before Flop (didn't bet)
Seat 8: deadmoneykid folded before Flop (didn't bet)
Seat 9: Lasutchik folded before Flop (didn't bet)



PokerStars Zoom Hand #84300254456:  Hold'em No Limit ($0.10/$0.25) - 2012/08/05 15:15:54 JST [2012/08/05 2:15:54 ET]
Table 'Whirlpool' 9-max Seat #1 is the button
Seat 1: phate-1up ($52.71 in chips) 
Seat 2: ChrisCDee ($44.86 in chips) 
Seat 3: kamikkaze ($12.50 in chips) 
Seat 4: chiyuki ($29.49 in chips) 
Seat 5: deadmoneykid ($24.31 in chips) 
Seat 6: Yoshimac ($17.51 in chips) 
Seat 7: KeLevro0 ($8.08 in chips) 
Seat 8: slapshot2011 ($25.47 in chips) 
Seat 9: grand maitre ($24.40 in chips) 
ChrisCDee: posts small blind $0.10
kamikkaze: posts big blind $0.25
*** HOLE CARDS ***
Dealt to chiyuki [4h 5c]
chiyuki: folds 
deadmoneykid: folds 
Yoshimac: raises $0.50 to $0.75
KeLevro0: folds 
slapshot2011: folds 
grand maitre: folds 
phate-1up: folds 
ChrisCDee: folds 
kamikkaze: raises $11.75 to $12.50 and is all-in
Yoshimac: calls $11.75
*** FLOP *** [7s 4c 9c]
*** TURN *** [7s 4c 9c] [6s]
*** RIVER *** [7s 4c 9c 6s] [2c]
*** SHOW DOWN ***
kamikkaze: shows [Js Jd] (a pair of Jacks)
Yoshimac: shows [9d 9s] (three of a kind, Nines)
Yoshimac collected $23.97 from pot
*** SUMMARY ***
Total pot $25.10 | Rake $1.13 
Board [7s 4c 9c 6s 2c]
Seat 1: phate-1up (button) folded before Flop (didn't bet)
Seat 2: ChrisCDee (small blind) folded before Flop
Seat 3: kamikkaze (big blind) showed [Js Jd] and lost with a pair of Jacks
Seat 4: chiyuki folded before Flop (didn't bet)
Seat 5: deadmoneykid folded before Flop (didn't bet)
Seat 6: Yoshimac showed [9d 9s] and won ($23.97) with three of a kind, Nines
Seat 7: KeLevro0 folded before Flop (didn't bet)
Seat 8: slapshot2011 folded before Flop (didn't bet)
Seat 9: grand maitre folded before Flop (didn't bet)



PokerStars Zoom Hand #84300257996:  Hold'em No Limit ($0.10/$0.25) - 2012/08/05 15:16:09 JST [2012/08/05 2:16:09 ET]
Table 'Whirlpool' 9-max Seat #1 is the button
Seat 1: PAMBOS.L ($18.25 in chips) 
Seat 2: moku36 ($19.36 in chips) 
Seat 3: slapshot2011 ($25.47 in chips) 
Seat 4: nastya040 ($18.37 in chips) 
Seat 5: WARIBANA7777 ($17.44 in chips) 
Seat 6: chiyuki ($29.49 in chips) 
Seat 7: 4plankton ($18.20 in chips) 
Seat 8: Silveystryk ($17.48 in chips) 
Seat 9: 1Karina1 ($31.07 in chips) 
moku36: posts small blind $0.10
slapshot2011: posts big blind $0.25
*** HOLE CARDS ***
Dealt to chiyuki [8s Kd]
nastya040: folds 
WARIBANA7777: folds 
chiyuki: folds 
4plankton: calls $0.25
Silveystryk: folds 
1Karina1: folds 
PAMBOS.L: raises $0.35 to $0.60
moku36: calls $0.50
slapshot2011: folds 
4plankton: calls $0.35
*** FLOP *** [Qd Ah 3d]
moku36: bets $1
4plankton: folds 
PAMBOS.L: folds 
Uncalled bet ($1) returned to moku36
moku36 collected $1.96 from pot
moku36: doesn't show hand 
*** SUMMARY ***
Total pot $2.05 | Rake $0.09 
Board [Qd Ah 3d]
Seat 1: PAMBOS.L (button) folded on the Flop
Seat 2: moku36 (small blind) collected ($1.96)
Seat 3: slapshot2011 (big blind) folded before Flop
Seat 4: nastya040 folded before Flop (didn't bet)
Seat 5: WARIBANA7777 folded before Flop (didn't bet)
Seat 6: chiyuki folded before Flop (didn't bet)
Seat 7: 4plankton folded on the Flop
Seat 8: Silveystryk folded before Flop (didn't bet)
Seat 9: 1Karina1 folded before Flop (didn't bet)



PokerStars Zoom Hand #84300269719:  Hold'em No Limit ($0.10/$0.25) - 2012/08/05 15:16:55 JST [2012/08/05 2:16:55 ET]
Table 'Whirlpool' 9-max Seat #1 is the button
Seat 1: pandaaaaaa ($9.67 in chips) 
Seat 2: DutchShultzs ($25 in chips) 
Seat 3: Dejacob ($25.35 in chips) 
Seat 4: jacquelinewu ($36.10 in chips) 
Seat 5: KrystalAA ($20.46 in chips) 
Seat 6: Roglus ($4.25 in chips) 
Seat 7: masterkoolb ($12.50 in chips) 
Seat 8: snejokCoxx ($12.50 in chips) 
Seat 9: chiyuki ($29.49 in chips) 
DutchShultzs: posts small blind $0.10
Dejacob: posts big blind $0.25
*** HOLE CARDS ***
Dealt to chiyuki [2s 2d]
jacquelinewu: folds 
KrystalAA: folds 
Roglus: folds 
masterkoolb: folds 
snejokCoxx: folds 
chiyuki: folds 
pandaaaaaa: folds 
DutchShultzs: folds 
Uncalled bet ($0.15) returned to Dejacob
Dejacob collected $0.20 from pot
Dejacob: doesn't show hand 
*** SUMMARY ***
Total pot $0.20 | Rake $0 
Seat 1: pandaaaaaa (button) folded before Flop (didn't bet)
Seat 2: DutchShultzs (small blind) folded before Flop
Seat 3: Dejacob (big blind) collected ($0.20)
Seat 4: jacquelinewu folded before Flop (didn't bet)
Seat 5: KrystalAA folded before Flop (didn't bet)
Seat 6: Roglus folded before Flop (didn't bet)
Seat 7: masterkoolb folded before Flop (didn't bet)
Seat 8: snejokCoxx folded before Flop (didn't bet)
Seat 9: chiyuki folded before Flop (didn't bet)



PokerStars Zoom Hand #84300249908:  Hold'em No Limit ($0.10/$0.25) - 2012/08/05 15:15:36 JST [2012/08/05 2:15:36 ET]
Table 'Whirlpool' 9-max Seat #1 is the button
Seat 1: jacquelinewu ($26.05 in chips) 
Seat 2: rorfo23 ($18.59 in chips) 
Seat 3: 1Karina1 ($29.38 in chips) 
Seat 4: DutchShultzs ($33.33 in chips) 
Seat 5: chiyuki ($29.49 in chips) 
Seat 6: masterkoolb ($13.06 in chips) 
Seat 7: Nerkit ($10.65 in chips) 
Seat 8: mjmichi ($30.21 in chips) 
Seat 9: Perstenev ($31.30 in chips) 
rorfo23: posts small blind $0.10
1Karina1: posts big blind $0.25
*** HOLE CARDS ***
Dealt to chiyuki [Ac 5h]
DutchShultzs: folds 
chiyuki: folds 
masterkoolb: folds 
Nerkit: folds 
mjmichi: raises $0.50 to $0.75
Perstenev: folds 
jacquelinewu: folds 
rorfo23: calls $0.65
1Karina1: folds 
*** FLOP *** [Ks 2d 6h]
rorfo23: bets $1
mjmichi: calls $1
*** TURN *** [Ks 2d 6h] [Ah]
rorfo23: bets $1
mjmichi: raises $1.50 to $2.50
rorfo23: calls $1.50
*** RIVER *** [Ks 2d 6h Ah] [2h]
rorfo23: bets $1
mjmichi: raises $3 to $4
rorfo23: raises $10.34 to $14.34 and is all-in
mjmichi: calls $10.34
*** SHOW DOWN ***
rorfo23: shows [9s 9h] (two pair, Nines and Deuces)
mjmichi: shows [Th As] (two pair, Aces and Deuces)
mjmichi collected $35.75 from pot
*** SUMMARY ***
Total pot $37.43 | Rake $1.68 
Board [Ks 2d 6h Ah 2h]
Seat 1: jacquelinewu (button) folded before Flop (didn't bet)
Seat 2: rorfo23 (small blind) showed [9s 9h] and lost with two pair, Nines and Deuces
Seat 3: 1Karina1 (big blind) folded before Flop
Seat 4: DutchShultzs folded before Flop (didn't bet)
Seat 5: chiyuki folded before Flop (didn't bet)
Seat 6: masterkoolb folded before Flop (didn't bet)
Seat 7: Nerkit folded before Flop (didn't bet)
Seat 8: mjmichi showed [Th As] and won ($35.75) with two pair, Aces and Deuces
Seat 9: Perstenev folded before Flop (didn't bet)



PokerStars Zoom Hand #84300266378:  Hold'em No Limit ($0.10/$0.25) - 2012/08/05 15:16:42 JST [2012/08/05 2:16:42 ET]
Table 'Whirlpool' 9-max Seat #1 is the button
Seat 1: tribunpdm ($33.97 in chips) 
Seat 2: Roglus ($16.29 in chips) 
Seat 3: Yoshimac ($28.98 in chips) 
Seat 4: ygoegoe ($30.32 in chips) 
Seat 5: snejokCoxx ($12.50 in chips) 
Seat 6: deadmoneykid ($31.59 in chips) 
Seat 7: womble32 ($26.68 in chips) 
Seat 8: chiyuki ($29.49 in chips) 
Seat 9: troublesomm ($35 in chips) 
Roglus: posts small blind $0.10
Yoshimac: posts big blind $0.25
*** HOLE CARDS ***
Dealt to chiyuki [6d 7h]
ygoegoe: folds 
snejokCoxx: folds 
deadmoneykid: folds 
womble32: folds 
chiyuki: folds 
troublesomm: folds 
tribunpdm: folds 
Roglus: raises $0.50 to $0.75
Yoshimac: calls $0.50
*** FLOP *** [Jc 3s Qh]
Roglus: bets $0.97
Yoshimac: calls $0.97
*** TURN *** [Jc 3s Qh] [2d]
Roglus: checks 
Yoshimac: checks 
*** RIVER *** [Jc 3s Qh 2d] [6h]
Roglus: checks 
Yoshimac: bets $2.50
Roglus: folds 
Uncalled bet ($2.50) returned to Yoshimac
Yoshimac collected $3.29 from pot
Yoshimac: doesn't show hand 
*** SUMMARY ***
Total pot $3.44 | Rake $0.15 
Board [Jc 3s Qh 2d 6h]
Seat 1: tribunpdm (button) folded before Flop (didn't bet)
Seat 2: Roglus (small blind) folded on the River
Seat 3: Yoshimac (big blind) collected ($3.29)
Seat 4: ygoegoe folded before Flop (didn't bet)
Seat 5: snejokCoxx folded before Flop (didn't bet)
Seat 6: deadmoneykid folded before Flop (didn't bet)
Seat 7: womble32 folded before Flop (didn't bet)
Seat 8: chiyuki folded before Flop (didn't bet)
Seat 9: troublesomm folded before Flop (didn't bet)



PokerStars Zoom Hand #84300278213:  Hold'em No Limit ($0.10/$0.25) - 2012/08/05 15:17:29 JST [2012/08/05 2:17:29 ET]
Table 'Whirlpool' 9-max Seat #1 is the button
Seat 1: deadmoneykid ($33.86 in chips) 
Seat 2: PetitAlejo ($25 in chips) 
Seat 3: Rici47 ($25 in chips) 
Seat 4: Silveystryk ($26.63 in chips) 
Seat 5: Rilko1975 ($24.55 in chips) 
Seat 6: chiyuki ($29.49 in chips) 
Seat 7: KeLevro0 ($9.48 in chips) 
Seat 8: DanielWhyte ($66.31 in chips) 
Seat 9: Nerkit ($10.93 in chips) 
PetitAlejo: posts small blind $0.10
Rici47: posts big blind $0.25
*** HOLE CARDS ***
Dealt to chiyuki [Qd 4c]
Silveystryk: folds 
Rilko1975: raises $0.25 to $0.50
chiyuki: folds 
KeLevro0: folds 
DanielWhyte: folds 
Nerkit: folds 
deadmoneykid: folds 
PetitAlejo: folds 
Rici47: calls $0.25
*** FLOP *** [9c 3c 6h]
Rici47: checks 
Rilko1975: bets $0.50
Rici47: folds 
Uncalled bet ($0.50) returned to Rilko1975
Rilko1975 collected $1.05 from pot
Rilko1975: doesn't show hand 
*** SUMMARY ***
Total pot $1.10 | Rake $0.05 
Board [9c 3c 6h]
Seat 1: deadmoneykid (button) folded before Flop (didn't bet)
Seat 2: PetitAlejo (small blind) folded before Flop
Seat 3: Rici47 (big blind) folded on the Flop
Seat 4: Silveystryk folded before Flop (didn't bet)
Seat 5: Rilko1975 collected ($1.05)
Seat 6: chiyuki folded before Flop (didn't bet)
Seat 7: KeLevro0 folded before Flop (didn't bet)
Seat 8: DanielWhyte folded before Flop (didn't bet)
Seat 9: Nerkit folded before Flop (didn't bet)



PokerStars Zoom Hand #84300280683:  Hold'em No Limit ($0.10/$0.25) - 2012/08/05 15:17:39 JST [2012/08/05 2:17:39 ET]
Table 'Whirlpool' 9-max Seat #1 is the button
Seat 1: DutchShultzs ($25 in chips) 
Seat 2: Jene4kaBest ($11.90 in chips) 
Seat 3: chiyuki ($29.49 in chips) 
Seat 4: Wilcox76607 ($35.39 in chips) 
Seat 5: Perstenev ($12.39 in chips) 
Seat 6: Robchie ($10.39 in chips) 
Seat 7: Dejacob ($31.87 in chips) 
Seat 8: snejokCoxx ($8.30 in chips) 
Seat 9: Sal y Limon1 ($24.75 in chips) 
Jene4kaBest: posts small blind $0.10
chiyuki: posts big blind $0.25
*** HOLE CARDS ***
Dealt to chiyuki [5d 4s]
Wilcox76607: folds 
Perstenev: folds 
Robchie: folds 
Dejacob: folds 
snejokCoxx: folds 
Sal y Limon1: folds 
DutchShultzs: folds 
Jene4kaBest: folds 
Uncalled bet ($0.15) returned to chiyuki
chiyuki collected $0.20 from pot
chiyuki: doesn't show hand 
*** SUMMARY ***
Total pot $0.20 | Rake $0 
Seat 1: DutchShultzs (button) folded before Flop (didn't bet)
Seat 2: Jene4kaBest (small blind) folded before Flop
Seat 3: chiyuki (big blind) collected ($0.20)
Seat 4: Wilcox76607 folded before Flop (didn't bet)
Seat 5: Perstenev folded before Flop (didn't bet)
Seat 6: Robchie folded before Flop (didn't bet)
Seat 7: Dejacob folded before Flop (didn't bet)
Seat 8: snejokCoxx folded before Flop (didn't bet)
Seat 9: Sal y Limon1 folded before Flop (didn't bet)



PokerStars Zoom Hand #84300273320:  Hold'em No Limit ($0.10/$0.25) - 2012/08/05 15:17:09 JST [2012/08/05 2:17:09 ET]
Table 'Whirlpool' 9-max Seat #1 is the button
Seat 1: Ellen1947 ($24.90 in chips) 
Seat 2: seula i ($27.51 in chips) 
Seat 3: 4ydo yogurt ($43.38 in chips) 
Seat 4: ZhukOFFskI ($28.99 in chips) 
Seat 5: chiyuki ($29.49 in chips) 
Seat 6: dushvan ($32.84 in chips) 
Seat 7: 1Karina1 ($28.49 in chips) 
Seat 8: River_GmbH ($16.30 in chips) 
Seat 9: Roglus ($4.15 in chips) 
seula i: posts small blind $0.10
4ydo yogurt: posts big blind $0.25
*** HOLE CARDS ***
Dealt to chiyuki [8s 6c]
ZhukOFFskI: raises $0.50 to $0.75
chiyuki: folds 
dushvan: folds 
1Karina1: folds 
River_GmbH: folds 
Roglus: calls $0.75
Ellen1947: folds 
seula i: folds 
4ydo yogurt: calls $0.50
*** FLOP *** [6d 8c 5s]
4ydo yogurt: checks 
ZhukOFFskI: checks 
Roglus: checks 
*** TURN *** [6d 8c 5s] [Jh]
4ydo yogurt: bets $0.30
ZhukOFFskI: folds 
Roglus: calls $0.30
*** RIVER *** [6d 8c 5s Jh] [6s]
4ydo yogurt: bets $1.41
Roglus: folds 
Uncalled bet ($1.41) returned to 4ydo yogurt
4ydo yogurt collected $2.82 from pot
4ydo yogurt: doesn't show hand 
*** SUMMARY ***
Total pot $2.95 | Rake $0.13 
Board [6d 8c 5s Jh 6s]
Seat 1: Ellen1947 (button) folded before Flop (didn't bet)
Seat 2: seula i (small blind) folded before Flop
Seat 3: 4ydo yogurt (big blind) collected ($2.82)
Seat 4: ZhukOFFskI folded on the Turn
Seat 5: chiyuki folded before Flop (didn't bet)
Seat 6: dushvan folded before Flop (didn't bet)
Seat 7: 1Karina1 folded before Flop (didn't bet)
Seat 8: River_GmbH folded before Flop (didn't bet)
Seat 9: Roglus folded on the River



PokerStars Zoom Hand #84300274828:  Hold'em No Limit ($0.10/$0.25) - 2012/08/05 15:17:15 JST [2012/08/05 2:17:15 ET]
Table 'Whirlpool' 9-max Seat #1 is the button
Seat 1: chiyuki ($29.49 in chips) 
Seat 2: mid22 ($18.42 in chips) 
Seat 3: 1Karina1 ($28.49 in chips) 
Seat 4: INSP!RON ($29.33 in chips) 
Seat 5: dushvan ($32.84 in chips) 
Seat 6: GovGus ($33.66 in chips) 
Seat 7: DutchShultzs ($40.68 in chips) 
Seat 8: el pore 5 ($10.72 in chips) 
Seat 9: Silveystryk ($17.83 in chips) 
mid22: posts small blind $0.10
1Karina1: posts big blind $0.25
*** HOLE CARDS ***
Dealt to chiyuki [3s Ts]
INSP!RON: folds 
dushvan: raises $0.50 to $0.75
GovGus: folds 
DutchShultzs: folds 
el pore 5: folds 
Silveystryk: folds 
chiyuki: folds 
mid22: calls $0.65
1Karina1: calls $0.50
*** FLOP *** [2s 8c 7s]
mid22: bets $0.25
1Karina1: raises $1.25 to $1.50
dushvan: calls $1.50
mid22: calls $1.25
*** TURN *** [2s 8c 7s] [5h]
mid22: checks 
1Karina1: bets $3.22
dushvan: calls $3.22
mid22: calls $3.22
*** RIVER *** [2s 8c 7s 5h] [Qd]
mid22: bets $12.95 and is all-in
1Karina1: folds 
dushvan: calls $12.95
*** SHOW DOWN ***
mid22: shows [As Ad] (a pair of Aces)
dushvan: shows [Qc Qs] (three of a kind, Queens)
dushvan collected $40.41 from pot
*** SUMMARY ***
Total pot $42.31 | Rake $1.90 
Board [2s 8c 7s 5h Qd]
Seat 1: chiyuki (button) folded before Flop (didn't bet)
Seat 2: mid22 (small blind) showed [As Ad] and lost with a pair of Aces
Seat 3: 1Karina1 (big blind) folded on the River
Seat 4: INSP!RON folded before Flop (didn't bet)
Seat 5: dushvan showed [Qc Qs] and won ($40.41) with three of a kind, Queens
Seat 6: GovGus folded before Flop (didn't bet)
Seat 7: DutchShultzs folded before Flop (didn't bet)
Seat 8: el pore 5 folded before Flop (didn't bet)
Seat 9: Silveystryk folded before Flop (didn't bet)



PokerStars Zoom Hand #84300278966:  Hold'em No Limit ($0.10/$0.25) - 2012/08/05 15:17:32 JST [2012/08/05 2:17:32 ET]
Table 'Whirlpool' 9-max Seat #1 is the button
Seat 1: phate-1up ($53.42 in chips) 
Seat 2: Lasutchik ($74.46 in chips) 
Seat 3: Nerkit ($10.93 in chips) 
Seat 4: PAMBOS.L ($17.40 in chips) 
Seat 5: Alvinpe85 ($48.72 in chips) 
Seat 6: panaam ($22.42 in chips) 
Seat 7: karpexxx ($15.70 in chips) 
Seat 8: chiyuki ($29.49 in chips) 
Seat 9: Dejacob ($25.35 in chips) 
Lasutchik: posts small blind $0.10
Nerkit: posts big blind $0.25
*** HOLE CARDS ***
Dealt to chiyuki [7h Jh]
PAMBOS.L: raises $0.50 to $0.75
Alvinpe85: folds 
panaam: folds 
karpexxx: folds 
chiyuki: folds 
Dejacob: raises $1.75 to $2.50
phate-1up: folds 
Lasutchik: folds 
Nerkit: folds 
PAMBOS.L: calls $1.75
*** FLOP *** [Td Ks 7s]
PAMBOS.L: checks 
Dejacob: bets $4
PAMBOS.L: folds 
Uncalled bet ($4) returned to Dejacob
Dejacob collected $5.11 from pot
Dejacob: doesn't show hand 
*** SUMMARY ***
Total pot $5.35 | Rake $0.24 
Board [Td Ks 7s]
Seat 1: phate-1up (button) folded before Flop (didn't bet)
Seat 2: Lasutchik (small blind) folded before Flop
Seat 3: Nerkit (big blind) folded before Flop
Seat 4: PAMBOS.L folded on the Flop
Seat 5: Alvinpe85 folded before Flop (didn't bet)
Seat 6: panaam folded before Flop (didn't bet)
Seat 7: karpexxx folded before Flop (didn't bet)
Seat 8: chiyuki folded before Flop (didn't bet)
Seat 9: Dejacob collected ($5.11)



PokerStars Zoom Hand #84300284216:  Hold'em No Limit ($0.10/$0.25) - 2012/08/05 15:17:53 JST [2012/08/05 2:17:53 ET]
Table 'Whirlpool' 9-max Seat #1 is the button
Seat 1: seula i ($46.88 in chips) 
Seat 2: chiyuki ($29.59 in chips) 
Seat 3: jacquelinewu ($73.79 in chips) 
Seat 4: ygoegoe ($30.07 in chips) 
Seat 5: Perstenev ($13.45 in chips) 
Seat 6: DutchShultzs ($25 in chips) 
Seat 7: Rici47 ($24.50 in chips) 
Seat 8: masterkoolb ($12.50 in chips) 
Seat 9: snejokCoxx ($8.68 in chips) 
chiyuki: posts small blind $0.10
jacquelinewu: posts big blind $0.25
*** HOLE CARDS ***
Dealt to chiyuki [Kh Kc]
ygoegoe: folds 
Perstenev: folds 
DutchShultzs: folds 
Rici47: folds 
masterkoolb: raises $0.60 to $0.85
snejokCoxx: folds 
seula i: folds 
chiyuki: raises $1.85 to $2.70
jacquelinewu: folds 
masterkoolb: calls $1.85
*** FLOP *** [8s 5c 4s]
chiyuki: bets $2.75
masterkoolb: folds 
Uncalled bet ($2.75) returned to chiyuki
chiyuki collected $5.40 from pot
chiyuki: doesn't show hand 
*** SUMMARY ***
Total pot $5.65 | Rake $0.25 
Board [8s 5c 4s]
Seat 1: seula i (button) folded before Flop (didn't bet)
Seat 2: chiyuki (small blind) collected ($5.40)
Seat 3: jacquelinewu (big blind) folded before Flop
Seat 4: ygoegoe folded before Flop (didn't bet)
Seat 5: Perstenev folded before Flop (didn't bet)
Seat 6: DutchShultzs folded before Flop (didn't bet)
Seat 7: Rici47 folded before Flop (didn't bet)
Seat 8: masterkoolb folded on the Flop
Seat 9: snejokCoxx folded before Flop (didn't bet)



PokerStars Zoom Hand #84300276932:  Hold'em No Limit ($0.10/$0.25) - 2012/08/05 15:17:24 JST [2012/08/05 2:17:24 ET]
Table 'Whirlpool' 9-max Seat #1 is the button
Seat 1: DanielWhyte ($66.31 in chips) 
Seat 2: troublesomm ($35.35 in chips) 
Seat 3: KrystalAA ($20.46 in chips) 
Seat 4: ygoegoe ($35.32 in chips) 
Seat 5: 1Karina1 ($30.72 in chips) 
Seat 6: DutchShultzs ($40.68 in chips) 
Seat 7: chiyuki ($29.49 in chips) 
Seat 8: GovGus ($25.45 in chips) 
Seat 9: seula i ($95.75 in chips) 
troublesomm: posts small blind $0.10
KrystalAA: posts big blind $0.25
*** HOLE CARDS ***
Dealt to chiyuki [4c 3c]
ygoegoe: raises $0.50 to $0.75
1Karina1: calls $0.75
DutchShultzs: calls $0.75
chiyuki: folds 
GovGus: folds 
seula i: folds 
DanielWhyte: folds 
troublesomm: folds 
KrystalAA: folds 
*** FLOP *** [5s 5d Jh]
ygoegoe: checks 
1Karina1: bets $1.75
DutchShultzs: calls $1.75
ygoegoe: folds 
*** TURN *** [5s 5d Jh] [Qd]
1Karina1: checks 
DutchShultzs: bets $2.40
1Karina1: folds 
Uncalled bet ($2.40) returned to DutchShultzs
DutchShultzs collected $5.83 from pot
DutchShultzs: doesn't show hand 
*** SUMMARY ***
Total pot $6.10 | Rake $0.27 
Board [5s 5d Jh Qd]
Seat 1: DanielWhyte (button) folded before Flop (didn't bet)
Seat 2: troublesomm (small blind) folded before Flop
Seat 3: KrystalAA (big blind) folded before Flop
Seat 4: ygoegoe folded on the Flop
Seat 5: 1Karina1 folded on the Turn
Seat 6: DutchShultzs collected ($5.83)
Seat 7: chiyuki folded before Flop (didn't bet)
Seat 8: GovGus folded before Flop (didn't bet)
Seat 9: seula i folded before Flop (didn't bet)



PokerStars Zoom Hand #84300294581:  Hold'em No Limit ($0.10/$0.25) - 2012/08/05 15:18:35 JST [2012/08/05 2:18:35 ET]
Table 'Whirlpool' 9-max Seat #1 is the button
Seat 1: Perstenev ($12.04 in chips) 
Seat 2: ZhukOFFskI ($34.64 in chips) 
Seat 3: therati ($21.18 in chips) 
Seat 4: DutchShultzs ($25 in chips) 
Seat 5: 4plankton ($16.75 in chips) 
Seat 6: Tom1999 ($11.15 in chips) 
Seat 7: Dan Royal ($36.74 in chips) 
Seat 8: hirozo ($25 in chips) 
Seat 9: chiyuki ($32.29 in chips) 
ZhukOFFskI: posts small blind $0.10
therati: posts big blind $0.25
*** HOLE CARDS ***
Dealt to chiyuki [Td Ac]
DutchShultzs: folds 
4plankton: raises $0.25 to $0.50
Tom1999: folds 
Dan Royal: folds 
hirozo: folds 
chiyuki: folds 
Perstenev: folds 
ZhukOFFskI: folds 
therati: folds 
Uncalled bet ($0.25) returned to 4plankton
4plankton collected $0.60 from pot
4plankton: doesn't show hand 
*** SUMMARY ***
Total pot $0.60 | Rake $0 
Seat 1: Perstenev (button) folded before Flop (didn't bet)
Seat 2: ZhukOFFskI (small blind) folded before Flop
Seat 3: therati (big blind) folded before Flop
Seat 4: DutchShultzs folded before Flop (didn't bet)
Seat 5: 4plankton collected ($0.60)
Seat 6: Tom1999 folded before Flop (didn't bet)
Seat 7: Dan Royal folded before Flop (didn't bet)
Seat 8: hirozo folded before Flop (didn't bet)
Seat 9: chiyuki folded before Flop (didn't bet)



PokerStars Zoom Hand #84300297887:  Hold'em No Limit ($0.10/$0.25) - 2012/08/05 15:18:48 JST [2012/08/05 2:18:48 ET]
Table 'Whirlpool' 9-max Seat #1 is the button
Seat 1: chiyuki ($32.29 in chips) 
Seat 2: nastya040 ($17.69 in chips) 
Seat 3: PetitAlejo ($25.35 in chips) 
Seat 4: d8hetniet ($15.83 in chips) 
Seat 5: phate-1up ($53.07 in chips) 
Seat 6: Nerkit ($11.30 in chips) 
Seat 7: kaplya2010 ($13.44 in chips) 
Seat 8: Tom1999 ($11.15 in chips) 
Seat 9: masterkoolb ($12.50 in chips) 
nastya040: posts small blind $0.10
PetitAlejo: posts big blind $0.25
*** HOLE CARDS ***
Dealt to chiyuki [8c 9d]
d8hetniet: folds 
phate-1up: folds 
Nerkit: folds 
kaplya2010: folds 
Tom1999: folds 
masterkoolb: folds 
chiyuki: folds 
nastya040: folds 
Uncalled bet ($0.15) returned to PetitAlejo
PetitAlejo collected $0.20 from pot
PetitAlejo: doesn't show hand 
*** SUMMARY ***
Total pot $0.20 | Rake $0 
Seat 1: chiyuki (button) folded before Flop (didn't bet)
Seat 2: nastya040 (small blind) folded before Flop
Seat 3: PetitAlejo (big blind) collected ($0.20)
Seat 4: d8hetniet folded before Flop (didn't bet)
Seat 5: phate-1up folded before Flop (didn't bet)
Seat 6: Nerkit folded before Flop (didn't bet)
Seat 7: kaplya2010 folded before Flop (didn't bet)
Seat 8: Tom1999 folded before Flop (didn't bet)
Seat 9: masterkoolb folded before Flop (didn't bet)



PokerStars Zoom Hand #84300299402:  Hold'em No Limit ($0.10/$0.25) - 2012/08/05 15:18:54 JST [2012/08/05 2:18:54 ET]
Table 'Whirlpool' 9-max Seat #1 is the button
Seat 1: WARIBANA7777 ($16.84 in chips) 
Seat 2: kwkim73 ($28.83 in chips) 
Seat 3: Gichboy ($7.60 in chips) 
Seat 4: chiyuki ($32.29 in chips) 
Seat 5: silvno31 ($25.31 in chips) 
Seat 6: KeLevro0 ($9.29 in chips) 
Seat 7: jacquelinewu ($27.73 in chips) 
Seat 8: INSP!RON ($26.59 in chips) 
Seat 9: deadmoneykid ($32.43 in chips) 
kwkim73: posts small blind $0.10
Gichboy: posts big blind $0.25
*** HOLE CARDS ***
Dealt to chiyuki [3d Qs]
chiyuki: folds 
silvno31: folds 
KeLevro0: folds 
jacquelinewu: raises $0.75 to $1
INSP!RON: folds 
deadmoneykid: folds 
WARIBANA7777: folds 
kwkim73: folds 
Gichboy: folds 
Uncalled bet ($0.75) returned to jacquelinewu
jacquelinewu collected $0.60 from pot
jacquelinewu: doesn't show hand 
*** SUMMARY ***
Total pot $0.60 | Rake $0 
Seat 1: WARIBANA7777 (button) folded before Flop (didn't bet)
Seat 2: kwkim73 (small blind) folded before Flop
Seat 3: Gichboy (big blind) folded before Flop
Seat 4: chiyuki folded before Flop (didn't bet)
Seat 5: silvno31 folded before Flop (didn't bet)
Seat 6: KeLevro0 folded before Flop (didn't bet)
Seat 7: jacquelinewu collected ($0.60)
Seat 8: INSP!RON folded before Flop (didn't bet)
Seat 9: deadmoneykid folded before Flop (didn't bet)



PokerStars Zoom Hand #84300301170:  Hold'em No Limit ($0.10/$0.25) - 2012/08/05 15:19:01 JST [2012/08/05 2:19:01 ET]
Table 'Whirlpool' 9-max Seat #1 is the button
Seat 1: KeLevro0 ($15.98 in chips) 
Seat 2: chiyuki ($32.29 in chips) 
Seat 3: Tom1999 ($6.27 in chips) 
Seat 4: kwkim73 ($27.28 in chips) 
Seat 5: panaam ($22.70 in chips) 
Seat 6: KrystalAA ($19.40 in chips) 
Seat 7: Silveystryk ($26.28 in chips) 
Seat 8: 1Karina1 ($25 in chips) 
Seat 9: deadmoneykid ($26.78 in chips) 
chiyuki: posts small blind $0.10
Tom1999: posts big blind $0.25
*** HOLE CARDS ***
Dealt to chiyuki [6s Kd]
kwkim73: folds 
panaam: folds 
KrystalAA: folds 
Silveystryk: calls $0.25
1Karina1: folds 
deadmoneykid: folds 
KeLevro0: folds 
chiyuki: folds 
Tom1999: checks 
*** FLOP *** [3s Ah Qd]
Tom1999: checks 
Silveystryk: bets $0.25
Tom1999: folds 
Uncalled bet ($0.25) returned to Silveystryk
Silveystryk collected $0.57 from pot
Silveystryk: doesn't show hand 
*** SUMMARY ***
Total pot $0.60 | Rake $0.03 
Board [3s Ah Qd]
Seat 1: KeLevro0 (button) folded before Flop (didn't bet)
Seat 2: chiyuki (small blind) folded before Flop
Seat 3: Tom1999 (big blind) folded on the Flop
Seat 4: kwkim73 folded before Flop (didn't bet)
Seat 5: panaam folded before Flop (didn't bet)
Seat 6: KrystalAA folded before Flop (didn't bet)
Seat 7: Silveystryk collected ($0.57)
Seat 8: 1Karina1 folded before Flop (didn't bet)
Seat 9: deadmoneykid folded before Flop (didn't bet)



PokerStars Zoom Hand #84300305077:  Hold'em No Limit ($0.10/$0.25) - 2012/08/05 15:19:16 JST [2012/08/05 2:19:16 ET]
Table 'Whirlpool' 9-max Seat #1 is the button
Seat 1: Ellen1947 ($23.55 in chips) 
Seat 2: 1Karina1 ($38.59 in chips) 
Seat 3: DutchShultzs ($32.37 in chips) 
Seat 4: Roglus ($3.20 in chips) 
Seat 5: chiyuki ($32.19 in chips) 
Seat 6: phate-1up ($28.22 in chips) 
Seat 7: GovGus ($35.43 in chips) 
Seat 8: 4plankton ($16.85 in chips) 
Seat 9: KeLevro0 ($15.98 in chips) 
1Karina1: posts small blind $0.10
DutchShultzs: posts big blind $0.25
*** HOLE CARDS ***
Dealt to chiyuki [7d 5s]
Roglus: folds 
chiyuki: folds 
phate-1up: folds 
GovGus: folds 
4plankton: folds 
KeLevro0: folds 
Ellen1947: folds 
1Karina1: folds 
Uncalled bet ($0.15) returned to DutchShultzs
DutchShultzs collected $0.20 from pot
DutchShultzs: doesn't show hand 
*** SUMMARY ***
Total pot $0.20 | Rake $0 
Seat 1: Ellen1947 (button) folded before Flop (didn't bet)
Seat 2: 1Karina1 (small blind) folded before Flop
Seat 3: DutchShultzs (big blind) collected ($0.20)
Seat 4: Roglus folded before Flop (didn't bet)
Seat 5: chiyuki folded before Flop (didn't bet)
Seat 6: phate-1up folded before Flop (didn't bet)
Seat 7: GovGus folded before Flop (didn't bet)
Seat 8: 4plankton folded before Flop (didn't bet)
Seat 9: KeLevro0 folded before Flop (didn't bet)



PokerStars Zoom Hand #84300300395:  Hold'em No Limit ($0.10/$0.25) - 2012/08/05 15:18:58 JST [2012/08/05 2:18:58 ET]
Table 'Whirlpool' 9-max Seat #1 is the button
Seat 1: phate-1up ($28.22 in chips) 
Seat 2: hirozo ($83.24 in chips) 
Seat 3: Rilko1975 ($35.20 in chips) 
Seat 4: chiyuki ($32.29 in chips) 
Seat 5: Dejacob ($27.96 in chips) 
Seat 6: dushvan ($55.28 in chips) 
Seat 7: womble32 ($28.72 in chips) 
Seat 8: Nerkit ($10.68 in chips) 
Seat 9: INSP!RON ($26.59 in chips) 
hirozo: posts small blind $0.10
Rilko1975: posts big blind $0.25
*** HOLE CARDS ***
Dealt to chiyuki [2c 6h]
chiyuki: folds 
Dejacob: folds 
dushvan: folds 
womble32: raises $0.50 to $0.75
Nerkit: raises $1.25 to $2
INSP!RON: folds 
phate-1up: folds 
hirozo: folds 
Rilko1975: folds 
womble32: folds 
Uncalled bet ($1.25) returned to Nerkit
Nerkit collected $1.85 from pot
Nerkit: doesn't show hand 
*** SUMMARY ***
Total pot $1.85 | Rake $0 
Seat 1: phate-1up (button) folded before Flop (didn't bet)
Seat 2: hirozo (small blind) folded before Flop
Seat 3: Rilko1975 (big blind) folded before Flop
Seat 4: chiyuki folded before Flop (didn't bet)
Seat 5: Dejacob folded before Flop (didn't bet)
Seat 6: dushvan folded before Flop (didn't bet)
Seat 7: womble32 folded before Flop
Seat 8: Nerkit collected ($1.85)
Seat 9: INSP!RON folded before Flop (didn't bet)



PokerStars Zoom Hand #84300293032:  Hold'em No Limit ($0.10/$0.25) - 2012/08/05 15:18:28 JST [2012/08/05 2:18:28 ET]
Table 'Whirlpool' 9-max Seat #1 is the button
Seat 1: Lasutchik ($74.11 in chips) 
Seat 2: phate-1up ($28.57 in chips) 
Seat 3: Littlea029 ($32.46 in chips) 
Seat 4: Nerkit ($10.93 in chips) 
Seat 5: JhonnyP1979 ($12.72 in chips) 
Seat 6: colorado2108 ($43.94 in chips) 
Seat 7: chiyuki ($32.29 in chips) 
Seat 8: Yoshimac ($30.20 in chips) 
Seat 9: Rici47 ($22.90 in chips) 
phate-1up: posts small blind $0.10
Littlea029: posts big blind $0.25
*** HOLE CARDS ***
Dealt to chiyuki [Ts Jh]
Nerkit: folds 
JhonnyP1979: folds 
colorado2108: raises $0.25 to $0.50
chiyuki: folds 
Yoshimac: calls $0.50
Rici47: folds 
Lasutchik: folds 
phate-1up: folds 
Littlea029: calls $0.25
*** FLOP *** [8s As Kd]
Littlea029: checks 
colorado2108: checks 
Yoshimac: checks 
*** TURN *** [8s As Kd] [6d]
Littlea029: checks 
colorado2108: bets $0.75
Yoshimac: folds 
Littlea029: calls $0.75
*** RIVER *** [8s As Kd 6d] [Qh]
Littlea029: checks 
colorado2108: bets $3.25
Littlea029: folds 
Uncalled bet ($3.25) returned to colorado2108
colorado2108 collected $2.96 from pot
colorado2108: doesn't show hand 
*** SUMMARY ***
Total pot $3.10 | Rake $0.14 
Board [8s As Kd 6d Qh]
Seat 1: Lasutchik (button) folded before Flop (didn't bet)
Seat 2: phate-1up (small blind) folded before Flop
Seat 3: Littlea029 (big blind) folded on the River
Seat 4: Nerkit folded before Flop (didn't bet)
Seat 5: JhonnyP1979 folded before Flop (didn't bet)
Seat 6: colorado2108 collected ($2.96)
Seat 7: chiyuki folded before Flop (didn't bet)
Seat 8: Yoshimac folded on the Turn
Seat 9: Rici47 folded before Flop (didn't bet)



PokerStars Zoom Hand #84300309163:  Hold'em No Limit ($0.10/$0.25) - 2012/08/05 15:19:32 JST [2012/08/05 2:19:32 ET]
Table 'Whirlpool' 9-max Seat #1 is the button
Seat 1: deadmoneykid ($32.43 in chips) 
Seat 2: phate-1up ($53.24 in chips) 
Seat 3: chiyuki ($32.19 in chips) 
Seat 4: macmauret ($20.81 in chips) 
Seat 5: hirozo ($83.14 in chips) 
Seat 6: Rilko1975 ($34.95 in chips) 
Seat 7: Nerkit ($11.78 in chips) 
Seat 8: kwkim73 ($28.83 in chips) 
Seat 9: KeLevro0 ($12.40 in chips) 
phate-1up: posts small blind $0.10
chiyuki: posts big blind $0.25
*** HOLE CARDS ***
Dealt to chiyuki [5h Jc]
macmauret: folds 
hirozo: folds 
Rilko1975: folds 
Nerkit: folds 
kwkim73: folds 
KeLevro0: folds 
deadmoneykid: folds 
phate-1up: folds 
Uncalled bet ($0.15) returned to chiyuki
chiyuki collected $0.20 from pot
chiyuki: doesn't show hand 
*** SUMMARY ***
Total pot $0.20 | Rake $0 
Seat 1: deadmoneykid (button) folded before Flop (didn't bet)
Seat 2: phate-1up (small blind) folded before Flop
Seat 3: chiyuki (big blind) collected ($0.20)
Seat 4: macmauret folded before Flop (didn't bet)
Seat 5: hirozo folded before Flop (didn't bet)
Seat 6: Rilko1975 folded before Flop (didn't bet)
Seat 7: Nerkit folded before Flop (didn't bet)
Seat 8: kwkim73 folded before Flop (didn't bet)
Seat 9: KeLevro0 folded before Flop (didn't bet)



PokerStars Zoom Hand #84300307067:  Hold'em No Limit ($0.10/$0.25) - 2012/08/05 15:19:24 JST [2012/08/05 2:19:24 ET]
Table 'Whirlpool' 9-max Seat #1 is the button
Seat 1: 4plankton ($16.85 in chips) 
Seat 2: troublesomm ($29.38 in chips) 
Seat 3: GSDP ($25 in chips) 
Seat 4: INSP!RON ($33.02 in chips) 
Seat 5: PetitAlejo ($25.35 in chips) 
Seat 6: chiyuki ($32.19 in chips) 
Seat 7: kwkim73 ($27.18 in chips) 
Seat 8: KeLevro0 ($15.98 in chips) 
Seat 9: phate-1up ($54.56 in chips) 
troublesomm: posts small blind $0.10
GSDP: posts big blind $0.25
*** HOLE CARDS ***
Dealt to chiyuki [Ks 2s]
INSP!RON: folds 
PetitAlejo: folds 
chiyuki: folds 
kwkim73: folds 
KeLevro0: folds 
phate-1up: folds 
4plankton: calls $0.25
troublesomm: folds 
GSDP: checks 
*** FLOP *** [3d Kh 7d]
GSDP: checks 
4plankton: checks 
*** TURN *** [3d Kh 7d] [Qs]
GSDP: bets $0.50
4plankton: folds 
Uncalled bet ($0.50) returned to GSDP
GSDP collected $0.57 from pot
GSDP: doesn't show hand 
*** SUMMARY ***
Total pot $0.60 | Rake $0.03 
Board [3d Kh 7d Qs]
Seat 1: 4plankton (button) folded on the Turn
Seat 2: troublesomm (small blind) folded before Flop
Seat 3: GSDP (big blind) collected ($0.57)
Seat 4: INSP!RON folded before Flop (didn't bet)
Seat 5: PetitAlejo folded before Flop (didn't bet)
Seat 6: chiyuki folded before Flop (didn't bet)
Seat 7: kwkim73 folded before Flop (didn't bet)
Seat 8: KeLevro0 folded before Flop (didn't bet)
Seat 9: phate-1up folded before Flop (didn't bet)



PokerStars Zoom Hand #84300313074:  Hold'em No Limit ($0.10/$0.25) - 2012/08/05 15:19:48 JST [2012/08/05 2:19:48 ET]
Table 'Whirlpool' 9-max Seat #1 is the button
Seat 1: Perstenev ($8.52 in chips) 
Seat 2: Silveystryk ($17.55 in chips) 
Seat 3: Gichboy ($29.28 in chips) 
Seat 4: KeLevro0 ($9.19 in chips) 
Seat 5: el pore 5 ($13.05 in chips) 
Seat 6: womble32 ($27.87 in chips) 
Seat 7: chiyuki ($32.29 in chips) 
Seat 8: phate-1up ($53.14 in chips) 
Seat 9: 1Karina1 ($28.26 in chips) 
Silveystryk: posts small blind $0.10
Gichboy: posts big blind $0.25
*** HOLE CARDS ***
Dealt to chiyuki [Kc Kd]
KeLevro0: folds 
el pore 5: raises $0.50 to $0.75
womble32: folds 
chiyuki: raises $1.50 to $2.25
phate-1up: folds 
1Karina1: folds 
Perstenev: folds 
Silveystryk: folds 
Gichboy: folds 
el pore 5: calls $1.50
*** FLOP *** [Tc 7d 7h]
el pore 5: checks 
chiyuki: bets $2.75
el pore 5: folds 
Uncalled bet ($2.75) returned to chiyuki
chiyuki collected $4.63 from pot
chiyuki: doesn't show hand 
*** SUMMARY ***
Total pot $4.85 | Rake $0.22 
Board [Tc 7d 7h]
Seat 1: Perstenev (button) folded before Flop (didn't bet)
Seat 2: Silveystryk (small blind) folded before Flop
Seat 3: Gichboy (big blind) folded before Flop
Seat 4: KeLevro0 folded before Flop (didn't bet)
Seat 5: el pore 5 folded on the Flop
Seat 6: womble32 folded before Flop (didn't bet)
Seat 7: chiyuki collected ($4.63)
Seat 8: phate-1up folded before Flop (didn't bet)
Seat 9: 1Karina1 folded before Flop (didn't bet)



PokerStars Zoom Hand #84300320537:  Hold'em No Limit ($0.10/$0.25) - 2012/08/05 15:20:18 JST [2012/08/05 2:20:18 ET]
Table 'Whirlpool' 9-max Seat #1 is the button
Seat 1: Ellen1947 ($22.05 in chips) 
Seat 2: Dan Royal ($22.55 in chips) 
Seat 3: DutchShultzs ($31.83 in chips) 
Seat 4: troublesomm ($37.86 in chips) 
Seat 5: KeLevro0 ($11.50 in chips) 
Seat 6: Wilcox76607 ($20.64 in chips) 
Seat 7: Nerkit ($10.20 in chips) 
Seat 8: nice.franki ($12.15 in chips) 
Seat 9: chiyuki ($34.67 in chips) 
Dan Royal: posts small blind $0.10
DutchShultzs: posts big blind $0.25
*** HOLE CARDS ***
Dealt to chiyuki [9h 3s]
troublesomm: folds 
KeLevro0: folds 
Wilcox76607: folds 
Nerkit: folds 
nice.franki: raises $0.50 to $0.75
chiyuki: folds 
Ellen1947: folds 
Dan Royal: folds 
DutchShultzs: folds 
Uncalled bet ($0.50) returned to nice.franki
nice.franki collected $0.60 from pot
nice.franki: doesn't show hand 
*** SUMMARY ***
Total pot $0.60 | Rake $0 
Seat 1: Ellen1947 (button) folded before Flop (didn't bet)
Seat 2: Dan Royal (small blind) folded before Flop
Seat 3: DutchShultzs (big blind) folded before Flop
Seat 4: troublesomm folded before Flop (didn't bet)
Seat 5: KeLevro0 folded before Flop (didn't bet)
Seat 6: Wilcox76607 folded before Flop (didn't bet)
Seat 7: Nerkit folded before Flop (didn't bet)
Seat 8: nice.franki collected ($0.60)
Seat 9: chiyuki folded before Flop (didn't bet)



PokerStars Zoom Hand #84300325460:  Hold'em No Limit ($0.10/$0.25) - 2012/08/05 15:20:37 JST [2012/08/05 2:20:37 ET]
Table 'Whirlpool' 9-max Seat #1 is the button
Seat 1: chiyuki ($34.67 in chips) 
Seat 2: risekuku468 ($36.06 in chips) 
Seat 3: ViTiV2010 ($12.50 in chips) 
Seat 4: ChrisCDee ($25 in chips) 
Seat 5: PetitAlejo ($25 in chips) 
Seat 6: Tom1999 ($11.50 in chips) 
Seat 7: pandaaaaaa ($8.57 in chips) 
Seat 8: Perstenev ($13.15 in chips) 
Seat 9: kamikkaze ($9.75 in chips) 
risekuku468: posts small blind $0.10
ViTiV2010: posts big blind $0.25
*** HOLE CARDS ***
Dealt to chiyuki [Qs Ah]
ChrisCDee: folds 
PetitAlejo: folds 
Tom1999: raises $0.50 to $0.75
pandaaaaaa: folds 
Perstenev: folds 
kamikkaze: folds 
chiyuki: raises $1.50 to $2.25
risekuku468: folds 
ViTiV2010: folds 
Tom1999: folds 
Uncalled bet ($1.50) returned to chiyuki
chiyuki collected $1.85 from pot
chiyuki: doesn't show hand 
*** SUMMARY ***
Total pot $1.85 | Rake $0 
Seat 1: chiyuki (button) collected ($1.85)
Seat 2: risekuku468 (small blind) folded before Flop
Seat 3: ViTiV2010 (big blind) folded before Flop
Seat 4: ChrisCDee folded before Flop (didn't bet)
Seat 5: PetitAlejo folded before Flop (didn't bet)
Seat 6: Tom1999 folded before Flop
Seat 7: pandaaaaaa folded before Flop (didn't bet)
Seat 8: Perstenev folded before Flop (didn't bet)
Seat 9: kamikkaze folded before Flop (didn't bet)



PokerStars Zoom Hand #84300331571:  Hold'em No Limit ($0.10/$0.25) - 2012/08/05 15:21:02 JST [2012/08/05 2:21:02 ET]
Table 'Whirlpool' 9-max Seat #1 is the button
Seat 1: KeLevro0 ($12.50 in chips) 
Seat 2: kwkim73 ($29.94 in chips) 
Seat 3: ZhukOFFskI ($34.29 in chips) 
Seat 4: 4plankton ($16.50 in chips) 
Seat 5: AntoineHunt ($36 in chips) 
Seat 6: Vahe50 ($14.76 in chips) 
Seat 7: 1Karina1 ($25.35 in chips) 
Seat 8: chiyuki ($35.77 in chips) 
Seat 9: DutchShultzs ($31.48 in chips) 
kwkim73: posts small blind $0.10
ZhukOFFskI: posts big blind $0.25
*** HOLE CARDS ***
Dealt to chiyuki [Td 7d]
4plankton: folds 
AntoineHunt: folds 
Vahe50 has timed out
Vahe50: folds 
1Karina1: raises $0.50 to $0.75
chiyuki: folds 
DutchShultzs: folds 
KeLevro0: folds 
kwkim73: folds 
ZhukOFFskI: folds 
Uncalled bet ($0.50) returned to 1Karina1
1Karina1 collected $0.60 from pot
1Karina1: doesn't show hand 
*** SUMMARY ***
Total pot $0.60 | Rake $0 
Seat 1: KeLevro0 (button) folded before Flop (didn't bet)
Seat 2: kwkim73 (small blind) folded before Flop
Seat 3: ZhukOFFskI (big blind) folded before Flop
Seat 4: 4plankton folded before Flop (didn't bet)
Seat 5: AntoineHunt folded before Flop (didn't bet)
Seat 6: Vahe50 folded before Flop (didn't bet)
Seat 7: 1Karina1 collected ($0.60)
Seat 8: chiyuki folded before Flop (didn't bet)
Seat 9: DutchShultzs folded before Flop (didn't bet)



PokerStars Zoom Hand #84300333363:  Hold'em No Limit ($0.10/$0.25) - 2012/08/05 15:21:09 JST [2012/08/05 2:21:09 ET]
Table 'Whirlpool' 9-max Seat #1 is the button
Seat 1: Wilcox76607 ($20.39 in chips) 
Seat 2: el pore 5 ($14.47 in chips) 
Seat 3: panaam ($21.85 in chips) 
Seat 4: turbotom122 ($28.54 in chips) 
Seat 5: KrystalAA ($24.89 in chips) 
Seat 6: chiyuki ($35.77 in chips) 
Seat 7: grand maitre ($24.35 in chips) 
Seat 8: troublesomm ($29.06 in chips) 
Seat 9: phate-1up ($29.69 in chips) 
el pore 5: posts small blind $0.10
panaam: posts big blind $0.25
*** HOLE CARDS ***
Dealt to chiyuki [Qc Tc]
turbotom122: folds 
KrystalAA: folds 
chiyuki: folds 
grand maitre: folds 
troublesomm: folds 
phate-1up: folds 
Wilcox76607: folds 
el pore 5: calls $0.15
panaam: checks 
*** FLOP *** [3c As 2c]
el pore 5: checks 
panaam: checks 
*** TURN *** [3c As 2c] [7d]
el pore 5: checks 
panaam: checks 
*** RIVER *** [3c As 2c 7d] [Td]
el pore 5: checks 
panaam: checks 
*** SHOW DOWN ***
el pore 5: shows [Qs Jd] (high card Ace)
panaam: shows [Jh Kd] (high card Ace - King kicker)
panaam collected $0.48 from pot
*** SUMMARY ***
Total pot $0.50 | Rake $0.02 
Board [3c As 2c 7d Td]
Seat 1: Wilcox76607 (button) folded before Flop (didn't bet)
Seat 2: el pore 5 (small blind) showed [Qs Jd] and lost with high card Ace
Seat 3: panaam (big blind) showed [Jh Kd] and won ($0.48) with high card Ace
Seat 4: turbotom122 folded before Flop (didn't bet)
Seat 5: KrystalAA folded before Flop (didn't bet)
Seat 6: chiyuki folded before Flop (didn't bet)
Seat 7: grand maitre folded before Flop (didn't bet)
Seat 8: troublesomm folded before Flop (didn't bet)
Seat 9: phate-1up folded before Flop (didn't bet)



PokerStars Zoom Hand #84300339580:  Hold'em No Limit ($0.10/$0.25) - 2012/08/05 15:21:33 JST [2012/08/05 2:21:33 ET]
Table 'Whirlpool' 9-max Seat #1 is the button
Seat 1: turbotom122 ($28.44 in chips) 
Seat 2: cofla tito ($12.75 in chips) 
Seat 3: tribunpdm ($24.94 in chips) 
Seat 4: Dan Royal ($23.37 in chips) 
Seat 5: chiyuki ($35.77 in chips) 
Seat 6: KeLevro0 ($8.94 in chips) 
Seat 7: mjmichi ($36.52 in chips) 
Seat 8: hirozo ($76.29 in chips) 
Seat 9: Jene4kaBest ($21.23 in chips) 
cofla tito: posts small blind $0.10
tribunpdm: posts big blind $0.25
*** HOLE CARDS ***
Dealt to chiyuki [Kd 7h]
Dan Royal: folds 
chiyuki: folds 
KeLevro0: folds 
mjmichi: folds 
hirozo: folds 
Jene4kaBest: folds 
turbotom122: folds 
cofla tito: calls $0.15
tribunpdm: checks 
*** FLOP *** [Ts Ks As]
cofla tito: bets $0.25
tribunpdm: folds 
Uncalled bet ($0.25) returned to cofla tito
cofla tito collected $0.48 from pot
cofla tito: doesn't show hand 
*** SUMMARY ***
Total pot $0.50 | Rake $0.02 
Board [Ts Ks As]
Seat 1: turbotom122 (button) folded before Flop (didn't bet)
Seat 2: cofla tito (small blind) collected ($0.48)
Seat 3: tribunpdm (big blind) folded on the Flop
Seat 4: Dan Royal folded before Flop (didn't bet)
Seat 5: chiyuki folded before Flop (didn't bet)
Seat 6: KeLevro0 folded before Flop (didn't bet)
Seat 7: mjmichi folded before Flop (didn't bet)
Seat 8: hirozo folded before Flop (didn't bet)
Seat 9: Jene4kaBest folded before Flop (didn't bet)



PokerStars Zoom Hand #84300344949:  Hold'em No Limit ($0.10/$0.25) - 2012/08/05 15:21:54 JST [2012/08/05 2:21:54 ET]
Table 'Whirlpool' 9-max Seat #1 is the button
Seat 1: 1Karina1 ($39.22 in chips) 
Seat 2: kamikkaze ($13.07 in chips) 
Seat 3: chiyuki ($35.77 in chips) 
Seat 4: kaplya2010 ($23.03 in chips) 
Seat 5: DanielWhyte ($61.81 in chips) 
Seat 6: phate-1up ($52.04 in chips) 
Seat 7: pandaaaaaa ($8.22 in chips) 
Seat 8: ViTiV2010 ($12.50 in chips) 
Seat 9: el pore 5 ($14.22 in chips) 
kamikkaze: posts small blind $0.10
chiyuki: posts big blind $0.25
*** HOLE CARDS ***
Dealt to chiyuki [7h Ac]
kaplya2010: folds 
DanielWhyte: folds 
phate-1up: folds 
pandaaaaaa: folds 
ViTiV2010: raises $0.50 to $0.75
el pore 5: folds 
1Karina1: folds 
kamikkaze: folds 
chiyuki: folds 
Uncalled bet ($0.50) returned to ViTiV2010
ViTiV2010 collected $0.60 from pot
ViTiV2010: doesn't show hand 
*** SUMMARY ***
Total pot $0.60 | Rake $0 
Seat 1: 1Karina1 (button) folded before Flop (didn't bet)
Seat 2: kamikkaze (small blind) folded before Flop
Seat 3: chiyuki (big blind) folded before Flop
Seat 4: kaplya2010 folded before Flop (didn't bet)
Seat 5: DanielWhyte folded before Flop (didn't bet)
Seat 6: phate-1up folded before Flop (didn't bet)
Seat 7: pandaaaaaa folded before Flop (didn't bet)
Seat 8: ViTiV2010 collected ($0.60)
Seat 9: el pore 5 folded before Flop (didn't bet)



PokerStars Zoom Hand #84300350353:  Hold'em No Limit ($0.10/$0.25) - 2012/08/05 15:22:16 JST [2012/08/05 2:22:16 ET]
Table 'Whirlpool' 9-max Seat #1 is the button
Seat 1: ChrisCDee ($68.22 in chips) 
Seat 2: seula i ($27.16 in chips) 
Seat 3: kamikkaze ($12.50 in chips) 
Seat 4: DanielWhyte ($61.71 in chips) 
Seat 5: Perstenev ($17.62 in chips) 
Seat 6: ZhukOFFskI ($29.55 in chips) 
Seat 7: slapshot2011 ($23.37 in chips) 
Seat 8: Dan Royal ($24.27 in chips) 
Seat 9: chiyuki ($35.42 in chips) 
seula i: posts small blind $0.10
kamikkaze: posts big blind $0.25
*** HOLE CARDS ***
Dealt to chiyuki [Jh 2h]
DanielWhyte: folds 
Perstenev: folds 
ZhukOFFskI: folds 
slapshot2011: folds 
Dan Royal: raises $0.50 to $0.75
chiyuki: folds 
ChrisCDee: folds 
seula i: raises $1.75 to $2.50
kamikkaze: folds 
Dan Royal: folds 
Uncalled bet ($1.75) returned to seula i
seula i collected $1.75 from pot
seula i: doesn't show hand 
*** SUMMARY ***
Total pot $1.75 | Rake $0 
Seat 1: ChrisCDee (button) folded before Flop (didn't bet)
Seat 2: seula i (small blind) collected ($1.75)
Seat 3: kamikkaze (big blind) folded before Flop
Seat 4: DanielWhyte folded before Flop (didn't bet)
Seat 5: Perstenev folded before Flop (didn't bet)
Seat 6: ZhukOFFskI folded before Flop (didn't bet)
Seat 7: slapshot2011 folded before Flop (didn't bet)
Seat 8: Dan Royal folded before Flop
Seat 9: chiyuki folded before Flop (didn't bet)



PokerStars Zoom Hand #84300342128:  Hold'em No Limit ($0.10/$0.25) - 2012/08/05 15:21:43 JST [2012/08/05 2:21:43 ET]
Table 'Whirlpool' 9-max Seat #1 is the button
Seat 1: snejokCoxx ($13.22 in chips) 
Seat 2: PAMBOS.L ($14.01 in chips) 
Seat 3: crazycrown1 ($12.50 in chips) 
Seat 4: GovGus ($25 in chips) 
Seat 5: xxx Spb xxx ($27.84 in chips) 
Seat 6: ygoegoe ($43.10 in chips) 
Seat 7: hirozo ($44.52 in chips) 
Seat 8: chiyuki ($35.77 in chips) 
Seat 9: PetitAlejo ($41.89 in chips) 
PAMBOS.L: posts small blind $0.10
crazycrown1: posts big blind $0.25
*** HOLE CARDS ***
Dealt to chiyuki [6c 8s]
GovGus: folds 
xxx Spb xxx: folds 
ygoegoe: folds 
hirozo: raises $0.50 to $0.75
chiyuki: folds 
PetitAlejo: folds 
snejokCoxx: folds 
PAMBOS.L: folds 
crazycrown1: calls $0.50
*** FLOP *** [7h 6d 5c]
crazycrown1: checks 
hirozo: bets $1.02
crazycrown1: calls $1.02
*** TURN *** [7h 6d 5c] [9d]
crazycrown1: checks 
hirozo: checks 
*** RIVER *** [7h 6d 5c 9d] [Ks]
crazycrown1: checks 
hirozo: checks 
*** SHOW DOWN ***
crazycrown1: shows [Jc 9c] (a pair of Nines)
hirozo: mucks hand 
crazycrown1 collected $3.48 from pot
crazycrown1 is disconnected 
*** SUMMARY ***
Total pot $3.64 | Rake $0.16 
Board [7h 6d 5c 9d Ks]
Seat 1: snejokCoxx (button) folded before Flop (didn't bet)
Seat 2: PAMBOS.L (small blind) folded before Flop
Seat 3: crazycrown1 (big blind) showed [Jc 9c] and won ($3.48) with a pair of Nines
Seat 4: GovGus folded before Flop (didn't bet)
Seat 5: xxx Spb xxx folded before Flop (didn't bet)
Seat 6: ygoegoe folded before Flop (didn't bet)
Seat 7: hirozo mucked [As Js]
Seat 8: chiyuki folded before Flop (didn't bet)
Seat 9: PetitAlejo folded before Flop (didn't bet)



PokerStars Zoom Hand #84300351597:  Hold'em No Limit ($0.10/$0.25) - 2012/08/05 15:22:21 JST [2012/08/05 2:22:21 ET]
Table 'Whirlpool' 9-max Seat #1 is the button
Seat 1: jacquelinewu ($73.61 in chips) 
Seat 2: AntoineHunt ($35.70 in chips) 
Seat 3: 1Karina1 ($26.27 in chips) 
Seat 4: el pore 5 ($14.22 in chips) 
Seat 5: snejokCoxx ($14.21 in chips) 
Seat 6: panaam ($20.98 in chips) 
Seat 7: chiyuki ($35.42 in chips) 
Seat 8: 4plankton ($17.40 in chips) 
Seat 9: DutchShultzs ($25.10 in chips) 
AntoineHunt: posts small blind $0.10
1Karina1: posts big blind $0.25
*** HOLE CARDS ***
Dealt to chiyuki [5d 3d]
el pore 5: folds 
snejokCoxx: folds 
panaam: folds 
chiyuki: folds 
4plankton: folds 
DutchShultzs: folds 
jacquelinewu: raises $0.50 to $0.75
AntoineHunt: folds 
1Karina1: calls $0.50
*** FLOP *** [Ks 2s 6d]
1Karina1: bets $1
jacquelinewu: folds 
Uncalled bet ($1) returned to 1Karina1
1Karina1 collected $1.53 from pot
1Karina1: doesn't show hand 
*** SUMMARY ***
Total pot $1.60 | Rake $0.07 
Board [Ks 2s 6d]
Seat 1: jacquelinewu (button) folded on the Flop
Seat 2: AntoineHunt (small blind) folded before Flop
Seat 3: 1Karina1 (big blind) collected ($1.53)
Seat 4: el pore 5 folded before Flop (didn't bet)
Seat 5: snejokCoxx folded before Flop (didn't bet)
Seat 6: panaam folded before Flop (didn't bet)
Seat 7: chiyuki folded before Flop (didn't bet)
Seat 8: 4plankton folded before Flop (didn't bet)
Seat 9: DutchShultzs folded before Flop (didn't bet)



PokerStars Zoom Hand #84300344164:  Hold'em No Limit ($0.10/$0.25) - 2012/08/05 15:21:51 JST [2012/08/05 2:21:51 ET]
Table 'Whirlpool' 9-max Seat #1 is the button
Seat 1: cofla tito ($12.25 in chips) 
Seat 2: snejokCoxx ($12.82 in chips) 
Seat 3: GovGus ($25 in chips) 
Seat 4: chiyuki ($35.77 in chips) 
Seat 5: phate-1up ($47.52 in chips) 
Seat 6: 1Karina1 ($25.70 in chips) 
Seat 7: Perstenev ($12.80 in chips) 
Seat 8: xxx Spb xxx ($25 in chips) 
Seat 9: AntoineHunt ($36.45 in chips) 
snejokCoxx: posts small blind $0.10
GovGus: posts big blind $0.25
*** HOLE CARDS ***
Dealt to chiyuki [Qs 7h]
chiyuki: folds 
phate-1up: raises $0.50 to $0.75
1Karina1: folds 
Perstenev: folds 
xxx Spb xxx: folds 
AntoineHunt: calls $0.75
cofla tito: calls $0.75
snejokCoxx: folds 
GovGus: folds 
*** FLOP *** [Qc 6h Kd]
phate-1up: bets $1.75
AntoineHunt: folds 
cofla tito: raises $2.75 to $4.50
phate-1up: folds 
Uncalled bet ($2.75) returned to cofla tito
cofla tito collected $5.83 from pot
cofla tito: doesn't show hand 
*** SUMMARY ***
Total pot $6.10 | Rake $0.27 
Board [Qc 6h Kd]
Seat 1: cofla tito (button) collected ($5.83)
Seat 2: snejokCoxx (small blind) folded before Flop
Seat 3: GovGus (big blind) folded before Flop
Seat 4: chiyuki folded before Flop (didn't bet)
Seat 5: phate-1up folded on the Flop
Seat 6: 1Karina1 folded before Flop (didn't bet)
Seat 7: Perstenev folded before Flop (didn't bet)
Seat 8: xxx Spb xxx folded before Flop (didn't bet)
Seat 9: AntoineHunt folded on the Flop



PokerStars Zoom Hand #84300348825:  Hold'em No Limit ($0.10/$0.25) - 2012/08/05 15:22:09 JST [2012/08/05 2:22:09 ET]
Table 'Whirlpool' 9-max Seat #1 is the button
Seat 1: troublesomm ($37.26 in chips) 
Seat 2: chiyuki ($35.52 in chips) 
Seat 3: phate-1up ($52.04 in chips) 
Seat 4: 1Karina1 ($26.27 in chips) 
Seat 5: DutchShultzs ($25.10 in chips) 
Seat 6: deadmoneykid ($41.31 in chips) 
Seat 7: snejokCoxx ($13.22 in chips) 
Seat 8: GovGus ($25 in chips) 
Seat 9: Dejacob ($38.36 in chips) 
chiyuki: posts small blind $0.10
phate-1up: posts big blind $0.25
*** HOLE CARDS ***
Dealt to chiyuki [6d Qh]
1Karina1: folds 
DutchShultzs: folds 
deadmoneykid: folds 
snejokCoxx: folds 
GovGus: raises $0.75 to $1
Dejacob: calls $1
troublesomm: folds 
chiyuki: folds 
phate-1up: folds 
*** FLOP *** [2s 7h 4s]
GovGus: checks 
Dejacob: bets $1.50
GovGus: folds 
Uncalled bet ($1.50) returned to Dejacob
Dejacob collected $2.24 from pot
Dejacob: doesn't show hand 
*** SUMMARY ***
Total pot $2.35 | Rake $0.11 
Board [2s 7h 4s]
Seat 1: troublesomm (button) folded before Flop (didn't bet)
Seat 2: chiyuki (small blind) folded before Flop
Seat 3: phate-1up (big blind) folded before Flop
Seat 4: 1Karina1 folded before Flop (didn't bet)
Seat 5: DutchShultzs folded before Flop (didn't bet)
Seat 6: deadmoneykid folded before Flop (didn't bet)
Seat 7: snejokCoxx folded before Flop (didn't bet)
Seat 8: GovGus folded on the Flop
Seat 9: Dejacob collected ($2.24)



PokerStars Zoom Hand #84300357717:  Hold'em No Limit ($0.10/$0.25) - 2012/08/05 15:22:45 JST [2012/08/05 2:22:45 ET]
Table 'Whirlpool' 9-max Seat #1 is the button
Seat 1: Perstenev ($10.34 in chips) 
Seat 2: Grishukps ($12.60 in chips) 
Seat 3: kwkim73 ($26.84 in chips) 
Seat 4: chiyuki ($35.42 in chips) 
Seat 5: Nerkit ($14.49 in chips) 
Seat 6: Silveystryk ($20.95 in chips) 
Seat 7: GovGus ($31.60 in chips) 
Seat 8: hirozo ($77.29 in chips) 
Seat 9: pandaaaaaa ($7.72 in chips) 
Grishukps: posts small blind $0.10
kwkim73: posts big blind $0.25
*** HOLE CARDS ***
Dealt to chiyuki [Jd 9c]
chiyuki: folds 
Nerkit: folds 
Silveystryk: folds 
GovGus: folds 
hirozo: raises $0.50 to $0.75
pandaaaaaa: folds 
Perstenev: folds 
Grishukps: folds 
kwkim73: folds 
Uncalled bet ($0.50) returned to hirozo
hirozo collected $0.60 from pot
hirozo: doesn't show hand 
*** SUMMARY ***
Total pot $0.60 | Rake $0 
Seat 1: Perstenev (button) folded before Flop (didn't bet)
Seat 2: Grishukps (small blind) folded before Flop
Seat 3: kwkim73 (big blind) folded before Flop
Seat 4: chiyuki folded before Flop (didn't bet)
Seat 5: Nerkit folded before Flop (didn't bet)
Seat 6: Silveystryk folded before Flop (didn't bet)
Seat 7: GovGus folded before Flop (didn't bet)
Seat 8: hirozo collected ($0.60)
Seat 9: pandaaaaaa folded before Flop (didn't bet)



PokerStars Zoom Hand #84300352798:  Hold'em No Limit ($0.10/$0.25) - 2012/08/05 15:22:26 JST [2012/08/05 2:22:26 ET]
Table 'Whirlpool' 9-max Seat #1 is the button
Seat 1: chiyuki ($35.42 in chips) 
Seat 2: Roglus ($3.60 in chips) 
Seat 3: drunk_bender ($16.65 in chips) 
Seat 4: ZhukOFFskI ($33.94 in chips) 
Seat 5: therati ($21.52 in chips) 
Seat 6: JhonnyP1979 ($7.40 in chips) 
Seat 7: xxx Spb xxx ($27.49 in chips) 
Seat 8: troublesomm ($37.16 in chips) 
Seat 9: Wilcox76607 ($18.29 in chips) 
Roglus: posts small blind $0.10
drunk_bender: posts big blind $0.25
*** HOLE CARDS ***
Dealt to chiyuki [9c Ac]
ZhukOFFskI: folds 
therati: calls $0.25
JhonnyP1979: folds 
xxx Spb xxx: folds 
troublesomm: folds 
Wilcox76607: calls $0.25
chiyuki: folds 
Roglus: folds 
drunk_bender: checks 
*** FLOP *** [6d Kc Ah]
drunk_bender: checks 
therati: checks 
Wilcox76607: bets $0.50
drunk_bender: folds 
therati: calls $0.50
*** TURN *** [6d Kc Ah] [4h]
therati: checks 
Wilcox76607: bets $1
therati: folds 
Uncalled bet ($1) returned to Wilcox76607
Wilcox76607 collected $1.77 from pot
Wilcox76607: doesn't show hand 
*** SUMMARY ***
Total pot $1.85 | Rake $0.08 
Board [6d Kc Ah 4h]
Seat 1: chiyuki (button) folded before Flop (didn't bet)
Seat 2: Roglus (small blind) folded before Flop
Seat 3: drunk_bender (big blind) folded on the Flop
Seat 4: ZhukOFFskI folded before Flop (didn't bet)
Seat 5: therati folded on the Turn
Seat 6: JhonnyP1979 folded before Flop (didn't bet)
Seat 7: xxx Spb xxx folded before Flop (didn't bet)
Seat 8: troublesomm folded before Flop (didn't bet)
Seat 9: Wilcox76607 collected ($1.77)



PokerStars Zoom Hand #84300355413:  Hold'em No Limit ($0.10/$0.25) - 2012/08/05 15:22:36 JST [2012/08/05 2:22:36 ET]
Table 'Whirlpool' 9-max Seat #1 is the button
Seat 1: xxx Spb xxx ($27.49 in chips) 
Seat 2: jacquelinewu ($37.64 in chips) 
Seat 3: troublesomm ($37.16 in chips) 
Seat 4: hirozo ($77.29 in chips) 
Seat 5: Ellen1947 ($22.72 in chips) 
Seat 6: chiyuki ($35.42 in chips) 
Seat 7: risekuku468 ($36.79 in chips) 
Seat 8: ygoegoe ($25 in chips) 
Seat 9: WARIBANA7777 ($14.08 in chips) 
jacquelinewu: posts small blind $0.10
troublesomm: posts big blind $0.25
*** HOLE CARDS ***
Dealt to chiyuki [6h 9c]
hirozo: folds 
Ellen1947: folds 
chiyuki: folds 
risekuku468: folds 
ygoegoe: folds 
WARIBANA7777: folds 
xxx Spb xxx: folds 
jacquelinewu: raises $0.50 to $0.75
troublesomm: calls $0.50
*** FLOP *** [2s 3h 8d]
jacquelinewu: checks 
troublesomm: bets $0.78
jacquelinewu: folds 
Uncalled bet ($0.78) returned to troublesomm
troublesomm collected $1.43 from pot
troublesomm: doesn't show hand 
*** SUMMARY ***
Total pot $1.50 | Rake $0.07 
Board [2s 3h 8d]
Seat 1: xxx Spb xxx (button) folded before Flop (didn't bet)
Seat 2: jacquelinewu (small blind) folded on the Flop
Seat 3: troublesomm (big blind) collected ($1.43)
Seat 4: hirozo folded before Flop (didn't bet)
Seat 5: Ellen1947 folded before Flop (didn't bet)
Seat 6: chiyuki folded before Flop (didn't bet)
Seat 7: risekuku468 folded before Flop (didn't bet)
Seat 8: ygoegoe folded before Flop (didn't bet)
Seat 9: WARIBANA7777 folded before Flop (didn't bet)



PokerStars Zoom Hand #84300358485:  Hold'em No Limit ($0.10/$0.25) - 2012/08/05 15:22:48 JST [2012/08/05 2:22:48 ET]
Table 'Whirlpool' 9-max Seat #1 is the button
Seat 1: seula i ($25 in chips) 
Seat 2: nastya040 ($21.28 in chips) 
Seat 3: chiyuki ($35.42 in chips) 
Seat 4: Yoshimac ($21.98 in chips) 
Seat 5: River_GmbH ($16.80 in chips) 
Seat 6: DutchShultzs ($25.10 in chips) 
Seat 7: Tom1999 ($4.95 in chips) 
Seat 8: slapshot2011 ($23.69 in chips) 
Seat 9: kwkim73 ($27.57 in chips) 
nastya040: posts small blind $0.10
chiyuki: posts big blind $0.25
*** HOLE CARDS ***
Dealt to chiyuki [Td Jd]
Yoshimac: calls $0.25
River_GmbH: folds 
DutchShultzs: folds 
Tom1999: folds 
slapshot2011: calls $0.25
kwkim73: folds 
seula i: folds 
nastya040: folds 
chiyuki: checks 
*** FLOP *** [Ks 8s 4s]
chiyuki: checks 
Yoshimac: checks 
slapshot2011: checks 
*** TURN *** [Ks 8s 4s] [8d]
chiyuki: checks 
Yoshimac: checks 
slapshot2011: bets $0.75
chiyuki: folds 
Yoshimac: folds 
Uncalled bet ($0.75) returned to slapshot2011
slapshot2011 collected $0.81 from pot
slapshot2011: doesn't show hand 
*** SUMMARY ***
Total pot $0.85 | Rake $0.04 
Board [Ks 8s 4s 8d]
Seat 1: seula i (button) folded before Flop (didn't bet)
Seat 2: nastya040 (small blind) folded before Flop
Seat 3: chiyuki (big blind) folded on the Turn
Seat 4: Yoshimac folded on the Turn
Seat 5: River_GmbH folded before Flop (didn't bet)
Seat 6: DutchShultzs folded before Flop (didn't bet)
Seat 7: Tom1999 folded before Flop (didn't bet)
Seat 8: slapshot2011 collected ($0.81)
Seat 9: kwkim73 folded before Flop (didn't bet)



PokerStars Zoom Hand #84300371392:  Hold'em No Limit ($0.10/$0.25) - 2012/08/05 15:23:39 JST [2012/08/05 2:23:39 ET]
Table 'Whirlpool' 9-max Seat #1 is the button
Seat 1: Spheroff ($25.10 in chips) 
Seat 2: crazycrown1 ($13.28 in chips) 
Seat 3: Perstenev ($11.70 in chips) 
Seat 4: kwkim73 ($33.77 in chips) 
Seat 5: masterkoolb ($12.85 in chips) 
Seat 6: troublesomm ($25 in chips) 
Seat 7: phate-1up ($30.04 in chips) 
Seat 8: chiyuki ($35.07 in chips) 
Seat 9: KeLevro0 ($12.88 in chips) 
crazycrown1: posts small blind $0.10
Perstenev: posts big blind $0.25
*** HOLE CARDS ***
Dealt to chiyuki [Jh Kh]
kwkim73: folds 
masterkoolb: folds 
troublesomm: folds 
phate-1up: folds 
chiyuki: folds 
KeLevro0: folds 
Spheroff: raises $0.50 to $0.75
crazycrown1: folds 
Perstenev: folds 
Uncalled bet ($0.50) returned to Spheroff
Spheroff collected $0.60 from pot
Spheroff: doesn't show hand 
*** SUMMARY ***
Total pot $0.60 | Rake $0 
Seat 1: Spheroff (button) collected ($0.60)
Seat 2: crazycrown1 (small blind) folded before Flop
Seat 3: Perstenev (big blind) folded before Flop
Seat 4: kwkim73 folded before Flop (didn't bet)
Seat 5: masterkoolb folded before Flop (didn't bet)
Seat 6: troublesomm folded before Flop (didn't bet)
Seat 7: phate-1up folded before Flop (didn't bet)
Seat 8: chiyuki folded before Flop (didn't bet)
Seat 9: KeLevro0 folded before Flop (didn't bet)



PokerStars Zoom Hand #84300373632:  Hold'em No Limit ($0.10/$0.25) - 2012/08/05 15:23:48 JST [2012/08/05 2:23:48 ET]
Table 'Whirlpool' 9-max Seat #1 is the button
Seat 1: chiyuki ($35.07 in chips) 
Seat 2: nastya040 ($19.18 in chips) 
Seat 3: cofla tito ($13.30 in chips) 
Seat 4: INSP!RON ($30.19 in chips) 
Seat 5: KrystalAA ($22.94 in chips) 
Seat 6: HighDuka ($29.35 in chips) 
Seat 7: KeLevro0 ($12.88 in chips) 
Seat 8: kamikkaze ($24.44 in chips) 
Seat 9: phate-1up ($51.44 in chips) 
nastya040: posts small blind $0.10
cofla tito: posts big blind $0.25
*** HOLE CARDS ***
Dealt to chiyuki [4c 6s]
INSP!RON: folds 
KrystalAA: folds 
HighDuka: folds 
KeLevro0: folds 
kamikkaze: folds 
phate-1up: folds 
chiyuki: folds 
nastya040: raises $0.50 to $0.75
cofla tito: folds 
Uncalled bet ($0.50) returned to nastya040
nastya040 collected $0.50 from pot
nastya040: doesn't show hand 
*** SUMMARY ***
Total pot $0.50 | Rake $0 
Seat 1: chiyuki (button) folded before Flop (didn't bet)
Seat 2: nastya040 (small blind) collected ($0.50)
Seat 3: cofla tito (big blind) folded before Flop
Seat 4: INSP!RON folded before Flop (didn't bet)
Seat 5: KrystalAA folded before Flop (didn't bet)
Seat 6: HighDuka folded before Flop (didn't bet)
Seat 7: KeLevro0 folded before Flop (didn't bet)
Seat 8: kamikkaze folded before Flop (didn't bet)
Seat 9: phate-1up folded before Flop (didn't bet)



PokerStars Zoom Hand #84300376474:  Hold'em No Limit ($0.10/$0.25) - 2012/08/05 15:23:59 JST [2012/08/05 2:23:59 ET]
Table 'Whirlpool' 9-max Seat #1 is the button
Seat 1: Silveystryk ($29.02 in chips) 
Seat 2: masterkoolb ($12.85 in chips) 
Seat 3: troublesomm ($25 in chips) 
Seat 4: mjmichi ($42.75 in chips) 
Seat 5: Perstenev ($11.45 in chips) 
Seat 6: chiyuki ($35.07 in chips) 
Seat 7: Rilko1975 ($35.86 in chips) 
Seat 8: snejokCoxx ($14.21 in chips) 
Seat 9: 1Karina1 ($27.41 in chips) 
masterkoolb: posts small blind $0.10
troublesomm: posts big blind $0.25
*** HOLE CARDS ***
Dealt to chiyuki [Ah 7d]
mjmichi: folds 
Perstenev: folds 
chiyuki: folds 
Rilko1975: folds 
snejokCoxx: folds 
1Karina1: folds 
Silveystryk: folds 
masterkoolb: raises $0.50 to $0.75
troublesomm: folds 
Uncalled bet ($0.50) returned to masterkoolb
masterkoolb collected $0.50 from pot
masterkoolb: doesn't show hand 
*** SUMMARY ***
Total pot $0.50 | Rake $0 
Seat 1: Silveystryk (button) folded before Flop (didn't bet)
Seat 2: masterkoolb (small blind) collected ($0.50)
Seat 3: troublesomm (big blind) folded before Flop
Seat 4: mjmichi folded before Flop (didn't bet)
Seat 5: Perstenev folded before Flop (didn't bet)
Seat 6: chiyuki folded before Flop (didn't bet)
Seat 7: Rilko1975 folded before Flop (didn't bet)
Seat 8: snejokCoxx folded before Flop (didn't bet)
Seat 9: 1Karina1 folded before Flop (didn't bet)



PokerStars Zoom Hand #84300367040:  Hold'em No Limit ($0.10/$0.25) - 2012/08/05 15:23:22 JST [2012/08/05 2:23:22 ET]
Table 'Whirlpool' 9-max Seat #1 is the button
Seat 1: GravyWalrus ($9.05 in chips) 
Seat 2: chiyuki ($35.17 in chips) 
Seat 3: Silveystryk ($25.35 in chips) 
Seat 4: ChrisCDee ($25 in chips) 
Seat 5: hirozo ($35.73 in chips) 
Seat 6: el pore 5 ($13.87 in chips) 
Seat 7: Perstenev ($12.65 in chips) 
Seat 8: Saruotiss ($55.97 in chips) 
Seat 9: xxx Spb xxx ($27.49 in chips) 
chiyuki: posts small blind $0.10
Silveystryk: posts big blind $0.25
*** HOLE CARDS ***
Dealt to chiyuki [7h 8d]
ChrisCDee: folds 
hirozo: folds 
el pore 5: calls $0.25
Perstenev: folds 
Saruotiss: folds 
xxx Spb xxx: raises $0.75 to $1
GravyWalrus: folds 
chiyuki: folds 
Silveystryk: folds 
el pore 5: calls $0.75
*** FLOP *** [5d 3d 5s]
el pore 5: checks 
xxx Spb xxx: bets $1.30
el pore 5: calls $1.30
*** TURN *** [5d 3d 5s] [Ts]
el pore 5: checks 
xxx Spb xxx: bets $2.50
el pore 5: raises $9.07 to $11.57 and is all-in
xxx Spb xxx: calls $9.07
*** RIVER *** [5d 3d 5s Ts] [7c]
*** SHOW DOWN ***
el pore 5: shows [Th Qs] (two pair, Tens and Fives)
xxx Spb xxx: shows [Tc Ah] (two pair, Tens and Fives - Ace kicker)
xxx Spb xxx collected $26.83 from pot
*** SUMMARY ***
Total pot $28.09 | Rake $1.26 
Board [5d 3d 5s Ts 7c]
Seat 1: GravyWalrus (button) folded before Flop (didn't bet)
Seat 2: chiyuki (small blind) folded before Flop
Seat 3: Silveystryk (big blind) folded before Flop
Seat 4: ChrisCDee folded before Flop (didn't bet)
Seat 5: hirozo folded before Flop (didn't bet)
Seat 6: el pore 5 showed [Th Qs] and lost with two pair, Tens and Fives
Seat 7: Perstenev folded before Flop (didn't bet)
Seat 8: Saruotiss folded before Flop (didn't bet)
Seat 9: xxx Spb xxx showed [Tc Ah] and won ($26.83) with two pair, Tens and Fives



PokerStars Zoom Hand #84300374650:  Hold'em No Limit ($0.10/$0.25) - 2012/08/05 15:23:52 JST [2012/08/05 2:23:52 ET]
Table 'Whirlpool' 9-max Seat #1 is the button
Seat 1: troublesomm ($25 in chips) 
Seat 2: phate-1up ($51.44 in chips) 
Seat 3: silvno31 ($47.57 in chips) 
Seat 4: Roglus ($7.23 in chips) 
Seat 5: deadmoneykid ($40.96 in chips) 
Seat 6: Grishukps ($12.50 in chips) 
Seat 7: Perstenev ($9.99 in chips) 
Seat 8: KeLevro0 ($12.88 in chips) 
Seat 9: chiyuki ($35.07 in chips) 
phate-1up: posts small blind $0.10
silvno31: posts big blind $0.25
*** HOLE CARDS ***
Dealt to chiyuki [6c Jh]
Roglus: folds 
deadmoneykid: folds 
Grishukps: folds 
Perstenev: folds 
KeLevro0: folds 
chiyuki: folds 
troublesomm: raises $0.50 to $0.75
phate-1up: folds 
silvno31: calls $0.50
*** FLOP *** [2d Th 9c]
silvno31: bets $1
troublesomm: raises $1 to $2
silvno31: calls $1
*** TURN *** [2d Th 9c] [Jc]
silvno31: checks 
troublesomm: bets $2.94
silvno31: folds 
Uncalled bet ($2.94) returned to troublesomm
troublesomm collected $5.35 from pot
troublesomm: doesn't show hand 
*** SUMMARY ***
Total pot $5.60 | Rake $0.25 
Board [2d Th 9c Jc]
Seat 1: troublesomm (button) collected ($5.35)
Seat 2: phate-1up (small blind) folded before Flop
Seat 3: silvno31 (big blind) folded on the Turn
Seat 4: Roglus folded before Flop (didn't bet)
Seat 5: deadmoneykid folded before Flop (didn't bet)
Seat 6: Grishukps folded before Flop (didn't bet)
Seat 7: Perstenev folded before Flop (didn't bet)
Seat 8: KeLevro0 folded before Flop (didn't bet)
Seat 9: chiyuki folded before Flop (didn't bet)



PokerStars Zoom Hand #84300380611:  Hold'em No Limit ($0.10/$0.25) - 2012/08/05 15:24:15 JST [2012/08/05 2:24:15 ET]
Table 'Whirlpool' 9-max Seat #1 is the button
Seat 1: hirozo ($81.19 in chips) 
Seat 2: snejokCoxx ($15.75 in chips) 
Seat 3: Dejacob ($25 in chips) 
Seat 4: deepakmbh ($29.95 in chips) 
Seat 5: Perstenev ($9.99 in chips) 
Seat 6: drunk_bender ($19.70 in chips) 
Seat 7: chiyuki ($35.07 in chips) 
Seat 8: Dan Royal ($26.03 in chips) 
Seat 9: phate-1up ($53.36 in chips) 
snejokCoxx: posts small blind $0.10
Dejacob: posts big blind $0.25
*** HOLE CARDS ***
Dealt to chiyuki [9s Kh]
deepakmbh: raises $0.55 to $0.80
Perstenev: folds 
drunk_bender: folds 
chiyuki: folds 
Dan Royal: folds 
phate-1up: folds 
hirozo: folds 
snejokCoxx: folds 
Dejacob: folds 
Uncalled bet ($0.55) returned to deepakmbh
deepakmbh collected $0.60 from pot
deepakmbh: doesn't show hand 
*** SUMMARY ***
Total pot $0.60 | Rake $0 
Seat 1: hirozo (button) folded before Flop (didn't bet)
Seat 2: snejokCoxx (small blind) folded before Flop
Seat 3: Dejacob (big blind) folded before Flop
Seat 4: deepakmbh collected ($0.60)
Seat 5: Perstenev folded before Flop (didn't bet)
Seat 6: drunk_bender folded before Flop (didn't bet)
Seat 7: chiyuki folded before Flop (didn't bet)
Seat 8: Dan Royal folded before Flop (didn't bet)
Seat 9: phate-1up folded before Flop (didn't bet)



PokerStars Zoom Hand #84300381336:  Hold'em No Limit ($0.10/$0.25) - 2012/08/05 15:24:18 JST [2012/08/05 2:24:18 ET]
Table 'Whirlpool' 9-max Seat #1 is the button
Seat 1: KeLevro0 ($12.88 in chips) 
Seat 2: troublesomm ($25 in chips) 
Seat 3: Rilko1975 ($35.86 in chips) 
Seat 4: kwkim73 ($25 in chips) 
Seat 5: chiyuki ($35.07 in chips) 
Seat 6: ZhukOFFskI ($29.90 in chips) 
Seat 7: deadmoneykid ($25.87 in chips) 
Seat 8: 1Karina1 ($27.41 in chips) 
Seat 9: GravyWalrus ($9.60 in chips) 
troublesomm: posts small blind $0.10
Rilko1975: posts big blind $0.25
*** HOLE CARDS ***
Dealt to chiyuki [9d 6s]
kwkim73: folds 
chiyuki: folds 
ZhukOFFskI: folds 
deadmoneykid: folds 
1Karina1: folds 
GravyWalrus: folds 
KeLevro0: folds 
troublesomm: folds 
Uncalled bet ($0.15) returned to Rilko1975
Rilko1975 collected $0.20 from pot
Rilko1975: doesn't show hand 
*** SUMMARY ***
Total pot $0.20 | Rake $0 
Seat 1: KeLevro0 (button) folded before Flop (didn't bet)
Seat 2: troublesomm (small blind) folded before Flop
Seat 3: Rilko1975 (big blind) collected ($0.20)
Seat 4: kwkim73 folded before Flop (didn't bet)
Seat 5: chiyuki folded before Flop (didn't bet)
Seat 6: ZhukOFFskI folded before Flop (didn't bet)
Seat 7: deadmoneykid folded before Flop (didn't bet)
Seat 8: 1Karina1 folded before Flop (didn't bet)
Seat 9: GravyWalrus folded before Flop (didn't bet)



PokerStars Zoom Hand #84300384174:  Hold'em No Limit ($0.10/$0.25) - 2012/08/05 15:24:29 JST [2012/08/05 2:24:29 ET]
Table 'Whirlpool' 9-max Seat #1 is the button
Seat 1: Dejacob ($25 in chips) 
Seat 2: Tidder ($24.25 in chips) 
Seat 3: nice.franki ($12.15 in chips) 
Seat 4: chiyuki ($35.07 in chips) 
Seat 5: ZhukOFFskI ($29.90 in chips) 
Seat 6: Silveystryk ($20.42 in chips) 
Seat 7: Grishukps ($12.50 in chips) 
Seat 8: troublesomm ($25 in chips) 
Seat 9: rey2040 ($4.67 in chips) 
Tidder: posts small blind $0.10
nice.franki: posts big blind $0.25
*** HOLE CARDS ***
Dealt to chiyuki [6s 3c]
chiyuki: folds 
ZhukOFFskI: folds 
Silveystryk: folds 
Grishukps: folds 
troublesomm: raises $0.50 to $0.75
rey2040: folds 
Dejacob: folds 
Tidder: folds 
nice.franki: folds 
Uncalled bet ($0.50) returned to troublesomm
troublesomm collected $0.60 from pot
troublesomm: doesn't show hand 
*** SUMMARY ***
Total pot $0.60 | Rake $0 
Seat 1: Dejacob (button) folded before Flop (didn't bet)
Seat 2: Tidder (small blind) folded before Flop
Seat 3: nice.franki (big blind) folded before Flop
Seat 4: chiyuki folded before Flop (didn't bet)
Seat 5: ZhukOFFskI folded before Flop (didn't bet)
Seat 6: Silveystryk folded before Flop (didn't bet)
Seat 7: Grishukps folded before Flop (didn't bet)
Seat 8: troublesomm collected ($0.60)
Seat 9: rey2040 folded before Flop (didn't bet)



PokerStars Zoom Hand #84300385188:  Hold'em No Limit ($0.10/$0.25) - 2012/08/05 15:24:33 JST [2012/08/05 2:24:33 ET]
Table 'Whirlpool' 9-max Seat #1 is the button
Seat 1: DutchShultzs ($42.61 in chips) 
Seat 2: Rilko1975 ($35.96 in chips) 
Seat 3: nice.franki ($12.50 in chips) 
Seat 4: troublesomm ($28.36 in chips) 
Seat 5: chiyuki ($35.07 in chips) 
Seat 6: deadmoneykid ($26.08 in chips) 
Seat 7: Rici47 ($27.65 in chips) 
Seat 8: ZhukOFFskI ($75.23 in chips) 
Seat 9: drunk_bender ($19.35 in chips) 
Rilko1975: posts small blind $0.10
nice.franki: posts big blind $0.25
*** HOLE CARDS ***
Dealt to chiyuki [Td Ts]
troublesomm: folds 
chiyuki: raises $0.50 to $0.75
deadmoneykid: folds 
Rici47: calls $0.75
ZhukOFFskI: folds 
drunk_bender: folds 
DutchShultzs: folds 
Rilko1975: folds 
nice.franki: folds 
*** FLOP *** [Jc Kc 3d]
chiyuki: checks 
Rici47: bets $0.25
chiyuki: calls $0.25
*** TURN *** [Jc Kc 3d] [Qh]
chiyuki: checks 
Rici47: bets $0.50
chiyuki: calls $0.50
*** RIVER *** [Jc Kc 3d Qh] [2c]
chiyuki: checks 
Rici47: bets $1
chiyuki: folds 
Uncalled bet ($1) returned to Rici47
Rici47 collected $3.20 from pot
Rici47: doesn't show hand 
*** SUMMARY ***
Total pot $3.35 | Rake $0.15 
Board [Jc Kc 3d Qh 2c]
Seat 1: DutchShultzs (button) folded before Flop (didn't bet)
Seat 2: Rilko1975 (small blind) folded before Flop
Seat 3: nice.franki (big blind) folded before Flop
Seat 4: troublesomm folded before Flop (didn't bet)
Seat 5: chiyuki folded on the River
Seat 6: deadmoneykid folded before Flop (didn't bet)
Seat 7: Rici47 collected ($3.20)
Seat 8: ZhukOFFskI folded before Flop (didn't bet)
Seat 9: drunk_bender folded before Flop (didn't bet)



PokerStars Zoom Hand #84300401356:  Hold'em No Limit ($0.10/$0.25) - 2012/08/05 15:25:37 JST [2012/08/05 2:25:37 ET]
Table 'Whirlpool' 9-max Seat #1 is the button
Seat 1: nice.franki ($11.80 in chips) 
Seat 2: therati ($21.85 in chips) 
Seat 3: kwkim73 ($25.35 in chips) 
Seat 4: ChrisCDee ($25 in chips) 
Seat 5: Roglus ($6.76 in chips) 
Seat 6: DutchShultzs ($42.96 in chips) 
Seat 7: Grishukps ($12.50 in chips) 
Seat 8: chiyuki ($33.47 in chips) 
Seat 9: ZhukOFFskI ($29.55 in chips) 
therati: posts small blind $0.10
kwkim73: posts big blind $0.25
*** HOLE CARDS ***
Dealt to chiyuki [Ah Jh]
ChrisCDee: folds 
Roglus: folds 
DutchShultzs: folds 
Grishukps: folds 
chiyuki: raises $0.50 to $0.75
ZhukOFFskI: folds 
nice.franki: folds 
therati: folds 
kwkim73: folds 
Uncalled bet ($0.50) returned to chiyuki
chiyuki collected $0.60 from pot
chiyuki: doesn't show hand 
*** SUMMARY ***
Total pot $0.60 | Rake $0 
Seat 1: nice.franki (button) folded before Flop (didn't bet)
Seat 2: therati (small blind) folded before Flop
Seat 3: kwkim73 (big blind) folded before Flop
Seat 4: ChrisCDee folded before Flop (didn't bet)
Seat 5: Roglus folded before Flop (didn't bet)
Seat 6: DutchShultzs folded before Flop (didn't bet)
Seat 7: Grishukps folded before Flop (didn't bet)
Seat 8: chiyuki collected ($0.60)
Seat 9: ZhukOFFskI folded before Flop (didn't bet)



PokerStars Zoom Hand #84300400323:  Hold'em No Limit ($0.10/$0.25) - 2012/08/05 15:25:33 JST [2012/08/05 2:25:33 ET]
Table 'Whirlpool' 9-max Seat #1 is the button
Seat 1: Yoshimac ($19.28 in chips) 
Seat 2: chiyuki ($33.57 in chips) 
Seat 3: phate-1up ($42.07 in chips) 
Seat 4: Perstenev ($10.95 in chips) 
Seat 5: mjmichi ($48.48 in chips) 
Seat 6: 1Karina1 ($26.60 in chips) 
Seat 7: nice.franki ($11.80 in chips) 
Seat 8: KeLevro0 ($12.89 in chips) 
Seat 9: seula i ($26.06 in chips) 
chiyuki: posts small blind $0.10
phate-1up: posts big blind $0.25
*** HOLE CARDS ***
Dealt to chiyuki [3s 7d]
Perstenev: folds 
mjmichi: raises $0.50 to $0.75
1Karina1: folds 
nice.franki: folds 
KeLevro0: folds 
seula i: folds 
Yoshimac: calls $0.75
chiyuki: folds 
phate-1up: calls $0.50
*** FLOP *** [4s 2c 3h]
phate-1up: checks 
mjmichi: bets $1.25
Yoshimac: folds 
phate-1up: folds 
Uncalled bet ($1.25) returned to mjmichi
mjmichi collected $2.24 from pot
mjmichi: doesn't show hand 
*** SUMMARY ***
Total pot $2.35 | Rake $0.11 
Board [4s 2c 3h]
Seat 1: Yoshimac (button) folded on the Flop
Seat 2: chiyuki (small blind) folded before Flop
Seat 3: phate-1up (big blind) folded on the Flop
Seat 4: Perstenev folded before Flop (didn't bet)
Seat 5: mjmichi collected ($2.24)
Seat 6: 1Karina1 folded before Flop (didn't bet)
Seat 7: nice.franki folded before Flop (didn't bet)
Seat 8: KeLevro0 folded before Flop (didn't bet)
Seat 9: seula i folded before Flop (didn't bet)



PokerStars Zoom Hand #84300405430:  Hold'em No Limit ($0.10/$0.25) - 2012/08/05 15:25:54 JST [2012/08/05 2:25:54 ET]
Table 'Whirlpool' 9-max Seat #1 is the button
Seat 1: Dejacob ($25 in chips) 
Seat 2: Gichboy ($11.99 in chips) 
Seat 3: chiyuki ($33.82 in chips) 
Seat 4: snejokCoxx ($12.02 in chips) 
Seat 5: DutchShultzs ($42.96 in chips) 
Seat 6: GovGus ($38.61 in chips) 
Seat 7: Lasutchik ($71.75 in chips) 
Seat 8: Perstenev ($15.90 in chips) 
Seat 9: jacquelinewu ($74.97 in chips) 
Gichboy: posts small blind $0.10
chiyuki: posts big blind $0.25
*** HOLE CARDS ***
Dealt to chiyuki [Qs Kd]
snejokCoxx: folds 
DutchShultzs: folds 
GovGus: folds 
Lasutchik: folds 
Perstenev: folds 
jacquelinewu: folds 
Dejacob: folds 
Gichboy: calls $0.15
chiyuki: raises $0.75 to $1
Gichboy: calls $0.75
*** FLOP *** [Jc 6c 8d]
Gichboy: checks 
chiyuki: bets $1
Gichboy: calls $1
*** TURN *** [Jc 6c 8d] [Tc]
Gichboy: checks 
chiyuki: checks 
*** RIVER *** [Jc 6c 8d Tc] [Ah]
Gichboy: bets $0.50
chiyuki: raises $2.50 to $3
Gichboy: calls $2.50
*** SHOW DOWN ***
chiyuki: shows [Qs Kd] (a straight, Ten to Ace)
Gichboy: mucks hand 
chiyuki collected $9.55 from pot
*** SUMMARY ***
Total pot $10 | Rake $0.45 
Board [Jc 6c 8d Tc Ah]
Seat 1: Dejacob (button) folded before Flop (didn't bet)
Seat 2: Gichboy (small blind) mucked [Js Ts]
Seat 3: chiyuki (big blind) showed [Qs Kd] and won ($9.55) with a straight, Ten to Ace
Seat 4: snejokCoxx folded before Flop (didn't bet)
Seat 5: DutchShultzs folded before Flop (didn't bet)
Seat 6: GovGus folded before Flop (didn't bet)
Seat 7: Lasutchik folded before Flop (didn't bet)
Seat 8: Perstenev folded before Flop (didn't bet)
Seat 9: jacquelinewu folded before Flop (didn't bet)



PokerStars Zoom Hand #84300425698:  Hold'em No Limit ($0.10/$0.25) - 2012/08/05 15:27:15 JST [2012/08/05 2:27:15 ET]
Table 'Whirlpool' 9-max Seat #1 is the button
Seat 1: cofla tito ($9.73 in chips) 
Seat 2: Gichboy ($25.17 in chips) 
Seat 3: snejokCoxx ($12.50 in chips) 
Seat 4: Jene4kaBest ($20.18 in chips) 
Seat 5: GovGus ($38.51 in chips) 
Seat 6: Grishukps ($12.85 in chips) 
Seat 7: chiyuki ($38.37 in chips) 
Seat 8: Perstenev ($15.55 in chips) 
Seat 9: Alvinpe85 ($55.19 in chips) 
Gichboy: posts small blind $0.10
snejokCoxx: posts big blind $0.25
*** HOLE CARDS ***
Dealt to chiyuki [5c 5h]
Jene4kaBest: folds 
GovGus: folds 
Grishukps: folds 
chiyuki: raises $0.50 to $0.75
Perstenev: folds 
Alvinpe85: folds 
cofla tito: folds 
Gichboy: folds 
snejokCoxx: folds 
Uncalled bet ($0.50) returned to chiyuki
chiyuki collected $0.60 from pot
chiyuki: doesn't show hand 
*** SUMMARY ***
Total pot $0.60 | Rake $0 
Seat 1: cofla tito (button) folded before Flop (didn't bet)
Seat 2: Gichboy (small blind) folded before Flop
Seat 3: snejokCoxx (big blind) folded before Flop
Seat 4: Jene4kaBest folded before Flop (didn't bet)
Seat 5: GovGus folded before Flop (didn't bet)
Seat 6: Grishukps folded before Flop (didn't bet)
Seat 7: chiyuki collected ($0.60)
Seat 8: Perstenev folded before Flop (didn't bet)
Seat 9: Alvinpe85 folded before Flop (didn't bet)



PokerStars Zoom Hand #84300434835:  Hold'em No Limit ($0.10/$0.25) - 2012/08/05 15:27:51 JST [2012/08/05 2:27:51 ET]
Table 'Whirlpool' 9-max Seat #1 is the button
Seat 1: kwkim73 ($25.60 in chips) 
Seat 2: Perstenev ($10.45 in chips) 
Seat 3: Grishukps ($13.20 in chips) 
Seat 4: troublesomm ($27.91 in chips) 
Seat 5: nice.franki ($11.45 in chips) 
Seat 6: chiyuki ($38.72 in chips) 
Seat 7: kamikkaze ($12.50 in chips) 
Seat 8: Dejacob ($28.35 in chips) 
Seat 9: nastya040 ($15.80 in chips) 
Perstenev: posts small blind $0.10
Grishukps: posts big blind $0.25
*** HOLE CARDS ***
Dealt to chiyuki [7d As]
troublesomm: folds 
nice.franki: folds 
chiyuki: folds 
kamikkaze: folds 
Dejacob: folds 
nastya040: raises $0.25 to $0.50
kwkim73: folds 
Perstenev: folds 
Grishukps: folds 
Uncalled bet ($0.25) returned to nastya040
nastya040 collected $0.60 from pot
nastya040: doesn't show hand 
*** SUMMARY ***
Total pot $0.60 | Rake $0 
Seat 1: kwkim73 (button) folded before Flop (didn't bet)
Seat 2: Perstenev (small blind) folded before Flop
Seat 3: Grishukps (big blind) folded before Flop
Seat 4: troublesomm folded before Flop (didn't bet)
Seat 5: nice.franki folded before Flop (didn't bet)
Seat 6: chiyuki folded before Flop (didn't bet)
Seat 7: kamikkaze folded before Flop (didn't bet)
Seat 8: Dejacob folded before Flop (didn't bet)
Seat 9: nastya040 collected ($0.60)



PokerStars Zoom Hand #84300439613:  Hold'em No Limit ($0.10/$0.25) - 2012/08/05 15:28:10 JST [2012/08/05 2:28:10 ET]
Table 'Whirlpool' 9-max Seat #1 is the button
Seat 1: snejokCoxx ($12.15 in chips) 
Seat 2: Alvinpe85 ($54.94 in chips) 
Seat 3: kwkim73 ($26.80 in chips) 
Seat 4: chiyuki ($38.72 in chips) 
Seat 5: Dejacob ($25 in chips) 
Seat 6: ygoegoe ($44.50 in chips) 
Seat 7: hirozo ($81.43 in chips) 
Seat 8: troublesomm ($27.66 in chips) 
Seat 9: Faraz ($14.65 in chips) 
Alvinpe85: posts small blind $0.10
kwkim73: posts big blind $0.25
*** HOLE CARDS ***
Dealt to chiyuki [5h Ks]
chiyuki: folds 
Dejacob: folds 
ygoegoe: folds 
hirozo: folds 
troublesomm: folds 
Faraz: raises $0.25 to $0.50
snejokCoxx: folds 
Alvinpe85: folds 
kwkim73: folds 
Uncalled bet ($0.25) returned to Faraz
Faraz collected $0.60 from pot
Faraz: doesn't show hand 
*** SUMMARY ***
Total pot $0.60 | Rake $0 
Seat 1: snejokCoxx (button) folded before Flop (didn't bet)
Seat 2: Alvinpe85 (small blind) folded before Flop
Seat 3: kwkim73 (big blind) folded before Flop
Seat 4: chiyuki folded before Flop (didn't bet)
Seat 5: Dejacob folded before Flop (didn't bet)
Seat 6: ygoegoe folded before Flop (didn't bet)
Seat 7: hirozo folded before Flop (didn't bet)
Seat 8: troublesomm folded before Flop (didn't bet)
Seat 9: Faraz collected ($0.60)



PokerStars Zoom Hand #84300442131:  Hold'em No Limit ($0.10/$0.25) - 2012/08/05 15:28:21 JST [2012/08/05 2:28:21 ET]
Table 'Whirlpool' 9-max Seat #1 is the button
Seat 1: nice.franki ($10.15 in chips) 
Seat 2: deadmoneykid ($30.92 in chips) 
Seat 3: hirozo ($35.23 in chips) 
Seat 4: chiyuki ($38.72 in chips) 
Seat 5: troublesomm ($27.90 in chips) 
Seat 6: ChrisCDee ($66.24 in chips) 
Seat 7: DutchShultzs ($26.02 in chips) 
Seat 8: Alvinpe85 ($52.76 in chips) 
Seat 9: River_GmbH ($15.60 in chips) 
deadmoneykid: posts small blind $0.10
hirozo: posts big blind $0.25
*** HOLE CARDS ***
Dealt to chiyuki [Kh Th]
chiyuki: folds 
troublesomm: folds 
ChrisCDee: folds 
DutchShultzs: folds 
Alvinpe85: folds 
River_GmbH: folds 
nice.franki: folds 
deadmoneykid: folds 
Uncalled bet ($0.15) returned to hirozo
hirozo collected $0.20 from pot
hirozo: doesn't show hand 
*** SUMMARY ***
Total pot $0.20 | Rake $0 
Seat 1: nice.franki (button) folded before Flop (didn't bet)
Seat 2: deadmoneykid (small blind) folded before Flop
Seat 3: hirozo (big blind) collected ($0.20)
Seat 4: chiyuki folded before Flop (didn't bet)
Seat 5: troublesomm folded before Flop (didn't bet)
Seat 6: ChrisCDee folded before Flop (didn't bet)
Seat 7: DutchShultzs folded before Flop (didn't bet)
Seat 8: Alvinpe85 folded before Flop (didn't bet)
Seat 9: River_GmbH folded before Flop (didn't bet)



PokerStars Zoom Hand #84300438870:  Hold'em No Limit ($0.10/$0.25) - 2012/08/05 15:28:07 JST [2012/08/05 2:28:07 ET]
Table 'Whirlpool' 9-max Seat #1 is the button
Seat 1: mjmichi ($48.62 in chips) 
Seat 2: Wilcox76607 ($19.90 in chips) 
Seat 3: Rilko1975 ($33.86 in chips) 
Seat 4: chiyuki ($38.72 in chips) 
Seat 5: Dan Royal ($31.41 in chips) 
Seat 6: KrystalAA ($12.77 in chips) 
Seat 7: Ellen1947 ($29.24 in chips) 
Seat 8: panaam ($20.53 in chips) 
Seat 9: hirozo ($85.11 in chips) 
Wilcox76607: posts small blind $0.10
Rilko1975: posts big blind $0.25
*** HOLE CARDS ***
Dealt to chiyuki [8c 9s]
chiyuki: folds 
Dan Royal: folds 
KrystalAA: folds 
Ellen1947: folds 
panaam: folds 
hirozo: raises $0.50 to $0.75
mjmichi: folds 
Wilcox76607: calls $0.65
Rilko1975: folds 
*** FLOP *** [3c 6h 4h]
Wilcox76607: checks 
hirozo: bets $1.11
Wilcox76607: folds 
Uncalled bet ($1.11) returned to hirozo
hirozo collected $1.67 from pot
hirozo: doesn't show hand 
*** SUMMARY ***
Total pot $1.75 | Rake $0.08 
Board [3c 6h 4h]
Seat 1: mjmichi (button) folded before Flop (didn't bet)
Seat 2: Wilcox76607 (small blind) folded on the Flop
Seat 3: Rilko1975 (big blind) folded before Flop
Seat 4: chiyuki folded before Flop (didn't bet)
Seat 5: Dan Royal folded before Flop (didn't bet)
Seat 6: KrystalAA folded before Flop (didn't bet)
Seat 7: Ellen1947 folded before Flop (didn't bet)
Seat 8: panaam folded before Flop (didn't bet)
Seat 9: hirozo collected ($1.67)



PokerStars Zoom Hand #84300430244:  Hold'em No Limit ($0.10/$0.25) - 2012/08/05 15:27:33 JST [2012/08/05 2:27:33 ET]
Table 'Whirlpool' 9-max Seat #1 is the button
Seat 1: chiyuki ($38.72 in chips) 
Seat 2: GovGus ($38.26 in chips) 
Seat 3: NuMetal88 ($25.25 in chips) 
Seat 4: ViTiV2010 ($13.20 in chips) 
Seat 5: kwkim73 ($25.60 in chips) 
Seat 6: Lasutchik ($69.54 in chips) 
Seat 7: KeLevro0 ($11.70 in chips) 
Seat 8: deadmoneykid ($39.16 in chips) 
Seat 9: Rilko1975 ($33.86 in chips) 
GovGus: posts small blind $0.10
NuMetal88: posts big blind $0.25
*** HOLE CARDS ***
Dealt to chiyuki [8s 6h]
ViTiV2010: folds 
kwkim73: folds 
Lasutchik: folds 
KeLevro0: folds 
deadmoneykid: calls $0.25
Rilko1975: folds 
chiyuki: folds 
GovGus: folds 
NuMetal88: checks 
*** FLOP *** [7d Qd 9d]
NuMetal88: checks 
deadmoneykid: checks 
*** TURN *** [7d Qd 9d] [3d]
NuMetal88: checks 
deadmoneykid: checks 
*** RIVER *** [7d Qd 9d 3d] [Tc]
NuMetal88: checks 
deadmoneykid: checks 
*** SHOW DOWN ***
NuMetal88: shows [4s 7h] (a pair of Sevens)
deadmoneykid: shows [Qc Jc] (a pair of Queens)
deadmoneykid collected $0.57 from pot
*** SUMMARY ***
Total pot $0.60 | Rake $0.03 
Board [7d Qd 9d 3d Tc]
Seat 1: chiyuki (button) folded before Flop (didn't bet)
Seat 2: GovGus (small blind) folded before Flop
Seat 3: NuMetal88 (big blind) showed [4s 7h] and lost with a pair of Sevens
Seat 4: ViTiV2010 folded before Flop (didn't bet)
Seat 5: kwkim73 folded before Flop (didn't bet)
Seat 6: Lasutchik folded before Flop (didn't bet)
Seat 7: KeLevro0 folded before Flop (didn't bet)
Seat 8: deadmoneykid showed [Qc Jc] and won ($0.57) with a pair of Queens
Seat 9: Rilko1975 folded before Flop (didn't bet)



PokerStars Zoom Hand #84300437601:  Hold'em No Limit ($0.10/$0.25) - 2012/08/05 15:28:02 JST [2012/08/05 2:28:02 ET]
Table 'Whirlpool' 9-max Seat #1 is the button
Seat 1: jacquelinewu ($74.52 in chips) 
Seat 2: AVerdonk ($37.97 in chips) 
Seat 3: PPP7SSS ($25 in chips) 
Seat 4: KeLevro0 ($11.51 in chips) 
Seat 5: chiyuki ($38.72 in chips) 
Seat 6: pandaaaaaa ($7.26 in chips) 
Seat 7: ViTiV2010 ($12.70 in chips) 
Seat 8: ygoegoe ($44.50 in chips) 
Seat 9: GSDP ($25.06 in chips) 
AVerdonk: posts small blind $0.10
PPP7SSS: posts big blind $0.25
*** HOLE CARDS ***
Dealt to chiyuki [Qd Ts]
KeLevro0: raises $0.42 to $0.67
chiyuki: folds 
pandaaaaaa: folds 
ViTiV2010: folds 
ygoegoe: folds 
GSDP: folds 
jacquelinewu: folds 
AVerdonk: calls $0.57
PPP7SSS: calls $0.42
*** FLOP *** [7h Td Js]
AVerdonk: checks 
PPP7SSS: bets $0.75
KeLevro0: folds 
AVerdonk: raises $1 to $1.75
PPP7SSS: folds 
Uncalled bet ($1) returned to AVerdonk
AVerdonk collected $3.35 from pot
AVerdonk: doesn't show hand 
*** SUMMARY ***
Total pot $3.51 | Rake $0.16 
Board [7h Td Js]
Seat 1: jacquelinewu (button) folded before Flop (didn't bet)
Seat 2: AVerdonk (small blind) collected ($3.35)
Seat 3: PPP7SSS (big blind) folded on the Flop
Seat 4: KeLevro0 folded on the Flop
Seat 5: chiyuki folded before Flop (didn't bet)
Seat 6: pandaaaaaa folded before Flop (didn't bet)
Seat 7: ViTiV2010 folded before Flop (didn't bet)
Seat 8: ygoegoe folded before Flop (didn't bet)
Seat 9: GSDP folded before Flop (didn't bet)



PokerStars Zoom Hand #84300444644:  Hold'em No Limit ($0.10/$0.25) - 2012/08/05 15:28:31 JST [2012/08/05 2:28:31 ET]
Table 'Whirlpool' 9-max Seat #1 is the button
Seat 1: Grishukps ($12.85 in chips) 
Seat 2: kamikkaze ($14.23 in chips) 
Seat 3: Dan Royal ($31.41 in chips) 
Seat 4: ygoegoe ($39.66 in chips) 
Seat 5: DutchShultzs ($43.93 in chips) 
Seat 6: masterkoolb ($15.13 in chips) 
Seat 7: kwkim73 ($25.35 in chips) 
Seat 8: deadmoneykid ($26.37 in chips) 
Seat 9: chiyuki ($38.72 in chips) 
kamikkaze: posts small blind $0.10
Dan Royal: posts big blind $0.25
*** HOLE CARDS ***
Dealt to chiyuki [8d Jh]
ygoegoe: folds 
DutchShultzs: folds 
masterkoolb: folds 
kwkim73: folds 
deadmoneykid: folds 
chiyuki: folds 
Grishukps: folds 
kamikkaze: folds 
Uncalled bet ($0.15) returned to Dan Royal
Dan Royal collected $0.20 from pot
Dan Royal: doesn't show hand 
*** SUMMARY ***
Total pot $0.20 | Rake $0 
Seat 1: Grishukps (button) folded before Flop (didn't bet)
Seat 2: kamikkaze (small blind) folded before Flop
Seat 3: Dan Royal (big blind) collected ($0.20)
Seat 4: ygoegoe folded before Flop (didn't bet)
Seat 5: DutchShultzs folded before Flop (didn't bet)
Seat 6: masterkoolb folded before Flop (didn't bet)
Seat 7: kwkim73 folded before Flop (didn't bet)
Seat 8: deadmoneykid folded before Flop (didn't bet)
Seat 9: chiyuki folded before Flop (didn't bet)



PokerStars Zoom Hand #84300433837:  Hold'em No Limit ($0.10/$0.25) - 2012/08/05 15:27:47 JST [2012/08/05 2:27:47 ET]
Table 'Whirlpool' 9-max Seat #1 is the button
Seat 1: nastya040 ($15.80 in chips) 
Seat 2: xxx Spb xxx ($25.98 in chips) 
Seat 3: Silveystryk ($20.93 in chips) 
Seat 4: DutchShultzs ($44.68 in chips) 
Seat 5: 1Karina1 ($26.19 in chips) 
Seat 6: Rici47 ($28.76 in chips) 
Seat 7: INSP!RON ($42 in chips) 
Seat 8: kwkim73 ($25.60 in chips) 
Seat 9: chiyuki ($38.72 in chips) 
xxx Spb xxx: posts small blind $0.10
Silveystryk: posts big blind $0.25
*** HOLE CARDS ***
Dealt to chiyuki [Js Qh]
DutchShultzs: folds 
1Karina1: folds 
Rici47: calls $0.25
INSP!RON: folds 
kwkim73: folds 
chiyuki: folds 
nastya040: folds 
xxx Spb xxx: folds 
Silveystryk: checks 
*** FLOP *** [8s 6d 2h]
Silveystryk: bets $0.25
Rici47: calls $0.25
*** TURN *** [8s 6d 2h] [Td]
Silveystryk: bets $0.25
Rici47: raises $0.50 to $0.75
Silveystryk: calls $0.50
*** RIVER *** [8s 6d 2h Td] [8h]
Silveystryk: bets $1.25
Rici47: calls $1.25
*** SHOW DOWN ***
Silveystryk: shows [8d Qc] (three of a kind, Eights)
Rici47: mucks hand 
Silveystryk collected $4.87 from pot
*** SUMMARY ***
Total pot $5.10 | Rake $0.23 
Board [8s 6d 2h Td 8h]
Seat 1: nastya040 (button) folded before Flop (didn't bet)
Seat 2: xxx Spb xxx (small blind) folded before Flop
Seat 3: Silveystryk (big blind) showed [8d Qc] and won ($4.87) with three of a kind, Eights
Seat 4: DutchShultzs folded before Flop (didn't bet)
Seat 5: 1Karina1 folded before Flop (didn't bet)
Seat 6: Rici47 mucked [As 9s]
Seat 7: INSP!RON folded before Flop (didn't bet)
Seat 8: kwkim73 folded before Flop (didn't bet)
Seat 9: chiyuki folded before Flop (didn't bet)



PokerStars Zoom Hand #84300445909:  Hold'em No Limit ($0.10/$0.25) - 2012/08/05 15:28:36 JST [2012/08/05 2:28:36 ET]
Table 'Whirlpool' 9-max Seat #1 is the button
Seat 1: Rilko1975 ($33.51 in chips) 
Seat 2: mjmichi ($46.19 in chips) 
Seat 3: chiyuki ($38.72 in chips) 
Seat 4: jacquelinewu ($25.35 in chips) 
Seat 5: hirozo ($35.33 in chips) 
Seat 6: Perstenev ($8.75 in chips) 
Seat 7: INSP!RON ($42.25 in chips) 
Seat 8: seula i ($25.75 in chips) 
Seat 9: pandaaaaaa ($7.16 in chips) 
mjmichi: posts small blind $0.10
chiyuki: posts big blind $0.25
*** HOLE CARDS ***
Dealt to chiyuki [7c 5s]
jacquelinewu: folds 
hirozo: folds 
Perstenev: folds 
INSP!RON: folds 
seula i: folds 
pandaaaaaa: folds 
Rilko1975: raises $0.50 to $0.75
mjmichi: raises $1.50 to $2.25
chiyuki: folds 
Rilko1975: folds 
Uncalled bet ($1.50) returned to mjmichi
mjmichi collected $1.75 from pot
mjmichi: doesn't show hand 
*** SUMMARY ***
Total pot $1.75 | Rake $0 
Seat 1: Rilko1975 (button) folded before Flop
Seat 2: mjmichi (small blind) collected ($1.75)
Seat 3: chiyuki (big blind) folded before Flop
Seat 4: jacquelinewu folded before Flop (didn't bet)
Seat 5: hirozo folded before Flop (didn't bet)
Seat 6: Perstenev folded before Flop (didn't bet)
Seat 7: INSP!RON folded before Flop (didn't bet)
Seat 8: seula i folded before Flop (didn't bet)
Seat 9: pandaaaaaa folded before Flop (didn't bet)



PokerStars Zoom Hand #84300455298:  Hold'em No Limit ($0.10/$0.25) - 2012/08/05 15:29:13 JST [2012/08/05 2:29:13 ET]
Table 'Whirlpool' 9-max Seat #1 is the button
Seat 1: DutchShultzs ($26.02 in chips) 
Seat 2: chiyuki ($38.47 in chips) 
Seat 3: Dan Royal ($31.41 in chips) 
Seat 4: ZhukOFFskI ($80.70 in chips) 
Seat 5: troublesomm ($25 in chips) 
Seat 6: Saruotiss ($61.36 in chips) 
Seat 7: snejokCoxx ($12.35 in chips) 
Seat 8: NuMetal88 ($25.35 in chips) 
Seat 9: soul_5577 ($12.25 in chips) 
chiyuki: posts small blind $0.10
Dan Royal: posts big blind $0.25
*** HOLE CARDS ***
Dealt to chiyuki [6c 4c]
ZhukOFFskI: folds 
troublesomm: folds 
Saruotiss: folds 
snejokCoxx: folds 
NuMetal88: folds 
soul_5577: folds 
DutchShultzs: folds 
chiyuki: folds 
Uncalled bet ($0.15) returned to Dan Royal
Dan Royal collected $0.20 from pot
Dan Royal: doesn't show hand 
*** SUMMARY ***
Total pot $0.20 | Rake $0 
Seat 1: DutchShultzs (button) folded before Flop (didn't bet)
Seat 2: chiyuki (small blind) folded before Flop
Seat 3: Dan Royal (big blind) collected ($0.20)
Seat 4: ZhukOFFskI folded before Flop (didn't bet)
Seat 5: troublesomm folded before Flop (didn't bet)
Seat 6: Saruotiss folded before Flop (didn't bet)
Seat 7: snejokCoxx folded before Flop (didn't bet)
Seat 8: NuMetal88 folded before Flop (didn't bet)
Seat 9: soul_5577 folded before Flop (didn't bet)



PokerStars Zoom Hand #84300461235:  Hold'em No Limit ($0.10/$0.25) - 2012/08/05 15:29:38 JST [2012/08/05 2:29:38 ET]
Table 'Whirlpool' 9-max Seat #1 is the button
Seat 1: Tom1999 ($20.92 in chips) 
Seat 2: cofla tito ($11.81 in chips) 
Seat 3: xxx Spb xxx ($25 in chips) 
Seat 4: silvno31 ($46.24 in chips) 
Seat 5: NuMetal88 ($25.35 in chips) 
Seat 6: nice.franki ($11.55 in chips) 
Seat 7: soul_5577 ($12.15 in chips) 
Seat 8: chiyuki ($38.37 in chips) 
Seat 9: troublesomm ($36.04 in chips) 
cofla tito: posts small blind $0.10
xxx Spb xxx: posts big blind $0.25
*** HOLE CARDS ***
Dealt to chiyuki [2c 2s]
silvno31: raises $0.50 to $0.75
NuMetal88: folds 
nice.franki: folds 
soul_5577: folds 
chiyuki: folds 
troublesomm: folds 
Tom1999: folds 
cofla tito: folds 
xxx Spb xxx: folds 
Uncalled bet ($0.50) returned to silvno31
silvno31 collected $0.60 from pot
silvno31: doesn't show hand 
*** SUMMARY ***
Total pot $0.60 | Rake $0 
Seat 1: Tom1999 (button) folded before Flop (didn't bet)
Seat 2: cofla tito (small blind) folded before Flop
Seat 3: xxx Spb xxx (big blind) folded before Flop
Seat 4: silvno31 collected ($0.60)
Seat 5: NuMetal88 folded before Flop (didn't bet)
Seat 6: nice.franki folded before Flop (didn't bet)
Seat 7: soul_5577 folded before Flop (didn't bet)
Seat 8: chiyuki folded before Flop (didn't bet)
Seat 9: troublesomm folded before Flop (didn't bet)



PokerStars Zoom Hand #84300457249:  Hold'em No Limit ($0.10/$0.25) - 2012/08/05 15:29:21 JST [2012/08/05 2:29:21 ET]
Table 'Whirlpool' 9-max Seat #1 is the button
Seat 1: chiyuki ($38.37 in chips) 
Seat 2: 4ydo yogurt ($29.26 in chips) 
Seat 3: kwkim73 ($25.15 in chips) 
Seat 4: JhonnyP1979 ($3.99 in chips) 
Seat 5: KeLevro0 ($10.78 in chips) 
Seat 6: wildy29 ($39.69 in chips) 
Seat 7: Perstenev ($8.40 in chips) 
Seat 8: Nerkit ($12.88 in chips) 
Seat 9: ViTiV2010 ($13.05 in chips) 
4ydo yogurt: posts small blind $0.10
kwkim73: posts big blind $0.25
*** HOLE CARDS ***
Dealt to chiyuki [Kc Td]
JhonnyP1979: folds 
KeLevro0: raises $0.42 to $0.67
wildy29: folds 
Perstenev: folds 
Nerkit: calls $0.67
ViTiV2010: folds 
chiyuki: folds 
4ydo yogurt: calls $0.57
kwkim73: folds 
*** FLOP *** [Qd 6h 3h]
4ydo yogurt: bets $0.50
KeLevro0: folds 
Nerkit: raises $2 to $2.50
4ydo yogurt: calls $2
*** TURN *** [Qd 6h 3h] [7s]
4ydo yogurt: bets $1
Nerkit: raises $4.50 to $5.50
4ydo yogurt: folds 
Uncalled bet ($4.50) returned to Nerkit
Nerkit collected $8.84 from pot
Nerkit: doesn't show hand 
*** SUMMARY ***
Total pot $9.26 | Rake $0.42 
Board [Qd 6h 3h 7s]
Seat 1: chiyuki (button) folded before Flop (didn't bet)
Seat 2: 4ydo yogurt (small blind) folded on the Turn
Seat 3: kwkim73 (big blind) folded before Flop
Seat 4: JhonnyP1979 folded before Flop (didn't bet)
Seat 5: KeLevro0 folded on the Flop
Seat 6: wildy29 folded before Flop (didn't bet)
Seat 7: Perstenev folded before Flop (didn't bet)
Seat 8: Nerkit collected ($8.84)
Seat 9: ViTiV2010 folded before Flop (didn't bet)



PokerStars Zoom Hand #84300463696:  Hold'em No Limit ($0.10/$0.25) - 2012/08/05 15:29:48 JST [2012/08/05 2:29:48 ET]
Table 'Whirlpool' 9-max Seat #1 is the button
Seat 1: PPP7SSS ($20.08 in chips) 
Seat 2: rey2040 ($10.06 in chips) 
Seat 3: jacquelinewu ($36.62 in chips) 
Seat 4: 1Karina1 ($25.59 in chips) 
Seat 5: deadmoneykid ($25.38 in chips) 
Seat 6: chiyuki ($38.37 in chips) 
Seat 7: mjmichi ($47.19 in chips) 
Seat 8: Jene4kaBest ($17.34 in chips) 
Seat 9: panaam ($20.50 in chips) 
rey2040: posts small blind $0.10
jacquelinewu: posts big blind $0.25
*** HOLE CARDS ***
Dealt to chiyuki [2h 8c]
1Karina1: folds 
deadmoneykid: folds 
chiyuki: folds 
mjmichi: folds 
Jene4kaBest: raises $0.50 to $0.75
panaam: folds 
PPP7SSS: calls $0.75
rey2040: calls $0.65
jacquelinewu: folds 
*** FLOP *** [5c Jh Qc]
rey2040: checks 
Jene4kaBest: checks 
PPP7SSS: bets $0.75
rey2040: folds 
Jene4kaBest: calls $0.75
*** TURN *** [5c Jh Qc] [4d]
Jene4kaBest: checks 
PPP7SSS: bets $1
Jene4kaBest: folds 
Uncalled bet ($1) returned to PPP7SSS
PPP7SSS collected $3.82 from pot
PPP7SSS: doesn't show hand 
*** SUMMARY ***
Total pot $4 | Rake $0.18 
Board [5c Jh Qc 4d]
Seat 1: PPP7SSS (button) collected ($3.82)
Seat 2: rey2040 (small blind) folded on the Flop
Seat 3: jacquelinewu (big blind) folded before Flop
Seat 4: 1Karina1 folded before Flop (didn't bet)
Seat 5: deadmoneykid folded before Flop (didn't bet)
Seat 6: chiyuki folded before Flop (didn't bet)
Seat 7: mjmichi folded before Flop (didn't bet)
Seat 8: Jene4kaBest folded on the Turn
Seat 9: panaam folded before Flop (didn't bet)



PokerStars Zoom Hand #84300462171:  Hold'em No Limit ($0.10/$0.25) - 2012/08/05 15:29:42 JST [2012/08/05 2:29:42 ET]
Table 'Whirlpool' 9-max Seat #1 is the button
Seat 1: troublesomm ($29.63 in chips) 
Seat 2: DutchShultzs ($27.40 in chips) 
Seat 3: Tom1999 ($20.92 in chips) 
Seat 4: GovGus ($43.91 in chips) 
Seat 5: rey2040 ($10.06 in chips) 
Seat 6: kwkim73 ($27.58 in chips) 
Seat 7: chiyuki ($38.37 in chips) 
Seat 8: soul_5577 ($12.15 in chips) 
Seat 9: Jene4kaBest ($17.34 in chips) 
DutchShultzs: posts small blind $0.10
Tom1999: posts big blind $0.25
*** HOLE CARDS ***
Dealt to chiyuki [4s 4h]
GovGus: raises $0.50 to $0.75
rey2040: folds 
kwkim73: calls $0.75
chiyuki: folds 
soul_5577: folds 
Jene4kaBest: folds 
troublesomm: folds 
DutchShultzs: folds 
Tom1999: calls $0.50
*** FLOP *** [Ad 7s 2c]
Tom1999: checks 
GovGus: bets $1.25
kwkim73: calls $1.25
Tom1999: folds 
*** TURN *** [Ad 7s 2c] [6h]
GovGus: checks 
kwkim73: bets $3.24
GovGus: folds 
Uncalled bet ($3.24) returned to kwkim73
kwkim73 collected $4.63 from pot
kwkim73: doesn't show hand 
*** SUMMARY ***
Total pot $4.85 | Rake $0.22 
Board [Ad 7s 2c 6h]
Seat 1: troublesomm (button) folded before Flop (didn't bet)
Seat 2: DutchShultzs (small blind) folded before Flop
Seat 3: Tom1999 (big blind) folded on the Flop
Seat 4: GovGus folded on the Turn
Seat 5: rey2040 folded before Flop (didn't bet)
Seat 6: kwkim73 collected ($4.63)
Seat 7: chiyuki folded before Flop (didn't bet)
Seat 8: soul_5577 folded before Flop (didn't bet)
Seat 9: Jene4kaBest folded before Flop (didn't bet)



PokerStars Zoom Hand #84300465053:  Hold'em No Limit ($0.10/$0.25) - 2012/08/05 15:29:53 JST [2012/08/05 2:29:53 ET]
Table 'Whirlpool' 9-max Seat #1 is the button
Seat 1: hirozo ($89.91 in chips) 
Seat 2: snejokCoxx ($12.35 in chips) 
Seat 3: mjmichi ($47.19 in chips) 
Seat 4: NuMetal88 ($25.35 in chips) 
Seat 5: chiyuki ($38.37 in chips) 
Seat 6: 1Karina1 ($25.59 in chips) 
Seat 7: kamikkaze ($13.69 in chips) 
Seat 8: AntoineHunt ($39.44 in chips) 
Seat 9: Silveystryk ($37.62 in chips) 
snejokCoxx: posts small blind $0.10
mjmichi: posts big blind $0.25
*** HOLE CARDS ***
Dealt to chiyuki [Kd 8h]
NuMetal88: folds 
chiyuki: folds 
1Karina1: folds 
kamikkaze: folds 
AntoineHunt: folds 
Silveystryk: folds 
hirozo: raises $0.25 to $0.50
snejokCoxx: raises $1.25 to $1.75
mjmichi: folds 
hirozo: folds 
Uncalled bet ($1.25) returned to snejokCoxx
snejokCoxx collected $1.25 from pot
snejokCoxx: doesn't show hand 
*** SUMMARY ***
Total pot $1.25 | Rake $0 
Seat 1: hirozo (button) folded before Flop
Seat 2: snejokCoxx (small blind) collected ($1.25)
Seat 3: mjmichi (big blind) folded before Flop
Seat 4: NuMetal88 folded before Flop (didn't bet)
Seat 5: chiyuki folded before Flop (didn't bet)
Seat 6: 1Karina1 folded before Flop (didn't bet)
Seat 7: kamikkaze folded before Flop (didn't bet)
Seat 8: AntoineHunt folded before Flop (didn't bet)
Seat 9: Silveystryk folded before Flop (didn't bet)



PokerStars Zoom Hand #84300466087:  Hold'em No Limit ($0.10/$0.25) - 2012/08/05 15:29:57 JST [2012/08/05 2:29:57 ET]
Table 'Whirlpool' 9-max Seat #1 is the button
Seat 1: ChrisCDee ($67.24 in chips) 
Seat 2: seula i ($25 in chips) 
Seat 3: wildy29 ($39.59 in chips) 
Seat 4: WARIBANA7777 ($14.68 in chips) 
Seat 5: masterkoolb ($15.66 in chips) 
Seat 6: cofla tito ($11.71 in chips) 
Seat 7: JhonnyP1979 ($3.89 in chips) 
Seat 8: DutchShultzs ($25.92 in chips) 
Seat 9: chiyuki ($38.37 in chips) 
seula i: posts small blind $0.10
wildy29: posts big blind $0.25
*** HOLE CARDS ***
Dealt to chiyuki [8s Ks]
WARIBANA7777: folds 
masterkoolb: folds 
cofla tito: raises $0.25 to $0.50
JhonnyP1979: folds 
DutchShultzs: folds 
chiyuki: folds 
ChrisCDee: folds 
seula i: folds 
wildy29: calls $0.25
*** FLOP *** [Jc 4d 3h]
wildy29: checks 
cofla tito: checks 
*** TURN *** [Jc 4d 3h] [6s]
wildy29: checks 
cofla tito: checks 
*** RIVER *** [Jc 4d 3h 6s] [Ts]
wildy29: checks 
cofla tito: checks 
*** SHOW DOWN ***
wildy29: shows [7s 5c] (a straight, Three to Seven)
cofla tito: mucks hand 
wildy29 collected $1.05 from pot
*** SUMMARY ***
Total pot $1.10 | Rake $0.05 
Board [Jc 4d 3h 6s Ts]
Seat 1: ChrisCDee (button) folded before Flop (didn't bet)
Seat 2: seula i (small blind) folded before Flop
Seat 3: wildy29 (big blind) showed [7s 5c] and won ($1.05) with a straight, Three to Seven
Seat 4: WARIBANA7777 folded before Flop (didn't bet)
Seat 5: masterkoolb folded before Flop (didn't bet)
Seat 6: cofla tito mucked [Ac Td]
Seat 7: JhonnyP1979 folded before Flop (didn't bet)
Seat 8: DutchShultzs folded before Flop (didn't bet)
Seat 9: chiyuki folded before Flop (didn't bet)



PokerStars Zoom Hand #84300468917:  Hold'em No Limit ($0.10/$0.25) - 2012/08/05 15:30:07 JST [2012/08/05 2:30:07 ET]
Table 'Whirlpool' 9-max Seat #1 is the button
Seat 1: nastya040 ($19.36 in chips) 
Seat 2: Tom1999 ($20.17 in chips) 
Seat 3: chiyuki ($38.37 in chips) 
Seat 4: Rilko1975 ($35.21 in chips) 
Seat 5: DutchShultzs ($25.92 in chips) 
Seat 6: Silveystryk ($23.27 in chips) 
Seat 7: kamikkaze ($13.69 in chips) 
Seat 8: Perstenev ($13.45 in chips) 
Seat 9: Spheroff ($22.88 in chips) 
Tom1999: posts small blind $0.10
chiyuki: posts big blind $0.25
*** HOLE CARDS ***
Dealt to chiyuki [Jd Kh]
Rilko1975: folds 
DutchShultzs: folds 
Silveystryk: folds 
kamikkaze: raises $0.26 to $0.51
Perstenev: calls $0.51
Spheroff: folds 
nastya040: folds 
Tom1999: calls $0.41
chiyuki: calls $0.26
*** FLOP *** [Td Qh 7c]
Tom1999: checks 
chiyuki: checks 
kamikkaze: checks 
Perstenev: checks 
*** TURN *** [Td Qh 7c] [Qc]
Tom1999: bets $0.75
chiyuki: folds 
kamikkaze: calls $0.75
Perstenev: folds 
*** RIVER *** [Td Qh 7c Qc] [Jc]
Tom1999: bets $1.25
kamikkaze: calls $1.25
*** SHOW DOWN ***
Tom1999: shows [Qs Ah] (three of a kind, Queens)
kamikkaze: mucks hand 
Tom1999 collected $5.77 from pot
*** SUMMARY ***
Total pot $6.04 | Rake $0.27 
Board [Td Qh 7c Qc Jc]
Seat 1: nastya040 (button) folded before Flop (didn't bet)
Seat 2: Tom1999 (small blind) showed [Qs Ah] and won ($5.77) with three of a kind, Queens
Seat 3: chiyuki (big blind) folded on the Turn
Seat 4: Rilko1975 folded before Flop (didn't bet)
Seat 5: DutchShultzs folded before Flop (didn't bet)
Seat 6: Silveystryk folded before Flop (didn't bet)
Seat 7: kamikkaze mucked [Jh Ks]
Seat 8: Perstenev folded on the Turn
Seat 9: Spheroff folded before Flop (didn't bet)



PokerStars Zoom Hand #84300483138:  Hold'em No Limit ($0.10/$0.25) - 2012/08/05 15:31:05 JST [2012/08/05 2:31:05 ET]
Table 'Whirlpool' 9-max Seat #1 is the button
Seat 1: WARIBANA7777 ($13.98 in chips) 
Seat 2: chiyuki ($37.86 in chips) 
Seat 3: svg51 ($6.62 in chips) 
Seat 4: Spheroff ($22.13 in chips) 
Seat 5: Grishukps ($12.50 in chips) 
Seat 6: slapshot2011 ($17.90 in chips) 
Seat 7: DutchShultzs ($37.06 in chips) 
Seat 8: 1Karina1 ($25 in chips) 
Seat 9: Tom1999 ($23.43 in chips) 
chiyuki: posts small blind $0.10
svg51: posts big blind $0.25
*** HOLE CARDS ***
Dealt to chiyuki [9s 9d]
Spheroff: raises $0.50 to $0.75
Grishukps: folds 
slapshot2011: calls $0.75
DutchShultzs: folds 
1Karina1: folds 
Tom1999: folds 
WARIBANA7777: folds 
chiyuki: calls $0.65
svg51: folds 
*** FLOP *** [Js 2s 3s]
chiyuki: checks 
Spheroff: bets $1
slapshot2011: folds 
chiyuki: folds 
Uncalled bet ($1) returned to Spheroff
Spheroff collected $2.39 from pot
Spheroff: doesn't show hand 
*** SUMMARY ***
Total pot $2.50 | Rake $0.11 
Board [Js 2s 3s]
Seat 1: WARIBANA7777 (button) folded before Flop (didn't bet)
Seat 2: chiyuki (small blind) folded on the Flop
Seat 3: svg51 (big blind) folded before Flop
Seat 4: Spheroff collected ($2.39)
Seat 5: Grishukps folded before Flop (didn't bet)
Seat 6: slapshot2011 folded on the Flop
Seat 7: DutchShultzs folded before Flop (didn't bet)
Seat 8: 1Karina1 folded before Flop (didn't bet)
Seat 9: Tom1999 folded before Flop (didn't bet)



PokerStars Zoom Hand #84300493194:  Hold'em No Limit ($0.10/$0.25) - 2012/08/05 15:31:44 JST [2012/08/05 2:31:44 ET]
Table 'Whirlpool' 9-max Seat #1 is the button
Seat 1: yvasilik ($27.95 in chips) 
Seat 2: KrystalAA ($25.23 in chips) 
Seat 3: Spheroff ($23.77 in chips) 
Seat 4: chiyuki ($37.11 in chips) 
Seat 5: INSP!RON ($44.92 in chips) 
Seat 6: PPP7SSS ($23.82 in chips) 
Seat 7: phate-1up ($44.44 in chips) 
Seat 8: fil740 ($8.48 in chips) 
Seat 9: Alvinpe85 ($49.84 in chips) 
KrystalAA: posts small blind $0.10
Spheroff: posts big blind $0.25
*** HOLE CARDS ***
Dealt to chiyuki [5h 3s]
chiyuki: folds 
INSP!RON: folds 
PPP7SSS: folds 
phate-1up: raises $0.50 to $0.75
fil740: folds 
Alvinpe85: folds 
yvasilik: folds 
KrystalAA: folds 
Spheroff: folds 
Uncalled bet ($0.50) returned to phate-1up
phate-1up collected $0.60 from pot
phate-1up: doesn't show hand 
*** SUMMARY ***
Total pot $0.60 | Rake $0 
Seat 1: yvasilik (button) folded before Flop (didn't bet)
Seat 2: KrystalAA (small blind) folded before Flop
Seat 3: Spheroff (big blind) folded before Flop
Seat 4: chiyuki folded before Flop (didn't bet)
Seat 5: INSP!RON folded before Flop (didn't bet)
Seat 6: PPP7SSS folded before Flop (didn't bet)
Seat 7: phate-1up collected ($0.60)
Seat 8: fil740 folded before Flop (didn't bet)
Seat 9: Alvinpe85 folded before Flop (didn't bet)



PokerStars Zoom Hand #84300502400:  Hold'em No Limit ($0.10/$0.25) - 2012/08/05 15:32:21 JST [2012/08/05 2:32:21 ET]
Table 'Whirlpool' 9-max Seat #1 is the button
Seat 1: Spheroff ($23.77 in chips) 
Seat 2: Roglus ($11.72 in chips) 
Seat 3: NENE54 ($14.17 in chips) 
Seat 4: DutchShultzs ($25 in chips) 
Seat 5: KrystalAA ($25.13 in chips) 
Seat 6: chiyuki ($37.11 in chips) 
Seat 7: Grishukps ($12.50 in chips) 
Seat 8: jacquelinewu ($72.87 in chips) 
Seat 9: kamikkaze ($13.21 in chips) 
Roglus: posts small blind $0.10
NENE54: posts big blind $0.25
*** HOLE CARDS ***
Dealt to chiyuki [2h 9h]
DutchShultzs: folds 
KrystalAA: folds 
chiyuki: folds 
Grishukps: folds 
jacquelinewu: folds 
kamikkaze: folds 
Spheroff: folds 
Roglus: folds 
Uncalled bet ($0.15) returned to NENE54
NENE54 collected $0.20 from pot
NENE54: doesn't show hand 
*** SUMMARY ***
Total pot $0.20 | Rake $0 
Seat 1: Spheroff (button) folded before Flop (didn't bet)
Seat 2: Roglus (small blind) folded before Flop
Seat 3: NENE54 (big blind) collected ($0.20)
Seat 4: DutchShultzs folded before Flop (didn't bet)
Seat 5: KrystalAA folded before Flop (didn't bet)
Seat 6: chiyuki folded before Flop (didn't bet)
Seat 7: Grishukps folded before Flop (didn't bet)
Seat 8: jacquelinewu folded before Flop (didn't bet)
Seat 9: kamikkaze folded before Flop (didn't bet)



PokerStars Zoom Hand #84300505486:  Hold'em No Limit ($0.10/$0.25) - 2012/08/05 15:32:33 JST [2012/08/05 2:32:33 ET]
Table 'Whirlpool' 9-max Seat #1 is the button
Seat 1: chiyuki ($37.11 in chips) 
Seat 2: yvasilik ($27.60 in chips) 
Seat 3: NuMetal88 ($25.25 in chips) 
Seat 4: 1Karina1 ($27.92 in chips) 
Seat 5: KimPa39 ($26.98 in chips) 
Seat 6: Roglus ($11.62 in chips) 
Seat 7: Perstenev ($28.11 in chips) 
Seat 8: NENE54 ($14.27 in chips) 
Seat 9: Nerkit ($12.40 in chips) 
yvasilik: posts small blind $0.10
NuMetal88: posts big blind $0.25
*** HOLE CARDS ***
Dealt to chiyuki [7s 5s]
1Karina1: folds 
KimPa39: folds 
Roglus: folds 
Perstenev: folds 
NENE54: folds 
Nerkit: folds 
chiyuki: raises $0.50 to $0.75
yvasilik: folds 
NuMetal88: folds 
Uncalled bet ($0.50) returned to chiyuki
chiyuki collected $0.60 from pot
chiyuki: doesn't show hand 
*** SUMMARY ***
Total pot $0.60 | Rake $0 
Seat 1: chiyuki (button) collected ($0.60)
Seat 2: yvasilik (small blind) folded before Flop
Seat 3: NuMetal88 (big blind) folded before Flop
Seat 4: 1Karina1 folded before Flop (didn't bet)
Seat 5: KimPa39 folded before Flop (didn't bet)
Seat 6: Roglus folded before Flop (didn't bet)
Seat 7: Perstenev folded before Flop (didn't bet)
Seat 8: NENE54 folded before Flop (didn't bet)
Seat 9: Nerkit folded before Flop (didn't bet)



PokerStars Zoom Hand #84300498345:  Hold'em No Limit ($0.10/$0.25) - 2012/08/05 15:32:05 JST [2012/08/05 2:32:05 ET]
Table 'Whirlpool' 9-max Seat #1 is the button
Seat 1: Perstenev ($28.11 in chips) 
Seat 2: kamikkaze ($13.31 in chips) 
Seat 3: Tom1999 ($23.78 in chips) 
Seat 4: drunk_bender ($16.40 in chips) 
Seat 5: phate-1up ($44.79 in chips) 
Seat 6: 1Karina1 ($27.92 in chips) 
Seat 7: jacquelinewu ($25.35 in chips) 
Seat 8: chiyuki ($37.11 in chips) 
Seat 9: banderas761 ($20.27 in chips) 
kamikkaze: posts small blind $0.10
Tom1999: posts big blind $0.25
*** HOLE CARDS ***
Dealt to chiyuki [9h Kc]
drunk_bender: folds 
phate-1up: folds 
1Karina1: folds 
jacquelinewu: folds 
chiyuki: folds 
banderas761: raises $0.62 to $0.87
Perstenev: folds 
kamikkaze: folds 
Tom1999: calls $0.62
*** FLOP *** [9s Ts Jd]
Tom1999: checks 
banderas761: bets $1.25
Tom1999: calls $1.25
*** TURN *** [9s Ts Jd] [Td]
Tom1999: checks 
banderas761: bets $18.15 and is all-in
Tom1999: folds 
Uncalled bet ($18.15) returned to banderas761
banderas761 collected $4.14 from pot
banderas761: doesn't show hand 
*** SUMMARY ***
Total pot $4.34 | Rake $0.20 
Board [9s Ts Jd Td]
Seat 1: Perstenev (button) folded before Flop (didn't bet)
Seat 2: kamikkaze (small blind) folded before Flop
Seat 3: Tom1999 (big blind) folded on the Turn
Seat 4: drunk_bender folded before Flop (didn't bet)
Seat 5: phate-1up folded before Flop (didn't bet)
Seat 6: 1Karina1 folded before Flop (didn't bet)
Seat 7: jacquelinewu folded before Flop (didn't bet)
Seat 8: chiyuki folded before Flop (didn't bet)
Seat 9: banderas761 collected ($4.14)



PokerStars Zoom Hand #84300504713:  Hold'em No Limit ($0.10/$0.25) - 2012/08/05 15:32:30 JST [2012/08/05 2:32:30 ET]
Table 'Whirlpool' 9-max Seat #1 is the button
Seat 1: seula i ($25.29 in chips) 
Seat 2: snejokCoxx ($13.85 in chips) 
Seat 3: kesstukas25 ($15 in chips) 
Seat 4: KrystalAA ($18.72 in chips) 
Seat 5: fima00000007 ($10.79 in chips) 
Seat 6: dergeb ($11.25 in chips) 
Seat 7: chiyuki ($37.11 in chips) 
Seat 8: leo2095 ($20 in chips) 
Seat 9: INSP!RON ($45.84 in chips) 
snejokCoxx: posts small blind $0.10
kesstukas25: posts big blind $0.25
*** HOLE CARDS ***
Dealt to chiyuki [3s Ks]
KrystalAA: folds 
fima00000007: calls $0.25
dergeb: folds 
chiyuki: folds 
leo2095: folds 
INSP!RON: raises $0.75 to $1
seula i: folds 
snejokCoxx: folds 
kesstukas25: folds 
fima00000007: calls $0.75
*** FLOP *** [8s 9h Ac]
fima00000007: checks 
INSP!RON: bets $1.25
fima00000007: calls $1.25
*** TURN *** [8s 9h Ac] [Js]
fima00000007: checks 
INSP!RON: bets $2.15
fima00000007: folds 
Uncalled bet ($2.15) returned to INSP!RON
INSP!RON collected $4.63 from pot
INSP!RON: doesn't show hand 
*** SUMMARY ***
Total pot $4.85 | Rake $0.22 
Board [8s 9h Ac Js]
Seat 1: seula i (button) folded before Flop (didn't bet)
Seat 2: snejokCoxx (small blind) folded before Flop
Seat 3: kesstukas25 (big blind) folded before Flop
Seat 4: KrystalAA folded before Flop (didn't bet)
Seat 5: fima00000007 folded on the Turn
Seat 6: dergeb folded before Flop (didn't bet)
Seat 7: chiyuki folded before Flop (didn't bet)
Seat 8: leo2095 folded before Flop (didn't bet)
Seat 9: INSP!RON collected ($4.63)



PokerStars Zoom Hand #84300510061:  Hold'em No Limit ($0.10/$0.25) - 2012/08/05 15:32:51 JST [2012/08/05 2:32:51 ET]
Table 'Whirlpool' 9-max Seat #1 is the button
Seat 1: Rilko1975 ($23.92 in chips) 
Seat 2: jacquelinewu ($36.17 in chips) 
Seat 3: kamikkaze ($14.70 in chips) 
Seat 4: Silveystryk ($21.27 in chips) 
Seat 5: Grishukps ($12.50 in chips) 
Seat 6: xxx Spb xxx ($25.60 in chips) 
Seat 7: turbotom122 ($16 in chips) 
Seat 8: chiyuki ($37.46 in chips) 
Seat 9: Serge Claws ($25 in chips) 
jacquelinewu: posts small blind $0.10
kamikkaze: posts big blind $0.25
*** HOLE CARDS ***
Dealt to chiyuki [6c 6s]
Silveystryk: folds 
Grishukps: folds 
xxx Spb xxx: folds 
turbotom122: folds 
chiyuki: raises $0.50 to $0.75
Serge Claws: folds 
Rilko1975: folds 
jacquelinewu: folds 
kamikkaze: calls $0.50
*** FLOP *** [7d 4c Jc]
kamikkaze: checks 
chiyuki: checks 
*** TURN *** [7d 4c Jc] [3h]
kamikkaze: bets $0.99
chiyuki: folds 
Uncalled bet ($0.99) returned to kamikkaze
kamikkaze collected $1.53 from pot
kamikkaze: doesn't show hand 
*** SUMMARY ***
Total pot $1.60 | Rake $0.07 
Board [7d 4c Jc 3h]
Seat 1: Rilko1975 (button) folded before Flop (didn't bet)
Seat 2: jacquelinewu (small blind) folded before Flop
Seat 3: kamikkaze (big blind) collected ($1.53)
Seat 4: Silveystryk folded before Flop (didn't bet)
Seat 5: Grishukps folded before Flop (didn't bet)
Seat 6: xxx Spb xxx folded before Flop (didn't bet)
Seat 7: turbotom122 folded before Flop (didn't bet)
Seat 8: chiyuki folded on the Turn
Seat 9: Serge Claws folded before Flop (didn't bet)



PokerStars Zoom Hand #84300521101:  Hold'em No Limit ($0.10/$0.25) - 2012/08/05 15:33:35 JST [2012/08/05 2:33:35 ET]
Table 'Whirlpool' 9-max Seat #1 is the button
Seat 1: nice.franki ($10.75 in chips) 
Seat 2: DutchShultzs ($36.46 in chips) 
Seat 3: River_GmbH ($14.90 in chips) 
Seat 4: ZhukOFFskI ($21.45 in chips) 
Seat 5: WARIBANA7777 ($16.23 in chips) 
Seat 6: kesstukas25 ($15 in chips) 
Seat 7: fima00000007 ($8.54 in chips) 
Seat 8: NuMetal88 ($25.35 in chips) 
Seat 9: chiyuki ($36.71 in chips) 
DutchShultzs: posts small blind $0.10
River_GmbH: posts big blind $0.25
*** HOLE CARDS ***
Dealt to chiyuki [Ad Th]
ZhukOFFskI: folds 
WARIBANA7777: folds 
kesstukas25: folds 
fima00000007: raises $0.75 to $1
NuMetal88: folds 
chiyuki: folds 
nice.franki: folds 
DutchShultzs: folds 
River_GmbH: folds 
Uncalled bet ($0.75) returned to fima00000007
fima00000007 collected $0.60 from pot
fima00000007: doesn't show hand 
*** SUMMARY ***
Total pot $0.60 | Rake $0 
Seat 1: nice.franki (button) folded before Flop (didn't bet)
Seat 2: DutchShultzs (small blind) folded before Flop
Seat 3: River_GmbH (big blind) folded before Flop
Seat 4: ZhukOFFskI folded before Flop (didn't bet)
Seat 5: WARIBANA7777 folded before Flop (didn't bet)
Seat 6: kesstukas25 folded before Flop (didn't bet)
Seat 7: fima00000007 collected ($0.60)
Seat 8: NuMetal88 folded before Flop (didn't bet)
Seat 9: chiyuki folded before Flop (didn't bet)



PokerStars Zoom Hand #84300524630:  Hold'em No Limit ($0.10/$0.25) - 2012/08/05 15:33:49 JST [2012/08/05 2:33:49 ET]
Table 'Whirlpool' 9-max Seat #1 is the button
Seat 1: snejokCoxx ($13.50 in chips) 
Seat 2: chiyuki ($36.71 in chips) 
Seat 3: Perstenev ($13 in chips) 
Seat 4: opie62 ($29.40 in chips) 
Seat 5: seula i ($25.45 in chips) 
Seat 6: DutchShultzs ($25 in chips) 
Seat 7: silvno31 ($43.07 in chips) 
Seat 8: Serge Claws ($25.50 in chips) 
Seat 9: deadmoneykid ($25.55 in chips) 
chiyuki: posts small blind $0.10
Perstenev: posts big blind $0.25
*** HOLE CARDS ***
Dealt to chiyuki [5c 4h]
opie62: folds 
seula i: folds 
DutchShultzs: folds 
silvno31: folds 
Serge Claws: folds 
deadmoneykid: folds 
snejokCoxx: folds 
chiyuki: folds 
Uncalled bet ($0.15) returned to Perstenev
Perstenev collected $0.20 from pot
Perstenev: doesn't show hand 
*** SUMMARY ***
Total pot $0.20 | Rake $0 
Seat 1: snejokCoxx (button) folded before Flop (didn't bet)
Seat 2: chiyuki (small blind) folded before Flop
Seat 3: Perstenev (big blind) collected ($0.20)
Seat 4: opie62 folded before Flop (didn't bet)
Seat 5: seula i folded before Flop (didn't bet)
Seat 6: DutchShultzs folded before Flop (didn't bet)
Seat 7: silvno31 folded before Flop (didn't bet)
Seat 8: Serge Claws folded before Flop (didn't bet)
Seat 9: deadmoneykid folded before Flop (didn't bet)



PokerStars Zoom Hand #84300525664:  Hold'em No Limit ($0.10/$0.25) - 2012/08/05 15:33:53 JST [2012/08/05 2:33:53 ET]
Table 'Whirlpool' 9-max Seat #1 is the button
Seat 1: kesstukas25 ($15 in chips) 
Seat 2: phate-1up ($49.58 in chips) 
Seat 3: chiyuki ($36.61 in chips) 
Seat 4: Faraz ($18.17 in chips) 
Seat 5: silvno31 ($43.07 in chips) 
Seat 6: fima00000007 ($8.89 in chips) 
Seat 7: Serge Claws ($25.50 in chips) 
Seat 8: Silveystryk ($20.40 in chips) 
Seat 9: nice.franki ($11.65 in chips) 
phate-1up: posts small blind $0.10
chiyuki: posts big blind $0.25
*** HOLE CARDS ***
Dealt to chiyuki [7h 2s]
Faraz: folds 
silvno31: folds 
fima00000007: folds 
Serge Claws: folds 
Silveystryk: calls $0.25
nice.franki: folds 
kesstukas25: folds 
phate-1up: folds 
chiyuki: checks 
*** FLOP *** [5d 5c 4s]
chiyuki: checks 
Silveystryk: bets $0.25
chiyuki: folds 
Uncalled bet ($0.25) returned to Silveystryk
Silveystryk collected $0.57 from pot
Silveystryk: doesn't show hand 
*** SUMMARY ***
Total pot $0.60 | Rake $0.03 
Board [5d 5c 4s]
Seat 1: kesstukas25 (button) folded before Flop (didn't bet)
Seat 2: phate-1up (small blind) folded before Flop
Seat 3: chiyuki (big blind) folded on the Flop
Seat 4: Faraz folded before Flop (didn't bet)
Seat 5: silvno31 folded before Flop (didn't bet)
Seat 6: fima00000007 folded before Flop (didn't bet)
Seat 7: Serge Claws folded before Flop (didn't bet)
Seat 8: Silveystryk collected ($0.57)
Seat 9: nice.franki folded before Flop (didn't bet)



PokerStars Zoom Hand #84300535646:  Hold'em No Limit ($0.10/$0.25) - 2012/08/05 15:34:33 JST [2012/08/05 2:34:33 ET]
Table 'Whirlpool' 9-max Seat #1 is the button
Seat 1: herkko11 ($8.27 in chips) 
Seat 2: GovGus ($43.70 in chips) 
Seat 3: nice.franki ($12.20 in chips) 
Seat 4: Rilko1975 ($26.88 in chips) 
Seat 5: Nerkit ($13.66 in chips) 
Seat 6: chiyuki ($36.36 in chips) 
Seat 7: INSP!RON ($39.68 in chips) 
Seat 8: macmauret ($17.14 in chips) 
Seat 9: WARIBANA7777 ($16.13 in chips) 
GovGus: posts small blind $0.10
nice.franki: posts big blind $0.25
*** HOLE CARDS ***
Dealt to chiyuki [Qd 8h]
Rilko1975: folds 
Nerkit: folds 
chiyuki: folds 
INSP!RON: folds 
macmauret: folds 
WARIBANA7777: raises $0.35 to $0.60
herkko11: folds 
GovGus: folds 
nice.franki: folds 
Uncalled bet ($0.35) returned to WARIBANA7777
WARIBANA7777 collected $0.60 from pot
WARIBANA7777: doesn't show hand 
*** SUMMARY ***
Total pot $0.60 | Rake $0 
Seat 1: herkko11 (button) folded before Flop (didn't bet)
Seat 2: GovGus (small blind) folded before Flop
Seat 3: nice.franki (big blind) folded before Flop
Seat 4: Rilko1975 folded before Flop (didn't bet)
Seat 5: Nerkit folded before Flop (didn't bet)
Seat 6: chiyuki folded before Flop (didn't bet)
Seat 7: INSP!RON folded before Flop (didn't bet)
Seat 8: macmauret folded before Flop (didn't bet)
Seat 9: WARIBANA7777 collected ($0.60)



PokerStars Zoom Hand #84300534086:  Hold'em No Limit ($0.10/$0.25) - 2012/08/05 15:34:27 JST [2012/08/05 2:34:27 ET]
Table 'Whirlpool' 9-max Seat #1 is the button
Seat 1: Rici47 ($28.30 in chips) 
Seat 2: kwkim73 ($25.79 in chips) 
Seat 3: banderas761 ($22.19 in chips) 
Seat 4: Perstenev ($12.10 in chips) 
Seat 5: Serge Claws ($25.40 in chips) 
Seat 6: leo2095 ($18.80 in chips) 
Seat 7: chiyuki ($36.36 in chips) 
Seat 8: Fructionar ($25.45 in chips) 
Seat 9: jacquelinewu ($36.03 in chips) 
kwkim73: posts small blind $0.10
banderas761: posts big blind $0.25
*** HOLE CARDS ***
Dealt to chiyuki [9d Ts]
Perstenev: folds 
Serge Claws: folds 
leo2095: raises $0.25 to $0.50
chiyuki: folds 
Fructionar: folds 
jacquelinewu: folds 
Rici47: calls $0.50
kwkim73: calls $0.40
banderas761: calls $0.25
*** FLOP *** [3h 4h 8h]
kwkim73: bets $1.25
banderas761: folds 
leo2095: folds 
Rici47: folds 
Uncalled bet ($1.25) returned to kwkim73
kwkim73 collected $1.91 from pot
kwkim73: doesn't show hand 
*** SUMMARY ***
Total pot $2 | Rake $0.09 
Board [3h 4h 8h]
Seat 1: Rici47 (button) folded on the Flop
Seat 2: kwkim73 (small blind) collected ($1.91)
Seat 3: banderas761 (big blind) folded on the Flop
Seat 4: Perstenev folded before Flop (didn't bet)
Seat 5: Serge Claws folded before Flop (didn't bet)
Seat 6: leo2095 folded on the Flop
Seat 7: chiyuki folded before Flop (didn't bet)
Seat 8: Fructionar folded before Flop (didn't bet)
Seat 9: jacquelinewu folded before Flop (didn't bet)



PokerStars Zoom Hand #84300533042:  Hold'em No Limit ($0.10/$0.25) - 2012/08/05 15:34:23 JST [2012/08/05 2:34:23 ET]
Table 'Whirlpool' 9-max Seat #1 is the button
Seat 1: chiyuki ($36.36 in chips) 
Seat 2: KrystalAA ($14.28 in chips) 
Seat 3: KeLevro0 ($10.84 in chips) 
Seat 4: KimPa39 ($12.10 in chips) 
Seat 5: hirozo ($89.83 in chips) 
Seat 6: Silveystryk ($20.50 in chips) 
Seat 7: banderas761 ($22.19 in chips) 
Seat 8: leo2095 ($18.80 in chips) 
Seat 9: Fructionar ($25.45 in chips) 
KrystalAA: posts small blind $0.10
KeLevro0: posts big blind $0.25
*** HOLE CARDS ***
Dealt to chiyuki [4h 7c]
KimPa39: folds 
hirozo: folds 
Silveystryk: calls $0.25
banderas761: folds 
leo2095: folds 
Fructionar: folds 
chiyuki: folds 
KrystalAA: calls $0.15
KeLevro0: raises $0.50 to $0.75
Silveystryk: calls $0.50
KrystalAA: calls $0.50
*** FLOP *** [Js 9h 2s]
KrystalAA: bets $1.65
KeLevro0: folds 
Silveystryk: folds 
Uncalled bet ($1.65) returned to KrystalAA
KrystalAA collected $2.15 from pot
KrystalAA: doesn't show hand 
*** SUMMARY ***
Total pot $2.25 | Rake $0.10 
Board [Js 9h 2s]
Seat 1: chiyuki (button) folded before Flop (didn't bet)
Seat 2: KrystalAA (small blind) collected ($2.15)
Seat 3: KeLevro0 (big blind) folded on the Flop
Seat 4: KimPa39 folded before Flop (didn't bet)
Seat 5: hirozo folded before Flop (didn't bet)
Seat 6: Silveystryk folded on the Flop
Seat 7: banderas761 folded before Flop (didn't bet)
Seat 8: leo2095 folded before Flop (didn't bet)
Seat 9: Fructionar folded before Flop (didn't bet)



PokerStars Zoom Hand #84300539122:  Hold'em No Limit ($0.10/$0.25) - 2012/08/05 15:34:47 JST [2012/08/05 2:34:47 ET]
Table 'Whirlpool' 9-max Seat #1 is the button
Seat 1: turbotom122 ($15.46 in chips) 
Seat 2: nice.franki ($11.95 in chips) 
Seat 3: svg51 ($4.32 in chips) 
Seat 4: KimPa39 ($11.85 in chips) 
Seat 5: hirozo ($25 in chips) 
Seat 6: chiyuki ($36.26 in chips) 
Seat 7: ZhukOFFskI ($35.28 in chips) 
Seat 8: phate-1up ($60.98 in chips) 
Seat 9: aivvo ($14.22 in chips) 
nice.franki: posts small blind $0.10
svg51: posts big blind $0.25
*** HOLE CARDS ***
Dealt to chiyuki [Ad As]
KimPa39: raises $0.50 to $0.75
hirozo: folds 
chiyuki: raises $1.50 to $2.25
ZhukOFFskI: folds 
phate-1up: folds 
aivvo: folds 
turbotom122: folds 
nice.franki: folds 
svg51: folds 
KimPa39: calls $1.50
*** FLOP *** [5s 6h Ah]
KimPa39: bets $9.60 and is all-in
chiyuki: calls $9.60
*** TURN *** [5s 6h Ah] [9d]
*** RIVER *** [5s 6h Ah 9d] [Ts]
*** SHOW DOWN ***
KimPa39: shows [Kh 8h] (high card Ace)
chiyuki: shows [Ad As] (three of a kind, Aces)
chiyuki collected $22.97 from pot
*** SUMMARY ***
Total pot $24.05 | Rake $1.08 
Board [5s 6h Ah 9d Ts]
Seat 1: turbotom122 (button) folded before Flop (didn't bet)
Seat 2: nice.franki (small blind) folded before Flop
Seat 3: svg51 (big blind) folded before Flop
Seat 4: KimPa39 showed [Kh 8h] and lost with high card Ace
Seat 5: hirozo folded before Flop (didn't bet)
Seat 6: chiyuki showed [Ad As] and won ($22.97) with three of a kind, Aces
Seat 7: ZhukOFFskI folded before Flop (didn't bet)
Seat 8: phate-1up folded before Flop (didn't bet)
Seat 9: aivvo folded before Flop (didn't bet)



PokerStars Zoom Hand #84300536654:  Hold'em No Limit ($0.10/$0.25) - 2012/08/05 15:34:37 JST [2012/08/05 2:34:37 ET]
Table 'Whirlpool' 9-max Seat #1 is the button
Seat 1: macmauret ($17.14 in chips) 
Seat 2: Ellen1947 ($24.45 in chips) 
Seat 3: masterkoolb ($12.85 in chips) 
Seat 4: Nerkit ($13.66 in chips) 
Seat 5: chiyuki ($36.36 in chips) 
Seat 6: 1Karina1 ($25.07 in chips) 
Seat 7: GSDP ($43.18 in chips) 
Seat 8: Faraz ($12.61 in chips) 
Seat 9: Rici47 ($30.54 in chips) 
Ellen1947: posts small blind $0.10
masterkoolb: posts big blind $0.25
*** HOLE CARDS ***
Dealt to chiyuki [8s Kc]
Nerkit: folds 
chiyuki: folds 
1Karina1: folds 
GSDP: raises $0.50 to $0.75
Faraz: calls $0.75
Rici47: folds 
macmauret: calls $0.75
Ellen1947: folds 
masterkoolb: folds 
*** FLOP *** [8h Kh Th]
GSDP: bets $1.50
Faraz: folds 
macmauret: calls $1.50
*** TURN *** [8h Kh Th] [Ah]
GSDP: bets $3.25
macmauret: folds 
Uncalled bet ($3.25) returned to GSDP
GSDP collected $5.35 from pot
GSDP: doesn't show hand 
*** SUMMARY ***
Total pot $5.60 | Rake $0.25 
Board [8h Kh Th Ah]
Seat 1: macmauret (button) folded on the Turn
Seat 2: Ellen1947 (small blind) folded before Flop
Seat 3: masterkoolb (big blind) folded before Flop
Seat 4: Nerkit folded before Flop (didn't bet)
Seat 5: chiyuki folded before Flop (didn't bet)
Seat 6: 1Karina1 folded before Flop (didn't bet)
Seat 7: GSDP collected ($5.35)
Seat 8: Faraz folded on the Flop
Seat 9: Rici47 folded before Flop (didn't bet)



PokerStars Zoom Hand #84300537365:  Hold'em No Limit ($0.10/$0.25) - 2012/08/05 15:34:40 JST [2012/08/05 2:34:40 ET]
Table 'Whirlpool' 9-max Seat #1 is the button
Seat 1: Wilcox76607 ($13.54 in chips) 
Seat 2: xxx Spb xxx ($25.60 in chips) 
Seat 3: nice.franki ($12 in chips) 
Seat 4: chiyuki ($36.36 in chips) 
Seat 5: Grishukps ($12.50 in chips) 
Seat 6: Fructionar ($25.45 in chips) 
Seat 7: snejokCoxx ($13.40 in chips) 
Seat 8: hirozo ($89.83 in chips) 
Seat 9: Rilko1975 ($33.11 in chips) 
xxx Spb xxx: posts small blind $0.10
nice.franki: posts big blind $0.25
*** HOLE CARDS ***
Dealt to chiyuki [5h 3c]
chiyuki: folds 
Grishukps: folds 
Fructionar: folds 
snejokCoxx: folds 
hirozo: folds 
Rilko1975: folds 
Wilcox76607: folds 
xxx Spb xxx: raises $0.50 to $0.75
nice.franki: calls $0.50
*** FLOP *** [4s 6h Th]
xxx Spb xxx: bets $0.80
nice.franki: raises $1.45 to $2.25
xxx Spb xxx: folds 
Uncalled bet ($1.45) returned to nice.franki
nice.franki collected $2.96 from pot
nice.franki: doesn't show hand 
*** SUMMARY ***
Total pot $3.10 | Rake $0.14 
Board [4s 6h Th]
Seat 1: Wilcox76607 (button) folded before Flop (didn't bet)
Seat 2: xxx Spb xxx (small blind) folded on the Flop
Seat 3: nice.franki (big blind) collected ($2.96)
Seat 4: chiyuki folded before Flop (didn't bet)
Seat 5: Grishukps folded before Flop (didn't bet)
Seat 6: Fructionar folded before Flop (didn't bet)
Seat 7: snejokCoxx folded before Flop (didn't bet)
Seat 8: hirozo folded before Flop (didn't bet)
Seat 9: Rilko1975 folded before Flop (didn't bet)



PokerStars Zoom Hand #84300552034:  Hold'em No Limit ($0.10/$0.25) - 2012/08/05 15:35:39 JST [2012/08/05 2:35:39 ET]
Table 'Whirlpool' 9-max Seat #1 is the button
Seat 1: PAMBOS.L ($22.38 in chips) 
Seat 2: Robchie ($23.12 in chips) 
Seat 3: chiyuki ($47.38 in chips) 
Seat 4: mjmichi ($57.47 in chips) 
Seat 5: Faraz ($11.86 in chips) 
Seat 6: Rici47 ($30.99 in chips) 
Seat 7: tribunpdm ($38.24 in chips) 
Seat 8: Silveystryk ($39.14 in chips) 
Seat 9: yvasilik ($23.60 in chips) 
Robchie: posts small blind $0.10
chiyuki: posts big blind $0.25
*** HOLE CARDS ***
Dealt to chiyuki [Kd 2h]
mjmichi: folds 
Faraz: folds 
Rici47: folds 
tribunpdm: folds 
Silveystryk: folds 
yvasilik: folds 
PAMBOS.L: folds 
Robchie: raises $0.50 to $0.75
chiyuki: folds 
Uncalled bet ($0.50) returned to Robchie
Robchie collected $0.50 from pot
Robchie: doesn't show hand 
*** SUMMARY ***
Total pot $0.50 | Rake $0 
Seat 1: PAMBOS.L (button) folded before Flop (didn't bet)
Seat 2: Robchie (small blind) collected ($0.50)
Seat 3: chiyuki (big blind) folded before Flop
Seat 4: mjmichi folded before Flop (didn't bet)
Seat 5: Faraz folded before Flop (didn't bet)
Seat 6: Rici47 folded before Flop (didn't bet)
Seat 7: tribunpdm folded before Flop (didn't bet)
Seat 8: Silveystryk folded before Flop (didn't bet)
Seat 9: yvasilik folded before Flop (didn't bet)



PokerStars Zoom Hand #84300547734:  Hold'em No Limit ($0.10/$0.25) - 2012/08/05 15:35:21 JST [2012/08/05 2:35:21 ET]
Table 'Whirlpool' 9-max Seat #1 is the button
Seat 1: yvasilik ($23.70 in chips) 
Seat 2: jacquelinewu ($72.74 in chips) 
Seat 3: laurentzu84 ($43.25 in chips) 
Seat 4: Faraz ($11.86 in chips) 
Seat 5: ZhukOFFskI ($35.28 in chips) 
Seat 6: KeLevro0 ($15.30 in chips) 
Seat 7: KrystalAA ($23.06 in chips) 
Seat 8: INSP!RON ($49.71 in chips) 
Seat 9: chiyuki ($47.38 in chips) 
jacquelinewu: posts small blind $0.10
laurentzu84: posts big blind $0.25
*** HOLE CARDS ***
Dealt to chiyuki [Ac Td]
Faraz: folds 
ZhukOFFskI: folds 
KeLevro0: folds 
KrystalAA: folds 
INSP!RON: raises $0.50 to $0.75
chiyuki: folds 
yvasilik: folds 
jacquelinewu: calls $0.65
laurentzu84: folds 
*** FLOP *** [8h 4s 4h]
jacquelinewu: checks 
INSP!RON: checks 
*** TURN *** [8h 4s 4h] [Ts]
jacquelinewu: bets $1.16
INSP!RON: folds 
Uncalled bet ($1.16) returned to jacquelinewu
jacquelinewu collected $1.67 from pot
jacquelinewu: doesn't show hand 
*** SUMMARY ***
Total pot $1.75 | Rake $0.08 
Board [8h 4s 4h Ts]
Seat 1: yvasilik (button) folded before Flop (didn't bet)
Seat 2: jacquelinewu (small blind) collected ($1.67)
Seat 3: laurentzu84 (big blind) folded before Flop
Seat 4: Faraz folded before Flop (didn't bet)
Seat 5: ZhukOFFskI folded before Flop (didn't bet)
Seat 6: KeLevro0 folded before Flop (didn't bet)
Seat 7: KrystalAA folded before Flop (didn't bet)
Seat 8: INSP!RON folded on the Turn
Seat 9: chiyuki folded before Flop (didn't bet)



PokerStars Zoom Hand #84300538360:  Hold'em No Limit ($0.10/$0.25) - 2012/08/05 15:34:44 JST [2012/08/05 2:34:44 ET]
Table 'Whirlpool' 9-max Seat #1 is the button
Seat 1: jacquelinewu ($25 in chips) 
Seat 2: chiyuki ($36.36 in chips) 
Seat 3: ViTiV2010 ($12.15 in chips) 
Seat 4: Rilko1975 ($33.11 in chips) 
Seat 5: Fructionar ($25.45 in chips) 
Seat 6: snejokCoxx ($13.40 in chips) 
Seat 7: DutchShultzs ($37 in chips) 
Seat 8: River_GmbH ($14.55 in chips) 
Seat 9: Faraz ($17.82 in chips) 
chiyuki: posts small blind $0.10
ViTiV2010: posts big blind $0.25
*** HOLE CARDS ***
Dealt to chiyuki [3d Kh]
Rilko1975: folds 
Fructionar: folds 
snejokCoxx: folds 
DutchShultzs: folds 
River_GmbH: folds 
Faraz: raises $0.25 to $0.50
jacquelinewu: folds 
chiyuki: folds 
ViTiV2010: calls $0.25
*** FLOP *** [9c 5s 5c]
ViTiV2010: checks 
Faraz: bets $0.75
ViTiV2010: calls $0.75
*** TURN *** [9c 5s 5c] [9s]
ViTiV2010: bets $1.50
Faraz: calls $1.50
*** RIVER *** [9c 5s 5c 9s] [7s]
ViTiV2010: checks 
Faraz: bets $5
ViTiV2010: folds 
Uncalled bet ($5) returned to Faraz
Faraz collected $5.35 from pot
Faraz: doesn't show hand 
*** SUMMARY ***
Total pot $5.60 | Rake $0.25 
Board [9c 5s 5c 9s 7s]
Seat 1: jacquelinewu (button) folded before Flop (didn't bet)
Seat 2: chiyuki (small blind) folded before Flop
Seat 3: ViTiV2010 (big blind) folded on the River
Seat 4: Rilko1975 folded before Flop (didn't bet)
Seat 5: Fructionar folded before Flop (didn't bet)
Seat 6: snejokCoxx folded before Flop (didn't bet)
Seat 7: DutchShultzs folded before Flop (didn't bet)
Seat 8: River_GmbH folded before Flop (didn't bet)
Seat 9: Faraz collected ($5.35)



PokerStars Zoom Hand #84300556560:  Hold'em No Limit ($0.10/$0.25) - 2012/08/05 15:35:57 JST [2012/08/05 2:35:57 ET]
Table 'Whirlpool' 9-max Seat #1 is the button
Seat 1: opie62 ($26.55 in chips) 
Seat 2: Faraz ($11.86 in chips) 
Seat 3: kesstukas25 ($13.90 in chips) 
Seat 4: kamikkaze ($16.15 in chips) 
Seat 5: chiyuki ($47.13 in chips) 
Seat 6: Grishukps ($12.50 in chips) 
Seat 7: nice.franki ($14.70 in chips) 
Seat 8: genamator ($19.18 in chips) 
Seat 9: GovGus ($38.95 in chips) 
Faraz: posts small blind $0.10
kesstukas25: posts big blind $0.25
*** HOLE CARDS ***
Dealt to chiyuki [Tc 5h]
kamikkaze: folds 
chiyuki: folds 
Grishukps: folds 
nice.franki: folds 
genamator: folds 
GovGus: folds 
opie62: folds 
Faraz: calls $0.15
kesstukas25: checks 
*** FLOP *** [9s Th Ks]
Faraz: bets $0.75
kesstukas25: folds 
Uncalled bet ($0.75) returned to Faraz
Faraz collected $0.48 from pot
Faraz: doesn't show hand 
*** SUMMARY ***
Total pot $0.50 | Rake $0.02 
Board [9s Th Ks]
Seat 1: opie62 (button) folded before Flop (didn't bet)
Seat 2: Faraz (small blind) collected ($0.48)
Seat 3: kesstukas25 (big blind) folded on the Flop
Seat 4: kamikkaze folded before Flop (didn't bet)
Seat 5: chiyuki folded before Flop (didn't bet)
Seat 6: Grishukps folded before Flop (didn't bet)
Seat 7: nice.franki folded before Flop (didn't bet)
Seat 8: genamator folded before Flop (didn't bet)
Seat 9: GovGus folded before Flop (didn't bet)



PokerStars Zoom Hand #84300557591:  Hold'em No Limit ($0.10/$0.25) - 2012/08/05 15:36:01 JST [2012/08/05 2:36:01 ET]
Table 'Whirlpool' 9-max Seat #1 is the button
Seat 1: AAAKK777 ($16.91 in chips) 
Seat 2: kesstukas25 ($14.05 in chips) 
Seat 3: Serge Claws ($25.70 in chips) 
Seat 4: Grishukps ($12.50 in chips) 
Seat 5: jacquelinewu ($35.03 in chips) 
Seat 6: Perstenev ($11.75 in chips) 
Seat 7: seula i ($28.09 in chips) 
Seat 8: chiyuki ($47.13 in chips) 
Seat 9: KeLevro0 ($13.30 in chips) 
kesstukas25: posts small blind $0.10
Serge Claws: posts big blind $0.25
*** HOLE CARDS ***
Dealt to chiyuki [Ks 8d]
Grishukps: folds 
jacquelinewu: folds 
Perstenev: folds 
seula i: raises $0.50 to $0.75
chiyuki: folds 
KeLevro0: folds 
AAAKK777: raises $0.50 to $1.25
kesstukas25: folds 
Serge Claws: folds 
seula i: calls $0.50
*** FLOP *** [3s 9d 7s]
seula i: checks 
AAAKK777: checks 
*** TURN *** [3s 9d 7s] [8s]
seula i: bets $2
AAAKK777: folds 
Uncalled bet ($2) returned to seula i
seula i collected $2.72 from pot
seula i: doesn't show hand 
*** SUMMARY ***
Total pot $2.85 | Rake $0.13 
Board [3s 9d 7s 8s]
Seat 1: AAAKK777 (button) folded on the Turn
Seat 2: kesstukas25 (small blind) folded before Flop
Seat 3: Serge Claws (big blind) folded before Flop
Seat 4: Grishukps folded before Flop (didn't bet)
Seat 5: jacquelinewu folded before Flop (didn't bet)
Seat 6: Perstenev folded before Flop (didn't bet)
Seat 7: seula i collected ($2.72)
Seat 8: chiyuki folded before Flop (didn't bet)
Seat 9: KeLevro0 folded before Flop (didn't bet)



PokerStars Zoom Hand #84300568761:  Hold'em No Limit ($0.10/$0.25) - 2012/08/05 15:36:46 JST [2012/08/05 2:36:46 ET]
Table 'Whirlpool' 9-max Seat #1 is the button
Seat 1: banderas761 ($21.47 in chips) 
Seat 2: Rici47 ($30.39 in chips) 
Seat 3: GovGus ($38.20 in chips) 
Seat 4: KeLevro0 ($11.69 in chips) 
Seat 5: Grishukps ($12.50 in chips) 
Seat 6: phate-1up ($60.23 in chips) 
Seat 7: 1Karina1 ($26.34 in chips) 
Seat 8: slapshot2011 ($10.58 in chips) 
Seat 9: chiyuki ($47.13 in chips) 
Rici47: posts small blind $0.10
GovGus: posts big blind $0.25
*** HOLE CARDS ***
Dealt to chiyuki [4h Ah]
KeLevro0: folds 
Grishukps: folds 
phate-1up: folds 
1Karina1: folds 
slapshot2011: folds 
chiyuki: folds 
banderas761: folds 
Rici47: folds 
Uncalled bet ($0.15) returned to GovGus
GovGus collected $0.20 from pot
GovGus: doesn't show hand 
*** SUMMARY ***
Total pot $0.20 | Rake $0 
Seat 1: banderas761 (button) folded before Flop (didn't bet)
Seat 2: Rici47 (small blind) folded before Flop
Seat 3: GovGus (big blind) collected ($0.20)
Seat 4: KeLevro0 folded before Flop (didn't bet)
Seat 5: Grishukps folded before Flop (didn't bet)
Seat 6: phate-1up folded before Flop (didn't bet)
Seat 7: 1Karina1 folded before Flop (didn't bet)
Seat 8: slapshot2011 folded before Flop (didn't bet)
Seat 9: chiyuki folded before Flop (didn't bet)



PokerStars Zoom Hand #84300563191:  Hold'em No Limit ($0.10/$0.25) - 2012/08/05 15:36:23 JST [2012/08/05 2:36:23 ET]
Table 'Whirlpool' 9-max Seat #1 is the button
Seat 1: chiyuki ($47.13 in chips) 
Seat 2: GSDP ($16.44 in chips) 
Seat 3: Saruotiss ($64.31 in chips) 
Seat 4: Fructionar ($27.68 in chips) 
Seat 5: KeLevro0 ($11.69 in chips) 
Seat 6: WARIBANA7777 ($15.88 in chips) 
Seat 7: Grishukps ($12.60 in chips) 
Seat 8: Spheroff ($23.37 in chips) 
Seat 9: 1Karina1 ($31.71 in chips) 
GSDP: posts small blind $0.10
Saruotiss: posts big blind $0.25
*** HOLE CARDS ***
Dealt to chiyuki [Kc 4h]
Fructionar: folds 
KeLevro0: folds 
WARIBANA7777: folds 
Grishukps: folds 
Spheroff: folds 
1Karina1: folds 
chiyuki: folds 
GSDP: calls $0.15
Saruotiss: checks 
*** FLOP *** [4d Ks Qh]
GSDP: bets $0.25
Saruotiss: folds 
Uncalled bet ($0.25) returned to GSDP
GSDP collected $0.48 from pot
GSDP: doesn't show hand 
*** SUMMARY ***
Total pot $0.50 | Rake $0.02 
Board [4d Ks Qh]
Seat 1: chiyuki (button) folded before Flop (didn't bet)
Seat 2: GSDP (small blind) collected ($0.48)
Seat 3: Saruotiss (big blind) folded on the Flop
Seat 4: Fructionar folded before Flop (didn't bet)
Seat 5: KeLevro0 folded before Flop (didn't bet)
Seat 6: WARIBANA7777 folded before Flop (didn't bet)
Seat 7: Grishukps folded before Flop (didn't bet)
Seat 8: Spheroff folded before Flop (didn't bet)
Seat 9: 1Karina1 folded before Flop (didn't bet)



PokerStars Zoom Hand #84300570836:  Hold'em No Limit ($0.10/$0.25) - 2012/08/05 15:36:54 JST [2012/08/05 2:36:54 ET]
Table 'Whirlpool' 9-max Seat #1 is the button
Seat 1: KrystalAA ($22.71 in chips) 
Seat 2: chiyuki ($47.13 in chips) 
Seat 3: ViTiV2010 ($12 in chips) 
Seat 4: seula i ($25 in chips) 
Seat 5: genamator ($19.96 in chips) 
Seat 6: Grishukps ($12.50 in chips) 
Seat 7: INSP!RON ($38.23 in chips) 
Seat 8: Vahe50 ($14.57 in chips) 
Seat 9: snejokCoxx ($10.66 in chips) 
chiyuki: posts small blind $0.10
ViTiV2010: posts big blind $0.25
*** HOLE CARDS ***
Dealt to chiyuki [Tc Qh]
seula i: folds 
genamator: folds 
Grishukps: folds 
INSP!RON: folds 
Vahe50: folds 
snejokCoxx: folds 
KrystalAA: folds 
chiyuki: folds 
Uncalled bet ($0.15) returned to ViTiV2010
ViTiV2010 collected $0.20 from pot
ViTiV2010: doesn't show hand 
*** SUMMARY ***
Total pot $0.20 | Rake $0 
Seat 1: KrystalAA (button) folded before Flop (didn't bet)
Seat 2: chiyuki (small blind) folded before Flop
Seat 3: ViTiV2010 (big blind) collected ($0.20)
Seat 4: seula i folded before Flop (didn't bet)
Seat 5: genamator folded before Flop (didn't bet)
Seat 6: Grishukps folded before Flop (didn't bet)
Seat 7: INSP!RON folded before Flop (didn't bet)
Seat 8: Vahe50 folded before Flop (didn't bet)
Seat 9: snejokCoxx folded before Flop (didn't bet)



PokerStars Zoom Hand #84300561394:  Hold'em No Limit ($0.10/$0.25) - 2012/08/05 15:36:16 JST [2012/08/05 2:36:16 ET]
Table 'Whirlpool' 9-max Seat #1 is the button
Seat 1: KeLevro0 ($13.30 in chips) 
Seat 2: banderas761 ($22.22 in chips) 
Seat 3: Spheroff ($23.62 in chips) 
Seat 4: NuMetal88 ($29.20 in chips) 
Seat 5: herkko11 ($9.22 in chips) 
Seat 6: DutchShultzs ($42.74 in chips) 
Seat 7: chiyuki ($47.13 in chips) 
Seat 8: kwkim73 ($27.18 in chips) 
Seat 9: seula i ($25 in chips) 
banderas761: posts small blind $0.10
Spheroff: posts big blind $0.25
*** HOLE CARDS ***
Dealt to chiyuki [3c As]
NuMetal88: folds 
herkko11: raises $0.50 to $0.75
DutchShultzs: folds 
chiyuki: folds 
kwkim73: calls $0.75
seula i: calls $0.75
KeLevro0: folds 
banderas761: calls $0.65
Spheroff: folds 
*** FLOP *** [7d 4h 3d]
banderas761: checks 
herkko11: bets $1.75
kwkim73: calls $1.75
seula i: folds 
banderas761: folds 
*** TURN *** [7d 4h 3d] [6c]
herkko11: bets $1.25
kwkim73: raises $8.95 to $10.20
herkko11: folds 
Uncalled bet ($8.95) returned to kwkim73
kwkim73 collected $8.83 from pot
kwkim73: doesn't show hand 
*** SUMMARY ***
Total pot $9.25 | Rake $0.42 
Board [7d 4h 3d 6c]
Seat 1: KeLevro0 (button) folded before Flop (didn't bet)
Seat 2: banderas761 (small blind) folded on the Flop
Seat 3: Spheroff (big blind) folded before Flop
Seat 4: NuMetal88 folded before Flop (didn't bet)
Seat 5: herkko11 folded on the Turn
Seat 6: DutchShultzs folded before Flop (didn't bet)
Seat 7: chiyuki folded before Flop (didn't bet)
Seat 8: kwkim73 collected ($8.83)
Seat 9: seula i folded on the Flop



PokerStars Zoom Hand #84300569797:  Hold'em No Limit ($0.10/$0.25) - 2012/08/05 15:36:50 JST [2012/08/05 2:36:50 ET]
Table 'Whirlpool' 9-max Seat #1 is the button
Seat 1: Grishukps ($12.50 in chips) 
Seat 2: snejokCoxx ($13.10 in chips) 
Seat 3: Perstenev ($9.74 in chips) 
Seat 4: chiyuki ($47.13 in chips) 
Seat 5: HighDuka ($37.88 in chips) 
Seat 6: kwkim73 ($56.45 in chips) 
Seat 7: slapshot2011 ($10.58 in chips) 
Seat 8: DutchShultzs ($25 in chips) 
Seat 9: Ellen1947 ($22.85 in chips) 
snejokCoxx: posts small blind $0.10
Perstenev: posts big blind $0.25
*** HOLE CARDS ***
Dealt to chiyuki [2c 9c]
chiyuki: folds 
HighDuka: folds 
kwkim73: folds 
slapshot2011: folds 
DutchShultzs: folds 
Ellen1947: raises $0.25 to $0.50
Grishukps: folds 
snejokCoxx: folds 
Perstenev: folds 
Uncalled bet ($0.25) returned to Ellen1947
Ellen1947 collected $0.60 from pot
Ellen1947: doesn't show hand 
*** SUMMARY ***
Total pot $0.60 | Rake $0 
Seat 1: Grishukps (button) folded before Flop (didn't bet)
Seat 2: snejokCoxx (small blind) folded before Flop
Seat 3: Perstenev (big blind) folded before Flop
Seat 4: chiyuki folded before Flop (didn't bet)
Seat 5: HighDuka folded before Flop (didn't bet)
Seat 6: kwkim73 folded before Flop (didn't bet)
Seat 7: slapshot2011 folded before Flop (didn't bet)
Seat 8: DutchShultzs folded before Flop (didn't bet)
Seat 9: Ellen1947 collected ($0.60)



PokerStars Zoom Hand #84300572362:  Hold'em No Limit ($0.10/$0.25) - 2012/08/05 15:37:00 JST [2012/08/05 2:37:00 ET]
Table 'Whirlpool' 9-max Seat #1 is the button
Seat 1: Gichboy ($10.78 in chips) 
Seat 2: 1Karina1 ($26.34 in chips) 
Seat 3: Serge Claws ($26.39 in chips) 
Seat 4: GSDP ($16.67 in chips) 
Seat 5: JhonnyP1979 ($14.58 in chips) 
Seat 6: snejokCoxx ($10.66 in chips) 
Seat 7: jacquelinewu ($30.86 in chips) 
Seat 8: chiyuki ($47.03 in chips) 
Seat 9: aivvo ($9.12 in chips) 
1Karina1: posts small blind $0.10
Serge Claws: posts big blind $0.25
*** HOLE CARDS ***
Dealt to chiyuki [5h 2c]
GSDP: folds 
JhonnyP1979: raises $0.50 to $0.75
snejokCoxx: folds 
jacquelinewu: folds 
chiyuki: folds 
aivvo: folds 
Gichboy: folds 
1Karina1: folds 
Serge Claws: folds 
Uncalled bet ($0.50) returned to JhonnyP1979
JhonnyP1979 collected $0.60 from pot
JhonnyP1979: doesn't show hand 
*** SUMMARY ***
Total pot $0.60 | Rake $0 
Seat 1: Gichboy (button) folded before Flop (didn't bet)
Seat 2: 1Karina1 (small blind) folded before Flop
Seat 3: Serge Claws (big blind) folded before Flop
Seat 4: GSDP folded before Flop (didn't bet)
Seat 5: JhonnyP1979 collected ($0.60)
Seat 6: snejokCoxx folded before Flop (didn't bet)
Seat 7: jacquelinewu folded before Flop (didn't bet)
Seat 8: chiyuki folded before Flop (didn't bet)
Seat 9: aivvo folded before Flop (didn't bet)



PokerStars Zoom Hand #84300575191:  Hold'em No Limit ($0.10/$0.25) - 2012/08/05 15:37:11 JST [2012/08/05 2:37:11 ET]
Table 'Whirlpool' 9-max Seat #1 is the button
Seat 1: ChrisCDee ($63.02 in chips) 
Seat 2: GSDP ($45.88 in chips) 
Seat 3: chiyuki ($47.03 in chips) 
Seat 4: KeLevro0 ($9.99 in chips) 
Seat 5: Roglus ($20.80 in chips) 
Seat 6: jacquelinewu ($30.86 in chips) 
Seat 7: seula i ($25 in chips) 
Seat 8: kwkim73 ($56.45 in chips) 
Seat 9: KrystalAA ($15.33 in chips) 
GSDP: posts small blind $0.10
chiyuki: posts big blind $0.25
*** HOLE CARDS ***
Dealt to chiyuki [7d Tc]
KeLevro0: folds 
Roglus: folds 
jacquelinewu: raises $0.50 to $0.75
seula i: folds 
kwkim73: folds 
KrystalAA: folds 
ChrisCDee: folds 
GSDP: folds 
chiyuki: folds 
Uncalled bet ($0.50) returned to jacquelinewu
jacquelinewu collected $0.60 from pot
jacquelinewu: doesn't show hand 
*** SUMMARY ***
Total pot $0.60 | Rake $0 
Seat 1: ChrisCDee (button) folded before Flop (didn't bet)
Seat 2: GSDP (small blind) folded before Flop
Seat 3: chiyuki (big blind) folded before Flop
Seat 4: KeLevro0 folded before Flop (didn't bet)
Seat 5: Roglus folded before Flop (didn't bet)
Seat 6: jacquelinewu collected ($0.60)
Seat 7: seula i folded before Flop (didn't bet)
Seat 8: kwkim73 folded before Flop (didn't bet)
Seat 9: KrystalAA folded before Flop (didn't bet)



PokerStars Zoom Hand #84300582540:  Hold'em No Limit ($0.10/$0.25) - 2012/08/05 15:37:40 JST [2012/08/05 2:37:40 ET]
Table 'Whirlpool' 9-max Seat #1 is the button
Seat 1: chiyuki ($46.78 in chips) 
Seat 2: TorTrade ($24.50 in chips) 
Seat 3: Gichboy ($32.93 in chips) 
Seat 4: hldtom ($25.35 in chips) 
Seat 5: kwkim73 ($27.30 in chips) 
Seat 6: macmauret ($15 in chips) 
Seat 7: River_GmbH ($14.20 in chips) 
Seat 8: ChrisCDee ($63.02 in chips) 
Seat 9: jacquelinewu ($25.46 in chips) 
TorTrade: posts small blind $0.10
Gichboy: posts big blind $0.25
*** HOLE CARDS ***
Dealt to chiyuki [Jd Kc]
hldtom: raises $0.50 to $0.75
kwkim73: folds 
macmauret: folds 
River_GmbH: folds 
ChrisCDee: folds 
jacquelinewu: folds 
chiyuki: folds 
TorTrade: calls $0.65
Gichboy: folds 
*** FLOP *** [7h Ks Qc]
TorTrade: checks 
hldtom: bets $1.26
TorTrade: calls $1.26
*** TURN *** [7h Ks Qc] [6h]
TorTrade: checks 
hldtom: checks 
*** RIVER *** [7h Ks Qc 6h] [5s]
TorTrade: bets $4.08
hldtom: folds 
Uncalled bet ($4.08) returned to TorTrade
TorTrade collected $4.08 from pot
TorTrade: doesn't show hand 
*** SUMMARY ***
Total pot $4.27 | Rake $0.19 
Board [7h Ks Qc 6h 5s]
Seat 1: chiyuki (button) folded before Flop (didn't bet)
Seat 2: TorTrade (small blind) collected ($4.08)
Seat 3: Gichboy (big blind) folded before Flop
Seat 4: hldtom folded on the River
Seat 5: kwkim73 folded before Flop (didn't bet)
Seat 6: macmauret folded before Flop (didn't bet)
Seat 7: River_GmbH folded before Flop (didn't bet)
Seat 8: ChrisCDee folded before Flop (didn't bet)
Seat 9: jacquelinewu folded before Flop (didn't bet)



PokerStars Zoom Hand #84300593969:  Hold'em No Limit ($0.10/$0.25) - 2012/08/05 15:38:26 JST [2012/08/05 2:38:26 ET]
Table 'Whirlpool' 9-max Seat #1 is the button
Seat 1: masterkoolb ($13.61 in chips) 
Seat 2: 1Karina1 ($36.82 in chips) 
Seat 3: hldtom ($25 in chips) 
Seat 4: JhonnyP1979 ($15.83 in chips) 
Seat 5: KrystalAA ($38.21 in chips) 
Seat 6: chiyuki ($46.03 in chips) 
Seat 7: Spheroff ($24.97 in chips) 
Seat 8: jacquelinewu ($74.86 in chips) 
Seat 9: Fructionar ($26.46 in chips) 
1Karina1: posts small blind $0.10
hldtom: posts big blind $0.25
*** HOLE CARDS ***
Dealt to chiyuki [3s 2c]
JhonnyP1979: folds 
KrystalAA: folds 
chiyuki: folds 
Spheroff: folds 
jacquelinewu: folds 
Fructionar: raises $0.50 to $0.75
masterkoolb: folds 
1Karina1: folds 
hldtom: folds 
Uncalled bet ($0.50) returned to Fructionar
Fructionar collected $0.60 from pot
Fructionar: doesn't show hand 
*** SUMMARY ***
Total pot $0.60 | Rake $0 
Seat 1: masterkoolb (button) folded before Flop (didn't bet)
Seat 2: 1Karina1 (small blind) folded before Flop
Seat 3: hldtom (big blind) folded before Flop
Seat 4: JhonnyP1979 folded before Flop (didn't bet)
Seat 5: KrystalAA folded before Flop (didn't bet)
Seat 6: chiyuki folded before Flop (didn't bet)
Seat 7: Spheroff folded before Flop (didn't bet)
Seat 8: jacquelinewu folded before Flop (didn't bet)
Seat 9: Fructionar collected ($0.60)



PokerStars Zoom Hand #84300584359:  Hold'em No Limit ($0.10/$0.25) - 2012/08/05 15:37:47 JST [2012/08/05 2:37:47 ET]
Table 'Whirlpool' 9-max Seat #1 is the button
Seat 1: KrystalAA ($15.33 in chips) 
Seat 2: DutchShultzs ($27.91 in chips) 
Seat 3: GovGus ($52.05 in chips) 
Seat 4: Jene4kaBest ($11.15 in chips) 
Seat 5: ZhukOFFskI ($79.61 in chips) 
Seat 6: God)Squall ($32.29 in chips) 
Seat 7: chiyuki ($46.78 in chips) 
Seat 8: NuMetal88 ($28.75 in chips) 
Seat 9: kesstukas25 ($13.20 in chips) 
DutchShultzs: posts small blind $0.10
GovGus: posts big blind $0.25
*** HOLE CARDS ***
Dealt to chiyuki [Kh 2h]
Jene4kaBest: folds 
ZhukOFFskI: folds 
God)Squall: folds 
chiyuki: folds 
NuMetal88: folds 
kesstukas25: folds 
KrystalAA: raises $0.46 to $0.71
DutchShultzs: folds 
GovGus: raises $1.54 to $2.25
KrystalAA: calls $1.54
*** FLOP *** [7h Qh Tc]
GovGus: bets $2.75
KrystalAA: calls $2.75
*** TURN *** [7h Qh Tc] [Ks]
GovGus: bets $5.50
KrystalAA: raises $4.83 to $10.33 and is all-in
GovGus: folds 
Uncalled bet ($4.83) returned to KrystalAA
KrystalAA collected $20.15 from pot
KrystalAA: doesn't show hand 
*** SUMMARY ***
Total pot $21.10 | Rake $0.95 
Board [7h Qh Tc Ks]
Seat 1: KrystalAA (button) collected ($20.15)
Seat 2: DutchShultzs (small blind) folded before Flop
Seat 3: GovGus (big blind) folded on the Turn
Seat 4: Jene4kaBest folded before Flop (didn't bet)
Seat 5: ZhukOFFskI folded before Flop (didn't bet)
Seat 6: God)Squall folded before Flop (didn't bet)
Seat 7: chiyuki folded before Flop (didn't bet)
Seat 8: NuMetal88 folded before Flop (didn't bet)
Seat 9: kesstukas25 folded before Flop (didn't bet)



PokerStars Zoom Hand #84300596770:  Hold'em No Limit ($0.10/$0.25) - 2012/08/05 15:38:37 JST [2012/08/05 2:38:37 ET]
Table 'Whirlpool' 9-max Seat #1 is the button
Seat 1: WARIBANA7777 ($15.53 in chips) 
Seat 2: Silveystryk ($20.02 in chips) 
Seat 3: mjmichi ($43.04 in chips) 
Seat 4: chiyuki ($46.03 in chips) 
Seat 5: Vahe50 ($19.44 in chips) 
Seat 6: kwkim73 ($26.95 in chips) 
Seat 7: phate-1up ($62.73 in chips) 
Seat 8: DutchShultzs ($28.16 in chips) 
Seat 9: macmauret ($14.75 in chips) 
Silveystryk: posts small blind $0.10
mjmichi: posts big blind $0.25
*** HOLE CARDS ***
Dealt to chiyuki [8s 2d]
chiyuki: folds 
Vahe50: folds 
kwkim73: folds 
phate-1up: folds 
DutchShultzs: folds 
macmauret: folds 
WARIBANA7777: folds 
Silveystryk: folds 
Uncalled bet ($0.15) returned to mjmichi
mjmichi collected $0.20 from pot
mjmichi: doesn't show hand 
*** SUMMARY ***
Total pot $0.20 | Rake $0 
Seat 1: WARIBANA7777 (button) folded before Flop (didn't bet)
Seat 2: Silveystryk (small blind) folded before Flop
Seat 3: mjmichi (big blind) collected ($0.20)
Seat 4: chiyuki folded before Flop (didn't bet)
Seat 5: Vahe50 folded before Flop (didn't bet)
Seat 6: kwkim73 folded before Flop (didn't bet)
Seat 7: phate-1up folded before Flop (didn't bet)
Seat 8: DutchShultzs folded before Flop (didn't bet)
Seat 9: macmauret folded before Flop (didn't bet)



PokerStars Zoom Hand #84300585572:  Hold'em No Limit ($0.10/$0.25) - 2012/08/05 15:37:53 JST [2012/08/05 2:37:53 ET]
Table 'Whirlpool' 9-max Seat #1 is the button
Seat 1: hirozo ($25 in chips) 
Seat 2: snejokCoxx ($10.41 in chips) 
Seat 3: NuMetal88 ($28.75 in chips) 
Seat 4: Ellen1947 ($23.20 in chips) 
Seat 5: chiyuki ($46.78 in chips) 
Seat 6: drunk_bender ($16.13 in chips) 
Seat 7: masterkoolb ($15.81 in chips) 
Seat 8: NENE54 ($14.20 in chips) 
Seat 9: ZhukOFFskI ($79.61 in chips) 
snejokCoxx: posts small blind $0.10
NuMetal88: posts big blind $0.25
*** HOLE CARDS ***
Dealt to chiyuki [6d 6h]
Ellen1947: folds 
chiyuki: raises $0.50 to $0.75
drunk_bender: folds 
masterkoolb: folds 
NENE54: calls $0.75
ZhukOFFskI: calls $0.75
hirozo: folds 
snejokCoxx: folds 
NuMetal88: folds 
*** FLOP *** [Jc 4s Kd]
chiyuki: checks 
NENE54: bets $1.25
ZhukOFFskI: calls $1.25
chiyuki: folds 
*** TURN *** [Jc 4s Kd] [Ad]
NENE54: bets $1.25
ZhukOFFskI: calls $1.25
*** RIVER *** [Jc 4s Kd Ad] [8s]
NENE54: bets $1.25
ZhukOFFskI: calls $1.25
*** SHOW DOWN ***
NENE54: shows [Ts Ks] (a pair of Kings)
ZhukOFFskI: mucks hand 
NENE54 collected $9.65 from pot
*** SUMMARY ***
Total pot $10.10 | Rake $0.45 
Board [Jc 4s Kd Ad 8s]
Seat 1: hirozo (button) folded before Flop (didn't bet)
Seat 2: snejokCoxx (small blind) folded before Flop
Seat 3: NuMetal88 (big blind) folded before Flop
Seat 4: Ellen1947 folded before Flop (didn't bet)
Seat 5: chiyuki folded on the Flop
Seat 6: drunk_bender folded before Flop (didn't bet)
Seat 7: masterkoolb folded before Flop (didn't bet)
Seat 8: NENE54 showed [Ts Ks] and won ($9.65) with a pair of Kings
Seat 9: ZhukOFFskI mucked [Qc Qs]



PokerStars Zoom Hand #84300599563:  Hold'em No Limit ($0.10/$0.25) - 2012/08/05 15:38:48 JST [2012/08/05 2:38:48 ET]
Table 'Whirlpool' 9-max Seat #1 is the button
Seat 1: kwkim73 ($32.01 in chips) 
Seat 2: drunk_bender ($16.23 in chips) 
Seat 3: herkko11 ($4.97 in chips) 
Seat 4: Vahe50 ($19.44 in chips) 
Seat 5: Spheroff ($25.07 in chips) 
Seat 6: Limoilou ($33.37 in chips) 
Seat 7: GovGus ($46.58 in chips) 
Seat 8: kesstukas25 ($14.80 in chips) 
Seat 9: chiyuki ($46.03 in chips) 
drunk_bender: posts small blind $0.10
herkko11: posts big blind $0.25
*** HOLE CARDS ***
Dealt to chiyuki [2s Ts]
Vahe50: folds 
Spheroff: folds 
Limoilou: folds 
GovGus: folds 
kesstukas25: folds 
chiyuki: folds 
kwkim73: folds 
drunk_bender: folds 
Uncalled bet ($0.15) returned to herkko11
herkko11 collected $0.20 from pot
herkko11: doesn't show hand 
*** SUMMARY ***
Total pot $0.20 | Rake $0 
Seat 1: kwkim73 (button) folded before Flop (didn't bet)
Seat 2: drunk_bender (small blind) folded before Flop
Seat 3: herkko11 (big blind) collected ($0.20)
Seat 4: Vahe50 folded before Flop (didn't bet)
Seat 5: Spheroff folded before Flop (didn't bet)
Seat 6: Limoilou folded before Flop (didn't bet)
Seat 7: GovGus folded before Flop (didn't bet)
Seat 8: kesstukas25 folded before Flop (didn't bet)
Seat 9: chiyuki folded before Flop (didn't bet)



PokerStars Zoom Hand #84300598537:  Hold'em No Limit ($0.10/$0.25) - 2012/08/05 15:38:44 JST [2012/08/05 2:38:44 ET]
Table 'Whirlpool' 9-max Seat #1 is the button
Seat 1: GovGus ($41.55 in chips) 
Seat 2: River_GmbH ($13.95 in chips) 
Seat 3: 500Ang ($25 in chips) 
Seat 4: chiyuki ($46.03 in chips) 
Seat 5: drunk_bender ($16.23 in chips) 
Seat 6: NuMetal88 ($28.15 in chips) 
Seat 7: Grishukps ($12.50 in chips) 
Seat 8: Perstenev ($24.18 in chips) 
Seat 9: KeLevro0 ($10.70 in chips) 
River_GmbH: posts small blind $0.10
500Ang: posts big blind $0.25
*** HOLE CARDS ***
Dealt to chiyuki [3c 5d]
chiyuki: folds 
drunk_bender: folds 
NuMetal88: raises $0.50 to $0.75
Grishukps: folds 
Perstenev: folds 
KeLevro0: folds 
GovGus: folds 
River_GmbH: folds 
500Ang: folds 
Uncalled bet ($0.50) returned to NuMetal88
NuMetal88 collected $0.60 from pot
NuMetal88: doesn't show hand 
*** SUMMARY ***
Total pot $0.60 | Rake $0 
Seat 1: GovGus (button) folded before Flop (didn't bet)
Seat 2: River_GmbH (small blind) folded before Flop
Seat 3: 500Ang (big blind) folded before Flop
Seat 4: chiyuki folded before Flop (didn't bet)
Seat 5: drunk_bender folded before Flop (didn't bet)
Seat 6: NuMetal88 collected ($0.60)
Seat 7: Grishukps folded before Flop (didn't bet)
Seat 8: Perstenev folded before Flop (didn't bet)
Seat 9: KeLevro0 folded before Flop (didn't bet)



PokerStars Zoom Hand #84300603690:  Hold'em No Limit ($0.10/$0.25) - 2012/08/05 15:39:05 JST [2012/08/05 2:39:05 ET]
Table 'Whirlpool' 9-max Seat #1 is the button
Seat 1: kwkim73 ($56.10 in chips) 
Seat 2: DutchShultzs ($47.06 in chips) 
Seat 3: westhavenbc ($20 in chips) 
Seat 4: phate-1up ($62.63 in chips) 
Seat 5: genamator ($19.96 in chips) 
Seat 6: NuMetal88 ($38.44 in chips) 
Seat 7: herkko11 ($5.07 in chips) 
Seat 8: chiyuki ($45.93 in chips) 
Seat 9: Spheroff ($24.97 in chips) 
DutchShultzs: posts small blind $0.10
westhavenbc: posts big blind $0.25
*** HOLE CARDS ***
Dealt to chiyuki [4c Kh]
phate-1up: folds 
genamator: folds 
NuMetal88: folds 
herkko11: folds 
chiyuki: folds 
Spheroff: folds 
kwkim73: folds 
DutchShultzs: folds 
Uncalled bet ($0.15) returned to westhavenbc
westhavenbc collected $0.20 from pot
westhavenbc: doesn't show hand 
*** SUMMARY ***
Total pot $0.20 | Rake $0 
Seat 1: kwkim73 (button) folded before Flop (didn't bet)
Seat 2: DutchShultzs (small blind) folded before Flop
Seat 3: westhavenbc (big blind) collected ($0.20)
Seat 4: phate-1up folded before Flop (didn't bet)
Seat 5: genamator folded before Flop (didn't bet)
Seat 6: NuMetal88 folded before Flop (didn't bet)
Seat 7: herkko11 folded before Flop (didn't bet)
Seat 8: chiyuki folded before Flop (didn't bet)
Seat 9: Spheroff folded before Flop (didn't bet)



PokerStars Zoom Hand #84300600825:  Hold'em No Limit ($0.10/$0.25) - 2012/08/05 15:38:53 JST [2012/08/05 2:38:53 ET]
Table 'Whirlpool' 9-max Seat #1 is the button
Seat 1: leo2095 ($19.89 in chips) 
Seat 2: chiyuki ($46.03 in chips) 
Seat 3: Vahe50 ($19.44 in chips) 
Seat 4: GovGus ($26 in chips) 
Seat 5: KeLevro0 ($10.70 in chips) 
Seat 6: aSasha280 ($14.14 in chips) 
Seat 7: Perstenev ($12.65 in chips) 
Seat 8: Serge Claws ($41.73 in chips) 
Seat 9: kamikkaze ($20.43 in chips) 
chiyuki: posts small blind $0.10
Vahe50: posts big blind $0.25
*** HOLE CARDS ***
Dealt to chiyuki [6d 2h]
GovGus: folds 
KeLevro0: folds 
aSasha280: folds 
Perstenev: folds 
Serge Claws: raises $0.50 to $0.75
kamikkaze: folds 
leo2095: calls $0.75
chiyuki: folds 
Vahe50: folds 
*** FLOP *** [8c 3h Tc]
Serge Claws: checks 
leo2095: checks 
*** TURN *** [8c 3h Tc] [7c]
Serge Claws: checks 
leo2095: checks 
*** RIVER *** [8c 3h Tc 7c] [Ac]
Serge Claws: checks 
leo2095: checks 
*** SHOW DOWN ***
Serge Claws: shows [Ad Jd] (a pair of Aces)
leo2095: mucks hand 
Serge Claws collected $1.77 from pot
*** SUMMARY ***
Total pot $1.85 | Rake $0.08 
Board [8c 3h Tc 7c Ac]
Seat 1: leo2095 (button) mucked [6h Ah]
Seat 2: chiyuki (small blind) folded before Flop
Seat 3: Vahe50 (big blind) folded before Flop
Seat 4: GovGus folded before Flop (didn't bet)
Seat 5: KeLevro0 folded before Flop (didn't bet)
Seat 6: aSasha280 folded before Flop (didn't bet)
Seat 7: Perstenev folded before Flop (didn't bet)
Seat 8: Serge Claws showed [Ad Jd] and won ($1.77) with a pair of Aces
Seat 9: kamikkaze folded before Flop (didn't bet)



PokerStars Zoom Hand #84300604705:  Hold'em No Limit ($0.10/$0.25) - 2012/08/05 15:39:09 JST [2012/08/05 2:39:09 ET]
Table 'Whirlpool' 9-max Seat #1 is the button
Seat 1: Gichboy ($30.68 in chips) 
Seat 2: Rilko1975 ($24.80 in chips) 
Seat 3: chiyuki ($45.93 in chips) 
Seat 4: Grishukps ($12.85 in chips) 
Seat 5: drunk_bender ($16.13 in chips) 
Seat 6: Alvinpe85 ($49.74 in chips) 
Seat 7: Silveystryk ($38.11 in chips) 
Seat 8: KeLevro0 ($11.78 in chips) 
Seat 9: Nerkit ($13.87 in chips) 
Rilko1975: posts small blind $0.10
chiyuki: posts big blind $0.25
*** HOLE CARDS ***
Dealt to chiyuki [9c Ah]
Grishukps: folds 
drunk_bender: folds 
Alvinpe85: raises $0.50 to $0.75
Silveystryk: folds 
KeLevro0: calls $0.75
Nerkit: raises $1.75 to $2.50
Gichboy: folds 
Rilko1975: folds 
chiyuki: folds 
Alvinpe85: folds 
KeLevro0: folds 
Uncalled bet ($1.75) returned to Nerkit
Nerkit collected $2.60 from pot
Nerkit: doesn't show hand 
*** SUMMARY ***
Total pot $2.60 | Rake $0 
Seat 1: Gichboy (button) folded before Flop (didn't bet)
Seat 2: Rilko1975 (small blind) folded before Flop
Seat 3: chiyuki (big blind) folded before Flop
Seat 4: Grishukps folded before Flop (didn't bet)
Seat 5: drunk_bender folded before Flop (didn't bet)
Seat 6: Alvinpe85 folded before Flop
Seat 7: Silveystryk folded before Flop (didn't bet)
Seat 8: KeLevro0 folded before Flop
Seat 9: Nerkit collected ($2.60)



PokerStars Zoom Hand #84300610581:  Hold'em No Limit ($0.10/$0.25) - 2012/08/05 15:39:32 JST [2012/08/05 2:39:32 ET]
Table 'Whirlpool' 9-max Seat #1 is the button
Seat 1: chiyuki ($45.68 in chips) 
Seat 2: Lasutchik ($11.90 in chips) 
Seat 3: genamator ($19.96 in chips) 
Seat 4: kwkim73 ($25.62 in chips) 
Seat 5: Silveystryk ($13.55 in chips) 
Seat 6: Faraz ($20.17 in chips) 
Seat 7: pandaaaaaa ($10.87 in chips) 
Seat 8: herkko11 ($4.97 in chips) 
Seat 9: snejokCoxx ($10.31 in chips) 
Lasutchik: posts small blind $0.10
genamator: posts big blind $0.25
*** HOLE CARDS ***
Dealt to chiyuki [As Qh]
kwkim73: folds 
Silveystryk: folds 
Faraz: folds 
pandaaaaaa: folds 
herkko11: raises $0.25 to $0.50
snejokCoxx: folds 
chiyuki: raises $1.25 to $1.75
Lasutchik: folds 
genamator: folds 
herkko11: calls $1.25
*** FLOP *** [Ad Kh 4s]
herkko11: checks 
chiyuki: bets $3.75
herkko11: folds 
Uncalled bet ($3.75) returned to chiyuki
chiyuki collected $3.68 from pot
chiyuki: doesn't show hand 
*** SUMMARY ***
Total pot $3.85 | Rake $0.17 
Board [Ad Kh 4s]
Seat 1: chiyuki (button) collected ($3.68)
Seat 2: Lasutchik (small blind) folded before Flop
Seat 3: genamator (big blind) folded before Flop
Seat 4: kwkim73 folded before Flop (didn't bet)
Seat 5: Silveystryk folded before Flop (didn't bet)
Seat 6: Faraz folded before Flop (didn't bet)
Seat 7: pandaaaaaa folded before Flop (didn't bet)
Seat 8: herkko11 folded on the Flop
Seat 9: snejokCoxx folded before Flop (didn't bet)



PokerStars Zoom Hand #84300619459:  Hold'em No Limit ($0.10/$0.25) - 2012/08/05 15:40:07 JST [2012/08/05 2:40:07 ET]
Table 'Whirlpool' 9-max Seat #1 is the button
Seat 1: risekuku468 ($29.99 in chips) 
Seat 2: GSDP ($25.79 in chips) 
Seat 3: jacquelinewu ($28.43 in chips) 
Seat 4: kamikkaze ($13.60 in chips) 
Seat 5: KrystalAA ($24.02 in chips) 
Seat 6: kwkim73 ($30.41 in chips) 
Seat 7: chiyuki ($47.61 in chips) 
Seat 8: Fructionar ($25.96 in chips) 
Seat 9: Grishukps ($14.61 in chips) 
GSDP: posts small blind $0.10
jacquelinewu: posts big blind $0.25
*** HOLE CARDS ***
Dealt to chiyuki [Qd Jd]
kamikkaze: folds 
KrystalAA: folds 
kwkim73: folds 
chiyuki: folds 
Fructionar: folds 
Grishukps: folds 
risekuku468: raises $0.50 to $0.75
GSDP: folds 
jacquelinewu: raises $1.50 to $2.25
risekuku468: folds 
Uncalled bet ($1.50) returned to jacquelinewu
jacquelinewu collected $1.60 from pot
jacquelinewu: doesn't show hand 
*** SUMMARY ***
Total pot $1.60 | Rake $0 
Seat 1: risekuku468 (button) folded before Flop
Seat 2: GSDP (small blind) folded before Flop
Seat 3: jacquelinewu (big blind) collected ($1.60)
Seat 4: kamikkaze folded before Flop (didn't bet)
Seat 5: KrystalAA folded before Flop (didn't bet)
Seat 6: kwkim73 folded before Flop (didn't bet)
Seat 7: chiyuki folded before Flop (didn't bet)
Seat 8: Fructionar folded before Flop (didn't bet)
Seat 9: Grishukps folded before Flop (didn't bet)



PokerStars Zoom Hand #84300622309:  Hold'em No Limit ($0.10/$0.25) - 2012/08/05 15:40:19 JST [2012/08/05 2:40:19 ET]
Table 'Whirlpool' 9-max Seat #1 is the button
Seat 1: ShaninPeter ($11.85 in chips) 
Seat 2: Serge Claws ($26.45 in chips) 
Seat 3: TorTrade ($28.29 in chips) 
Seat 4: opie62 ($22.57 in chips) 
Seat 5: 500Ang ($26.33 in chips) 
Seat 6: KrystalAA ($21.55 in chips) 
Seat 7: yvasilik ($20.50 in chips) 
Seat 8: KeLevro0 ($9.38 in chips) 
Seat 9: chiyuki ($47.51 in chips) 
Serge Claws: posts small blind $0.10
TorTrade: posts big blind $0.25
*** HOLE CARDS ***
Dealt to chiyuki [Qs As]
opie62: folds 
500Ang: folds 
KrystalAA: folds 
yvasilik: folds 
KeLevro0: folds 
chiyuki: raises $0.50 to $0.75
ShaninPeter: folds 
Serge Claws: folds 
TorTrade: folds 
Uncalled bet ($0.50) returned to chiyuki
chiyuki collected $0.60 from pot
chiyuki: doesn't show hand 
*** SUMMARY ***
Total pot $0.60 | Rake $0 
Seat 1: ShaninPeter (button) folded before Flop (didn't bet)
Seat 2: Serge Claws (small blind) folded before Flop
Seat 3: TorTrade (big blind) folded before Flop
Seat 4: opie62 folded before Flop (didn't bet)
Seat 5: 500Ang folded before Flop (didn't bet)
Seat 6: KrystalAA folded before Flop (didn't bet)
Seat 7: yvasilik folded before Flop (didn't bet)
Seat 8: KeLevro0 folded before Flop (didn't bet)
Seat 9: chiyuki collected ($0.60)



PokerStars Zoom Hand #84300618438:  Hold'em No Limit ($0.10/$0.25) - 2012/08/05 15:40:03 JST [2012/08/05 2:40:03 ET]
Table 'Whirlpool' 9-max Seat #1 is the button
Seat 1: KeLevro0 ($9.38 in chips) 
Seat 2: kwkim73 ($30.51 in chips) 
Seat 3: Serge Claws ($36.94 in chips) 
Seat 4: Saruotiss ($62.71 in chips) 
Seat 5: Alvinpe85 ($54.09 in chips) 
Seat 6: chiyuki ($47.61 in chips) 
Seat 7: Faraz ($11.47 in chips) 
Seat 8: kamikkaze ($13.60 in chips) 
Seat 9: Robchie ($20.25 in chips) 
kwkim73: posts small blind $0.10
Serge Claws: posts big blind $0.25
*** HOLE CARDS ***
Dealt to chiyuki [3c 6h]
Saruotiss: folds 
Alvinpe85: raises $0.50 to $0.75
chiyuki: folds 
Faraz: calls $0.75
kamikkaze: folds 
Robchie: calls $0.75
KeLevro0: folds 
kwkim73: folds 
Serge Claws: folds 
*** FLOP *** [6c Ts Ah]
Alvinpe85: bets $1.48
Faraz: folds 
Robchie: folds 
Uncalled bet ($1.48) returned to Alvinpe85
Alvinpe85 collected $2.48 from pot
Alvinpe85: doesn't show hand 
*** SUMMARY ***
Total pot $2.60 | Rake $0.12 
Board [6c Ts Ah]
Seat 1: KeLevro0 (button) folded before Flop (didn't bet)
Seat 2: kwkim73 (small blind) folded before Flop
Seat 3: Serge Claws (big blind) folded before Flop
Seat 4: Saruotiss folded before Flop (didn't bet)
Seat 5: Alvinpe85 collected ($2.48)
Seat 6: chiyuki folded before Flop (didn't bet)
Seat 7: Faraz folded on the Flop
Seat 8: kamikkaze folded before Flop (didn't bet)
Seat 9: Robchie folded on the Flop



PokerStars Zoom Hand #84300620742:  Hold'em No Limit ($0.10/$0.25) - 2012/08/05 15:40:12 JST [2012/08/05 2:40:12 ET]
Table 'Whirlpool' 9-max Seat #1 is the button
Seat 1: Silveystryk ($37.11 in chips) 
Seat 2: chiyuki ($47.61 in chips) 
Seat 3: kamikkaze ($13.60 in chips) 
Seat 4: kwkim73 ($30.41 in chips) 
Seat 5: seula i ($28.86 in chips) 
Seat 6: hldtom ($26.95 in chips) 
Seat 7: Grishukps ($14.61 in chips) 
Seat 8: nice.franki ($12.71 in chips) 
Seat 9: Fructionar ($25.96 in chips) 
chiyuki: posts small blind $0.10
kamikkaze: posts big blind $0.25
*** HOLE CARDS ***
Dealt to chiyuki [3c Js]
kwkim73: folds 
seula i: folds 
hldtom: folds 
Grishukps: raises $0.50 to $0.75
nice.franki: folds 
Fructionar: folds 
Silveystryk: calls $0.75
chiyuki: folds 
kamikkaze: folds 
*** FLOP *** [5s Ac 2c]
Grishukps: bets $1.10
Silveystryk: folds 
Uncalled bet ($1.10) returned to Grishukps
Grishukps collected $1.77 from pot
Grishukps: doesn't show hand 
*** SUMMARY ***
Total pot $1.85 | Rake $0.08 
Board [5s Ac 2c]
Seat 1: Silveystryk (button) folded on the Flop
Seat 2: chiyuki (small blind) folded before Flop
Seat 3: kamikkaze (big blind) folded before Flop
Seat 4: kwkim73 folded before Flop (didn't bet)
Seat 5: seula i folded before Flop (didn't bet)
Seat 6: hldtom folded before Flop (didn't bet)
Seat 7: Grishukps collected ($1.77)
Seat 8: nice.franki folded before Flop (didn't bet)
Seat 9: Fructionar folded before Flop (didn't bet)



PokerStars Zoom Hand #84300631036:  Hold'em No Limit ($0.10/$0.25) - 2012/08/05 15:40:53 JST [2012/08/05 2:40:53 ET]
Table 'Whirlpool' 9-max Seat #1 is the button
Seat 1: chiyuki ($47.86 in chips) 
Seat 2: Faraz ($11.53 in chips) 
Seat 3: macmauret ($11.65 in chips) 
Seat 4: Serge Claws ($26.10 in chips) 
Seat 5: GSDP ($49.45 in chips) 
Seat 6: seula i ($28.13 in chips) 
Seat 7: jacquelinewu ($74.11 in chips) 
Seat 8: kamikkaze ($13.25 in chips) 
Seat 9: NuMetal88 ($38.44 in chips) 
Faraz: posts small blind $0.10
macmauret: posts big blind $0.25
*** HOLE CARDS ***
Dealt to chiyuki [Ah 8d]
Serge Claws: raises $0.50 to $0.75
GSDP: folds 
seula i: folds 
jacquelinewu: folds 
kamikkaze: folds 
NuMetal88: folds 
chiyuki: folds 
Faraz: folds 
macmauret: folds 
Uncalled bet ($0.50) returned to Serge Claws
Serge Claws collected $0.60 from pot
Serge Claws: doesn't show hand 
*** SUMMARY ***
Total pot $0.60 | Rake $0 
Seat 1: chiyuki (button) folded before Flop (didn't bet)
Seat 2: Faraz (small blind) folded before Flop
Seat 3: macmauret (big blind) folded before Flop
Seat 4: Serge Claws collected ($0.60)
Seat 5: GSDP folded before Flop (didn't bet)
Seat 6: seula i folded before Flop (didn't bet)
Seat 7: jacquelinewu folded before Flop (didn't bet)
Seat 8: kamikkaze folded before Flop (didn't bet)
Seat 9: NuMetal88 folded before Flop (didn't bet)



PokerStars Zoom Hand #84300626948:  Hold'em No Limit ($0.10/$0.25) - 2012/08/05 15:40:37 JST [2012/08/05 2:40:37 ET]
Table 'Whirlpool' 9-max Seat #1 is the button
Seat 1: aSasha280 ($8.29 in chips) 
Seat 2: DutchShultzs ($25 in chips) 
Seat 3: seula i ($28.86 in chips) 
Seat 4: ShaninPeter ($11.85 in chips) 
Seat 5: chiyuki ($47.86 in chips) 
Seat 6: 4plankton ($26.15 in chips) 
Seat 7: leo2095 ($19.14 in chips) 
Seat 8: Alvinpe85 ($48.99 in chips) 
Seat 9: moku36 ($35.92 in chips) 
DutchShultzs: posts small blind $0.10
seula i: posts big blind $0.25
*** HOLE CARDS ***
Dealt to chiyuki [6h 7d]
ShaninPeter: folds 
chiyuki: folds 
4plankton: folds 
leo2095: folds 
Alvinpe85: folds 
moku36: calls $0.25
aSasha280: folds 
DutchShultzs: calls $0.15
seula i: checks 
*** FLOP *** [3d 3h 2h]
DutchShultzs: checks 
seula i: checks 
moku36: bets $1
DutchShultzs: folds 
seula i: folds 
Uncalled bet ($1) returned to moku36
moku36 collected $0.72 from pot
moku36: doesn't show hand 
*** SUMMARY ***
Total pot $0.75 | Rake $0.03 
Board [3d 3h 2h]
Seat 1: aSasha280 (button) folded before Flop (didn't bet)
Seat 2: DutchShultzs (small blind) folded on the Flop
Seat 3: seula i (big blind) folded on the Flop
Seat 4: ShaninPeter folded before Flop (didn't bet)
Seat 5: chiyuki folded before Flop (didn't bet)
Seat 6: 4plankton folded before Flop (didn't bet)
Seat 7: leo2095 folded before Flop (didn't bet)
Seat 8: Alvinpe85 folded before Flop (didn't bet)
Seat 9: moku36 collected ($0.72)



PokerStars Zoom Hand #84300625943:  Hold'em No Limit ($0.10/$0.25) - 2012/08/05 15:40:33 JST [2012/08/05 2:40:33 ET]
Table 'Whirlpool' 9-max Seat #1 is the button
Seat 1: hldtom ($12.50 in chips) 
Seat 2: Faraz ($20.72 in chips) 
Seat 3: Ozboy80 ($25.65 in chips) 
Seat 4: mjmichi ($64.35 in chips) 
Seat 5: Alvinpe85 ($48.99 in chips) 
Seat 6: jacquelinewu ($29.28 in chips) 
Seat 7: Gichboy ($16.75 in chips) 
Seat 8: chiyuki ($47.86 in chips) 
Seat 9: KrystalAA ($24.27 in chips) 
Faraz: posts small blind $0.10
Ozboy80: posts big blind $0.25
*** HOLE CARDS ***
Dealt to chiyuki [7h 9d]
mjmichi: folds 
Alvinpe85: folds 
jacquelinewu: folds 
Gichboy: raises $0.25 to $0.50
chiyuki: folds 
KrystalAA: folds 
hldtom: folds 
Faraz: calls $0.40
Ozboy80: raises $1 to $1.50
Gichboy: calls $1
Faraz: calls $1
*** FLOP *** [Th Td 3h]
Faraz: checks 
Ozboy80: bets $3.25
Gichboy: folds 
Faraz: folds 
Uncalled bet ($3.25) returned to Ozboy80
Ozboy80 collected $4.30 from pot
Ozboy80: doesn't show hand 
*** SUMMARY ***
Total pot $4.50 | Rake $0.20 
Board [Th Td 3h]
Seat 1: hldtom (button) folded before Flop (didn't bet)
Seat 2: Faraz (small blind) folded on the Flop
Seat 3: Ozboy80 (big blind) collected ($4.30)
Seat 4: mjmichi folded before Flop (didn't bet)
Seat 5: Alvinpe85 folded before Flop (didn't bet)
Seat 6: jacquelinewu folded before Flop (didn't bet)
Seat 7: Gichboy folded on the Flop
Seat 8: chiyuki folded before Flop (didn't bet)
Seat 9: KrystalAA folded before Flop (didn't bet)



PokerStars Zoom Hand #84300635122:  Hold'em No Limit ($0.10/$0.25) - 2012/08/05 15:41:09 JST [2012/08/05 2:41:09 ET]
Table 'Whirlpool' 9-max Seat #1 is the button
Seat 1: seula i ($28.13 in chips) 
Seat 2: 0 operator 0 ($22.39 in chips) 
Seat 3: chiyuki ($47.86 in chips) 
Seat 4: kwkim73 ($30.06 in chips) 
Seat 5: Serge Claws ($37.69 in chips) 
Seat 6: Saruotiss ($62.21 in chips) 
Seat 7: DutchShultzs ($29.23 in chips) 
Seat 8: nice.franki ($12.61 in chips) 
Seat 9: soul_5577 ($39.75 in chips) 
0 operator 0: posts small blind $0.10
chiyuki: posts big blind $0.25
*** HOLE CARDS ***
Dealt to chiyuki [2c 2s]
kwkim73: folds 
Serge Claws: raises $0.50 to $0.75
Saruotiss: folds 
DutchShultzs: calls $0.75
nice.franki: folds 
soul_5577: folds 
seula i: folds 
0 operator 0: folds 
chiyuki: calls $0.50
*** FLOP *** [6d Qs 4h]
chiyuki: checks 
Serge Claws: bets $1.50
DutchShultzs: folds 
chiyuki: folds 
Uncalled bet ($1.50) returned to Serge Claws
Serge Claws collected $2.24 from pot
Serge Claws: doesn't show hand 
*** SUMMARY ***
Total pot $2.35 | Rake $0.11 
Board [6d Qs 4h]
Seat 1: seula i (button) folded before Flop (didn't bet)
Seat 2: 0 operator 0 (small blind) folded before Flop
Seat 3: chiyuki (big blind) folded on the Flop
Seat 4: kwkim73 folded before Flop (didn't bet)
Seat 5: Serge Claws collected ($2.24)
Seat 6: Saruotiss folded before Flop (didn't bet)
Seat 7: DutchShultzs folded on the Flop
Seat 8: nice.franki folded before Flop (didn't bet)
Seat 9: soul_5577 folded before Flop (didn't bet)



PokerStars Zoom Hand #84300643771:  Hold'em No Limit ($0.10/$0.25) - 2012/08/05 15:41:44 JST [2012/08/05 2:41:44 ET]
Table 'Whirlpool' 9-max Seat #1 is the button
Seat 1: kesstukas25 ($13.85 in chips) 
Seat 2: INSP!RON ($37.10 in chips) 
Seat 3: kamikkaze ($19.35 in chips) 
Seat 4: hldtom ($34.46 in chips) 
Seat 5: Roglus ($13.55 in chips) 
Seat 6: DutchShultzs ($46.61 in chips) 
Seat 7: chiyuki ($47.11 in chips) 
Seat 8: 1Karina1 ($26.45 in chips) 
Seat 9: Ellen1947 ($22.60 in chips) 
INSP!RON: posts small blind $0.10
kamikkaze: posts big blind $0.25
*** HOLE CARDS ***
Dealt to chiyuki [Jh Kc]
hldtom: folds 
Roglus: folds 
DutchShultzs: folds 
chiyuki: folds 
1Karina1: folds 
Ellen1947: folds 
kesstukas25: folds 
INSP!RON: raises $0.50 to $0.75
kamikkaze: folds 
Uncalled bet ($0.50) returned to INSP!RON
INSP!RON collected $0.50 from pot
INSP!RON: doesn't show hand 
*** SUMMARY ***
Total pot $0.50 | Rake $0 
Seat 1: kesstukas25 (button) folded before Flop (didn't bet)
Seat 2: INSP!RON (small blind) collected ($0.50)
Seat 3: kamikkaze (big blind) folded before Flop
Seat 4: hldtom folded before Flop (didn't bet)
Seat 5: Roglus folded before Flop (didn't bet)
Seat 6: DutchShultzs folded before Flop (didn't bet)
Seat 7: chiyuki folded before Flop (didn't bet)
Seat 8: 1Karina1 folded before Flop (didn't bet)
Seat 9: Ellen1947 folded before Flop (didn't bet)



PokerStars Zoom Hand #84300651780:  Hold'em No Limit ($0.10/$0.25) - 2012/08/05 15:42:15 JST [2012/08/05 2:42:15 ET]
Table 'Whirlpool' 9-max Seat #1 is the button
Seat 1: DrunkTyphoon ($27.60 in chips) 
Seat 2: KeLevro0 ($9.26 in chips) 
Seat 3: KrystalAA ($24.17 in chips) 
Seat 4: chiyuki ($47.01 in chips) 
Seat 5: Serge Claws ($27.82 in chips) 
Seat 6: Rici47 ($32.69 in chips) 
Seat 7: WARIBANA7777 ($15.18 in chips) 
Seat 8: kamikkaze ($19.10 in chips) 
Seat 9: ShaninPeter ($11.50 in chips) 
KeLevro0: posts small blind $0.10
KrystalAA: posts big blind $0.25
*** HOLE CARDS ***
Dealt to chiyuki [7d 6s]
chiyuki: folds 
Serge Claws: folds 
Rici47: folds 
WARIBANA7777: folds 
kamikkaze: folds 
ShaninPeter: folds 
DrunkTyphoon: folds 
KeLevro0: folds 
Uncalled bet ($0.15) returned to KrystalAA
KrystalAA collected $0.20 from pot
KrystalAA: doesn't show hand 
*** SUMMARY ***
Total pot $0.20 | Rake $0 
Seat 1: DrunkTyphoon (button) folded before Flop (didn't bet)
Seat 2: KeLevro0 (small blind) folded before Flop
Seat 3: KrystalAA (big blind) collected ($0.20)
Seat 4: chiyuki folded before Flop (didn't bet)
Seat 5: Serge Claws folded before Flop (didn't bet)
Seat 6: Rici47 folded before Flop (didn't bet)
Seat 7: WARIBANA7777 folded before Flop (didn't bet)
Seat 8: kamikkaze folded before Flop (didn't bet)
Seat 9: ShaninPeter folded before Flop (didn't bet)



PokerStars Zoom Hand #84300654035:  Hold'em No Limit ($0.10/$0.25) - 2012/08/05 15:42:24 JST [2012/08/05 2:42:24 ET]
Table 'Whirlpool' 9-max Seat #1 is the button
Seat 1: Alvinpe85 ($56.74 in chips) 
Seat 2: slapshot2011 ($9.69 in chips) 
Seat 3: Dejacob ($25 in chips) 
Seat 4: Vahe50 ($22.83 in chips) 
Seat 5: Jene4kaBest ($10.09 in chips) 
Seat 6: KrystalAA ($24.27 in chips) 
Seat 7: HighDuka ($33.06 in chips) 
Seat 8: opie62 ($18.47 in chips) 
Seat 9: chiyuki ($47.01 in chips) 
slapshot2011: posts small blind $0.10
Dejacob: posts big blind $0.25
*** HOLE CARDS ***
Dealt to chiyuki [Ac 8d]
Vahe50: folds 
Jene4kaBest: folds 
KrystalAA: folds 
HighDuka: folds 
opie62: folds 
chiyuki: folds 
Alvinpe85: folds 
slapshot2011: folds 
Uncalled bet ($0.15) returned to Dejacob
Dejacob collected $0.20 from pot
Dejacob: doesn't show hand 
*** SUMMARY ***
Total pot $0.20 | Rake $0 
Seat 1: Alvinpe85 (button) folded before Flop (didn't bet)
Seat 2: slapshot2011 (small blind) folded before Flop
Seat 3: Dejacob (big blind) collected ($0.20)
Seat 4: Vahe50 folded before Flop (didn't bet)
Seat 5: Jene4kaBest folded before Flop (didn't bet)
Seat 6: KrystalAA folded before Flop (didn't bet)
Seat 7: HighDuka folded before Flop (didn't bet)
Seat 8: opie62 folded before Flop (didn't bet)
Seat 9: chiyuki folded before Flop (didn't bet)



PokerStars Zoom Hand #84300648281:  Hold'em No Limit ($0.10/$0.25) - 2012/08/05 15:42:01 JST [2012/08/05 2:42:01 ET]
Table 'Whirlpool' 9-max Seat #1 is the button
Seat 1: phate-1up ($69.10 in chips) 
Seat 2: chiyuki ($47.11 in chips) 
Seat 3: soul_5577 ($39 in chips) 
Seat 4: 1Karina1 ($31.93 in chips) 
Seat 5: KeLevro0 ($9.73 in chips) 
Seat 6: mjmichi ($64 in chips) 
Seat 7: panaam ($26.19 in chips) 
Seat 8: kwkim73 ($55.88 in chips) 
Seat 9: kamikkaze ($19.10 in chips) 
chiyuki: posts small blind $0.10
soul_5577: posts big blind $0.25
*** HOLE CARDS ***
Dealt to chiyuki [8d 9c]
1Karina1: folds 
KeLevro0: folds 
mjmichi: raises $0.50 to $0.75
panaam: folds 
kwkim73: calls $0.75
kamikkaze: folds 
phate-1up: folds 
chiyuki: folds 
soul_5577: calls $0.50
*** FLOP *** [Kd 4d Kh]
soul_5577: checks 
mjmichi: checks 
kwkim73: checks 
*** TURN *** [Kd 4d Kh] [Jc]
soul_5577: checks 
mjmichi: bets $1.50
kwkim73: folds 
soul_5577: folds 
Uncalled bet ($1.50) returned to mjmichi
mjmichi collected $2.24 from pot
mjmichi: doesn't show hand 
*** SUMMARY ***
Total pot $2.35 | Rake $0.11 
Board [Kd 4d Kh Jc]
Seat 1: phate-1up (button) folded before Flop (didn't bet)
Seat 2: chiyuki (small blind) folded before Flop
Seat 3: soul_5577 (big blind) folded on the Turn
Seat 4: 1Karina1 folded before Flop (didn't bet)
Seat 5: KeLevro0 folded before Flop (didn't bet)
Seat 6: mjmichi collected ($2.24)
Seat 7: panaam folded before Flop (didn't bet)
Seat 8: kwkim73 folded on the Turn
Seat 9: kamikkaze folded before Flop (didn't bet)



PokerStars Zoom Hand #84300644794:  Hold'em No Limit ($0.10/$0.25) - 2012/08/05 15:41:48 JST [2012/08/05 2:41:48 ET]
Table 'Whirlpool' 9-max Seat #1 is the button
Seat 1: snejokCoxx ($11.75 in chips) 
Seat 2: Roglus ($13.55 in chips) 
Seat 3: Serge Claws ($39.18 in chips) 
Seat 4: DutchShultzs ($46.61 in chips) 
Seat 5: seula i ($25.30 in chips) 
Seat 6: chiyuki ($47.11 in chips) 
Seat 7: romanian c4 ($20.70 in chips) 
Seat 8: ShaninPeter ($11.85 in chips) 
Seat 9: DrunkTyphoon ($25 in chips) 
Roglus: posts small blind $0.10
Serge Claws: posts big blind $0.25
*** HOLE CARDS ***
Dealt to chiyuki [Qs 5d]
DutchShultzs: folds 
seula i: folds 
chiyuki: folds 
romanian c4: folds 
ShaninPeter: folds 
DrunkTyphoon: folds 
snejokCoxx: folds 
Roglus: raises $0.50 to $0.75
Serge Claws: calls $0.50
*** FLOP *** [Td 4s 5c]
Roglus: bets $0.75
Serge Claws: raises $1.25 to $2
Roglus: calls $1.25
*** TURN *** [Td 4s 5c] [7h]
Roglus: checks 
Serge Claws: bets $3.25
Roglus: calls $3.25
*** RIVER *** [Td 4s 5c 7h] [Ah]
Roglus: bets $4.01
Serge Claws: folds 
Uncalled bet ($4.01) returned to Roglus
Roglus collected $11.46 from pot
Roglus: doesn't show hand 
*** SUMMARY ***
Total pot $12 | Rake $0.54 
Board [Td 4s 5c 7h Ah]
Seat 1: snejokCoxx (button) folded before Flop (didn't bet)
Seat 2: Roglus (small blind) collected ($11.46)
Seat 3: Serge Claws (big blind) folded on the River
Seat 4: DutchShultzs folded before Flop (didn't bet)
Seat 5: seula i folded before Flop (didn't bet)
Seat 6: chiyuki folded before Flop (didn't bet)
Seat 7: romanian c4 folded before Flop (didn't bet)
Seat 8: ShaninPeter folded before Flop (didn't bet)
Seat 9: DrunkTyphoon folded before Flop (didn't bet)



PokerStars Zoom Hand #84300652524:  Hold'em No Limit ($0.10/$0.25) - 2012/08/05 15:42:18 JST [2012/08/05 2:42:18 ET]
Table 'Whirlpool' 9-max Seat #1 is the button
Seat 1: nice.franki ($12.25 in chips) 
Seat 2: banderas761 ($22.20 in chips) 
Seat 3: Ozboy80 ($27.74 in chips) 
Seat 4: masterkoolb ($12.91 in chips) 
Seat 5: DrunkTyphoon ($25 in chips) 
Seat 6: svg51 ($6.37 in chips) 
Seat 7: phate-1up ($69.10 in chips) 
Seat 8: chiyuki ($47.01 in chips) 
Seat 9: Grishukps ($12.50 in chips) 
banderas761: posts small blind $0.10
Ozboy80: posts big blind $0.25
*** HOLE CARDS ***
Dealt to chiyuki [7d Js]
masterkoolb: folds 
DrunkTyphoon: folds 
svg51: folds 
phate-1up: folds 
chiyuki: folds 
Grishukps: folds 
nice.franki has timed out
nice.franki: folds 
banderas761: folds 
Uncalled bet ($0.15) returned to Ozboy80
Ozboy80 collected $0.20 from pot
Ozboy80: doesn't show hand 
*** SUMMARY ***
Total pot $0.20 | Rake $0 
Seat 1: nice.franki (button) folded before Flop (didn't bet)
Seat 2: banderas761 (small blind) folded before Flop
Seat 3: Ozboy80 (big blind) collected ($0.20)
Seat 4: masterkoolb folded before Flop (didn't bet)
Seat 5: DrunkTyphoon folded before Flop (didn't bet)
Seat 6: svg51 folded before Flop (didn't bet)
Seat 7: phate-1up folded before Flop (didn't bet)
Seat 8: chiyuki folded before Flop (didn't bet)
Seat 9: Grishukps folded before Flop (didn't bet)



PokerStars Zoom Hand #84300655584:  Hold'em No Limit ($0.10/$0.25) - 2012/08/05 15:42:30 JST [2012/08/05 2:42:30 ET]
Table 'Whirlpool' 9-max Seat #1 is the button
Seat 1: kwkim73 ($25 in chips) 
Seat 2: NuMetal88 ($33.50 in chips) 
Seat 3: DrunkTyphoon ($25 in chips) 
Seat 4: 1Karina1 ($36.42 in chips) 
Seat 5: phate-1up ($57.70 in chips) 
Seat 6: chiyuki ($47.01 in chips) 
Seat 7: Silveystryk ($37.45 in chips) 
Seat 8: ViTiV2010 ($13.17 in chips) 
Seat 9: nastya040 ($8.18 in chips) 
NuMetal88: posts small blind $0.10
DrunkTyphoon: posts big blind $0.25
*** HOLE CARDS ***
Dealt to chiyuki [Js Qc]
1Karina1: folds 
phate-1up has timed out
phate-1up: folds 
chiyuki: folds 
Silveystryk: folds 
ViTiV2010: folds 
nastya040: folds 
kwkim73: folds 
NuMetal88: folds 
Uncalled bet ($0.15) returned to DrunkTyphoon
DrunkTyphoon collected $0.20 from pot
DrunkTyphoon: doesn't show hand 
*** SUMMARY ***
Total pot $0.20 | Rake $0 
Seat 1: kwkim73 (button) folded before Flop (didn't bet)
Seat 2: NuMetal88 (small blind) folded before Flop
Seat 3: DrunkTyphoon (big blind) collected ($0.20)
Seat 4: 1Karina1 folded before Flop (didn't bet)
Seat 5: phate-1up folded before Flop (didn't bet)
Seat 6: chiyuki folded before Flop (didn't bet)
Seat 7: Silveystryk folded before Flop (didn't bet)
Seat 8: ViTiV2010 folded before Flop (didn't bet)
Seat 9: nastya040 folded before Flop (didn't bet)



PokerStars Zoom Hand #84300645789:  Hold'em No Limit ($0.10/$0.25) - 2012/08/05 15:41:52 JST [2012/08/05 2:41:52 ET]
Table 'Whirlpool' 9-max Seat #1 is the button
Seat 1: KeLevro0 ($9.26 in chips) 
Seat 2: romanian c4 ($20.70 in chips) 
Seat 3: River_GmbH ($13.35 in chips) 
Seat 4: Limoilou ($34.07 in chips) 
Seat 5: chiyuki ($47.11 in chips) 
Seat 6: mjmichi ($40.19 in chips) 
Seat 7: moku36 ($37.32 in chips) 
Seat 8: DrunkTyphoon ($25 in chips) 
Seat 9: GSDP ($49.10 in chips) 
romanian c4: posts small blind $0.10
River_GmbH: posts big blind $0.25
*** HOLE CARDS ***
Dealt to chiyuki [Ad Ts]
Limoilou: folds 
chiyuki: folds 
mjmichi: raises $0.50 to $0.75
moku36: calls $0.75
DrunkTyphoon: folds 
GSDP: folds 
KeLevro0: folds 
romanian c4: folds 
River_GmbH: folds 
*** FLOP *** [As 2s 2d]
mjmichi: checks 
moku36: bets $0.75
mjmichi: raises $1.50 to $2.25
moku36: calls $1.50
*** TURN *** [As 2s 2d] [Qs]
mjmichi: checks 
moku36: checks 
*** RIVER *** [As 2s 2d Qs] [5h]
mjmichi: checks 
moku36: checks 
*** SHOW DOWN ***
mjmichi: shows [7c 7h] (two pair, Sevens and Deuces)
moku36: shows [Ah 3s] (two pair, Aces and Deuces)
moku36 collected $6.06 from pot
*** SUMMARY ***
Total pot $6.35 | Rake $0.29 
Board [As 2s 2d Qs 5h]
Seat 1: KeLevro0 (button) folded before Flop (didn't bet)
Seat 2: romanian c4 (small blind) folded before Flop
Seat 3: River_GmbH (big blind) folded before Flop
Seat 4: Limoilou folded before Flop (didn't bet)
Seat 5: chiyuki folded before Flop (didn't bet)
Seat 6: mjmichi showed [7c 7h] and lost with two pair, Sevens and Deuces
Seat 7: moku36 showed [Ah 3s] and won ($6.06) with two pair, Aces and Deuces
Seat 8: DrunkTyphoon folded before Flop (didn't bet)
Seat 9: GSDP folded before Flop (didn't bet)



PokerStars Zoom Hand #84300657637:  Hold'em No Limit ($0.10/$0.25) - 2012/08/05 15:42:38 JST [2012/08/05 2:42:38 ET]
Table 'Whirlpool' 9-max Seat #1 is the button
Seat 1: Limoilou ($33.72 in chips) 
Seat 2: Jene4kaBest ($10.09 in chips) 
Seat 3: chiyuki ($47.01 in chips) 
Seat 4: 1Karina1 ($31.68 in chips) 
Seat 5: hldtom ($12.60 in chips) 
Seat 6: INSP!RON ($37.54 in chips) 
Seat 7: ShaninPeter ($11.50 in chips) 
Seat 8: aivvo ($8.85 in chips) 
Seat 9: Saruotiss ($61.71 in chips) 
Jene4kaBest: posts small blind $0.10
chiyuki: posts big blind $0.25
*** HOLE CARDS ***
Dealt to chiyuki [Kh 5d]
1Karina1: folds 
hldtom: raises $0.50 to $0.75
INSP!RON: folds 
ShaninPeter: folds 
aivvo: folds 
Saruotiss: folds 
Limoilou: folds 
Jene4kaBest: folds 
chiyuki: folds 
Uncalled bet ($0.50) returned to hldtom
hldtom collected $0.60 from pot
hldtom: doesn't show hand 
*** SUMMARY ***
Total pot $0.60 | Rake $0 
Seat 1: Limoilou (button) folded before Flop (didn't bet)
Seat 2: Jene4kaBest (small blind) folded before Flop
Seat 3: chiyuki (big blind) folded before Flop
Seat 4: 1Karina1 folded before Flop (didn't bet)
Seat 5: hldtom collected ($0.60)
Seat 6: INSP!RON folded before Flop (didn't bet)
Seat 7: ShaninPeter folded before Flop (didn't bet)
Seat 8: aivvo folded before Flop (didn't bet)
Seat 9: Saruotiss folded before Flop (didn't bet)



PokerStars Zoom Hand #84300665145:  Hold'em No Limit ($0.10/$0.25) - 2012/08/05 15:43:09 JST [2012/08/05 2:43:09 ET]
Table 'Whirlpool' 9-max Seat #1 is the button
Seat 1: chiyuki ($46.76 in chips) 
Seat 2: hldtom ($12.95 in chips) 
Seat 3: yvasilik ($22.13 in chips) 
Seat 4: risekuku468 ($28.29 in chips) 
Seat 5: slapshot2011 ($9.59 in chips) 
Seat 6: jacquelinewu ($71.53 in chips) 
Seat 7: Perstenev ($8.06 in chips) 
Seat 8: DrunkTyphoon ($25 in chips) 
Seat 9: silvno31 ($66.19 in chips) 
hldtom: posts small blind $0.10
yvasilik: posts big blind $0.25
*** HOLE CARDS ***
Dealt to chiyuki [As 5h]
risekuku468: folds 
slapshot2011: folds 
jacquelinewu: folds 
Perstenev: folds 
DrunkTyphoon: folds 
silvno31: folds 
chiyuki: raises $0.50 to $0.75
hldtom: folds 
yvasilik: calls $0.50
*** FLOP *** [9h 2h 6h]
yvasilik: checks 
chiyuki: checks 
*** TURN *** [9h 2h 6h] [7s]
yvasilik: checks 
chiyuki: checks 
*** RIVER *** [9h 2h 6h 7s] [9s]
yvasilik: checks 
chiyuki: checks 
*** SHOW DOWN ***
yvasilik: shows [Ac 5d] (a pair of Nines)
chiyuki: shows [As 5h] (a pair of Nines)
yvasilik collected $0.77 from pot
chiyuki collected $0.76 from pot
*** SUMMARY ***
Total pot $1.60 | Rake $0.07 
Board [9h 2h 6h 7s 9s]
Seat 1: chiyuki (button) showed [As 5h] and won ($0.76) with a pair of Nines
Seat 2: hldtom (small blind) folded before Flop
Seat 3: yvasilik (big blind) showed [Ac 5d] and won ($0.77) with a pair of Nines
Seat 4: risekuku468 folded before Flop (didn't bet)
Seat 5: slapshot2011 folded before Flop (didn't bet)
Seat 6: jacquelinewu folded before Flop (didn't bet)
Seat 7: Perstenev folded before Flop (didn't bet)
Seat 8: DrunkTyphoon folded before Flop (didn't bet)
Seat 9: silvno31 folded before Flop (didn't bet)



PokerStars Zoom Hand #84300664428:  Hold'em No Limit ($0.10/$0.25) - 2012/08/05 15:43:06 JST [2012/08/05 2:43:06 ET]
Table 'Whirlpool' 9-max Seat #1 is the button
Seat 1: 4ydo yogurt ($27.27 in chips) 
Seat 2: Gichboy ($31.28 in chips) 
Seat 3: DutchShultzs ($36.49 in chips) 
Seat 4: nice.franki ($8.05 in chips) 
Seat 5: chiyuki ($46.76 in chips) 
Seat 6: Roglus ($18.76 in chips) 
Seat 7: KeLevro0 ($9.26 in chips) 
Seat 8: phate-1up ($45.34 in chips) 
Seat 9: masterkoolb ($14.01 in chips) 
Gichboy: posts small blind $0.10
DutchShultzs: posts big blind $0.25
*** HOLE CARDS ***
Dealt to chiyuki [5d 9d]
nice.franki: folds 
chiyuki: folds 
Roglus: folds 
KeLevro0: folds 
phate-1up: folds 
masterkoolb: folds 
4ydo yogurt: folds 
Gichboy: calls $0.15
DutchShultzs: checks 
*** FLOP *** [As Th Js]
Gichboy: checks 
DutchShultzs: bets $0.38
Gichboy: calls $0.38
*** TURN *** [As Th Js] [9c]
Gichboy: checks 
DutchShultzs: bets $0.90
Gichboy: calls $0.90
*** RIVER *** [As Th Js 9c] [8d]
Gichboy: checks 
DutchShultzs: checks 
*** SHOW DOWN ***
Gichboy: shows [8h Jh] (two pair, Jacks and Eights)
DutchShultzs: mucks hand 
Gichboy collected $2.92 from pot
*** SUMMARY ***
Total pot $3.06 | Rake $0.14 
Board [As Th Js 9c 8d]
Seat 1: 4ydo yogurt (button) folded before Flop (didn't bet)
Seat 2: Gichboy (small blind) showed [8h Jh] and won ($2.92) with two pair, Jacks and Eights
Seat 3: DutchShultzs (big blind) mucked [5c Ah]
Seat 4: nice.franki folded before Flop (didn't bet)
Seat 5: chiyuki folded before Flop (didn't bet)
Seat 6: Roglus folded before Flop (didn't bet)
Seat 7: KeLevro0 folded before Flop (didn't bet)
Seat 8: phate-1up folded before Flop (didn't bet)
Seat 9: masterkoolb folded before Flop (didn't bet)



PokerStars Zoom Hand #84300682267:  Hold'em No Limit ($0.10/$0.25) - 2012/08/05 15:44:17 JST [2012/08/05 2:44:17 ET]
Table 'Whirlpool' 9-max Seat #1 is the button
Seat 1: KeLevro0 ($12.15 in chips) 
Seat 2: seula i ($27.66 in chips) 
Seat 3: masterkoolb ($17.63 in chips) 
Seat 4: risekuku468 ($28.39 in chips) 
Seat 5: WARIBANA7777 ($15.49 in chips) 
Seat 6: rey2040 ($19.60 in chips) 
Seat 7: chiyuki ($46.67 in chips) 
Seat 8: 0 operator 0 ($32.67 in chips) 
Seat 9: aivvo ($8.98 in chips) 
seula i: posts small blind $0.10
masterkoolb: posts big blind $0.25
*** HOLE CARDS ***
Dealt to chiyuki [6h 8c]
risekuku468: folds 
WARIBANA7777: folds 
rey2040: folds 
chiyuki: folds 
0 operator 0: folds 
aivvo: folds 
KeLevro0: folds 
seula i: folds 
Uncalled bet ($0.15) returned to masterkoolb
masterkoolb collected $0.20 from pot
masterkoolb: doesn't show hand 
*** SUMMARY ***
Total pot $0.20 | Rake $0 
Seat 1: KeLevro0 (button) folded before Flop (didn't bet)
Seat 2: seula i (small blind) folded before Flop
Seat 3: masterkoolb (big blind) collected ($0.20)
Seat 4: risekuku468 folded before Flop (didn't bet)
Seat 5: WARIBANA7777 folded before Flop (didn't bet)
Seat 6: rey2040 folded before Flop (didn't bet)
Seat 7: chiyuki folded before Flop (didn't bet)
Seat 8: 0 operator 0 folded before Flop (didn't bet)
Seat 9: aivvo folded before Flop (didn't bet)



PokerStars Zoom Hand #84300676214:  Hold'em No Limit ($0.10/$0.25) - 2012/08/05 15:43:53 JST [2012/08/05 2:43:53 ET]
Table 'Whirlpool' 9-max Seat #1 is the button
Seat 1: snejokCoxx ($11.90 in chips) 
Seat 2: opie62 ($19.27 in chips) 
Seat 3: banderas761 ($21.75 in chips) 
Seat 4: DutchShultzs ($25 in chips) 
Seat 5: Perstenev ($7.81 in chips) 
Seat 6: phate-1up ($58.37 in chips) 
Seat 7: chiyuki ($46.77 in chips) 
Seat 8: risekuku468 ($28.39 in chips) 
Seat 9: Kasperlmusik ($25 in chips) 
opie62: posts small blind $0.10
banderas761: posts big blind $0.25
*** HOLE CARDS ***
Dealt to chiyuki [Ac 5c]
DutchShultzs: folds 
Perstenev: folds 
phate-1up: folds 
chiyuki: folds 
risekuku468: folds 
Kasperlmusik: folds 
snejokCoxx: folds 
opie62: raises $0.25 to $0.50
banderas761: calls $0.25
*** FLOP *** [Jc 2s 5d]
opie62: bets $0.50
banderas761: folds 
Uncalled bet ($0.50) returned to opie62
opie62 collected $0.96 from pot
opie62: doesn't show hand 
*** SUMMARY ***
Total pot $1 | Rake $0.04 
Board [Jc 2s 5d]
Seat 1: snejokCoxx (button) folded before Flop (didn't bet)
Seat 2: opie62 (small blind) collected ($0.96)
Seat 3: banderas761 (big blind) folded on the Flop
Seat 4: DutchShultzs folded before Flop (didn't bet)
Seat 5: Perstenev folded before Flop (didn't bet)
Seat 6: phate-1up folded before Flop (didn't bet)
Seat 7: chiyuki folded before Flop (didn't bet)
Seat 8: risekuku468 folded before Flop (didn't bet)
Seat 9: Kasperlmusik folded before Flop (didn't bet)



PokerStars Zoom Hand #84300680008:  Hold'em No Limit ($0.10/$0.25) - 2012/08/05 15:44:08 JST [2012/08/05 2:44:08 ET]
Table 'Whirlpool' 9-max Seat #1 is the button
Seat 1: 1Karina1 ($33.44 in chips) 
Seat 2: chiyuki ($46.77 in chips) 
Seat 3: nice.franki ($7.95 in chips) 
Seat 4: PPP7SSS ($23.33 in chips) 
Seat 5: kwkim73 ($27.14 in chips) 
Seat 6: Perstenev ($8.88 in chips) 
Seat 7: snejokCoxx ($12.50 in chips) 
Seat 8: Alvinpe85 ($56.39 in chips) 
Seat 9: laurentzu84 ($37.60 in chips) 
chiyuki: posts small blind $0.10
nice.franki: posts big blind $0.25
*** HOLE CARDS ***
Dealt to chiyuki [Kd 2d]
PPP7SSS: raises $0.50 to $0.75
kwkim73: folds 
Perstenev: folds 
snejokCoxx: folds 
Alvinpe85: folds 
laurentzu84: calls $0.75
1Karina1: folds 
chiyuki: folds 
nice.franki: folds 
*** FLOP *** [5c Tc Qc]
PPP7SSS: bets $0.75
laurentzu84: raises $1.25 to $2
PPP7SSS: calls $1.25
*** TURN *** [5c Tc Qc] [7s]
PPP7SSS: bets $0.75
laurentzu84: raises $3.50 to $4.25
PPP7SSS: folds 
Uncalled bet ($3.50) returned to laurentzu84
laurentzu84 collected $7.02 from pot
laurentzu84: doesn't show hand 
*** SUMMARY ***
Total pot $7.35 | Rake $0.33 
Board [5c Tc Qc 7s]
Seat 1: 1Karina1 (button) folded before Flop (didn't bet)
Seat 2: chiyuki (small blind) folded before Flop
Seat 3: nice.franki (big blind) folded before Flop
Seat 4: PPP7SSS folded on the Turn
Seat 5: kwkim73 folded before Flop (didn't bet)
Seat 6: Perstenev folded before Flop (didn't bet)
Seat 7: snejokCoxx folded before Flop (didn't bet)
Seat 8: Alvinpe85 folded before Flop (didn't bet)
Seat 9: laurentzu84 collected ($7.02)



PokerStars Zoom Hand #84300677946:  Hold'em No Limit ($0.10/$0.25) - 2012/08/05 15:44:00 JST [2012/08/05 2:44:00 ET]
Table 'Whirlpool' 9-max Seat #1 is the button
Seat 1: laurentzu84 ($37.60 in chips) 
Seat 2: AntoineHunt ($41.69 in chips) 
Seat 3: Rici47 ($29.54 in chips) 
Seat 4: phate-1up ($42.39 in chips) 
Seat 5: nice.franki ($12.15 in chips) 
Seat 6: KeLevro0 ($8.63 in chips) 
Seat 7: jacquelinewu ($28.96 in chips) 
Seat 8: Serge Claws ($26.72 in chips) 
Seat 9: chiyuki ($46.77 in chips) 
AntoineHunt: posts small blind $0.10
Rici47: posts big blind $0.25
*** HOLE CARDS ***
Dealt to chiyuki [2d 7c]
phate-1up: folds 
nice.franki: folds 
KeLevro0: folds 
jacquelinewu: folds 
Serge Claws: folds 
chiyuki: folds 
laurentzu84: folds 
AntoineHunt: raises $0.50 to $0.75
Rici47: calls $0.50
*** FLOP *** [Js Kd 9d]
AntoineHunt: checks 
Rici47: checks 
*** TURN *** [Js Kd 9d] [Jd]
AntoineHunt: checks 
Rici47: bets $2
AntoineHunt: folds 
Uncalled bet ($2) returned to Rici47
Rici47 collected $1.43 from pot
Rici47: doesn't show hand 
*** SUMMARY ***
Total pot $1.50 | Rake $0.07 
Board [Js Kd 9d Jd]
Seat 1: laurentzu84 (button) folded before Flop (didn't bet)
Seat 2: AntoineHunt (small blind) folded on the Turn
Seat 3: Rici47 (big blind) collected ($1.43)
Seat 4: phate-1up folded before Flop (didn't bet)
Seat 5: nice.franki folded before Flop (didn't bet)
Seat 6: KeLevro0 folded before Flop (didn't bet)
Seat 7: jacquelinewu folded before Flop (didn't bet)
Seat 8: Serge Claws folded before Flop (didn't bet)
Seat 9: chiyuki folded before Flop (didn't bet)



PokerStars Zoom Hand #84300677189:  Hold'em No Limit ($0.10/$0.25) - 2012/08/05 15:43:57 JST [2012/08/05 2:43:57 ET]
Table 'Whirlpool' 9-max Seat #1 is the button
Seat 1: panaam ($28.03 in chips) 
Seat 2: fil740 ($13.83 in chips) 
Seat 3: KeLevro0 ($9.16 in chips) 
Seat 4: chiyuki ($46.77 in chips) 
Seat 5: DutchShultzs ($27.23 in chips) 
Seat 6: 1Karina1 ($37.49 in chips) 
Seat 7: Faantomace ($32.48 in chips) 
Seat 8: nice.franki ($7.95 in chips) 
Seat 9: Fructionar ($32.76 in chips) 
fil740: posts small blind $0.10
KeLevro0: posts big blind $0.25
*** HOLE CARDS ***
Dealt to chiyuki [3c 5d]
chiyuki: folds 
DutchShultzs: folds 
1Karina1: folds 
Faantomace: folds 
nice.franki: folds 
Fructionar: calls $0.25
panaam: folds 
fil740: raises $0.50 to $0.75
KeLevro0: raises $1.75 to $2.50
Fructionar: folds 
fil740: calls $1.75
*** FLOP *** [Td Ad 8d]
fil740: checks 
KeLevro0: bets $2.50
fil740: calls $2.50
*** TURN *** [Td Ad 8d] [As]
fil740: bets $6.75
KeLevro0: calls $4.16 and is all-in
Uncalled bet ($2.59) returned to fil740
*** RIVER *** [Td Ad 8d As] [2c]
*** SHOW DOWN ***
fil740: shows [Jh Jc] (two pair, Aces and Jacks)
KeLevro0: shows [Ks Kh] (two pair, Aces and Kings)
KeLevro0 collected $17.73 from pot
*** SUMMARY ***
Total pot $18.57 | Rake $0.84 
Board [Td Ad 8d As 2c]
Seat 1: panaam (button) folded before Flop (didn't bet)
Seat 2: fil740 (small blind) showed [Jh Jc] and lost with two pair, Aces and Jacks
Seat 3: KeLevro0 (big blind) showed [Ks Kh] and won ($17.73) with two pair, Aces and Kings
Seat 4: chiyuki folded before Flop (didn't bet)
Seat 5: DutchShultzs folded before Flop (didn't bet)
Seat 6: 1Karina1 folded before Flop (didn't bet)
Seat 7: Faantomace folded before Flop (didn't bet)
Seat 8: nice.franki folded before Flop (didn't bet)
Seat 9: Fructionar folded before Flop



PokerStars Zoom Hand #84300681018:  Hold'em No Limit ($0.10/$0.25) - 2012/08/05 15:44:12 JST [2012/08/05 2:44:12 ET]
Table 'Whirlpool' 9-max Seat #1 is the button
Seat 1: DutchShultzs ($34.96 in chips) 
Seat 2: KeLevro0 ($12.25 in chips) 
Seat 3: jacquelinewu ($71.53 in chips) 
Seat 4: seula i ($27.66 in chips) 
Seat 5: risekuku468 ($28.39 in chips) 
Seat 6: 1Karina1 ($33.44 in chips) 
Seat 7: phate-1up ($58.72 in chips) 
Seat 8: chiyuki ($46.67 in chips) 
Seat 9: INSP!RON ($38.56 in chips) 
KeLevro0: posts small blind $0.10
jacquelinewu: posts big blind $0.25
*** HOLE CARDS ***
Dealt to chiyuki [2h Tc]
seula i: folds 
risekuku468: folds 
1Karina1: calls $0.25
phate-1up: folds 
chiyuki: folds 
INSP!RON: folds 
DutchShultzs: folds 
KeLevro0: folds 
jacquelinewu: checks 
*** FLOP *** [3c 6c 9s]
jacquelinewu: bets $0.50
1Karina1: raises $1 to $1.50
jacquelinewu: folds 
Uncalled bet ($1) returned to 1Karina1
1Karina1 collected $1.53 from pot
1Karina1: doesn't show hand 
*** SUMMARY ***
Total pot $1.60 | Rake $0.07 
Board [3c 6c 9s]
Seat 1: DutchShultzs (button) folded before Flop (didn't bet)
Seat 2: KeLevro0 (small blind) folded before Flop
Seat 3: jacquelinewu (big blind) folded on the Flop
Seat 4: seula i folded before Flop (didn't bet)
Seat 5: risekuku468 folded before Flop (didn't bet)
Seat 6: 1Karina1 collected ($1.53)
Seat 7: phate-1up folded before Flop (didn't bet)
Seat 8: chiyuki folded before Flop (didn't bet)
Seat 9: INSP!RON folded before Flop (didn't bet)



PokerStars Zoom Hand #84300684634:  Hold'em No Limit ($0.10/$0.25) - 2012/08/05 15:44:26 JST [2012/08/05 2:44:26 ET]
Table 'Whirlpool' 9-max Seat #1 is the button
Seat 1: Jene4kaBest ($11.89 in chips) 
Seat 2: kesstukas25 ($22.54 in chips) 
Seat 3: chiyuki ($46.67 in chips) 
Seat 4: kwkim73 ($28.06 in chips) 
Seat 5: rey2040 ($19.60 in chips) 
Seat 6: snejokCoxx ($13.25 in chips) 
Seat 7: God)Squall ($31.85 in chips) 
Seat 8: ZhukOFFskI ($39.41 in chips) 
Seat 9: Ozboy80 ($26.34 in chips) 
kesstukas25: posts small blind $0.10
chiyuki: posts big blind $0.25
*** HOLE CARDS ***
Dealt to chiyuki [7c 7d]
kwkim73: folds 
rey2040: folds 
snejokCoxx: folds 
God)Squall: raises $0.50 to $0.75
ZhukOFFskI: folds 
Ozboy80: folds 
Jene4kaBest: folds 
kesstukas25: folds 
chiyuki: calls $0.50
*** FLOP *** [Qd Ac 7h]
chiyuki: checks 
God)Squall: bets $0.75
chiyuki: raises $1.25 to $2
God)Squall: calls $1.25
*** TURN *** [Qd Ac 7h] [5d]
chiyuki: bets $4
God)Squall: calls $4
*** RIVER *** [Qd Ac 7h 5d] [9d]
chiyuki: bets $8
God)Squall: folds 
Uncalled bet ($8) returned to chiyuki
chiyuki collected $12.99 from pot
chiyuki: doesn't show hand 
*** SUMMARY ***
Total pot $13.60 | Rake $0.61 
Board [Qd Ac 7h 5d 9d]
Seat 1: Jene4kaBest (button) folded before Flop (didn't bet)
Seat 2: kesstukas25 (small blind) folded before Flop
Seat 3: chiyuki (big blind) collected ($12.99)
Seat 4: kwkim73 folded before Flop (didn't bet)
Seat 5: rey2040 folded before Flop (didn't bet)
Seat 6: snejokCoxx folded before Flop (didn't bet)
Seat 7: God)Squall folded on the River
Seat 8: ZhukOFFskI folded before Flop (didn't bet)
Seat 9: Ozboy80 folded before Flop (didn't bet)



PokerStars Zoom Hand #84300699329:  Hold'em No Limit ($0.10/$0.25) - 2012/08/05 15:45:24 JST [2012/08/05 2:45:24 ET]
Table 'Whirlpool' 9-max Seat #1 is the button
Seat 1: jacquelinewu ($25.98 in chips) 
Seat 2: masterkoolb ($18.84 in chips) 
Seat 3: panaam ($21.94 in chips) 
Seat 4: AntoineHunt ($40.94 in chips) 
Seat 5: chiyuki ($52.91 in chips) 
Seat 6: nice.franki ($7.35 in chips) 
Seat 7: snejokCoxx ($11.90 in chips) 
Seat 8: ViTiV2010 ($12.82 in chips) 
Seat 9: River_GmbH ($13.20 in chips) 
masterkoolb: posts small blind $0.10
panaam: posts big blind $0.25
*** HOLE CARDS ***
Dealt to chiyuki [2d Td]
AntoineHunt: folds 
chiyuki: folds 
nice.franki: folds 
snejokCoxx: folds 
ViTiV2010: folds 
River_GmbH: folds 
jacquelinewu: raises $0.50 to $0.75
masterkoolb: folds 
panaam: folds 
Uncalled bet ($0.50) returned to jacquelinewu
jacquelinewu collected $0.60 from pot
jacquelinewu: doesn't show hand 
*** SUMMARY ***
Total pot $0.60 | Rake $0 
Seat 1: jacquelinewu (button) collected ($0.60)
Seat 2: masterkoolb (small blind) folded before Flop
Seat 3: panaam (big blind) folded before Flop
Seat 4: AntoineHunt folded before Flop (didn't bet)
Seat 5: chiyuki folded before Flop (didn't bet)
Seat 6: nice.franki folded before Flop (didn't bet)
Seat 7: snejokCoxx folded before Flop (didn't bet)
Seat 8: ViTiV2010 folded before Flop (didn't bet)
Seat 9: River_GmbH folded before Flop (didn't bet)



PokerStars Zoom Hand #84300700871:  Hold'em No Limit ($0.10/$0.25) - 2012/08/05 15:45:30 JST [2012/08/05 2:45:30 ET]
Table 'Whirlpool' 9-max Seat #1 is the button
Seat 1: chiyuki ($52.91 in chips) 
Seat 2: Spheroff ($19.62 in chips) 
Seat 3: Alvinpe85 ($49.03 in chips) 
Seat 4: PPP7SSS ($19.48 in chips) 
Seat 5: Grishukps ($12.50 in chips) 
Seat 6: pawn909 ($12.10 in chips) 
Seat 7: Roglus ($6.44 in chips) 
Seat 8: KeLevro0 ($8.71 in chips) 
Seat 9: nice.franki ($11.05 in chips) 
Spheroff: posts small blind $0.10
Alvinpe85: posts big blind $0.25
*** HOLE CARDS ***
Dealt to chiyuki [5s Ts]
PPP7SSS: raises $0.50 to $0.75
Grishukps: folds 
pawn909: folds 
Roglus: folds 
KeLevro0: folds 
nice.franki: folds 
chiyuki: folds 
Spheroff: folds 
Alvinpe85: folds 
Uncalled bet ($0.50) returned to PPP7SSS
PPP7SSS collected $0.60 from pot
PPP7SSS: doesn't show hand 
*** SUMMARY ***
Total pot $0.60 | Rake $0 
Seat 1: chiyuki (button) folded before Flop (didn't bet)
Seat 2: Spheroff (small blind) folded before Flop
Seat 3: Alvinpe85 (big blind) folded before Flop
Seat 4: PPP7SSS collected ($0.60)
Seat 5: Grishukps folded before Flop (didn't bet)
Seat 6: pawn909 folded before Flop (didn't bet)
Seat 7: Roglus folded before Flop (didn't bet)
Seat 8: KeLevro0 folded before Flop (didn't bet)
Seat 9: nice.franki folded before Flop (didn't bet)



PokerStars Zoom Hand #84300702662:  Hold'em No Limit ($0.10/$0.25) - 2012/08/05 15:45:37 JST [2012/08/05 2:45:37 ET]
Table 'Whirlpool' 9-max Seat #1 is the button
Seat 1: Serge Claws ($31.08 in chips) 
Seat 2: Grishukps ($13.10 in chips) 
Seat 3: seula i ($26.56 in chips) 
Seat 4: chiyuki ($52.81 in chips) 
Seat 5: mjmichi ($37.19 in chips) 
Seat 6: Roglus ($6.44 in chips) 
Seat 7: Perstenev ($13 in chips) 
Seat 8: romanian c4 ($20.32 in chips) 
Seat 9: masterkoolb ($18.74 in chips) 
Grishukps: posts small blind $0.10
seula i: posts big blind $0.25
*** HOLE CARDS ***
Dealt to chiyuki [Ts 7s]
chiyuki: folds 
mjmichi: folds 
Roglus: folds 
Perstenev: folds 
romanian c4: folds 
masterkoolb: folds 
Serge Claws: folds 
Grishukps: folds 
Uncalled bet ($0.15) returned to seula i
seula i collected $0.20 from pot
seula i: doesn't show hand 
*** SUMMARY ***
Total pot $0.20 | Rake $0 
Seat 1: Serge Claws (button) folded before Flop (didn't bet)
Seat 2: Grishukps (small blind) folded before Flop
Seat 3: seula i (big blind) collected ($0.20)
Seat 4: chiyuki folded before Flop (didn't bet)
Seat 5: mjmichi folded before Flop (didn't bet)
Seat 6: Roglus folded before Flop (didn't bet)
Seat 7: Perstenev folded before Flop (didn't bet)
Seat 8: romanian c4 folded before Flop (didn't bet)
Seat 9: masterkoolb folded before Flop (didn't bet)



PokerStars Zoom Hand #84300698323:  Hold'em No Limit ($0.10/$0.25) - 2012/08/05 15:45:20 JST [2012/08/05 2:45:20 ET]
Table 'Whirlpool' 9-max Seat #1 is the button
Seat 1: jvds114 ($28.42 in chips) 
Seat 2: leo2095 ($30.18 in chips) 
Seat 3: slapshot2011 ($4.24 in chips) 
Seat 4: AntoineHunt ($40.94 in chips) 
Seat 5: ZhukOFFskI ($66.52 in chips) 
Seat 6: chiyuki ($52.91 in chips) 
Seat 7: Saruotiss ($63.87 in chips) 
Seat 8: kwkim73 ($25 in chips) 
Seat 9: fwnaf ($14.10 in chips) 
leo2095: posts small blind $0.10
slapshot2011: posts big blind $0.25
*** HOLE CARDS ***
Dealt to chiyuki [3h 4h]
AntoineHunt: folds 
ZhukOFFskI: folds 
chiyuki: folds 
Saruotiss: folds 
kwkim73: raises $0.50 to $0.75
fwnaf: folds 
jvds114: raises $1.25 to $2
leo2095: folds 
slapshot2011: raises $2.24 to $4.24 and is all-in
kwkim73: folds 
jvds114: calls $2.24
*** FLOP *** [5c Kd 4d]
*** TURN *** [5c Kd 4d] [9c]
*** RIVER *** [5c Kd 4d 9c] [Qd]
*** SHOW DOWN ***
slapshot2011: shows [9d 9h] (three of a kind, Nines)
jvds114: shows [Jc Ad] (high card Ace)
slapshot2011 collected $8.91 from pot
*** SUMMARY ***
Total pot $9.33 | Rake $0.42 
Board [5c Kd 4d 9c Qd]
Seat 1: jvds114 (button) showed [Jc Ad] and lost with high card Ace
Seat 2: leo2095 (small blind) folded before Flop
Seat 3: slapshot2011 (big blind) showed [9d 9h] and won ($8.91) with three of a kind, Nines
Seat 4: AntoineHunt folded before Flop (didn't bet)
Seat 5: ZhukOFFskI folded before Flop (didn't bet)
Seat 6: chiyuki folded before Flop (didn't bet)
Seat 7: Saruotiss folded before Flop (didn't bet)
Seat 8: kwkim73 folded before Flop
Seat 9: fwnaf folded before Flop (didn't bet)



PokerStars Zoom Hand #84300704697:  Hold'em No Limit ($0.10/$0.25) - 2012/08/05 15:45:45 JST [2012/08/05 2:45:45 ET]
Table 'Whirlpool' 9-max Seat #1 is the button
Seat 1: Limoilou ($31.32 in chips) 
Seat 2: nice.franki ($7.35 in chips) 
Seat 3: KeLevro0 ($8.63 in chips) 
Seat 4: romanian c4 ($20.32 in chips) 
Seat 5: Serge Claws ($31.08 in chips) 
Seat 6: ChrisCDee ($38.72 in chips) 
Seat 7: masterkoolb ($18.74 in chips) 
Seat 8: Grishukps ($13 in chips) 
Seat 9: chiyuki ($52.81 in chips) 
nice.franki: posts small blind $0.10
KeLevro0: posts big blind $0.25
*** HOLE CARDS ***
Dealt to chiyuki [3s Qh]
romanian c4: folds 
Serge Claws: raises $0.50 to $0.75
ChrisCDee: folds 
masterkoolb: folds 
Grishukps: folds 
chiyuki: folds 
Limoilou: folds 
nice.franki: folds 
KeLevro0: folds 
Uncalled bet ($0.50) returned to Serge Claws
Serge Claws collected $0.60 from pot
Serge Claws: doesn't show hand 
*** SUMMARY ***
Total pot $0.60 | Rake $0 
Seat 1: Limoilou (button) folded before Flop (didn't bet)
Seat 2: nice.franki (small blind) folded before Flop
Seat 3: KeLevro0 (big blind) folded before Flop
Seat 4: romanian c4 folded before Flop (didn't bet)
Seat 5: Serge Claws collected ($0.60)
Seat 6: ChrisCDee folded before Flop (didn't bet)
Seat 7: masterkoolb folded before Flop (didn't bet)
Seat 8: Grishukps folded before Flop (didn't bet)
Seat 9: chiyuki folded before Flop (didn't bet)



PokerStars Zoom Hand #84300705511:  Hold'em No Limit ($0.10/$0.25) - 2012/08/05 15:45:48 JST [2012/08/05 2:45:48 ET]
Table 'Whirlpool' 9-max Seat #1 is the button
Seat 1: Kasperlmusik ($25 in chips) 
Seat 2: TorTrade ($26.14 in chips) 
Seat 3: Rilko1975 ($25 in chips) 
Seat 4: AntoineHunt ($40.69 in chips) 
Seat 5: hldtom ($13.86 in chips) 
Seat 6: chiyuki ($52.81 in chips) 
Seat 7: pandaaaaaa ($22.85 in chips) 
Seat 8: KrystalAA ($42.02 in chips) 
Seat 9: kesstukas25 ($22.44 in chips) 
TorTrade: posts small blind $0.10
Rilko1975: posts big blind $0.25
*** HOLE CARDS ***
Dealt to chiyuki [4h Qs]
AntoineHunt: folds 
hldtom: folds 
chiyuki: folds 
pandaaaaaa: folds 
KrystalAA: folds 
kesstukas25: folds 
Kasperlmusik: raises $0.50 to $0.75
TorTrade: folds 
Rilko1975: folds 
Uncalled bet ($0.50) returned to Kasperlmusik
Kasperlmusik collected $0.60 from pot
Kasperlmusik: doesn't show hand 
*** SUMMARY ***
Total pot $0.60 | Rake $0 
Seat 1: Kasperlmusik (button) collected ($0.60)
Seat 2: TorTrade (small blind) folded before Flop
Seat 3: Rilko1975 (big blind) folded before Flop
Seat 4: AntoineHunt folded before Flop (didn't bet)
Seat 5: hldtom folded before Flop (didn't bet)
Seat 6: chiyuki folded before Flop (didn't bet)
Seat 7: pandaaaaaa folded before Flop (didn't bet)
Seat 8: KrystalAA folded before Flop (didn't bet)
Seat 9: kesstukas25 folded before Flop (didn't bet)



PokerStars Zoom Hand #84300706617:  Hold'em No Limit ($0.10/$0.25) - 2012/08/05 15:45:52 JST [2012/08/05 2:45:52 ET]
Table 'Whirlpool' 9-max Seat #1 is the button
Seat 1: jacquelinewu ($32.29 in chips) 
Seat 2: drunk_bender ($18.96 in chips) 
Seat 3: chiyuki ($52.81 in chips) 
Seat 4: Ellen1947 ($22.60 in chips) 
Seat 5: leo2095 ($30.08 in chips) 
Seat 6: kesstukas25 ($22.44 in chips) 
Seat 7: KeLevro0 ($8.71 in chips) 
Seat 8: pawn909 ($12.10 in chips) 
Seat 9: Nerkit ($12.50 in chips) 
drunk_bender: posts small blind $0.10
chiyuki: posts big blind $0.25
*** HOLE CARDS ***
Dealt to chiyuki [9s 6c]
Ellen1947: folds 
leo2095: folds 
kesstukas25: folds 
KeLevro0: folds 
pawn909: folds 
Nerkit: folds 
jacquelinewu: raises $0.50 to $0.75
drunk_bender: folds 
chiyuki: folds 
Uncalled bet ($0.50) returned to jacquelinewu
jacquelinewu collected $0.60 from pot
jacquelinewu: doesn't show hand 
*** SUMMARY ***
Total pot $0.60 | Rake $0 
Seat 1: jacquelinewu (button) collected ($0.60)
Seat 2: drunk_bender (small blind) folded before Flop
Seat 3: chiyuki (big blind) folded before Flop
Seat 4: Ellen1947 folded before Flop (didn't bet)
Seat 5: leo2095 folded before Flop (didn't bet)
Seat 6: kesstukas25 folded before Flop (didn't bet)
Seat 7: KeLevro0 folded before Flop (didn't bet)
Seat 8: pawn909 folded before Flop (didn't bet)
Seat 9: Nerkit folded before Flop (didn't bet)



PokerStars Zoom Hand #84300711520:  Hold'em No Limit ($0.10/$0.25) - 2012/08/05 15:46:11 JST [2012/08/05 2:46:11 ET]
Table 'Whirlpool' 9-max Seat #1 is the button
Seat 1: Gichboy ($31.52 in chips) 
Seat 2: DrunkTyphoon ($30.85 in chips) 
Seat 3: Limoilou ($31.22 in chips) 
Seat 4: snejokCoxx ($13.25 in chips) 
Seat 5: chiyuki ($52.56 in chips) 
Seat 6: Perstenev ($13 in chips) 
Seat 7: 4plankton ($22.43 in chips) 
Seat 8: phate-1up ($57.97 in chips) 
Seat 9: herkko11 ($6.18 in chips) 
DrunkTyphoon: posts small blind $0.10
Limoilou: posts big blind $0.25
*** HOLE CARDS ***
Dealt to chiyuki [2h 3s]
snejokCoxx: folds 
chiyuki: folds 
Perstenev: folds 
4plankton: folds 
phate-1up: folds 
herkko11: folds 
Gichboy: raises $0.25 to $0.50
DrunkTyphoon: folds 
Limoilou: folds 
Uncalled bet ($0.25) returned to Gichboy
Gichboy collected $0.60 from pot
Gichboy: doesn't show hand 
*** SUMMARY ***
Total pot $0.60 | Rake $0 
Seat 1: Gichboy (button) collected ($0.60)
Seat 2: DrunkTyphoon (small blind) folded before Flop
Seat 3: Limoilou (big blind) folded before Flop
Seat 4: snejokCoxx folded before Flop (didn't bet)
Seat 5: chiyuki folded before Flop (didn't bet)
Seat 6: Perstenev folded before Flop (didn't bet)
Seat 7: 4plankton folded before Flop (didn't bet)
Seat 8: phate-1up folded before Flop (didn't bet)
Seat 9: herkko11 folded before Flop (didn't bet)



PokerStars Zoom Hand #84300710720:  Hold'em No Limit ($0.10/$0.25) - 2012/08/05 15:46:08 JST [2012/08/05 2:46:08 ET]
Table 'Whirlpool' 9-max Seat #1 is the button
Seat 1: TorTrade ($26.04 in chips) 
Seat 2: GovGus ($29.10 in chips) 
Seat 3: Serge Claws ($31.43 in chips) 
Seat 4: Nerkit ($12.50 in chips) 
Seat 5: INSP!RON ($40.94 in chips) 
Seat 6: kkbruins0408 ($21.20 in chips) 
Seat 7: 1Karina1 ($40.64 in chips) 
Seat 8: chiyuki ($52.56 in chips) 
Seat 9: masterkoolb ($18.74 in chips) 
GovGus: posts small blind $0.10
Serge Claws: posts big blind $0.25
*** HOLE CARDS ***
Dealt to chiyuki [Ah 2h]
Nerkit: folds 
INSP!RON: folds 
kkbruins0408: folds 
1Karina1: folds 
chiyuki: folds 
masterkoolb: folds 
TorTrade: folds 
GovGus: raises $0.50 to $0.75
Serge Claws: folds 
Uncalled bet ($0.50) returned to GovGus
GovGus collected $0.50 from pot
GovGus: doesn't show hand 
*** SUMMARY ***
Total pot $0.50 | Rake $0 
Seat 1: TorTrade (button) folded before Flop (didn't bet)
Seat 2: GovGus (small blind) collected ($0.50)
Seat 3: Serge Claws (big blind) folded before Flop
Seat 4: Nerkit folded before Flop (didn't bet)
Seat 5: INSP!RON folded before Flop (didn't bet)
Seat 6: kkbruins0408 folded before Flop (didn't bet)
Seat 7: 1Karina1 folded before Flop (didn't bet)
Seat 8: chiyuki folded before Flop (didn't bet)
Seat 9: masterkoolb folded before Flop (didn't bet)



PokerStars Zoom Hand #84300701872:  Hold'em No Limit ($0.10/$0.25) - 2012/08/05 15:45:34 JST [2012/08/05 2:45:34 ET]
Table 'Whirlpool' 9-max Seat #1 is the button
Seat 1: snejokCoxx ($11.90 in chips) 
Seat 2: chiyuki ($52.91 in chips) 
Seat 3: Dejacob ($25.79 in chips) 
Seat 4: Serge Claws ($31.08 in chips) 
Seat 5: hldtom ($12.50 in chips) 
Seat 6: ViTiV2010 ($12.82 in chips) 
Seat 7: Grishukps ($12.85 in chips) 
Seat 8: INSP!RON ($39.57 in chips) 
Seat 9: 0 operator 0 ($33.47 in chips) 
chiyuki: posts small blind $0.10
Dejacob: posts big blind $0.25
*** HOLE CARDS ***
Dealt to chiyuki [Js 6h]
Serge Claws: folds 
hldtom: folds 
ViTiV2010: folds 
Grishukps: folds 
INSP!RON: folds 
0 operator 0: folds 
snejokCoxx: raises $0.40 to $0.65
chiyuki: folds 
Dejacob: calls $0.40
*** FLOP *** [Qs Ts 8s]
Dejacob: checks 
snejokCoxx: checks 
*** TURN *** [Qs Ts 8s] [9c]
Dejacob: checks 
snejokCoxx: bets $1
Dejacob: folds 
Uncalled bet ($1) returned to snejokCoxx
snejokCoxx collected $1.34 from pot
snejokCoxx: doesn't show hand 
*** SUMMARY ***
Total pot $1.40 | Rake $0.06 
Board [Qs Ts 8s 9c]
Seat 1: snejokCoxx (button) collected ($1.34)
Seat 2: chiyuki (small blind) folded before Flop
Seat 3: Dejacob (big blind) folded on the Turn
Seat 4: Serge Claws folded before Flop (didn't bet)
Seat 5: hldtom folded before Flop (didn't bet)
Seat 6: ViTiV2010 folded before Flop (didn't bet)
Seat 7: Grishukps folded before Flop (didn't bet)
Seat 8: INSP!RON folded before Flop (didn't bet)
Seat 9: 0 operator 0 folded before Flop (didn't bet)



PokerStars Zoom Hand #84300713403:  Hold'em No Limit ($0.10/$0.25) - 2012/08/05 15:46:19 JST [2012/08/05 2:46:19 ET]
Table 'Whirlpool' 9-max Seat #1 is the button
Seat 1: Fructionar ($35.33 in chips) 
Seat 2: Rici47 ($30.22 in chips) 
Seat 3: nice.franki ($11.05 in chips) 
Seat 4: Saruotiss ($65.11 in chips) 
Seat 5: silvno31 ($66.76 in chips) 
Seat 6: Alvinpe85 ($54.04 in chips) 
Seat 7: chiyuki ($52.56 in chips) 
Seat 8: jacquelinewu ($26.43 in chips) 
Seat 9: Perstenev ($10.91 in chips) 
Rici47: posts small blind $0.10
nice.franki: posts big blind $0.25
*** HOLE CARDS ***
Dealt to chiyuki [5d 2d]
Saruotiss: folds 
silvno31: folds 
Alvinpe85: folds 
chiyuki: folds 
jacquelinewu: folds 
Perstenev: raises $0.50 to $0.75
Fructionar: folds 
Rici47: folds 
nice.franki: folds 
Uncalled bet ($0.50) returned to Perstenev
Perstenev collected $0.60 from pot
Perstenev: doesn't show hand 
*** SUMMARY ***
Total pot $0.60 | Rake $0 
Seat 1: Fructionar (button) folded before Flop (didn't bet)
Seat 2: Rici47 (small blind) folded before Flop
Seat 3: nice.franki (big blind) folded before Flop
Seat 4: Saruotiss folded before Flop (didn't bet)
Seat 5: silvno31 folded before Flop (didn't bet)
Seat 6: Alvinpe85 folded before Flop (didn't bet)
Seat 7: chiyuki folded before Flop (didn't bet)
Seat 8: jacquelinewu folded before Flop (didn't bet)
Seat 9: Perstenev collected ($0.60)



PokerStars Zoom Hand #84300719079:  Hold'em No Limit ($0.10/$0.25) - 2012/08/05 15:46:41 JST [2012/08/05 2:46:41 ET]
Table 'Whirlpool' 9-max Seat #1 is the button
Seat 1: Rilko1975 ($25.91 in chips) 
Seat 2: seula i ($26.56 in chips) 
Seat 3: INSP!RON ($39.57 in chips) 
Seat 4: panaam ($26.61 in chips) 
Seat 5: aivvo ($8.25 in chips) 
Seat 6: jacquelinewu ($26.43 in chips) 
Seat 7: River_GmbH ($13.63 in chips) 
Seat 8: snejokCoxx ($12.59 in chips) 
Seat 9: chiyuki ($52.46 in chips) 
seula i: posts small blind $0.10
INSP!RON: posts big blind $0.25
*** HOLE CARDS ***
Dealt to chiyuki [2s 8d]
panaam: calls $0.25
aivvo: folds 
jacquelinewu: folds 
River_GmbH: folds 
snejokCoxx: folds 
chiyuki: folds 
Rilko1975: folds 
seula i: folds 
INSP!RON: checks 
*** FLOP *** [8c 5h 4c]
INSP!RON: bets $0.40
panaam: folds 
Uncalled bet ($0.40) returned to INSP!RON
INSP!RON collected $0.57 from pot
INSP!RON: doesn't show hand 
*** SUMMARY ***
Total pot $0.60 | Rake $0.03 
Board [8c 5h 4c]
Seat 1: Rilko1975 (button) folded before Flop (didn't bet)
Seat 2: seula i (small blind) folded before Flop
Seat 3: INSP!RON (big blind) collected ($0.57)
Seat 4: panaam folded on the Flop
Seat 5: aivvo folded before Flop (didn't bet)
Seat 6: jacquelinewu folded before Flop (didn't bet)
Seat 7: River_GmbH folded before Flop (didn't bet)
Seat 8: snejokCoxx folded before Flop (didn't bet)
Seat 9: chiyuki folded before Flop (didn't bet)



PokerStars Zoom Hand #84300718062:  Hold'em No Limit ($0.10/$0.25) - 2012/08/05 15:46:37 JST [2012/08/05 2:46:37 ET]
Table 'Whirlpool' 9-max Seat #1 is the button
Seat 1: chiyuki ($52.46 in chips) 
Seat 2: Femali54 ($24.75 in chips) 
Seat 3: nice.franki ($7.25 in chips) 
Seat 4: Kasperlmusik ($25.35 in chips) 
Seat 5: fwnaf ($15.11 in chips) 
Seat 6: Rilko1975 ($25.91 in chips) 
Seat 7: Grishukps ($12.50 in chips) 
Seat 8: aivvo ($8.25 in chips) 
Seat 9: KeLevro0 ($8.36 in chips) 
Femali54: posts small blind $0.10
nice.franki: posts big blind $0.25
*** HOLE CARDS ***
Dealt to chiyuki [3c Td]
Kasperlmusik: folds 
fwnaf: folds 
Rilko1975: folds 
Grishukps: folds 
aivvo: folds 
KeLevro0: folds 
chiyuki: folds 
Femali54: raises $0.36 to $0.61
nice.franki: folds 
Uncalled bet ($0.36) returned to Femali54
Femali54 collected $0.50 from pot
Femali54: doesn't show hand 
Femali54 is disconnected 
*** SUMMARY ***
Total pot $0.50 | Rake $0 
Seat 1: chiyuki (button) folded before Flop (didn't bet)
Seat 2: Femali54 (small blind) collected ($0.50)
Seat 3: nice.franki (big blind) folded before Flop
Seat 4: Kasperlmusik folded before Flop (didn't bet)
Seat 5: fwnaf folded before Flop (didn't bet)
Seat 6: Rilko1975 folded before Flop (didn't bet)
Seat 7: Grishukps folded before Flop (didn't bet)
Seat 8: aivvo folded before Flop (didn't bet)
Seat 9: KeLevro0 folded before Flop (didn't bet)



PokerStars Zoom Hand #84300715687:  Hold'em No Limit ($0.10/$0.25) - 2012/08/05 15:46:28 JST [2012/08/05 2:46:28 ET]
Table 'Whirlpool' 9-max Seat #1 is the button
Seat 1: JhonnyP1979 ($18.36 in chips) 
Seat 2: chiyuki ($52.56 in chips) 
Seat 3: kamikkaze ($19.10 in chips) 
Seat 4: yvasilik ($22.94 in chips) 
Seat 5: phate-1up ($41.19 in chips) 
Seat 6: Limoilou ($30.97 in chips) 
Seat 7: seula i ($26.56 in chips) 
Seat 8: nice.franki ($7.25 in chips) 
Seat 9: Kasperlmusik ($25 in chips) 
chiyuki: posts small blind $0.10
kamikkaze: posts big blind $0.25
*** HOLE CARDS ***
Dealt to chiyuki [4s 6c]
yvasilik: folds 
phate-1up: folds 
Limoilou: raises $0.50 to $0.75
seula i: folds 
nice.franki: folds 
Kasperlmusik: folds 
JhonnyP1979: folds 
chiyuki: folds 
kamikkaze: calls $0.50
*** FLOP *** [5s Jh Ah]
kamikkaze: checks 
Limoilou: bets $0.76
kamikkaze: folds 
Uncalled bet ($0.76) returned to Limoilou
Limoilou collected $1.53 from pot
Limoilou: doesn't show hand 
*** SUMMARY ***
Total pot $1.60 | Rake $0.07 
Board [5s Jh Ah]
Seat 1: JhonnyP1979 (button) folded before Flop (didn't bet)
Seat 2: chiyuki (small blind) folded before Flop
Seat 3: kamikkaze (big blind) folded on the Flop
Seat 4: yvasilik folded before Flop (didn't bet)
Seat 5: phate-1up folded before Flop (didn't bet)
Seat 6: Limoilou collected ($1.53)
Seat 7: seula i folded before Flop (didn't bet)
Seat 8: nice.franki folded before Flop (didn't bet)
Seat 9: Kasperlmusik folded before Flop (didn't bet)



PokerStars Zoom Hand #84300717037:  Hold'em No Limit ($0.10/$0.25) - 2012/08/05 15:46:33 JST [2012/08/05 2:46:33 ET]
Table 'Whirlpool' 9-max Seat #1 is the button
Seat 1: DrunkTyphoon ($30.50 in chips) 
Seat 2: Rici47 ($42.94 in chips) 
Seat 3: KrystalAA ($10.71 in chips) 
Seat 4: 1Karina1 ($40.64 in chips) 
Seat 5: chiyuki ($52.46 in chips) 
Seat 6: INSP!RON ($39.57 in chips) 
Seat 7: hldtom ($13.61 in chips) 
Seat 8: JhonnyP1979 ($18.36 in chips) 
Seat 9: Femali54 ($24.75 in chips) 
Rici47: posts small blind $0.10
KrystalAA: posts big blind $0.25
*** HOLE CARDS ***
Dealt to chiyuki [7c 9s]
1Karina1: folds 
chiyuki: folds 
INSP!RON: folds 
hldtom: folds 
JhonnyP1979: calls $0.25
Femali54: folds 
DrunkTyphoon: folds 
Rici47: folds 
KrystalAA: checks 
*** FLOP *** [Th 2c Ah]
KrystalAA: checks 
JhonnyP1979: checks 
*** TURN *** [Th 2c Ah] [5s]
KrystalAA: checks 
JhonnyP1979: bets $0.42
KrystalAA: folds 
Uncalled bet ($0.42) returned to JhonnyP1979
JhonnyP1979 collected $0.57 from pot
JhonnyP1979: doesn't show hand 
*** SUMMARY ***
Total pot $0.60 | Rake $0.03 
Board [Th 2c Ah 5s]
Seat 1: DrunkTyphoon (button) folded before Flop (didn't bet)
Seat 2: Rici47 (small blind) folded before Flop
Seat 3: KrystalAA (big blind) folded on the Turn
Seat 4: 1Karina1 folded before Flop (didn't bet)
Seat 5: chiyuki folded before Flop (didn't bet)
Seat 6: INSP!RON folded before Flop (didn't bet)
Seat 7: hldtom folded before Flop (didn't bet)
Seat 8: JhonnyP1979 collected ($0.57)
Seat 9: Femali54 folded before Flop (didn't bet)



PokerStars Zoom Hand #84300723326:  Hold'em No Limit ($0.10/$0.25) - 2012/08/05 15:46:57 JST [2012/08/05 2:46:57 ET]
Table 'Whirlpool' 9-max Seat #1 is the button
Seat 1: snejokCoxx ($15.97 in chips) 
Seat 2: kesstukas25 ($15.35 in chips) 
Seat 3: chiyuki ($52.46 in chips) 
Seat 4: phate-1up ($57.97 in chips) 
Seat 5: GovGus ($44.66 in chips) 
Seat 6: 1Karina1 ($25 in chips) 
Seat 7: Kozyavkin ($21.40 in chips) 
Seat 8: Grishukps ($12.50 in chips) 
Seat 9: hldtom ($28.64 in chips) 
kesstukas25: posts small blind $0.10
chiyuki: posts big blind $0.25
*** HOLE CARDS ***
Dealt to chiyuki [4s 4h]
phate-1up: folds 
GovGus: folds 
1Karina1: folds 
Kozyavkin: folds 
Grishukps: folds 
hldtom: folds 
snejokCoxx: folds 
kesstukas25: folds 
Uncalled bet ($0.15) returned to chiyuki
chiyuki collected $0.20 from pot
chiyuki: doesn't show hand 
*** SUMMARY ***
Total pot $0.20 | Rake $0 
Seat 1: snejokCoxx (button) folded before Flop (didn't bet)
Seat 2: kesstukas25 (small blind) folded before Flop
Seat 3: chiyuki (big blind) collected ($0.20)
Seat 4: phate-1up folded before Flop (didn't bet)
Seat 5: GovGus folded before Flop (didn't bet)
Seat 6: 1Karina1 folded before Flop (didn't bet)
Seat 7: Kozyavkin folded before Flop (didn't bet)
Seat 8: Grishukps folded before Flop (didn't bet)
Seat 9: hldtom folded before Flop (didn't bet)



PokerStars Zoom Hand #84300726650:  Hold'em No Limit ($0.10/$0.25) - 2012/08/05 15:47:10 JST [2012/08/05 2:47:10 ET]
Table 'Whirlpool' 9-max Seat #1 is the button
Seat 1: aivvo ($7.90 in chips) 
Seat 2: DutchShultzs ($46.01 in chips) 
Seat 3: drunk_bender ($18.86 in chips) 
Seat 4: snejokCoxx ($11.40 in chips) 
Seat 5: AntoineHunt ($36.59 in chips) 
Seat 6: Rici47 ($30.12 in chips) 
Seat 7: ShaninPeter ($11.37 in chips) 
Seat 8: chiyuki ($52.56 in chips) 
Seat 9: 1Karina1 ($35.72 in chips) 
DutchShultzs: posts small blind $0.10
drunk_bender: posts big blind $0.25
*** HOLE CARDS ***
Dealt to chiyuki [7h Jd]
snejokCoxx: folds 
AntoineHunt: folds 
Rici47: folds 
ShaninPeter: folds 
chiyuki: folds 
1Karina1: folds 
aivvo: folds 
DutchShultzs: folds 
Uncalled bet ($0.15) returned to drunk_bender
drunk_bender collected $0.20 from pot
drunk_bender: doesn't show hand 
*** SUMMARY ***
Total pot $0.20 | Rake $0 
Seat 1: aivvo (button) folded before Flop (didn't bet)
Seat 2: DutchShultzs (small blind) folded before Flop
Seat 3: drunk_bender (big blind) collected ($0.20)
Seat 4: snejokCoxx folded before Flop (didn't bet)
Seat 5: AntoineHunt folded before Flop (didn't bet)
Seat 6: Rici47 folded before Flop (didn't bet)
Seat 7: ShaninPeter folded before Flop (didn't bet)
Seat 8: chiyuki folded before Flop (didn't bet)
Seat 9: 1Karina1 folded before Flop (didn't bet)



PokerStars Zoom Hand #84300722256:  Hold'em No Limit ($0.10/$0.25) - 2012/08/05 15:46:53 JST [2012/08/05 2:46:53 ET]
Table 'Whirlpool' 9-max Seat #1 is the button
Seat 1: xxx Spb xxx ($26.30 in chips) 
Seat 2: Fructionar ($35.33 in chips) 
Seat 3: masterkoolb ($12.50 in chips) 
Seat 4: chiyuki ($52.46 in chips) 
Seat 5: jacquelinewu ($32.74 in chips) 
Seat 6: GovGus ($36.80 in chips) 
Seat 7: DrunkTyphoon ($30.50 in chips) 
Seat 8: KeLevro0 ($12.82 in chips) 
Seat 9: nastya040 ($16.95 in chips) 
Fructionar: posts small blind $0.10
masterkoolb: posts big blind $0.25
*** HOLE CARDS ***
Dealt to chiyuki [Kc Jd]
chiyuki: folds 
jacquelinewu: folds 
GovGus: folds 
DrunkTyphoon: folds 
KeLevro0: folds 
nastya040: folds 
xxx Spb xxx: folds 
Fructionar: calls $0.15
masterkoolb: checks 
*** FLOP *** [9d 6s 9s]
Fructionar: checks 
masterkoolb: checks 
*** TURN *** [9d 6s 9s] [9h]
Fructionar: bets $0.25
masterkoolb: calls $0.25
*** RIVER *** [9d 6s 9s 9h] [2h]
Fructionar: bets $0.72
masterkoolb: folds 
Uncalled bet ($0.72) returned to Fructionar
Fructionar collected $0.96 from pot
Fructionar: doesn't show hand 
*** SUMMARY ***
Total pot $1 | Rake $0.04 
Board [9d 6s 9s 9h 2h]
Seat 1: xxx Spb xxx (button) folded before Flop (didn't bet)
Seat 2: Fructionar (small blind) collected ($0.96)
Seat 3: masterkoolb (big blind) folded on the River
Seat 4: chiyuki folded before Flop (didn't bet)
Seat 5: jacquelinewu folded before Flop (didn't bet)
Seat 6: GovGus folded before Flop (didn't bet)
Seat 7: DrunkTyphoon folded before Flop (didn't bet)
Seat 8: KeLevro0 folded before Flop (didn't bet)
Seat 9: nastya040 folded before Flop (didn't bet)



PokerStars Zoom Hand #84300732419:  Hold'em No Limit ($0.10/$0.25) - 2012/08/05 15:47:33 JST [2012/08/05 2:47:33 ET]
Table 'Whirlpool' 9-max Seat #1 is the button
Seat 1: rey2040 ($23.62 in chips) 
Seat 2: ShaninPeter ($11.72 in chips) 
Seat 3: risekuku468 ($29.31 in chips) 
Seat 4: fil740 ($9.63 in chips) 
Seat 5: KrystalAA ($27.75 in chips) 
Seat 6: DrunkTyphoon ($30.15 in chips) 
Seat 7: chiyuki ($52.56 in chips) 
Seat 8: PPP7SSS ($18.58 in chips) 
Seat 9: Jene4kaBest ($19.80 in chips) 
ShaninPeter: posts small blind $0.10
risekuku468: posts big blind $0.25
*** HOLE CARDS ***
Dealt to chiyuki [3c Ts]
fil740: folds 
KrystalAA: folds 
DrunkTyphoon: folds 
chiyuki: folds 
PPP7SSS: folds 
Jene4kaBest: raises $0.50 to $0.75
rey2040: folds 
ShaninPeter: folds 
risekuku468: folds 
Uncalled bet ($0.50) returned to Jene4kaBest
Jene4kaBest collected $0.60 from pot
Jene4kaBest: doesn't show hand 
*** SUMMARY ***
Total pot $0.60 | Rake $0 
Seat 1: rey2040 (button) folded before Flop (didn't bet)
Seat 2: ShaninPeter (small blind) folded before Flop
Seat 3: risekuku468 (big blind) folded before Flop
Seat 4: fil740 folded before Flop (didn't bet)
Seat 5: KrystalAA folded before Flop (didn't bet)
Seat 6: DrunkTyphoon folded before Flop (didn't bet)
Seat 7: chiyuki folded before Flop (didn't bet)
Seat 8: PPP7SSS folded before Flop (didn't bet)
Seat 9: Jene4kaBest collected ($0.60)



PokerStars Zoom Hand #84300733431:  Hold'em No Limit ($0.10/$0.25) - 2012/08/05 15:47:37 JST [2012/08/05 2:47:37 ET]
Table 'Whirlpool' 9-max Seat #1 is the button
Seat 1: kwkim73 ($28.43 in chips) 
Seat 2: Kozyavkin ($21.15 in chips) 
Seat 3: Komissar82 ($15 in chips) 
Seat 4: JhonnyP1979 ($17.93 in chips) 
Seat 5: masterkoolb ($20.24 in chips) 
Seat 6: ViTiV2010 ($11.24 in chips) 
Seat 7: Femali54 ($25 in chips) 
Seat 8: Nerkit ($12.62 in chips) 
Seat 9: chiyuki ($52.56 in chips) 
Kozyavkin: posts small blind $0.10
Komissar82: posts big blind $0.25
*** HOLE CARDS ***
Dealt to chiyuki [6h 9s]
JhonnyP1979: folds 
masterkoolb: folds 
ViTiV2010: folds 
Femali54: folds 
Nerkit: folds 
chiyuki: folds 
kwkim73: folds 
Kozyavkin: folds 
Uncalled bet ($0.15) returned to Komissar82
Komissar82 collected $0.20 from pot
Komissar82: doesn't show hand 
*** SUMMARY ***
Total pot $0.20 | Rake $0 
Seat 1: kwkim73 (button) folded before Flop (didn't bet)
Seat 2: Kozyavkin (small blind) folded before Flop
Seat 3: Komissar82 (big blind) collected ($0.20)
Seat 4: JhonnyP1979 folded before Flop (didn't bet)
Seat 5: masterkoolb folded before Flop (didn't bet)
Seat 6: ViTiV2010 folded before Flop (didn't bet)
Seat 7: Femali54 folded before Flop (didn't bet)
Seat 8: Nerkit folded before Flop (didn't bet)
Seat 9: chiyuki folded before Flop (didn't bet)



PokerStars Zoom Hand #84300730923:  Hold'em No Limit ($0.10/$0.25) - 2012/08/05 15:47:27 JST [2012/08/05 2:47:27 ET]
Table 'Whirlpool' 9-max Seat #1 is the button
Seat 1: chiyuki ($52.56 in chips) 
Seat 2: kesstukas25 ($15.57 in chips) 
Seat 3: KeLevro0 ($12.82 in chips) 
Seat 4: 1Karina1 ($35.72 in chips) 
Seat 5: rey2040 ($23.62 in chips) 
Seat 6: Dan Royal ($27.32 in chips) 
Seat 7: Serge Claws ($31.08 in chips) 
Seat 8: phate-1up ($40.99 in chips) 
Seat 9: Kozyavkin ($21.15 in chips) 
kesstukas25: posts small blind $0.10
KeLevro0: posts big blind $0.25
*** HOLE CARDS ***
Dealt to chiyuki [7s 9h]
1Karina1: folds 
rey2040: folds 
Dan Royal: calls $0.25
Serge Claws: folds 
phate-1up: folds 
Kozyavkin: folds 
chiyuki: folds 
kesstukas25: raises $0.75 to $1
KeLevro0: folds 
Dan Royal: calls $0.75
*** FLOP *** [4h Ad Kh]
kesstukas25: bets $1.50
Dan Royal: folds 
Uncalled bet ($1.50) returned to kesstukas25
kesstukas25 collected $2.15 from pot
kesstukas25: doesn't show hand 
*** SUMMARY ***
Total pot $2.25 | Rake $0.10 
Board [4h Ad Kh]
Seat 1: chiyuki (button) folded before Flop (didn't bet)
Seat 2: kesstukas25 (small blind) collected ($2.15)
Seat 3: KeLevro0 (big blind) folded before Flop
Seat 4: 1Karina1 folded before Flop (didn't bet)
Seat 5: rey2040 folded before Flop (didn't bet)
Seat 6: Dan Royal folded on the Flop
Seat 7: Serge Claws folded before Flop (didn't bet)
Seat 8: phate-1up folded before Flop (didn't bet)
Seat 9: Kozyavkin folded before Flop (didn't bet)



PokerStars Zoom Hand #84300736037:  Hold'em No Limit ($0.10/$0.25) - 2012/08/05 15:47:47 JST [2012/08/05 2:47:47 ET]
Table 'Whirlpool' 9-max Seat #1 is the button
Seat 1: Komissar82 ($15.10 in chips) 
Seat 2: chiyuki ($52.56 in chips) 
Seat 3: aivvo ($7.90 in chips) 
Seat 4: mr_pugsley69 ($14.30 in chips) 
Seat 5: KeLevro0 ($12.63 in chips) 
Seat 6: GSDP ($19.29 in chips) 
Seat 7: INSP!RON ($40.14 in chips) 
Seat 8: hldtom ($12.50 in chips) 
Seat 9: wildy29 ($44.63 in chips) 
chiyuki: posts small blind $0.10
aivvo: posts big blind $0.25
*** HOLE CARDS ***
Dealt to chiyuki [4s 5s]
mr_pugsley69: folds 
KeLevro0: folds 
GSDP: folds 
INSP!RON: folds 
hldtom: folds 
wildy29: folds 
Komissar82: folds 
chiyuki: folds 
Uncalled bet ($0.15) returned to aivvo
aivvo collected $0.20 from pot
aivvo: doesn't show hand 
*** SUMMARY ***
Total pot $0.20 | Rake $0 
Seat 1: Komissar82 (button) folded before Flop (didn't bet)
Seat 2: chiyuki (small blind) folded before Flop
Seat 3: aivvo (big blind) collected ($0.20)
Seat 4: mr_pugsley69 folded before Flop (didn't bet)
Seat 5: KeLevro0 folded before Flop (didn't bet)
Seat 6: GSDP folded before Flop (didn't bet)
Seat 7: INSP!RON folded before Flop (didn't bet)
Seat 8: hldtom folded before Flop (didn't bet)
Seat 9: wildy29 folded before Flop (didn't bet)



PokerStars Zoom Hand #84300735011:  Hold'em No Limit ($0.10/$0.25) - 2012/08/05 15:47:43 JST [2012/08/05 2:47:43 ET]
Table 'Whirlpool' 9-max Seat #1 is the button
Seat 1: snejokCoxx ($11.15 in chips) 
Seat 2: jacquelinewu ($25.68 in chips) 
Seat 3: kwkim73 ($28.43 in chips) 
Seat 4: INSP!RON ($40.94 in chips) 
Seat 5: chiyuki ($52.56 in chips) 
Seat 6: 4ydo yogurt ($28.55 in chips) 
Seat 7: aivvo ($7.90 in chips) 
Seat 8: DutchShultzs ($45.91 in chips) 
Seat 9: Alvinpe85 ($46.52 in chips) 
jacquelinewu: posts small blind $0.10
kwkim73: posts big blind $0.25
*** HOLE CARDS ***
Dealt to chiyuki [Td 8d]
INSP!RON: folds 
chiyuki: folds 
4ydo yogurt: folds 
aivvo: folds 
DutchShultzs: folds 
Alvinpe85: folds 
snejokCoxx: raises $0.40 to $0.65
jacquelinewu: folds 
kwkim73: raises $1.85 to $2.50
snejokCoxx: folds 
Uncalled bet ($1.85) returned to kwkim73
kwkim73 collected $1.40 from pot
kwkim73: doesn't show hand 
*** SUMMARY ***
Total pot $1.40 | Rake $0 
Seat 1: snejokCoxx (button) folded before Flop
Seat 2: jacquelinewu (small blind) folded before Flop
Seat 3: kwkim73 (big blind) collected ($1.40)
Seat 4: INSP!RON folded before Flop (didn't bet)
Seat 5: chiyuki folded before Flop (didn't bet)
Seat 6: 4ydo yogurt folded before Flop (didn't bet)
Seat 7: aivvo folded before Flop (didn't bet)
Seat 8: DutchShultzs folded before Flop (didn't bet)
Seat 9: Alvinpe85 folded before Flop (didn't bet)



PokerStars Zoom Hand #84300720388:  Hold'em No Limit ($0.10/$0.25) - 2012/08/05 15:46:46 JST [2012/08/05 2:46:46 ET]
Table 'Whirlpool' 9-max Seat #1 is the button
Seat 1: Saruotiss ($64.86 in chips) 
Seat 2: Perstenev ($11.26 in chips) 
Seat 3: Kasperlmusik ($25 in chips) 
Seat 4: Gichboy ($13.30 in chips) 
Seat 5: Grishukps ($12.50 in chips) 
Seat 6: chiyuki ($52.46 in chips) 
Seat 7: 1Karina1 ($38.17 in chips) 
Seat 8: Rilko1975 ($25.91 in chips) 
Seat 9: WARIBANA7777 ($14.79 in chips) 
Perstenev: posts small blind $0.10
Kasperlmusik: posts big blind $0.25
*** HOLE CARDS ***
Dealt to chiyuki [Jh 3s]
Gichboy: folds 
Grishukps: folds 
chiyuki: folds 
1Karina1: raises $0.50 to $0.75
Rilko1975: folds 
WARIBANA7777: folds 
Saruotiss: folds 
Perstenev is disconnected 
Perstenev is connected 
Perstenev: calls $0.65
Kasperlmusik: folds 
*** FLOP *** [2s 4s Qs]
Perstenev: checks 
1Karina1: checks 
*** TURN *** [2s 4s Qs] [7s]
Perstenev: checks 
1Karina1: checks 
*** RIVER *** [2s 4s Qs 7s] [Ts]
Perstenev: bets $1.67
1Karina1: folds 
Uncalled bet ($1.67) returned to Perstenev
Perstenev collected $1.67 from pot
Perstenev: doesn't show hand 
*** SUMMARY ***
Total pot $1.75 | Rake $0.08 
Board [2s 4s Qs 7s Ts]
Seat 1: Saruotiss (button) folded before Flop (didn't bet)
Seat 2: Perstenev (small blind) collected ($1.67)
Seat 3: Kasperlmusik (big blind) folded before Flop
Seat 4: Gichboy folded before Flop (didn't bet)
Seat 5: Grishukps folded before Flop (didn't bet)
Seat 6: chiyuki folded before Flop (didn't bet)
Seat 7: 1Karina1 folded on the River
Seat 8: Rilko1975 folded before Flop (didn't bet)
Seat 9: WARIBANA7777 folded before Flop (didn't bet)



PokerStars Zoom Hand #84300740467:  Hold'em No Limit ($0.10/$0.25) - 2012/08/05 15:48:04 JST [2012/08/05 2:48:04 ET]
Table 'Whirlpool' 9-max Seat #1 is the button
Seat 1: Saruotiss ($65.46 in chips) 
Seat 2: HighDuka ($31.15 in chips) 
Seat 3: nice.franki ($6.90 in chips) 
Seat 4: herkko11 ($9.43 in chips) 
Seat 5: banderas761 ($10.23 in chips) 
Seat 6: 1Karina1 ($43.59 in chips) 
Seat 7: snejokCoxx ($12.24 in chips) 
Seat 8: chiyuki ($52.46 in chips) 
Seat 9: Grishukps ($13.40 in chips) 
HighDuka: posts small blind $0.10
nice.franki: posts big blind $0.25
*** HOLE CARDS ***
Dealt to chiyuki [Qc 6d]
herkko11: folds 
banderas761: folds 
1Karina1: folds 
snejokCoxx: folds 
chiyuki: folds 
Grishukps: folds 
Saruotiss: folds 
HighDuka: raises $0.50 to $0.75
nice.franki: folds 
Uncalled bet ($0.50) returned to HighDuka
HighDuka collected $0.50 from pot
HighDuka: doesn't show hand 
*** SUMMARY ***
Total pot $0.50 | Rake $0 
Seat 1: Saruotiss (button) folded before Flop (didn't bet)
Seat 2: HighDuka (small blind) collected ($0.50)
Seat 3: nice.franki (big blind) folded before Flop
Seat 4: herkko11 folded before Flop (didn't bet)
Seat 5: banderas761 folded before Flop (didn't bet)
Seat 6: 1Karina1 folded before Flop (didn't bet)
Seat 7: snejokCoxx folded before Flop (didn't bet)
Seat 8: chiyuki folded before Flop (didn't bet)
Seat 9: Grishukps folded before Flop (didn't bet)



PokerStars Zoom Hand #84300743942:  Hold'em No Limit ($0.10/$0.25) - 2012/08/05 15:48:17 JST [2012/08/05 2:48:17 ET]
Table 'Whirlpool' 9-max Seat #1 is the button
Seat 1: leo2095 ($28.49 in chips) 
Seat 2: mr_pugsley69 ($14.40 in chips) 
Seat 3: Perstenev ($23.76 in chips) 
Seat 4: jacquelinewu ($32.99 in chips) 
Seat 5: chiyuki ($52.46 in chips) 
Seat 6: Alvinpe85 ($56.55 in chips) 
Seat 7: kwkim73 ($25 in chips) 
Seat 8: Rici47 ($32.01 in chips) 
Seat 9: masterkoolb ($12.50 in chips) 
mr_pugsley69: posts small blind $0.10
Perstenev: posts big blind $0.25
*** HOLE CARDS ***
Dealt to chiyuki [Td 2h]
jacquelinewu: folds 
chiyuki: folds 
Alvinpe85: folds 
kwkim73: folds 
Rici47: folds 
masterkoolb: folds 
leo2095: folds 
mr_pugsley69: folds 
Uncalled bet ($0.15) returned to Perstenev
Perstenev collected $0.20 from pot
Perstenev: doesn't show hand 
*** SUMMARY ***
Total pot $0.20 | Rake $0 
Seat 1: leo2095 (button) folded before Flop (didn't bet)
Seat 2: mr_pugsley69 (small blind) folded before Flop
Seat 3: Perstenev (big blind) collected ($0.20)
Seat 4: jacquelinewu folded before Flop (didn't bet)
Seat 5: chiyuki folded before Flop (didn't bet)
Seat 6: Alvinpe85 folded before Flop (didn't bet)
Seat 7: kwkim73 folded before Flop (didn't bet)
Seat 8: Rici47 folded before Flop (didn't bet)
Seat 9: masterkoolb folded before Flop (didn't bet)



PokerStars Zoom Hand #84300739428:  Hold'em No Limit ($0.10/$0.25) - 2012/08/05 15:48:00 JST [2012/08/05 2:48:00 ET]
Table 'Whirlpool' 9-max Seat #1 is the button
Seat 1: Trip_Krowns ($26.36 in chips) 
Seat 2: Jene4kaBest ($20.15 in chips) 
Seat 3: kamikkaze ($18.60 in chips) 
Seat 4: chiyuki ($52.46 in chips) 
Seat 5: jacquelinewu ($68.48 in chips) 
Seat 6: River_GmbH ($13.38 in chips) 
Seat 7: Ozboy80 ($26.28 in chips) 
Seat 8: romanian c4 ($18.32 in chips) 
Seat 9: snejokCoxx ($12.24 in chips) 
Jene4kaBest: posts small blind $0.10
kamikkaze: posts big blind $0.25
*** HOLE CARDS ***
Dealt to chiyuki [5s 9h]
chiyuki: folds 
jacquelinewu: folds 
River_GmbH: raises $0.50 to $0.75
Ozboy80: calls $0.75
romanian c4: folds 
snejokCoxx: folds 
Trip_Krowns: folds 
Jene4kaBest: folds 
kamikkaze: folds 
*** FLOP *** [Td Kd 8d]
River_GmbH: bets $1
Ozboy80: calls $1
*** TURN *** [Td Kd 8d] [9c]
River_GmbH: checks 
Ozboy80: bets $1
River_GmbH: calls $1
*** RIVER *** [Td Kd 8d 9c] [7h]
River_GmbH: checks 
Ozboy80: checks 
*** SHOW DOWN ***
River_GmbH: shows [Ac Ad] (a pair of Aces)
Ozboy80: mucks hand 
River_GmbH collected $5.59 from pot
*** SUMMARY ***
Total pot $5.85 | Rake $0.26 
Board [Td Kd 8d 9c 7h]
Seat 1: Trip_Krowns (button) folded before Flop (didn't bet)
Seat 2: Jene4kaBest (small blind) folded before Flop
Seat 3: kamikkaze (big blind) folded before Flop
Seat 4: chiyuki folded before Flop (didn't bet)
Seat 5: jacquelinewu folded before Flop (didn't bet)
Seat 6: River_GmbH showed [Ac Ad] and won ($5.59) with a pair of Aces
Seat 7: Ozboy80 mucked [Ts Qd]
Seat 8: romanian c4 folded before Flop (didn't bet)
Seat 9: snejokCoxx folded before Flop (didn't bet)



PokerStars Zoom Hand #84300741551:  Hold'em No Limit ($0.10/$0.25) - 2012/08/05 15:48:08 JST [2012/08/05 2:48:08 ET]
Table 'Whirlpool' 9-max Seat #1 is the button
Seat 1: chiyuki ($52.46 in chips) 
Seat 2: KeLevro0 ($12.63 in chips) 
Seat 3: phate-1up ($53.87 in chips) 
Seat 4: herkko11 ($9.43 in chips) 
Seat 5: kamikkaze ($18.95 in chips) 
Seat 6: Grishukps ($12.95 in chips) 
Seat 7: Rici47 ($39.16 in chips) 
Seat 8: Spheroff ($18.02 in chips) 
Seat 9: crazycrown1 ($12.15 in chips) 
KeLevro0: posts small blind $0.10
phate-1up: posts big blind $0.25
*** HOLE CARDS ***
Dealt to chiyuki [4h 5h]
herkko11: folds 
kamikkaze: folds 
Grishukps: raises $0.50 to $0.75
Rici47: folds 
Spheroff: calls $0.75
crazycrown1: calls $0.75
chiyuki: folds 
KeLevro0: folds 
phate-1up: calls $0.50
*** FLOP *** [9c 8c 8s]
phate-1up: checks 
Grishukps: checks 
Spheroff: bets $1.25
crazycrown1: calls $1.25
phate-1up: folds 
Grishukps: folds 
*** TURN *** [9c 8c 8s] [Qh]
Spheroff: bets $2
crazycrown1: calls $2
*** RIVER *** [9c 8c 8s Qh] [As]
Spheroff: checks 
crazycrown1: checks 
*** SHOW DOWN ***
Spheroff: shows [9d 6d] (two pair, Nines and Eights)
crazycrown1: shows [Qs Jd] (two pair, Queens and Eights)
crazycrown1 collected $9.17 from pot
*** SUMMARY ***
Total pot $9.60 | Rake $0.43 
Board [9c 8c 8s Qh As]
Seat 1: chiyuki (button) folded before Flop (didn't bet)
Seat 2: KeLevro0 (small blind) folded before Flop
Seat 3: phate-1up (big blind) folded on the Flop
Seat 4: herkko11 folded before Flop (didn't bet)
Seat 5: kamikkaze folded before Flop (didn't bet)
Seat 6: Grishukps folded on the Flop
Seat 7: Rici47 folded before Flop (didn't bet)
Seat 8: Spheroff showed [9d 6d] and lost with two pair, Nines and Eights
Seat 9: crazycrown1 showed [Qs Jd] and won ($9.17) with two pair, Queens and Eights



PokerStars Zoom Hand #84300745433:  Hold'em No Limit ($0.10/$0.25) - 2012/08/05 15:48:23 JST [2012/08/05 2:48:23 ET]
Table 'Whirlpool' 9-max Seat #1 is the button
Seat 1: kamikkaze ($18.35 in chips) 
Seat 2: Silveystryk ($23.26 in chips) 
Seat 3: chiyuki ($52.46 in chips) 
Seat 4: DrunkTyphoon ($29.80 in chips) 
Seat 5: Limoilou ($32.50 in chips) 
Seat 6: KrystalAA ($42.72 in chips) 
Seat 7: GovGus ($26.35 in chips) 
Seat 8: 1Karina1 ($35.12 in chips) 
Seat 9: jacquelinewu ($28.21 in chips) 
Silveystryk: posts small blind $0.10
chiyuki: posts big blind $0.25
*** HOLE CARDS ***
Dealt to chiyuki [2h 3h]
DrunkTyphoon: folds 
Limoilou: folds 
KrystalAA: folds 
GovGus: raises $0.75 to $1
1Karina1: folds 
jacquelinewu: folds 
kamikkaze: folds 
Silveystryk: folds 
chiyuki: folds 
Uncalled bet ($0.75) returned to GovGus
GovGus collected $0.60 from pot
GovGus: doesn't show hand 
*** SUMMARY ***
Total pot $0.60 | Rake $0 
Seat 1: kamikkaze (button) folded before Flop (didn't bet)
Seat 2: Silveystryk (small blind) folded before Flop
Seat 3: chiyuki (big blind) folded before Flop
Seat 4: DrunkTyphoon folded before Flop (didn't bet)
Seat 5: Limoilou folded before Flop (didn't bet)
Seat 6: KrystalAA folded before Flop (didn't bet)
Seat 7: GovGus collected ($0.60)
Seat 8: 1Karina1 folded before Flop (didn't bet)
Seat 9: jacquelinewu folded before Flop (didn't bet)



PokerStars Zoom Hand #84300753381:  Hold'em No Limit ($0.10/$0.25) - 2012/08/05 15:48:54 JST [2012/08/05 2:48:54 ET]
Table 'Whirlpool' 9-max Seat #1 is the button
Seat 1: KrystalAA ($13.92 in chips) 
Seat 2: ViTiV2010 ($10.49 in chips) 
Seat 3: nice.franki ($10.45 in chips) 
Seat 4: Ellen1947 ($25 in chips) 
Seat 5: pandaaaaaa ($16 in chips) 
Seat 6: Silveystryk ($22.91 in chips) 
Seat 7: chiyuki ($52.21 in chips) 
Seat 8: INSP!RON ($35.37 in chips) 
Seat 9: fil740 ($6.22 in chips) 
ViTiV2010: posts small blind $0.10
nice.franki: posts big blind $0.25
*** HOLE CARDS ***
Dealt to chiyuki [Jh 3h]
Ellen1947: folds 
pandaaaaaa: folds 
Silveystryk: folds 
chiyuki: folds 
INSP!RON: folds 
fil740: folds 
KrystalAA: folds 
ViTiV2010: folds 
Uncalled bet ($0.15) returned to nice.franki
nice.franki collected $0.20 from pot
nice.franki: doesn't show hand 
*** SUMMARY ***
Total pot $0.20 | Rake $0 
Seat 1: KrystalAA (button) folded before Flop (didn't bet)
Seat 2: ViTiV2010 (small blind) folded before Flop
Seat 3: nice.franki (big blind) collected ($0.20)
Seat 4: Ellen1947 folded before Flop (didn't bet)
Seat 5: pandaaaaaa folded before Flop (didn't bet)
Seat 6: Silveystryk folded before Flop (didn't bet)
Seat 7: chiyuki folded before Flop (didn't bet)
Seat 8: INSP!RON folded before Flop (didn't bet)
Seat 9: fil740 folded before Flop (didn't bet)



PokerStars Zoom Hand #84300755457:  Hold'em No Limit ($0.10/$0.25) - 2012/08/05 15:49:02 JST [2012/08/05 2:49:02 ET]
Table 'Whirlpool' 9-max Seat #1 is the button
Seat 1: romanian c4 ($18.32 in chips) 
Seat 2: snejokCoxx ($11.99 in chips) 
Seat 3: Fructionar ($35.89 in chips) 
Seat 4: kesstukas25 ($12.90 in chips) 
Seat 5: seula i ($26.91 in chips) 
Seat 6: chiyuki ($52.21 in chips) 
Seat 7: pandaaaaaa ($16 in chips) 
Seat 8: Silveystryk ($22.91 in chips) 
Seat 9: Perstenev ($23.76 in chips) 
snejokCoxx: posts small blind $0.10
Fructionar: posts big blind $0.25
*** HOLE CARDS ***
Dealt to chiyuki [3h Jd]
kesstukas25: folds 
seula i: folds 
chiyuki: folds 
pandaaaaaa: folds 
Silveystryk: folds 
Perstenev: folds 
romanian c4: folds 
snejokCoxx: folds 
Uncalled bet ($0.15) returned to Fructionar
Fructionar collected $0.20 from pot
Fructionar: doesn't show hand 
*** SUMMARY ***
Total pot $0.20 | Rake $0 
Seat 1: romanian c4 (button) folded before Flop (didn't bet)
Seat 2: snejokCoxx (small blind) folded before Flop
Seat 3: Fructionar (big blind) collected ($0.20)
Seat 4: kesstukas25 folded before Flop (didn't bet)
Seat 5: seula i folded before Flop (didn't bet)
Seat 6: chiyuki folded before Flop (didn't bet)
Seat 7: pandaaaaaa folded before Flop (didn't bet)
Seat 8: Silveystryk folded before Flop (didn't bet)
Seat 9: Perstenev folded before Flop (didn't bet)



PokerStars Zoom Hand #84300758557:  Hold'em No Limit ($0.10/$0.25) - 2012/08/05 15:49:14 JST [2012/08/05 2:49:14 ET]
Table 'Whirlpool' 9-max Seat #1 is the button
Seat 1: KeLevro0 ($12.18 in chips) 
Seat 2: pandaaaaaa ($16 in chips) 
Seat 3: tribunpdm ($93.13 in chips) 
Seat 4: HighDuka ($31.75 in chips) 
Seat 5: Silveystryk ($22.91 in chips) 
Seat 6: ChrisCDee ($58.77 in chips) 
Seat 7: chiyuki ($52.11 in chips) 
Seat 8: Komissar82 ($18.80 in chips) 
Seat 9: 1Karina1 ($37.07 in chips) 
pandaaaaaa: posts small blind $0.10
tribunpdm: posts big blind $0.25
*** HOLE CARDS ***
Dealt to chiyuki [4c Jd]
HighDuka: folds 
Silveystryk: folds 
ChrisCDee: folds 
chiyuki: folds 
Komissar82: folds 
1Karina1: folds 
KeLevro0: folds 
pandaaaaaa: folds 
Uncalled bet ($0.15) returned to tribunpdm
tribunpdm collected $0.20 from pot
tribunpdm: doesn't show hand 
*** SUMMARY ***
Total pot $0.20 | Rake $0 
Seat 1: KeLevro0 (button) folded before Flop (didn't bet)
Seat 2: pandaaaaaa (small blind) folded before Flop
Seat 3: tribunpdm (big blind) collected ($0.20)
Seat 4: HighDuka folded before Flop (didn't bet)
Seat 5: Silveystryk folded before Flop (didn't bet)
Seat 6: ChrisCDee folded before Flop (didn't bet)
Seat 7: chiyuki folded before Flop (didn't bet)
Seat 8: Komissar82 folded before Flop (didn't bet)
Seat 9: 1Karina1 folded before Flop (didn't bet)



PokerStars Zoom Hand #84300760122:  Hold'em No Limit ($0.10/$0.25) - 2012/08/05 15:49:20 JST [2012/08/05 2:49:20 ET]
Table 'Whirlpool' 9-max Seat #1 is the button
Seat 1: xxx Spb xxx ($26.30 in chips) 
Seat 2: KrystalAA ($42.82 in chips) 
Seat 3: herkko11 ($9.78 in chips) 
Seat 4: 1Karina1 ($44.34 in chips) 
Seat 5: Grishukps ($13.21 in chips) 
Seat 6: chiyuki ($52.11 in chips) 
Seat 7: Serge Claws ($26.85 in chips) 
Seat 8: nice.franki ($10.70 in chips) 
Seat 9: DrunkTyphoon ($25 in chips) 
KrystalAA: posts small blind $0.10
herkko11: posts big blind $0.25
*** HOLE CARDS ***
Dealt to chiyuki [9d 6h]
1Karina1: folds 
Grishukps: folds 
chiyuki: folds 
Serge Claws: folds 
nice.franki: folds 
DrunkTyphoon: folds 
xxx Spb xxx: folds 
KrystalAA: folds 
Uncalled bet ($0.15) returned to herkko11
herkko11 collected $0.20 from pot
herkko11: doesn't show hand 
*** SUMMARY ***
Total pot $0.20 | Rake $0 
Seat 1: xxx Spb xxx (button) folded before Flop (didn't bet)
Seat 2: KrystalAA (small blind) folded before Flop
Seat 3: herkko11 (big blind) collected ($0.20)
Seat 4: 1Karina1 folded before Flop (didn't bet)
Seat 5: Grishukps folded before Flop (didn't bet)
Seat 6: chiyuki folded before Flop (didn't bet)
Seat 7: Serge Claws folded before Flop (didn't bet)
Seat 8: nice.franki folded before Flop (didn't bet)
Seat 9: DrunkTyphoon folded before Flop (didn't bet)



PokerStars Zoom Hand #84300756525:  Hold'em No Limit ($0.10/$0.25) - 2012/08/05 15:49:06 JST [2012/08/05 2:49:06 ET]
Table 'Whirlpool' 9-max Seat #1 is the button
Seat 1: Serge Claws ($39.33 in chips) 
Seat 2: luyifei ($9.50 in chips) 
Seat 3: Ozboy80 ($23.88 in chips) 
Seat 4: pandaaaaaa ($16 in chips) 
Seat 5: Spheroff ($14.02 in chips) 
Seat 6: jacquelinewu ($25.68 in chips) 
Seat 7: romanian c4 ($18.32 in chips) 
Seat 8: 4ydo yogurt ($55.60 in chips) 
Seat 9: chiyuki ($52.21 in chips) 
luyifei: posts small blind $0.10
Ozboy80: posts big blind $0.25
*** HOLE CARDS ***
Dealt to chiyuki [2c 9d]
pandaaaaaa: folds 
Spheroff: folds 
jacquelinewu: folds 
romanian c4: folds 
4ydo yogurt: folds 
chiyuki: folds 
Serge Claws: folds 
luyifei: raises $0.50 to $0.75
Ozboy80: calls $0.50
*** FLOP *** [4h 8s Qh]
luyifei: bets $0.25
Ozboy80: calls $0.25
*** TURN *** [4h 8s Qh] [6d]
luyifei: bets $0.25
Ozboy80: calls $0.25
*** RIVER *** [4h 8s Qh 6d] [Qs]
luyifei: checks 
Ozboy80: checks 
*** SHOW DOWN ***
luyifei: shows [Ts Jd] (a pair of Queens)
Ozboy80: shows [Jh Ac] (a pair of Queens - Ace kicker)
Ozboy80 collected $2.39 from pot
*** SUMMARY ***
Total pot $2.50 | Rake $0.11 
Board [4h 8s Qh 6d Qs]
Seat 1: Serge Claws (button) folded before Flop (didn't bet)
Seat 2: luyifei (small blind) showed [Ts Jd] and lost with a pair of Queens
Seat 3: Ozboy80 (big blind) showed [Jh Ac] and won ($2.39) with a pair of Queens
Seat 4: pandaaaaaa folded before Flop (didn't bet)
Seat 5: Spheroff folded before Flop (didn't bet)
Seat 6: jacquelinewu folded before Flop (didn't bet)
Seat 7: romanian c4 folded before Flop (didn't bet)
Seat 8: 4ydo yogurt folded before Flop (didn't bet)
Seat 9: chiyuki folded before Flop (didn't bet)



PokerStars Zoom Hand #84300757559:  Hold'em No Limit ($0.10/$0.25) - 2012/08/05 15:49:10 JST [2012/08/05 2:49:10 ET]
Table 'Whirlpool' 9-max Seat #1 is the button
Seat 1: ShaninPeter ($12.07 in chips) 
Seat 2: chiyuki ($52.21 in chips) 
Seat 3: snejokCoxx ($10.75 in chips) 
Seat 4: pandaaaaaa ($16 in chips) 
Seat 5: nice.franki ($12.15 in chips) 
Seat 6: herkko11 ($9.78 in chips) 
Seat 7: Perstenev ($23.76 in chips) 
Seat 8: laurentzu84 ($46.04 in chips) 
Seat 9: Serge Claws ($39.33 in chips) 
chiyuki: posts small blind $0.10
snejokCoxx: posts big blind $0.25
*** HOLE CARDS ***
Dealt to chiyuki [8d 9c]
pandaaaaaa: folds 
nice.franki: folds 
herkko11: folds 
Perstenev: folds 
laurentzu84: raises $0.50 to $0.75
Serge Claws: folds 
ShaninPeter: raises $0.75 to $1.50
chiyuki: folds 
snejokCoxx: folds 
laurentzu84: calls $0.75
*** FLOP *** [2s 8c 3d]
laurentzu84: checks 
ShaninPeter: bets $2
laurentzu84: calls $2
*** TURN *** [2s 8c 3d] [8s]
laurentzu84: bets $3.25
ShaninPeter: calls $3.25
*** RIVER *** [2s 8c 3d 8s] [2c]
laurentzu84: bets $4.75
ShaninPeter: calls $4.75
*** SHOW DOWN ***
laurentzu84: shows [6d 6c] (two pair, Eights and Sixes)
ShaninPeter: mucks hand 
laurentzu84 collected $22.30 from pot
*** SUMMARY ***
Total pot $23.35 | Rake $1.05 
Board [2s 8c 3d 8s 2c]
Seat 1: ShaninPeter (button) mucked [Kd Jh]
Seat 2: chiyuki (small blind) folded before Flop
Seat 3: snejokCoxx (big blind) folded before Flop
Seat 4: pandaaaaaa folded before Flop (didn't bet)
Seat 5: nice.franki folded before Flop (didn't bet)
Seat 6: herkko11 folded before Flop (didn't bet)
Seat 7: Perstenev folded before Flop (didn't bet)
Seat 8: laurentzu84 showed [6d 6c] and won ($22.30) with two pair, Eights and Sixes
Seat 9: Serge Claws folded before Flop (didn't bet)



PokerStars Zoom Hand #84300761700:  Hold'em No Limit ($0.10/$0.25) - 2012/08/05 15:49:26 JST [2012/08/05 2:49:26 ET]
Table 'Whirlpool' 9-max Seat #1 is the button
Seat 1: snejokCoxx ($11.89 in chips) 
Seat 2: masterkoolb ($12.50 in chips) 
Seat 3: chiyuki ($52.11 in chips) 
Seat 4: nice.franki ($10.55 in chips) 
Seat 5: 1Karina1 ($37.07 in chips) 
Seat 6: Rici47 ($38.81 in chips) 
Seat 7: Serge Claws ($39.23 in chips) 
Seat 8: ViTiV2010 ($10.39 in chips) 
Seat 9: Jene4kaBest ($21.13 in chips) 
masterkoolb: posts small blind $0.10
chiyuki: posts big blind $0.25
*** HOLE CARDS ***
Dealt to chiyuki [Ts Kc]
nice.franki: folds 
1Karina1: folds 
Rici47: calls $0.25
Serge Claws: folds 
ViTiV2010: folds 
Jene4kaBest: folds 
snejokCoxx: folds 
masterkoolb: folds 
chiyuki: checks 
*** FLOP *** [8s 7s 4d]
chiyuki: checks 
Rici47: checks 
*** TURN *** [8s 7s 4d] [4s]
chiyuki: checks 
Rici47: checks 
*** RIVER *** [8s 7s 4d 4s] [6d]
chiyuki: bets $0.50
Rici47: calls $0.50
*** SHOW DOWN ***
chiyuki: shows [Ts Kc] (a pair of Fours)
Rici47: shows [5h Ah] (a straight, Four to Eight)
Rici47 collected $1.53 from pot
*** SUMMARY ***
Total pot $1.60 | Rake $0.07 
Board [8s 7s 4d 4s 6d]
Seat 1: snejokCoxx (button) folded before Flop (didn't bet)
Seat 2: masterkoolb (small blind) folded before Flop
Seat 3: chiyuki (big blind) showed [Ts Kc] and lost with a pair of Fours
Seat 4: nice.franki folded before Flop (didn't bet)
Seat 5: 1Karina1 folded before Flop (didn't bet)
Seat 6: Rici47 showed [5h Ah] and won ($1.53) with a straight, Four to Eight
Seat 7: Serge Claws folded before Flop (didn't bet)
Seat 8: ViTiV2010 folded before Flop (didn't bet)
Seat 9: Jene4kaBest folded before Flop (didn't bet)



PokerStars Zoom Hand #84300775893:  Hold'em No Limit ($0.10/$0.25) - 2012/08/05 15:50:22 JST [2012/08/05 2:50:22 ET]
Table 'Whirlpool' 9-max Seat #1 is the button
Seat 1: Jene4kaBest ($21.03 in chips) 
Seat 2: GovGus ($25.95 in chips) 
Seat 3: MurMurRu ($25 in chips) 
Seat 4: Dan Royal ($25.47 in chips) 
Seat 5: nice.franki ($6.55 in chips) 
Seat 6: soul_5577 ($32.82 in chips) 
Seat 7: Rici47 ($39.59 in chips) 
Seat 8: chiyuki ($51.36 in chips) 
Seat 9: KrystalAA ($42.72 in chips) 
GovGus: posts small blind $0.10
MurMurRu: posts big blind $0.25
*** HOLE CARDS ***
Dealt to chiyuki [8s Qd]
Dan Royal: folds 
nice.franki: folds 
soul_5577: folds 
Rici47: folds 
chiyuki: folds 
KrystalAA: raises $0.46 to $0.71
Jene4kaBest: folds 
GovGus: folds 
MurMurRu: folds 
Uncalled bet ($0.46) returned to KrystalAA
KrystalAA collected $0.60 from pot
KrystalAA: doesn't show hand 
*** SUMMARY ***
Total pot $0.60 | Rake $0 
Seat 1: Jene4kaBest (button) folded before Flop (didn't bet)
Seat 2: GovGus (small blind) folded before Flop
Seat 3: MurMurRu (big blind) folded before Flop
Seat 4: Dan Royal folded before Flop (didn't bet)
Seat 5: nice.franki folded before Flop (didn't bet)
Seat 6: soul_5577 folded before Flop (didn't bet)
Seat 7: Rici47 folded before Flop (didn't bet)
Seat 8: chiyuki folded before Flop (didn't bet)
Seat 9: KrystalAA collected ($0.60)



PokerStars Zoom Hand #84300776994:  Hold'em No Limit ($0.10/$0.25) - 2012/08/05 15:50:26 JST [2012/08/05 2:50:26 ET]
Table 'Whirlpool' 9-max Seat #1 is the button
Seat 1: chiyuki ($51.36 in chips) 
Seat 2: ViTiV2010 ($12 in chips) 
Seat 3: Rici47 ($39.59 in chips) 
Seat 4: Jene4kaBest ($21.03 in chips) 
Seat 5: soul_5577 ($32.82 in chips) 
Seat 6: ShockLaMuc ($24.25 in chips) 
Seat 7: Perstenev ($11.93 in chips) 
Seat 8: herkko11 ($9.03 in chips) 
Seat 9: jacquelinewu ($27.62 in chips) 
ViTiV2010: posts small blind $0.10
Rici47: posts big blind $0.25
*** HOLE CARDS ***
Dealt to chiyuki [4h Kh]
Jene4kaBest: folds 
soul_5577: folds 
ShockLaMuc: folds 
Perstenev: folds 
herkko11: folds 
jacquelinewu: folds 
chiyuki: folds 
ViTiV2010: folds 
Uncalled bet ($0.15) returned to Rici47
Rici47 collected $0.20 from pot
Rici47: doesn't show hand 
*** SUMMARY ***
Total pot $0.20 | Rake $0 
Seat 1: chiyuki (button) folded before Flop (didn't bet)
Seat 2: ViTiV2010 (small blind) folded before Flop
Seat 3: Rici47 (big blind) collected ($0.20)
Seat 4: Jene4kaBest folded before Flop (didn't bet)
Seat 5: soul_5577 folded before Flop (didn't bet)
Seat 6: ShockLaMuc folded before Flop (didn't bet)
Seat 7: Perstenev folded before Flop (didn't bet)
Seat 8: herkko11 folded before Flop (didn't bet)
Seat 9: jacquelinewu folded before Flop (didn't bet)



PokerStars Zoom Hand #84300780319:  Hold'em No Limit ($0.10/$0.25) - 2012/08/05 15:50:39 JST [2012/08/05 2:50:39 ET]
Table 'Whirlpool' 9-max Seat #1 is the button
Seat 1: munky3 ($25 in chips) 
Seat 2: fwnaf ($21.31 in chips) 
Seat 3: chiyuki ($51.26 in chips) 
Seat 4: KeLevro0 ($11.58 in chips) 
Seat 5: mjmichi ($38.61 in chips) 
Seat 6: Serge Claws ($28.08 in chips) 
Seat 7: Silveystryk ($47.53 in chips) 
Seat 8: 1Karina1 ($43.99 in chips) 
Seat 9: jacquelinewu ($31.33 in chips) 
fwnaf: posts small blind $0.10
chiyuki: posts big blind $0.25
*** HOLE CARDS ***
Dealt to chiyuki [8c 2s]
KeLevro0: folds 
mjmichi: folds 
Serge Claws: folds 
Silveystryk: folds 
1Karina1: folds 
jacquelinewu: folds 
munky3: folds 
fwnaf: folds 
Uncalled bet ($0.15) returned to chiyuki
chiyuki collected $0.20 from pot
chiyuki: doesn't show hand 
*** SUMMARY ***
Total pot $0.20 | Rake $0 
Seat 1: munky3 (button) folded before Flop (didn't bet)
Seat 2: fwnaf (small blind) folded before Flop
Seat 3: chiyuki (big blind) collected ($0.20)
Seat 4: KeLevro0 folded before Flop (didn't bet)
Seat 5: mjmichi folded before Flop (didn't bet)
Seat 6: Serge Claws folded before Flop (didn't bet)
Seat 7: Silveystryk folded before Flop (didn't bet)
Seat 8: 1Karina1 folded before Flop (didn't bet)
Seat 9: jacquelinewu folded before Flop (didn't bet)



PokerStars Zoom Hand #84300779045:  Hold'em No Limit ($0.10/$0.25) - 2012/08/05 15:50:34 JST [2012/08/05 2:50:34 ET]
Table 'Whirlpool' 9-max Seat #1 is the button
Seat 1: soul_5577 ($32.82 in chips) 
Seat 2: seula i ($30.32 in chips) 
Seat 3: jvds114 ($38 in chips) 
Seat 4: chiyuki ($51.26 in chips) 
Seat 5: Grishukps ($12.50 in chips) 
Seat 6: nice.franki ($11.35 in chips) 
Seat 7: 1Karina1 ($25.10 in chips) 
Seat 8: snejokCoxx ($10.75 in chips) 
Seat 9: Femali54 ($24.59 in chips) 
seula i: posts small blind $0.10
jvds114: posts big blind $0.25
*** HOLE CARDS ***
Dealt to chiyuki [Kd Ts]
chiyuki: folds 
Grishukps: folds 
nice.franki: folds 
1Karina1: raises $0.50 to $0.75
snejokCoxx: folds 
Femali54: folds 
soul_5577: folds 
seula i: folds 
jvds114: folds 
Uncalled bet ($0.50) returned to 1Karina1
1Karina1 collected $0.60 from pot
1Karina1: doesn't show hand 
*** SUMMARY ***
Total pot $0.60 | Rake $0 
Seat 1: soul_5577 (button) folded before Flop (didn't bet)
Seat 2: seula i (small blind) folded before Flop
Seat 3: jvds114 (big blind) folded before Flop
Seat 4: chiyuki folded before Flop (didn't bet)
Seat 5: Grishukps folded before Flop (didn't bet)
Seat 6: nice.franki folded before Flop (didn't bet)
Seat 7: 1Karina1 collected ($0.60)
Seat 8: snejokCoxx folded before Flop (didn't bet)
Seat 9: Femali54 folded before Flop (didn't bet)



PokerStars Zoom Hand #84300778031:  Hold'em No Limit ($0.10/$0.25) - 2012/08/05 15:50:30 JST [2012/08/05 2:50:30 ET]
Table 'Whirlpool' 9-max Seat #1 is the button
Seat 1: GovGus ($51.53 in chips) 
Seat 2: chiyuki ($51.36 in chips) 
Seat 3: AntoineHunt ($34.71 in chips) 
Seat 4: romanian c4 ($14.72 in chips) 
Seat 5: SAILUSI ($24.30 in chips) 
Seat 6: jvds114 ($38 in chips) 
Seat 7: DrunkTyphoon ($30.12 in chips) 
Seat 8: HighDuka ($33.11 in chips) 
Seat 9: nice.franki ($11.35 in chips) 
chiyuki: posts small blind $0.10
AntoineHunt: posts big blind $0.25
*** HOLE CARDS ***
Dealt to chiyuki [8h Ts]
romanian c4: folds 
SAILUSI: calls $0.25
jvds114: folds 
DrunkTyphoon: calls $0.25
HighDuka: calls $0.25
nice.franki: folds 
GovGus: raises $1 to $1.25
chiyuki: folds 
AntoineHunt: folds 
SAILUSI: folds 
DrunkTyphoon: calls $1
HighDuka: folds 
*** FLOP *** [Qs 7h Qc]
DrunkTyphoon: checks 
GovGus: bets $1.75
DrunkTyphoon: folds 
Uncalled bet ($1.75) returned to GovGus
GovGus collected $3.20 from pot
GovGus: doesn't show hand 
*** SUMMARY ***
Total pot $3.35 | Rake $0.15 
Board [Qs 7h Qc]
Seat 1: GovGus (button) collected ($3.20)
Seat 2: chiyuki (small blind) folded before Flop
Seat 3: AntoineHunt (big blind) folded before Flop
Seat 4: romanian c4 folded before Flop (didn't bet)
Seat 5: SAILUSI folded before Flop
Seat 6: jvds114 folded before Flop (didn't bet)
Seat 7: DrunkTyphoon folded on the Flop
Seat 8: HighDuka folded before Flop
Seat 9: nice.franki folded before Flop (didn't bet)



PokerStars Zoom Hand #84300784649:  Hold'em No Limit ($0.10/$0.25) - 2012/08/05 15:50:56 JST [2012/08/05 2:50:56 ET]
Table 'Whirlpool' 9-max Seat #1 is the button
Seat 1: kwkim73 ($27.98 in chips) 
Seat 2: Perstenev ($12.75 in chips) 
Seat 3: Fructionar ($37.47 in chips) 
Seat 4: xxx Spb xxx ($26.04 in chips) 
Seat 5: TorTrade ($26.14 in chips) 
Seat 6: KrystalAA ($13.57 in chips) 
Seat 7: hldtom ($13.75 in chips) 
Seat 8: 1Karina1 ($36.92 in chips) 
Seat 9: chiyuki ($51.36 in chips) 
Perstenev: posts small blind $0.10
Fructionar: posts big blind $0.25
*** HOLE CARDS ***
Dealt to chiyuki [9d Ks]
xxx Spb xxx: folds 
TorTrade: folds 
KrystalAA: folds 
hldtom: folds 
1Karina1: folds 
chiyuki: folds 
kwkim73: folds 
Perstenev: folds 
Uncalled bet ($0.15) returned to Fructionar
Fructionar collected $0.20 from pot
Fructionar: doesn't show hand 
*** SUMMARY ***
Total pot $0.20 | Rake $0 
Seat 1: kwkim73 (button) folded before Flop (didn't bet)
Seat 2: Perstenev (small blind) folded before Flop
Seat 3: Fructionar (big blind) collected ($0.20)
Seat 4: xxx Spb xxx folded before Flop (didn't bet)
Seat 5: TorTrade folded before Flop (didn't bet)
Seat 6: KrystalAA folded before Flop (didn't bet)
Seat 7: hldtom folded before Flop (didn't bet)
Seat 8: 1Karina1 folded before Flop (didn't bet)
Seat 9: chiyuki folded before Flop (didn't bet)



PokerStars Zoom Hand #84300786992:  Hold'em No Limit ($0.10/$0.25) - 2012/08/05 15:51:05 JST [2012/08/05 2:51:05 ET]
Table 'Whirlpool' 9-max Seat #1 is the button
Seat 1: tribunpdm ($84.90 in chips) 
Seat 2: Afcawins25 ($17.38 in chips) 
Seat 3: herkko11 ($9.03 in chips) 
Seat 4: silvno31 ($64.60 in chips) 
Seat 5: chiyuki ($51.36 in chips) 
Seat 6: Perstenev ($12.43 in chips) 
Seat 7: snejokCoxx ($10.75 in chips) 
Seat 8: GovGus ($42.76 in chips) 
Seat 9: Grishukps ($12.50 in chips) 
Afcawins25: posts small blind $0.10
herkko11: posts big blind $0.25
*** HOLE CARDS ***
Dealt to chiyuki [7h Js]
silvno31: folds 
chiyuki: folds 
Perstenev: folds 
snejokCoxx: folds 
GovGus: folds 
Grishukps: folds 
tribunpdm: folds 
Afcawins25: folds 
Uncalled bet ($0.15) returned to herkko11
herkko11 collected $0.20 from pot
herkko11: doesn't show hand 
*** SUMMARY ***
Total pot $0.20 | Rake $0 
Seat 1: tribunpdm (button) folded before Flop (didn't bet)
Seat 2: Afcawins25 (small blind) folded before Flop
Seat 3: herkko11 (big blind) collected ($0.20)
Seat 4: silvno31 folded before Flop (didn't bet)
Seat 5: chiyuki folded before Flop (didn't bet)
Seat 6: Perstenev folded before Flop (didn't bet)
Seat 7: snejokCoxx folded before Flop (didn't bet)
Seat 8: GovGus folded before Flop (didn't bet)
Seat 9: Grishukps folded before Flop (didn't bet)



PokerStars Zoom Hand #84300793749:  Hold'em No Limit ($0.10/$0.25) - 2012/08/05 15:51:32 JST [2012/08/05 2:51:32 ET]
Table 'Whirlpool' 9-max Seat #1 is the button
Seat 1: jacquelinewu ($31.23 in chips) 
Seat 2: snejokCoxx ($12.25 in chips) 
Seat 3: WARIBANA7777 ($15.46 in chips) 
Seat 4: Rilko1975 ($23.37 in chips) 
Seat 5: Afcawins25 ($17.03 in chips) 
Seat 6: herkko11 ($9.13 in chips) 
Seat 7: masterkoolb ($12.50 in chips) 
Seat 8: chiyuki ($51.36 in chips) 
Seat 9: Silveystryk ($25.12 in chips) 
snejokCoxx: posts small blind $0.10
WARIBANA7777: posts big blind $0.25
*** HOLE CARDS ***
Dealt to chiyuki [Qs Td]
Rilko1975: folds 
Afcawins25: folds 
herkko11: folds 
masterkoolb: folds 
chiyuki: folds 
Silveystryk: folds 
jacquelinewu: raises $0.50 to $0.75
snejokCoxx: folds 
WARIBANA7777: folds 
Uncalled bet ($0.50) returned to jacquelinewu
jacquelinewu collected $0.60 from pot
jacquelinewu: doesn't show hand 
*** SUMMARY ***
Total pot $0.60 | Rake $0 
Seat 1: jacquelinewu (button) collected ($0.60)
Seat 2: snejokCoxx (small blind) folded before Flop
Seat 3: WARIBANA7777 (big blind) folded before Flop
Seat 4: Rilko1975 folded before Flop (didn't bet)
Seat 5: Afcawins25 folded before Flop (didn't bet)
Seat 6: herkko11 folded before Flop (didn't bet)
Seat 7: masterkoolb folded before Flop (didn't bet)
Seat 8: chiyuki folded before Flop (didn't bet)
Seat 9: Silveystryk folded before Flop (didn't bet)



PokerStars Zoom Hand #84300796084:  Hold'em No Limit ($0.10/$0.25) - 2012/08/05 15:51:41 JST [2012/08/05 2:51:41 ET]
Table 'Whirlpool' 9-max Seat #1 is the button
Seat 1: chiyuki ($51.36 in chips) 
Seat 2: snejokCoxx ($11.75 in chips) 
Seat 3: Alvinpe85 ($67.84 in chips) 
Seat 4: phate-1up ($42.33 in chips) 
Seat 5: misskitty354 ($10.33 in chips) 
Seat 6: silvno31 ($64.35 in chips) 
Seat 7: Rilko1975 ($23.37 in chips) 
Seat 8: Saruotiss ($64.92 in chips) 
Seat 9: Spheroff ($7.62 in chips) 
snejokCoxx: posts small blind $0.10
Alvinpe85: posts big blind $0.25
*** HOLE CARDS ***
Dealt to chiyuki [Tc 4h]
phate-1up: folds 
misskitty354: raises $0.50 to $0.75
silvno31: folds 
Rilko1975: folds 
Saruotiss: folds 
Spheroff: folds 
chiyuki: folds 
snejokCoxx: folds 
Alvinpe85: folds 
Uncalled bet ($0.50) returned to misskitty354
misskitty354 collected $0.60 from pot
misskitty354: doesn't show hand 
*** SUMMARY ***
Total pot $0.60 | Rake $0 
Seat 1: chiyuki (button) folded before Flop (didn't bet)
Seat 2: snejokCoxx (small blind) folded before Flop
Seat 3: Alvinpe85 (big blind) folded before Flop
Seat 4: phate-1up folded before Flop (didn't bet)
Seat 5: misskitty354 collected ($0.60)
Seat 6: silvno31 folded before Flop (didn't bet)
Seat 7: Rilko1975 folded before Flop (didn't bet)
Seat 8: Saruotiss folded before Flop (didn't bet)
Seat 9: Spheroff folded before Flop (didn't bet)



PokerStars Zoom Hand #84300791121:  Hold'em No Limit ($0.10/$0.25) - 2012/08/05 15:51:22 JST [2012/08/05 2:51:22 ET]
Table 'Whirlpool' 9-max Seat #1 is the button
Seat 1: AntoineHunt ($34.71 in chips) 
Seat 2: Grishukps ($12.50 in chips) 
Seat 3: Dejacob ($25 in chips) 
Seat 4: GovGus ($53.48 in chips) 
Seat 5: Alvinpe85 ($44.80 in chips) 
Seat 6: chiyuki ($51.36 in chips) 
Seat 7: Kasperlmusik ($25.53 in chips) 
Seat 8: fil740 ($6.92 in chips) 
Seat 9: KeLevro0 ($12.15 in chips) 
Grishukps: posts small blind $0.10
Dejacob: posts big blind $0.25
*** HOLE CARDS ***
Dealt to chiyuki [5c Jc]
GovGus: folds 
Alvinpe85: folds 
chiyuki: folds 
Kasperlmusik: folds 
fil740: folds 
KeLevro0: folds 
AntoineHunt: raises $0.50 to $0.75
Grishukps: folds 
Dejacob: calls $0.50
*** FLOP *** [Ad Qh 9s]
Dejacob: checks 
AntoineHunt: bets $0.75
Dejacob: folds 
Uncalled bet ($0.75) returned to AntoineHunt
AntoineHunt collected $1.53 from pot
AntoineHunt: doesn't show hand 
*** SUMMARY ***
Total pot $1.60 | Rake $0.07 
Board [Ad Qh 9s]
Seat 1: AntoineHunt (button) collected ($1.53)
Seat 2: Grishukps (small blind) folded before Flop
Seat 3: Dejacob (big blind) folded on the Flop
Seat 4: GovGus folded before Flop (didn't bet)
Seat 5: Alvinpe85 folded before Flop (didn't bet)
Seat 6: chiyuki folded before Flop (didn't bet)
Seat 7: Kasperlmusik folded before Flop (didn't bet)
Seat 8: fil740 folded before Flop (didn't bet)
Seat 9: KeLevro0 folded before Flop (didn't bet)



PokerStars Zoom Hand #84300797849:  Hold'em No Limit ($0.10/$0.25) - 2012/08/05 15:51:48 JST [2012/08/05 2:51:48 ET]
Table 'Whirlpool' 9-max Seat #1 is the button
Seat 1: Rici47 ($39.59 in chips) 
Seat 2: Serge Claws ($30.82 in chips) 
Seat 3: INSP!RON ($35.41 in chips) 
Seat 4: jacquelinewu ($65.63 in chips) 
Seat 5: chiyuki ($51.36 in chips) 
Seat 6: silvno31 ($64.35 in chips) 
Seat 7: tribunpdm ($85.58 in chips) 
Seat 8: 1Karina1 ($36.67 in chips) 
Seat 9: MurMurRu ($25 in chips) 
Serge Claws: posts small blind $0.10
INSP!RON: posts big blind $0.25
*** HOLE CARDS ***
Dealt to chiyuki [9d 8s]
jacquelinewu: raises $0.50 to $0.75
chiyuki: folds 
silvno31: folds 
tribunpdm: folds 
1Karina1: folds 
MurMurRu: folds 
Rici47: folds 
Serge Claws: folds 
INSP!RON: folds 
Uncalled bet ($0.50) returned to jacquelinewu
jacquelinewu collected $0.60 from pot
jacquelinewu: doesn't show hand 
*** SUMMARY ***
Total pot $0.60 | Rake $0 
Seat 1: Rici47 (button) folded before Flop (didn't bet)
Seat 2: Serge Claws (small blind) folded before Flop
Seat 3: INSP!RON (big blind) folded before Flop
Seat 4: jacquelinewu collected ($0.60)
Seat 5: chiyuki folded before Flop (didn't bet)
Seat 6: silvno31 folded before Flop (didn't bet)
Seat 7: tribunpdm folded before Flop (didn't bet)
Seat 8: 1Karina1 folded before Flop (didn't bet)
Seat 9: MurMurRu folded before Flop (didn't bet)



PokerStars Zoom Hand #84300792653:  Hold'em No Limit ($0.10/$0.25) - 2012/08/05 15:51:28 JST [2012/08/05 2:51:28 ET]
Table 'Whirlpool' 9-max Seat #1 is the button
Seat 1: silvno31 ($64.35 in chips) 
Seat 2: Perstenev ($15 in chips) 
Seat 3: kwkim73 ($27.98 in chips) 
Seat 4: chiyuki ($51.36 in chips) 
Seat 5: KrystalAA ($13.57 in chips) 
Seat 6: kamikkaze ($21.47 in chips) 
Seat 7: HighDuka ($33.21 in chips) 
Seat 8: Afcawins25 ($17.03 in chips) 
Seat 9: Rilko1975 ($23.37 in chips) 
Perstenev: posts small blind $0.10
kwkim73: posts big blind $0.25
*** HOLE CARDS ***
Dealt to chiyuki [8s 9c]
chiyuki: folds 
KrystalAA: folds 
kamikkaze: raises $0.38 to $0.63
HighDuka: calls $0.63
Afcawins25: folds 
Rilko1975: folds 
silvno31: folds 
Perstenev: folds 
kwkim73: folds 
*** FLOP *** [Jc 3d 4c]
kamikkaze: checks 
HighDuka: bets $0.50
kamikkaze: raises $0.93 to $1.43
HighDuka: folds 
Uncalled bet ($0.93) returned to kamikkaze
kamikkaze collected $2.49 from pot
kamikkaze: doesn't show hand 
*** SUMMARY ***
Total pot $2.61 | Rake $0.12 
Board [Jc 3d 4c]
Seat 1: silvno31 (button) folded before Flop (didn't bet)
Seat 2: Perstenev (small blind) folded before Flop
Seat 3: kwkim73 (big blind) folded before Flop
Seat 4: chiyuki folded before Flop (didn't bet)
Seat 5: KrystalAA folded before Flop (didn't bet)
Seat 6: kamikkaze collected ($2.49)
Seat 7: HighDuka folded on the Flop
Seat 8: Afcawins25 folded before Flop (didn't bet)
Seat 9: Rilko1975 folded before Flop (didn't bet)



PokerStars Zoom Hand #84300795087:  Hold'em No Limit ($0.10/$0.25) - 2012/08/05 15:51:37 JST [2012/08/05 2:51:37 ET]
Table 'Whirlpool' 9-max Seat #1 is the button
Seat 1: Dejacob ($25 in chips) 
Seat 2: Saruotiss ($65.02 in chips) 
Seat 3: Afcawins25 ($17.03 in chips) 
Seat 4: Rilko1975 ($23.37 in chips) 
Seat 5: mjmichi ($68.98 in chips) 
Seat 6: KeLevro0 ($12.15 in chips) 
Seat 7: chiyuki ($51.36 in chips) 
Seat 8: silvno31 ($64.35 in chips) 
Seat 9: Perstenev ($12.08 in chips) 
Saruotiss: posts small blind $0.10
Afcawins25: posts big blind $0.25
*** HOLE CARDS ***
Dealt to chiyuki [9d 6h]
Rilko1975: folds 
mjmichi: folds 
KeLevro0: raises $0.42 to $0.67
chiyuki: folds 
silvno31: folds 
Perstenev: folds 
Dejacob: folds 
Saruotiss: folds 
Afcawins25: calls $0.42
*** FLOP *** [Ks 9c 7c]
Afcawins25: checks 
KeLevro0: bets $1.06
Afcawins25: calls $1.06
*** TURN *** [Ks 9c 7c] [3h]
Afcawins25: checks 
KeLevro0: bets $1.90
Afcawins25: calls $1.90
*** RIVER *** [Ks 9c 7c 3h] [8s]
Afcawins25: checks 
KeLevro0: checks 
*** SHOW DOWN ***
Afcawins25: shows [Jd 7h] (a pair of Sevens)
KeLevro0: shows [Jc Kc] (a pair of Kings)
KeLevro0 collected $7.03 from pot
*** SUMMARY ***
Total pot $7.36 | Rake $0.33 
Board [Ks 9c 7c 3h 8s]
Seat 1: Dejacob (button) folded before Flop (didn't bet)
Seat 2: Saruotiss (small blind) folded before Flop
Seat 3: Afcawins25 (big blind) showed [Jd 7h] and lost with a pair of Sevens
Seat 4: Rilko1975 folded before Flop (didn't bet)
Seat 5: mjmichi folded before Flop (didn't bet)
Seat 6: KeLevro0 showed [Jc Kc] and won ($7.03) with a pair of Kings
Seat 7: chiyuki folded before Flop (didn't bet)
Seat 8: silvno31 folded before Flop (didn't bet)
Seat 9: Perstenev folded before Flop (didn't bet)



PokerStars Zoom Hand #84300804830:  Hold'em No Limit ($0.10/$0.25) - 2012/08/05 15:52:15 JST [2012/08/05 2:52:15 ET]
Table 'Whirlpool' 9-max Seat #1 is the button
Seat 1: Alvinpe85 ($44.80 in chips) 
Seat 2: nice.franki ($5.95 in chips) 
Seat 3: masterkoolb ($13.52 in chips) 
Seat 4: Grishukps ($12.50 in chips) 
Seat 5: Nerkit ($12.27 in chips) 
Seat 6: 1Karina1 ($36.57 in chips) 
Seat 7: GSDP ($24.39 in chips) 
Seat 8: Ellen1947 ($31.15 in chips) 
Seat 9: chiyuki ($51.26 in chips) 
nice.franki: posts small blind $0.10
masterkoolb: posts big blind $0.25
*** HOLE CARDS ***
Dealt to chiyuki [Js 8s]
Grishukps: folds 
Nerkit: raises $0.50 to $0.75
1Karina1: folds 
GSDP: folds 
Ellen1947: folds 
chiyuki: folds 
Alvinpe85: folds 
nice.franki: folds 
masterkoolb: folds 
Uncalled bet ($0.50) returned to Nerkit
Nerkit collected $0.60 from pot
Nerkit: doesn't show hand 
*** SUMMARY ***
Total pot $0.60 | Rake $0 
Seat 1: Alvinpe85 (button) folded before Flop (didn't bet)
Seat 2: nice.franki (small blind) folded before Flop
Seat 3: masterkoolb (big blind) folded before Flop
Seat 4: Grishukps folded before Flop (didn't bet)
Seat 5: Nerkit collected ($0.60)
Seat 6: 1Karina1 folded before Flop (didn't bet)
Seat 7: GSDP folded before Flop (didn't bet)
Seat 8: Ellen1947 folded before Flop (didn't bet)
Seat 9: chiyuki folded before Flop (didn't bet)



PokerStars Zoom Hand #84300805828:  Hold'em No Limit ($0.10/$0.25) - 2012/08/05 15:52:20 JST [2012/08/05 2:52:20 ET]
Table 'Whirlpool' 9-max Seat #1 is the button
Seat 1: panaam ($36.51 in chips) 
Seat 2: Perstenev ($10.83 in chips) 
Seat 3: chiyuki ($51.26 in chips) 
Seat 4: Faantomace ($32.95 in chips) 
Seat 5: 1Karina1 ($36.57 in chips) 
Seat 6: Spheroff ($7.37 in chips) 
Seat 7: drunk_bender ($11.01 in chips) 
Seat 8: Dejacob ($26.93 in chips) 
Seat 9: aivvo ($6.50 in chips) 
Perstenev: posts small blind $0.10
chiyuki: posts big blind $0.25
*** HOLE CARDS ***
Dealt to chiyuki [Qd 2s]
Faantomace: folds 
1Karina1: folds 
Spheroff: folds 
drunk_bender: folds 
Dejacob: folds 
aivvo: folds 
panaam: folds 
Perstenev: folds 
Uncalled bet ($0.15) returned to chiyuki
chiyuki collected $0.20 from pot
chiyuki: doesn't show hand 
*** SUMMARY ***
Total pot $0.20 | Rake $0 
Seat 1: panaam (button) folded before Flop (didn't bet)
Seat 2: Perstenev (small blind) folded before Flop
Seat 3: chiyuki (big blind) collected ($0.20)
Seat 4: Faantomace folded before Flop (didn't bet)
Seat 5: 1Karina1 folded before Flop (didn't bet)
Seat 6: Spheroff folded before Flop (didn't bet)
Seat 7: drunk_bender folded before Flop (didn't bet)
Seat 8: Dejacob folded before Flop (didn't bet)
Seat 9: aivvo folded before Flop (didn't bet)



PokerStars Zoom Hand #84300801709:  Hold'em No Limit ($0.10/$0.25) - 2012/08/05 15:52:03 JST [2012/08/05 2:52:03 ET]
Table 'Whirlpool' 9-max Seat #1 is the button
Seat 1: kkbruins0408 ($9.77 in chips) 
Seat 2: chiyuki ($51.36 in chips) 
Seat 3: KeLevro0 ($11.41 in chips) 
Seat 4: Dejacob ($26.93 in chips) 
Seat 5: tribunpdm ($85.48 in chips) 
Seat 6: Silveystryk ($21.79 in chips) 
Seat 7: masterkoolb ($13.65 in chips) 
Seat 8: ShockLaMuc ($24.78 in chips) 
Seat 9: AntoineHunt ($35.49 in chips) 
chiyuki: posts small blind $0.10
KeLevro0: posts big blind $0.25
*** HOLE CARDS ***
Dealt to chiyuki [Kh 7h]
Dejacob: folds 
tribunpdm: raises $0.50 to $0.75
Silveystryk: folds 
masterkoolb: folds 
ShockLaMuc: folds 
AntoineHunt: raises $1.75 to $2.50
kkbruins0408: folds 
chiyuki: folds 
KeLevro0: folds 
tribunpdm: calls $1.75
*** FLOP *** [Kc Tc 6d]
tribunpdm: checks 
AntoineHunt: bets $2.50
tribunpdm: folds 
Uncalled bet ($2.50) returned to AntoineHunt
AntoineHunt collected $5.11 from pot
AntoineHunt: doesn't show hand 
*** SUMMARY ***
Total pot $5.35 | Rake $0.24 
Board [Kc Tc 6d]
Seat 1: kkbruins0408 (button) folded before Flop (didn't bet)
Seat 2: chiyuki (small blind) folded before Flop
Seat 3: KeLevro0 (big blind) folded before Flop
Seat 4: Dejacob folded before Flop (didn't bet)
Seat 5: tribunpdm folded on the Flop
Seat 6: Silveystryk folded before Flop (didn't bet)
Seat 7: masterkoolb folded before Flop (didn't bet)
Seat 8: ShockLaMuc folded before Flop (didn't bet)
Seat 9: AntoineHunt collected ($5.11)



PokerStars Zoom Hand #84300811819:  Hold'em No Limit ($0.10/$0.25) - 2012/08/05 15:52:43 JST [2012/08/05 2:52:43 ET]
Table 'Whirlpool' 9-max Seat #1 is the button
Seat 1: Alvinpe85 ($44.80 in chips) 
Seat 2: Perstenev ($13.60 in chips) 
Seat 3: Lasutchik ($11.17 in chips) 
Seat 4: INSP!RON ($35.51 in chips) 
Seat 5: 1Karina1 ($35.47 in chips) 
Seat 6: phate-1up ($42.58 in chips) 
Seat 7: ChrisCDee ($58.02 in chips) 
Seat 8: chiyuki ($51.36 in chips) 
Seat 9: kwkim73 ($25 in chips) 
Perstenev: posts small blind $0.10
Lasutchik: posts big blind $0.25
*** HOLE CARDS ***
Dealt to chiyuki [8h 5s]
INSP!RON: folds 
1Karina1: folds 
phate-1up: folds 
ChrisCDee: folds 
chiyuki: folds 
kwkim73: raises $0.50 to $0.75
Alvinpe85: folds 
Perstenev: folds 
Lasutchik: folds 
Uncalled bet ($0.50) returned to kwkim73
kwkim73 collected $0.60 from pot
kwkim73: doesn't show hand 
*** SUMMARY ***
Total pot $0.60 | Rake $0 
Seat 1: Alvinpe85 (button) folded before Flop (didn't bet)
Seat 2: Perstenev (small blind) folded before Flop
Seat 3: Lasutchik (big blind) folded before Flop
Seat 4: INSP!RON folded before Flop (didn't bet)
Seat 5: 1Karina1 folded before Flop (didn't bet)
Seat 6: phate-1up folded before Flop (didn't bet)
Seat 7: ChrisCDee folded before Flop (didn't bet)
Seat 8: chiyuki folded before Flop (didn't bet)
Seat 9: kwkim73 collected ($0.60)



PokerStars Zoom Hand #84300812614:  Hold'em No Limit ($0.10/$0.25) - 2012/08/05 15:52:46 JST [2012/08/05 2:52:46 ET]
Table 'Whirlpool' 9-max Seat #1 is the button
Seat 1: Rilko1975 ($23.37 in chips) 
Seat 2: KeLevro0 ($15.30 in chips) 
Seat 3: Perstenev ($10.73 in chips) 
Seat 4: MurMurRu ($25 in chips) 
Seat 5: kkbruins0408 ($9.67 in chips) 
Seat 6: Kasperlmusik ($25 in chips) 
Seat 7: chiyuki ($51.36 in chips) 
Seat 8: INSP!RON ($35.51 in chips) 
Seat 9: 1Karina1 ($35.47 in chips) 
KeLevro0: posts small blind $0.10
Perstenev: posts big blind $0.25
*** HOLE CARDS ***
Dealt to chiyuki [7h As]
MurMurRu: folds 
kkbruins0408: folds 
Kasperlmusik: folds 
chiyuki: folds 
INSP!RON: folds 
1Karina1: folds 
Rilko1975: raises $0.50 to $0.75
KeLevro0: folds 
Perstenev: folds 
Uncalled bet ($0.50) returned to Rilko1975
Rilko1975 collected $0.60 from pot
Rilko1975: doesn't show hand 
*** SUMMARY ***
Total pot $0.60 | Rake $0 
Seat 1: Rilko1975 (button) collected ($0.60)
Seat 2: KeLevro0 (small blind) folded before Flop
Seat 3: Perstenev (big blind) folded before Flop
Seat 4: MurMurRu folded before Flop (didn't bet)
Seat 5: kkbruins0408 folded before Flop (didn't bet)
Seat 6: Kasperlmusik folded before Flop (didn't bet)
Seat 7: chiyuki folded before Flop (didn't bet)
Seat 8: INSP!RON folded before Flop (didn't bet)
Seat 9: 1Karina1 folded before Flop (didn't bet)



PokerStars Zoom Hand #84300800928:  Hold'em No Limit ($0.10/$0.25) - 2012/08/05 15:52:00 JST [2012/08/05 2:52:00 ET]
Table 'Whirlpool' 9-max Seat #1 is the button
Seat 1: Kasperlmusik ($31.95 in chips) 
Seat 2: jacquelinewu ($26.11 in chips) 
Seat 3: dergeb ($17.75 in chips) 
Seat 4: chiyuki ($51.36 in chips) 
Seat 5: opie62 ($20.30 in chips) 
Seat 6: soul_5577 ($37.03 in chips) 
Seat 7: Perstenev ($10.83 in chips) 
Seat 8: Nerkit ($12.27 in chips) 
Seat 9: Fructionar ($37.07 in chips) 
jacquelinewu: posts small blind $0.10
dergeb: posts big blind $0.25
*** HOLE CARDS ***
Dealt to chiyuki [Kd 8h]
chiyuki: folds 
opie62: folds 
soul_5577: raises $0.25 to $0.50
Perstenev: folds 
Nerkit: folds 
Fructionar: folds 
Kasperlmusik: folds 
jacquelinewu: calls $0.40
dergeb: calls $0.25
*** FLOP *** [3s Qh 7s]
jacquelinewu: checks 
dergeb: checks 
soul_5577: checks 
*** TURN *** [3s Qh 7s] [6s]
jacquelinewu: checks 
dergeb: checks 
soul_5577: checks 
*** RIVER *** [3s Qh 7s 6s] [4h]
jacquelinewu: checks 
dergeb: checks 
soul_5577: checks 
*** SHOW DOWN ***
jacquelinewu: shows [8s 8d] (a pair of Eights)
dergeb: mucks hand 
soul_5577: mucks hand 
jacquelinewu collected $1.43 from pot
*** SUMMARY ***
Total pot $1.50 | Rake $0.07 
Board [3s Qh 7s 6s 4h]
Seat 1: Kasperlmusik (button) folded before Flop (didn't bet)
Seat 2: jacquelinewu (small blind) showed [8s 8d] and won ($1.43) with a pair of Eights
Seat 3: dergeb (big blind) mucked [Ad 6c]
Seat 4: chiyuki folded before Flop (didn't bet)
Seat 5: opie62 folded before Flop (didn't bet)
Seat 6: soul_5577 mucked [Tc Jc]
Seat 7: Perstenev folded before Flop (didn't bet)
Seat 8: Nerkit folded before Flop (didn't bet)
Seat 9: Fructionar folded before Flop (didn't bet)



PokerStars Zoom Hand #84300815184:  Hold'em No Limit ($0.10/$0.25) - 2012/08/05 15:52:56 JST [2012/08/05 2:52:56 ET]
Table 'Whirlpool' 9-max Seat #1 is the button
Seat 1: vpetrovi ($11.57 in chips) 
Seat 2: INSP!RON ($35.51 in chips) 
Seat 3: Dejacob ($26.93 in chips) 
Seat 4: nice.franki ($8.23 in chips) 
Seat 5: chiyuki ($51.36 in chips) 
Seat 6: snejokCoxx ($12.15 in chips) 
Seat 7: Alvinpe85 ($67.59 in chips) 
Seat 8: Rici47 ($35.21 in chips) 
Seat 9: misskitty354 ($9.40 in chips) 
INSP!RON: posts small blind $0.10
Dejacob: posts big blind $0.25
*** HOLE CARDS ***
Dealt to chiyuki [3h Ks]
nice.franki: folds 
chiyuki: folds 
snejokCoxx: folds 
Alvinpe85: raises $0.50 to $0.75
Rici47: folds 
misskitty354: folds 
vpetrovi: folds 
INSP!RON: folds 
Dejacob: folds 
Uncalled bet ($0.50) returned to Alvinpe85
Alvinpe85 collected $0.60 from pot
Alvinpe85: doesn't show hand 
*** SUMMARY ***
Total pot $0.60 | Rake $0 
Seat 1: vpetrovi (button) folded before Flop (didn't bet)
Seat 2: INSP!RON (small blind) folded before Flop
Seat 3: Dejacob (big blind) folded before Flop
Seat 4: nice.franki folded before Flop (didn't bet)
Seat 5: chiyuki folded before Flop (didn't bet)
Seat 6: snejokCoxx folded before Flop (didn't bet)
Seat 7: Alvinpe85 collected ($0.60)
Seat 8: Rici47 folded before Flop (didn't bet)
Seat 9: misskitty354 folded before Flop (didn't bet)



PokerStars Zoom Hand #84300813867:  Hold'em No Limit ($0.10/$0.25) - 2012/08/05 15:52:51 JST [2012/08/05 2:52:51 ET]
Table 'Whirlpool' 9-max Seat #1 is the button
Seat 1: KeLevro0 ($15.20 in chips) 
Seat 2: herkko11 ($9.13 in chips) 
Seat 3: 1Karina1 ($35.47 in chips) 
Seat 4: Saruotiss ($63.43 in chips) 
Seat 5: Kasperlmusik ($25 in chips) 
Seat 6: chiyuki ($51.36 in chips) 
Seat 7: INSP!RON ($35.51 in chips) 
Seat 8: MurMurRu ($25 in chips) 
Seat 9: pandaaaaaa ($13.80 in chips) 
herkko11: posts small blind $0.10
1Karina1: posts big blind $0.25
*** HOLE CARDS ***
Dealt to chiyuki [7h 2s]
Saruotiss: folds 
Kasperlmusik: folds 
chiyuki: folds 
INSP!RON: folds 
MurMurRu: raises $0.42 to $0.67
pandaaaaaa: folds 
KeLevro0: folds 
herkko11: calls $0.57
1Karina1: folds 
*** FLOP *** [As Ac Ts]
herkko11: checks 
MurMurRu: bets $1.29
herkko11: raises $1.29 to $2.58
MurMurRu: folds 
Uncalled bet ($1.29) returned to herkko11
herkko11 collected $3.98 from pot
herkko11: doesn't show hand 
*** SUMMARY ***
Total pot $4.17 | Rake $0.19 
Board [As Ac Ts]
Seat 1: KeLevro0 (button) folded before Flop (didn't bet)
Seat 2: herkko11 (small blind) collected ($3.98)
Seat 3: 1Karina1 (big blind) folded before Flop
Seat 4: Saruotiss folded before Flop (didn't bet)
Seat 5: Kasperlmusik folded before Flop (didn't bet)
Seat 6: chiyuki folded before Flop (didn't bet)
Seat 7: INSP!RON folded before Flop (didn't bet)
Seat 8: MurMurRu folded on the Flop
Seat 9: pandaaaaaa folded before Flop (didn't bet)



PokerStars Zoom Hand #84300816208:  Hold'em No Limit ($0.10/$0.25) - 2012/08/05 15:53:00 JST [2012/08/05 2:53:00 ET]
Table 'Whirlpool' 9-max Seat #1 is the button
Seat 1: Limoilou ($28.57 in chips) 
Seat 2: pandaaaaaa ($13.80 in chips) 
Seat 3: leo2095 ($28.50 in chips) 
Seat 4: Rici47 ($35.21 in chips) 
Seat 5: ViTiV2010 ($12.50 in chips) 
Seat 6: ShockLaMuc ($26 in chips) 
Seat 7: INSP!RON ($37.54 in chips) 
Seat 8: slapshot2011 ($19.69 in chips) 
Seat 9: chiyuki ($51.36 in chips) 
pandaaaaaa: posts small blind $0.10
leo2095: posts big blind $0.25
*** HOLE CARDS ***
Dealt to chiyuki [3h Td]
Rici47: folds 
ViTiV2010: folds 
ShockLaMuc: raises $0.50 to $0.75
INSP!RON: folds 
slapshot2011: folds 
chiyuki: folds 
Limoilou: folds 
pandaaaaaa: raises $3.25 to $4
leo2095: folds 
ShockLaMuc: folds 
Uncalled bet ($3.25) returned to pandaaaaaa
pandaaaaaa collected $1.75 from pot
pandaaaaaa: doesn't show hand 
*** SUMMARY ***
Total pot $1.75 | Rake $0 
Seat 1: Limoilou (button) folded before Flop (didn't bet)
Seat 2: pandaaaaaa (small blind) collected ($1.75)
Seat 3: leo2095 (big blind) folded before Flop
Seat 4: Rici47 folded before Flop (didn't bet)
Seat 5: ViTiV2010 folded before Flop (didn't bet)
Seat 6: ShockLaMuc folded before Flop
Seat 7: INSP!RON folded before Flop (didn't bet)
Seat 8: slapshot2011 folded before Flop (didn't bet)
Seat 9: chiyuki folded before Flop (didn't bet)



PokerStars Zoom Hand #84300818561:  Hold'em No Limit ($0.10/$0.25) - 2012/08/05 15:53:09 JST [2012/08/05 2:53:09 ET]
Table 'Whirlpool' 9-max Seat #1 is the button
Seat 1: ViTiV2010 ($9.69 in chips) 
Seat 2: chiyuki ($51.36 in chips) 
Seat 3: snejokCoxx ($11.10 in chips) 
Seat 4: xxx Spb xxx ($28.76 in chips) 
Seat 5: kwkim73 ($25.35 in chips) 
Seat 6: Serge Claws ($25.78 in chips) 
Seat 7: romanian c4 ($3.08 in chips) 
Seat 8: HighDuka ($34.22 in chips) 
Seat 9: Afcawins25 ($12.65 in chips) 
chiyuki: posts small blind $0.10
snejokCoxx: posts big blind $0.25
*** HOLE CARDS ***
Dealt to chiyuki [3h Ks]
xxx Spb xxx: raises $0.50 to $0.75
kwkim73: folds 
Serge Claws: folds 
romanian c4: folds 
HighDuka: folds 
Afcawins25: raises $1.50 to $2.25
ViTiV2010: folds 
chiyuki: folds 
snejokCoxx: folds 
xxx Spb xxx: folds 
Uncalled bet ($1.50) returned to Afcawins25
Afcawins25 collected $1.85 from pot
Afcawins25: doesn't show hand 
*** SUMMARY ***
Total pot $1.85 | Rake $0 
Seat 1: ViTiV2010 (button) folded before Flop (didn't bet)
Seat 2: chiyuki (small blind) folded before Flop
Seat 3: snejokCoxx (big blind) folded before Flop
Seat 4: xxx Spb xxx folded before Flop
Seat 5: kwkim73 folded before Flop (didn't bet)
Seat 6: Serge Claws folded before Flop (didn't bet)
Seat 7: romanian c4 folded before Flop (didn't bet)
Seat 8: HighDuka folded before Flop (didn't bet)
Seat 9: Afcawins25 collected ($1.85)



PokerStars Zoom Hand #84300825274:  Hold'em No Limit ($0.10/$0.25) - 2012/08/05 15:53:36 JST [2012/08/05 2:53:36 ET]
Table 'Whirlpool' 9-max Seat #1 is the button
Seat 1: silvno31 ($59.85 in chips) 
Seat 2: ChrisCDee ($44.99 in chips) 
Seat 3: phate-1up ($51.57 in chips) 
Seat 4: KeLevro0 ($14.53 in chips) 
Seat 5: Ellen1947 ($31.15 in chips) 
Seat 6: GSDP ($46.43 in chips) 
Seat 7: yvasilik ($24.77 in chips) 
Seat 8: chiyuki ($51.26 in chips) 
Seat 9: kamikkaze ($18.40 in chips) 
ChrisCDee: posts small blind $0.10
phate-1up: posts big blind $0.25
*** HOLE CARDS ***
Dealt to chiyuki [8h Kh]
KeLevro0: folds 
Ellen1947: folds 
GSDP: folds 
yvasilik: folds 
chiyuki: folds 
kamikkaze: folds 
silvno31: folds 
ChrisCDee: folds 
Uncalled bet ($0.15) returned to phate-1up
phate-1up collected $0.20 from pot
phate-1up: doesn't show hand 
*** SUMMARY ***
Total pot $0.20 | Rake $0 
Seat 1: silvno31 (button) folded before Flop (didn't bet)
Seat 2: ChrisCDee (small blind) folded before Flop
Seat 3: phate-1up (big blind) collected ($0.20)
Seat 4: KeLevro0 folded before Flop (didn't bet)
Seat 5: Ellen1947 folded before Flop (didn't bet)
Seat 6: GSDP folded before Flop (didn't bet)
Seat 7: yvasilik folded before Flop (didn't bet)
Seat 8: chiyuki folded before Flop (didn't bet)
Seat 9: kamikkaze folded before Flop (didn't bet)



PokerStars Zoom Hand #84300828054:  Hold'em No Limit ($0.10/$0.25) - 2012/08/05 15:53:47 JST [2012/08/05 2:53:47 ET]
Table 'Whirlpool' 9-max Seat #1 is the button
Seat 1: phate-1up ($42.23 in chips) 
Seat 2: ShockLaMuc ($25 in chips) 
Seat 3: Dejacob ($26.02 in chips) 
Seat 4: jacquelinewu ($28.06 in chips) 
Seat 5: yoube ($24.15 in chips) 
Seat 6: chiyuki ($51.26 in chips) 
Seat 7: Rici47 ($42.13 in chips) 
Seat 8: Afcawins25 ($13.75 in chips) 
Seat 9: KeLevro0 ($10.39 in chips) 
ShockLaMuc: posts small blind $0.10
Dejacob: posts big blind $0.25
*** HOLE CARDS ***
Dealt to chiyuki [Jh 9d]
jacquelinewu: folds 
yoube: folds 
chiyuki: folds 
Rici47: folds 
Afcawins25: folds 
KeLevro0: folds 
phate-1up: folds 
ShockLaMuc: folds 
Uncalled bet ($0.15) returned to Dejacob
Dejacob collected $0.20 from pot
Dejacob: doesn't show hand 
*** SUMMARY ***
Total pot $0.20 | Rake $0 
Seat 1: phate-1up (button) folded before Flop (didn't bet)
Seat 2: ShockLaMuc (small blind) folded before Flop
Seat 3: Dejacob (big blind) collected ($0.20)
Seat 4: jacquelinewu folded before Flop (didn't bet)
Seat 5: yoube folded before Flop (didn't bet)
Seat 6: chiyuki folded before Flop (didn't bet)
Seat 7: Rici47 folded before Flop (didn't bet)
Seat 8: Afcawins25 folded before Flop (didn't bet)
Seat 9: KeLevro0 folded before Flop (didn't bet)



PokerStars Zoom Hand #84300817508:  Hold'em No Limit ($0.10/$0.25) - 2012/08/05 15:53:05 JST [2012/08/05 2:53:05 ET]
Table 'Whirlpool' 9-max Seat #1 is the button
Seat 1: Perstenev ($13.25 in chips) 
Seat 2: misskitty354 ($9.40 in chips) 
Seat 3: kesstukas25 ($18.43 in chips) 
Seat 4: chiyuki ($51.36 in chips) 
Seat 5: DrunkTyphoon ($28.99 in chips) 
Seat 6: drunk_bender ($11.36 in chips) 
Seat 7: nice.franki ($10.75 in chips) 
Seat 8: romanian c4 ($3.08 in chips) 
Seat 9: KrystalAA ($44.55 in chips) 
misskitty354: posts small blind $0.10
kesstukas25: posts big blind $0.25
*** HOLE CARDS ***
Dealt to chiyuki [8h Jc]
chiyuki: folds 
DrunkTyphoon: raises $0.50 to $0.75
drunk_bender: folds 
nice.franki: raises $1.25 to $2
romanian c4: folds 
KrystalAA: folds 
Perstenev: folds 
misskitty354: folds 
kesstukas25: folds 
DrunkTyphoon: raises $10.50 to $12.50
nice.franki: calls $8.75 and is all-in
Uncalled bet ($1.75) returned to DrunkTyphoon
*** FLOP *** [4s 5h 5s]
*** TURN *** [4s 5h 5s] [7c]
*** RIVER *** [4s 5h 5s 7c] [4h]
*** SHOW DOWN ***
DrunkTyphoon: shows [Ks Kc] (two pair, Kings and Fives)
nice.franki: shows [Ad Kd] (two pair, Fives and Fours)
DrunkTyphoon collected $20.87 from pot
*** SUMMARY ***
Total pot $21.85 | Rake $0.98 
Board [4s 5h 5s 7c 4h]
Seat 1: Perstenev (button) folded before Flop (didn't bet)
Seat 2: misskitty354 (small blind) folded before Flop
Seat 3: kesstukas25 (big blind) folded before Flop
Seat 4: chiyuki folded before Flop (didn't bet)
Seat 5: DrunkTyphoon showed [Ks Kc] and won ($20.87) with two pair, Kings and Fives
Seat 6: drunk_bender folded before Flop (didn't bet)
Seat 7: nice.franki showed [Ad Kd] and lost with two pair, Fives and Fours
Seat 8: romanian c4 folded before Flop (didn't bet)
Seat 9: KrystalAA folded before Flop (didn't bet)



PokerStars Zoom Hand #84300810758:  Hold'em No Limit ($0.10/$0.25) - 2012/08/05 15:52:39 JST [2012/08/05 2:52:39 ET]
Table 'Whirlpool' 9-max Seat #1 is the button
Seat 1: chiyuki ($51.36 in chips) 
Seat 2: ViTiV2010 ($9.79 in chips) 
Seat 3: PPP7SSS ($10.78 in chips) 
Seat 4: Alvinpe85 ($44.80 in chips) 
Seat 5: MurMurRu ($25 in chips) 
Seat 6: Dejacob ($26.93 in chips) 
Seat 7: nice.franki ($12.93 in chips) 
Seat 8: Trip_Krowns ($25.22 in chips) 
Seat 9: Grishukps ($12.50 in chips) 
ViTiV2010: posts small blind $0.10
PPP7SSS: posts big blind $0.25
*** HOLE CARDS ***
Dealt to chiyuki [6d 5c]
Alvinpe85: folds 
MurMurRu: folds 
Dejacob: folds 
nice.franki: folds 
Trip_Krowns: raises $0.50 to $0.75
Grishukps: calls $0.75
chiyuki: folds 
ViTiV2010: folds 
PPP7SSS: raises $0.50 to $1.25
Trip_Krowns: calls $0.50
Grishukps: calls $0.50
*** FLOP *** [2s 8s Kd]
PPP7SSS: checks 
Trip_Krowns: bets $1.50
Grishukps: calls $1.50
PPP7SSS: folds 
*** TURN *** [2s 8s Kd] [6h]
Trip_Krowns: bets $3
Grishukps: calls $3
*** RIVER *** [2s 8s Kd 6h] [9h]
Trip_Krowns: bets $7
Grishukps: folds 
Uncalled bet ($7) returned to Trip_Krowns
Trip_Krowns collected $12.27 from pot
Trip_Krowns: doesn't show hand 
*** SUMMARY ***
Total pot $12.85 | Rake $0.58 
Board [2s 8s Kd 6h 9h]
Seat 1: chiyuki (button) folded before Flop (didn't bet)
Seat 2: ViTiV2010 (small blind) folded before Flop
Seat 3: PPP7SSS (big blind) folded on the Flop
Seat 4: Alvinpe85 folded before Flop (didn't bet)
Seat 5: MurMurRu folded before Flop (didn't bet)
Seat 6: Dejacob folded before Flop (didn't bet)
Seat 7: nice.franki folded before Flop (didn't bet)
Seat 8: Trip_Krowns collected ($12.27)
Seat 9: Grishukps folded on the River



PokerStars Zoom Hand #84300829592:  Hold'em No Limit ($0.10/$0.25) - 2012/08/05 15:53:53 JST [2012/08/05 2:53:53 ET]
Table 'Whirlpool' 9-max Seat #1 is the button
Seat 1: kesstukas25 ($17.81 in chips) 
Seat 2: slapshot2011 ($19.44 in chips) 
Seat 3: chiyuki ($51.26 in chips) 
Seat 4: ShockLaMuc ($23.15 in chips) 
Seat 5: soul_5577 ($36.18 in chips) 
Seat 6: SAILUSI ($32.42 in chips) 
Seat 7: hldtom ($13.95 in chips) 
Seat 8: ChrisCDee ($58.94 in chips) 
Seat 9: KeLevro0 ($12.15 in chips) 
slapshot2011: posts small blind $0.10
chiyuki: posts big blind $0.25
*** HOLE CARDS ***
Dealt to chiyuki [5s 9d]
ShockLaMuc: folds 
soul_5577: folds 
SAILUSI: folds 
hldtom: folds 
ChrisCDee: folds 
KeLevro0: raises $0.42 to $0.67
kesstukas25: folds 
slapshot2011: calls $0.57
chiyuki: folds 
*** FLOP *** [As 4h 3h]
slapshot2011: checks 
KeLevro0: bets $0.85
slapshot2011: folds 
Uncalled bet ($0.85) returned to KeLevro0
KeLevro0 collected $1.52 from pot
KeLevro0: doesn't show hand 
KeLevro0 is disconnected 
*** SUMMARY ***
Total pot $1.59 | Rake $0.07 
Board [As 4h 3h]
Seat 1: kesstukas25 (button) folded before Flop (didn't bet)
Seat 2: slapshot2011 (small blind) folded on the Flop
Seat 3: chiyuki (big blind) folded before Flop
Seat 4: ShockLaMuc folded before Flop (didn't bet)
Seat 5: soul_5577 folded before Flop (didn't bet)
Seat 6: SAILUSI folded before Flop (didn't bet)
Seat 7: hldtom folded before Flop (didn't bet)
Seat 8: ChrisCDee folded before Flop (didn't bet)
Seat 9: KeLevro0 collected ($1.52)



PokerStars Zoom Hand #84300836074:  Hold'em No Limit ($0.10/$0.25) - 2012/08/05 15:54:18 JST [2012/08/05 2:54:18 ET]
Table 'Whirlpool' 9-max Seat #1 is the button
Seat 1: ViTiV2010 ($13.15 in chips) 
Seat 2: Ellen1947 ($30.90 in chips) 
Seat 3: risekuku468 ($34.51 in chips) 
Seat 4: 1Karina1 ($25 in chips) 
Seat 5: chiyuki ($51.01 in chips) 
Seat 6: hldtom ($14.28 in chips) 
Seat 7: Faantomace ($34.89 in chips) 
Seat 8: ShockLaMuc ($24.90 in chips) 
Seat 9: nice.franki ($12.40 in chips) 
Ellen1947: posts small blind $0.10
risekuku468: posts big blind $0.25
*** HOLE CARDS ***
Dealt to chiyuki [8c Kh]
1Karina1: folds 
chiyuki: folds 
hldtom: folds 
Faantomace: folds 
ShockLaMuc: folds 
nice.franki: raises $0.37 to $0.62
ViTiV2010: folds 
Ellen1947: folds 
risekuku468: folds 
Uncalled bet ($0.37) returned to nice.franki
nice.franki collected $0.60 from pot
nice.franki: doesn't show hand 
*** SUMMARY ***
Total pot $0.60 | Rake $0 
Seat 1: ViTiV2010 (button) folded before Flop (didn't bet)
Seat 2: Ellen1947 (small blind) folded before Flop
Seat 3: risekuku468 (big blind) folded before Flop
Seat 4: 1Karina1 folded before Flop (didn't bet)
Seat 5: chiyuki folded before Flop (didn't bet)
Seat 6: hldtom folded before Flop (didn't bet)
Seat 7: Faantomace folded before Flop (didn't bet)
Seat 8: ShockLaMuc folded before Flop (didn't bet)
Seat 9: nice.franki collected ($0.60)



PokerStars Zoom Hand #84300842214:  Hold'em No Limit ($0.10/$0.25) - 2012/08/05 15:54:42 JST [2012/08/05 2:54:42 ET]
Table 'Whirlpool' 9-max Seat #1 is the button
Seat 1: Femali54 ($26.77 in chips) 
Seat 2: Spheroff ($10.02 in chips) 
Seat 3: leo2095 ($28 in chips) 
Seat 4: River_GmbH ($21.54 in chips) 
Seat 5: Grishukps ($12.50 in chips) 
Seat 6: opie62 ($25.28 in chips) 
Seat 7: chiyuki ($51.01 in chips) 
Seat 8: Jene4kaBest ($16.18 in chips) 
Seat 9: Perstenev ($12.40 in chips) 
Spheroff: posts small blind $0.10
leo2095: posts big blind $0.25
*** HOLE CARDS ***
Dealt to chiyuki [Qd 9h]
River_GmbH: folds 
Grishukps: raises $0.50 to $0.75
opie62: folds 
chiyuki: folds 
Jene4kaBest: folds 
Perstenev: folds 
Femali54: folds 
Spheroff: folds 
leo2095: folds 
Uncalled bet ($0.50) returned to Grishukps
Grishukps collected $0.60 from pot
Grishukps: doesn't show hand 
*** SUMMARY ***
Total pot $0.60 | Rake $0 
Seat 1: Femali54 (button) folded before Flop (didn't bet)
Seat 2: Spheroff (small blind) folded before Flop
Seat 3: leo2095 (big blind) folded before Flop
Seat 4: River_GmbH folded before Flop (didn't bet)
Seat 5: Grishukps collected ($0.60)
Seat 6: opie62 folded before Flop (didn't bet)
Seat 7: chiyuki folded before Flop (didn't bet)
Seat 8: Jene4kaBest folded before Flop (didn't bet)
Seat 9: Perstenev folded before Flop (didn't bet)



PokerStars Zoom Hand #84300837119:  Hold'em No Limit ($0.10/$0.25) - 2012/08/05 15:54:22 JST [2012/08/05 2:54:22 ET]
Table 'Whirlpool' 9-max Seat #1 is the button
Seat 1: chiyuki ($51.01 in chips) 
Seat 2: westhavenbc ($17.15 in chips) 
Seat 3: Afcawins25 ($14.10 in chips) 
Seat 4: yvasilik ($24.02 in chips) 
Seat 5: TorTrade ($25.68 in chips) 
Seat 6: 4plankton ($20.78 in chips) 
Seat 7: Perstenev ($9.38 in chips) 
Seat 8: kwkim73 ($30 in chips) 
Seat 9: HighDuka ($34.91 in chips) 
westhavenbc: posts small blind $0.10
Afcawins25: posts big blind $0.25
*** HOLE CARDS ***
Dealt to chiyuki [Tc Qs]
yvasilik: folds 
TorTrade: folds 
4plankton: folds 
Perstenev: folds 
kwkim73: folds 
HighDuka: raises $0.75 to $1
chiyuki: folds 
westhavenbc: folds 
Afcawins25: calls $0.75
*** FLOP *** [Kh Qd Js]
Afcawins25: checks 
HighDuka: bets $1.25
Afcawins25: raises $1.75 to $3
HighDuka: folds 
Uncalled bet ($1.75) returned to Afcawins25
Afcawins25 collected $4.39 from pot
Afcawins25: doesn't show hand 
*** SUMMARY ***
Total pot $4.60 | Rake $0.21 
Board [Kh Qd Js]
Seat 1: chiyuki (button) folded before Flop (didn't bet)
Seat 2: westhavenbc (small blind) folded before Flop
Seat 3: Afcawins25 (big blind) collected ($4.39)
Seat 4: yvasilik folded before Flop (didn't bet)
Seat 5: TorTrade folded before Flop (didn't bet)
Seat 6: 4plankton folded before Flop (didn't bet)
Seat 7: Perstenev folded before Flop (didn't bet)
Seat 8: kwkim73 folded before Flop (didn't bet)
Seat 9: HighDuka folded on the Flop



PokerStars Zoom Hand #84300847611:  Hold'em No Limit ($0.10/$0.25) - 2012/08/05 15:55:04 JST [2012/08/05 2:55:04 ET]
Table 'Whirlpool' 9-max Seat #1 is the button
Seat 1: westhavenbc ($19.93 in chips) 
Seat 2: kamikkaze ($17.80 in chips) 
Seat 3: chiyuki ($51.01 in chips) 
Seat 4: Grishukps ($12.50 in chips) 
Seat 5: Kasperlmusik ($32.45 in chips) 
Seat 6: 1Karina1 ($38.87 in chips) 
Seat 7: schoof 2 ($26.09 in chips) 
Seat 8: snejokCoxx ($10.44 in chips) 
Seat 9: Dejacob ($25.74 in chips) 
kamikkaze: posts small blind $0.10
chiyuki: posts big blind $0.25
*** HOLE CARDS ***
Dealt to chiyuki [Kh Ac]
Grishukps: folds 
Kasperlmusik: folds 
1Karina1: folds 
schoof 2: folds 
snejokCoxx: folds 
Dejacob: folds 
westhavenbc: folds 
kamikkaze: folds 
Uncalled bet ($0.15) returned to chiyuki
chiyuki collected $0.20 from pot
chiyuki: doesn't show hand 
*** SUMMARY ***
Total pot $0.20 | Rake $0 
Seat 1: westhavenbc (button) folded before Flop (didn't bet)
Seat 2: kamikkaze (small blind) folded before Flop
Seat 3: chiyuki (big blind) collected ($0.20)
Seat 4: Grishukps folded before Flop (didn't bet)
Seat 5: Kasperlmusik folded before Flop (didn't bet)
Seat 6: 1Karina1 folded before Flop (didn't bet)
Seat 7: schoof 2 folded before Flop (didn't bet)
Seat 8: snejokCoxx folded before Flop (didn't bet)
Seat 9: Dejacob folded before Flop (didn't bet)



PokerStars Zoom Hand #84300851198:  Hold'em No Limit ($0.10/$0.25) - 2012/08/05 15:55:21 JST [2012/08/05 2:55:21 ET]
Table 'Whirlpool' 9-max Seat #1 is the button
Seat 1: Nerkit ($8.75 in chips) 
Seat 2: slapshot2011 ($18.87 in chips) 
Seat 3: seula i ($50.21 in chips) 
Seat 4: PPP7SSS ($18.53 in chips) 
Seat 5: Dan Royal ($32.33 in chips) 
Seat 6: 1Karina1 ($25 in chips) 
Seat 7: chiyuki ($51.11 in chips) 
Seat 8: Faantomace ($35.57 in chips) 
Seat 9: kamikkaze ($17.70 in chips) 
slapshot2011: posts small blind $0.10
seula i: posts big blind $0.25
*** HOLE CARDS ***
Dealt to chiyuki [Jh 7h]
PPP7SSS: raises $0.50 to $0.75
Dan Royal: folds 
1Karina1: folds 
chiyuki: folds 
Faantomace: folds 
kamikkaze: folds 
Nerkit: folds 
slapshot2011: folds 
seula i: folds 
Uncalled bet ($0.50) returned to PPP7SSS
PPP7SSS collected $0.60 from pot
PPP7SSS: doesn't show hand 
*** SUMMARY ***
Total pot $0.60 | Rake $0 
Seat 1: Nerkit (button) folded before Flop (didn't bet)
Seat 2: slapshot2011 (small blind) folded before Flop
Seat 3: seula i (big blind) folded before Flop
Seat 4: PPP7SSS collected ($0.60)
Seat 5: Dan Royal folded before Flop (didn't bet)
Seat 6: 1Karina1 folded before Flop (didn't bet)
Seat 7: chiyuki folded before Flop (didn't bet)
Seat 8: Faantomace folded before Flop (didn't bet)
Seat 9: kamikkaze folded before Flop (didn't bet)



PokerStars Zoom Hand #84300852667:  Hold'em No Limit ($0.10/$0.25) - 2012/08/05 15:55:28 JST [2012/08/05 2:55:28 ET]
Table 'Whirlpool' 9-max Seat #1 is the button
Seat 1: leo2095 ($27.50 in chips) 
Seat 2: chiyuki ($51.11 in chips) 
Seat 3: kwkim73 ($25.70 in chips) 
Seat 4: CrittHunter ($29.19 in chips) 
Seat 5: masterkoolb ($12.92 in chips) 
Seat 6: Faantomace ($35.57 in chips) 
Seat 7: westhavenbc ($17.15 in chips) 
Seat 8: nice.franki ($12.50 in chips) 
Seat 9: Perstenev ($8.53 in chips) 
chiyuki: posts small blind $0.10
kwkim73: posts big blind $0.25
*** HOLE CARDS ***
Dealt to chiyuki [3s As]
CrittHunter: folds 
masterkoolb: folds 
Faantomace: folds 
westhavenbc: folds 
nice.franki: folds 
Perstenev: folds 
leo2095: raises $0.25 to $0.50
chiyuki: folds 
kwkim73: folds 
Uncalled bet ($0.25) returned to leo2095
leo2095 collected $0.60 from pot
leo2095: doesn't show hand 
*** SUMMARY ***
Total pot $0.60 | Rake $0 
Seat 1: leo2095 (button) collected ($0.60)
Seat 2: chiyuki (small blind) folded before Flop
Seat 3: kwkim73 (big blind) folded before Flop
Seat 4: CrittHunter folded before Flop (didn't bet)
Seat 5: masterkoolb folded before Flop (didn't bet)
Seat 6: Faantomace folded before Flop (didn't bet)
Seat 7: westhavenbc folded before Flop (didn't bet)
Seat 8: nice.franki folded before Flop (didn't bet)
Seat 9: Perstenev folded before Flop (didn't bet)



PokerStars Zoom Hand #84300843289:  Hold'em No Limit ($0.10/$0.25) - 2012/08/05 15:54:47 JST [2012/08/05 2:54:47 ET]
Table 'Whirlpool' 9-max Seat #1 is the button
Seat 1: kamikkaze ($21.78 in chips) 
Seat 2: Trip_Krowns ($31.81 in chips) 
Seat 3: opie62 ($25.28 in chips) 
Seat 4: risekuku468 ($34.26 in chips) 
Seat 5: nice.franki ($12.23 in chips) 
Seat 6: phate-1up ($54.17 in chips) 
Seat 7: Dejacob ($25.35 in chips) 
Seat 8: Femali54 ($26.77 in chips) 
Seat 9: chiyuki ($51.01 in chips) 
Trip_Krowns: posts small blind $0.10
opie62: posts big blind $0.25
*** HOLE CARDS ***
Dealt to chiyuki [9s Ac]
risekuku468: folds 
nice.franki: folds 
phate-1up: folds 
Dejacob: folds 
Femali54: raises $0.38 to $0.63
chiyuki: folds 
kamikkaze: folds 
Trip_Krowns: calls $0.53
opie62: calls $0.38
*** FLOP *** [6c 6d 3s]
Trip_Krowns: checks 
opie62: checks 
Femali54: bets $1.29
Trip_Krowns: calls $1.29
opie62: folds 
*** TURN *** [6c 6d 3s] [4h]
Trip_Krowns: checks 
Femali54: checks 
*** RIVER *** [6c 6d 3s 4h] [Th]
Trip_Krowns: bets $2.50
Femali54: folds 
Uncalled bet ($2.50) returned to Trip_Krowns
Trip_Krowns collected $4.27 from pot
Trip_Krowns: doesn't show hand 
*** SUMMARY ***
Total pot $4.47 | Rake $0.20 
Board [6c 6d 3s 4h Th]
Seat 1: kamikkaze (button) folded before Flop (didn't bet)
Seat 2: Trip_Krowns (small blind) collected ($4.27)
Seat 3: opie62 (big blind) folded on the Flop
Seat 4: risekuku468 folded before Flop (didn't bet)
Seat 5: nice.franki folded before Flop (didn't bet)
Seat 6: phate-1up folded before Flop (didn't bet)
Seat 7: Dejacob folded before Flop (didn't bet)
Seat 8: Femali54 folded on the River
Seat 9: chiyuki folded before Flop (didn't bet)



PokerStars Zoom Hand #84300862142:  Hold'em No Limit ($0.10/$0.25) - 2012/08/05 15:56:14 JST [2012/08/05 2:56:14 ET]
Table 'Whirlpool' 9-max Seat #1 is the button
Seat 1: Rici47 ($37.50 in chips) 
Seat 2: risekuku468 ($33.91 in chips) 
Seat 3: MurMurRu ($25 in chips) 
Seat 4: chiyuki ($51.01 in chips) 
Seat 5: nice.franki ($6.35 in chips) 
Seat 6: kwkim73 ($25 in chips) 
Seat 7: yvasilik ($25.68 in chips) 
Seat 8: Dan Royal ($34.58 in chips) 
Seat 9: 4plankton ($19.88 in chips) 
risekuku468: posts small blind $0.10
MurMurRu: posts big blind $0.25
*** HOLE CARDS ***
Dealt to chiyuki [4h 5d]
chiyuki: folds 
nice.franki: folds 
kwkim73: folds 
yvasilik: folds 
Dan Royal: folds 
4plankton: folds 
Rici47: raises $0.50 to $0.75
risekuku468: folds 
MurMurRu: folds 
Uncalled bet ($0.50) returned to Rici47
Rici47 collected $0.60 from pot
Rici47: doesn't show hand 
*** SUMMARY ***
Total pot $0.60 | Rake $0 
Seat 1: Rici47 (button) collected ($0.60)
Seat 2: risekuku468 (small blind) folded before Flop
Seat 3: MurMurRu (big blind) folded before Flop
Seat 4: chiyuki folded before Flop (didn't bet)
Seat 5: nice.franki folded before Flop (didn't bet)
Seat 6: kwkim73 folded before Flop (didn't bet)
Seat 7: yvasilik folded before Flop (didn't bet)
Seat 8: Dan Royal folded before Flop (didn't bet)
Seat 9: 4plankton folded before Flop (didn't bet)



PokerStars Zoom Hand #84300862964:  Hold'em No Limit ($0.10/$0.25) - 2012/08/05 15:56:18 JST [2012/08/05 2:56:18 ET]
Table 'Whirlpool' 9-max Seat #1 is the button
Seat 1: chiyuki ($51.01 in chips) 
Seat 2: Rilko1975 ($25.77 in chips) 
Seat 3: yvasilik ($25.68 in chips) 
Seat 4: kwkim73 ($25 in chips) 
Seat 5: Nerkit ($9 in chips) 
Seat 6: DrunkTyphoon ($37.66 in chips) 
Seat 7: pandaaaaaa ($14.65 in chips) 
Seat 8: snejokCoxx ($11.50 in chips) 
Seat 9: Dan Royal ($34.58 in chips) 
Rilko1975: posts small blind $0.10
yvasilik: posts big blind $0.25
*** HOLE CARDS ***
Dealt to chiyuki [3s 3d]
kwkim73: folds 
Nerkit: folds 
DrunkTyphoon: folds 
pandaaaaaa: raises $0.75 to $1
snejokCoxx: folds 
Dan Royal: calls $1
chiyuki: folds 
Rilko1975: folds 
yvasilik: folds 
*** FLOP *** [Ad 9d 3h]
pandaaaaaa: bets $2
Dan Royal: folds 
Uncalled bet ($2) returned to pandaaaaaa
pandaaaaaa collected $2.24 from pot
pandaaaaaa: doesn't show hand 
*** SUMMARY ***
Total pot $2.35 | Rake $0.11 
Board [Ad 9d 3h]
Seat 1: chiyuki (button) folded before Flop (didn't bet)
Seat 2: Rilko1975 (small blind) folded before Flop
Seat 3: yvasilik (big blind) folded before Flop
Seat 4: kwkim73 folded before Flop (didn't bet)
Seat 5: Nerkit folded before Flop (didn't bet)
Seat 6: DrunkTyphoon folded before Flop (didn't bet)
Seat 7: pandaaaaaa collected ($2.24)
Seat 8: snejokCoxx folded before Flop (didn't bet)
Seat 9: Dan Royal folded on the Flop



PokerStars Zoom Hand #84300858552:  Hold'em No Limit ($0.10/$0.25) - 2012/08/05 15:55:57 JST [2012/08/05 2:55:57 ET]
Table 'Whirlpool' 9-max Seat #1 is the button
Seat 1: FoRlan77 ($25 in chips) 
Seat 2: KrystalAA ($13.41 in chips) 
Seat 3: xxx Spb xxx ($25 in chips) 
Seat 4: Rilko1975 ($26.02 in chips) 
Seat 5: kwkim73 ($25.78 in chips) 
Seat 6: Ozboy80 ($25.31 in chips) 
Seat 7: nice.franki ($7.78 in chips) 
Seat 8: chiyuki ($51.01 in chips) 
Seat 9: Trip_Krowns ($34.16 in chips) 
KrystalAA: posts small blind $0.10
xxx Spb xxx: posts big blind $0.25
*** HOLE CARDS ***
Dealt to chiyuki [7h 3h]
Rilko1975: folds 
kwkim73: folds 
Ozboy80: folds 
nice.franki: folds 
chiyuki: folds 
Trip_Krowns: calls $0.25
FoRlan77: folds 
KrystalAA: folds 
xxx Spb xxx: checks 
*** FLOP *** [4s 6c Jh]
xxx Spb xxx: checks 
Trip_Krowns: checks 
*** TURN *** [4s 6c Jh] [7s]
xxx Spb xxx: bets $0.30
Trip_Krowns: folds 
Uncalled bet ($0.30) returned to xxx Spb xxx
xxx Spb xxx collected $0.57 from pot
xxx Spb xxx: doesn't show hand 
*** SUMMARY ***
Total pot $0.60 | Rake $0.03 
Board [4s 6c Jh 7s]
Seat 1: FoRlan77 (button) folded before Flop (didn't bet)
Seat 2: KrystalAA (small blind) folded before Flop
Seat 3: xxx Spb xxx (big blind) collected ($0.57)
Seat 4: Rilko1975 folded before Flop (didn't bet)
Seat 5: kwkim73 folded before Flop (didn't bet)
Seat 6: Ozboy80 folded before Flop (didn't bet)
Seat 7: nice.franki folded before Flop (didn't bet)
Seat 8: chiyuki folded before Flop (didn't bet)
Seat 9: Trip_Krowns folded on the Turn



PokerStars Zoom Hand #84300856675:  Hold'em No Limit ($0.10/$0.25) - 2012/08/05 15:55:47 JST [2012/08/05 2:55:47 ET]
Table 'Whirlpool' 9-max Seat #1 is the button
Seat 1: slapshot2011 ($18.52 in chips) 
Seat 2: ChrisCDee ($44.24 in chips) 
Seat 3: drunk_bender ($14.06 in chips) 
Seat 4: Serge Claws ($25.76 in chips) 
Seat 5: pandaaaaaa ($14.90 in chips) 
Seat 6: chiyuki ($51.01 in chips) 
Seat 7: Kozyavkin ($18.63 in chips) 
Seat 8: nice.franki ($7.78 in chips) 
Seat 9: Silveystryk ($15.89 in chips) 
ChrisCDee: posts small blind $0.10
drunk_bender: posts big blind $0.25
*** HOLE CARDS ***
Dealt to chiyuki [4h 4s]
Serge Claws: raises $0.50 to $0.75
pandaaaaaa: folds 
chiyuki: folds 
Kozyavkin: folds 
nice.franki: folds 
Silveystryk: calls $0.75
slapshot2011: folds 
ChrisCDee: calls $0.65
drunk_bender: calls $0.50
*** FLOP *** [3c 3d 2h]
ChrisCDee: bets $1.71
drunk_bender: folds 
Serge Claws: calls $1.71
Silveystryk: folds 
*** TURN *** [3c 3d 2h] [7h]
ChrisCDee: bets $3.67
Serge Claws: calls $3.67
*** RIVER *** [3c 3d 2h 7h] [7c]
ChrisCDee: checks 
Serge Claws: bets $7.75
ChrisCDee: calls $7.75
*** SHOW DOWN ***
Serge Claws: shows [3h 3s] (four of a kind, Threes)
ChrisCDee: mucks hand 
Serge Claws collected $27.94 from pot
*** SUMMARY ***
Total pot $29.26 | Rake $1.32 
Board [3c 3d 2h 7h 7c]
Seat 1: slapshot2011 (button) folded before Flop (didn't bet)
Seat 2: ChrisCDee (small blind) mucked [Tc Td]
Seat 3: drunk_bender (big blind) folded on the Flop
Seat 4: Serge Claws showed [3h 3s] and won ($27.94) with four of a kind, Threes
Seat 5: pandaaaaaa folded before Flop (didn't bet)
Seat 6: chiyuki folded before Flop (didn't bet)
Seat 7: Kozyavkin folded before Flop (didn't bet)
Seat 8: nice.franki folded before Flop (didn't bet)
Seat 9: Silveystryk folded on the Flop



PokerStars Zoom Hand #84300869087:  Hold'em No Limit ($0.10/$0.25) - 2012/08/05 15:56:47 JST [2012/08/05 2:56:47 ET]
Table 'Whirlpool' 9-max Seat #1 is the button
Seat 1: 1Karina1 ($35.37 in chips) 
Seat 2: kwkim73 ($26.13 in chips) 
Seat 3: Grishukps ($12.50 in chips) 
Seat 4: DrunkTyphoon ($43.13 in chips) 
Seat 5: Dan Royal ($33.58 in chips) 
Seat 6: Ellen1947 ($29.22 in chips) 
Seat 7: Kasperlmusik ($31.35 in chips) 
Seat 8: phate-1up ($57.46 in chips) 
Seat 9: chiyuki ($51.01 in chips) 
kwkim73: posts small blind $0.10
Grishukps: posts big blind $0.25
*** HOLE CARDS ***
Dealt to chiyuki [4h 3c]
DrunkTyphoon: folds 
Dan Royal: folds 
Ellen1947: folds 
Kasperlmusik: folds 
phate-1up: folds 
chiyuki: folds 
1Karina1: folds 
kwkim73: folds 
Uncalled bet ($0.15) returned to Grishukps
Grishukps collected $0.20 from pot
Grishukps: doesn't show hand 
*** SUMMARY ***
Total pot $0.20 | Rake $0 
Seat 1: 1Karina1 (button) folded before Flop (didn't bet)
Seat 2: kwkim73 (small blind) folded before Flop
Seat 3: Grishukps (big blind) collected ($0.20)
Seat 4: DrunkTyphoon folded before Flop (didn't bet)
Seat 5: Dan Royal folded before Flop (didn't bet)
Seat 6: Ellen1947 folded before Flop (didn't bet)
Seat 7: Kasperlmusik folded before Flop (didn't bet)
Seat 8: phate-1up folded before Flop (didn't bet)
Seat 9: chiyuki folded before Flop (didn't bet)



PokerStars Zoom Hand #84300872932:  Hold'em No Limit ($0.10/$0.25) - 2012/08/05 15:57:05 JST [2012/08/05 2:57:05 ET]
Table 'Whirlpool' 9-max Seat #1 is the button
Seat 1: hldtom ($42.57 in chips) 
Seat 2: kwkim73 ($25.10 in chips) 
Seat 3: chiyuki ($51.01 in chips) 
Seat 4: Rici47 ($37.75 in chips) 
Seat 5: kesstukas25 ($31.26 in chips) 
Seat 6: Kasperlmusik ($31.35 in chips) 
Seat 7: westhavenbc ($19.23 in chips) 
Seat 8: Saruotiss ($61.41 in chips) 
Seat 9: risekuku468 ($33.81 in chips) 
kwkim73: posts small blind $0.10
chiyuki: posts big blind $0.25
*** HOLE CARDS ***
Dealt to chiyuki [Ah 6c]
Rici47: folds 
kesstukas25: folds 
Kasperlmusik: folds 
westhavenbc: folds 
Saruotiss: folds 
risekuku468: folds 
hldtom: raises $0.50 to $0.75
kwkim73: folds 
chiyuki: folds 
Uncalled bet ($0.50) returned to hldtom
hldtom collected $0.60 from pot
hldtom: doesn't show hand 
*** SUMMARY ***
Total pot $0.60 | Rake $0 
Seat 1: hldtom (button) collected ($0.60)
Seat 2: kwkim73 (small blind) folded before Flop
Seat 3: chiyuki (big blind) folded before Flop
Seat 4: Rici47 folded before Flop (didn't bet)
Seat 5: kesstukas25 folded before Flop (didn't bet)
Seat 6: Kasperlmusik folded before Flop (didn't bet)
Seat 7: westhavenbc folded before Flop (didn't bet)
Seat 8: Saruotiss folded before Flop (didn't bet)
Seat 9: risekuku468 folded before Flop (didn't bet)



PokerStars Zoom Hand #84300865908:  Hold'em No Limit ($0.10/$0.25) - 2012/08/05 15:56:32 JST [2012/08/05 2:56:32 ET]
Table 'Whirlpool' 9-max Seat #1 is the button
Seat 1: AAAKK777 ($12.86 in chips) 
Seat 2: Ozboy80 ($25.06 in chips) 
Seat 3: Limoilou ($25.73 in chips) 
Seat 4: snejokCoxx ($11.50 in chips) 
Seat 5: chiyuki ($51.01 in chips) 
Seat 6: westhavenbc ($19.58 in chips) 
Seat 7: Rici47 ($37.85 in chips) 
Seat 8: Grishukps ($12.90 in chips) 
Seat 9: kwkim73 ($25.78 in chips) 
Ozboy80: posts small blind $0.10
Limoilou: posts big blind $0.25
*** HOLE CARDS ***
Dealt to chiyuki [8s 8c]
snejokCoxx: raises $0.40 to $0.65
chiyuki: folds 
westhavenbc: folds 
Rici47: folds 
Grishukps: folds 
kwkim73: folds 
AAAKK777: calls $0.65
Ozboy80: folds 
Limoilou: folds 
*** FLOP *** [Ks 2s Td]
snejokCoxx: checks 
AAAKK777: checks 
*** TURN *** [Ks 2s Td] [3c]
snejokCoxx: checks 
AAAKK777: checks 
*** RIVER *** [Ks 2s Td 3c] [4d]
snejokCoxx: checks 
AAAKK777: checks 
*** SHOW DOWN ***
snejokCoxx: shows [Qs Ac] (high card Ace)
AAAKK777: mucks hand 
snejokCoxx collected $1.58 from pot
*** SUMMARY ***
Total pot $1.65 | Rake $0.07 
Board [Ks 2s Td 3c 4d]
Seat 1: AAAKK777 (button) mucked [7d Js]
Seat 2: Ozboy80 (small blind) folded before Flop
Seat 3: Limoilou (big blind) folded before Flop
Seat 4: snejokCoxx showed [Qs Ac] and won ($1.58) with high card Ace
Seat 5: chiyuki folded before Flop (didn't bet)
Seat 6: westhavenbc folded before Flop (didn't bet)
Seat 7: Rici47 folded before Flop (didn't bet)
Seat 8: Grishukps folded before Flop (didn't bet)
Seat 9: kwkim73 folded before Flop (didn't bet)



PokerStars Zoom Hand #84300872117:  Hold'em No Limit ($0.10/$0.25) - 2012/08/05 15:57:01 JST [2012/08/05 2:57:01 ET]
Table 'Whirlpool' 9-max Seat #1 is the button
Seat 1: jacquelinewu ($25.62 in chips) 
Seat 2: soul_5577 ($41.02 in chips) 
Seat 3: Kozyavkin ($17.63 in chips) 
Seat 4: chiyuki ($51.01 in chips) 
Seat 5: Perstenev ($17.42 in chips) 
Seat 6: GSDP ($42.33 in chips) 
Seat 7: Limoilou ($25.48 in chips) 
Seat 8: opie62 ($24.15 in chips) 
Seat 9: fwnaf ($22.91 in chips) 
soul_5577: posts small blind $0.10
Kozyavkin: posts big blind $0.25
*** HOLE CARDS ***
Dealt to chiyuki [7c Ts]
chiyuki: folds 
Perstenev: folds 
GSDP: raises $0.50 to $0.75
Limoilou: folds 
opie62: folds 
fwnaf: raises $1.50 to $2.25
jacquelinewu: folds 
soul_5577: folds 
Kozyavkin: folds 
GSDP: folds 
Uncalled bet ($1.50) returned to fwnaf
fwnaf collected $1.85 from pot
fwnaf: doesn't show hand 
*** SUMMARY ***
Total pot $1.85 | Rake $0 
Seat 1: jacquelinewu (button) folded before Flop (didn't bet)
Seat 2: soul_5577 (small blind) folded before Flop
Seat 3: Kozyavkin (big blind) folded before Flop
Seat 4: chiyuki folded before Flop (didn't bet)
Seat 5: Perstenev folded before Flop (didn't bet)
Seat 6: GSDP folded before Flop
Seat 7: Limoilou folded before Flop (didn't bet)
Seat 8: opie62 folded before Flop (didn't bet)
Seat 9: fwnaf collected ($1.85)



PokerStars Zoom Hand #84300870854:  Hold'em No Limit ($0.10/$0.25) - 2012/08/05 15:56:55 JST [2012/08/05 2:56:55 ET]
Table 'Whirlpool' 9-max Seat #1 is the button
Seat 1: MurMurRu ($25 in chips) 
Seat 2: Saruotiss ($61.51 in chips) 
Seat 3: scaredsare ($14.50 in chips) 
Seat 4: snejokCoxx ($11.50 in chips) 
Seat 5: Serge Claws ($27.70 in chips) 
Seat 6: chiyuki ($51.01 in chips) 
Seat 7: DrunkTyphoon ($43.13 in chips) 
Seat 8: Dan Royal ($33.58 in chips) 
Seat 9: xxx Spb xxx ($25.32 in chips) 
Saruotiss: posts small blind $0.10
scaredsare: posts big blind $0.25
*** HOLE CARDS ***
Dealt to chiyuki [3h 5s]
snejokCoxx: folds 
Serge Claws: folds 
chiyuki: folds 
DrunkTyphoon: raises $0.50 to $0.75
Dan Royal: folds 
xxx Spb xxx: folds 
MurMurRu: calls $0.75
Saruotiss: folds 
scaredsare: calls $0.50
*** FLOP *** [2h Jh Qh]
scaredsare: checks 
DrunkTyphoon: bets $1.50
MurMurRu: calls $1.50
scaredsare: calls $1.50
*** TURN *** [2h Jh Qh] [3c]
scaredsare: checks 
DrunkTyphoon: checks 
MurMurRu: checks 
*** RIVER *** [2h Jh Qh 3c] [Ad]
scaredsare: bets $1
DrunkTyphoon: raises $8.54 to $9.54
MurMurRu: folds 
scaredsare: raises $2.71 to $12.25 and is all-in
DrunkTyphoon: calls $2.71
*** SHOW DOWN ***
scaredsare: shows [8h Th] (a flush, Queen high)
DrunkTyphoon: shows [Ac As] (three of a kind, Aces)
scaredsare collected $29.94 from pot
*** SUMMARY ***
Total pot $31.35 | Rake $1.41 
Board [2h Jh Qh 3c Ad]
Seat 1: MurMurRu (button) folded on the River
Seat 2: Saruotiss (small blind) folded before Flop
Seat 3: scaredsare (big blind) showed [8h Th] and won ($29.94) with a flush, Queen high
Seat 4: snejokCoxx folded before Flop (didn't bet)
Seat 5: Serge Claws folded before Flop (didn't bet)
Seat 6: chiyuki folded before Flop (didn't bet)
Seat 7: DrunkTyphoon showed [Ac As] and lost with three of a kind, Aces
Seat 8: Dan Royal folded before Flop (didn't bet)
Seat 9: xxx Spb xxx folded before Flop (didn't bet)



PokerStars Zoom Hand #84300877229:  Hold'em No Limit ($0.10/$0.25) - 2012/08/05 15:57:26 JST [2012/08/05 2:57:26 ET]
Table 'Whirlpool' 9-max Seat #1 is the button
Seat 1: seula i ($47.06 in chips) 
Seat 2: chiyuki ($50.76 in chips) 
Seat 3: jacquelinewu ($71.44 in chips) 
Seat 4: GovGus ($34.59 in chips) 
Seat 5: leo2095 ($27.50 in chips) 
Seat 6: soul_5577 ($40.92 in chips) 
Seat 7: Alvinpe85 ($40.15 in chips) 
Seat 8: hldtom ($25 in chips) 
Seat 9: PPP7SSS ($27.73 in chips) 
chiyuki: posts small blind $0.10
jacquelinewu: posts big blind $0.25
*** HOLE CARDS ***
Dealt to chiyuki [Qc Kd]
GovGus: folds 
leo2095: folds 
soul_5577: folds 
Alvinpe85: folds 
hldtom: folds 
PPP7SSS: folds 
seula i: raises $0.50 to $0.75
chiyuki: folds 
jacquelinewu: calls $0.50
*** FLOP *** [Th 7d Qh]
jacquelinewu: checks 
seula i: bets $1.25
jacquelinewu: raises $2.75 to $4
seula i: folds 
Uncalled bet ($2.75) returned to jacquelinewu
jacquelinewu collected $3.92 from pot
jacquelinewu: doesn't show hand 
*** SUMMARY ***
Total pot $4.10 | Rake $0.18 
Board [Th 7d Qh]
Seat 1: seula i (button) folded on the Flop
Seat 2: chiyuki (small blind) folded before Flop
Seat 3: jacquelinewu (big blind) collected ($3.92)
Seat 4: GovGus folded before Flop (didn't bet)
Seat 5: leo2095 folded before Flop (didn't bet)
Seat 6: soul_5577 folded before Flop (didn't bet)
Seat 7: Alvinpe85 folded before Flop (didn't bet)
Seat 8: hldtom folded before Flop (didn't bet)
Seat 9: PPP7SSS folded before Flop (didn't bet)



PokerStars Zoom Hand #84300881867:  Hold'em No Limit ($0.10/$0.25) - 2012/08/05 15:57:47 JST [2012/08/05 2:57:47 ET]
Table 'Whirlpool' 9-max Seat #1 is the button
Seat 1: Perstenev ($10.70 in chips) 
Seat 2: dergeb ($16.84 in chips) 
Seat 3: Dionisko ($12.50 in chips) 
Seat 4: xxx Spb xxx ($25 in chips) 
Seat 5: Serge Claws ($39.92 in chips) 
Seat 6: pawn909 ($21.08 in chips) 
Seat 7: Silveystryk ($29.91 in chips) 
Seat 8: chiyuki ($50.66 in chips) 
Seat 9: EvgenyBaikov ($20.44 in chips) 
dergeb: posts small blind $0.10
Dionisko: posts big blind $0.25
*** HOLE CARDS ***
Dealt to chiyuki [9s Th]
xxx Spb xxx: folds 
Serge Claws: folds 
pawn909: folds 
Silveystryk: folds 
chiyuki: folds 
EvgenyBaikov: raises $0.25 to $0.50
Perstenev: folds 
dergeb: folds 
Dionisko: calls $0.25
*** FLOP *** [7h 6h Kd]
Dionisko: checks 
EvgenyBaikov: checks 
*** TURN *** [7h 6h Kd] [Qs]
Dionisko: bets $0.75
EvgenyBaikov: calls $0.75
*** RIVER *** [7h 6h Kd Qs] [Ah]
Dionisko: bets $2.50
EvgenyBaikov: calls $2.50
*** SHOW DOWN ***
Dionisko: shows [8c 2c] (high card Ace)
EvgenyBaikov: shows [Tc Qd] (a pair of Queens)
EvgenyBaikov collected $7.26 from pot
*** SUMMARY ***
Total pot $7.60 | Rake $0.34 
Board [7h 6h Kd Qs Ah]
Seat 1: Perstenev (button) folded before Flop (didn't bet)
Seat 2: dergeb (small blind) folded before Flop
Seat 3: Dionisko (big blind) showed [8c 2c] and lost with high card Ace
Seat 4: xxx Spb xxx folded before Flop (didn't bet)
Seat 5: Serge Claws folded before Flop (didn't bet)
Seat 6: pawn909 folded before Flop (didn't bet)
Seat 7: Silveystryk folded before Flop (didn't bet)
Seat 8: chiyuki folded before Flop (didn't bet)
Seat 9: EvgenyBaikov showed [Tc Qd] and won ($7.26) with a pair of Queens



PokerStars Zoom Hand #84300884848:  Hold'em No Limit ($0.10/$0.25) - 2012/08/05 15:58:01 JST [2012/08/05 2:58:01 ET]
Table 'Whirlpool' 9-max Seat #1 is the button
Seat 1: chiyuki ($50.66 in chips) 
Seat 2: Bahia gyn ($19.37 in chips) 
Seat 3: KrystalAA ($12.91 in chips) 
Seat 4: xxx Spb xxx ($25 in chips) 
Seat 5: Dejacob ($26.35 in chips) 
Seat 6: Rici47 ($31.27 in chips) 
Seat 7: ChrisCDee ($56.33 in chips) 
Seat 8: kwkim73 ($26.16 in chips) 
Seat 9: boboshooter ($24.52 in chips) 
Bahia gyn: posts small blind $0.10
KrystalAA: posts big blind $0.25
*** HOLE CARDS ***
Dealt to chiyuki [3h 4h]
xxx Spb xxx: raises $0.50 to $0.75
Dejacob: folds 
Rici47: folds 
ChrisCDee: folds 
kwkim73: folds 
boboshooter: folds 
chiyuki: folds 
Bahia gyn: folds 
KrystalAA: folds 
Uncalled bet ($0.50) returned to xxx Spb xxx
xxx Spb xxx collected $0.60 from pot
xxx Spb xxx: doesn't show hand 
*** SUMMARY ***
Total pot $0.60 | Rake $0 
Seat 1: chiyuki (button) folded before Flop (didn't bet)
Seat 2: Bahia gyn (small blind) folded before Flop
Seat 3: KrystalAA (big blind) folded before Flop
Seat 4: xxx Spb xxx collected ($0.60)
Seat 5: Dejacob folded before Flop (didn't bet)
Seat 6: Rici47 folded before Flop (didn't bet)
Seat 7: ChrisCDee folded before Flop (didn't bet)
Seat 8: kwkim73 folded before Flop (didn't bet)
Seat 9: boboshooter folded before Flop (didn't bet)



PokerStars Zoom Hand #84300882911:  Hold'em No Limit ($0.10/$0.25) - 2012/08/05 15:57:52 JST [2012/08/05 2:57:52 ET]
Table 'Whirlpool' 9-max Seat #1 is the button
Seat 1: dergeb ($16.74 in chips) 
Seat 2: CrittHunter ($26.20 in chips) 
Seat 3: hldtom ($25 in chips) 
Seat 4: INSP!RON ($38.85 in chips) 
Seat 5: chiyuki ($50.66 in chips) 
Seat 6: kwkim73 ($25.78 in chips) 
Seat 7: phate-1up ($53.36 in chips) 
Seat 8: Silveystryk ($43.76 in chips) 
Seat 9: GovGus ($34.49 in chips) 
CrittHunter: posts small blind $0.10
hldtom: posts big blind $0.25
*** HOLE CARDS ***
Dealt to chiyuki [Ts Ac]
INSP!RON: folds 
chiyuki: folds 
kwkim73: folds 
phate-1up: folds 
Silveystryk: folds 
GovGus: folds 
dergeb: folds 
CrittHunter: raises $0.25 to $0.50
hldtom: folds 
Uncalled bet ($0.25) returned to CrittHunter
CrittHunter collected $0.50 from pot
CrittHunter: doesn't show hand 
*** SUMMARY ***
Total pot $0.50 | Rake $0 
Seat 1: dergeb (button) folded before Flop (didn't bet)
Seat 2: CrittHunter (small blind) collected ($0.50)
Seat 3: hldtom (big blind) folded before Flop
Seat 4: INSP!RON folded before Flop (didn't bet)
Seat 5: chiyuki folded before Flop (didn't bet)
Seat 6: kwkim73 folded before Flop (didn't bet)
Seat 7: phate-1up folded before Flop (didn't bet)
Seat 8: Silveystryk folded before Flop (didn't bet)
Seat 9: GovGus folded before Flop (didn't bet)



PokerStars Zoom Hand #84300891618:  Hold'em No Limit ($0.10/$0.25) - 2012/08/05 15:58:33 JST [2012/08/05 2:58:33 ET]
Table 'Whirlpool' 9-max Seat #1 is the button
Seat 1: MurMurRu ($25 in chips) 
Seat 2: andy0815r ($24.75 in chips) 
Seat 3: ChrisCDee ($56.23 in chips) 
Seat 4: KrystalAA ($28.50 in chips) 
Seat 5: snejokCoxx ($9.23 in chips) 
Seat 6: INSP!RON ($32.83 in chips) 
Seat 7: scaredsare ($29.84 in chips) 
Seat 8: chiyuki ($50.56 in chips) 
Seat 9: Afcawins25 ($16.59 in chips) 
andy0815r: posts small blind $0.10
ChrisCDee: posts big blind $0.25
*** HOLE CARDS ***
Dealt to chiyuki [Th 4s]
KrystalAA: folds 
snejokCoxx: folds 
INSP!RON: raises $0.50 to $0.75
scaredsare: folds 
chiyuki: folds 
Afcawins25: folds 
MurMurRu: folds 
andy0815r: folds 
ChrisCDee: folds 
Uncalled bet ($0.50) returned to INSP!RON
INSP!RON collected $0.60 from pot
INSP!RON: doesn't show hand 
*** SUMMARY ***
Total pot $0.60 | Rake $0 
Seat 1: MurMurRu (button) folded before Flop (didn't bet)
Seat 2: andy0815r (small blind) folded before Flop
Seat 3: ChrisCDee (big blind) folded before Flop
Seat 4: KrystalAA folded before Flop (didn't bet)
Seat 5: snejokCoxx folded before Flop (didn't bet)
Seat 6: INSP!RON collected ($0.60)
Seat 7: scaredsare folded before Flop (didn't bet)
Seat 8: chiyuki folded before Flop (didn't bet)
Seat 9: Afcawins25 folded before Flop (didn't bet)



PokerStars Zoom Hand #84300886148:  Hold'em No Limit ($0.10/$0.25) - 2012/08/05 15:58:07 JST [2012/08/05 2:58:07 ET]
Table 'Whirlpool' 9-max Seat #1 is the button
Seat 1: Dejacob ($26.35 in chips) 
Seat 2: GSDP ($42.43 in chips) 
Seat 3: Grishukps ($12.85 in chips) 
Seat 4: Lasutchik ($28.43 in chips) 
Seat 5: jacquelinewu ($73.36 in chips) 
Seat 6: Serge Claws ($61.03 in chips) 
Seat 7: chiyuki ($50.66 in chips) 
Seat 8: snejokCoxx ($11.15 in chips) 
Seat 9: romanian c4 ($12 in chips) 
GSDP: posts small blind $0.10
Grishukps: posts big blind $0.25
*** HOLE CARDS ***
Dealt to chiyuki [7d 3h]
Lasutchik: folds 
jacquelinewu: raises $0.50 to $0.75
Serge Claws: folds 
chiyuki: folds 
snejokCoxx: folds 
romanian c4: folds 
Dejacob: folds 
GSDP: calls $0.65
Grishukps: folds 
*** FLOP *** [6c 5s 7h]
GSDP: checks 
jacquelinewu: checks 
*** TURN *** [6c 5s 7h] [7s]
GSDP: bets $1
jacquelinewu: calls $1
*** RIVER *** [6c 5s 7h 7s] [9d]
GSDP: checks 
jacquelinewu: bets $2
GSDP: calls $2
*** SHOW DOWN ***
jacquelinewu: shows [8d 8h] (a straight, Five to Nine)
GSDP: mucks hand 
jacquelinewu collected $7.40 from pot
*** SUMMARY ***
Total pot $7.75 | Rake $0.35 
Board [6c 5s 7h 7s 9d]
Seat 1: Dejacob (button) folded before Flop (didn't bet)
Seat 2: GSDP (small blind) mucked [Ah 6h]
Seat 3: Grishukps (big blind) folded before Flop
Seat 4: Lasutchik folded before Flop (didn't bet)
Seat 5: jacquelinewu showed [8d 8h] and won ($7.40) with a straight, Five to Nine
Seat 6: Serge Claws folded before Flop (didn't bet)
Seat 7: chiyuki folded before Flop (didn't bet)
Seat 8: snejokCoxx folded before Flop (didn't bet)
Seat 9: romanian c4 folded before Flop (didn't bet)



PokerStars Zoom Hand #84300887669:  Hold'em No Limit ($0.10/$0.25) - 2012/08/05 15:58:14 JST [2012/08/05 2:58:14 ET]
Table 'Whirlpool' 9-max Seat #1 is the button
Seat 1: romanian c4 ($12 in chips) 
Seat 2: ChrisCDee ($30.11 in chips) 
Seat 3: INSP!RON ($38.85 in chips) 
Seat 4: kwkim73 ($26.16 in chips) 
Seat 5: Rici47 ($37.40 in chips) 
Seat 6: snejokCoxx ($9.23 in chips) 
Seat 7: kesstukas25 ($31.16 in chips) 
Seat 8: rey2040 ($13.55 in chips) 
Seat 9: chiyuki ($50.66 in chips) 
ChrisCDee: posts small blind $0.10
INSP!RON: posts big blind $0.25
*** HOLE CARDS ***
Dealt to chiyuki [9d 4c]
kwkim73: folds 
Rici47: folds 
snejokCoxx: folds 
kesstukas25: folds 
rey2040: raises $0.50 to $0.75
chiyuki: folds 
romanian c4: calls $0.75
ChrisCDee: folds 
INSP!RON: folds 
*** FLOP *** [5d Js Ks]
rey2040: bets $0.25
romanian c4: calls $0.25
*** TURN *** [5d Js Ks] [Kd]
rey2040: bets $0.50
romanian c4: raises $2.50 to $3
rey2040: folds 
Uncalled bet ($2.50) returned to romanian c4
romanian c4 collected $3.20 from pot
romanian c4: doesn't show hand 
*** SUMMARY ***
Total pot $3.35 | Rake $0.15 
Board [5d Js Ks Kd]
Seat 1: romanian c4 (button) collected ($3.20)
Seat 2: ChrisCDee (small blind) folded before Flop
Seat 3: INSP!RON (big blind) folded before Flop
Seat 4: kwkim73 folded before Flop (didn't bet)
Seat 5: Rici47 folded before Flop (didn't bet)
Seat 6: snejokCoxx folded before Flop (didn't bet)
Seat 7: kesstukas25 folded before Flop (didn't bet)
Seat 8: rey2040 folded on the Turn
Seat 9: chiyuki folded before Flop (didn't bet)



PokerStars Zoom Hand #84300888761:  Hold'em No Limit ($0.10/$0.25) - 2012/08/05 15:58:20 JST [2012/08/05 2:58:20 ET]
Table 'Whirlpool' 9-max Seat #1 is the button
Seat 1: DrunkTyphoon ($28.28 in chips) 
Seat 2: chiyuki ($50.66 in chips) 
Seat 3: hldtom ($42.67 in chips) 
Seat 4: herkko11 ($5.10 in chips) 
Seat 5: ChrisCDee ($30.01 in chips) 
Seat 6: Serge Claws ($61.03 in chips) 
Seat 7: kkbruins0408 ($10.19 in chips) 
Seat 8: 1Karina1 ($33.37 in chips) 
Seat 9: NoWurriz ($18.88 in chips) 
chiyuki: posts small blind $0.10
hldtom: posts big blind $0.25
*** HOLE CARDS ***
Dealt to chiyuki [7s 4s]
herkko11: folds 
ChrisCDee: folds 
Serge Claws: raises $0.50 to $0.75
kkbruins0408: folds 
1Karina1: folds 
NoWurriz: folds 
DrunkTyphoon: folds 
chiyuki: folds 
hldtom: folds 
Uncalled bet ($0.50) returned to Serge Claws
Serge Claws collected $0.60 from pot
Serge Claws: doesn't show hand 
*** SUMMARY ***
Total pot $0.60 | Rake $0 
Seat 1: DrunkTyphoon (button) folded before Flop (didn't bet)
Seat 2: chiyuki (small blind) folded before Flop
Seat 3: hldtom (big blind) folded before Flop
Seat 4: herkko11 folded before Flop (didn't bet)
Seat 5: ChrisCDee folded before Flop (didn't bet)
Seat 6: Serge Claws collected ($0.60)
Seat 7: kkbruins0408 folded before Flop (didn't bet)
Seat 8: 1Karina1 folded before Flop (didn't bet)
Seat 9: NoWurriz folded before Flop (didn't bet)



PokerStars Zoom Hand #84300892245:  Hold'em No Limit ($0.10/$0.25) - 2012/08/05 15:58:36 JST [2012/08/05 2:58:36 ET]
Table 'Whirlpool' 9-max Seat #1 is the button
Seat 1: Dejacob ($27.64 in chips) 
Seat 2: Perstenev ($14.69 in chips) 
Seat 3: chiyuki ($50.56 in chips) 
Seat 4: misskitty354 ($9.75 in chips) 
Seat 5: HighDuka ($17.13 in chips) 
Seat 6: azizmimi ($13.71 in chips) 
Seat 7: GovGus ($42.13 in chips) 
Seat 8: CrittHunter ($26.45 in chips) 
Seat 9: wildy29 ($56.69 in chips) 
Perstenev: posts small blind $0.10
chiyuki: posts big blind $0.25
*** HOLE CARDS ***
Dealt to chiyuki [Ts Kd]
misskitty354: folds 
HighDuka: folds 
azizmimi: folds 
GovGus: raises $0.75 to $1
CrittHunter: folds 
wildy29: folds 
Dejacob: folds 
Perstenev: folds 
chiyuki: folds 
Uncalled bet ($0.75) returned to GovGus
GovGus collected $0.60 from pot
GovGus: doesn't show hand 
*** SUMMARY ***
Total pot $0.60 | Rake $0 
Seat 1: Dejacob (button) folded before Flop (didn't bet)
Seat 2: Perstenev (small blind) folded before Flop
Seat 3: chiyuki (big blind) folded before Flop
Seat 4: misskitty354 folded before Flop (didn't bet)
Seat 5: HighDuka folded before Flop (didn't bet)
Seat 6: azizmimi folded before Flop (didn't bet)
Seat 7: GovGus collected ($0.60)
Seat 8: CrittHunter folded before Flop (didn't bet)
Seat 9: wildy29 folded before Flop (didn't bet)



PokerStars Zoom Hand #84300890511:  Hold'em No Limit ($0.10/$0.25) - 2012/08/05 15:58:28 JST [2012/08/05 2:58:28 ET]
Table 'Whirlpool' 9-max Seat #1 is the button
Seat 1: Rilko1975 ($25.27 in chips) 
Seat 2: andy0815r ($24.75 in chips) 
Seat 3: ChrisCDee ($30.01 in chips) 
Seat 4: KrystalAA ($17.46 in chips) 
Seat 5: herkko11 ($5.10 in chips) 
Seat 6: chiyuki ($50.56 in chips) 
Seat 7: yoube ($29.07 in chips) 
Seat 8: 4ydo yogurt ($69.38 in chips) 
Seat 9: DrunkTyphoon ($37.31 in chips) 
andy0815r: posts small blind $0.10
ChrisCDee: posts big blind $0.25
*** HOLE CARDS ***
Dealt to chiyuki [Kd 2c]
KrystalAA: folds 
herkko11: folds 
chiyuki: folds 
yoube: raises $0.40 to $0.65
4ydo yogurt: calls $0.65
DrunkTyphoon: folds 
Rilko1975: folds 
andy0815r: folds 
ChrisCDee: calls $0.40
*** FLOP *** [Tc Ah 8c]
ChrisCDee: checks 
yoube: bets $0.75
4ydo yogurt: calls $0.75
ChrisCDee: calls $0.75
*** TURN *** [Tc Ah 8c] [Ks]
ChrisCDee: checks 
yoube: bets $1.25
4ydo yogurt: calls $1.25
ChrisCDee: calls $1.25
*** RIVER *** [Tc Ah 8c Ks] [8h]
ChrisCDee: checks 
yoube: bets $3.25
4ydo yogurt: folds 
ChrisCDee: folds 
Uncalled bet ($3.25) returned to yoube
yoube collected $7.69 from pot
yoube: doesn't show hand 
*** SUMMARY ***
Total pot $8.05 | Rake $0.36 
Board [Tc Ah 8c Ks 8h]
Seat 1: Rilko1975 (button) folded before Flop (didn't bet)
Seat 2: andy0815r (small blind) folded before Flop
Seat 3: ChrisCDee (big blind) folded on the River
Seat 4: KrystalAA folded before Flop (didn't bet)
Seat 5: herkko11 folded before Flop (didn't bet)
Seat 6: chiyuki folded before Flop (didn't bet)
Seat 7: yoube collected ($7.69)
Seat 8: 4ydo yogurt folded on the River
Seat 9: DrunkTyphoon folded before Flop (didn't bet)



PokerStars Zoom Hand #84300901438:  Hold'em No Limit ($0.10/$0.25) - 2012/08/05 15:59:18 JST [2012/08/05 2:59:18 ET]
Table 'Whirlpool' 9-max Seat #1 is the button
Seat 1: Dejacob ($26.89 in chips) 
Seat 2: Perstenev ($8.20 in chips) 
Seat 3: Rilko1975 ($24.42 in chips) 
Seat 4: FoRlan77 ($25 in chips) 
Seat 5: chiyuki ($50.31 in chips) 
Seat 6: kkbruins0408 ($9.84 in chips) 
Seat 7: ChrisCDee ($55.23 in chips) 
Seat 8: Grishukps ($12.50 in chips) 
Seat 9: DrunkTyphoon ($27.93 in chips) 
Perstenev: posts small blind $0.10
Rilko1975: posts big blind $0.25
*** HOLE CARDS ***
Dealt to chiyuki [3h 4c]
FoRlan77: folds 
chiyuki: folds 
kkbruins0408: folds 
ChrisCDee: folds 
Grishukps: folds 
DrunkTyphoon: folds 
Dejacob: folds 
Perstenev: folds 
Uncalled bet ($0.15) returned to Rilko1975
Rilko1975 collected $0.20 from pot
Rilko1975: doesn't show hand 
*** SUMMARY ***
Total pot $0.20 | Rake $0 
Seat 1: Dejacob (button) folded before Flop (didn't bet)
Seat 2: Perstenev (small blind) folded before Flop
Seat 3: Rilko1975 (big blind) collected ($0.20)
Seat 4: FoRlan77 folded before Flop (didn't bet)
Seat 5: chiyuki folded before Flop (didn't bet)
Seat 6: kkbruins0408 folded before Flop (didn't bet)
Seat 7: ChrisCDee folded before Flop (didn't bet)
Seat 8: Grishukps folded before Flop (didn't bet)
Seat 9: DrunkTyphoon folded before Flop (didn't bet)



PokerStars Zoom Hand #84300898415:  Hold'em No Limit ($0.10/$0.25) - 2012/08/05 15:59:04 JST [2012/08/05 2:59:04 ET]
Table 'Whirlpool' 9-max Seat #1 is the button
Seat 1: chiyuki ($50.31 in chips) 
Seat 2: KsuhaLove ($12.64 in chips) 
Seat 3: romanian c4 ($13.70 in chips) 
Seat 4: KrystalAA ($12.56 in chips) 
Seat 5: Ellen1947 ($33.63 in chips) 
Seat 6: Kasperlmusik ($27.75 in chips) 
Seat 7: seula i ($44.21 in chips) 
Seat 8: silvno31 ($56.74 in chips) 
Seat 9: drunk_bender ($25.30 in chips) 
KsuhaLove: posts small blind $0.10
romanian c4: posts big blind $0.25
*** HOLE CARDS ***
Dealt to chiyuki [Qs 4c]
KrystalAA: folds 
Ellen1947: calls $0.25
Kasperlmusik: raises $0.75 to $1
seula i: folds 
silvno31: folds 
drunk_bender: calls $1
chiyuki: folds 
KsuhaLove: folds 
romanian c4: folds 
Ellen1947: calls $0.75
*** FLOP *** [Kh 6d 6h]
Ellen1947: checks 
Kasperlmusik: bets $1.25
drunk_bender: folds 
Ellen1947: folds 
Uncalled bet ($1.25) returned to Kasperlmusik
Kasperlmusik collected $3.20 from pot
Kasperlmusik: doesn't show hand 
*** SUMMARY ***
Total pot $3.35 | Rake $0.15 
Board [Kh 6d 6h]
Seat 1: chiyuki (button) folded before Flop (didn't bet)
Seat 2: KsuhaLove (small blind) folded before Flop
Seat 3: romanian c4 (big blind) folded before Flop
Seat 4: KrystalAA folded before Flop (didn't bet)
Seat 5: Ellen1947 folded on the Flop
Seat 6: Kasperlmusik collected ($3.20)
Seat 7: seula i folded before Flop (didn't bet)
Seat 8: silvno31 folded before Flop (didn't bet)
Seat 9: drunk_bender folded on the Flop



PokerStars Zoom Hand #84300896874:  Hold'em No Limit ($0.10/$0.25) - 2012/08/05 15:58:57 JST [2012/08/05 2:58:57 ET]
Table 'Whirlpool' 9-max Seat #1 is the button
Seat 1: kkbruins0408 ($9.84 in chips) 
Seat 2: Blikkslager ($14.75 in chips) 
Seat 3: Nerkit ($16.67 in chips) 
Seat 4: Rilko1975 ($25.17 in chips) 
Seat 5: phate-1up ($61.69 in chips) 
Seat 6: EvgenyBaikov ($24.18 in chips) 
Seat 7: chiyuki ($50.31 in chips) 
Seat 8: mjmichi ($36.38 in chips) 
Seat 9: nice.franki ($12.40 in chips) 
Blikkslager: posts small blind $0.10
Nerkit: posts big blind $0.25
*** HOLE CARDS ***
Dealt to chiyuki [9c 5d]
Rilko1975: raises $0.50 to $0.75
phate-1up: folds 
EvgenyBaikov: calls $0.75
chiyuki: folds 
mjmichi: raises $2 to $2.75
nice.franki: raises $9.65 to $12.40 and is all-in
kkbruins0408: folds 
Blikkslager: folds 
Nerkit: folds 
Rilko1975: folds 
EvgenyBaikov: folds 
mjmichi: calls $9.65
*** FLOP *** [Td 6h Tc]
*** TURN *** [Td 6h Tc] [9h]
*** RIVER *** [Td 6h Tc 9h] [5c]
*** SHOW DOWN ***
mjmichi: shows [Qs Qc] (two pair, Queens and Tens)
nice.franki: shows [Ac Ah] (two pair, Aces and Tens)
nice.franki collected $25.45 from pot
*** SUMMARY ***
Total pot $26.65 | Rake $1.20 
Board [Td 6h Tc 9h 5c]
Seat 1: kkbruins0408 (button) folded before Flop (didn't bet)
Seat 2: Blikkslager (small blind) folded before Flop
Seat 3: Nerkit (big blind) folded before Flop
Seat 4: Rilko1975 folded before Flop
Seat 5: phate-1up folded before Flop (didn't bet)
Seat 6: EvgenyBaikov folded before Flop
Seat 7: chiyuki folded before Flop (didn't bet)
Seat 8: mjmichi showed [Qs Qc] and lost with two pair, Queens and Tens
Seat 9: nice.franki showed [Ac Ah] and won ($25.45) with two pair, Aces and Tens



PokerStars Zoom Hand #84300903574:  Hold'em No Limit ($0.10/$0.25) - 2012/08/05 15:59:28 JST [2012/08/05 2:59:28 ET]
Table 'Whirlpool' 9-max Seat #1 is the button
Seat 1: nice.franki ($4.93 in chips) 
Seat 2: chiyuki ($50.31 in chips) 
Seat 3: Serge Claws ($28.30 in chips) 
Seat 4: Grishukps ($12.90 in chips) 
Seat 5: jacquelinewu ($25 in chips) 
Seat 6: Perstenev ($8.10 in chips) 
Seat 7: Roglus ($12.39 in chips) 
Seat 8: kwkim73 ($25.81 in chips) 
Seat 9: phate-1up ($61.69 in chips) 
chiyuki: posts small blind $0.10
Serge Claws: posts big blind $0.25
*** HOLE CARDS ***
Dealt to chiyuki [Jd Kh]
Grishukps: folds 
jacquelinewu: folds 
Perstenev: folds 
Roglus: folds 
kwkim73: folds 
phate-1up: folds 
nice.franki: folds 
chiyuki: raises $0.50 to $0.75
Serge Claws: folds 
Uncalled bet ($0.50) returned to chiyuki
chiyuki collected $0.50 from pot
chiyuki: doesn't show hand 
*** SUMMARY ***
Total pot $0.50 | Rake $0 
Seat 1: nice.franki (button) folded before Flop (didn't bet)
Seat 2: chiyuki (small blind) collected ($0.50)
Seat 3: Serge Claws (big blind) folded before Flop
Seat 4: Grishukps folded before Flop (didn't bet)
Seat 5: jacquelinewu folded before Flop (didn't bet)
Seat 6: Perstenev folded before Flop (didn't bet)
Seat 7: Roglus folded before Flop (didn't bet)
Seat 8: kwkim73 folded before Flop (didn't bet)
Seat 9: phate-1up folded before Flop (didn't bet)



PokerStars Zoom Hand #84300902717:  Hold'em No Limit ($0.10/$0.25) - 2012/08/05 15:59:24 JST [2012/08/05 2:59:24 ET]
Table 'Whirlpool' 9-max Seat #1 is the button
Seat 1: FoRlan77 ($27.83 in chips) 
Seat 2: scaredsare ($30.53 in chips) 
Seat 3: Rici47 ($31.02 in chips) 
Seat 4: seula i ($44.31 in chips) 
Seat 5: Roglus ($12.39 in chips) 
Seat 6: 1Karina1 ($37.24 in chips) 
Seat 7: chiyuki ($50.31 in chips) 
Seat 8: pandaaaaaa ($15.54 in chips) 
Seat 9: kwkim73 ($25.81 in chips) 
scaredsare: posts small blind $0.10
Rici47: posts big blind $0.25
*** HOLE CARDS ***
Dealt to chiyuki [8s 4s]
seula i: folds 
Roglus: folds 
1Karina1: folds 
chiyuki: folds 
pandaaaaaa: folds 
kwkim73: folds 
FoRlan77: folds 
scaredsare: folds 
Uncalled bet ($0.15) returned to Rici47
Rici47 collected $0.20 from pot
Rici47: doesn't show hand 
*** SUMMARY ***
Total pot $0.20 | Rake $0 
Seat 1: FoRlan77 (button) folded before Flop (didn't bet)
Seat 2: scaredsare (small blind) folded before Flop
Seat 3: Rici47 (big blind) collected ($0.20)
Seat 4: seula i folded before Flop (didn't bet)
Seat 5: Roglus folded before Flop (didn't bet)
Seat 6: 1Karina1 folded before Flop (didn't bet)
Seat 7: chiyuki folded before Flop (didn't bet)
Seat 8: pandaaaaaa folded before Flop (didn't bet)
Seat 9: kwkim73 folded before Flop (didn't bet)



PokerStars Zoom Hand #84300899543:  Hold'em No Limit ($0.10/$0.25) - 2012/08/05 15:59:09 JST [2012/08/05 2:59:09 ET]
Table 'Whirlpool' 9-max Seat #1 is the button
Seat 1: TorTrade ($21.50 in chips) 
Seat 2: ShockLaMuc ($15.95 in chips) 
Seat 3: JhonnyP1979 ($16.23 in chips) 
Seat 4: ChrisCDee ($55.23 in chips) 
Seat 5: hldtom ($12.60 in chips) 
Seat 6: Grishukps ($12.90 in chips) 
Seat 7: Nerkit ($12.61 in chips) 
Seat 8: Roglus ($12.39 in chips) 
Seat 9: chiyuki ($50.31 in chips) 
ShockLaMuc: posts small blind $0.10
JhonnyP1979: posts big blind $0.25
*** HOLE CARDS ***
Dealt to chiyuki [Ks 4h]
ChrisCDee: folds 
hldtom: raises $0.50 to $0.75
Grishukps: folds 
Nerkit: folds 
Roglus: folds 
chiyuki: folds 
TorTrade: folds 
ShockLaMuc: calls $0.65
JhonnyP1979: calls $0.50
*** FLOP *** [Kh Qd 8h]
ShockLaMuc: checks 
JhonnyP1979: checks 
hldtom: checks 
*** TURN *** [Kh Qd 8h] [2d]
ShockLaMuc: checks 
JhonnyP1979: checks 
hldtom: bets $3.20
ShockLaMuc: folds 
JhonnyP1979: folds 
Uncalled bet ($3.20) returned to hldtom
hldtom collected $2.15 from pot
hldtom: doesn't show hand 
*** SUMMARY ***
Total pot $2.25 | Rake $0.10 
Board [Kh Qd 8h 2d]
Seat 1: TorTrade (button) folded before Flop (didn't bet)
Seat 2: ShockLaMuc (small blind) folded on the Turn
Seat 3: JhonnyP1979 (big blind) folded on the Turn
Seat 4: ChrisCDee folded before Flop (didn't bet)
Seat 5: hldtom collected ($2.15)
Seat 6: Grishukps folded before Flop (didn't bet)
Seat 7: Nerkit folded before Flop (didn't bet)
Seat 8: Roglus folded before Flop (didn't bet)
Seat 9: chiyuki folded before Flop (didn't bet)



PokerStars Zoom Hand #84300908202:  Hold'em No Limit ($0.10/$0.25) - 2012/08/05 15:59:50 JST [2012/08/05 2:59:50 ET]
Table 'Whirlpool' 9-max Seat #1 is the button
Seat 1: Grishukps ($12.65 in chips) 
Seat 2: INSP!RON ($33.95 in chips) 
Seat 3: chiyuki ($50.56 in chips) 
Seat 4: Fructionar ($44.84 in chips) 
Seat 5: Serge Claws ($39.57 in chips) 
Seat 6: nice.franki ($4.93 in chips) 
Seat 7: Blikkslager ($14.65 in chips) 
Seat 8: rey2040 ($11.70 in chips) 
Seat 9: crazycrown1 ($7.49 in chips) 
INSP!RON: posts small blind $0.10
chiyuki: posts big blind $0.25
*** HOLE CARDS ***
Dealt to chiyuki [5h Kc]
Fructionar: folds 
Serge Claws: folds 
nice.franki: folds 
Blikkslager: folds 
rey2040: folds 
crazycrown1: folds 
Grishukps: raises $0.37 to $0.62
INSP!RON: folds 
chiyuki: folds 
Uncalled bet ($0.37) returned to Grishukps
Grishukps collected $0.60 from pot
Grishukps: doesn't show hand 
*** SUMMARY ***
Total pot $0.60 | Rake $0 
Seat 1: Grishukps (button) collected ($0.60)
Seat 2: INSP!RON (small blind) folded before Flop
Seat 3: chiyuki (big blind) folded before Flop
Seat 4: Fructionar folded before Flop (didn't bet)
Seat 5: Serge Claws folded before Flop (didn't bet)
Seat 6: nice.franki folded before Flop (didn't bet)
Seat 7: Blikkslager folded before Flop (didn't bet)
Seat 8: rey2040 folded before Flop (didn't bet)
Seat 9: crazycrown1 folded before Flop (didn't bet)



PokerStars Zoom Hand #84300897731:  Hold'em No Limit ($0.10/$0.25) - 2012/08/05 15:59:01 JST [2012/08/05 2:59:01 ET]
Table 'Whirlpool' 9-max Seat #1 is the button
Seat 1: deepakmbh ($25 in chips) 
Seat 2: ShockLaMuc ($22.65 in chips) 
Seat 3: Serge Claws ($39.47 in chips) 
Seat 4: chiyuki ($50.31 in chips) 
Seat 5: kwkim73 ($25.81 in chips) 
Seat 6: JhonnyP1979 ($16.23 in chips) 
Seat 7: hldtom ($12.60 in chips) 
Seat 8: MurMurRu ($25 in chips) 
Seat 9: kkbruins0408 ($9.84 in chips) 
ShockLaMuc: posts small blind $0.10
Serge Claws: posts big blind $0.25
*** HOLE CARDS ***
Dealt to chiyuki [5s Kh]
chiyuki: folds 
kwkim73: folds 
JhonnyP1979: folds 
hldtom: folds 
MurMurRu: raises $0.42 to $0.67
kkbruins0408: folds 
deepakmbh: calls $0.67
ShockLaMuc: folds 
Serge Claws: folds 
*** FLOP *** [9h 8h Js]
MurMurRu: checks 
deepakmbh: bets $1
MurMurRu: calls $1
*** TURN *** [9h 8h Js] [Qh]
MurMurRu: checks 
deepakmbh: bets $1.88
MurMurRu: calls $1.88
*** RIVER *** [9h 8h Js Qh] [3s]
MurMurRu: checks 
deepakmbh: bets $4.25
MurMurRu: folds 
Uncalled bet ($4.25) returned to deepakmbh
deepakmbh collected $7.11 from pot
deepakmbh: doesn't show hand 
*** SUMMARY ***
Total pot $7.45 | Rake $0.34 
Board [9h 8h Js Qh 3s]
Seat 1: deepakmbh (button) collected ($7.11)
Seat 2: ShockLaMuc (small blind) folded before Flop
Seat 3: Serge Claws (big blind) folded before Flop
Seat 4: chiyuki folded before Flop (didn't bet)
Seat 5: kwkim73 folded before Flop (didn't bet)
Seat 6: JhonnyP1979 folded before Flop (didn't bet)
Seat 7: hldtom folded before Flop (didn't bet)
Seat 8: MurMurRu folded on the River
Seat 9: kkbruins0408 folded before Flop (didn't bet)



PokerStars Zoom Hand #84300914220:  Hold'em No Limit ($0.10/$0.25) - 2012/08/05 16:00:17 JST [2012/08/05 3:00:17 ET]
Table 'Whirlpool' 9-max Seat #1 is the button
Seat 1: pawn909 ($23.06 in chips) 
Seat 2: jvds114 ($66.11 in chips) 
Seat 3: Kasperlmusik ($28.52 in chips) 
Seat 4: CrittHunter ($24.90 in chips) 
Seat 5: slapshot2011 ($30.22 in chips) 
Seat 6: FoRlan77 ($27.83 in chips) 
Seat 7: laurentzu84 ($35.62 in chips) 
Seat 8: chiyuki ($50.31 in chips) 
Seat 9: Dan Royal ($32.38 in chips) 
jvds114: posts small blind $0.10
Kasperlmusik: posts big blind $0.25
*** HOLE CARDS ***
Dealt to chiyuki [Js 5d]
CrittHunter: folds 
slapshot2011: folds 
FoRlan77: folds 
laurentzu84: folds 
chiyuki: folds 
Dan Royal: folds 
pawn909: folds 
jvds114: folds 
Uncalled bet ($0.15) returned to Kasperlmusik
Kasperlmusik collected $0.20 from pot
Kasperlmusik: doesn't show hand 
*** SUMMARY ***
Total pot $0.20 | Rake $0 
Seat 1: pawn909 (button) folded before Flop (didn't bet)
Seat 2: jvds114 (small blind) folded before Flop
Seat 3: Kasperlmusik (big blind) collected ($0.20)
Seat 4: CrittHunter folded before Flop (didn't bet)
Seat 5: slapshot2011 folded before Flop (didn't bet)
Seat 6: FoRlan77 folded before Flop (didn't bet)
Seat 7: laurentzu84 folded before Flop (didn't bet)
Seat 8: chiyuki folded before Flop (didn't bet)
Seat 9: Dan Royal folded before Flop (didn't bet)



PokerStars Zoom Hand #84300912264:  Hold'em No Limit ($0.10/$0.25) - 2012/08/05 16:00:08 JST [2012/08/05 3:00:08 ET]
Table 'Whirlpool' 9-max Seat #1 is the button
Seat 1: Dionisko ($9.15 in chips) 
Seat 2: Kasperlmusik ($29.70 in chips) 
Seat 3: Grishukps ($13.20 in chips) 
Seat 4: Rici47 ($31.12 in chips) 
Seat 5: Serge Claws ($27.95 in chips) 
Seat 6: chiyuki ($50.31 in chips) 
Seat 7: kwkim73 ($36.70 in chips) 
Seat 8: deepakmbh ($26.47 in chips) 
Seat 9: Ellen1947 ($33.65 in chips) 
Kasperlmusik: posts small blind $0.10
Grishukps: posts big blind $0.25
*** HOLE CARDS ***
Dealt to chiyuki [Ah 2d]
Rici47: folds 
Serge Claws: folds 
chiyuki: folds 
kwkim73: raises $0.50 to $0.75
deepakmbh: calls $0.75
Ellen1947: folds 
Dionisko: folds 
Kasperlmusik: folds 
Grishukps: folds 
*** FLOP *** [As Qc 2h]
kwkim73: checks 
deepakmbh: bets $1
kwkim73: folds 
Uncalled bet ($1) returned to deepakmbh
deepakmbh collected $1.77 from pot
deepakmbh: doesn't show hand 
*** SUMMARY ***
Total pot $1.85 | Rake $0.08 
Board [As Qc 2h]
Seat 1: Dionisko (button) folded before Flop (didn't bet)
Seat 2: Kasperlmusik (small blind) folded before Flop
Seat 3: Grishukps (big blind) folded before Flop
Seat 4: Rici47 folded before Flop (didn't bet)
Seat 5: Serge Claws folded before Flop (didn't bet)
Seat 6: chiyuki folded before Flop (didn't bet)
Seat 7: kwkim73 folded on the Flop
Seat 8: deepakmbh collected ($1.77)
Seat 9: Ellen1947 folded before Flop (didn't bet)



PokerStars Zoom Hand #84300917904:  Hold'em No Limit ($0.10/$0.25) - 2012/08/05 16:00:33 JST [2012/08/05 3:00:33 ET]
Table 'Whirlpool' 9-max Seat #1 is the button
Seat 1: Perstenev ($12.16 in chips) 
Seat 2: 4plankton ($13.23 in chips) 
Seat 3: GovGus ($34.39 in chips) 
Seat 4: chiyuki ($50.31 in chips) 
Seat 5: soul_5577 ($41.36 in chips) 
Seat 6: KrystalAA ($11.51 in chips) 
Seat 7: TorTrade ($21.15 in chips) 
Seat 8: jacquelinewu ($30.34 in chips) 
Seat 9: DrunkTyphoon ($35.86 in chips) 
4plankton: posts small blind $0.10
GovGus: posts big blind $0.25
*** HOLE CARDS ***
Dealt to chiyuki [Js Kc]
chiyuki: folds 
soul_5577: folds 
KrystalAA: folds 
TorTrade: folds 
jacquelinewu: raises $0.50 to $0.75
DrunkTyphoon: folds 
Perstenev: folds 
4plankton: folds 
GovGus: folds 
Uncalled bet ($0.50) returned to jacquelinewu
jacquelinewu collected $0.60 from pot
jacquelinewu: doesn't show hand 
*** SUMMARY ***
Total pot $0.60 | Rake $0 
Seat 1: Perstenev (button) folded before Flop (didn't bet)
Seat 2: 4plankton (small blind) folded before Flop
Seat 3: GovGus (big blind) folded before Flop
Seat 4: chiyuki folded before Flop (didn't bet)
Seat 5: soul_5577 folded before Flop (didn't bet)
Seat 6: KrystalAA folded before Flop (didn't bet)
Seat 7: TorTrade folded before Flop (didn't bet)
Seat 8: jacquelinewu collected ($0.60)
Seat 9: DrunkTyphoon folded before Flop (didn't bet)



PokerStars Zoom Hand #84300913132:  Hold'em No Limit ($0.10/$0.25) - 2012/08/05 16:00:12 JST [2012/08/05 3:00:12 ET]
Table 'Whirlpool' 9-max Seat #1 is the button
Seat 1: Kasperlmusik ($29.60 in chips) 
Seat 2: westhavenbc ($18.11 in chips) 
Seat 3: xxASSO124xx ($11.05 in chips) 
Seat 4: Perstenev ($9.79 in chips) 
Seat 5: chiyuki ($50.31 in chips) 
Seat 6: hldtom ($13.90 in chips) 
Seat 7: phate-1up ($61.34 in chips) 
Seat 8: INSP!RON ($33.85 in chips) 
Seat 9: MurMurRu ($25 in chips) 
westhavenbc: posts small blind $0.10
xxASSO124xx: posts big blind $0.25
*** HOLE CARDS ***
Dealt to chiyuki [9s Tc]
Perstenev: folds 
chiyuki: folds 
hldtom: folds 
phate-1up: folds 
INSP!RON: folds 
MurMurRu: raises $0.42 to $0.67
Kasperlmusik: calls $0.67
westhavenbc: folds 
xxASSO124xx: folds 
*** FLOP *** [8c 4h 3d]
MurMurRu: bets $1.37
Kasperlmusik: calls $1.37
*** TURN *** [8c 4h 3d] [Qc]
MurMurRu: checks 
Kasperlmusik: checks 
*** RIVER *** [8c 4h 3d Qc] [7h]
MurMurRu: checks 
Kasperlmusik: bets $2.25
MurMurRu: folds 
Uncalled bet ($2.25) returned to Kasperlmusik
Kasperlmusik collected $4.23 from pot
Kasperlmusik: doesn't show hand 
*** SUMMARY ***
Total pot $4.43 | Rake $0.20 
Board [8c 4h 3d Qc 7h]
Seat 1: Kasperlmusik (button) collected ($4.23)
Seat 2: westhavenbc (small blind) folded before Flop
Seat 3: xxASSO124xx (big blind) folded before Flop
Seat 4: Perstenev folded before Flop (didn't bet)
Seat 5: chiyuki folded before Flop (didn't bet)
Seat 6: hldtom folded before Flop (didn't bet)
Seat 7: phate-1up folded before Flop (didn't bet)
Seat 8: INSP!RON folded before Flop (didn't bet)
Seat 9: MurMurRu folded on the River



PokerStars Zoom Hand #84300920776:  Hold'em No Limit ($0.10/$0.25) - 2012/08/05 16:00:46 JST [2012/08/05 3:00:46 ET]
Table 'Whirlpool' 9-max Seat #1 is the button
Seat 1: soul_5577 ($41.36 in chips) 
Seat 2: xxASSO124xx ($10.80 in chips) 
Seat 3: Rici47 ($31.02 in chips) 
Seat 4: chiyuki ($50.21 in chips) 
Seat 5: Dionisko ($8.80 in chips) 
Seat 6: DrunkTyphoon ($35.86 in chips) 
Seat 7: Grishukps ($12.50 in chips) 
Seat 8: TorTrade ($21.15 in chips) 
Seat 9: ViTiV2010 ($13.20 in chips) 
xxASSO124xx: posts small blind $0.10
Rici47: posts big blind $0.25
*** HOLE CARDS ***
Dealt to chiyuki [5s 2d]
chiyuki: folds 
Dionisko: folds 
DrunkTyphoon: folds 
Grishukps: folds 
TorTrade: raises $0.75 to $1
ViTiV2010: folds 
soul_5577: folds 
xxASSO124xx: folds 
Rici47: folds 
Uncalled bet ($0.75) returned to TorTrade
TorTrade collected $0.60 from pot
TorTrade: doesn't show hand 
*** SUMMARY ***
Total pot $0.60 | Rake $0 
Seat 1: soul_5577 (button) folded before Flop (didn't bet)
Seat 2: xxASSO124xx (small blind) folded before Flop
Seat 3: Rici47 (big blind) folded before Flop
Seat 4: chiyuki folded before Flop (didn't bet)
Seat 5: Dionisko folded before Flop (didn't bet)
Seat 6: DrunkTyphoon folded before Flop (didn't bet)
Seat 7: Grishukps folded before Flop (didn't bet)
Seat 8: TorTrade collected ($0.60)
Seat 9: ViTiV2010 folded before Flop (didn't bet)



PokerStars Zoom Hand #84300919821:  Hold'em No Limit ($0.10/$0.25) - 2012/08/05 16:00:41 JST [2012/08/05 3:00:41 ET]
Table 'Whirlpool' 9-max Seat #1 is the button
Seat 1: INSP!RON ($34.81 in chips) 
Seat 2: pandaaaaaa ($15.54 in chips) 
Seat 3: xxx Spb xxx ($26.46 in chips) 
Seat 4: TorTrade ($21.15 in chips) 
Seat 5: chiyuki ($50.21 in chips) 
Seat 6: GSDP ($19.71 in chips) 
Seat 7: Faantomace ($40.30 in chips) 
Seat 8: scaredsare ($31.44 in chips) 
Seat 9: Spheroff ($24.90 in chips) 
pandaaaaaa: posts small blind $0.10
xxx Spb xxx: posts big blind $0.25
*** HOLE CARDS ***
Dealt to chiyuki [7s Qh]
TorTrade: folds 
chiyuki: folds 
GSDP: folds 
Faantomace: folds 
scaredsare: folds 
Spheroff: folds 
INSP!RON: raises $0.35 to $0.60
pandaaaaaa: folds 
xxx Spb xxx: folds 
Uncalled bet ($0.35) returned to INSP!RON
INSP!RON collected $0.60 from pot
INSP!RON: doesn't show hand 
*** SUMMARY ***
Total pot $0.60 | Rake $0 
Seat 1: INSP!RON (button) collected ($0.60)
Seat 2: pandaaaaaa (small blind) folded before Flop
Seat 3: xxx Spb xxx (big blind) folded before Flop
Seat 4: TorTrade folded before Flop (didn't bet)
Seat 5: chiyuki folded before Flop (didn't bet)
Seat 6: GSDP folded before Flop (didn't bet)
Seat 7: Faantomace folded before Flop (didn't bet)
Seat 8: scaredsare folded before Flop (didn't bet)
Seat 9: Spheroff folded before Flop (didn't bet)



PokerStars Zoom Hand #84300916986:  Hold'em No Limit ($0.10/$0.25) - 2012/08/05 16:00:29 JST [2012/08/05 3:00:29 ET]
Table 'Whirlpool' 9-max Seat #1 is the button
Seat 1: chiyuki ($50.31 in chips) 
Seat 2: HighDuka ($18.48 in chips) 
Seat 3: Dejacob ($44.91 in chips) 
Seat 4: DrunkTyphoon ($35.86 in chips) 
Seat 5: dergeb ($7.71 in chips) 
Seat 6: xxASSO124xx ($10.80 in chips) 
Seat 7: Dan Royal ($32.38 in chips) 
Seat 8: Blikkslager ($14.25 in chips) 
Seat 9: 4plankton ($13.23 in chips) 
HighDuka: posts small blind $0.10
Dejacob: posts big blind $0.25
*** HOLE CARDS ***
Dealt to chiyuki [6h 7d]
DrunkTyphoon: folds 
dergeb: raises $0.50 to $0.75
xxASSO124xx: folds 
Dan Royal: folds 
Blikkslager: raises $1.50 to $2.25
4plankton: folds 
chiyuki: folds 
HighDuka: folds 
Dejacob: folds 
dergeb: calls $1.50
*** FLOP *** [7c 2h Kh]
dergeb: checks 
Blikkslager: checks 
*** TURN *** [7c 2h Kh] [3c]
dergeb: checks 
Blikkslager: checks 
*** RIVER *** [7c 2h Kh 3c] [7h]
dergeb: checks 
Blikkslager: bets $1.75
dergeb: calls $1.75
*** SHOW DOWN ***
Blikkslager: shows [8c 8s] (two pair, Eights and Sevens)
dergeb: mucks hand 
Blikkslager collected $7.97 from pot
*** SUMMARY ***
Total pot $8.35 | Rake $0.38 
Board [7c 2h Kh 3c 7h]
Seat 1: chiyuki (button) folded before Flop (didn't bet)
Seat 2: HighDuka (small blind) folded before Flop
Seat 3: Dejacob (big blind) folded before Flop
Seat 4: DrunkTyphoon folded before Flop (didn't bet)
Seat 5: dergeb mucked [Ad 6d]
Seat 6: xxASSO124xx folded before Flop (didn't bet)
Seat 7: Dan Royal folded before Flop (didn't bet)
Seat 8: Blikkslager showed [8c 8s] and won ($7.97) with two pair, Eights and Sevens
Seat 9: 4plankton folded before Flop (didn't bet)



PokerStars Zoom Hand #84300924309:  Hold'em No Limit ($0.10/$0.25) - 2012/08/05 16:01:01 JST [2012/08/05 3:01:01 ET]
Table 'Whirlpool' 9-max Seat #1 is the button
Seat 1: Perstenev ($12.16 in chips) 
Seat 2: silvno31 ($55.74 in chips) 
Seat 3: chiyuki ($50.21 in chips) 
Seat 4: TorTrade ($21.50 in chips) 
Seat 5: KrystalAA ($11.86 in chips) 
Seat 6: INSP!RON ($35.16 in chips) 
Seat 7: rey2040 ($12.45 in chips) 
Seat 8: snejokCoxx ($12.50 in chips) 
Seat 9: Dejacob ($25.60 in chips) 
silvno31: posts small blind $0.10
chiyuki: posts big blind $0.25
*** HOLE CARDS ***
Dealt to chiyuki [2c 4s]
TorTrade: folds 
KrystalAA: folds 
INSP!RON: folds 
rey2040: folds 
snejokCoxx: folds 
Dejacob: raises $0.50 to $0.75
Perstenev: folds 
silvno31: folds 
chiyuki: folds 
Uncalled bet ($0.50) returned to Dejacob
Dejacob collected $0.60 from pot
Dejacob: doesn't show hand 
*** SUMMARY ***
Total pot $0.60 | Rake $0 
Seat 1: Perstenev (button) folded before Flop (didn't bet)
Seat 2: silvno31 (small blind) folded before Flop
Seat 3: chiyuki (big blind) folded before Flop
Seat 4: TorTrade folded before Flop (didn't bet)
Seat 5: KrystalAA folded before Flop (didn't bet)
Seat 6: INSP!RON folded before Flop (didn't bet)
Seat 7: rey2040 folded before Flop (didn't bet)
Seat 8: snejokCoxx folded before Flop (didn't bet)
Seat 9: Dejacob collected ($0.60)



PokerStars Zoom Hand #84300928005:  Hold'em No Limit ($0.10/$0.25) - 2012/08/05 16:01:16 JST [2012/08/05 3:01:16 ET]
Table 'Whirlpool' 9-max Seat #1 is the button
Seat 1: chiyuki ($49.96 in chips) 
Seat 2: Serge Claws ($39.57 in chips) 
Seat 3: Roglus ($15.15 in chips) 
Seat 4: jacquelinewu ($28.51 in chips) 
Seat 5: Alvinpe85 ($93.95 in chips) 
Seat 6: romanian c4 ($14.34 in chips) 
Seat 7: DrunkTyphoon ($32.19 in chips) 
Seat 8: rey2040 ($12.20 in chips) 
Seat 9: silvno31 ($55.64 in chips) 
Serge Claws: posts small blind $0.10
Roglus: posts big blind $0.25
*** HOLE CARDS ***
Dealt to chiyuki [Qc 7h]
jacquelinewu: folds 
Alvinpe85: folds 
romanian c4: folds 
DrunkTyphoon: folds 
rey2040: folds 
silvno31: folds 
chiyuki: folds 
Serge Claws: raises $0.50 to $0.75
Roglus: folds 
Uncalled bet ($0.50) returned to Serge Claws
Serge Claws collected $0.50 from pot
Serge Claws: doesn't show hand 
*** SUMMARY ***
Total pot $0.50 | Rake $0 
Seat 1: chiyuki (button) folded before Flop (didn't bet)
Seat 2: Serge Claws (small blind) collected ($0.50)
Seat 3: Roglus (big blind) folded before Flop
Seat 4: jacquelinewu folded before Flop (didn't bet)
Seat 5: Alvinpe85 folded before Flop (didn't bet)
Seat 6: romanian c4 folded before Flop (didn't bet)
Seat 7: DrunkTyphoon folded before Flop (didn't bet)
Seat 8: rey2040 folded before Flop (didn't bet)
Seat 9: silvno31 folded before Flop (didn't bet)



PokerStars Zoom Hand #84300927011:  Hold'em No Limit ($0.10/$0.25) - 2012/08/05 16:01:12 JST [2012/08/05 3:01:12 ET]
Table 'Whirlpool' 9-max Seat #1 is the button
Seat 1: silvno31 ($55.64 in chips) 
Seat 2: Perstenev ($15.94 in chips) 
Seat 3: Cripple86 ($25 in chips) 
Seat 4: masterkoolb ($12.50 in chips) 
Seat 5: Roglus ($15.15 in chips) 
Seat 6: xxx Spb xxx ($26.21 in chips) 
Seat 7: chiyuki ($49.96 in chips) 
Seat 8: Dejacob ($44.56 in chips) 
Seat 9: Serge Claws ($39.57 in chips) 
Perstenev: posts small blind $0.10
Cripple86: posts big blind $0.25
*** HOLE CARDS ***
Dealt to chiyuki [Qc 2h]
masterkoolb: folds 
Roglus: folds 
xxx Spb xxx: folds 
chiyuki: folds 
Dejacob: folds 
Serge Claws: folds 
silvno31: folds 
Perstenev: folds 
Uncalled bet ($0.15) returned to Cripple86
Cripple86 collected $0.20 from pot
Cripple86: doesn't show hand 
*** SUMMARY ***
Total pot $0.20 | Rake $0 
Seat 1: silvno31 (button) folded before Flop (didn't bet)
Seat 2: Perstenev (small blind) folded before Flop
Seat 3: Cripple86 (big blind) collected ($0.20)
Seat 4: masterkoolb folded before Flop (didn't bet)
Seat 5: Roglus folded before Flop (didn't bet)
Seat 6: xxx Spb xxx folded before Flop (didn't bet)
Seat 7: chiyuki folded before Flop (didn't bet)
Seat 8: Dejacob folded before Flop (didn't bet)
Seat 9: Serge Claws folded before Flop (didn't bet)



PokerStars Zoom Hand #84300918820:  Hold'em No Limit ($0.10/$0.25) - 2012/08/05 16:00:37 JST [2012/08/05 3:00:37 ET]
Table 'Whirlpool' 9-max Seat #1 is the button
Seat 1: poorpoor6551 ($12.55 in chips) 
Seat 2: chiyuki ($50.31 in chips) 
Seat 3: phate-1up ($51.86 in chips) 
Seat 4: 1Karina1 ($38.54 in chips) 
Seat 5: 4plankton ($13.13 in chips) 
Seat 6: mjmichi ($25 in chips) 
Seat 7: Dejacob ($44.66 in chips) 
Seat 8: DrunkTyphoon ($35.86 in chips) 
Seat 9: soul_5577 ($41.36 in chips) 
chiyuki: posts small blind $0.10
phate-1up: posts big blind $0.25
*** HOLE CARDS ***
Dealt to chiyuki [9c 2d]
1Karina1: raises $0.50 to $0.75
4plankton: calls $0.75
mjmichi: folds 
Dejacob: folds 
DrunkTyphoon: folds 
soul_5577: folds 
poorpoor6551: folds 
chiyuki: folds 
phate-1up: folds 
*** FLOP *** [9s 6h Ks]
1Karina1: checks 
4plankton: checks 
*** TURN *** [9s 6h Ks] [As]
1Karina1: checks 
4plankton: checks 
*** RIVER *** [9s 6h Ks As] [6c]
1Karina1: checks 
4plankton: checks 
*** SHOW DOWN ***
1Karina1: shows [Qs Qc] (two pair, Queens and Sixes)
4plankton: mucks hand 
1Karina1 collected $1.77 from pot
*** SUMMARY ***
Total pot $1.85 | Rake $0.08 
Board [9s 6h Ks As 6c]
Seat 1: poorpoor6551 (button) folded before Flop (didn't bet)
Seat 2: chiyuki (small blind) folded before Flop
Seat 3: phate-1up (big blind) folded before Flop
Seat 4: 1Karina1 showed [Qs Qc] and won ($1.77) with two pair, Queens and Sixes
Seat 5: 4plankton mucked [7c 7s]
Seat 6: mjmichi folded before Flop (didn't bet)
Seat 7: Dejacob folded before Flop (didn't bet)
Seat 8: DrunkTyphoon folded before Flop (didn't bet)
Seat 9: soul_5577 folded before Flop (didn't bet)



PokerStars Zoom Hand #84300921477:  Hold'em No Limit ($0.10/$0.25) - 2012/08/05 16:00:49 JST [2012/08/05 3:00:49 ET]
Table 'Whirlpool' 9-max Seat #1 is the button
Seat 1: Dejacob ($25.60 in chips) 
Seat 2: kesstukas25 ($29.91 in chips) 
Seat 3: kwkim73 ($35.85 in chips) 
Seat 4: munky3 ($38.85 in chips) 
Seat 5: boboshooter ($27.82 in chips) 
Seat 6: chiyuki ($50.21 in chips) 
Seat 7: Grishukps ($12.85 in chips) 
Seat 8: phate-1up ($51.61 in chips) 
Seat 9: pandaaaaaa ($15.44 in chips) 
kesstukas25: posts small blind $0.10
kwkim73: posts big blind $0.25
*** HOLE CARDS ***
Dealt to chiyuki [2s Jh]
munky3: calls $0.25
boboshooter: folds 
chiyuki: folds 
Grishukps: folds 
phate-1up: folds 
pandaaaaaa: folds 
Dejacob: folds 
kesstukas25: raises $0.50 to $0.75
kwkim73: folds 
munky3: calls $0.50
*** FLOP *** [7d 7h 2c]
kesstukas25: checks 
munky3: checks 
*** TURN *** [7d 7h 2c] [3d]
kesstukas25: checks 
munky3: checks 
*** RIVER *** [7d 7h 2c 3d] [Th]
kesstukas25: checks 
munky3: checks 
*** SHOW DOWN ***
kesstukas25: shows [9h As] (a pair of Sevens)
munky3: mucks hand 
kesstukas25 collected $1.67 from pot
*** SUMMARY ***
Total pot $1.75 | Rake $0.08 
Board [7d 7h 2c 3d Th]
Seat 1: Dejacob (button) folded before Flop (didn't bet)
Seat 2: kesstukas25 (small blind) showed [9h As] and won ($1.67) with a pair of Sevens
Seat 3: kwkim73 (big blind) folded before Flop
Seat 4: munky3 mucked [Ks Qc]
Seat 5: boboshooter folded before Flop (didn't bet)
Seat 6: chiyuki folded before Flop (didn't bet)
Seat 7: Grishukps folded before Flop (didn't bet)
Seat 8: phate-1up folded before Flop (didn't bet)
Seat 9: pandaaaaaa folded before Flop (didn't bet)



PokerStars Zoom Hand #84300915598:  Hold'em No Limit ($0.10/$0.25) - 2012/08/05 16:00:23 JST [2012/08/05 3:00:23 ET]
Table 'Whirlpool' 9-max Seat #1 is the button
Seat 1: Tonychanman ($24.15 in chips) 
Seat 2: Nerkit ($16.07 in chips) 
Seat 3: INSP!RON ($38.71 in chips) 
Seat 4: ShockLaMuc ($21.80 in chips) 
Seat 5: schoof 2 ($34.07 in chips) 
Seat 6: pandaaaaaa ($15.54 in chips) 
Seat 7: KrystalAA ($11.51 in chips) 
Seat 8: soul_5577 ($41.46 in chips) 
Seat 9: chiyuki ($50.31 in chips) 
Nerkit: posts small blind $0.10
INSP!RON: posts big blind $0.25
*** HOLE CARDS ***
Dealt to chiyuki [3s 6s]
ShockLaMuc: folds 
schoof 2: calls $0.25
pandaaaaaa: folds 
KrystalAA: folds 
soul_5577: folds 
chiyuki: folds 
Tonychanman: raises $0.50 to $0.75
Nerkit: folds 
INSP!RON: raises $1.85 to $2.60
schoof 2: calls $2.35
Tonychanman: calls $1.85
*** FLOP *** [3c 4c Qs]
INSP!RON: bets $3.80
schoof 2: calls $3.80
Tonychanman: folds 
*** TURN *** [3c 4c Qs] [2s]
INSP!RON: checks 
schoof 2: bets $10.75
INSP!RON: calls $10.75
*** RIVER *** [3c 4c Qs 2s] [2h]
INSP!RON: checks 
schoof 2: bets $16.92 and is all-in
INSP!RON: folds 
Uncalled bet ($16.92) returned to schoof 2
schoof 2 collected $35.34 from pot
schoof 2: doesn't show hand 
*** SUMMARY ***
Total pot $37 | Rake $1.66 
Board [3c 4c Qs 2s 2h]
Seat 1: Tonychanman (button) folded on the Flop
Seat 2: Nerkit (small blind) folded before Flop
Seat 3: INSP!RON (big blind) folded on the River
Seat 4: ShockLaMuc folded before Flop (didn't bet)
Seat 5: schoof 2 collected ($35.34)
Seat 6: pandaaaaaa folded before Flop (didn't bet)
Seat 7: KrystalAA folded before Flop (didn't bet)
Seat 8: soul_5577 folded before Flop (didn't bet)
Seat 9: chiyuki folded before Flop (didn't bet)



PokerStars Zoom Hand #84300930367:  Hold'em No Limit ($0.10/$0.25) - 2012/08/05 16:01:25 JST [2012/08/05 3:01:25 ET]
Table 'Whirlpool' 9-max Seat #1 is the button
Seat 1: kwkim73 ($25 in chips) 
Seat 2: GovGus ($58.83 in chips) 
Seat 3: seula i ($27.32 in chips) 
Seat 4: Kasperlmusik ($28.52 in chips) 
Seat 5: jacquelinewu ($26.59 in chips) 
Seat 6: xxASSO124xx ($11.05 in chips) 
Seat 7: pawn909 ($22.71 in chips) 
Seat 8: xxx Spb xxx ($26.21 in chips) 
Seat 9: chiyuki ($49.96 in chips) 
GovGus: posts small blind $0.10
seula i: posts big blind $0.25
*** HOLE CARDS ***
Dealt to chiyuki [9d 5h]
Kasperlmusik: folds 
jacquelinewu: folds 
xxASSO124xx: folds 
pawn909: folds 
xxx Spb xxx: folds 
chiyuki: folds 
kwkim73: raises $0.50 to $0.75
GovGus: folds 
seula i: folds 
Uncalled bet ($0.50) returned to kwkim73
kwkim73 collected $0.60 from pot
kwkim73: doesn't show hand 
*** SUMMARY ***
Total pot $0.60 | Rake $0 
Seat 1: kwkim73 (button) collected ($0.60)
Seat 2: GovGus (small blind) folded before Flop
Seat 3: seula i (big blind) folded before Flop
Seat 4: Kasperlmusik folded before Flop (didn't bet)
Seat 5: jacquelinewu folded before Flop (didn't bet)
Seat 6: xxASSO124xx folded before Flop (didn't bet)
Seat 7: pawn909 folded before Flop (didn't bet)
Seat 8: xxx Spb xxx folded before Flop (didn't bet)
Seat 9: chiyuki folded before Flop (didn't bet)



PokerStars Zoom Hand #84300932354:  Hold'em No Limit ($0.10/$0.25) - 2012/08/05 16:01:33 JST [2012/08/05 3:01:33 ET]
Table 'Whirlpool' 9-max Seat #1 is the button
Seat 1: Perstenev ($15.84 in chips) 
Seat 2: Femali54 ($26.93 in chips) 
Seat 3: xxASSO124xx ($11.05 in chips) 
Seat 4: DrunkTyphoon ($32.19 in chips) 
Seat 5: Dejacob ($25.95 in chips) 
Seat 6: phate-1up ($41.82 in chips) 
Seat 7: Rici47 ($25.50 in chips) 
Seat 8: chiyuki ($49.96 in chips) 
Seat 9: jacquelinewu ($28.51 in chips) 
Femali54: posts small blind $0.10
xxASSO124xx: posts big blind $0.25
*** HOLE CARDS ***
Dealt to chiyuki [6s 3s]
DrunkTyphoon: folds 
Dejacob: folds 
phate-1up: folds 
Rici47: folds 
chiyuki: folds 
jacquelinewu: folds 
Perstenev: folds 
Femali54: folds 
Uncalled bet ($0.15) returned to xxASSO124xx
xxASSO124xx collected $0.20 from pot
xxASSO124xx: doesn't show hand 
*** SUMMARY ***
Total pot $0.20 | Rake $0 
Seat 1: Perstenev (button) folded before Flop (didn't bet)
Seat 2: Femali54 (small blind) folded before Flop
Seat 3: xxASSO124xx (big blind) collected ($0.20)
Seat 4: DrunkTyphoon folded before Flop (didn't bet)
Seat 5: Dejacob folded before Flop (didn't bet)
Seat 6: phate-1up folded before Flop (didn't bet)
Seat 7: Rici47 folded before Flop (didn't bet)
Seat 8: chiyuki folded before Flop (didn't bet)
Seat 9: jacquelinewu folded before Flop (didn't bet)



PokerStars Zoom Hand #84300935138:  Hold'em No Limit ($0.10/$0.25) - 2012/08/05 16:01:44 JST [2012/08/05 3:01:44 ET]
Table 'Whirlpool' 9-max Seat #1 is the button
Seat 1: MurMurRu ($25 in chips) 
Seat 2: seula i ($27.07 in chips) 
Seat 3: chiyuki ($49.96 in chips) 
Seat 4: Afcawins25 ($9.94 in chips) 
Seat 5: silvno31 ($55.39 in chips) 
Seat 6: Trip_Krowns ($27.39 in chips) 
Seat 7: xxx Spb xxx ($26.21 in chips) 
Seat 8: hldtom ($18.90 in chips) 
Seat 9: Perstenev ($11.81 in chips) 
seula i: posts small blind $0.10
chiyuki: posts big blind $0.25
*** HOLE CARDS ***
Dealt to chiyuki [As Td]
Afcawins25: folds 
silvno31: folds 
Trip_Krowns: folds 
xxx Spb xxx: folds 
hldtom: raises $0.50 to $0.75
Perstenev: folds 
MurMurRu: folds 
seula i: folds 
chiyuki: folds 
Uncalled bet ($0.50) returned to hldtom
hldtom collected $0.60 from pot
hldtom: doesn't show hand 
*** SUMMARY ***
Total pot $0.60 | Rake $0 
Seat 1: MurMurRu (button) folded before Flop (didn't bet)
Seat 2: seula i (small blind) folded before Flop
Seat 3: chiyuki (big blind) folded before Flop
Seat 4: Afcawins25 folded before Flop (didn't bet)
Seat 5: silvno31 folded before Flop (didn't bet)
Seat 6: Trip_Krowns folded before Flop (didn't bet)
Seat 7: xxx Spb xxx folded before Flop (didn't bet)
Seat 8: hldtom collected ($0.60)
Seat 9: Perstenev folded before Flop (didn't bet)



PokerStars Zoom Hand #84300933327:  Hold'em No Limit ($0.10/$0.25) - 2012/08/05 16:01:37 JST [2012/08/05 3:01:37 ET]
Table 'Whirlpool' 9-max Seat #1 is the button
Seat 1: Serge Claws ($39.82 in chips) 
Seat 2: MurMurRu ($28.74 in chips) 
Seat 3: Grishukps ($12.50 in chips) 
Seat 4: GSDP ($18.96 in chips) 
Seat 5: chiyuki ($49.96 in chips) 
Seat 6: seula i ($72.12 in chips) 
Seat 7: Perstenev ($15.84 in chips) 
Seat 8: Femali54 ($26.83 in chips) 
Seat 9: Rici47 ($25.50 in chips) 
MurMurRu: posts small blind $0.10
Grishukps: posts big blind $0.25
*** HOLE CARDS ***
Dealt to chiyuki [6d Qs]
GSDP: folds 
chiyuki: folds 
seula i: folds 
Perstenev: folds 
Femali54: folds 
Rici47: folds 
Serge Claws: raises $0.50 to $0.75
MurMurRu: raises $1.60 to $2.35
Grishukps: folds 
Serge Claws: calls $1.60
*** FLOP *** [2h 8s 7h]
MurMurRu: checks 
Serge Claws: bets $2.50
MurMurRu: folds 
Uncalled bet ($2.50) returned to Serge Claws
Serge Claws collected $4.73 from pot
Serge Claws: doesn't show hand 
*** SUMMARY ***
Total pot $4.95 | Rake $0.22 
Board [2h 8s 7h]
Seat 1: Serge Claws (button) collected ($4.73)
Seat 2: MurMurRu (small blind) folded on the Flop
Seat 3: Grishukps (big blind) folded before Flop
Seat 4: GSDP folded before Flop (didn't bet)
Seat 5: chiyuki folded before Flop (didn't bet)
Seat 6: seula i folded before Flop (didn't bet)
Seat 7: Perstenev folded before Flop (didn't bet)
Seat 8: Femali54 folded before Flop (didn't bet)
Seat 9: Rici47 folded before Flop (didn't bet)



PokerStars Zoom Hand #84300934132:  Hold'em No Limit ($0.10/$0.25) - 2012/08/05 16:01:40 JST [2012/08/05 3:01:40 ET]
Table 'Whirlpool' 9-max Seat #1 is the button
Seat 1: andy0815r ($26.74 in chips) 
Seat 2: masterkoolb ($12.85 in chips) 
Seat 3: nice.franki ($12.50 in chips) 
Seat 4: kesstukas25 ($14.82 in chips) 
Seat 5: jacquelinewu ($28.51 in chips) 
Seat 6: Kozyavkin ($10.94 in chips) 
Seat 7: chiyuki ($49.96 in chips) 
Seat 8: silvno31 ($55.39 in chips) 
Seat 9: crazycrown1 ($8.89 in chips) 
masterkoolb: posts small blind $0.10
nice.franki: posts big blind $0.25
*** HOLE CARDS ***
Dealt to chiyuki [9s Jh]
kesstukas25: folds 
jacquelinewu: raises $0.50 to $0.75
Kozyavkin: calls $0.75
chiyuki: folds 
silvno31: folds 
crazycrown1: calls $0.75
andy0815r: raises $13.50 to $14.25
masterkoolb: folds 
nice.franki: folds 
jacquelinewu: folds 
Kozyavkin: folds 
crazycrown1: calls $8.14 and is all-in
Uncalled bet ($5.36) returned to andy0815r
*** FLOP *** [5d 3d 4d]
*** TURN *** [5d 3d 4d] [Js]
*** RIVER *** [5d 3d 4d Js] [8d]
*** SHOW DOWN ***
crazycrown1: shows [Jd Kc] (a flush, Jack high)
andy0815r: shows [Ah Ad] (a flush, Ace high)
andy0815r collected $18.75 from pot
*** SUMMARY ***
Total pot $19.63 | Rake $0.88 
Board [5d 3d 4d Js 8d]
Seat 1: andy0815r (button) showed [Ah Ad] and won ($18.75) with a flush, Ace high
Seat 2: masterkoolb (small blind) folded before Flop
Seat 3: nice.franki (big blind) folded before Flop
Seat 4: kesstukas25 folded before Flop (didn't bet)
Seat 5: jacquelinewu folded before Flop
Seat 6: Kozyavkin folded before Flop
Seat 7: chiyuki folded before Flop (didn't bet)
Seat 8: silvno31 folded before Flop (didn't bet)
Seat 9: crazycrown1 showed [Jd Kc] and lost with a flush, Jack high



PokerStars Zoom Hand #84300938393:  Hold'em No Limit ($0.10/$0.25) - 2012/08/05 16:01:58 JST [2012/08/05 3:01:58 ET]
Table 'Whirlpool' 9-max Seat #1 is the button
Seat 1: kesstukas25 ($30.83 in chips) 
Seat 2: chiyuki ($49.71 in chips) 
Seat 3: GovGus ($58.73 in chips) 
Seat 4: Bahia gyn ($26.16 in chips) 
Seat 5: nice.franki ($6.07 in chips) 
Seat 6: Femali54 ($26.83 in chips) 
Seat 7: PPP7SSS ($28.43 in chips) 
Seat 8: jvds114 ($62.91 in chips) 
Seat 9: xxx Spb xxx ($26.21 in chips) 
chiyuki: posts small blind $0.10
GovGus: posts big blind $0.25
*** HOLE CARDS ***
Dealt to chiyuki [Ts Kh]
Bahia gyn: folds 
nice.franki: folds 
Femali54: folds 
PPP7SSS: folds 
jvds114: folds 
xxx Spb xxx: folds 
kesstukas25: folds 
chiyuki: raises $0.50 to $0.75
GovGus: calls $0.50
*** FLOP *** [Qc 9h 9c]
chiyuki: bets $0.75
GovGus: calls $0.75
*** TURN *** [Qc 9h 9c] [Ks]
chiyuki: checks 
GovGus: bets $1.85
chiyuki: calls $1.85
*** RIVER *** [Qc 9h 9c Ks] [Jh]
chiyuki: checks 
GovGus: checks 
*** SHOW DOWN ***
chiyuki: shows [Ts Kh] (a straight, Nine to King)
GovGus: mucks hand 
chiyuki collected $6.40 from pot
*** SUMMARY ***
Total pot $6.70 | Rake $0.30 
Board [Qc 9h 9c Ks Jh]
Seat 1: kesstukas25 (button) folded before Flop (didn't bet)
Seat 2: chiyuki (small blind) showed [Ts Kh] and won ($6.40) with a straight, Nine to King
Seat 3: GovGus (big blind) mucked [Jd Qh]
Seat 4: Bahia gyn folded before Flop (didn't bet)
Seat 5: nice.franki folded before Flop (didn't bet)
Seat 6: Femali54 folded before Flop (didn't bet)
Seat 7: PPP7SSS folded before Flop (didn't bet)
Seat 8: jvds114 folded before Flop (didn't bet)
Seat 9: xxx Spb xxx folded before Flop (didn't bet)



PokerStars Zoom Hand #84300954870:  Hold'em No Limit ($0.10/$0.25) - 2012/08/05 16:03:02 JST [2012/08/05 3:03:02 ET]
Table 'Whirlpool' 9-max Seat #1 is the button
Seat 1: GovGus ($55.38 in chips) 
Seat 2: westhavenbc ($17.01 in chips) 
Seat 3: Perstenev ($15.84 in chips) 
Seat 4: kwkim73 ($26.59 in chips) 
Seat 5: hldtom ($25 in chips) 
Seat 6: chiyuki ($52.76 in chips) 
Seat 7: Dejacob ($28 in chips) 
Seat 8: DanielWhyte ($23.48 in chips) 
Seat 9: Alvinpe85 ($94.95 in chips) 
westhavenbc: posts small blind $0.10
Perstenev: posts big blind $0.25
*** HOLE CARDS ***
Dealt to chiyuki [Th Td]
kwkim73: raises $0.50 to $0.75
hldtom: folds 
chiyuki: raises $1.50 to $2.25
Dejacob: folds 
DanielWhyte: folds 
Alvinpe85: folds 
GovGus: folds 
westhavenbc: folds 
Perstenev: folds 
kwkim73: raises $4.25 to $6.50
chiyuki: folds 
Uncalled bet ($4.25) returned to kwkim73
kwkim73 collected $4.85 from pot
kwkim73: doesn't show hand 
*** SUMMARY ***
Total pot $4.85 | Rake $0 
Seat 1: GovGus (button) folded before Flop (didn't bet)
Seat 2: westhavenbc (small blind) folded before Flop
Seat 3: Perstenev (big blind) folded before Flop
Seat 4: kwkim73 collected ($4.85)
Seat 5: hldtom folded before Flop (didn't bet)
Seat 6: chiyuki folded before Flop
Seat 7: Dejacob folded before Flop (didn't bet)
Seat 8: DanielWhyte folded before Flop (didn't bet)
Seat 9: Alvinpe85 folded before Flop (didn't bet)



PokerStars Zoom Hand #84300967192:  Hold'em No Limit ($0.10/$0.25) - 2012/08/05 16:03:50 JST [2012/08/05 3:03:50 ET]
Table 'Whirlpool' 9-max Seat #1 is the button
Seat 1: chiyuki ($50.51 in chips) 
Seat 2: snejokCoxx ($12.60 in chips) 
Seat 3: nice.franki ($5.72 in chips) 
Seat 4: Femali54 ($23.33 in chips) 
Seat 5: Rici47 ($26.99 in chips) 
Seat 6: deepakmbh ($27.64 in chips) 
Seat 7: Grishukps ($12.60 in chips) 
Seat 8: Spheroff ($24.55 in chips) 
Seat 9: MurMurRu ($26.47 in chips) 
snejokCoxx: posts small blind $0.10
nice.franki: posts big blind $0.25
*** HOLE CARDS ***
Dealt to chiyuki [3h 8s]
Femali54: raises $0.50 to $0.75
Rici47: folds 
deepakmbh: folds 
Grishukps: folds 
Spheroff: folds 
MurMurRu: folds 
chiyuki: folds 
snejokCoxx: folds 
nice.franki: raises $4.97 to $5.72 and is all-in
Femali54: folds 
Uncalled bet ($4.97) returned to nice.franki
nice.franki collected $1.60 from pot
nice.franki: doesn't show hand 
*** SUMMARY ***
Total pot $1.60 | Rake $0 
Seat 1: chiyuki (button) folded before Flop (didn't bet)
Seat 2: snejokCoxx (small blind) folded before Flop
Seat 3: nice.franki (big blind) collected ($1.60)
Seat 4: Femali54 folded before Flop
Seat 5: Rici47 folded before Flop (didn't bet)
Seat 6: deepakmbh folded before Flop (didn't bet)
Seat 7: Grishukps folded before Flop (didn't bet)
Seat 8: Spheroff folded before Flop (didn't bet)
Seat 9: MurMurRu folded before Flop (didn't bet)



PokerStars Zoom Hand #84300972345:  Hold'em No Limit ($0.10/$0.25) - 2012/08/05 16:04:10 JST [2012/08/05 3:04:10 ET]
Table 'Whirlpool' 9-max Seat #1 is the button
Seat 1: fil740 ($33.78 in chips) 
Seat 2: Vall179 ($24.75 in chips) 
Seat 3: ShockLaMuc ($22.55 in chips) 
Seat 4: kwkim73 ($29.19 in chips) 
Seat 5: chiyuki ($50.51 in chips) 
Seat 6: Spheroff ($24.55 in chips) 
Seat 7: pawn909 ($20.23 in chips) 
Seat 8: Cripple86 ($25.60 in chips) 
Seat 9: codan23 ($12.15 in chips) 
Vall179: posts small blind $0.10
ShockLaMuc: posts big blind $0.25
*** HOLE CARDS ***
Dealt to chiyuki [2h Qc]
kwkim73: raises $0.50 to $0.75
chiyuki: folds 
Spheroff: folds 
pawn909: folds 
Cripple86: folds 
codan23: folds 
fil740: folds 
Vall179: folds 
ShockLaMuc: folds 
Uncalled bet ($0.50) returned to kwkim73
kwkim73 collected $0.60 from pot
kwkim73: doesn't show hand 
*** SUMMARY ***
Total pot $0.60 | Rake $0 
Seat 1: fil740 (button) folded before Flop (didn't bet)
Seat 2: Vall179 (small blind) folded before Flop
Seat 3: ShockLaMuc (big blind) folded before Flop
Seat 4: kwkim73 collected ($0.60)
Seat 5: chiyuki folded before Flop (didn't bet)
Seat 6: Spheroff folded before Flop (didn't bet)
Seat 7: pawn909 folded before Flop (didn't bet)
Seat 8: Cripple86 folded before Flop (didn't bet)
Seat 9: codan23 folded before Flop (didn't bet)



PokerStars Zoom Hand #84300974987:  Hold'em No Limit ($0.10/$0.25) - 2012/08/05 16:04:20 JST [2012/08/05 3:04:20 ET]
Table 'Whirlpool' 9-max Seat #1 is the button
Seat 1: DrunkTyphoon ($36.34 in chips) 
Seat 2: kwkim73 ($34.10 in chips) 
Seat 3: Cripple86 ($26.49 in chips) 
Seat 4: chiyuki ($50.51 in chips) 
Seat 5: pandaaaaaa ($18.56 in chips) 
Seat 6: Rilko1975 ($22.40 in chips) 
Seat 7: schoof 2 ($57.19 in chips) 
Seat 8: kesstukas25 ($30.73 in chips) 
Seat 9: Dejacob ($28.84 in chips) 
kwkim73: posts small blind $0.10
Cripple86: posts big blind $0.25
*** HOLE CARDS ***
Dealt to chiyuki [8c Ts]
chiyuki: folds 
pandaaaaaa: folds 
Rilko1975: folds 
schoof 2: folds 
kesstukas25: folds 
Dejacob: folds 
DrunkTyphoon: folds 
kwkim73: folds 
Uncalled bet ($0.15) returned to Cripple86
Cripple86 collected $0.20 from pot
Cripple86: doesn't show hand 
*** SUMMARY ***
Total pot $0.20 | Rake $0 
Seat 1: DrunkTyphoon (button) folded before Flop (didn't bet)
Seat 2: kwkim73 (small blind) folded before Flop
Seat 3: Cripple86 (big blind) collected ($0.20)
Seat 4: chiyuki folded before Flop (didn't bet)
Seat 5: pandaaaaaa folded before Flop (didn't bet)
Seat 6: Rilko1975 folded before Flop (didn't bet)
Seat 7: schoof 2 folded before Flop (didn't bet)
Seat 8: kesstukas25 folded before Flop (didn't bet)
Seat 9: Dejacob folded before Flop (didn't bet)



PokerStars Zoom Hand #84300977160:  Hold'em No Limit ($0.10/$0.25) - 2012/08/05 16:04:29 JST [2012/08/05 3:04:29 ET]
Table 'Whirlpool' 9-max Seat #1 is the button
Seat 1: Cripple86 ($25 in chips) 
Seat 2: hldtom ($25.45 in chips) 
Seat 3: zongo1 ($23.80 in chips) 
Seat 4: Grishukps ($12.50 in chips) 
Seat 5: masterkoolb ($12.50 in chips) 
Seat 6: DrunkTyphoon ($36.85 in chips) 
Seat 7: fil740 ($33.78 in chips) 
Seat 8: chiyuki ($50.51 in chips) 
Seat 9: roksmokndonk ($25.99 in chips) 
hldtom: posts small blind $0.10
zongo1: posts big blind $0.25
*** HOLE CARDS ***
Dealt to chiyuki [Kh 8h]
Grishukps: folds 
masterkoolb: folds 
DrunkTyphoon: folds 
fil740: raises $0.50 to $0.75
chiyuki: folds 
roksmokndonk: folds 
Cripple86: folds 
hldtom: folds 
zongo1: folds 
Uncalled bet ($0.50) returned to fil740
fil740 collected $0.60 from pot
fil740: doesn't show hand 
*** SUMMARY ***
Total pot $0.60 | Rake $0 
Seat 1: Cripple86 (button) folded before Flop (didn't bet)
Seat 2: hldtom (small blind) folded before Flop
Seat 3: zongo1 (big blind) folded before Flop
Seat 4: Grishukps folded before Flop (didn't bet)
Seat 5: masterkoolb folded before Flop (didn't bet)
Seat 6: DrunkTyphoon folded before Flop (didn't bet)
Seat 7: fil740 collected ($0.60)
Seat 8: chiyuki folded before Flop (didn't bet)
Seat 9: roksmokndonk folded before Flop (didn't bet)



PokerStars Zoom Hand #84300975835:  Hold'em No Limit ($0.10/$0.25) - 2012/08/05 16:04:24 JST [2012/08/05 3:04:24 ET]
Table 'Whirlpool' 9-max Seat #1 is the button
Seat 1: roksmokndonk ($25.99 in chips) 
Seat 2: pandaaaaaa ($18.56 in chips) 
Seat 3: kesstukas25 ($14.04 in chips) 
Seat 4: phate-1up ($59.64 in chips) 
Seat 5: DrunkTyphoon ($36.85 in chips) 
Seat 6: Grishukps ($12.50 in chips) 
Seat 7: Dan Royal ($30.24 in chips) 
Seat 8: Perstenev ($8.43 in chips) 
Seat 9: chiyuki ($50.51 in chips) 
pandaaaaaa: posts small blind $0.10
kesstukas25: posts big blind $0.25
*** HOLE CARDS ***
Dealt to chiyuki [Kh 9d]
phate-1up has timed out
phate-1up: folds 
DrunkTyphoon: folds 
Grishukps: folds 
Dan Royal: folds 
Perstenev: raises $0.50 to $0.75
chiyuki: folds 
roksmokndonk: folds 
pandaaaaaa: folds 
kesstukas25: folds 
Uncalled bet ($0.50) returned to Perstenev
Perstenev collected $0.60 from pot
Perstenev: doesn't show hand 
*** SUMMARY ***
Total pot $0.60 | Rake $0 
Seat 1: roksmokndonk (button) folded before Flop (didn't bet)
Seat 2: pandaaaaaa (small blind) folded before Flop
Seat 3: kesstukas25 (big blind) folded before Flop
Seat 4: phate-1up folded before Flop (didn't bet)
Seat 5: DrunkTyphoon folded before Flop (didn't bet)
Seat 6: Grishukps folded before Flop (didn't bet)
Seat 7: Dan Royal folded before Flop (didn't bet)
Seat 8: Perstenev collected ($0.60)
Seat 9: chiyuki folded before Flop (didn't bet)



PokerStars Zoom Hand #84300978191:  Hold'em No Limit ($0.10/$0.25) - 2012/08/05 16:04:33 JST [2012/08/05 3:04:33 ET]
Table 'Whirlpool' 9-max Seat #1 is the button
Seat 1: GSDP ($19.39 in chips) 
Seat 2: 1Karina1 ($38.21 in chips) 
Seat 3: Grumpy as 2 ($13 in chips) 
Seat 4: chiyuki ($50.51 in chips) 
Seat 5: Serge Claws ($27.74 in chips) 
Seat 6: ivan130 ($22.90 in chips) 
Seat 7: Nerkit ($15 in chips) 
Seat 8: masterkoolb ($12.50 in chips) 
Seat 9: snejokCoxx ($12.15 in chips) 
1Karina1: posts small blind $0.10
Grumpy as 2: posts big blind $0.25
*** HOLE CARDS ***
Dealt to chiyuki [Tc 8c]
chiyuki: folds 
Serge Claws: raises $0.50 to $0.75
ivan130: calls $0.75
Nerkit: folds 
masterkoolb: folds 
snejokCoxx: folds 
GSDP: folds 
1Karina1: folds 
Grumpy as 2: folds 
*** FLOP *** [Kd 6c 7c]
Serge Claws: bets $1.25
ivan130: calls $1.25
*** TURN *** [Kd 6c 7c] [Js]
Serge Claws: bets $3
ivan130: folds 
Uncalled bet ($3) returned to Serge Claws
Serge Claws collected $4.15 from pot
Serge Claws: doesn't show hand 
*** SUMMARY ***
Total pot $4.35 | Rake $0.20 
Board [Kd 6c 7c Js]
Seat 1: GSDP (button) folded before Flop (didn't bet)
Seat 2: 1Karina1 (small blind) folded before Flop
Seat 3: Grumpy as 2 (big blind) folded before Flop
Seat 4: chiyuki folded before Flop (didn't bet)
Seat 5: Serge Claws collected ($4.15)
Seat 6: ivan130 folded on the Turn
Seat 7: Nerkit folded before Flop (didn't bet)
Seat 8: masterkoolb folded before Flop (didn't bet)
Seat 9: snejokCoxx folded before Flop (didn't bet)



PokerStars Zoom Hand #84300979967:  Hold'em No Limit ($0.10/$0.25) - 2012/08/05 16:04:39 JST [2012/08/05 3:04:39 ET]
Table 'Whirlpool' 9-max Seat #1 is the button
Seat 1: chiyuki ($50.51 in chips) 
Seat 2: opie62 ($29.45 in chips) 
Seat 3: DrunkTyphoon ($36.85 in chips) 
Seat 4: ShockLaMuc ($26.20 in chips) 
Seat 5: Nerkit ($15 in chips) 
Seat 6: jacquelinewu ($25.59 in chips) 
Seat 7: TorTrade ($22.52 in chips) 
Seat 8: Rici47 ($26.49 in chips) 
Seat 9: hldtom ($44.29 in chips) 
opie62: posts small blind $0.10
DrunkTyphoon: posts big blind $0.25
*** HOLE CARDS ***
Dealt to chiyuki [9h Ac]
ShockLaMuc: folds 
Nerkit: folds 
jacquelinewu: folds 
TorTrade: folds 
Rici47: folds 
hldtom: raises $0.50 to $0.75
chiyuki: raises $1.50 to $2.25
opie62: raises $4 to $6.25
DrunkTyphoon: folds 
hldtom: folds 
chiyuki: folds 
Uncalled bet ($4) returned to opie62
opie62 collected $5.50 from pot
opie62: doesn't show hand 
*** SUMMARY ***
Total pot $5.50 | Rake $0 
Seat 1: chiyuki (button) folded before Flop
Seat 2: opie62 (small blind) collected ($5.50)
Seat 3: DrunkTyphoon (big blind) folded before Flop
Seat 4: ShockLaMuc folded before Flop (didn't bet)
Seat 5: Nerkit folded before Flop (didn't bet)
Seat 6: jacquelinewu folded before Flop (didn't bet)
Seat 7: TorTrade folded before Flop (didn't bet)
Seat 8: Rici47 folded before Flop (didn't bet)
Seat 9: hldtom folded before Flop



PokerStars Zoom Hand #84300990520:  Hold'em No Limit ($0.10/$0.25) - 2012/08/05 16:05:18 JST [2012/08/05 3:05:18 ET]
Table 'Whirlpool' 9-max Seat #1 is the button
Seat 1: roksmokndonk ($25.64 in chips) 
Seat 2: chiyuki ($48.26 in chips) 
Seat 3: poorpoor6551 ($20.14 in chips) 
Seat 4: romanian c4 ($16.18 in chips) 
Seat 5: fwnaf ($22.61 in chips) 
Seat 6: phate-1up ($60.78 in chips) 
Seat 7: GovGus ($35.72 in chips) 
Seat 8: Grishukps ($12.50 in chips) 
Seat 9: Mytea88 ($13.65 in chips) 
chiyuki: posts small blind $0.10
poorpoor6551: posts big blind $0.25
*** HOLE CARDS ***
Dealt to chiyuki [Ad 9d]
romanian c4: folds 
fwnaf: folds 
phate-1up: folds 
GovGus: folds 
Grishukps: folds 
Mytea88: folds 
roksmokndonk: folds 
chiyuki: raises $0.50 to $0.75
poorpoor6551: folds 
Uncalled bet ($0.50) returned to chiyuki
chiyuki collected $0.50 from pot
chiyuki: doesn't show hand 
*** SUMMARY ***
Total pot $0.50 | Rake $0 
Seat 1: roksmokndonk (button) folded before Flop (didn't bet)
Seat 2: chiyuki (small blind) collected ($0.50)
Seat 3: poorpoor6551 (big blind) folded before Flop
Seat 4: romanian c4 folded before Flop (didn't bet)
Seat 5: fwnaf folded before Flop (didn't bet)
Seat 6: phate-1up folded before Flop (didn't bet)
Seat 7: GovGus folded before Flop (didn't bet)
Seat 8: Grishukps folded before Flop (didn't bet)
Seat 9: Mytea88 folded before Flop (didn't bet)



PokerStars Zoom Hand #84300995962:  Hold'em No Limit ($0.10/$0.25) - 2012/08/05 16:05:39 JST [2012/08/05 3:05:39 ET]
Table 'Whirlpool' 9-max Seat #1 is the button
Seat 1: DrunkTyphoon ($37.20 in chips) 
Seat 2: 1Karina1 ($29.09 in chips) 
Seat 3: chiyuki ($48.51 in chips) 
Seat 4: westhavenbc ($15.51 in chips) 
Seat 5: nice.franki ($13.30 in chips) 
Seat 6: Grishukps ($12.50 in chips) 
Seat 7: FoRlan77 ($26.03 in chips) 
Seat 8: Ellen1947 ($33.02 in chips) 
Seat 9: Grumpy as 2 ($12 in chips) 
1Karina1: posts small blind $0.10
chiyuki: posts big blind $0.25
*** HOLE CARDS ***
Dealt to chiyuki [4c 2d]
westhavenbc: folds 
nice.franki: folds 
Grishukps: folds 
FoRlan77: folds 
Ellen1947: raises $0.50 to $0.75
Grumpy as 2: folds 
DrunkTyphoon: folds 
1Karina1: folds 
chiyuki: folds 
Uncalled bet ($0.50) returned to Ellen1947
Ellen1947 collected $0.60 from pot
Ellen1947: doesn't show hand 
*** SUMMARY ***
Total pot $0.60 | Rake $0 
Seat 1: DrunkTyphoon (button) folded before Flop (didn't bet)
Seat 2: 1Karina1 (small blind) folded before Flop
Seat 3: chiyuki (big blind) folded before Flop
Seat 4: westhavenbc folded before Flop (didn't bet)
Seat 5: nice.franki folded before Flop (didn't bet)
Seat 6: Grishukps folded before Flop (didn't bet)
Seat 7: FoRlan77 folded before Flop (didn't bet)
Seat 8: Ellen1947 collected ($0.60)
Seat 9: Grumpy as 2 folded before Flop (didn't bet)



PokerStars Zoom Hand #84300994860:  Hold'em No Limit ($0.10/$0.25) - 2012/08/05 16:05:35 JST [2012/08/05 3:05:35 ET]
Table 'Whirlpool' 9-max Seat #1 is the button
Seat 1: MurMurRu ($25 in chips) 
Seat 2: ShockLaMuc ($21.95 in chips) 
Seat 3: Cripple86 ($27.51 in chips) 
Seat 4: phate-1up ($60.68 in chips) 
Seat 5: westhavenbc ($15.51 in chips) 
Seat 6: Vall179 ($24.65 in chips) 
Seat 7: Perstenev ($11.28 in chips) 
Seat 8: chiyuki ($48.51 in chips) 
Seat 9: Dejacob ($35.52 in chips) 
ShockLaMuc: posts small blind $0.10
Cripple86: posts big blind $0.25
*** HOLE CARDS ***
Dealt to chiyuki [9d Jc]
phate-1up: folds 
westhavenbc: folds 
Vall179: folds 
Perstenev: folds 
chiyuki: folds 
Dejacob: raises $0.50 to $0.75
MurMurRu: calls $0.75
ShockLaMuc: folds 
Cripple86: folds 
*** FLOP *** [Jh 2h 3c]
Dejacob: checks 
MurMurRu: checks 
*** TURN *** [Jh 2h 3c] [Qc]
Dejacob: bets $1
MurMurRu: calls $1
*** RIVER *** [Jh 2h 3c Qc] [4c]
Dejacob: checks 
MurMurRu: checks 
*** SHOW DOWN ***
Dejacob: shows [Ad Ts] (high card Ace)
MurMurRu: shows [3s 3d] (three of a kind, Threes)
MurMurRu collected $3.68 from pot
*** SUMMARY ***
Total pot $3.85 | Rake $0.17 
Board [Jh 2h 3c Qc 4c]
Seat 1: MurMurRu (button) showed [3s 3d] and won ($3.68) with three of a kind, Threes
Seat 2: ShockLaMuc (small blind) folded before Flop
Seat 3: Cripple86 (big blind) folded before Flop
Seat 4: phate-1up folded before Flop (didn't bet)
Seat 5: westhavenbc folded before Flop (didn't bet)
Seat 6: Vall179 folded before Flop (didn't bet)
Seat 7: Perstenev folded before Flop (didn't bet)
Seat 8: chiyuki folded before Flop (didn't bet)
Seat 9: Dejacob showed [Ad Ts] and lost with high card Ace



PokerStars Zoom Hand #84301011183:  Hold'em No Limit ($0.10/$0.25) - 2012/08/05 16:06:36 JST [2012/08/05 3:06:36 ET]
Table 'Whirlpool' 9-max Seat #1 is the button
Seat 1: andy0815r ($31.61 in chips) 
Seat 2: Femali54 ($26.76 in chips) 
Seat 3: Dan Royal ($30.14 in chips) 
Seat 4: Tonychanman ($17.25 in chips) 
Seat 5: opie62 ($31.95 in chips) 
Seat 6: chiyuki ($48.26 in chips) 
Seat 7: top gun 2950 ($20.04 in chips) 
Seat 8: kwkim73 ($26.13 in chips) 
Seat 9: .7.DanDan.7. ($17.58 in chips) 
Femali54: posts small blind $0.10
Dan Royal: posts big blind $0.25
*** HOLE CARDS ***
Dealt to chiyuki [Th 4h]
Tonychanman: folds 
opie62: folds 
chiyuki: folds 
top gun 2950: folds 
kwkim73: raises $0.50 to $0.75
.7.DanDan.7.: folds 
andy0815r: folds 
Femali54: folds 
Dan Royal: folds 
Uncalled bet ($0.50) returned to kwkim73
kwkim73 collected $0.60 from pot
kwkim73: doesn't show hand 
*** SUMMARY ***
Total pot $0.60 | Rake $0 
Seat 1: andy0815r (button) folded before Flop (didn't bet)
Seat 2: Femali54 (small blind) folded before Flop
Seat 3: Dan Royal (big blind) folded before Flop
Seat 4: Tonychanman folded before Flop (didn't bet)
Seat 5: opie62 folded before Flop (didn't bet)
Seat 6: chiyuki folded before Flop (didn't bet)
Seat 7: top gun 2950 folded before Flop (didn't bet)
Seat 8: kwkim73 collected ($0.60)
Seat 9: .7.DanDan.7. folded before Flop (didn't bet)



PokerStars Zoom Hand #84301009283:  Hold'em No Limit ($0.10/$0.25) - 2012/08/05 16:06:29 JST [2012/08/05 3:06:29 ET]
Table 'Whirlpool' 9-max Seat #1 is the button
Seat 1: tribunpdm ($68.86 in chips) 
Seat 2: MurMurRu ($35.22 in chips) 
Seat 3: Perstenev ($11.63 in chips) 
Seat 4: drunk_bender ($14.05 in chips) 
Seat 5: hldtom ($62.89 in chips) 
Seat 6: chiyuki ($48.26 in chips) 
Seat 7: deepakmbh ($27.44 in chips) 
Seat 8: top gun 2950 ($20.04 in chips) 
Seat 9: Vall179 ($24.75 in chips) 
MurMurRu: posts small blind $0.10
Perstenev: posts big blind $0.25
*** HOLE CARDS ***
Dealt to chiyuki [Qd 3d]
drunk_bender: folds 
hldtom: folds 
chiyuki: folds 
deepakmbh: folds 
top gun 2950: folds 
Vall179: folds 
tribunpdm: raises $0.50 to $0.75
MurMurRu: folds 
Perstenev: folds 
Uncalled bet ($0.50) returned to tribunpdm
tribunpdm collected $0.60 from pot
tribunpdm: doesn't show hand 
*** SUMMARY ***
Total pot $0.60 | Rake $0 
Seat 1: tribunpdm (button) collected ($0.60)
Seat 2: MurMurRu (small blind) folded before Flop
Seat 3: Perstenev (big blind) folded before Flop
Seat 4: drunk_bender folded before Flop (didn't bet)
Seat 5: hldtom folded before Flop (didn't bet)
Seat 6: chiyuki folded before Flop (didn't bet)
Seat 7: deepakmbh folded before Flop (didn't bet)
Seat 8: top gun 2950 folded before Flop (didn't bet)
Seat 9: Vall179 folded before Flop (didn't bet)



PokerStars Zoom Hand #84301008223:  Hold'em No Limit ($0.10/$0.25) - 2012/08/05 16:06:25 JST [2012/08/05 3:06:25 ET]
Table 'Whirlpool' 9-max Seat #1 is the button
Seat 1: Tonychanman ($17.25 in chips) 
Seat 2: Rilko1975 ($17.90 in chips) 
Seat 3: azizmimi ($30.15 in chips) 
Seat 4: Ellen1947 ($31.66 in chips) 
Seat 5: Lasutchik ($28.44 in chips) 
Seat 6: FoRlan77 ($26.03 in chips) 
Seat 7: kwkim73 ($26.13 in chips) 
Seat 8: TorTrade ($22.87 in chips) 
Seat 9: chiyuki ($48.26 in chips) 
Rilko1975: posts small blind $0.10
azizmimi: posts big blind $0.25
*** HOLE CARDS ***
Dealt to chiyuki [9h 7d]
Ellen1947: raises $0.50 to $0.75
Lasutchik: folds 
FoRlan77: folds 
kwkim73: folds 
TorTrade: folds 
chiyuki: folds 
Tonychanman: folds 
Rilko1975: folds 
azizmimi: calls $0.50
*** FLOP *** [Ah 5s Js]
azizmimi: bets $0.50
Ellen1947: folds 
Uncalled bet ($0.50) returned to azizmimi
azizmimi collected $1.53 from pot
azizmimi: doesn't show hand 
*** SUMMARY ***
Total pot $1.60 | Rake $0.07 
Board [Ah 5s Js]
Seat 1: Tonychanman (button) folded before Flop (didn't bet)
Seat 2: Rilko1975 (small blind) folded before Flop
Seat 3: azizmimi (big blind) collected ($1.53)
Seat 4: Ellen1947 folded on the Flop
Seat 5: Lasutchik folded before Flop (didn't bet)
Seat 6: FoRlan77 folded before Flop (didn't bet)
Seat 7: kwkim73 folded before Flop (didn't bet)
Seat 8: TorTrade folded before Flop (didn't bet)
Seat 9: chiyuki folded before Flop (didn't bet)



PokerStars Zoom Hand #84301006660:  Hold'em No Limit ($0.10/$0.25) - 2012/08/05 16:06:19 JST [2012/08/05 3:06:19 ET]
Table 'Whirlpool' 9-max Seat #1 is the button
Seat 1: poorpoor6551 ($21.49 in chips) 
Seat 2: Trip_Krowns ($33.35 in chips) 
Seat 3: nice.franki ($5.38 in chips) 
Seat 4: phate-1up ($56.39 in chips) 
Seat 5: Angi858 ($24.65 in chips) 
Seat 6: codan23 ($11.10 in chips) 
Seat 7: chiyuki ($48.26 in chips) 
Seat 8: INSP!RON ($32.03 in chips) 
Seat 9: schoof 2 ($56.59 in chips) 
Trip_Krowns: posts small blind $0.10
nice.franki: posts big blind $0.25
*** HOLE CARDS ***
Dealt to chiyuki [Kc Js]
phate-1up: folds 
Angi858: raises $0.25 to $0.50
codan23: calls $0.50
chiyuki: folds 
INSP!RON: folds 
schoof 2: folds 
poorpoor6551: calls $0.50
Trip_Krowns: folds 
nice.franki: calls $0.25
*** FLOP *** [2d 9d 2c]
nice.franki: checks 
Angi858: checks 
codan23: bets $1.20
poorpoor6551: folds 
nice.franki: folds 
Angi858: calls $1.20
*** TURN *** [2d 9d 2c] [7c]
Angi858: checks 
codan23: bets $1.72
Angi858: calls $1.72
*** RIVER *** [2d 9d 2c 7c] [2s]
Angi858: checks 
codan23: bets $4.54
Angi858: folds 
Uncalled bet ($4.54) returned to codan23
codan23 collected $7.58 from pot
codan23: doesn't show hand 
*** SUMMARY ***
Total pot $7.94 | Rake $0.36 
Board [2d 9d 2c 7c 2s]
Seat 1: poorpoor6551 (button) folded on the Flop
Seat 2: Trip_Krowns (small blind) folded before Flop
Seat 3: nice.franki (big blind) folded on the Flop
Seat 4: phate-1up folded before Flop (didn't bet)
Seat 5: Angi858 folded on the River
Seat 6: codan23 collected ($7.58)
Seat 7: chiyuki folded before Flop (didn't bet)
Seat 8: INSP!RON folded before Flop (didn't bet)
Seat 9: schoof 2 folded before Flop (didn't bet)



PokerStars Zoom Hand #84301012317:  Hold'em No Limit ($0.10/$0.25) - 2012/08/05 16:06:40 JST [2012/08/05 3:06:40 ET]
Table 'Whirlpool' 9-max Seat #1 is the button
Seat 1: Loholov ($15 in chips) 
Seat 2: teaser07 ($25 in chips) 
Seat 3: opie62 ($31.95 in chips) 
Seat 4: FoRlan77 ($26.03 in chips) 
Seat 5: top gun 2950 ($20.04 in chips) 
Seat 6: masterkoolb ($14.23 in chips) 
Seat 7: chiyuki ($48.26 in chips) 
Seat 8: andy0815r ($31.61 in chips) 
Seat 9: PPP7SSS ($52.98 in chips) 
teaser07: posts small blind $0.10
opie62: posts big blind $0.25
*** HOLE CARDS ***
Dealt to chiyuki [Qs Tc]
FoRlan77: folds 
top gun 2950: raises $0.75 to $1
masterkoolb: calls $1
chiyuki: folds 
andy0815r: folds 
PPP7SSS: folds 
Loholov: folds 
teaser07: raises $3 to $4
opie62: folds 
top gun 2950: calls $3
masterkoolb: folds 
*** FLOP *** [Qh 9s 4d]
teaser07: bets $3.50
top gun 2950: raises $3.50 to $7
teaser07: raises $12.90 to $19.90
top gun 2950: calls $9.04 and is all-in
Uncalled bet ($3.86) returned to teaser07
*** TURN *** [Qh 9s 4d] [6h]
*** RIVER *** [Qh 9s 4d 6h] [2s]
*** SHOW DOWN ***
teaser07: shows [Ac Ah] (a pair of Aces)
top gun 2950: shows [6s 6c] (three of a kind, Sixes)
top gun 2950 collected $39.47 from pot
*** SUMMARY ***
Total pot $41.33 | Rake $1.86 
Board [Qh 9s 4d 6h 2s]
Seat 1: Loholov (button) folded before Flop (didn't bet)
Seat 2: teaser07 (small blind) showed [Ac Ah] and lost with a pair of Aces
Seat 3: opie62 (big blind) folded before Flop
Seat 4: FoRlan77 folded before Flop (didn't bet)
Seat 5: top gun 2950 showed [6s 6c] and won ($39.47) with three of a kind, Sixes
Seat 6: masterkoolb folded before Flop
Seat 7: chiyuki folded before Flop (didn't bet)
Seat 8: andy0815r folded before Flop (didn't bet)
Seat 9: PPP7SSS folded before Flop (didn't bet)



PokerStars Zoom Hand #84301013685:  Hold'em No Limit ($0.10/$0.25) - 2012/08/05 16:06:46 JST [2012/08/05 3:06:46 ET]
Table 'Whirlpool' 9-max Seat #1 is the button
Seat 1: phate-1up ($64.03 in chips) 
Seat 2: kwkim73 ($32.47 in chips) 
Seat 3: FoRlan77 ($26.03 in chips) 
Seat 4: chiyuki ($48.26 in chips) 
Seat 5: Lindikor ($5.01 in chips) 
Seat 6: Spheroff ($15.30 in chips) 
Seat 7: nice.franki ($5.30 in chips) 
Seat 8: xxASSO124xx ($10.21 in chips) 
Seat 9: Blue-GumBum ($8.89 in chips) 
kwkim73: posts small blind $0.10
FoRlan77: posts big blind $0.25
*** HOLE CARDS ***
Dealt to chiyuki [9c 9h]
chiyuki: raises $0.50 to $0.75
Lindikor: folds 
Spheroff: folds 
nice.franki: folds 
xxASSO124xx has timed out
xxASSO124xx: folds 
Blue-GumBum: calls $0.75
phate-1up: folds 
kwkim73: folds 
FoRlan77: folds 
*** FLOP *** [7d Kd Js]
chiyuki: checks 
Blue-GumBum: checks 
*** TURN *** [7d Kd Js] [Ad]
chiyuki: bets $1
Blue-GumBum: calls $1
*** RIVER *** [7d Kd Js Ad] [Jh]
chiyuki: checks 
Blue-GumBum: checks 
*** SHOW DOWN ***
chiyuki: shows [9c 9h] (two pair, Jacks and Nines)
Blue-GumBum: shows [As Qc] (two pair, Aces and Jacks)
Blue-GumBum collected $3.68 from pot
*** SUMMARY ***
Total pot $3.85 | Rake $0.17 
Board [7d Kd Js Ad Jh]
Seat 1: phate-1up (button) folded before Flop (didn't bet)
Seat 2: kwkim73 (small blind) folded before Flop
Seat 3: FoRlan77 (big blind) folded before Flop
Seat 4: chiyuki showed [9c 9h] and lost with two pair, Jacks and Nines
Seat 5: Lindikor folded before Flop (didn't bet)
Seat 6: Spheroff folded before Flop (didn't bet)
Seat 7: nice.franki folded before Flop (didn't bet)
Seat 8: xxASSO124xx folded before Flop (didn't bet)
Seat 9: Blue-GumBum showed [As Qc] and won ($3.68) with two pair, Aces and Jacks



PokerStars Zoom Hand #84301029949:  Hold'em No Limit ($0.10/$0.25) - 2012/08/05 16:07:47 JST [2012/08/05 3:07:47 ET]
Table 'Whirlpool' 9-max Seat #1 is the button
Seat 1: masterkoolb ($12.50 in chips) 
Seat 2: chiyuki ($46.51 in chips) 
Seat 3: Cripple86 ($25 in chips) 
Seat 4: Alvinpe85 ($29.69 in chips) 
Seat 5: 1Karina1 ($37.61 in chips) 
Seat 6: top gun 2950 ($39.47 in chips) 
Seat 7: ShockLaMuc ($21.63 in chips) 
Seat 8: INSP!RON ($25.60 in chips) 
Seat 9: Serge Claws ($64.60 in chips) 
chiyuki: posts small blind $0.10
Cripple86: posts big blind $0.25
*** HOLE CARDS ***
Dealt to chiyuki [4s Kc]
Alvinpe85: folds 
1Karina1 has timed out
1Karina1: folds 
top gun 2950: raises $0.75 to $1
ShockLaMuc: folds 
INSP!RON: folds 
Serge Claws: folds 
masterkoolb: folds 
chiyuki: folds 
Cripple86: folds 
Uncalled bet ($0.75) returned to top gun 2950
top gun 2950 collected $0.60 from pot
top gun 2950: doesn't show hand 
*** SUMMARY ***
Total pot $0.60 | Rake $0 
Seat 1: masterkoolb (button) folded before Flop (didn't bet)
Seat 2: chiyuki (small blind) folded before Flop
Seat 3: Cripple86 (big blind) folded before Flop
Seat 4: Alvinpe85 folded before Flop (didn't bet)
Seat 5: 1Karina1 folded before Flop (didn't bet)
Seat 6: top gun 2950 collected ($0.60)
Seat 7: ShockLaMuc folded before Flop (didn't bet)
Seat 8: INSP!RON folded before Flop (didn't bet)
Seat 9: Serge Claws folded before Flop (didn't bet)



PokerStars Zoom Hand #84301044741:  Hold'em No Limit ($0.10/$0.25) - 2012/08/05 16:08:43 JST [2012/08/05 3:08:43 ET]
Table 'Whirlpool' 9-max Seat #1 is the button
Seat 1: Spheroff ($15.20 in chips) 
Seat 2: andy0815r ($30.44 in chips) 
Seat 3: kwkim73 ($26.03 in chips) 
Seat 4: xxASSO124xx ($9.86 in chips) 
Seat 5: Serge Claws ($25 in chips) 
Seat 6: 4plankton ($8.33 in chips) 
Seat 7: 4ydo yogurt ($65.36 in chips) 
Seat 8: chiyuki ($46.16 in chips) 
Seat 9: hldtom ($27.44 in chips) 
andy0815r: posts small blind $0.10
kwkim73: posts big blind $0.25
*** HOLE CARDS ***
Dealt to chiyuki [5s Ks]
xxASSO124xx: folds 
Serge Claws: folds 
4plankton: folds 
4ydo yogurt: folds 
chiyuki: folds 
hldtom: folds 
Spheroff: folds 
andy0815r: folds 
Uncalled bet ($0.15) returned to kwkim73
kwkim73 collected $0.20 from pot
kwkim73: doesn't show hand 
*** SUMMARY ***
Total pot $0.20 | Rake $0 
Seat 1: Spheroff (button) folded before Flop (didn't bet)
Seat 2: andy0815r (small blind) folded before Flop
Seat 3: kwkim73 (big blind) collected ($0.20)
Seat 4: xxASSO124xx folded before Flop (didn't bet)
Seat 5: Serge Claws folded before Flop (didn't bet)
Seat 6: 4plankton folded before Flop (didn't bet)
Seat 7: 4ydo yogurt folded before Flop (didn't bet)
Seat 8: chiyuki folded before Flop (didn't bet)
Seat 9: hldtom folded before Flop (didn't bet)



PokerStars Zoom Hand #84301037815:  Hold'em No Limit ($0.10/$0.25) - 2012/08/05 16:08:17 JST [2012/08/05 3:08:17 ET]
Table 'Whirlpool' 9-max Seat #1 is the button
Seat 1: scaredsare ($28.62 in chips) 
Seat 2: Grumpy as 2 ($11.92 in chips) 
Seat 3: chiyuki ($46.41 in chips) 
Seat 4: phate-1up ($75.51 in chips) 
Seat 5: opie62 ($33.29 in chips) 
Seat 6: Cripple86 ($25 in chips) 
Seat 7: TorTrade ($22.97 in chips) 
Seat 8: Grishukps ($12.50 in chips) 
Seat 9: kwkim73 ($26.13 in chips) 
Grumpy as 2: posts small blind $0.10
chiyuki: posts big blind $0.25
*** HOLE CARDS ***
Dealt to chiyuki [4d 7h]
phate-1up: folds 
opie62: folds 
Cripple86: folds 
TorTrade: raises $0.75 to $1
Grishukps: folds 
kwkim73: folds 
scaredsare: calls $1
Grumpy as 2: folds 
chiyuki: folds 
*** FLOP *** [9c 5c Kh]
TorTrade: bets $1.68
scaredsare: calls $1.68
*** TURN *** [9c 5c Kh] [8c]
TorTrade: checks 
scaredsare: bets $2.75
TorTrade: raises $2.75 to $5.50
scaredsare: folds 
Uncalled bet ($2.75) returned to TorTrade
TorTrade collected $10.71 from pot
TorTrade: doesn't show hand 
*** SUMMARY ***
Total pot $11.21 | Rake $0.50 
Board [9c 5c Kh 8c]
Seat 1: scaredsare (button) folded on the Turn
Seat 2: Grumpy as 2 (small blind) folded before Flop
Seat 3: chiyuki (big blind) folded before Flop
Seat 4: phate-1up folded before Flop (didn't bet)
Seat 5: opie62 folded before Flop (didn't bet)
Seat 6: Cripple86 folded before Flop (didn't bet)
Seat 7: TorTrade collected ($10.71)
Seat 8: Grishukps folded before Flop (didn't bet)
Seat 9: kwkim73 folded before Flop (didn't bet)



PokerStars Zoom Hand #84301042323:  Hold'em No Limit ($0.10/$0.25) - 2012/08/05 16:08:34 JST [2012/08/05 3:08:34 ET]
Table 'Whirlpool' 9-max Seat #1 is the button
Seat 1: INSP!RON ($25.60 in chips) 
Seat 2: PAMBOS.L ($14.50 in chips) 
Seat 3: tribunpdm ($68.46 in chips) 
Seat 4: GSDP ($26.19 in chips) 
Seat 5: chiyuki ($46.16 in chips) 
Seat 6: Serge Claws ($25 in chips) 
Seat 7: Femali54 ($24.51 in chips) 
Seat 8: Vall179 ($22.55 in chips) 
Seat 9: Cripple86 ($26.94 in chips) 
PAMBOS.L: posts small blind $0.10
tribunpdm: posts big blind $0.25
*** HOLE CARDS ***
Dealt to chiyuki [Jc 7d]
GSDP: folds 
chiyuki: folds 
Serge Claws: folds 
Femali54: folds 
Vall179: raises $0.50 to $0.75
Cripple86: folds 
INSP!RON: folds 
PAMBOS.L: folds 
tribunpdm: calls $0.50
*** FLOP *** [6s Ac Tc]
tribunpdm: checks 
Vall179: bets $1.14
tribunpdm: folds 
Uncalled bet ($1.14) returned to Vall179
Vall179 collected $1.53 from pot
Vall179: doesn't show hand 
*** SUMMARY ***
Total pot $1.60 | Rake $0.07 
Board [6s Ac Tc]
Seat 1: INSP!RON (button) folded before Flop (didn't bet)
Seat 2: PAMBOS.L (small blind) folded before Flop
Seat 3: tribunpdm (big blind) folded on the Flop
Seat 4: GSDP folded before Flop (didn't bet)
Seat 5: chiyuki folded before Flop (didn't bet)
Seat 6: Serge Claws folded before Flop (didn't bet)
Seat 7: Femali54 folded before Flop (didn't bet)
Seat 8: Vall179 collected ($1.53)
Seat 9: Cripple86 folded before Flop (didn't bet)



PokerStars Zoom Hand #84301046378:  Hold'em No Limit ($0.10/$0.25) - 2012/08/05 16:08:49 JST [2012/08/05 3:08:49 ET]
Table 'Whirlpool' 9-max Seat #1 is the button
Seat 1: andy0815r ($30.34 in chips) 
Seat 2: seula i ($71.21 in chips) 
Seat 3: CrittHunter ($21.26 in chips) 
Seat 4: Spheroff ($15.20 in chips) 
Seat 5: chiyuki ($46.16 in chips) 
Seat 6: snejokCoxx ($11.15 in chips) 
Seat 7: Cripple86 ($25 in chips) 
Seat 8: FoRlan77 ($25 in chips) 
Seat 9: Dejacob ($25.09 in chips) 
seula i: posts small blind $0.10
CrittHunter: posts big blind $0.25
*** HOLE CARDS ***
Dealt to chiyuki [8c Th]
Spheroff: folds 
chiyuki: folds 
snejokCoxx: folds 
Cripple86: folds 
FoRlan77: folds 
Dejacob: raises $0.50 to $0.75
andy0815r: folds 
seula i: folds 
CrittHunter: folds 
Uncalled bet ($0.50) returned to Dejacob
Dejacob collected $0.60 from pot
Dejacob: doesn't show hand 
*** SUMMARY ***
Total pot $0.60 | Rake $0 
Seat 1: andy0815r (button) folded before Flop (didn't bet)
Seat 2: seula i (small blind) folded before Flop
Seat 3: CrittHunter (big blind) folded before Flop
Seat 4: Spheroff folded before Flop (didn't bet)
Seat 5: chiyuki folded before Flop (didn't bet)
Seat 6: snejokCoxx folded before Flop (didn't bet)
Seat 7: Cripple86 folded before Flop (didn't bet)
Seat 8: FoRlan77 folded before Flop (didn't bet)
Seat 9: Dejacob collected ($0.60)



PokerStars Zoom Hand #84301047695:  Hold'em No Limit ($0.10/$0.25) - 2012/08/05 16:08:54 JST [2012/08/05 3:08:54 ET]
Table 'Whirlpool' 9-max Seat #1 is the button
Seat 1: 1Karina1 ($35.91 in chips) 
Seat 2: ShockLaMuc ($21.28 in chips) 
Seat 3: Serge Claws ($25 in chips) 
Seat 4: kwkim73 ($35.23 in chips) 
Seat 5: 4ydo yogurt ($65.36 in chips) 
Seat 6: chiyuki ($46.16 in chips) 
Seat 7: andy0815r ($49.47 in chips) 
Seat 8: xxx Spb xxx ($30.21 in chips) 
Seat 9: snejokCoxx ($11.15 in chips) 
ShockLaMuc: posts small blind $0.10
Serge Claws: posts big blind $0.25
*** HOLE CARDS ***
Dealt to chiyuki [Ts Kh]
kwkim73: folds 
4ydo yogurt: folds 
chiyuki: folds 
andy0815r: folds 
xxx Spb xxx: raises $0.50 to $0.75
snejokCoxx: folds 
1Karina1: folds 
ShockLaMuc: folds 
Serge Claws: folds 
Uncalled bet ($0.50) returned to xxx Spb xxx
xxx Spb xxx collected $0.60 from pot
xxx Spb xxx: doesn't show hand 
*** SUMMARY ***
Total pot $0.60 | Rake $0 
Seat 1: 1Karina1 (button) folded before Flop (didn't bet)
Seat 2: ShockLaMuc (small blind) folded before Flop
Seat 3: Serge Claws (big blind) folded before Flop
Seat 4: kwkim73 folded before Flop (didn't bet)
Seat 5: 4ydo yogurt folded before Flop (didn't bet)
Seat 6: chiyuki folded before Flop (didn't bet)
Seat 7: andy0815r folded before Flop (didn't bet)
Seat 8: xxx Spb xxx collected ($0.60)
Seat 9: snejokCoxx folded before Flop (didn't bet)



PokerStars Zoom Hand #84301043936:  Hold'em No Limit ($0.10/$0.25) - 2012/08/05 16:08:40 JST [2012/08/05 3:08:40 ET]
Table 'Whirlpool' 9-max Seat #1 is the button
Seat 1: chiyuki ($46.16 in chips) 
Seat 2: men1989 ($23.29 in chips) 
Seat 3: masterkoolb ($12.50 in chips) 
Seat 4: Lasutchik ($28.19 in chips) 
Seat 5: zongo1 ($25.89 in chips) 
Seat 6: nice.franki ($10.35 in chips) 
Seat 7: NEZZA177 ($24.15 in chips) 
Seat 8: drunk_bender ($27.46 in chips) 
Seat 9: PAMBOS.L ($14.40 in chips) 
men1989: posts small blind $0.10
masterkoolb: posts big blind $0.25
*** HOLE CARDS ***
Dealt to chiyuki [2d 9s]
Lasutchik: calls $0.25
zongo1: folds 
nice.franki: folds 
NEZZA177: folds 
drunk_bender: folds 
PAMBOS.L: folds 
chiyuki: folds 
men1989: calls $0.15
masterkoolb: checks 
*** FLOP *** [Tc 3s 8s]
men1989: checks 
masterkoolb: checks 
Lasutchik: bets $0.36
men1989: folds 
masterkoolb: folds 
Uncalled bet ($0.36) returned to Lasutchik
Lasutchik collected $0.72 from pot
Lasutchik: doesn't show hand 
*** SUMMARY ***
Total pot $0.75 | Rake $0.03 
Board [Tc 3s 8s]
Seat 1: chiyuki (button) folded before Flop (didn't bet)
Seat 2: men1989 (small blind) folded on the Flop
Seat 3: masterkoolb (big blind) folded on the Flop
Seat 4: Lasutchik collected ($0.72)
Seat 5: zongo1 folded before Flop (didn't bet)
Seat 6: nice.franki folded before Flop (didn't bet)
Seat 7: NEZZA177 folded before Flop (didn't bet)
Seat 8: drunk_bender folded before Flop (didn't bet)
Seat 9: PAMBOS.L folded before Flop (didn't bet)



PokerStars Zoom Hand #84301049361:  Hold'em No Limit ($0.10/$0.25) - 2012/08/05 16:09:00 JST [2012/08/05 3:09:00 ET]
Table 'Whirlpool' 9-max Seat #1 is the button
Seat 1: 1Karina1 ($30.16 in chips) 
Seat 2: tribunpdm ($67.71 in chips) 
Seat 3: snejokCoxx ($12.50 in chips) 
Seat 4: Grishukps ($13.46 in chips) 
Seat 5: Serge Claws ($39.93 in chips) 
Seat 6: ivan130 ($28.73 in chips) 
Seat 7: Vall179 ($23.95 in chips) 
Seat 8: andy0815r ($49.47 in chips) 
Seat 9: chiyuki ($46.16 in chips) 
tribunpdm: posts small blind $0.10
snejokCoxx: posts big blind $0.25
*** HOLE CARDS ***
Dealt to chiyuki [5s 5c]
Grishukps: raises $0.50 to $0.75
Serge Claws: folds 
ivan130: calls $0.75
Vall179: folds 
andy0815r: calls $0.75
chiyuki: calls $0.75
1Karina1: folds 
tribunpdm: folds 
snejokCoxx: folds 
*** FLOP *** [2d Jd 6d]
Grishukps: checks 
ivan130: checks 
andy0815r: bets $1.60
chiyuki: folds 
Grishukps: folds 
ivan130: folds 
Uncalled bet ($1.60) returned to andy0815r
andy0815r collected $3.20 from pot
andy0815r: doesn't show hand 
*** SUMMARY ***
Total pot $3.35 | Rake $0.15 
Board [2d Jd 6d]
Seat 1: 1Karina1 (button) folded before Flop (didn't bet)
Seat 2: tribunpdm (small blind) folded before Flop
Seat 3: snejokCoxx (big blind) folded before Flop
Seat 4: Grishukps folded on the Flop
Seat 5: Serge Claws folded before Flop (didn't bet)
Seat 6: ivan130 folded on the Flop
Seat 7: Vall179 folded before Flop (didn't bet)
Seat 8: andy0815r collected ($3.20)
Seat 9: chiyuki folded on the Flop



PokerStars Zoom Hand #84301061222:  Hold'em No Limit ($0.10/$0.25) - 2012/08/05 16:09:45 JST [2012/08/05 3:09:45 ET]
Table 'Whirlpool' 9-max Seat #1 is the button
Seat 1: Fructionar ($43.46 in chips) 
Seat 2: chiyuki ($45.41 in chips) 
Seat 3: DrunkTyphoon ($47.43 in chips) 
Seat 4: Grumpy as 2 ($14.20 in chips) 
Seat 5: INSP!RON ($32.57 in chips) 
Seat 6: Serge Claws ($25 in chips) 
Seat 7: Spheroff ($15.30 in chips) 
Seat 8: fil740 ($11.58 in chips) 
Seat 9: Loholov ($16.15 in chips) 
chiyuki: posts small blind $0.10
DrunkTyphoon: posts big blind $0.25
*** HOLE CARDS ***
Dealt to chiyuki [5d 5h]
Grumpy as 2: folds 
INSP!RON: raises $0.50 to $0.75
Serge Claws: folds 
Spheroff: calls $0.75
fil740: folds 
Loholov: folds 
Fructionar: folds 
chiyuki: calls $0.65
DrunkTyphoon: folds 
*** FLOP *** [Kh Ks 6s]
chiyuki: checks 
INSP!RON: bets $1.70
Spheroff: folds 
chiyuki: folds 
Uncalled bet ($1.70) returned to INSP!RON
INSP!RON collected $2.39 from pot
INSP!RON: doesn't show hand 
*** SUMMARY ***
Total pot $2.50 | Rake $0.11 
Board [Kh Ks 6s]
Seat 1: Fructionar (button) folded before Flop (didn't bet)
Seat 2: chiyuki (small blind) folded on the Flop
Seat 3: DrunkTyphoon (big blind) folded before Flop
Seat 4: Grumpy as 2 folded before Flop (didn't bet)
Seat 5: INSP!RON collected ($2.39)
Seat 6: Serge Claws folded before Flop (didn't bet)
Seat 7: Spheroff folded on the Flop
Seat 8: fil740 folded before Flop (didn't bet)
Seat 9: Loholov folded before Flop (didn't bet)



PokerStars Zoom Hand #84301072678:  Hold'em No Limit ($0.10/$0.25) - 2012/08/05 16:10:28 JST [2012/08/05 3:10:28 ET]
Table 'Whirlpool' 9-max Seat #1 is the button
Seat 1: tribunpdm ($68.98 in chips) 
Seat 2: seula i ($60.50 in chips) 
Seat 3: chiyuki ($44.66 in chips) 
Seat 4: Kasperlmusik ($32.54 in chips) 
Seat 5: codan23 ($14.58 in chips) 
Seat 6: Loholov ($15 in chips) 
Seat 7: Grishukps ($12.50 in chips) 
Seat 8: top gun 2950 ($41.31 in chips) 
Seat 9: pandaaaaaa ($19.61 in chips) 
seula i: posts small blind $0.10
chiyuki: posts big blind $0.25
*** HOLE CARDS ***
Dealt to chiyuki [Js Kh]
Kasperlmusik: folds 
codan23: folds 
Loholov: folds 
Grishukps: folds 
top gun 2950: folds 
pandaaaaaa: folds 
tribunpdm: folds 
seula i: folds 
Uncalled bet ($0.15) returned to chiyuki
chiyuki collected $0.20 from pot
chiyuki: doesn't show hand 
*** SUMMARY ***
Total pot $0.20 | Rake $0 
Seat 1: tribunpdm (button) folded before Flop (didn't bet)
Seat 2: seula i (small blind) folded before Flop
Seat 3: chiyuki (big blind) collected ($0.20)
Seat 4: Kasperlmusik folded before Flop (didn't bet)
Seat 5: codan23 folded before Flop (didn't bet)
Seat 6: Loholov folded before Flop (didn't bet)
Seat 7: Grishukps folded before Flop (didn't bet)
Seat 8: top gun 2950 folded before Flop (didn't bet)
Seat 9: pandaaaaaa folded before Flop (didn't bet)



PokerStars Zoom Hand #84301075938:  Hold'em No Limit ($0.10/$0.25) - 2012/08/05 16:10:40 JST [2012/08/05 3:10:40 ET]
Table 'Whirlpool' 9-max Seat #1 is the button
Seat 1: fwnaf ($20.43 in chips) 
Seat 2: Loholov ($15.90 in chips) 
Seat 3: GovGus ($46.64 in chips) 
Seat 4: Kozyavkin ($8.31 in chips) 
Seat 5: 4plankton ($7.63 in chips) 
Seat 6: 1Karina1 ($61.95 in chips) 
Seat 7: chiyuki ($44.76 in chips) 
Seat 8: kesstukas25 ($12.50 in chips) 
Seat 9: FoRlan77 ($25.28 in chips) 
Loholov: posts small blind $0.10
GovGus: posts big blind $0.25
*** HOLE CARDS ***
Dealt to chiyuki [Kh 6s]
Kozyavkin: folds 
4plankton: folds 
1Karina1: folds 
chiyuki: folds 
kesstukas25: folds 
FoRlan77: folds 
fwnaf: folds 
Loholov: folds 
Uncalled bet ($0.15) returned to GovGus
GovGus collected $0.20 from pot
GovGus: doesn't show hand 
*** SUMMARY ***
Total pot $0.20 | Rake $0 
Seat 1: fwnaf (button) folded before Flop (didn't bet)
Seat 2: Loholov (small blind) folded before Flop
Seat 3: GovGus (big blind) collected ($0.20)
Seat 4: Kozyavkin folded before Flop (didn't bet)
Seat 5: 4plankton folded before Flop (didn't bet)
Seat 6: 1Karina1 folded before Flop (didn't bet)
Seat 7: chiyuki folded before Flop (didn't bet)
Seat 8: kesstukas25 folded before Flop (didn't bet)
Seat 9: FoRlan77 folded before Flop (didn't bet)



PokerStars Zoom Hand #84301077028:  Hold'em No Limit ($0.10/$0.25) - 2012/08/05 16:10:44 JST [2012/08/05 3:10:44 ET]
Table 'Whirlpool' 9-max Seat #1 is the button
Seat 1: chiyuki ($44.76 in chips) 
Seat 2: 1Karina1 ($30.66 in chips) 
Seat 3: Vall179 ($22.98 in chips) 
Seat 4: phate-1up ($84.51 in chips) 
Seat 5: snejokCoxx ($14.54 in chips) 
Seat 6: laurentzu84 ($31.09 in chips) 
Seat 7: Serge Claws ($37.18 in chips) 
Seat 8: seula i ($36.48 in chips) 
Seat 9: DrunkTyphoon ($48.10 in chips) 
1Karina1: posts small blind $0.10
Vall179: posts big blind $0.25
*** HOLE CARDS ***
Dealt to chiyuki [Qd 7h]
phate-1up: folds 
snejokCoxx: folds 
laurentzu84: folds 
Serge Claws: folds 
seula i: folds 
DrunkTyphoon: folds 
chiyuki: folds 
1Karina1: raises $0.50 to $0.75
Vall179: folds 
Uncalled bet ($0.50) returned to 1Karina1
1Karina1 collected $0.50 from pot
1Karina1: doesn't show hand 
*** SUMMARY ***
Total pot $0.50 | Rake $0 
Seat 1: chiyuki (button) folded before Flop (didn't bet)
Seat 2: 1Karina1 (small blind) collected ($0.50)
Seat 3: Vall179 (big blind) folded before Flop
Seat 4: phate-1up folded before Flop (didn't bet)
Seat 5: snejokCoxx folded before Flop (didn't bet)
Seat 6: laurentzu84 folded before Flop (didn't bet)
Seat 7: Serge Claws folded before Flop (didn't bet)
Seat 8: seula i folded before Flop (didn't bet)
Seat 9: DrunkTyphoon folded before Flop (didn't bet)



PokerStars Zoom Hand #84301078364:  Hold'em No Limit ($0.10/$0.25) - 2012/08/05 16:10:49 JST [2012/08/05 3:10:49 ET]
Table 'Whirlpool' 9-max Seat #1 is the button
Seat 1: laurentzu84 ($31.09 in chips) 
Seat 2: Ellen1947 ($31.58 in chips) 
Seat 3: Loholov ($15 in chips) 
Seat 4: Alvinpe85 ($28.99 in chips) 
Seat 5: DrunkTyphoon ($48.10 in chips) 
Seat 6: Cripple86 ($28.88 in chips) 
Seat 7: fwnaf ($20.43 in chips) 
Seat 8: INSP!RON ($34.56 in chips) 
Seat 9: chiyuki ($44.76 in chips) 
Ellen1947: posts small blind $0.10
Loholov: posts big blind $0.25
*** HOLE CARDS ***
Dealt to chiyuki [3d 8s]
Alvinpe85: folds 
DrunkTyphoon: folds 
Cripple86: raises $0.50 to $0.75
fwnaf: folds 
INSP!RON: folds 
chiyuki: folds 
laurentzu84: folds 
Ellen1947: folds 
Loholov: folds 
Uncalled bet ($0.50) returned to Cripple86
Cripple86 collected $0.60 from pot
Cripple86: doesn't show hand 
*** SUMMARY ***
Total pot $0.60 | Rake $0 
Seat 1: laurentzu84 (button) folded before Flop (didn't bet)
Seat 2: Ellen1947 (small blind) folded before Flop
Seat 3: Loholov (big blind) folded before Flop
Seat 4: Alvinpe85 folded before Flop (didn't bet)
Seat 5: DrunkTyphoon folded before Flop (didn't bet)
Seat 6: Cripple86 collected ($0.60)
Seat 7: fwnaf folded before Flop (didn't bet)
Seat 8: INSP!RON folded before Flop (didn't bet)
Seat 9: chiyuki folded before Flop (didn't bet)



PokerStars Zoom Hand #84301082411:  Hold'em No Limit ($0.10/$0.25) - 2012/08/05 16:11:04 JST [2012/08/05 3:11:04 ET]
Table 'Whirlpool' 9-max Seat #1 is the button
Seat 1: Perstenev ($13.32 in chips) 
Seat 2: chiyuki ($44.76 in chips) 
Seat 3: Ellen1947 ($28.56 in chips) 
Seat 4: INSP!RON ($25.10 in chips) 
Seat 5: Roglus ($7.64 in chips) 
Seat 6: CrittHunter ($20.28 in chips) 
Seat 7: slapshot2011 ($35.95 in chips) 
Seat 8: 4plankton ($7.28 in chips) 
Seat 9: Kozyavkin ($8.21 in chips) 
chiyuki: posts small blind $0.10
Ellen1947: posts big blind $0.25
*** HOLE CARDS ***
Dealt to chiyuki [6h 4d]
INSP!RON: folds 
Roglus: folds 
CrittHunter: folds 
slapshot2011: folds 
4plankton: folds 
Kozyavkin: folds 
Perstenev: folds 
chiyuki: folds 
Uncalled bet ($0.15) returned to Ellen1947
Ellen1947 collected $0.20 from pot
Ellen1947: doesn't show hand 
*** SUMMARY ***
Total pot $0.20 | Rake $0 
Seat 1: Perstenev (button) folded before Flop (didn't bet)
Seat 2: chiyuki (small blind) folded before Flop
Seat 3: Ellen1947 (big blind) collected ($0.20)
Seat 4: INSP!RON folded before Flop (didn't bet)
Seat 5: Roglus folded before Flop (didn't bet)
Seat 6: CrittHunter folded before Flop (didn't bet)
Seat 7: slapshot2011 folded before Flop (didn't bet)
Seat 8: 4plankton folded before Flop (didn't bet)
Seat 9: Kozyavkin folded before Flop (didn't bet)



PokerStars Zoom Hand #84301071255:  Hold'em No Limit ($0.10/$0.25) - 2012/08/05 16:10:23 JST [2012/08/05 3:10:23 ET]
Table 'Whirlpool' 9-max Seat #1 is the button
Seat 1: nice.franki ($9.85 in chips) 
Seat 2: snejokCoxx ($10.08 in chips) 
Seat 3: Bahia gyn ($19.81 in chips) 
Seat 4: chiyuki ($44.66 in chips) 
Seat 5: xxASSO124xx ($8.26 in chips) 
Seat 6: Lasutchik ($12.15 in chips) 
Seat 7: phate-1up ($55.19 in chips) 
Seat 8: Kasperlmusik ($32.54 in chips) 
Seat 9: risekuku468 ($33.36 in chips) 
snejokCoxx: posts small blind $0.10
Bahia gyn: posts big blind $0.25
*** HOLE CARDS ***
Dealt to chiyuki [4d Jc]
chiyuki: folds 
xxASSO124xx: folds 
Lasutchik: folds 
phate-1up: folds 
Kasperlmusik: folds 
risekuku468: folds 
nice.franki: raises $0.37 to $0.62
snejokCoxx: raises $1.23 to $1.85
Bahia gyn: folds 
nice.franki: raises $8 to $9.85 and is all-in
snejokCoxx: calls $8
*** FLOP *** [8h Js 9d]
*** TURN *** [8h Js 9d] [Td]
*** RIVER *** [8h Js 9d Td] [2s]
*** SHOW DOWN ***
snejokCoxx: shows [Ts Tc] (three of a kind, Tens)
nice.franki: shows [Kc Kh] (a pair of Kings)
snejokCoxx collected $19.05 from pot
*** SUMMARY ***
Total pot $19.95 | Rake $0.90 
Board [8h Js 9d Td 2s]
Seat 1: nice.franki (button) showed [Kc Kh] and lost with a pair of Kings
Seat 2: snejokCoxx (small blind) showed [Ts Tc] and won ($19.05) with three of a kind, Tens
Seat 3: Bahia gyn (big blind) folded before Flop
Seat 4: chiyuki folded before Flop (didn't bet)
Seat 5: xxASSO124xx folded before Flop (didn't bet)
Seat 6: Lasutchik folded before Flop (didn't bet)
Seat 7: phate-1up folded before Flop (didn't bet)
Seat 8: Kasperlmusik folded before Flop (didn't bet)
Seat 9: risekuku468 folded before Flop (didn't bet)



PokerStars Zoom Hand #84301081327:  Hold'em No Limit ($0.10/$0.25) - 2012/08/05 16:11:00 JST [2012/08/05 3:11:00 ET]
Table 'Whirlpool' 9-max Seat #1 is the button
Seat 1: Ellen1947 ($28.56 in chips) 
Seat 2: nice.franki ($10.77 in chips) 
Seat 3: Lasutchik ($12.15 in chips) 
Seat 4: Perstenev ($13.32 in chips) 
Seat 5: ShockLaMuc ($21.18 in chips) 
Seat 6: xxx Spb xxx ($27.58 in chips) 
Seat 7: chiyuki ($44.76 in chips) 
Seat 8: kwkim73 ($31.74 in chips) 
Seat 9: Bahia gyn ($19.56 in chips) 
nice.franki: posts small blind $0.10
Lasutchik: posts big blind $0.25
*** HOLE CARDS ***
Dealt to chiyuki [8s 2c]
Perstenev: folds 
ShockLaMuc: folds 
xxx Spb xxx: folds 
chiyuki: folds 
kwkim73: folds 
Bahia gyn: raises $0.50 to $0.75
Ellen1947: folds 
nice.franki: folds 
Lasutchik: folds 
Uncalled bet ($0.50) returned to Bahia gyn
Bahia gyn collected $0.60 from pot
Bahia gyn: doesn't show hand 
*** SUMMARY ***
Total pot $0.60 | Rake $0 
Seat 1: Ellen1947 (button) folded before Flop (didn't bet)
Seat 2: nice.franki (small blind) folded before Flop
Seat 3: Lasutchik (big blind) folded before Flop
Seat 4: Perstenev folded before Flop (didn't bet)
Seat 5: ShockLaMuc folded before Flop (didn't bet)
Seat 6: xxx Spb xxx folded before Flop (didn't bet)
Seat 7: chiyuki folded before Flop (didn't bet)
Seat 8: kwkim73 folded before Flop (didn't bet)
Seat 9: Bahia gyn collected ($0.60)



PokerStars Zoom Hand #84301079444:  Hold'em No Limit ($0.10/$0.25) - 2012/08/05 16:10:53 JST [2012/08/05 3:10:53 ET]
Table 'Whirlpool' 9-max Seat #1 is the button
Seat 1: deepakmbh ($31.26 in chips) 
Seat 2: DanielWhyte ($30.72 in chips) 
Seat 3: kwkim73 ($31.99 in chips) 
Seat 4: DrunkTyphoon ($48.10 in chips) 
Seat 5: Serge Claws ($37.18 in chips) 
Seat 6: ShockLaMuc ($21.18 in chips) 
Seat 7: soul_5577 ($43.18 in chips) 
Seat 8: chiyuki ($44.76 in chips) 
Seat 9: Rici47 ($45.49 in chips) 
DanielWhyte: posts small blind $0.10
kwkim73: posts big blind $0.25
*** HOLE CARDS ***
Dealt to chiyuki [7h 6d]
DrunkTyphoon: folds 
Serge Claws: raises $0.50 to $0.75
ShockLaMuc: folds 
soul_5577: folds 
chiyuki: folds 
Rici47: folds 
deepakmbh: calls $0.75
DanielWhyte: folds 
kwkim73: folds 
*** FLOP *** [2c Ad 5c]
Serge Claws: bets $1.25
deepakmbh: calls $1.25
*** TURN *** [2c Ad 5c] [Qd]
Serge Claws: bets $3
deepakmbh: calls $3
*** RIVER *** [2c Ad 5c Qd] [3d]
Serge Claws: checks 
deepakmbh: checks 
*** SHOW DOWN ***
Serge Claws: shows [3c 3s] (three of a kind, Threes)
deepakmbh: mucks hand 
Serge Claws collected $9.88 from pot
*** SUMMARY ***
Total pot $10.35 | Rake $0.47 
Board [2c Ad 5c Qd 3d]
Seat 1: deepakmbh (button) mucked [Ah Jc]
Seat 2: DanielWhyte (small blind) folded before Flop
Seat 3: kwkim73 (big blind) folded before Flop
Seat 4: DrunkTyphoon folded before Flop (didn't bet)
Seat 5: Serge Claws showed [3c 3s] and won ($9.88) with three of a kind, Threes
Seat 6: ShockLaMuc folded before Flop (didn't bet)
Seat 7: soul_5577 folded before Flop (didn't bet)
Seat 8: chiyuki folded before Flop (didn't bet)
Seat 9: Rici47 folded before Flop (didn't bet)



PokerStars Zoom Hand #84301083783:  Hold'em No Limit ($0.10/$0.25) - 2012/08/05 16:11:09 JST [2012/08/05 3:11:09 ET]
Table 'Whirlpool' 9-max Seat #1 is the button
Seat 1: Loholov ($15.10 in chips) 
Seat 2: hldtom ($24.99 in chips) 
Seat 3: chiyuki ($44.66 in chips) 
Seat 4: Cripple86 ($25.84 in chips) 
Seat 5: Grumpy as 2 ($13.35 in chips) 
Seat 6: 1Karina1 ($25 in chips) 
Seat 7: drunk_bender ($26.96 in chips) 
Seat 8: Kozyavkin ($8.21 in chips) 
Seat 9: INSP!RON ($25.10 in chips) 
hldtom: posts small blind $0.10
chiyuki: posts big blind $0.25
*** HOLE CARDS ***
Dealt to chiyuki [2h 9h]
Cripple86: folds 
Grumpy as 2: folds 
1Karina1: folds 
drunk_bender: raises $0.50 to $0.75
Kozyavkin: folds 
INSP!RON: folds 
Loholov: calls $0.75
hldtom: folds 
chiyuki: folds 
*** FLOP *** [7h Ks Kd]
drunk_bender: checks 
Loholov: checks 
*** TURN *** [7h Ks Kd] [Td]
drunk_bender: bets $1
Loholov: folds 
Uncalled bet ($1) returned to drunk_bender
drunk_bender collected $1.77 from pot
drunk_bender: doesn't show hand 
*** SUMMARY ***
Total pot $1.85 | Rake $0.08 
Board [7h Ks Kd Td]
Seat 1: Loholov (button) folded on the Turn
Seat 2: hldtom (small blind) folded before Flop
Seat 3: chiyuki (big blind) folded before Flop
Seat 4: Cripple86 folded before Flop (didn't bet)
Seat 5: Grumpy as 2 folded before Flop (didn't bet)
Seat 6: 1Karina1 folded before Flop (didn't bet)
Seat 7: drunk_bender collected ($1.77)
Seat 8: Kozyavkin folded before Flop (didn't bet)
Seat 9: INSP!RON folded before Flop (didn't bet)



PokerStars Zoom Hand #84301080503:  Hold'em No Limit ($0.10/$0.25) - 2012/08/05 16:10:57 JST [2012/08/05 3:10:57 ET]
Table 'Whirlpool' 9-max Seat #1 is the button
Seat 1: silvno31 ($63.09 in chips) 
Seat 2: 19MJJ21 ($12.79 in chips) 
Seat 3: Grishukps ($12.50 in chips) 
Seat 4: AntoineHunt ($39.96 in chips) 
Seat 5: Grumpy as 2 ($13.85 in chips) 
Seat 6: chiyuki ($44.76 in chips) 
Seat 7: DrunkTyphoon ($48.10 in chips) 
Seat 8: Faantomace ($37.74 in chips) 
Seat 9: soul_5577 ($43.18 in chips) 
19MJJ21: posts small blind $0.10
Grishukps: posts big blind $0.25
*** HOLE CARDS ***
Dealt to chiyuki [4d 6d]
AntoineHunt: folds 
Grumpy as 2: raises $0.25 to $0.50
chiyuki: folds 
DrunkTyphoon: raises $0.25 to $0.75
Faantomace: raises $0.75 to $1.50
soul_5577: folds 
silvno31: folds 
19MJJ21: calls $1.40
Grishukps: folds 
Grumpy as 2: folds 
DrunkTyphoon: folds 
*** FLOP *** [As 2c 9s]
19MJJ21: checks 
Faantomace: checks 
*** TURN *** [As 2c 9s] [Qc]
19MJJ21: checks 
Faantomace: checks 
*** RIVER *** [As 2c 9s Qc] [4c]
19MJJ21: bets $2.15
Faantomace: calls $2.15
*** SHOW DOWN ***
19MJJ21: shows [Jh Ah] (a pair of Aces)
Faantomace: mucks hand 
19MJJ21 collected $8.40 from pot
*** SUMMARY ***
Total pot $8.80 | Rake $0.40 
Board [As 2c 9s Qc 4c]
Seat 1: silvno31 (button) folded before Flop (didn't bet)
Seat 2: 19MJJ21 (small blind) showed [Jh Ah] and won ($8.40) with a pair of Aces
Seat 3: Grishukps (big blind) folded before Flop
Seat 4: AntoineHunt folded before Flop (didn't bet)
Seat 5: Grumpy as 2 folded before Flop
Seat 6: chiyuki folded before Flop (didn't bet)
Seat 7: DrunkTyphoon folded before Flop
Seat 8: Faantomace mucked [8c 8d]
Seat 9: soul_5577 folded before Flop (didn't bet)



PokerStars Zoom Hand #84301090299:  Hold'em No Limit ($0.10/$0.25) - 2012/08/05 16:11:33 JST [2012/08/05 3:11:33 ET]
Table 'Whirlpool' 9-max Seat #1 is the button
Seat 1: chiyuki ($44.41 in chips) 
Seat 2: Cripple86 ($25 in chips) 
Seat 3: PAMBOS.L ($15.66 in chips) 
Seat 4: Dejacob ($31.95 in chips) 
Seat 5: snejokCoxx ($19.28 in chips) 
Seat 6: Trip_Krowns ($26.44 in chips) 
Seat 7: GovGus ($29.22 in chips) 
Seat 8: risekuku468 ($29.51 in chips) 
Seat 9: kwkim73 ($26.08 in chips) 
Cripple86: posts small blind $0.10
PAMBOS.L: posts big blind $0.25
*** HOLE CARDS ***
Dealt to chiyuki [Kc Qs]
Dejacob: raises $0.50 to $0.75
snejokCoxx: folds 
Trip_Krowns: folds 
GovGus: folds 
risekuku468: calls $0.75
kwkim73: folds 
chiyuki: folds 
Cripple86: folds 
PAMBOS.L: folds 
*** FLOP *** [Kd 6d Tc]
Dejacob: bets $1
risekuku468: folds 
Uncalled bet ($1) returned to Dejacob
Dejacob collected $1.77 from pot
Dejacob: doesn't show hand 
*** SUMMARY ***
Total pot $1.85 | Rake $0.08 
Board [Kd 6d Tc]
Seat 1: chiyuki (button) folded before Flop (didn't bet)
Seat 2: Cripple86 (small blind) folded before Flop
Seat 3: PAMBOS.L (big blind) folded before Flop
Seat 4: Dejacob collected ($1.77)
Seat 5: snejokCoxx folded before Flop (didn't bet)
Seat 6: Trip_Krowns folded before Flop (didn't bet)
Seat 7: GovGus folded before Flop (didn't bet)
Seat 8: risekuku468 folded on the Flop
Seat 9: kwkim73 folded before Flop (didn't bet)



PokerStars Zoom Hand #84301095360:  Hold'em No Limit ($0.10/$0.25) - 2012/08/05 16:11:53 JST [2012/08/05 3:11:53 ET]
Table 'Whirlpool' 9-max Seat #1 is the button
Seat 1: tribunpdm ($68.38 in chips) 
Seat 2: Trip_Krowns ($26.19 in chips) 
Seat 3: 19MJJ21 ($17.54 in chips) 
Seat 4: Serge Claws ($73.56 in chips) 
Seat 5: teaser07 ($25.35 in chips) 
Seat 6: Kozyavkin ($7.96 in chips) 
Seat 7: Faantomace ($34.09 in chips) 
Seat 8: chiyuki ($44.41 in chips) 
Seat 9: snejokCoxx ($11.82 in chips) 
Trip_Krowns: posts small blind $0.10
19MJJ21: posts big blind $0.25
*** HOLE CARDS ***
Dealt to chiyuki [3s Ah]
Serge Claws: folds 
teaser07: folds 
Kozyavkin: folds 
Faantomace: folds 
chiyuki: folds 
snejokCoxx: folds 
tribunpdm: raises $0.50 to $0.75
Trip_Krowns: folds 
19MJJ21: folds 
Uncalled bet ($0.50) returned to tribunpdm
tribunpdm collected $0.60 from pot
tribunpdm: doesn't show hand 
*** SUMMARY ***
Total pot $0.60 | Rake $0 
Seat 1: tribunpdm (button) collected ($0.60)
Seat 2: Trip_Krowns (small blind) folded before Flop
Seat 3: 19MJJ21 (big blind) folded before Flop
Seat 4: Serge Claws folded before Flop (didn't bet)
Seat 5: teaser07 folded before Flop (didn't bet)
Seat 6: Kozyavkin folded before Flop (didn't bet)
Seat 7: Faantomace folded before Flop (didn't bet)
Seat 8: chiyuki folded before Flop (didn't bet)
Seat 9: snejokCoxx folded before Flop (didn't bet)



PokerStars Zoom Hand #84301097354:  Hold'em No Limit ($0.10/$0.25) - 2012/08/05 16:12:00 JST [2012/08/05 3:12:00 ET]
Table 'Whirlpool' 9-max Seat #1 is the button
Seat 1: Cripple86 ($26.19 in chips) 
Seat 2: INSP!RON ($27.21 in chips) 
Seat 3: kwkim73 ($26.08 in chips) 
Seat 4: Dejacob ($32.98 in chips) 
Seat 5: phate-1up ($36.17 in chips) 
Seat 6: chiyuki ($44.41 in chips) 
Seat 7: nice.franki ($3.31 in chips) 
Seat 8: Roglus ($9.28 in chips) 
Seat 9: Serge Claws ($41.81 in chips) 
INSP!RON: posts small blind $0.10
kwkim73: posts big blind $0.25
*** HOLE CARDS ***
Dealt to chiyuki [9h 3c]
Dejacob: folds 
phate-1up: folds 
chiyuki: folds 
nice.franki: folds 
Roglus: folds 
Serge Claws: raises $0.50 to $0.75
Cripple86: folds 
INSP!RON: raises $1.95 to $2.70
kwkim73: folds 
Serge Claws: folds 
Uncalled bet ($1.95) returned to INSP!RON
INSP!RON collected $1.75 from pot
INSP!RON: doesn't show hand 
*** SUMMARY ***
Total pot $1.75 | Rake $0 
Seat 1: Cripple86 (button) folded before Flop (didn't bet)
Seat 2: INSP!RON (small blind) collected ($1.75)
Seat 3: kwkim73 (big blind) folded before Flop
Seat 4: Dejacob folded before Flop (didn't bet)
Seat 5: phate-1up folded before Flop (didn't bet)
Seat 6: chiyuki folded before Flop (didn't bet)
Seat 7: nice.franki folded before Flop (didn't bet)
Seat 8: Roglus folded before Flop (didn't bet)
Seat 9: Serge Claws folded before Flop



PokerStars Zoom Hand #84301099307:  Hold'em No Limit ($0.10/$0.25) - 2012/08/05 16:12:07 JST [2012/08/05 3:12:07 ET]
Table 'Whirlpool' 9-max Seat #1 is the button
Seat 1: kesstukas25 ($31.76 in chips) 
Seat 2: nice.franki ($12.25 in chips) 
Seat 3: FoRlan77 ($25 in chips) 
Seat 4: phate-1up ($36.17 in chips) 
Seat 5: 1Karina1 ($25 in chips) 
Seat 6: Vall179 ($22.63 in chips) 
Seat 7: Rici47 ($47.77 in chips) 
Seat 8: Loholov ($15 in chips) 
Seat 9: chiyuki ($44.41 in chips) 
nice.franki: posts small blind $0.10
FoRlan77: posts big blind $0.25
*** HOLE CARDS ***
Dealt to chiyuki [Ts 6c]
phate-1up: folds 
1Karina1: raises $0.50 to $0.75
Vall179: folds 
Rici47: folds 
Loholov: folds 
chiyuki: folds 
kesstukas25: folds 
nice.franki: folds 
FoRlan77: folds 
Uncalled bet ($0.50) returned to 1Karina1
1Karina1 collected $0.60 from pot
1Karina1: doesn't show hand 
*** SUMMARY ***
Total pot $0.60 | Rake $0 
Seat 1: kesstukas25 (button) folded before Flop (didn't bet)
Seat 2: nice.franki (small blind) folded before Flop
Seat 3: FoRlan77 (big blind) folded before Flop
Seat 4: phate-1up folded before Flop (didn't bet)
Seat 5: 1Karina1 collected ($0.60)
Seat 6: Vall179 folded before Flop (didn't bet)
Seat 7: Rici47 folded before Flop (didn't bet)
Seat 8: Loholov folded before Flop (didn't bet)
Seat 9: chiyuki folded before Flop (didn't bet)



PokerStars Zoom Hand #84301100081:  Hold'em No Limit ($0.10/$0.25) - 2012/08/05 16:12:10 JST [2012/08/05 3:12:10 ET]
Table 'Whirlpool' 9-max Seat #1 is the button
Seat 1: kwkim73 ($37.40 in chips) 
Seat 2: masterkoolb ($15.44 in chips) 
Seat 3: codan23 ($11.91 in chips) 
Seat 4: GovGus ($46.49 in chips) 
Seat 5: chiyuki ($44.41 in chips) 
Seat 6: deepakmbh ($26.36 in chips) 
Seat 7: DanielWhyte ($30.62 in chips) 
Seat 8: roksmokndonk ($19.80 in chips) 
Seat 9: Cripple86 ($28.13 in chips) 
masterkoolb: posts small blind $0.10
codan23: posts big blind $0.25
*** HOLE CARDS ***
Dealt to chiyuki [5h 7c]
GovGus: folds 
chiyuki: folds 
deepakmbh: folds 
DanielWhyte: folds 
roksmokndonk: folds 
Cripple86: folds 
kwkim73: folds 
masterkoolb: raises $0.50 to $0.75
codan23: folds 
Uncalled bet ($0.50) returned to masterkoolb
masterkoolb collected $0.50 from pot
masterkoolb: doesn't show hand 
*** SUMMARY ***
Total pot $0.50 | Rake $0 
Seat 1: kwkim73 (button) folded before Flop (didn't bet)
Seat 2: masterkoolb (small blind) collected ($0.50)
Seat 3: codan23 (big blind) folded before Flop
Seat 4: GovGus folded before Flop (didn't bet)
Seat 5: chiyuki folded before Flop (didn't bet)
Seat 6: deepakmbh folded before Flop (didn't bet)
Seat 7: DanielWhyte folded before Flop (didn't bet)
Seat 8: roksmokndonk folded before Flop (didn't bet)
Seat 9: Cripple86 folded before Flop (didn't bet)



PokerStars Zoom Hand #84301096239:  Hold'em No Limit ($0.10/$0.25) - 2012/08/05 16:11:56 JST [2012/08/05 3:11:56 ET]
Table 'Whirlpool' 9-max Seat #1 is the button
Seat 1: GovGus ($40.80 in chips) 
Seat 2: Grishukps ($14.75 in chips) 
Seat 3: GSDP ($28.89 in chips) 
Seat 4: wildy29 ($97.96 in chips) 
Seat 5: INSP!RON ($27.21 in chips) 
Seat 6: d4dda ($25 in chips) 
Seat 7: chiyuki ($44.41 in chips) 
Seat 8: DrunkTyphoon ($47 in chips) 
Seat 9: Nerkit ($12.15 in chips) 
Grishukps: posts small blind $0.10
GSDP: posts big blind $0.25
*** HOLE CARDS ***
Dealt to chiyuki [Qc Th]
wildy29: calls $0.25
INSP!RON: folds 
d4dda: folds 
chiyuki: folds 
DrunkTyphoon: folds 
Nerkit: folds 
GovGus: raises $0.75 to $1
Grishukps: raises $13.75 to $14.75 and is all-in
GSDP: folds 
wildy29: folds 
GovGus: calls $13.75
*** FLOP *** [9h 3d 5c]
*** TURN *** [9h 3d 5c] [5d]
*** RIVER *** [9h 3d 5c 5d] [Kc]
*** SHOW DOWN ***
Grishukps: shows [Qd Qh] (two pair, Queens and Fives)
GovGus: shows [Kh Ah] (two pair, Kings and Fives)
GovGus collected $28.65 from pot
*** SUMMARY ***
Total pot $30 | Rake $1.35 
Board [9h 3d 5c 5d Kc]
Seat 1: GovGus (button) showed [Kh Ah] and won ($28.65) with two pair, Kings and Fives
Seat 2: Grishukps (small blind) showed [Qd Qh] and lost with two pair, Queens and Fives
Seat 3: GSDP (big blind) folded before Flop
Seat 4: wildy29 folded before Flop
Seat 5: INSP!RON folded before Flop (didn't bet)
Seat 6: d4dda folded before Flop (didn't bet)
Seat 7: chiyuki folded before Flop (didn't bet)
Seat 8: DrunkTyphoon folded before Flop (didn't bet)
Seat 9: Nerkit folded before Flop (didn't bet)



PokerStars Zoom Hand #84301105553:  Hold'em No Limit ($0.10/$0.25) - 2012/08/05 16:12:30 JST [2012/08/05 3:12:30 ET]
Table 'Whirlpool' 9-max Seat #1 is the button
Seat 1: Perstenev ($4.78 in chips) 
Seat 2: 1Karina1 ($36.03 in chips) 
Seat 3: GovGus ($54.70 in chips) 
Seat 4: chiyuki ($44.41 in chips) 
Seat 5: Vall179 ($22.63 in chips) 
Seat 6: Kasperlmusik ($39.58 in chips) 
Seat 7: kesstukas25 ($31.76 in chips) 
Seat 8: men1989 ($25 in chips) 
Seat 9: Grishukps ($12.50 in chips) 
1Karina1: posts small blind $0.10
GovGus: posts big blind $0.25
*** HOLE CARDS ***
Dealt to chiyuki [7d Jd]
chiyuki: folds 
Vall179: folds 
Kasperlmusik: folds 
kesstukas25: folds 
men1989: folds 
Grishukps: folds 
Perstenev: folds 
1Karina1: folds 
Uncalled bet ($0.15) returned to GovGus
GovGus collected $0.20 from pot
GovGus: doesn't show hand 
*** SUMMARY ***
Total pot $0.20 | Rake $0 
Seat 1: Perstenev (button) folded before Flop (didn't bet)
Seat 2: 1Karina1 (small blind) folded before Flop
Seat 3: GovGus (big blind) collected ($0.20)
Seat 4: chiyuki folded before Flop (didn't bet)
Seat 5: Vall179 folded before Flop (didn't bet)
Seat 6: Kasperlmusik folded before Flop (didn't bet)
Seat 7: kesstukas25 folded before Flop (didn't bet)
Seat 8: men1989 folded before Flop (didn't bet)
Seat 9: Grishukps folded before Flop (didn't bet)



PokerStars Zoom Hand #84301102598:  Hold'em No Limit ($0.10/$0.25) - 2012/08/05 16:12:19 JST [2012/08/05 3:12:19 ET]
Table 'Whirlpool' 9-max Seat #1 is the button
Seat 1: Perstenev ($13.60 in chips) 
Seat 2: nice.franki ($12.60 in chips) 
Seat 3: Serge Claws ($74.58 in chips) 
Seat 4: chiyuki ($44.41 in chips) 
Seat 5: Vall179 ($22.63 in chips) 
Seat 6: Loholov ($15 in chips) 
Seat 7: Ellen1947 ($29.58 in chips) 
Seat 8: 1Karina1 ($30.66 in chips) 
Seat 9: kwkim73 ($37.40 in chips) 
nice.franki: posts small blind $0.10
Serge Claws: posts big blind $0.25
*** HOLE CARDS ***
Dealt to chiyuki [Qs 7h]
chiyuki: folds 
Vall179: folds 
Loholov: folds 
Ellen1947: folds 
1Karina1: raises $0.50 to $0.75
kwkim73: folds 
Perstenev: folds 
nice.franki: folds 
Serge Claws: calls $0.50
*** FLOP *** [2h Kh 8s]
Serge Claws: checks 
1Karina1: bets $1
Serge Claws: folds 
Uncalled bet ($1) returned to 1Karina1
1Karina1 collected $1.53 from pot
1Karina1: doesn't show hand 
*** SUMMARY ***
Total pot $1.60 | Rake $0.07 
Board [2h Kh 8s]
Seat 1: Perstenev (button) folded before Flop (didn't bet)
Seat 2: nice.franki (small blind) folded before Flop
Seat 3: Serge Claws (big blind) folded on the Flop
Seat 4: chiyuki folded before Flop (didn't bet)
Seat 5: Vall179 folded before Flop (didn't bet)
Seat 6: Loholov folded before Flop (didn't bet)
Seat 7: Ellen1947 folded before Flop (didn't bet)
Seat 8: 1Karina1 collected ($1.53)
Seat 9: kwkim73 folded before Flop (didn't bet)



PokerStars Zoom Hand #84301104758:  Hold'em No Limit ($0.10/$0.25) - 2012/08/05 16:12:27 JST [2012/08/05 3:12:27 ET]
Table 'Whirlpool' 9-max Seat #1 is the button
Seat 1: Nerkit ($13.07 in chips) 
Seat 2: TorTrade ($24.61 in chips) 
Seat 3: snejokCoxx ($12.50 in chips) 
Seat 4: yoube ($72.03 in chips) 
Seat 5: chiyuki ($44.41 in chips) 
Seat 6: INSP!RON ($28.17 in chips) 
Seat 7: Loholov ($15 in chips) 
Seat 8: nice.franki ($3.21 in chips) 
Seat 9: xxx Spb xxx ($29.46 in chips) 
TorTrade: posts small blind $0.10
snejokCoxx: posts big blind $0.25
*** HOLE CARDS ***
Dealt to chiyuki [8d Tc]
yoube: folds 
chiyuki: folds 
INSP!RON: folds 
Loholov: folds 
nice.franki: raises $0.50 to $0.75
xxx Spb xxx: folds 
Nerkit: folds 
TorTrade: folds 
snejokCoxx: folds 
Uncalled bet ($0.50) returned to nice.franki
nice.franki collected $0.60 from pot
nice.franki: doesn't show hand 
*** SUMMARY ***
Total pot $0.60 | Rake $0 
Seat 1: Nerkit (button) folded before Flop (didn't bet)
Seat 2: TorTrade (small blind) folded before Flop
Seat 3: snejokCoxx (big blind) folded before Flop
Seat 4: yoube folded before Flop (didn't bet)
Seat 5: chiyuki folded before Flop (didn't bet)
Seat 6: INSP!RON folded before Flop (didn't bet)
Seat 7: Loholov folded before Flop (didn't bet)
Seat 8: nice.franki collected ($0.60)
Seat 9: xxx Spb xxx folded before Flop (didn't bet)



PokerStars Zoom Hand #84301109881:  Hold'em No Limit ($0.10/$0.25) - 2012/08/05 16:12:46 JST [2012/08/05 3:12:46 ET]
Table 'Whirlpool' 9-max Seat #1 is the button
Seat 1: Loholov ($15 in chips) 
Seat 2: nice.franki ($12.15 in chips) 
Seat 3: chiyuki ($44.31 in chips) 
Seat 4: Tonychanman ($22.81 in chips) 
Seat 5: phate-1up ($54.09 in chips) 
Seat 6: RRMM_again ($26.29 in chips) 
Seat 7: 19MJJ21 ($16.54 in chips) 
Seat 8: Grishukps ($12.50 in chips) 
Seat 9: loszavera ($29.95 in chips) 
nice.franki: posts small blind $0.10
chiyuki: posts big blind $0.25
*** HOLE CARDS ***
Dealt to chiyuki [Kh Ts]
Tonychanman: folds 
phate-1up: folds 
RRMM_again: folds 
19MJJ21: folds 
Grishukps: folds 
loszavera: raises $0.35 to $0.60
Loholov: folds 
nice.franki: folds 
chiyuki: calls $0.35
*** FLOP *** [Ah 7c 9c]
chiyuki: checks 
loszavera: bets $0.91
chiyuki: folds 
Uncalled bet ($0.91) returned to loszavera
loszavera collected $1.24 from pot
loszavera: doesn't show hand 
*** SUMMARY ***
Total pot $1.30 | Rake $0.06 
Board [Ah 7c 9c]
Seat 1: Loholov (button) folded before Flop (didn't bet)
Seat 2: nice.franki (small blind) folded before Flop
Seat 3: chiyuki (big blind) folded on the Flop
Seat 4: Tonychanman folded before Flop (didn't bet)
Seat 5: phate-1up folded before Flop (didn't bet)
Seat 6: RRMM_again folded before Flop (didn't bet)
Seat 7: 19MJJ21 folded before Flop (didn't bet)
Seat 8: Grishukps folded before Flop (didn't bet)
Seat 9: loszavera collected ($1.24)



PokerStars Zoom Hand #84301106643:  Hold'em No Limit ($0.10/$0.25) - 2012/08/05 16:12:34 JST [2012/08/05 3:12:34 ET]
Table 'Whirlpool' 9-max Seat #1 is the button
Seat 1: Kasperlmusik ($39.58 in chips) 
Seat 2: chiyuki ($44.41 in chips) 
Seat 3: INSP!RON ($28.17 in chips) 
Seat 4: Grishukps ($12.50 in chips) 
Seat 5: 1Karina1 ($35.93 in chips) 
Seat 6: xxASSO124xx ($9.70 in chips) 
Seat 7: men1989 ($25 in chips) 
Seat 8: d4dda ($24.65 in chips) 
Seat 9: Perstenev ($4.78 in chips) 
chiyuki: posts small blind $0.10
INSP!RON: posts big blind $0.25
*** HOLE CARDS ***
Dealt to chiyuki [Kh Jd]
Grishukps: folds 
1Karina1: folds 
xxASSO124xx: raises $0.50 to $0.75
men1989: calls $0.75
d4dda: folds 
Perstenev: folds 
Kasperlmusik: calls $0.75
chiyuki: folds 
INSP!RON: folds 
*** FLOP *** [7d 5d Th]
xxASSO124xx: bets $1
men1989: calls $1
Kasperlmusik: raises $2.25 to $3.25
xxASSO124xx: raises $5.70 to $8.95 and is all-in
men1989: folds 
Kasperlmusik: calls $5.70
*** TURN *** [7d 5d Th] [9c]
*** RIVER *** [7d 5d Th 9c] [Jh]
*** SHOW DOWN ***
xxASSO124xx: shows [7s Ts] (two pair, Tens and Sevens)
Kasperlmusik: shows [9d Td] (two pair, Tens and Nines)
Kasperlmusik collected $20.53 from pot
*** SUMMARY ***
Total pot $21.50 | Rake $0.97 
Board [7d 5d Th 9c Jh]
Seat 1: Kasperlmusik (button) showed [9d Td] and won ($20.53) with two pair, Tens and Nines
Seat 2: chiyuki (small blind) folded before Flop
Seat 3: INSP!RON (big blind) folded before Flop
Seat 4: Grishukps folded before Flop (didn't bet)
Seat 5: 1Karina1 folded before Flop (didn't bet)
Seat 6: xxASSO124xx showed [7s Ts] and lost with two pair, Tens and Sevens
Seat 7: men1989 folded on the Flop
Seat 8: d4dda folded before Flop (didn't bet)
Seat 9: Perstenev folded before Flop (didn't bet)



PokerStars Zoom Hand #84301117205:  Hold'em No Limit ($0.10/$0.25) - 2012/08/05 16:13:14 JST [2012/08/05 3:13:14 ET]
Table 'Whirlpool' 9-max Seat #1 is the button
Seat 1: chiyuki ($43.71 in chips) 
Seat 2: phate-1up ($35.92 in chips) 
Seat 3: RRMM_again ($26.64 in chips) 
Seat 4: GovGus ($28.22 in chips) 
Seat 5: zongo1 ($24.69 in chips) 
Seat 6: Nerkit ($17.40 in chips) 
Seat 7: tribunpdm ($68.08 in chips) 
Seat 8: men1989 ($23.25 in chips) 
Seat 9: Lasutchik ($12.15 in chips) 
phate-1up: posts small blind $0.10
RRMM_again: posts big blind $0.25
*** HOLE CARDS ***
Dealt to chiyuki [2c Ac]
GovGus: folds 
zongo1: folds 
Nerkit: folds 
tribunpdm: folds 
men1989: folds 
Lasutchik: folds 
chiyuki: raises $0.50 to $0.75
phate-1up: folds 
RRMM_again: folds 
Uncalled bet ($0.50) returned to chiyuki
chiyuki collected $0.60 from pot
chiyuki: doesn't show hand 
*** SUMMARY ***
Total pot $0.60 | Rake $0 
Seat 1: chiyuki (button) collected ($0.60)
Seat 2: phate-1up (small blind) folded before Flop
Seat 3: RRMM_again (big blind) folded before Flop
Seat 4: GovGus folded before Flop (didn't bet)
Seat 5: zongo1 folded before Flop (didn't bet)
Seat 6: Nerkit folded before Flop (didn't bet)
Seat 7: tribunpdm folded before Flop (didn't bet)
Seat 8: men1989 folded before Flop (didn't bet)
Seat 9: Lasutchik folded before Flop (didn't bet)



PokerStars Zoom Hand #84301125046:  Hold'em No Limit ($0.10/$0.25) - 2012/08/05 16:13:43 JST [2012/08/05 3:13:43 ET]
Table 'Whirlpool' 9-max Seat #1 is the button
Seat 1: phate-1up ($35.82 in chips) 
Seat 2: soul_5577 ($36.43 in chips) 
Seat 3: roksmokndonk ($22.21 in chips) 
Seat 4: chiyuki ($44.06 in chips) 
Seat 5: deepakmbh ($30.58 in chips) 
Seat 6: d4dda ($24.30 in chips) 
Seat 7: nice.franki ($12.50 in chips) 
Seat 8: leo2095 ($25.10 in chips) 
Seat 9: theo0630 ($13.15 in chips) 
soul_5577: posts small blind $0.10
roksmokndonk: posts big blind $0.25
*** HOLE CARDS ***
Dealt to chiyuki [Ks Ac]
chiyuki: raises $0.50 to $0.75
deepakmbh: folds 
d4dda: folds 
nice.franki: folds 
leo2095: folds 
theo0630: folds 
phate-1up: folds 
soul_5577: folds 
roksmokndonk: folds 
Uncalled bet ($0.50) returned to chiyuki
chiyuki collected $0.60 from pot
chiyuki: doesn't show hand 
*** SUMMARY ***
Total pot $0.60 | Rake $0 
Seat 1: phate-1up (button) folded before Flop (didn't bet)
Seat 2: soul_5577 (small blind) folded before Flop
Seat 3: roksmokndonk (big blind) folded before Flop
Seat 4: chiyuki collected ($0.60)
Seat 5: deepakmbh folded before Flop (didn't bet)
Seat 6: d4dda folded before Flop (didn't bet)
Seat 7: nice.franki folded before Flop (didn't bet)
Seat 8: leo2095 folded before Flop (didn't bet)
Seat 9: theo0630 folded before Flop (didn't bet)



PokerStars Zoom Hand #84301121599:  Hold'em No Limit ($0.10/$0.25) - 2012/08/05 16:13:30 JST [2012/08/05 3:13:30 ET]
Table 'Whirlpool' 9-max Seat #1 is the button
Seat 1: Grishukps ($12.50 in chips) 
Seat 2: codan23 ($13.36 in chips) 
Seat 3: Vall179 ($30.44 in chips) 
Seat 4: Serge Claws ($28.60 in chips) 
Seat 5: chiyuki ($44.06 in chips) 
Seat 6: Kasperlmusik ($32.21 in chips) 
Seat 7: GovGus ($46.59 in chips) 
Seat 8: Tonychanman ($22.56 in chips) 
Seat 9: kwkim73 ($25 in chips) 
codan23: posts small blind $0.10
Vall179: posts big blind $0.25
*** HOLE CARDS ***
Dealt to chiyuki [3s 4s]
Serge Claws: folds 
chiyuki: folds 
Kasperlmusik: folds 
GovGus: folds 
Tonychanman: folds 
kwkim73: raises $0.50 to $0.75
Grishukps: folds 
codan23: calls $0.65
Vall179: folds 
*** FLOP *** [9c 4h 7c]
codan23: bets $0.66
kwkim73: folds 
Uncalled bet ($0.66) returned to codan23
codan23 collected $1.67 from pot
codan23: doesn't show hand 
*** SUMMARY ***
Total pot $1.75 | Rake $0.08 
Board [9c 4h 7c]
Seat 1: Grishukps (button) folded before Flop (didn't bet)
Seat 2: codan23 (small blind) collected ($1.67)
Seat 3: Vall179 (big blind) folded before Flop
Seat 4: Serge Claws folded before Flop (didn't bet)
Seat 5: chiyuki folded before Flop (didn't bet)
Seat 6: Kasperlmusik folded before Flop (didn't bet)
Seat 7: GovGus folded before Flop (didn't bet)
Seat 8: Tonychanman folded before Flop (didn't bet)
Seat 9: kwkim73 folded on the Flop



PokerStars Zoom Hand #84301123219:  Hold'em No Limit ($0.10/$0.25) - 2012/08/05 16:13:36 JST [2012/08/05 3:13:36 ET]
Table 'Whirlpool' 9-max Seat #1 is the button
Seat 1: snejokCoxx ($11.37 in chips) 
Seat 2: Bahia gyn ($15.81 in chips) 
Seat 3: benjuer ($25 in chips) 
Seat 4: xxx Spb xxx ($31.67 in chips) 
Seat 5: mjmichi ($75.67 in chips) 
Seat 6: Vall179 ($23.69 in chips) 
Seat 7: 4plankton ($4.53 in chips) 
Seat 8: chiyuki ($44.06 in chips) 
Seat 9: deepakmbh ($27.13 in chips) 
Bahia gyn: posts small blind $0.10
benjuer: posts big blind $0.25
*** HOLE CARDS ***
Dealt to chiyuki [2d 4d]
xxx Spb xxx: folds 
mjmichi: folds 
Vall179: folds 
4plankton: folds 
chiyuki: folds 
deepakmbh: folds 
snejokCoxx: raises $0.25 to $0.50
Bahia gyn: folds 
benjuer: folds 
Uncalled bet ($0.25) returned to snejokCoxx
snejokCoxx collected $0.60 from pot
snejokCoxx: doesn't show hand 
*** SUMMARY ***
Total pot $0.60 | Rake $0 
Seat 1: snejokCoxx (button) collected ($0.60)
Seat 2: Bahia gyn (small blind) folded before Flop
Seat 3: benjuer (big blind) folded before Flop
Seat 4: xxx Spb xxx folded before Flop (didn't bet)
Seat 5: mjmichi folded before Flop (didn't bet)
Seat 6: Vall179 folded before Flop (didn't bet)
Seat 7: 4plankton folded before Flop (didn't bet)
Seat 8: chiyuki folded before Flop (didn't bet)
Seat 9: deepakmbh folded before Flop (didn't bet)



PokerStars Zoom Hand #84301120502:  Hold'em No Limit ($0.10/$0.25) - 2012/08/05 16:13:26 JST [2012/08/05 3:13:26 ET]
Table 'Whirlpool' 9-max Seat #1 is the button
Seat 1: Ellen1947 ($32.15 in chips) 
Seat 2: hldtom ($35.15 in chips) 
Seat 3: nice.franki ($12.05 in chips) 
Seat 4: 4plankton ($4.53 in chips) 
Seat 5: DrunkTyphoon ($46.30 in chips) 
Seat 6: Bahia gyn ($15.81 in chips) 
Seat 7: Angi858 ($26.45 in chips) 
Seat 8: Dejacob ($31.98 in chips) 
Seat 9: chiyuki ($44.06 in chips) 
hldtom: posts small blind $0.10
nice.franki: posts big blind $0.25
*** HOLE CARDS ***
Dealt to chiyuki [As 2d]
4plankton: folds 
DrunkTyphoon: folds 
Bahia gyn: folds 
Angi858: calls $0.25
Dejacob: folds 
chiyuki: folds 
Ellen1947: folds 
hldtom: calls $0.15
nice.franki: checks 
*** FLOP *** [4h 5s 9c]
hldtom: checks 
nice.franki: checks 
Angi858: checks 
*** TURN *** [4h 5s 9c] [9d]
hldtom: checks 
nice.franki: checks 
Angi858: checks 
*** RIVER *** [4h 5s 9c 9d] [6c]
hldtom: checks 
nice.franki: checks 
Angi858: checks 
*** SHOW DOWN ***
hldtom: shows [Kc 8c] (a pair of Nines)
nice.franki: shows [6h Qc] (two pair, Nines and Sixes)
Angi858: mucks hand 
nice.franki collected $0.72 from pot
*** SUMMARY ***
Total pot $0.75 | Rake $0.03 
Board [4h 5s 9c 9d 6c]
Seat 1: Ellen1947 (button) folded before Flop (didn't bet)
Seat 2: hldtom (small blind) showed [Kc 8c] and lost with a pair of Nines
Seat 3: nice.franki (big blind) showed [6h Qc] and won ($0.72) with two pair, Nines and Sixes
Seat 4: 4plankton folded before Flop (didn't bet)
Seat 5: DrunkTyphoon folded before Flop (didn't bet)
Seat 6: Bahia gyn folded before Flop (didn't bet)
Seat 7: Angi858 mucked [Jh Td]
Seat 8: Dejacob folded before Flop (didn't bet)
Seat 9: chiyuki folded before Flop (didn't bet)



PokerStars Zoom Hand #84301127786:  Hold'em No Limit ($0.10/$0.25) - 2012/08/05 16:13:53 JST [2012/08/05 3:13:53 ET]
Table 'Whirlpool' 9-max Seat #1 is the button
Seat 1: a_tasmanian ($24.30 in chips) 
Seat 2: chiyuki ($44.41 in chips) 
Seat 3: FoRlan77 ($25 in chips) 
Seat 4: snejokCoxx ($12.50 in chips) 
Seat 5: olligol123 ($25 in chips) 
Seat 6: Grishukps ($12.50 in chips) 
Seat 7: Vall179 ($27.98 in chips) 
Seat 8: drunk_bender ($28.41 in chips) 
Seat 9: phate-1up ($115.72 in chips) 
chiyuki: posts small blind $0.10
FoRlan77: posts big blind $0.25
*** HOLE CARDS ***
Dealt to chiyuki [Kc Kh]
snejokCoxx: folds 
olligol123: folds 
Grishukps: folds 
Vall179: folds 
drunk_bender: folds 
phate-1up: raises $0.50 to $0.75
a_tasmanian: folds 
chiyuki: raises $1.50 to $2.25
FoRlan77: folds 
phate-1up: calls $1.50
*** FLOP *** [Js 7h 3s]
chiyuki: bets $3
phate-1up: folds 
Uncalled bet ($3) returned to chiyuki
chiyuki collected $4.54 from pot
chiyuki: doesn't show hand 
*** SUMMARY ***
Total pot $4.75 | Rake $0.21 
Board [Js 7h 3s]
Seat 1: a_tasmanian (button) folded before Flop (didn't bet)
Seat 2: chiyuki (small blind) collected ($4.54)
Seat 3: FoRlan77 (big blind) folded before Flop
Seat 4: snejokCoxx folded before Flop (didn't bet)
Seat 5: olligol123 folded before Flop (didn't bet)
Seat 6: Grishukps folded before Flop (didn't bet)
Seat 7: Vall179 folded before Flop (didn't bet)
Seat 8: drunk_bender folded before Flop (didn't bet)
Seat 9: phate-1up folded on the Flop



PokerStars Zoom Hand #84301146567:  Hold'em No Limit ($0.10/$0.25) - 2012/08/05 16:15:03 JST [2012/08/05 3:15:03 ET]
Table 'Whirlpool' 9-max Seat #1 is the button
Seat 1: nice.franki ($2.81 in chips) 
Seat 2: Vall179 ($31.29 in chips) 
Seat 3: Femali54 ($15.74 in chips) 
Seat 4: Cripple86 ($28.91 in chips) 
Seat 5: MurMurRu ($25 in chips) 
Seat 6: Loholov ($18.37 in chips) 
Seat 7: chiyuki ($46.70 in chips) 
Seat 8: Kasperlmusik ($32.21 in chips) 
Seat 9: INSP!RON ($35.24 in chips) 
Vall179: posts small blind $0.10
Femali54: posts big blind $0.25
*** HOLE CARDS ***
Dealt to chiyuki [5h 4d]
Cripple86: folds 
MurMurRu: folds 
Loholov: folds 
chiyuki: folds 
Kasperlmusik: folds 
INSP!RON: folds 
nice.franki: folds 
Vall179: raises $0.37 to $0.62
Femali54: folds 
Uncalled bet ($0.37) returned to Vall179
Vall179 collected $0.50 from pot
Vall179: doesn't show hand 
*** SUMMARY ***
Total pot $0.50 | Rake $0 
Seat 1: nice.franki (button) folded before Flop (didn't bet)
Seat 2: Vall179 (small blind) collected ($0.50)
Seat 3: Femali54 (big blind) folded before Flop
Seat 4: Cripple86 folded before Flop (didn't bet)
Seat 5: MurMurRu folded before Flop (didn't bet)
Seat 6: Loholov folded before Flop (didn't bet)
Seat 7: chiyuki folded before Flop (didn't bet)
Seat 8: Kasperlmusik folded before Flop (didn't bet)
Seat 9: INSP!RON folded before Flop (didn't bet)



PokerStars Zoom Hand #84301147916:  Hold'em No Limit ($0.10/$0.25) - 2012/08/05 16:15:08 JST [2012/08/05 3:15:08 ET]
Table 'Whirlpool' 9-max Seat #1 is the button
Seat 1: kwkim73 ($34.16 in chips) 
Seat 2: nice.franki ($12.52 in chips) 
Seat 3: phate-1up ($35.57 in chips) 
Seat 4: Angi858 ($26.75 in chips) 
Seat 5: Kozyavkin ($7.58 in chips) 
Seat 6: chiyuki ($46.70 in chips) 
Seat 7: Ellen1947 ($22.01 in chips) 
Seat 8: MurMurRu ($25 in chips) 
Seat 9: Alvinpe85 ($103.99 in chips) 
nice.franki: posts small blind $0.10
phate-1up: posts big blind $0.25
*** HOLE CARDS ***
Dealt to chiyuki [8h Kh]
Angi858: folds 
Kozyavkin: folds 
chiyuki: folds 
Ellen1947: folds 
MurMurRu: folds 
Alvinpe85: raises $0.37 to $0.62
kwkim73: folds 
nice.franki: folds 
phate-1up: folds 
Uncalled bet ($0.37) returned to Alvinpe85
Alvinpe85 collected $0.60 from pot
Alvinpe85: doesn't show hand 
*** SUMMARY ***
Total pot $0.60 | Rake $0 
Seat 1: kwkim73 (button) folded before Flop (didn't bet)
Seat 2: nice.franki (small blind) folded before Flop
Seat 3: phate-1up (big blind) folded before Flop
Seat 4: Angi858 folded before Flop (didn't bet)
Seat 5: Kozyavkin folded before Flop (didn't bet)
Seat 6: chiyuki folded before Flop (didn't bet)
Seat 7: Ellen1947 folded before Flop (didn't bet)
Seat 8: MurMurRu folded before Flop (didn't bet)
Seat 9: Alvinpe85 collected ($0.60)



PokerStars Zoom Hand #84301148757:  Hold'em No Limit ($0.10/$0.25) - 2012/08/05 16:15:11 JST [2012/08/05 3:15:11 ET]
Table 'Whirlpool' 9-max Seat #1 is the button
Seat 1: Cripple86 ($25.84 in chips) 
Seat 2: Angi858 ($26.75 in chips) 
Seat 3: xxx Spb xxx ($28.82 in chips) 
Seat 4: Dejacob ($32.63 in chips) 
Seat 5: deepakmbh ($29.83 in chips) 
Seat 6: Perstenev ($9.90 in chips) 
Seat 7: 1Karina1 ($33.05 in chips) 
Seat 8: chiyuki ($46.70 in chips) 
Seat 9: svg51 ($13.65 in chips) 
Angi858: posts small blind $0.10
xxx Spb xxx: posts big blind $0.25
*** HOLE CARDS ***
Dealt to chiyuki [2s 9h]
Dejacob: folds 
deepakmbh: folds 
Perstenev: folds 
1Karina1: calls $0.25
chiyuki: folds 
svg51: folds 
Cripple86: folds 
Angi858: folds 
xxx Spb xxx: checks 
*** FLOP *** [Qc Ad Th]
xxx Spb xxx: checks 
1Karina1: checks 
*** TURN *** [Qc Ad Th] [3c]
xxx Spb xxx: checks 
1Karina1: checks 
*** RIVER *** [Qc Ad Th 3c] [8s]
xxx Spb xxx: checks 
1Karina1: checks 
*** SHOW DOWN ***
xxx Spb xxx: shows [6h Js] (high card Ace)
1Karina1: shows [Qd Kc] (a pair of Queens)
1Karina1 collected $0.57 from pot
*** SUMMARY ***
Total pot $0.60 | Rake $0.03 
Board [Qc Ad Th 3c 8s]
Seat 1: Cripple86 (button) folded before Flop (didn't bet)
Seat 2: Angi858 (small blind) folded before Flop
Seat 3: xxx Spb xxx (big blind) showed [6h Js] and lost with high card Ace
Seat 4: Dejacob folded before Flop (didn't bet)
Seat 5: deepakmbh folded before Flop (didn't bet)
Seat 6: Perstenev folded before Flop (didn't bet)
Seat 7: 1Karina1 showed [Qd Kc] and won ($0.57) with a pair of Queens
Seat 8: chiyuki folded before Flop (didn't bet)
Seat 9: svg51 folded before Flop (didn't bet)



PokerStars Zoom Hand #84301150122:  Hold'em No Limit ($0.10/$0.25) - 2012/08/05 16:15:17 JST [2012/08/05 3:15:17 ET]
Table 'Whirlpool' 9-max Seat #1 is the button
Seat 1: risekuku468 ($26.81 in chips) 
Seat 2: Femali54 ($15.49 in chips) 
Seat 3: chiyuki ($46.70 in chips) 
Seat 4: Ih8niknames ($20 in chips) 
Seat 5: Angi858 ($26.65 in chips) 
Seat 6: MurMurRu ($25 in chips) 
Seat 7: pandaaaaaa ($17.56 in chips) 
Seat 8: Mytea88 ($13.05 in chips) 
Seat 9: benjuer ($25 in chips) 
Femali54: posts small blind $0.10
chiyuki: posts big blind $0.25
*** HOLE CARDS ***
Dealt to chiyuki [Kc Jc]
Ih8niknames: calls $0.25
Angi858: calls $0.25
MurMurRu: folds 
pandaaaaaa: calls $0.25
Mytea88: folds 
benjuer: folds 
risekuku468: folds 
Femali54: folds 
chiyuki: checks 
*** FLOP *** [2h Ac 2c]
chiyuki: checks 
Ih8niknames: bets $0.68
Angi858: calls $0.68
pandaaaaaa: calls $0.68
chiyuki: calls $0.68
*** TURN *** [2h Ac 2c] [Ks]
chiyuki: checks 
Ih8niknames: checks 
Angi858: checks 
pandaaaaaa: checks 
*** RIVER *** [2h Ac 2c Ks] [7s]
chiyuki: checks 
Ih8niknames: checks 
Angi858: checks 
pandaaaaaa: checks 
*** SHOW DOWN ***
chiyuki: shows [Kc Jc] (two pair, Kings and Deuces)
Ih8niknames: mucks hand 
Angi858: mucks hand 
pandaaaaaa: mucks hand 
chiyuki collected $3.65 from pot
*** SUMMARY ***
Total pot $3.82 | Rake $0.17 
Board [2h Ac 2c Ks 7s]
Seat 1: risekuku468 (button) folded before Flop (didn't bet)
Seat 2: Femali54 (small blind) folded before Flop
Seat 3: chiyuki (big blind) showed [Kc Jc] and won ($3.65) with two pair, Kings and Deuces
Seat 4: Ih8niknames mucked [6h 6c]
Seat 5: Angi858 mucked [3c 3d]
Seat 6: MurMurRu folded before Flop (didn't bet)
Seat 7: pandaaaaaa mucked [9h 9d]
Seat 8: Mytea88 folded before Flop (didn't bet)
Seat 9: benjuer folded before Flop (didn't bet)



PokerStars Zoom Hand #84301170528:  Hold'em No Limit ($0.10/$0.25) - 2012/08/05 16:16:32 JST [2012/08/05 3:16:32 ET]
Table 'Whirlpool' 9-max Seat #1 is the button
Seat 1: pikhtovnikov ($28.04 in chips) 
Seat 2: d4dda ($19.95 in chips) 
Seat 3: benjuer ($28.49 in chips) 
Seat 4: 1Karina1 ($66.89 in chips) 
Seat 5: silvno31 ($67.39 in chips) 
Seat 6: chiyuki ($49.42 in chips) 
Seat 7: MurMurRu ($42.09 in chips) 
Seat 8: Grishukps ($12.50 in chips) 
Seat 9: INSP!RON ($29.22 in chips) 
d4dda: posts small blind $0.10
benjuer: posts big blind $0.25
*** HOLE CARDS ***
Dealt to chiyuki [Td 6d]
1Karina1: folds 
silvno31: folds 
chiyuki: folds 
MurMurRu: folds 
Grishukps: folds 
INSP!RON: folds 
pikhtovnikov: folds 
d4dda: folds 
Uncalled bet ($0.15) returned to benjuer
benjuer collected $0.20 from pot
benjuer: doesn't show hand 
*** SUMMARY ***
Total pot $0.20 | Rake $0 
Seat 1: pikhtovnikov (button) folded before Flop (didn't bet)
Seat 2: d4dda (small blind) folded before Flop
Seat 3: benjuer (big blind) collected ($0.20)
Seat 4: 1Karina1 folded before Flop (didn't bet)
Seat 5: silvno31 folded before Flop (didn't bet)
Seat 6: chiyuki folded before Flop (didn't bet)
Seat 7: MurMurRu folded before Flop (didn't bet)
Seat 8: Grishukps folded before Flop (didn't bet)
Seat 9: INSP!RON folded before Flop (didn't bet)



PokerStars Zoom Hand #84301166940:  Hold'em No Limit ($0.10/$0.25) - 2012/08/05 16:16:18 JST [2012/08/05 3:16:18 ET]
Table 'Whirlpool' 9-max Seat #1 is the button
Seat 1: chiyuki ($49.42 in chips) 
Seat 2: phate-1up ($102 in chips) 
Seat 3: Angi858 ($25.72 in chips) 
Seat 4: MurMurRu ($25 in chips) 
Seat 5: nice.franki ($12.17 in chips) 
Seat 6: svg51 ($13.30 in chips) 
Seat 7: Dejacob ($35.96 in chips) 
Seat 8: benjuer ($26.11 in chips) 
Seat 9: Loholov ($15 in chips) 
phate-1up: posts small blind $0.10
Angi858: posts big blind $0.25
*** HOLE CARDS ***
Dealt to chiyuki [9h 8d]
MurMurRu: calls $0.25
nice.franki: folds 
svg51: folds 
Dejacob: folds 
benjuer: folds 
Loholov: folds 
chiyuki: folds 
phate-1up: folds 
Angi858: checks 
*** FLOP *** [Jc 7d Ts]
Angi858: checks 
MurMurRu: bets $0.48
Angi858: folds 
Uncalled bet ($0.48) returned to MurMurRu
MurMurRu collected $0.57 from pot
MurMurRu: doesn't show hand 
*** SUMMARY ***
Total pot $0.60 | Rake $0.03 
Board [Jc 7d Ts]
Seat 1: chiyuki (button) folded before Flop (didn't bet)
Seat 2: phate-1up (small blind) folded before Flop
Seat 3: Angi858 (big blind) folded on the Flop
Seat 4: MurMurRu collected ($0.57)
Seat 5: nice.franki folded before Flop (didn't bet)
Seat 6: svg51 folded before Flop (didn't bet)
Seat 7: Dejacob folded before Flop (didn't bet)
Seat 8: benjuer folded before Flop (didn't bet)
Seat 9: Loholov folded before Flop (didn't bet)



PokerStars Zoom Hand #84301174352:  Hold'em No Limit ($0.10/$0.25) - 2012/08/05 16:16:46 JST [2012/08/05 3:16:46 ET]
Table 'Whirlpool' 9-max Seat #1 is the button
Seat 1: Lucky Maga ($13 in chips) 
Seat 2: olligol123 ($26.03 in chips) 
Seat 3: MurMurRu ($35.40 in chips) 
Seat 4: Kasperlmusik ($31.11 in chips) 
Seat 5: Cripple86 ($25.84 in chips) 
Seat 6: Serge Claws ($64.48 in chips) 
Seat 7: chiyuki ($49.42 in chips) 
Seat 8: Ih8niknames ($20 in chips) 
Seat 9: Blue-GumBum ($13.10 in chips) 
olligol123: posts small blind $0.10
MurMurRu: posts big blind $0.25
*** HOLE CARDS ***
Dealt to chiyuki [Qh 2h]
Kasperlmusik: folds 
Cripple86: folds 
Serge Claws: folds 
chiyuki: folds 
Ih8niknames: folds 
Blue-GumBum: folds 
Lucky Maga: folds 
olligol123: raises $0.50 to $0.75
MurMurRu: folds 
Uncalled bet ($0.50) returned to olligol123
olligol123 collected $0.50 from pot
olligol123: doesn't show hand 
*** SUMMARY ***
Total pot $0.50 | Rake $0 
Seat 1: Lucky Maga (button) folded before Flop (didn't bet)
Seat 2: olligol123 (small blind) collected ($0.50)
Seat 3: MurMurRu (big blind) folded before Flop
Seat 4: Kasperlmusik folded before Flop (didn't bet)
Seat 5: Cripple86 folded before Flop (didn't bet)
Seat 6: Serge Claws folded before Flop (didn't bet)
Seat 7: chiyuki folded before Flop (didn't bet)
Seat 8: Ih8niknames folded before Flop (didn't bet)
Seat 9: Blue-GumBum folded before Flop (didn't bet)



PokerStars Zoom Hand #84301177153:  Hold'em No Limit ($0.10/$0.25) - 2012/08/05 16:16:56 JST [2012/08/05 3:16:56 ET]
Table 'Whirlpool' 9-max Seat #1 is the button
Seat 1: Serge Claws ($39.17 in chips) 
Seat 2: chiyuki ($49.42 in chips) 
Seat 3: pandaaaaaa ($15.88 in chips) 
Seat 4: Blue-GumBum ($13.10 in chips) 
Seat 5: masterkoolb ($12.85 in chips) 
Seat 6: phate-1up ($34.47 in chips) 
Seat 7: xxx Spb xxx ($28.47 in chips) 
Seat 8: Femali54 ($20.27 in chips) 
Seat 9: Loholov ($20.22 in chips) 
chiyuki: posts small blind $0.10
pandaaaaaa: posts big blind $0.25
*** HOLE CARDS ***
Dealt to chiyuki [8d 2c]
Blue-GumBum: folds 
masterkoolb: folds 
phate-1up: folds 
xxx Spb xxx: folds 
Femali54: folds 
Loholov: folds 
Serge Claws: folds 
chiyuki: folds 
Uncalled bet ($0.15) returned to pandaaaaaa
pandaaaaaa collected $0.20 from pot
pandaaaaaa: doesn't show hand 
*** SUMMARY ***
Total pot $0.20 | Rake $0 
Seat 1: Serge Claws (button) folded before Flop (didn't bet)
Seat 2: chiyuki (small blind) folded before Flop
Seat 3: pandaaaaaa (big blind) collected ($0.20)
Seat 4: Blue-GumBum folded before Flop (didn't bet)
Seat 5: masterkoolb folded before Flop (didn't bet)
Seat 6: phate-1up folded before Flop (didn't bet)
Seat 7: xxx Spb xxx folded before Flop (didn't bet)
Seat 8: Femali54 folded before Flop (didn't bet)
Seat 9: Loholov folded before Flop (didn't bet)



PokerStars Zoom Hand #84301172425:  Hold'em No Limit ($0.10/$0.25) - 2012/08/05 16:16:39 JST [2012/08/05 3:16:39 ET]
Table 'Whirlpool' 9-max Seat #1 is the button
Seat 1: nice.franki ($12.17 in chips) 
Seat 2: GSDP ($37.32 in chips) 
Seat 3: Vall179 ($28.33 in chips) 
Seat 4: Dejacob ($32.63 in chips) 
Seat 5: AntoineHunt ($28.86 in chips) 
Seat 6: 1Karina1 ($33.27 in chips) 
Seat 7: INSP!RON ($29.22 in chips) 
Seat 8: Loholov ($15 in chips) 
Seat 9: chiyuki ($49.42 in chips) 
GSDP: posts small blind $0.10
Vall179: posts big blind $0.25
*** HOLE CARDS ***
Dealt to chiyuki [3h 2h]
Dejacob: folds 
AntoineHunt: folds 
1Karina1: folds 
INSP!RON: folds 
Loholov: folds 
chiyuki: folds 
nice.franki: folds 
GSDP: calls $0.15
Vall179: checks 
*** FLOP *** [5d 9d Qd]
GSDP: bets $0.50
Vall179: calls $0.50
*** TURN *** [5d 9d Qd] [Qc]
GSDP: bets $0.75
Vall179: calls $0.75
*** RIVER *** [5d 9d Qd Qc] [Ks]
GSDP: checks 
Vall179: bets $1.74
GSDP: folds 
Uncalled bet ($1.74) returned to Vall179
Vall179 collected $2.86 from pot
Vall179: doesn't show hand 
*** SUMMARY ***
Total pot $3 | Rake $0.14 
Board [5d 9d Qd Qc Ks]
Seat 1: nice.franki (button) folded before Flop (didn't bet)
Seat 2: GSDP (small blind) folded on the River
Seat 3: Vall179 (big blind) collected ($2.86)
Seat 4: Dejacob folded before Flop (didn't bet)
Seat 5: AntoineHunt folded before Flop (didn't bet)
Seat 6: 1Karina1 folded before Flop (didn't bet)
Seat 7: INSP!RON folded before Flop (didn't bet)
Seat 8: Loholov folded before Flop (didn't bet)
Seat 9: chiyuki folded before Flop (didn't bet)



PokerStars Zoom Hand #84301180750:  Hold'em No Limit ($0.10/$0.25) - 2012/08/05 16:17:09 JST [2012/08/05 3:17:09 ET]
Table 'Whirlpool' 9-max Seat #1 is the button
Seat 1: benjuer ($28.49 in chips) 
Seat 2: new85new85 ($24.75 in chips) 
Seat 3: chiyuki ($49.32 in chips) 
Seat 4: phate-1up ($56.08 in chips) 
Seat 5: Ih8niknames ($20 in chips) 
Seat 6: Alvinpe85 ($109.33 in chips) 
Seat 7: Fructionar ($36.60 in chips) 
Seat 8: d4dda ($19.85 in chips) 
Seat 9: 1Karina1 ($30.34 in chips) 
new85new85: posts small blind $0.10
chiyuki: posts big blind $0.25
*** HOLE CARDS ***
Dealt to chiyuki [2s 4s]
phate-1up: folds 
Ih8niknames: folds 
Alvinpe85: folds 
Fructionar: folds 
d4dda: folds 
1Karina1: folds 
benjuer: folds 
new85new85: raises $0.25 to $0.50
chiyuki: folds 
Uncalled bet ($0.25) returned to new85new85
new85new85 collected $0.50 from pot
new85new85: doesn't show hand 
*** SUMMARY ***
Total pot $0.50 | Rake $0 
Seat 1: benjuer (button) folded before Flop (didn't bet)
Seat 2: new85new85 (small blind) collected ($0.50)
Seat 3: chiyuki (big blind) folded before Flop
Seat 4: phate-1up folded before Flop (didn't bet)
Seat 5: Ih8niknames folded before Flop (didn't bet)
Seat 6: Alvinpe85 folded before Flop (didn't bet)
Seat 7: Fructionar folded before Flop (didn't bet)
Seat 8: d4dda folded before Flop (didn't bet)
Seat 9: 1Karina1 folded before Flop (didn't bet)



PokerStars Zoom Hand #84301178792:  Hold'em No Limit ($0.10/$0.25) - 2012/08/05 16:17:02 JST [2012/08/05 3:17:02 ET]
Table 'Whirlpool' 9-max Seat #1 is the button
Seat 1: mungroo ($24.65 in chips) 
Seat 2: Vall179 ($37.50 in chips) 
Seat 3: Limoilou ($31.81 in chips) 
Seat 4: chiyuki ($49.32 in chips) 
Seat 5: Alvinpe85 ($30.10 in chips) 
Seat 6: phate-1up ($101.65 in chips) 
Seat 7: Dejacob ($28.53 in chips) 
Seat 8: Serge Claws ($39.07 in chips) 
Seat 9: xxx Spb xxx ($28.47 in chips) 
Vall179: posts small blind $0.10
Limoilou: posts big blind $0.25
*** HOLE CARDS ***
Dealt to chiyuki [Th Kh]
chiyuki: folds 
Alvinpe85: raises $0.50 to $0.75
phate-1up: folds 
Dejacob: folds 
Serge Claws: folds 
xxx Spb xxx: folds 
mungroo: calls $0.75
Vall179: folds 
Limoilou: folds 
*** FLOP *** [5h 2c 3s]
Alvinpe85: bets $1.06
mungroo: folds 
Uncalled bet ($1.06) returned to Alvinpe85
Alvinpe85 collected $1.77 from pot
Alvinpe85: doesn't show hand 
*** SUMMARY ***
Total pot $1.85 | Rake $0.08 
Board [5h 2c 3s]
Seat 1: mungroo (button) folded on the Flop
Seat 2: Vall179 (small blind) folded before Flop
Seat 3: Limoilou (big blind) folded before Flop
Seat 4: chiyuki folded before Flop (didn't bet)
Seat 5: Alvinpe85 collected ($1.77)
Seat 6: phate-1up folded before Flop (didn't bet)
Seat 7: Dejacob folded before Flop (didn't bet)
Seat 8: Serge Claws folded before Flop (didn't bet)
Seat 9: xxx Spb xxx folded before Flop (didn't bet)



PokerStars Zoom Hand #84301179948:  Hold'em No Limit ($0.10/$0.25) - 2012/08/05 16:17:06 JST [2012/08/05 3:17:06 ET]
Table 'Whirlpool' 9-max Seat #1 is the button
Seat 1: MurMurRu ($35.15 in chips) 
Seat 2: 19MJJ21 ($16.30 in chips) 
Seat 3: scaredsare ($23.48 in chips) 
Seat 4: Perstenev ($12.33 in chips) 
Seat 5: chiyuki ($49.32 in chips) 
Seat 6: Kasperlmusik ($31.01 in chips) 
Seat 7: INSP!RON ($26.93 in chips) 
Seat 8: Dejacob ($36.64 in chips) 
Seat 9: deepakmbh ($28.52 in chips) 
19MJJ21: posts small blind $0.10
scaredsare: posts big blind $0.25
*** HOLE CARDS ***
Dealt to chiyuki [5d 9s]
Perstenev: folds 
chiyuki: folds 
Kasperlmusik: folds 
INSP!RON: folds 
Dejacob: folds 
deepakmbh: raises $0.25 to $0.50
MurMurRu: folds 
19MJJ21: calls $0.40
scaredsare: calls $0.25
*** FLOP *** [7c 8d Jc]
19MJJ21: checks 
scaredsare: checks 
deepakmbh: checks 
*** TURN *** [7c 8d Jc] [4d]
19MJJ21: checks 
scaredsare: bets $1.25
deepakmbh: folds 
19MJJ21: folds 
Uncalled bet ($1.25) returned to scaredsare
scaredsare collected $1.43 from pot
scaredsare: doesn't show hand 
*** SUMMARY ***
Total pot $1.50 | Rake $0.07 
Board [7c 8d Jc 4d]
Seat 1: MurMurRu (button) folded before Flop (didn't bet)
Seat 2: 19MJJ21 (small blind) folded on the Turn
Seat 3: scaredsare (big blind) collected ($1.43)
Seat 4: Perstenev folded before Flop (didn't bet)
Seat 5: chiyuki folded before Flop (didn't bet)
Seat 6: Kasperlmusik folded before Flop (didn't bet)
Seat 7: INSP!RON folded before Flop (didn't bet)
Seat 8: Dejacob folded before Flop (didn't bet)
Seat 9: deepakmbh folded on the Turn



PokerStars Zoom Hand #84301189845:  Hold'em No Limit ($0.10/$0.25) - 2012/08/05 16:17:43 JST [2012/08/05 3:17:43 ET]
Table 'Whirlpool' 9-max Seat #1 is the button
Seat 1: 4plankton ($3.83 in chips) 
Seat 2: GSDP ($24.50 in chips) 
Seat 3: soul_5577 ($34.73 in chips) 
Seat 4: chiyuki ($49.07 in chips) 
Seat 5: Blue-GumBum ($13.10 in chips) 
Seat 6: mungroo ($24.65 in chips) 
Seat 7: Cripple86 ($25.70 in chips) 
Seat 8: Ih8niknames ($20 in chips) 
Seat 9: Grishukps ($13.18 in chips) 
GSDP: posts small blind $0.10
soul_5577: posts big blind $0.25
*** HOLE CARDS ***
Dealt to chiyuki [Qd Ac]
chiyuki: raises $0.50 to $0.75
Blue-GumBum: folds 
mungroo: folds 
Cripple86: folds 
Ih8niknames: folds 
Grishukps: folds 
4plankton: folds 
GSDP: calls $0.65
soul_5577: folds 
*** FLOP *** [Jh 4s Qc]
GSDP: checks 
chiyuki: bets $1.25
GSDP: folds 
Uncalled bet ($1.25) returned to chiyuki
chiyuki collected $1.67 from pot
chiyuki: doesn't show hand 
*** SUMMARY ***
Total pot $1.75 | Rake $0.08 
Board [Jh 4s Qc]
Seat 1: 4plankton (button) folded before Flop (didn't bet)
Seat 2: GSDP (small blind) folded on the Flop
Seat 3: soul_5577 (big blind) folded before Flop
Seat 4: chiyuki collected ($1.67)
Seat 5: Blue-GumBum folded before Flop (didn't bet)
Seat 6: mungroo folded before Flop (didn't bet)
Seat 7: Cripple86 folded before Flop (didn't bet)
Seat 8: Ih8niknames folded before Flop (didn't bet)
Seat 9: Grishukps folded before Flop (didn't bet)



PokerStars Zoom Hand #84301186727:  Hold'em No Limit ($0.10/$0.25) - 2012/08/05 16:17:31 JST [2012/08/05 3:17:31 ET]
Table 'Whirlpool' 9-max Seat #1 is the button
Seat 1: new85new85 ($25 in chips) 
Seat 2: PAMBOS.L ($12.94 in chips) 
Seat 3: FoRlan77 ($25 in chips) 
Seat 4: snejokCoxx ($26.35 in chips) 
Seat 5: Nerkit ($14.70 in chips) 
Seat 6: chiyuki ($49.07 in chips) 
Seat 7: Limoilou ($31.56 in chips) 
Seat 8: Loholov ($17.38 in chips) 
Seat 9: schoof 2 ($16.44 in chips) 
PAMBOS.L: posts small blind $0.10
FoRlan77: posts big blind $0.25
*** HOLE CARDS ***
Dealt to chiyuki [6c 5h]
snejokCoxx: folds 
Nerkit: folds 
chiyuki: folds 
Limoilou: folds 
Loholov: raises $0.50 to $0.75
schoof 2: calls $0.75
new85new85: folds 
PAMBOS.L: folds 
FoRlan77: folds 
*** FLOP *** [Js Ks 4h]
Loholov: checks 
schoof 2: checks 
*** TURN *** [Js Ks 4h] [6s]
Loholov: checks 
schoof 2: bets $1
Loholov: calls $1
*** RIVER *** [Js Ks 4h 6s] [5s]
Loholov: bets $3
schoof 2: calls $3
*** SHOW DOWN ***
Loholov: shows [Qh As] (a flush, Ace high)
schoof 2: mucks hand 
Loholov collected $9.41 from pot
*** SUMMARY ***
Total pot $9.85 | Rake $0.44 
Board [Js Ks 4h 6s 5s]
Seat 1: new85new85 (button) folded before Flop (didn't bet)
Seat 2: PAMBOS.L (small blind) folded before Flop
Seat 3: FoRlan77 (big blind) folded before Flop
Seat 4: snejokCoxx folded before Flop (didn't bet)
Seat 5: Nerkit folded before Flop (didn't bet)
Seat 6: chiyuki folded before Flop (didn't bet)
Seat 7: Limoilou folded before Flop (didn't bet)
Seat 8: Loholov showed [Qh As] and won ($9.41) with a flush, Ace high
Seat 9: schoof 2 mucked [Ah 7s]



PokerStars Zoom Hand #84301197373:  Hold'em No Limit ($0.10/$0.25) - 2012/08/05 16:18:10 JST [2012/08/05 3:18:10 ET]
Table 'Whirlpool' 9-max Seat #1 is the button
Seat 1: fil740 ($22.26 in chips) 
Seat 2: Dejacob ($28.63 in chips) 
Seat 3: GovGus ($51.55 in chips) 
Seat 4: nice.franki ($12.15 in chips) 
Seat 5: Limoilou ($31.21 in chips) 
Seat 6: Vall179 ($29.59 in chips) 
Seat 7: 1Karina1 ($30.24 in chips) 
Seat 8: benjuer ($25.36 in chips) 
Seat 9: chiyuki ($49.99 in chips) 
Dejacob: posts small blind $0.10
GovGus: posts big blind $0.25
*** HOLE CARDS ***
Dealt to chiyuki [4s Qc]
nice.franki: folds 
Limoilou: folds 
Vall179: folds 
1Karina1: folds 
benjuer: folds 
chiyuki: folds 
fil740: raises $0.25 to $0.50
Dejacob: folds 
GovGus: folds 
Uncalled bet ($0.25) returned to fil740
fil740 collected $0.60 from pot
fil740: doesn't show hand 
*** SUMMARY ***
Total pot $0.60 | Rake $0 
Seat 1: fil740 (button) collected ($0.60)
Seat 2: Dejacob (small blind) folded before Flop
Seat 3: GovGus (big blind) folded before Flop
Seat 4: nice.franki folded before Flop (didn't bet)
Seat 5: Limoilou folded before Flop (didn't bet)
Seat 6: Vall179 folded before Flop (didn't bet)
Seat 7: 1Karina1 folded before Flop (didn't bet)
Seat 8: benjuer folded before Flop (didn't bet)
Seat 9: chiyuki folded before Flop (didn't bet)



PokerStars Zoom Hand #84301203988:  Hold'em No Limit ($0.10/$0.25) - 2012/08/05 16:18:34 JST [2012/08/05 3:18:34 ET]
Table 'Whirlpool' 9-max Seat #1 is the button
Seat 1: leo2095 ($25.88 in chips) 
Seat 2: FoRlan77 ($26.10 in chips) 
Seat 3: chiyuki ($49.99 in chips) 
Seat 4: kwkim73 ($25.35 in chips) 
Seat 5: Grishukps ($13.28 in chips) 
Seat 6: Nerkit ($10.73 in chips) 
Seat 7: wildy29 ($106.30 in chips) 
Seat 8: kesstukas25 ($24.19 in chips) 
Seat 9: Perstenev ($9.93 in chips) 
FoRlan77: posts small blind $0.10
chiyuki: posts big blind $0.25
*** HOLE CARDS ***
Dealt to chiyuki [Qh 2c]
kwkim73: folds 
Grishukps: folds 
Nerkit: folds 
wildy29: folds 
kesstukas25: folds 
Perstenev: folds 
leo2095: folds 
FoRlan77: folds 
Uncalled bet ($0.15) returned to chiyuki
chiyuki collected $0.20 from pot
chiyuki: doesn't show hand 
*** SUMMARY ***
Total pot $0.20 | Rake $0 
Seat 1: leo2095 (button) folded before Flop (didn't bet)
Seat 2: FoRlan77 (small blind) folded before Flop
Seat 3: chiyuki (big blind) collected ($0.20)
Seat 4: kwkim73 folded before Flop (didn't bet)
Seat 5: Grishukps folded before Flop (didn't bet)
Seat 6: Nerkit folded before Flop (didn't bet)
Seat 7: wildy29 folded before Flop (didn't bet)
Seat 8: kesstukas25 folded before Flop (didn't bet)
Seat 9: Perstenev folded before Flop (didn't bet)



PokerStars Zoom Hand #84301187859:  Hold'em No Limit ($0.10/$0.25) - 2012/08/05 16:17:35 JST [2012/08/05 3:17:35 ET]
Table 'Whirlpool' 9-max Seat #1 is the button
Seat 1: chiyuki ($49.07 in chips) 
Seat 2: Femali54 ($20.02 in chips) 
Seat 3: PAMBOS.L ($12.84 in chips) 
Seat 4: Cripple86 ($26.81 in chips) 
Seat 5: 19MJJ21 ($15.80 in chips) 
Seat 6: GovGus ($25 in chips) 
Seat 7: Vall179 ($37.40 in chips) 
Seat 8: Ellen1947 ($28.42 in chips) 
Seat 9: CBR1000RR890 ($12.57 in chips) 
Femali54: posts small blind $0.10
PAMBOS.L: posts big blind $0.25
*** HOLE CARDS ***
Dealt to chiyuki [9h 3h]
Cripple86: folds 
19MJJ21: folds 
GovGus: folds 
Vall179: folds 
Ellen1947: raises $0.50 to $0.75
CBR1000RR890: folds 
chiyuki: folds 
Femali54: calls $0.65
PAMBOS.L: folds 
*** FLOP *** [2h Js 7h]
Femali54: checks 
Ellen1947: bets $0.90
Femali54: raises $1.60 to $2.50
Ellen1947: calls $1.60
*** TURN *** [2h Js 7h] [Tc]
Femali54: checks 
Ellen1947: checks 
*** RIVER *** [2h Js 7h Tc] [Ah]
Femali54: bets $3.75
Ellen1947: calls $3.75
*** SHOW DOWN ***
Femali54: shows [Qs Kd] (a straight, Ten to Ace)
Ellen1947: mucks hand 
Femali54 collected $13.61 from pot
*** SUMMARY ***
Total pot $14.25 | Rake $0.64 
Board [2h Js 7h Tc Ah]
Seat 1: chiyuki (button) folded before Flop (didn't bet)
Seat 2: Femali54 (small blind) showed [Qs Kd] and won ($13.61) with a straight, Ten to Ace
Seat 3: PAMBOS.L (big blind) folded before Flop
Seat 4: Cripple86 folded before Flop (didn't bet)
Seat 5: 19MJJ21 folded before Flop (didn't bet)
Seat 6: GovGus folded before Flop (didn't bet)
Seat 7: Vall179 folded before Flop (didn't bet)
Seat 8: Ellen1947 mucked [Ad Ac]
Seat 9: CBR1000RR890 folded before Flop (didn't bet)



PokerStars Zoom Hand #84301208982:  Hold'em No Limit ($0.10/$0.25) - 2012/08/05 16:18:53 JST [2012/08/05 3:18:53 ET]
Table 'Whirlpool' 9-max Seat #1 is the button
Seat 1: GSDP ($23.85 in chips) 
Seat 2: chiyuki ($50.09 in chips) 
Seat 3: deepakmbh ($28.95 in chips) 
Seat 4: Nerkit ($15.61 in chips) 
Seat 5: silvno31 ($67.04 in chips) 
Seat 6: nice.franki ($12.63 in chips) 
Seat 7: Cripple86 ($25.84 in chips) 
Seat 8: MurMurRu ($41.49 in chips) 
Seat 9: 280128si ($17.89 in chips) 
chiyuki: posts small blind $0.10
deepakmbh: posts big blind $0.25
*** HOLE CARDS ***
Dealt to chiyuki [3c 9s]
Nerkit: folds 
silvno31: folds 
nice.franki: folds 
Cripple86: folds 
MurMurRu: folds 
280128si: folds 
GSDP: raises $0.50 to $0.75
chiyuki: folds 
deepakmbh: calls $0.50
*** FLOP *** [Ah 9c Ks]
deepakmbh: checks 
GSDP: bets $1
deepakmbh: folds 
Uncalled bet ($1) returned to GSDP
GSDP collected $1.53 from pot
GSDP: doesn't show hand 
*** SUMMARY ***
Total pot $1.60 | Rake $0.07 
Board [Ah 9c Ks]
Seat 1: GSDP (button) collected ($1.53)
Seat 2: chiyuki (small blind) folded before Flop
Seat 3: deepakmbh (big blind) folded on the Flop
Seat 4: Nerkit folded before Flop (didn't bet)
Seat 5: silvno31 folded before Flop (didn't bet)
Seat 6: nice.franki folded before Flop (didn't bet)
Seat 7: Cripple86 folded before Flop (didn't bet)
Seat 8: MurMurRu folded before Flop (didn't bet)
Seat 9: 280128si folded before Flop (didn't bet)



PokerStars Zoom Hand #84301198483:  Hold'em No Limit ($0.10/$0.25) - 2012/08/05 16:18:14 JST [2012/08/05 3:18:14 ET]
Table 'Whirlpool' 9-max Seat #1 is the button
Seat 1: new85new85 ($25 in chips) 
Seat 2: Patient90122 ($26.87 in chips) 
Seat 3: nice.franki ($12.15 in chips) 
Seat 4: pandaaaaaa ($15.63 in chips) 
Seat 5: Grishukps ($16.22 in chips) 
Seat 6: hldtom ($34.80 in chips) 
Seat 7: slapshot2011 ($45.39 in chips) 
Seat 8: chiyuki ($49.99 in chips) 
Seat 9: Dejacob ($28.53 in chips) 
Patient90122: posts small blind $0.10
nice.franki: posts big blind $0.25
*** HOLE CARDS ***
Dealt to chiyuki [Js 9c]
pandaaaaaa: raises $0.50 to $0.75
Grishukps: folds 
hldtom: calls $0.75
slapshot2011: folds 
chiyuki: folds 
Dejacob: folds 
new85new85: calls $0.75
Patient90122: folds 
nice.franki: folds 
*** FLOP *** [5d 6d 4c]
pandaaaaaa: checks 
hldtom: checks 
new85new85: checks 
*** TURN *** [5d 6d 4c] [Jc]
pandaaaaaa: checks 
hldtom: checks 
new85new85: checks 
*** RIVER *** [5d 6d 4c Jc] [8d]
pandaaaaaa: checks 
hldtom: bets $1.24
new85new85: folds 
pandaaaaaa: folds 
Uncalled bet ($1.24) returned to hldtom
hldtom collected $2.48 from pot
hldtom: doesn't show hand 
*** SUMMARY ***
Total pot $2.60 | Rake $0.12 
Board [5d 6d 4c Jc 8d]
Seat 1: new85new85 (button) folded on the River
Seat 2: Patient90122 (small blind) folded before Flop
Seat 3: nice.franki (big blind) folded before Flop
Seat 4: pandaaaaaa folded on the River
Seat 5: Grishukps folded before Flop (didn't bet)
Seat 6: hldtom collected ($2.48)
Seat 7: slapshot2011 folded before Flop (didn't bet)
Seat 8: chiyuki folded before Flop (didn't bet)
Seat 9: Dejacob folded before Flop (didn't bet)



PokerStars Zoom Hand #84301200716:  Hold'em No Limit ($0.10/$0.25) - 2012/08/05 16:18:22 JST [2012/08/05 3:18:22 ET]
Table 'Whirlpool' 9-max Seat #1 is the button
Seat 1: Vall179 ($31.29 in chips) 
Seat 2: phate-1up ($34.63 in chips) 
Seat 3: opie62 ($19.16 in chips) 
Seat 4: Kozyavkin ($5.28 in chips) 
Seat 5: chiyuki ($49.99 in chips) 
Seat 6: Alvinpe85 ($31.12 in chips) 
Seat 7: Cripple86 ($26.56 in chips) 
Seat 8: codan23 ($13.60 in chips) 
Seat 9: benjuer ($25.36 in chips) 
phate-1up: posts small blind $0.10
opie62: posts big blind $0.25
*** HOLE CARDS ***
Dealt to chiyuki [Td 2s]
Kozyavkin: folds 
chiyuki: folds 
Alvinpe85: raises $0.50 to $0.75
Cripple86: folds 
codan23: folds 
benjuer: calls $0.75
Vall179: folds 
phate-1up: folds 
opie62: folds 
*** FLOP *** [Ad 8h 9c]
Alvinpe85: bets $1.06
benjuer: folds 
Uncalled bet ($1.06) returned to Alvinpe85
Alvinpe85 collected $1.77 from pot
Alvinpe85: doesn't show hand 
*** SUMMARY ***
Total pot $1.85 | Rake $0.08 
Board [Ad 8h 9c]
Seat 1: Vall179 (button) folded before Flop (didn't bet)
Seat 2: phate-1up (small blind) folded before Flop
Seat 3: opie62 (big blind) folded before Flop
Seat 4: Kozyavkin folded before Flop (didn't bet)
Seat 5: chiyuki folded before Flop (didn't bet)
Seat 6: Alvinpe85 collected ($1.77)
Seat 7: Cripple86 folded before Flop (didn't bet)
Seat 8: codan23 folded before Flop (didn't bet)
Seat 9: benjuer folded on the Flop



PokerStars Zoom Hand #84301211496:  Hold'em No Limit ($0.10/$0.25) - 2012/08/05 16:19:02 JST [2012/08/05 3:19:02 ET]
Table 'Whirlpool' 9-max Seat #1 is the button
Seat 1: chiyuki ($49.99 in chips) 
Seat 2: Blue-GumBum ($12.35 in chips) 
Seat 3: poorpoor6551 ($11.74 in chips) 
Seat 4: DanielWhyte ($35.12 in chips) 
Seat 5: Serge Claws ($39.42 in chips) 
Seat 6: MurMurRu ($27.18 in chips) 
Seat 7: Dejacob ($28.28 in chips) 
Seat 8: Nerkit ($15.61 in chips) 
Seat 9: nice.franki ($11.80 in chips) 
Blue-GumBum: posts small blind $0.10
poorpoor6551: posts big blind $0.25
*** HOLE CARDS ***
Dealt to chiyuki [7c 7s]
DanielWhyte: folds 
Serge Claws: folds 
MurMurRu: calls $0.25
Dejacob: raises $0.75 to $1
Nerkit: folds 
nice.franki: folds 
chiyuki: folds 
Blue-GumBum: folds 
poorpoor6551: folds 
MurMurRu: calls $0.75
*** FLOP *** [Td Ts 3s]
MurMurRu: checks 
Dejacob: checks 
*** TURN *** [Td Ts 3s] [9c]
MurMurRu: checks 
Dejacob: checks 
*** RIVER *** [Td Ts 3s 9c] [5d]
MurMurRu: checks 
Dejacob: checks 
*** SHOW DOWN ***
MurMurRu: shows [Kh Kd] (two pair, Kings and Tens)
Dejacob: mucks hand 
MurMurRu collected $2.24 from pot
*** SUMMARY ***
Total pot $2.35 | Rake $0.11 
Board [Td Ts 3s 9c 5d]
Seat 1: chiyuki (button) folded before Flop (didn't bet)
Seat 2: Blue-GumBum (small blind) folded before Flop
Seat 3: poorpoor6551 (big blind) folded before Flop
Seat 4: DanielWhyte folded before Flop (didn't bet)
Seat 5: Serge Claws folded before Flop (didn't bet)
Seat 6: MurMurRu showed [Kh Kd] and won ($2.24) with two pair, Kings and Tens
Seat 7: Dejacob mucked [As Kc]
Seat 8: Nerkit folded before Flop (didn't bet)
Seat 9: nice.franki folded before Flop (didn't bet)



PokerStars Zoom Hand #84301215064:  Hold'em No Limit ($0.10/$0.25) - 2012/08/05 16:19:15 JST [2012/08/05 3:19:15 ET]
Table 'Whirlpool' 9-max Seat #1 is the button
Seat 1: INSP!RON ($25 in chips) 
Seat 2: PAMBOS.L ($10.34 in chips) 
Seat 3: nice.franki ($4.21 in chips) 
Seat 4: Perstenev ($8.88 in chips) 
Seat 5: Dejacob ($26.22 in chips) 
Seat 6: risekuku468 ($30.31 in chips) 
Seat 7: chiyuki ($49.99 in chips) 
Seat 8: DanielWhyte ($35.12 in chips) 
Seat 9: GSDP ($24.63 in chips) 
PAMBOS.L: posts small blind $0.10
nice.franki: posts big blind $0.25
*** HOLE CARDS ***
Dealt to chiyuki [Jh 4h]
Perstenev: folds 
Dejacob: folds 
risekuku468: folds 
chiyuki: folds 
DanielWhyte: raises $0.25 to $0.50
GSDP: folds 
INSP!RON: raises $1.40 to $1.90
PAMBOS.L: folds 
nice.franki: folds 
DanielWhyte: calls $1.40
*** FLOP *** [7c Tc 3d]
DanielWhyte: checks 
INSP!RON: bets $2
DanielWhyte: folds 
Uncalled bet ($2) returned to INSP!RON
INSP!RON collected $3.96 from pot
INSP!RON: doesn't show hand 
*** SUMMARY ***
Total pot $4.15 | Rake $0.19 
Board [7c Tc 3d]
Seat 1: INSP!RON (button) collected ($3.96)
Seat 2: PAMBOS.L (small blind) folded before Flop
Seat 3: nice.franki (big blind) folded before Flop
Seat 4: Perstenev folded before Flop (didn't bet)
Seat 5: Dejacob folded before Flop (didn't bet)
Seat 6: risekuku468 folded before Flop (didn't bet)
Seat 7: chiyuki folded before Flop (didn't bet)
Seat 8: DanielWhyte folded on the Flop
Seat 9: GSDP folded before Flop (didn't bet)



PokerStars Zoom Hand #84301217260:  Hold'em No Limit ($0.10/$0.25) - 2012/08/05 16:19:23 JST [2012/08/05 3:19:23 ET]
Table 'Whirlpool' 9-max Seat #1 is the button
Seat 1: KeLevro0 ($10.14 in chips) 
Seat 2: AAT Shark ($12.50 in chips) 
Seat 3: MurMurRu ($41.49 in chips) 
Seat 4: Dejacob ($36.24 in chips) 
Seat 5: mamlind ($12.95 in chips) 
Seat 6: PAMBOS.L ($10.24 in chips) 
Seat 7: benjuer ($25 in chips) 
Seat 8: chiyuki ($49.99 in chips) 
Seat 9: Alvinpe85 ($32.14 in chips) 
AAT Shark: posts small blind $0.10
MurMurRu: posts big blind $0.25
*** HOLE CARDS ***
Dealt to chiyuki [Kc Qd]
Dejacob: folds 
mamlind: folds 
PAMBOS.L: folds 
benjuer: folds 
chiyuki: raises $0.50 to $0.75
Alvinpe85: folds 
KeLevro0: folds 
AAT Shark: folds 
MurMurRu: folds 
Uncalled bet ($0.50) returned to chiyuki
chiyuki collected $0.60 from pot
chiyuki: doesn't show hand 
*** SUMMARY ***
Total pot $0.60 | Rake $0 
Seat 1: KeLevro0 (button) folded before Flop (didn't bet)
Seat 2: AAT Shark (small blind) folded before Flop
Seat 3: MurMurRu (big blind) folded before Flop
Seat 4: Dejacob folded before Flop (didn't bet)
Seat 5: mamlind folded before Flop (didn't bet)
Seat 6: PAMBOS.L folded before Flop (didn't bet)
Seat 7: benjuer folded before Flop (didn't bet)
Seat 8: chiyuki collected ($0.60)
Seat 9: Alvinpe85 folded before Flop (didn't bet)



PokerStars Zoom Hand #84301202909:  Hold'em No Limit ($0.10/$0.25) - 2012/08/05 16:18:30 JST [2012/08/05 3:18:30 ET]
Table 'Whirlpool' 9-max Seat #1 is the button
Seat 1: Loholov ($20.32 in chips) 
Seat 2: galaxe ($26.42 in chips) 
Seat 3: CBR1000RR890 ($12.47 in chips) 
Seat 4: chiyuki ($49.99 in chips) 
Seat 5: ivan130 ($28.51 in chips) 
Seat 6: kwkim73 ($25.35 in chips) 
Seat 7: phate-1up ($34.53 in chips) 
Seat 8: scaredsare ($23.44 in chips) 
Seat 9: INSP!RON ($30.91 in chips) 
galaxe: posts small blind $0.10
CBR1000RR890: posts big blind $0.25
*** HOLE CARDS ***
Dealt to chiyuki [4s Jd]
chiyuki: folds 
ivan130: raises $0.25 to $0.50
kwkim73: folds 
phate-1up: folds 
scaredsare: folds 
INSP!RON: calls $0.50
Loholov: calls $0.50
galaxe: calls $0.40
CBR1000RR890: calls $0.25
*** FLOP *** [5s Qs Ac]
galaxe: checks 
CBR1000RR890: checks 
ivan130: checks 
INSP!RON: checks 
Loholov: checks 
*** TURN *** [5s Qs Ac] [9h]
galaxe: checks 
CBR1000RR890: checks 
ivan130: checks 
INSP!RON: bets $1.65
Loholov: calls $1.65
galaxe: folds 
CBR1000RR890: folds 
ivan130: folds 
*** RIVER *** [5s Qs Ac 9h] [3s]
INSP!RON: checks 
Loholov: bets $2.75
INSP!RON: folds 
Uncalled bet ($2.75) returned to Loholov
Loholov collected $5.54 from pot
Loholov: doesn't show hand 
*** SUMMARY ***
Total pot $5.80 | Rake $0.26 
Board [5s Qs Ac 9h 3s]
Seat 1: Loholov (button) collected ($5.54)
Seat 2: galaxe (small blind) folded on the Turn
Seat 3: CBR1000RR890 (big blind) folded on the Turn
Seat 4: chiyuki folded before Flop (didn't bet)
Seat 5: ivan130 folded on the Turn
Seat 6: kwkim73 folded before Flop (didn't bet)
Seat 7: phate-1up folded before Flop (didn't bet)
Seat 8: scaredsare folded before Flop (didn't bet)
Seat 9: INSP!RON folded on the River



PokerStars Zoom Hand #84301223897:  Hold'em No Limit ($0.10/$0.25) - 2012/08/05 16:19:47 JST [2012/08/05 3:19:47 ET]
Table 'Whirlpool' 9-max Seat #1 is the button
Seat 1: Vall179 ($28.80 in chips) 
Seat 2: Ellen1947 ($21.17 in chips) 
Seat 3: scaredsare ($19.44 in chips) 
Seat 4: munky3 ($26.61 in chips) 
Seat 5: masterkoolb ($17.42 in chips) 
Seat 6: chiyuki ($50.34 in chips) 
Seat 7: MurMurRu ($29.84 in chips) 
Seat 8: DrunkTyphoon ($33.11 in chips) 
Seat 9: Grumpy as 2 ($8.43 in chips) 
Ellen1947: posts small blind $0.10
scaredsare: posts big blind $0.25
*** HOLE CARDS ***
Dealt to chiyuki [Jh 5c]
munky3: folds 
masterkoolb: folds 
chiyuki: folds 
MurMurRu: folds 
DrunkTyphoon: folds 
Grumpy as 2: folds 
Vall179: folds 
Ellen1947: folds 
Uncalled bet ($0.15) returned to scaredsare
scaredsare collected $0.20 from pot
scaredsare: doesn't show hand 
*** SUMMARY ***
Total pot $0.20 | Rake $0 
Seat 1: Vall179 (button) folded before Flop (didn't bet)
Seat 2: Ellen1947 (small blind) folded before Flop
Seat 3: scaredsare (big blind) collected ($0.20)
Seat 4: munky3 folded before Flop (didn't bet)
Seat 5: masterkoolb folded before Flop (didn't bet)
Seat 6: chiyuki folded before Flop (didn't bet)
Seat 7: MurMurRu folded before Flop (didn't bet)
Seat 8: DrunkTyphoon folded before Flop (didn't bet)
Seat 9: Grumpy as 2 folded before Flop (didn't bet)



PokerStars Zoom Hand #84301227298:  Hold'em No Limit ($0.10/$0.25) - 2012/08/05 16:20:00 JST [2012/08/05 3:20:00 ET]
Table 'Whirlpool' 9-max Seat #1 is the button
Seat 1: Femali54 ($26.63 in chips) 
Seat 2: mjmichi ($25.92 in chips) 
Seat 3: d4dda ($28.28 in chips) 
Seat 4: chiyuki ($50.34 in chips) 
Seat 5: Loholov ($15 in chips) 
Seat 6: roksmokndonk ($16.05 in chips) 
Seat 7: Lasutchik ($32.54 in chips) 
Seat 8: 280128si ($17.54 in chips) 
Seat 9: RRMM_again ($21.64 in chips) 
mjmichi: posts small blind $0.10
d4dda: posts big blind $0.25
*** HOLE CARDS ***
Dealt to chiyuki [5s 7s]
chiyuki: folds 
Loholov: folds 
roksmokndonk: folds 
Lasutchik: folds 
280128si: folds 
RRMM_again: folds 
Femali54: folds 
mjmichi: raises $0.50 to $0.75
d4dda: folds 
Uncalled bet ($0.50) returned to mjmichi
mjmichi collected $0.50 from pot
mjmichi: doesn't show hand 
*** SUMMARY ***
Total pot $0.50 | Rake $0 
Seat 1: Femali54 (button) folded before Flop (didn't bet)
Seat 2: mjmichi (small blind) collected ($0.50)
Seat 3: d4dda (big blind) folded before Flop
Seat 4: chiyuki folded before Flop (didn't bet)
Seat 5: Loholov folded before Flop (didn't bet)
Seat 6: roksmokndonk folded before Flop (didn't bet)
Seat 7: Lasutchik folded before Flop (didn't bet)
Seat 8: 280128si folded before Flop (didn't bet)
Seat 9: RRMM_again folded before Flop (didn't bet)



PokerStars Zoom Hand #84301228411:  Hold'em No Limit ($0.10/$0.25) - 2012/08/05 16:20:04 JST [2012/08/05 3:20:04 ET]
Table 'Whirlpool' 9-max Seat #1 is the button
Seat 1: fwnaf ($29.83 in chips) 
Seat 2: chiyuki ($50.34 in chips) 
Seat 3: GSDP ($24.53 in chips) 
Seat 4: masterkoolb ($12.50 in chips) 
Seat 5: 280128si ($17.54 in chips) 
Seat 6: Patient90122 ($26.17 in chips) 
Seat 7: roksmokndonk ($16.05 in chips) 
Seat 8: teaser07 ($26.67 in chips) 
Seat 9: Cripple86 ($33.91 in chips) 
chiyuki: posts small blind $0.10
GSDP: posts big blind $0.25
*** HOLE CARDS ***
Dealt to chiyuki [2c 7h]
masterkoolb: folds 
280128si: folds 
Patient90122: folds 
roksmokndonk: folds 
teaser07: raises $0.50 to $0.75
Cripple86: folds 
fwnaf: folds 
chiyuki: folds 
GSDP: folds 
Uncalled bet ($0.50) returned to teaser07
teaser07 collected $0.60 from pot
teaser07: doesn't show hand 
*** SUMMARY ***
Total pot $0.60 | Rake $0 
Seat 1: fwnaf (button) folded before Flop (didn't bet)
Seat 2: chiyuki (small blind) folded before Flop
Seat 3: GSDP (big blind) folded before Flop
Seat 4: masterkoolb folded before Flop (didn't bet)
Seat 5: 280128si folded before Flop (didn't bet)
Seat 6: Patient90122 folded before Flop (didn't bet)
Seat 7: roksmokndonk folded before Flop (didn't bet)
Seat 8: teaser07 collected ($0.60)
Seat 9: Cripple86 folded before Flop (didn't bet)



PokerStars Zoom Hand #84301231632:  Hold'em No Limit ($0.10/$0.25) - 2012/08/05 16:20:16 JST [2012/08/05 3:20:16 ET]
Table 'Whirlpool' 9-max Seat #1 is the button
Seat 1: chiyuki ($50.24 in chips) 
Seat 2: Serge Claws ($25.30 in chips) 
Seat 3: Grishukps ($12.85 in chips) 
Seat 4: KeLevro0 ($12.88 in chips) 
Seat 5: top gun 2950 ($30.73 in chips) 
Seat 6: DrunkTyphoon ($51.11 in chips) 
Seat 7: a_tasmanian ($21.66 in chips) 
Seat 8: deepakmbh ($26.16 in chips) 
Seat 9: codan23 ($14.27 in chips) 
Serge Claws: posts small blind $0.10
Grishukps: posts big blind $0.25
*** HOLE CARDS ***
Dealt to chiyuki [Ts 5s]
KeLevro0: folds 
top gun 2950: folds 
DrunkTyphoon: folds 
a_tasmanian: folds 
deepakmbh: folds 
codan23: folds 
chiyuki: folds 
Serge Claws: folds 
Uncalled bet ($0.15) returned to Grishukps
Grishukps collected $0.20 from pot
Grishukps: doesn't show hand 
*** SUMMARY ***
Total pot $0.20 | Rake $0 
Seat 1: chiyuki (button) folded before Flop (didn't bet)
Seat 2: Serge Claws (small blind) folded before Flop
Seat 3: Grishukps (big blind) collected ($0.20)
Seat 4: KeLevro0 folded before Flop (didn't bet)
Seat 5: top gun 2950 folded before Flop (didn't bet)
Seat 6: DrunkTyphoon folded before Flop (didn't bet)
Seat 7: a_tasmanian folded before Flop (didn't bet)
Seat 8: deepakmbh folded before Flop (didn't bet)
Seat 9: codan23 folded before Flop (didn't bet)



PokerStars Zoom Hand #84301230549:  Hold'em No Limit ($0.10/$0.25) - 2012/08/05 16:20:12 JST [2012/08/05 3:20:12 ET]
Table 'Whirlpool' 9-max Seat #1 is the button
Seat 1: CrittHunter ($29.06 in chips) 
Seat 2: codan23 ($14.37 in chips) 
Seat 3: Loholov ($15 in chips) 
Seat 4: risekuku468 ($30.21 in chips) 
Seat 5: wildy29 ($105.90 in chips) 
Seat 6: svg51 ($19.48 in chips) 
Seat 7: nice.franki ($3.86 in chips) 
Seat 8: chiyuki ($50.24 in chips) 
Seat 9: GovGus ($25 in chips) 
codan23: posts small blind $0.10
Loholov: posts big blind $0.25
*** HOLE CARDS ***
Dealt to chiyuki [6s Kh]
risekuku468: folds 
wildy29: raises $0.50 to $0.75
svg51: folds 
nice.franki: folds 
chiyuki: folds 
GovGus: folds 
CrittHunter: folds 
codan23: folds 
Loholov: folds 
Uncalled bet ($0.50) returned to wildy29
wildy29 collected $0.60 from pot
wildy29: doesn't show hand 
*** SUMMARY ***
Total pot $0.60 | Rake $0 
Seat 1: CrittHunter (button) folded before Flop (didn't bet)
Seat 2: codan23 (small blind) folded before Flop
Seat 3: Loholov (big blind) folded before Flop
Seat 4: risekuku468 folded before Flop (didn't bet)
Seat 5: wildy29 collected ($0.60)
Seat 6: svg51 folded before Flop (didn't bet)
Seat 7: nice.franki folded before Flop (didn't bet)
Seat 8: chiyuki folded before Flop (didn't bet)
Seat 9: GovGus folded before Flop (didn't bet)



PokerStars Zoom Hand #84301226144:  Hold'em No Limit ($0.10/$0.25) - 2012/08/05 16:19:55 JST [2012/08/05 3:19:55 ET]
Table 'Whirlpool' 9-max Seat #1 is the button
Seat 1: AAT Shark ($13.16 in chips) 
Seat 2: INSP!RON ($28.76 in chips) 
Seat 3: PPP7SSS ($43.53 in chips) 
Seat 4: dlogic27 ($14.65 in chips) 
Seat 5: Vall179 ($30.94 in chips) 
Seat 6: 1Karina1 ($32.67 in chips) 
Seat 7: Lindikor ($13 in chips) 
Seat 8: Loholov ($15 in chips) 
Seat 9: chiyuki ($50.34 in chips) 
INSP!RON: posts small blind $0.10
PPP7SSS: posts big blind $0.25
*** HOLE CARDS ***
Dealt to chiyuki [7c Th]
dlogic27: calls $0.25
Vall179: folds 
1Karina1: calls $0.25
Lindikor: folds 
Loholov: folds 
chiyuki: folds 
AAT Shark: folds 
INSP!RON: raises $1.25 to $1.50
PPP7SSS: folds 
dlogic27: folds 
1Karina1: folds 
Uncalled bet ($1.25) returned to INSP!RON
INSP!RON collected $1 from pot
INSP!RON: doesn't show hand 
*** SUMMARY ***
Total pot $1 | Rake $0 
Seat 1: AAT Shark (button) folded before Flop (didn't bet)
Seat 2: INSP!RON (small blind) collected ($1)
Seat 3: PPP7SSS (big blind) folded before Flop
Seat 4: dlogic27 folded before Flop
Seat 5: Vall179 folded before Flop (didn't bet)
Seat 6: 1Karina1 folded before Flop
Seat 7: Lindikor folded before Flop (didn't bet)
Seat 8: Loholov folded before Flop (didn't bet)
Seat 9: chiyuki folded before Flop (didn't bet)



PokerStars Zoom Hand #84301229747:  Hold'em No Limit ($0.10/$0.25) - 2012/08/05 16:20:09 JST [2012/08/05 3:20:09 ET]
Table 'Whirlpool' 9-max Seat #1 is the button
Seat 1: benjuer ($25 in chips) 
Seat 2: Patient90122 ($26.17 in chips) 
Seat 3: polk11 ($25 in chips) 
Seat 4: Vall179 ($28.80 in chips) 
Seat 5: Bondvsta ($25.55 in chips) 
Seat 6: top gun 2950 ($30.73 in chips) 
Seat 7: chiyuki ($50.24 in chips) 
Seat 8: fwnaf ($29.83 in chips) 
Seat 9: DrunkTyphoon ($51.11 in chips) 
Patient90122: posts small blind $0.10
polk11: posts big blind $0.25
*** HOLE CARDS ***
Dealt to chiyuki [5c Qc]
Vall179: folds 
Bondvsta: folds 
top gun 2950: folds 
chiyuki: folds 
fwnaf: raises $0.75 to $1
DrunkTyphoon: folds 
benjuer: folds 
Patient90122: folds 
polk11: folds 
Uncalled bet ($0.75) returned to fwnaf
fwnaf collected $0.60 from pot
fwnaf: doesn't show hand 
*** SUMMARY ***
Total pot $0.60 | Rake $0 
Seat 1: benjuer (button) folded before Flop (didn't bet)
Seat 2: Patient90122 (small blind) folded before Flop
Seat 3: polk11 (big blind) folded before Flop
Seat 4: Vall179 folded before Flop (didn't bet)
Seat 5: Bondvsta folded before Flop (didn't bet)
Seat 6: top gun 2950 folded before Flop (didn't bet)
Seat 7: chiyuki folded before Flop (didn't bet)
Seat 8: fwnaf collected ($0.60)
Seat 9: DrunkTyphoon folded before Flop (didn't bet)



PokerStars Zoom Hand #84301232781:  Hold'em No Limit ($0.10/$0.25) - 2012/08/05 16:20:20 JST [2012/08/05 3:20:20 ET]
Table 'Whirlpool' 9-max Seat #1 is the button
Seat 1: Cripple86 ($25 in chips) 
Seat 2: Vall179 ($28.80 in chips) 
Seat 3: chiyuki ($50.24 in chips) 
Seat 4: Ih8niknames ($20.35 in chips) 
Seat 5: DrunkTyphoon ($51.11 in chips) 
Seat 6: teaser07 ($27.02 in chips) 
Seat 7: nice.franki ($11.82 in chips) 
Seat 8: 1Karina1 ($47.54 in chips) 
Seat 9: hldtom ($16.85 in chips) 
Vall179: posts small blind $0.10
chiyuki: posts big blind $0.25
*** HOLE CARDS ***
Dealt to chiyuki [Qc 7d]
Ih8niknames: folds 
DrunkTyphoon: folds 
teaser07: folds 
nice.franki: folds 
1Karina1: folds 
hldtom has timed out
hldtom: folds 
Cripple86: raises $0.50 to $0.75
Vall179: folds 
chiyuki: folds 
Uncalled bet ($0.50) returned to Cripple86
Cripple86 collected $0.60 from pot
Cripple86: doesn't show hand 
*** SUMMARY ***
Total pot $0.60 | Rake $0 
Seat 1: Cripple86 (button) collected ($0.60)
Seat 2: Vall179 (small blind) folded before Flop
Seat 3: chiyuki (big blind) folded before Flop
Seat 4: Ih8niknames folded before Flop (didn't bet)
Seat 5: DrunkTyphoon folded before Flop (didn't bet)
Seat 6: teaser07 folded before Flop (didn't bet)
Seat 7: nice.franki folded before Flop (didn't bet)
Seat 8: 1Karina1 folded before Flop (didn't bet)
Seat 9: hldtom folded before Flop (didn't bet)



PokerStars Zoom Hand #84301244624:  Hold'em No Limit ($0.10/$0.25) - 2012/08/05 16:21:03 JST [2012/08/05 3:21:03 ET]
Table 'Whirlpool' 9-max Seat #1 is the button
Seat 1: KeLevro0 ($12.15 in chips) 
Seat 2: nice.franki ($14.23 in chips) 
Seat 3: kesstukas25 ($36.49 in chips) 
Seat 4: INSP!RON ($29.51 in chips) 
Seat 5: chiyuki ($49.99 in chips) 
Seat 6: Grishukps ($12.85 in chips) 
Seat 7: 280128si ($17.19 in chips) 
Seat 8: Nerkit ($12.15 in chips) 
Seat 9: deepakmbh ($25.81 in chips) 
nice.franki: posts small blind $0.10
kesstukas25: posts big blind $0.25
*** HOLE CARDS ***
Dealt to chiyuki [4s 9h]
INSP!RON: folds 
chiyuki: folds 
Grishukps: folds 
280128si: folds 
Nerkit: folds 
deepakmbh: folds 
KeLevro0: folds 
nice.franki: folds 
Uncalled bet ($0.15) returned to kesstukas25
kesstukas25 collected $0.20 from pot
kesstukas25: doesn't show hand 
*** SUMMARY ***
Total pot $0.20 | Rake $0 
Seat 1: KeLevro0 (button) folded before Flop (didn't bet)
Seat 2: nice.franki (small blind) folded before Flop
Seat 3: kesstukas25 (big blind) collected ($0.20)
Seat 4: INSP!RON folded before Flop (didn't bet)
Seat 5: chiyuki folded before Flop (didn't bet)
Seat 6: Grishukps folded before Flop (didn't bet)
Seat 7: 280128si folded before Flop (didn't bet)
Seat 8: Nerkit folded before Flop (didn't bet)
Seat 9: deepakmbh folded before Flop (didn't bet)



PokerStars Zoom Hand #84301250124:  Hold'em No Limit ($0.10/$0.25) - 2012/08/05 16:21:24 JST [2012/08/05 3:21:24 ET]
Table 'Whirlpool' 9-max Seat #1 is the button
Seat 1: Vall179 ($34.90 in chips) 
Seat 2: mamlind ($12.70 in chips) 
Seat 3: Kozyavkin ($15.16 in chips) 
Seat 4: pikhtovnikov ($27.74 in chips) 
Seat 5: Loholov ($15 in chips) 
Seat 6: mjmichi ($26.27 in chips) 
Seat 7: new85new85 ($23.65 in chips) 
Seat 8: chiyuki ($49.99 in chips) 
Seat 9: Dejacob ($34.43 in chips) 
mamlind: posts small blind $0.10
Kozyavkin: posts big blind $0.25
*** HOLE CARDS ***
Dealt to chiyuki [3d 9c]
pikhtovnikov: raises $0.75 to $1
Loholov: folds 
mjmichi: folds 
new85new85: folds 
chiyuki: folds 
Dejacob: folds 
Vall179: folds 
mamlind: folds 
Kozyavkin: folds 
Uncalled bet ($0.75) returned to pikhtovnikov
pikhtovnikov collected $0.60 from pot
pikhtovnikov: doesn't show hand 
*** SUMMARY ***
Total pot $0.60 | Rake $0 
Seat 1: Vall179 (button) folded before Flop (didn't bet)
Seat 2: mamlind (small blind) folded before Flop
Seat 3: Kozyavkin (big blind) folded before Flop
Seat 4: pikhtovnikov collected ($0.60)
Seat 5: Loholov folded before Flop (didn't bet)
Seat 6: mjmichi folded before Flop (didn't bet)
Seat 7: new85new85 folded before Flop (didn't bet)
Seat 8: chiyuki folded before Flop (didn't bet)
Seat 9: Dejacob folded before Flop (didn't bet)



PokerStars Zoom Hand #84301245734:  Hold'em No Limit ($0.10/$0.25) - 2012/08/05 16:21:07 JST [2012/08/05 3:21:07 ET]
Table 'Whirlpool' 9-max Seat #1 is the button
Seat 1: Loholov ($15 in chips) 
Seat 2: kwkim73 ($29.96 in chips) 
Seat 3: Ellen1947 ($22.10 in chips) 
Seat 4: hldtom ($17.71 in chips) 
Seat 5: codan23 ($14.73 in chips) 
Seat 6: Perstenev ($12.60 in chips) 
Seat 7: Alvinpe85 ($93.53 in chips) 
Seat 8: AAT Shark ($14.79 in chips) 
Seat 9: chiyuki ($49.99 in chips) 
kwkim73: posts small blind $0.10
Ellen1947: posts big blind $0.25
*** HOLE CARDS ***
Dealt to chiyuki [5s Ah]
hldtom: folds 
codan23: folds 
Perstenev: calls $0.25
Alvinpe85: folds 
AAT Shark: folds 
chiyuki: folds 
Loholov: calls $0.25
kwkim73: folds 
Ellen1947: checks 
*** FLOP *** [8h As Ks]
Ellen1947: checks 
Perstenev: checks 
Loholov: checks 
*** TURN *** [8h As Ks] [9d]
Ellen1947: checks 
Perstenev: checks 
Loholov: checks 
*** RIVER *** [8h As Ks 9d] [5c]
Ellen1947: checks 
Perstenev: checks 
Loholov: checks 
*** SHOW DOWN ***
Ellen1947: shows [6d 3d] (high card Ace)
Perstenev: shows [3c 3s] (a pair of Threes)
Loholov: shows [9s 7s] (a pair of Nines)
Loholov collected $0.81 from pot
*** SUMMARY ***
Total pot $0.85 | Rake $0.04 
Board [8h As Ks 9d 5c]
Seat 1: Loholov (button) showed [9s 7s] and won ($0.81) with a pair of Nines
Seat 2: kwkim73 (small blind) folded before Flop
Seat 3: Ellen1947 (big blind) showed [6d 3d] and lost with high card Ace
Seat 4: hldtom folded before Flop (didn't bet)
Seat 5: codan23 folded before Flop (didn't bet)
Seat 6: Perstenev showed [3c 3s] and lost with a pair of Threes
Seat 7: Alvinpe85 folded before Flop (didn't bet)
Seat 8: AAT Shark folded before Flop (didn't bet)
Seat 9: chiyuki folded before Flop (didn't bet)



PokerStars Zoom Hand #84301256579:  Hold'em No Limit ($0.10/$0.25) - 2012/08/05 16:21:47 JST [2012/08/05 3:21:47 ET]
Table 'Whirlpool' 9-max Seat #1 is the button
Seat 1: Grishukps ($12.85 in chips) 
Seat 2: hldtom ($35.68 in chips) 
Seat 3: Alvinpe85 ($32.95 in chips) 
Seat 4: munky3 ($25.76 in chips) 
Seat 5: chiyuki ($49.89 in chips) 
Seat 6: DanielWhyte ($32.37 in chips) 
Seat 7: AAT Shark ($15.14 in chips) 
Seat 8: Lindikor ($14.43 in chips) 
Seat 9: INSP!RON ($27.06 in chips) 
hldtom: posts small blind $0.10
Alvinpe85: posts big blind $0.25
*** HOLE CARDS ***
Dealt to chiyuki [4d 8h]
munky3: folds 
chiyuki: folds 
DanielWhyte: folds 
AAT Shark: raises $0.37 to $0.62
Lindikor: folds 
INSP!RON: folds 
Grishukps: folds 
hldtom: folds 
Alvinpe85: folds 
Uncalled bet ($0.37) returned to AAT Shark
AAT Shark collected $0.60 from pot
AAT Shark: doesn't show hand 
*** SUMMARY ***
Total pot $0.60 | Rake $0 
Seat 1: Grishukps (button) folded before Flop (didn't bet)
Seat 2: hldtom (small blind) folded before Flop
Seat 3: Alvinpe85 (big blind) folded before Flop
Seat 4: munky3 folded before Flop (didn't bet)
Seat 5: chiyuki folded before Flop (didn't bet)
Seat 6: DanielWhyte folded before Flop (didn't bet)
Seat 7: AAT Shark collected ($0.60)
Seat 8: Lindikor folded before Flop (didn't bet)
Seat 9: INSP!RON folded before Flop (didn't bet)



PokerStars Zoom Hand #84301251592:  Hold'em No Limit ($0.10/$0.25) - 2012/08/05 16:21:29 JST [2012/08/05 3:21:29 ET]
Table 'Whirlpool' 9-max Seat #1 is the button
Seat 1: deepakmbh ($25.81 in chips) 
Seat 2: Dejacob ($34.43 in chips) 
Seat 3: tribunpdm ($75.53 in chips) 
Seat 4: kwkim73 ($29.86 in chips) 
Seat 5: mungroo ($25.14 in chips) 
Seat 6: chiyuki ($49.99 in chips) 
Seat 7: loszavera ($29.91 in chips) 
Seat 8: soul_5577 ($41.06 in chips) 
Seat 9: yoube ($100.16 in chips) 
Dejacob: posts small blind $0.10
tribunpdm: posts big blind $0.25
*** HOLE CARDS ***
Dealt to chiyuki [6h 3h]
kwkim73: folds 
mungroo: folds 
chiyuki: folds 
loszavera: folds 
soul_5577: folds 
yoube: folds 
deepakmbh: raises $0.45 to $0.70
Dejacob: folds 
tribunpdm: calls $0.45
*** FLOP *** [Qh Ac 2s]
tribunpdm: checks 
deepakmbh: checks 
*** TURN *** [Qh Ac 2s] [3s]
tribunpdm: bets $1.50
deepakmbh: calls $1.50
*** RIVER *** [Qh Ac 2s 3s] [Jh]
tribunpdm: checks 
deepakmbh: checks 
*** SHOW DOWN ***
tribunpdm: shows [5c Jc] (a pair of Jacks)
deepakmbh: shows [Ks Qd] (a pair of Queens)
deepakmbh collected $4.30 from pot
*** SUMMARY ***
Total pot $4.50 | Rake $0.20 
Board [Qh Ac 2s 3s Jh]
Seat 1: deepakmbh (button) showed [Ks Qd] and won ($4.30) with a pair of Queens
Seat 2: Dejacob (small blind) folded before Flop
Seat 3: tribunpdm (big blind) showed [5c Jc] and lost with a pair of Jacks
Seat 4: kwkim73 folded before Flop (didn't bet)
Seat 5: mungroo folded before Flop (didn't bet)
Seat 6: chiyuki folded before Flop (didn't bet)
Seat 7: loszavera folded before Flop (didn't bet)
Seat 8: soul_5577 folded before Flop (didn't bet)
Seat 9: yoube folded before Flop (didn't bet)



